Nr.;"Darželio pavadinimas";"Grupės pavadinimas";"Vaiko Identifikacinis Nr.";"Deklaruotas mieste";"Pateisintos dėl ligos";"Pateisintos dėl kitų priežasčių";"Nepateisintos dienos";"Praleistos dienos Viso"
1;Aitvaras;"VIJURKAI (ALERG.)";1795308718;Taip;8;1;0;9
2;Aitvaras;"VIJURKAI (ALERG.)";9649742132;Taip;0;10;0;10
3;Aitvaras;"VIJURKAI (ALERG.)";84922258988;Taip;5;3;0;8
4;Aitvaras;"VIJURKAI (ALERG.)";1201862001;Ne;16;0;0;16
5;Aitvaras;"VIJURKAI (ALERG.)";8970519668;Ne;0;6;0;6
6;Aitvaras;"VIJURKAI (ALERG.)";1600657305;Taip;1;0;1;2
7;Aitvaras;"VIJURKAI (ALERG.)";1621302802;Taip;0;14;0;14
8;Aitvaras;"VIJURKAI (ALERG.)";94080483856;Taip;0;1;0;1
9;Aitvaras;"VIJURKAI (ALERG.)";5083382326;Taip;0;2;0;2
10;Aitvaras;"VIJURKAI (ALERG.)";1834535594;Taip;0;1;0;1
11;Aitvaras;"VIJURKAI (ALERG.)";7083046536;Taip;0;1;0;1
12;Aitvaras;"VIJURKAI (ALERG.)";1773366241;Taip;0;2;0;2
13;Aitvaras;"VIJURKAI (ALERG.)";1553462849;Ne;10;1;0;11
14;Aitvaras;"VIJURKAI (ALERG.)";1398792964;Taip;0;1;0;1
15;Aitvaras;"VIJURKAI (ALERG.)";5770779699;Taip;0;1;0;1
16;Aitvaras;"VIJURKAI (ALERG.)";2159901439;Taip;5;6;0;11
17;Aitvaras;"VIJURKAI (ALERG.)";3716313515;Taip;0;1;0;1
18;Aitvaras;"VIJURKAI (ALERG.)";8366627546;Taip;0;8;0;8
19;Aitvaras;"VIJURKAI (ALERG.)";1481849611;Taip;5;1;2;8
20;Aitvaras;"VIJURKAI (ALERG.)";1090979323;Taip;5;2;1;8
21;Aitvaras;"SMALSUČIAI (ALERG.)";85826303673;Ne;15;0;0;15
22;Aitvaras;"SMALSUČIAI (ALERG.)";7592535089;Taip;1;1;0;2
23;Aitvaras;"SMALSUČIAI (ALERG.)";9845539641;Taip;5;4;0;9
24;Aitvaras;"SMALSUČIAI (ALERG.)";44139920757;Ne;0;2;0;2
25;Aitvaras;"SMALSUČIAI (ALERG.)";3001619281;Taip;0;3;0;3
26;Aitvaras;"SMALSUČIAI (ALERG.)";4708741626;Taip;0;2;0;2
27;Aitvaras;"SMALSUČIAI (ALERG.)";1301667420;Taip;0;4;0;4
28;Aitvaras;"SMALSUČIAI (ALERG.)";47686798724;Taip;0;3;2;5
29;Aitvaras;"SMALSUČIAI (ALERG.)";1892295973;Ne;3;3;0;6
30;Aitvaras;"SMALSUČIAI (ALERG.)";89623351867;Taip;0;1;0;1
31;Aitvaras;"SMALSUČIAI (ALERG.)";5204534227;Taip;0;1;0;1
32;Aitvaras;"SMALSUČIAI (ALERG.)";2674192321;Taip;0;1;0;1
33;Aitvaras;"SMALSUČIAI (ALERG.)";37391225613;Taip;0;8;0;8
34;Aitvaras;"SMALSUČIAI (ALERG.)";36359228257;Taip;0;1;0;1
35;Aitvaras;"SMALSUČIAI (ALERG.)";31074942686;Taip;0;8;0;8
36;Aitvaras;"SMALSUČIAI (ALERG.)";13670186807;Taip;13;0;2;15
37;Aitvaras;"SMALSUČIAI (ALERG.)";76280361479;Taip;0;2;0;2
38;Aitvaras;"SMALSUČIAI (ALERG.)";85103026654;Taip;5;0;0;5
39;Aitvaras;"SMALSUČIAI (ALERG.)";12962784212;Ne;0;3;0;3
40;Aitvaras;PADAUŽIUKAI;75662895254;Taip;10;0;0;10
41;Aitvaras;PADAUŽIUKAI;46998364516;Taip;0;1;0;1
42;Aitvaras;PADAUŽIUKAI;1355296093;Taip;7;0;0;7
43;Aitvaras;PADAUŽIUKAI;1641140396;Ne;8;1;3;12
44;Aitvaras;PADAUŽIUKAI;2136550853;Ne;2;1;0;3
45;Aitvaras;PADAUŽIUKAI;64683090780;Ne;0;1;0;1
46;Aitvaras;PADAUŽIUKAI;87846069433;Taip;0;2;0;2
47;Aitvaras;PADAUŽIUKAI;30517554931;Taip;0;2;0;2
48;Aitvaras;PADAUŽIUKAI;69145890005;Taip;0;1;0;1
49;Aitvaras;PADAUŽIUKAI;89194677727;Taip;0;2;0;2
50;Aitvaras;PADAUŽIUKAI;45833790181;Taip;0;1;0;1
51;Aitvaras;PADAUŽIUKAI;1371102633;Taip;5;2;1;8
52;Aitvaras;PADAUŽIUKAI;24017694836;Taip;0;0;3;3
53;Aitvaras;PADAUŽIUKAI;2092431875;Taip;0;4;2;6
54;Aitvaras;PADAUŽIUKAI;12216502128;Taip;4;1;0;5
55;Aitvaras;PADAUŽIUKAI;64205113506;Taip;0;2;0;2
56;Aitvaras;PADAUŽIUKAI;1315081684;Taip;2;1;0;3
57;Aitvaras;PADAUŽIUKAI;25117529505;Taip;0;1;0;1
58;Aitvaras;PADAUŽIUKAI;403821197;Taip;0;1;0;1
59;Aitvaras;"AITVARIUKAI (ALERG.)";1542575012;Taip;8;1;0;9
60;Aitvaras;"AITVARIUKAI (ALERG.)";1223627682;Taip;0;13;0;13
61;Aitvaras;"AITVARIUKAI (ALERG.)";3471031093;Taip;15;0;0;15
62;Aitvaras;"AITVARIUKAI (ALERG.)";9810370596;Taip;11;0;0;11
63;Aitvaras;"AITVARIUKAI (ALERG.)";34735287315;Taip;5;6;0;11
64;Aitvaras;"AITVARIUKAI (ALERG.)";4833313373;Taip;0;1;0;1
65;Aitvaras;"AITVARIUKAI (ALERG.)";9745864667;Taip;11;5;0;16
66;Aitvaras;"AITVARIUKAI (ALERG.)";5389627560;Taip;7;5;0;12
67;Aitvaras;"AITVARIUKAI (ALERG.)";5956333024;Taip;0;1;0;1
68;Aitvaras;"AITVARIUKAI (ALERG.)";1636794584;Taip;8;1;0;9
69;Aitvaras;"AITVARIUKAI (ALERG.)";2953536545;Taip;0;2;0;2
70;Aitvaras;"AITVARIUKAI (ALERG.)";3535659630;Taip;5;0;4;9
71;Aitvaras;"AITVARIUKAI (ALERG.)";3488467265;Taip;0;1;0;1
72;Aitvaras;"AITVARIUKAI (ALERG.)";6356432078;Taip;4;0;0;4
73;Aitvaras;"AITVARIUKAI (ALERG.)";3639102842;Taip;3;5;0;8
74;Aitvaras;"AITVARIUKAI (ALERG.)";7243387750;Taip;14;2;0;16
75;Aitvaras;"AITVARIUKAI (ALERG.)";6587437949;Taip;0;6;0;6
76;Aitvaras;"AITVARIUKAI (ALERG.)";7461284958;Taip;15;1;0;16
77;Aitvaras;"SAULĖS ZUIKUČIAI  (ALERG.)";1019661577;Taip;0;1;0;1
78;Aitvaras;"SAULĖS ZUIKUČIAI  (ALERG.)";55369747065;Ne;0;0;2;2
79;Aitvaras;"SAULĖS ZUIKUČIAI  (ALERG.)";837021325;Taip;2;1;0;3
80;Aitvaras;"SAULĖS ZUIKUČIAI  (ALERG.)";1207249857;Taip;10;1;0;11
81;Aitvaras;"SAULĖS ZUIKUČIAI  (ALERG.)";30174058452;Taip;0;2;0;2
82;Aitvaras;"SAULĖS ZUIKUČIAI  (ALERG.)";24247118884;Taip;0;3;0;3
83;Aitvaras;"SAULĖS ZUIKUČIAI  (ALERG.)";1516018865;Taip;0;4;0;4
84;Aitvaras;"SAULĖS ZUIKUČIAI  (ALERG.)";1392528718;Taip;0;1;0;1
85;Aitvaras;"SAULĖS ZUIKUČIAI  (ALERG.)";1011446683;Taip;0;0;5;5
86;Aitvaras;"SAULĖS ZUIKUČIAI  (ALERG.)";2021772475;Ne;0;1;0;1
87;Aitvaras;"SAULĖS ZUIKUČIAI  (ALERG.)";1872130301;Taip;0;0;4;4
88;Aitvaras;"SAULĖS ZUIKUČIAI  (ALERG.)";3433178644;Ne;0;3;0;3
89;Aitvaras;"SAULĖS ZUIKUČIAI  (ALERG.)";69352006024;Taip;0;11;0;11
90;Aitvaras;"SAULĖS ZUIKUČIAI  (ALERG.)";2083332491;Ne;0;1;0;1
91;Aitvaras;"SAULĖS ZUIKUČIAI  (ALERG.)";61721665912;Taip;0;2;0;2
92;Aitvaras;"SAULĖS ZUIKUČIAI  (ALERG.)";6238828251;Taip;0;0;9;9
93;Aitvaras;"SAULĖS ZUIKUČIAI  (ALERG.)";1877245088;Taip;3;5;0;8
94;Aitvaras;"SAULĖS ZUIKUČIAI  (ALERG.)";5619137905;Taip;0;5;0;5
95;Aitvaras;"SAULĖS ZUIKUČIAI  (ALERG.)";4426643908;Taip;0;7;0;7
96;Aitvaras;"ŽEMYNUKAI (ALERG.)";1652681820;Taip;0;3;1;4
97;Aitvaras;"ŽEMYNUKAI (ALERG.)";6166757095;Taip;6;0;2;8
98;Aitvaras;"ŽEMYNUKAI (ALERG.)";5595233402;Taip;19;0;0;19
99;Aitvaras;"ŽEMYNUKAI (ALERG.)";2650483861;Taip;0;1;0;1
100;Aitvaras;"ŽEMYNUKAI (ALERG.)";5922357091;Taip;5;3;2;10
101;Aitvaras;"ŽEMYNUKAI (ALERG.)";6951219468;Taip;3;1;0;4
102;Aitvaras;"ŽEMYNUKAI (ALERG.)";4868552034;Taip;0;1;0;1
103;Aitvaras;"ŽEMYNUKAI (ALERG.)";1494094426;Taip;0;5;0;5
104;Aitvaras;"ŽEMYNUKAI (ALERG.)";9562494357;Taip;14;0;0;14
105;Aitvaras;"ŽEMYNUKAI (ALERG.)";6021342178;Taip;5;6;0;11
106;Aitvaras;"ŽEMYNUKAI (ALERG.)";9142513631;Taip;5;6;0;11
107;Aitvaras;"ŽEMYNUKAI (ALERG.)";4480921300;Taip;16;0;2;18
108;Aitvaras;"ŽEMYNUKAI (ALERG.)";8567255042;Ne;3;0;0;3
109;Aitvaras;"ŽEMYNUKAI (ALERG.)";6218019092;Taip;0;0;1;1
110;Aitvaras;"ŽEMYNUKAI (ALERG.)";7560642918;Taip;2;0;0;2
111;Aitvaras;"ŽEMYNUKAI (ALERG.)";3820930777;Taip;17;1;0;18
112;Aitvaras;"ŽEMYNUKAI (ALERG.)";6624986090;Taip;7;0;1;8
113;Aitvaras;"ŽEMYNUKAI (ALERG.)";4733627644;Taip;0;2;4;6
114;Aitvaras;"ŽEMYNUKAI (ALERG.)";3104109370;Taip;0;0;5;5
115;Aitvaras;"LINKSMUČIAI (ALERG.)";5238819066;Taip;0;1;0;1
116;Aitvaras;"LINKSMUČIAI (ALERG.)";7109001184;Taip;0;0;3;3
117;Aitvaras;"LINKSMUČIAI (ALERG.)";5378212904;Ne;21;0;0;21
118;Aitvaras;"LINKSMUČIAI (ALERG.)";3655710511;Taip;0;0;4;4
119;Aitvaras;"LINKSMUČIAI (ALERG.)";1091372798;Taip;0;2;2;4
120;Aitvaras;"LINKSMUČIAI (ALERG.)";8666824607;Ne;0;1;3;4
121;Aitvaras;"LINKSMUČIAI (ALERG.)";5612991255;Taip;0;1;0;1
122;Aitvaras;"LINKSMUČIAI (ALERG.)";5330618557;Ne;21;0;0;21
123;Aitvaras;"LINKSMUČIAI (ALERG.)";5504431748;Taip;2;0;0;2
124;Aitvaras;"LINKSMUČIAI (ALERG.)";8178703988;Taip;1;0;1;2
125;Aitvaras;"LINKSMUČIAI (ALERG.)";7260577885;Taip;0;2;0;2
126;Aitvaras;"LINKSMUČIAI (ALERG.)";1599183050;Taip;5;0;1;6
127;Aitvaras;"LINKSMUČIAI (ALERG.)";1115202169;Ne;4;1;1;6
128;Aitvaras;"LINKSMUČIAI (ALERG.)";7029464687;Taip;7;0;2;9
129;Aitvaras;"LINKSMUČIAI (ALERG.)";2760970218;Taip;1;2;0;3
130;Aitvaras;"LINKSMUČIAI (ALERG.)";4120515569;Taip;10;1;0;11
131;Aitvaras;"LINKSMUČIAI (ALERG.)";9885781306;Taip;4;0;0;4
132;Aitvaras;"LINKSMUČIAI (ALERG.)";4564723798;Taip;15;0;6;21
133;Aitvaras;"LINKSMUČIAI (ALERG.)";4612994715;Taip;1;0;2;3
134;Aitvaras;NAMINUKAI;40344230133;Taip;0;0;1;1
135;Aitvaras;NAMINUKAI;1493048970;Ne;17;0;0;17
136;Aitvaras;NAMINUKAI;1306408890;Taip;0;5;0;5
137;Aitvaras;NAMINUKAI;59572108690;Taip;0;1;0;1
138;Aitvaras;NAMINUKAI;74628671065;Taip;0;6;6;12
139;Aitvaras;NAMINUKAI;70367340825;Taip;0;1;0;1
140;Aitvaras;NAMINUKAI;62126044317;Taip;10;4;0;14
141;Aitvaras;NAMINUKAI;46021715174;Taip;0;1;1;2
142;Aitvaras;NAMINUKAI;85560586048;Taip;0;0;1;1
143;Aitvaras;NAMINUKAI;26906648835;Taip;0;2;0;2
144;Aitvaras;NAMINUKAI;42556460388;Taip;0;1;0;1
145;Aitvaras;NAMINUKAI;54496602809;Ne;0;0;6;6
146;Aitvaras;NAMINUKAI;97382092851;Taip;5;4;0;9
147;Aitvaras;NAMINUKAI;1886917840;Taip;20;1;0;21
148;Aitvaras;NAMINUKAI;52679806772;Taip;1;0;0;1
149;Aitvaras;NAMINUKAI;1500548803;Taip;0;1;0;1
150;Aitvaras;NAMINUKAI;5103057090;Taip;0;1;0;1
151;Aitvaras;NAMINUKAI;3836513736;Taip;10;0;2;12
152;Aitvaras;ŠELMIAI;9332771711;Ne;6;1;0;7
153;Aitvaras;ŠELMIAI;6550426644;Taip;5;10;0;15
154;Aitvaras;ŠELMIAI;58780461337;Taip;5;1;0;6
155;Aitvaras;ŠELMIAI;1116271183;Taip;0;3;0;3
156;Aitvaras;ŠELMIAI;44046627149;Taip;0;0;5;5
157;Aitvaras;ŠELMIAI;43711349817;Taip;6;0;2;8
158;Aitvaras;ŠELMIAI;7469656671;Taip;4;2;0;6
159;Aitvaras;ŠELMIAI;2408952971;Taip;15;0;0;15
160;Aitvaras;ŠELMIAI;2330782717;Taip;5;0;0;5
161;Aitvaras;ŠELMIAI;47875842134;Taip;3;1;0;4
162;Aitvaras;ŠELMIAI;40799643122;Taip;0;3;0;3
163;Aitvaras;ŠELMIAI;8784628567;Taip;0;3;0;3
164;Aitvaras;ŠELMIAI;2601983670;Taip;0;3;1;4
165;Aitvaras;ŠELMIAI;1387254053;Taip;4;1;0;5
166;Aitvaras;ŠELMIAI;8503279655;Taip;3;1;0;4
167;Aitvaras;ŠELMIAI;1105354193;Taip;0;1;0;1
168;Aitvaras;ŠELMIAI;2034293999;Taip;21;0;0;21
169;Aitvaras;ŠELMIAI;2804106417;Taip;0;1;0;1
170;Aitvaras;ŠELMIAI;2711888522;Taip;0;1;0;1
171;Aitvaras;ŠELMIAI;1996524718;Taip;15;0;0;15
172;Aitvaras;ŠELMIAI;4110585744;Ne;5;1;1;7
173;Aitvaras;ŠELMIAI;6010324894;Taip;10;0;2;12
174;Aitvaras;KODĖLČIUKAI;6214572150;Taip;10;2;6;18
175;Aitvaras;KODĖLČIUKAI;8065540507;Taip;17;0;0;17
176;Aitvaras;KODĖLČIUKAI;1288810999;Taip;16;0;0;16
177;Aitvaras;KODĖLČIUKAI;6501943902;Taip;16;0;0;16
178;Aitvaras;KODĖLČIUKAI;3101015381;Taip;0;0;1;1
179;Aitvaras;KODĖLČIUKAI;7777235021;Ne;0;1;0;1
180;Aitvaras;KODĖLČIUKAI;5641224483;Taip;0;1;0;1
181;Aitvaras;KODĖLČIUKAI;1830134108;Taip;0;11;0;11
182;Aitvaras;KODĖLČIUKAI;2452780076;Taip;6;0;0;6
183;Aitvaras;KODĖLČIUKAI;3178965623;Taip;0;6;0;6
184;Aitvaras;KODĖLČIUKAI;5905456814;Ne;9;1;0;10
185;Aitvaras;KODĖLČIUKAI;1761446849;Taip;3;0;0;3
186;Aitvaras;KODĖLČIUKAI;6739827530;Taip;6;1;0;7
187;Aitvaras;KODĖLČIUKAI;2807595769;Ne;1;0;0;1
188;Aitvaras;KODĖLČIUKAI;1252145346;Taip;0;0;1;1
189;Aitvaras;KODĖLČIUKAI;7455895024;Taip;6;0;0;6
190;Aitvaras;KODĖLČIUKAI;8439586875;Taip;0;1;0;1
191;Aitvaras;PABIRUČIAI;8043062737;Taip;8;1;0;9
192;Aitvaras;PABIRUČIAI;9039303562;Taip;21;0;0;21
193;Aitvaras;PABIRUČIAI;6080549524;Taip;21;0;0;21
194;Aitvaras;PABIRUČIAI;6060880045;Taip;5;1;0;6
195;Aitvaras;PABIRUČIAI;1376605323;Taip;5;1;0;6
196;Aitvaras;PABIRUČIAI;4106097701;Taip;0;4;0;4
197;Aitvaras;PABIRUČIAI;8512502118;Taip;0;1;1;2
198;Aitvaras;PABIRUČIAI;3347213578;Taip;15;1;0;16
199;Aitvaras;PABIRUČIAI;3053557807;Taip;21;0;0;21
200;Aitvaras;PABIRUČIAI;2821221241;Taip;2;1;0;3
201;Aitvaras;PABIRUČIAI;9453994213;Taip;5;1;0;6
202;Aitvaras;PABIRUČIAI;6048701733;Taip;0;3;0;3
203;Aitvaras;PABIRUČIAI;9024245490;Taip;16;0;2;18
204;Aitvaras;PABIRUČIAI;6110226958;Taip;14;0;7;21
205;Aitvaras;PABIRUČIAI;6126913961;Taip;6;0;0;6
206;Aitvaras;"SVAJOKLIAI  (ALERG.)";1606267845;Taip;8;0;0;8
207;Aitvaras;"SVAJOKLIAI  (ALERG.)";5856250605;Taip;10;0;0;10
208;Aitvaras;"SVAJOKLIAI  (ALERG.)";2004112424;Taip;16;2;0;18
209;Aitvaras;"SVAJOKLIAI  (ALERG.)";6084096300;Taip;0;1;0;1
210;Aitvaras;"SVAJOKLIAI  (ALERG.)";5750154036;Taip;10;2;0;12
211;Aitvaras;"SVAJOKLIAI  (ALERG.)";6201118021;Taip;13;6;0;19
212;Aitvaras;"SVAJOKLIAI  (ALERG.)";3133031845;Ne;14;0;0;14
213;Aitvaras;"SVAJOKLIAI  (ALERG.)";1275561645;Ne;4;2;0;6
214;Aitvaras;"SVAJOKLIAI  (ALERG.)";1879540041;Taip;8;1;0;9
215;Aitvaras;"SVAJOKLIAI  (ALERG.)";1347364985;Taip;5;0;0;5
216;Aitvaras;"SVAJOKLIAI  (ALERG.)";5425259260;Taip;5;3;0;8
217;Aitvaras;"SVAJOKLIAI  (ALERG.)";9228736015;Taip;18;2;0;20
218;Aitvaras;"SVAJOKLIAI  (ALERG.)";9763502346;Taip;16;0;0;16
219;Aitvaras;"SVAJOKLIAI  (ALERG.)";7568388141;Taip;5;4;0;9
220;Aitvaras;"SVAJOKLIAI  (ALERG.)";4204923580;Taip;11;3;0;14
221;Aitvaras;"SVAJOKLIAI  (ALERG.)";1532588441;Ne;10;0;0;10
222;Aitvaras;"SVAJOKLIAI  (ALERG.)";8206046301;Taip;6;0;0;6
223;Aitvaras;"SVAJOKLIAI  (ALERG.)";6572235324;Taip;10;0;0;10
224;Aitvaras;"SVAJOKLIAI  (ALERG.)";3005447572;Taip;11;0;0;11
225;Aitvaras;"SVAJOKLIAI  (ALERG.)";1859647003;Taip;11;0;0;11
226;Atžalėlės;Gėlytės;5742471497;Taip;5;0;11;16
227;Atžalėlės;Gėlytės;4284673729;Ne;15;3;0;18
228;Atžalėlės;Gėlytės;8695865604;Ne;4;8;0;12
229;Atžalėlės;Gėlytės;1137741059;Taip;5;0;0;5
230;Atžalėlės;Gėlytės;2385614957;Taip;4;0;1;5
231;Atžalėlės;Gėlytės;5432433423;Taip;0;6;0;6
232;Atžalėlės;Gėlytės;9715625283;Taip;11;0;5;16
233;Atžalėlės;Gėlytės;4682216852;Ne;0;0;2;2
234;Atžalėlės;Gėlytės;4238773173;Taip;0;0;2;2
235;Atžalėlės;Gėlytės;2131592139;Taip;6;0;0;6
236;Atžalėlės;Gėlytės;3191066669;Taip;6;0;0;6
237;Atžalėlės;Gėlytės;1500456945;Taip;0;0;5;5
238;Atžalėlės;Gėlytės;6177038838;Taip;0;6;0;6
239;Atžalėlės;Gėlytės;1722233272;Taip;5;5;0;10
240;Atžalėlės;Gėlytės;5310990513;Taip;0;1;0;1
241;Atžalėlės;Gėlytės;7702502252;Taip;0;14;0;14
242;Atžalėlės;Gėlytės;9189223222;Taip;0;7;0;7
243;Atžalėlės;Gėlytės;3283415814;Taip;12;0;0;12
244;Atžalėlės;Gėlytės;1146492807;Taip;4;0;3;7
245;Atžalėlės;Gėlytės;1036410428;Taip;0;1;0;1
246;Atžalėlės;Gėlytės;1450609695;Taip;5;1;0;6
247;Atžalėlės;Drugeliai;4643154006;Taip;1;2;0;3
248;Atžalėlės;Drugeliai;6903666624;Taip;1;8;0;9
249;Atžalėlės;Drugeliai;4902947406;Taip;0;1;7;8
250;Atžalėlės;Drugeliai;6570245757;Taip;10;0;7;17
251;Atžalėlės;Drugeliai;6132569107;Taip;0;0;2;2
252;Atžalėlės;Drugeliai;2315790531;Ne;11;0;0;11
253;Atžalėlės;Drugeliai;6782007470;Taip;0;0;15;15
254;Atžalėlės;Drugeliai;8393217418;Taip;0;9;0;9
255;Atžalėlės;Drugeliai;1805496887;Taip;0;0;1;1
256;Atžalėlės;Drugeliai;5417971068;Taip;2;0;0;2
257;Atžalėlės;Drugeliai;7953922166;Taip;5;1;0;6
258;Atžalėlės;Drugeliai;1830572633;Taip;1;0;0;1
259;Atžalėlės;Drugeliai;5147078840;Taip;0;1;0;1
260;Atžalėlės;Drugeliai;9222670655;Taip;0;1;0;1
261;Atžalėlės;Drugeliai;77261118958;Taip;0;1;0;1
262;Atžalėlės;Drugeliai;1429493246;Taip;0;4;0;4
263;Atžalėlės;Drugeliai;6114426973;Taip;11;3;0;14
264;Atžalėlės;Drugeliai;1456979448;Taip;0;3;0;3
265;Atžalėlės;Drugeliai;4884599397;Taip;0;0;2;2
266;Atžalėlės;Drugeliai;8718036014;Taip;0;0;2;2
267;Atžalėlės;Drugeliai;3571134734;Taip;14;3;0;17
268;Atžalėlės;Gandriukai;28910361902;Taip;0;3;0;3
269;Atžalėlės;Gandriukai;32154742975;Taip;1;0;0;1
270;Atžalėlės;Gandriukai;93452036571;Taip;0;6;0;6
271;Atžalėlės;Gandriukai;4483002806;Taip;0;0;2;2
272;Atžalėlės;Gandriukai;16442821393;Taip;0;3;0;3
273;Atžalėlės;Gandriukai;1197205716;Taip;0;1;0;1
274;Atžalėlės;Gandriukai;70694002130;Taip;8;0;3;11
275;Atžalėlės;Gandriukai;87334806437;Taip;0;1;0;1
276;Atžalėlės;Gandriukai;1074259644;Taip;5;4;0;9
277;Atžalėlės;Gandriukai;66107666615;Taip;0;1;3;4
278;Atžalėlės;Gandriukai;2124150483;Taip;0;2;0;2
279;Atžalėlės;Gandriukai;87567915519;Taip;5;1;0;6
280;Atžalėlės;Gandriukai;78120202936;Taip;0;1;0;1
281;Atžalėlės;Gandriukai;1011601294;Taip;0;9;0;9
282;Atžalėlės;Gandriukai;1299048195;Taip;5;1;0;6
283;Atžalėlės;Gandriukai;54869610865;Taip;0;0;3;3
284;Atžalėlės;Gandriukai;80500800894;Taip;0;0;4;4
285;Atžalėlės;Gandriukai;519493490;Ne;0;6;0;6
286;Atžalėlės;Gandriukai;82777644548;Taip;5;0;3;8
287;Atžalėlės;Gandriukai;23453799177;Taip;0;3;0;3
288;Atžalėlės;Gandriukai;78664848612;Taip;7;1;0;8
289;Atžalėlės;Voveriukai;52803011399;Taip;0;1;0;1
290;Atžalėlės;Voveriukai;30370285022;Taip;0;1;0;1
291;Atžalėlės;Voveriukai;1447259034;Taip;2;1;0;3
292;Atžalėlės;Voveriukai;64596277701;Taip;5;0;3;8
293;Atžalėlės;Voveriukai;3379307367;Taip;0;1;9;10
294;Atžalėlės;Voveriukai;62325712598;Taip;6;0;0;6
295;Atžalėlės;Voveriukai;1312772153;Taip;1;4;0;5
296;Atžalėlės;Voveriukai;1865339755;Taip;0;0;5;5
297;Atžalėlės;Voveriukai;8138683218;Taip;0;5;0;5
298;Atžalėlės;Voveriukai;4467364336;Taip;6;0;0;6
299;Atžalėlės;Voveriukai;1804802235;Taip;4;2;0;6
300;Atžalėlės;Voveriukai;1316154666;Taip;0;5;1;6
301;Atžalėlės;Voveriukai;9699811980;Ne;0;8;0;8
302;Atžalėlės;Voveriukai;8847754477;Taip;0;7;0;7
303;Atžalėlės;Voveriukai;7689394485;Taip;10;0;0;10
304;Atžalėlės;Voveriukai;2013707106;Taip;10;0;0;10
305;Atžalėlės;Voveriukai;2757744826;Ne;5;4;0;9
306;Atžalėlės;Voveriukai;3795729265;Taip;0;0;2;2
307;Atžalėlės;Voveriukai;8201582382;Taip;0;1;5;6
308;Atžalėlės;Voveriukai;4362058013;Taip;0;1;5;6
309;Atžalėlės;Voveriukai;51586822606;Taip;5;1;1;7
310;Atžalėlės;Voveriukai;8819893830;Taip;0;0;2;2
311;Atžalėlės;Žirniukai;7807313362;Taip;8;0;0;8
312;Atžalėlės;Žirniukai;4081717007;Taip;21;0;0;21
313;Atžalėlės;Žirniukai;9977104915;Taip;0;4;0;4
314;Atžalėlės;Žirniukai;6265777690;Taip;0;10;0;10
315;Atžalėlės;Žirniukai;7321516783;Taip;0;15;0;15
316;Atžalėlės;Žirniukai;8768704484;Taip;5;0;13;18
317;Atžalėlės;Žirniukai;6675588261;Taip;5;0;13;18
318;Atžalėlės;Žirniukai;1844980319;Ne;0;0;3;3
319;Atžalėlės;Žirniukai;5997958773;Ne;0;0;3;3
320;Atžalėlės;Žirniukai;8524244526;Taip;13;0;3;16
321;Atžalėlės;Žirniukai;1704679306;Taip;5;0;1;6
322;Atžalėlės;Žirniukai;7356877676;Taip;10;1;0;11
323;Atžalėlės;Žirniukai;6873507667;Taip;5;0;1;6
324;Atžalėlės;Žirniukai;2374624441;Taip;10;1;0;11
325;Atžalėlės;Ežiukai;8619613890;Taip;6;0;1;7
326;Atžalėlės;Ežiukai;8586739429;Taip;11;0;1;12
327;Atžalėlės;Ežiukai;1423254771;Taip;10;1;0;11
328;Atžalėlės;Ežiukai;3281114596;Taip;15;0;2;17
329;Atžalėlės;Ežiukai;1431197358;Taip;10;0;6;16
330;Atžalėlės;Ežiukai;4177753994;Taip;0;0;1;1
331;Atžalėlės;Ežiukai;3982090601;Taip;8;0;3;11
332;Atžalėlės;Ežiukai;9925178685;Taip;14;0;0;14
333;Atžalėlės;Ežiukai;2617568019;Taip;11;0;2;13
334;Atžalėlės;Ežiukai;8512283024;Taip;8;0;0;8
335;Atžalėlės;Ežiukai;4233689945;Taip;14;0;0;14
336;Atžalėlės;Ežiukai;9053620501;Taip;6;0;3;9
337;Atžalėlės;Ežiukai;8508450500;Taip;0;12;0;12
338;Atžalėlės;Ežiukai;3743308789;Taip;3;0;1;4
339;Atžalėlės;Ežiukai;2339599448;Ne;16;1;0;17
340;Atžalėlės;Paukšteliai;77693032830;Ne;0;2;0;2
341;Atžalėlės;Paukšteliai;99097316080;Taip;9;0;1;10
342;Atžalėlės;Paukšteliai;1576891322;Ne;5;0;0;5
343;Atžalėlės;Paukšteliai;72360139252;Taip;4;4;0;8
344;Atžalėlės;Paukšteliai;89028851257;Taip;10;1;0;11
345;Atžalėlės;Paukšteliai;88525056192;Taip;0;0;1;1
346;Atžalėlės;Paukšteliai;30452835434;Taip;0;0;1;1
347;Atžalėlės;Paukšteliai;1046971571;Taip;0;0;5;5
348;Atžalėlės;Paukšteliai;71490200980;Taip;0;0;1;1
349;Atžalėlės;Paukšteliai;93709702327;Taip;5;0;0;5
350;Atžalėlės;Paukšteliai;90664899396;Taip;0;0;3;3
351;Atžalėlės;Paukšteliai;35472285094;Taip;0;0;2;2
352;Atžalėlės;Paukšteliai;42752976301;Taip;0;0;10;10
353;Atžalėlės;Paukšteliai;27330226432;Ne;6;0;0;6
354;Atžalėlės;Paukšteliai;57459192709;Ne;18;0;0;18
355;Atžalėlės;Paukšteliai;5438129052;Taip;0;0;2;2
356;Atžalėlės;Meškiukai;26878092629;Taip;0;9;0;9
357;Atžalėlės;Meškiukai;1083996834;Taip;0;10;0;10
358;Atžalėlės;Meškiukai;53385285795;Ne;10;2;0;12
359;Atžalėlės;Meškiukai;57197465236;Taip;5;0;0;5
360;Atžalėlės;Meškiukai;96954269567;Taip;10;1;0;11
361;Atžalėlės;Meškiukai;91094623082;Taip;0;2;0;2
362;Atžalėlės;Meškiukai;52163840804;Taip;0;1;1;2
363;Atžalėlės;Meškiukai;97667536161;Taip;0;4;0;4
364;Atžalėlės;Meškiukai;32165722689;Taip;0;1;0;1
365;Atžalėlės;Meškiukai;59994970570;Taip;11;1;0;12
366;Atžalėlės;Meškiukai;60841336326;Taip;0;1;0;1
367;Atžalėlės;Meškiukai;83433461267;Taip;1;1;0;2
368;Atžalėlės;Meškiukai;78909909613;Taip;0;1;0;1
369;Atžalėlės;Meškiukai;46263888918;Taip;0;10;0;10
370;Atžalėlės;Meškiukai;7315734265;Taip;0;1;0;1
371;Atžalėlės;Meškiukai;30776087985;Taip;0;1;3;4
372;Atžalėlės;Meškiukai;74153703568;Taip;0;1;0;1
373;Atžalėlės;Meškiukai;939302682;Taip;0;1;0;1
374;Atžalėlės;Meškiukai;40388417436;Taip;0;3;0;3
375;Atžalėlės;Meškiukai;45860181171;Taip;0;6;0;6
376;Atžalėlės;Meškiukai;1512766841;Taip;3;1;2;6
377;Atžalėlės;Meškiukai;76280495364;Taip;0;1;0;1
378;Atžalėlės;Meškiukai;1448431632;Taip;0;7;0;7
379;Atžalėlės;Meškiukai;4702130326;Taip;0;5;0;5
380;Aušrelė;PASAKIUKAI;2974714806;Ne;13;0;0;13
381;Aušrelė;PASAKIUKAI;1327431679;Taip;0;5;0;5
382;Aušrelė;PASAKIUKAI;8960462835;Taip;0;2;4;6
383;Aušrelė;PASAKIUKAI;6037757548;Taip;9;0;0;9
384;Aušrelė;PASAKIUKAI;7682402576;Taip;0;5;0;5
385;Aušrelė;PASAKIUKAI;1408751702;Taip;0;5;0;5
386;Aušrelė;PASAKIUKAI;6995749373;Taip;0;6;0;6
387;Aušrelė;PASAKIUKAI;8372554796;Taip;0;4;2;6
388;Aušrelė;PASAKIUKAI;1502146844;Ne;9;3;0;12
389;Aušrelė;PASAKIUKAI;8341539501;Taip;1;1;0;2
390;Aušrelė;PASAKIUKAI;8230362307;Taip;0;2;1;3
391;Aušrelė;PASAKIUKAI;9440600785;Taip;0;4;0;4
392;Aušrelė;PASAKIUKAI;91282753561;Taip;6;4;0;10
393;Aušrelė;PASAKIUKAI;4306578299;Taip;0;10;0;10
394;Aušrelė;PASAKIUKAI;5777214701;Taip;0;2;0;2
395;Aušrelė;PASAKIUKAI;6277405405;Taip;0;8;0;8
396;Aušrelė;PASAKIUKAI;6909708079;Ne;0;2;0;2
397;Aušrelė;BORUŽĖLĖS;6673034329;Taip;16;0;0;16
398;Aušrelė;BORUŽĖLĖS;4957581753;Ne;9;1;2;12
399;Aušrelė;BORUŽĖLĖS;3165692699;Ne;10;2;0;12
400;Aušrelė;BORUŽĖLĖS;1928260563;Taip;6;0;1;7
401;Aušrelė;BORUŽĖLĖS;2626569015;Taip;0;1;2;3
402;Aušrelė;BORUŽĖLĖS;2574681867;Taip;2;0;11;13
403;Aušrelė;BORUŽĖLĖS;1543314096;Taip;7;1;6;14
404;Aušrelė;BORUŽĖLĖS;6084682084;Taip;0;8;0;8
405;Aušrelė;BORUŽĖLĖS;8243716759;Taip;7;2;0;9
406;Aušrelė;BORUŽĖLĖS;6886505025;Taip;0;5;0;5
407;Aušrelė;BORUŽĖLĖS;3206495858;Taip;15;1;0;16
408;Aušrelė;BORUŽĖLĖS;7861208185;Taip;15;1;0;16
409;Aušrelė;BORUŽĖLĖS;1549962200;Taip;0;8;0;8
410;Aušrelė;BORUŽĖLĖS;4505922394;Taip;8;1;1;10
411;Aušrelė;BORUŽĖLĖS;4895872593;Taip;21;0;0;21
412;Aušrelė;BORUŽĖLĖS;1582618217;Taip;10;3;0;13
413;Aušrelė;BORUŽĖLĖS;7190665397;Taip;4;6;5;15
414;Aušrelė;BORUŽĖLĖS;2991828434;Taip;6;1;0;7
415;Aušrelė;SMALSUČIAI;76459345433;Ne;0;3;0;3
416;Aušrelė;SMALSUČIAI;17931731597;Taip;0;2;0;2
417;Aušrelė;SMALSUČIAI;8572216200;Taip;0;4;0;4
418;Aušrelė;SMALSUČIAI;74365190360;Taip;0;4;1;5
419;Aušrelė;SMALSUČIAI;1951435363;Taip;0;2;1;3
420;Aušrelė;SMALSUČIAI;3392276890;Taip;6;2;0;8
421;Aušrelė;SMALSUČIAI;14080739740;Taip;0;6;0;6
422;Aušrelė;SMALSUČIAI;73050137188;Taip;0;11;0;11
423;Aušrelė;SMALSUČIAI;49563719275;Taip;0;2;0;2
424;Aušrelė;SMALSUČIAI;7859894371;Taip;0;7;0;7
425;Aušrelė;SMALSUČIAI;1883795851;Taip;0;2;0;2
426;Aušrelė;SMALSUČIAI;68223308125;Ne;0;2;7;9
427;Aušrelė;SMALSUČIAI;90185478786;Taip;0;1;0;1
428;Aušrelė;SMALSUČIAI;26235102809;Taip;0;4;0;4
429;Aušrelė;SMALSUČIAI;42158121278;Taip;20;1;0;21
430;Aušrelė;SMALSUČIAI;78823564616;Taip;0;10;0;10
431;Aušrelė;SMALSUČIAI;1944021609;Taip;0;2;0;2
432;Aušrelė;SMALSUČIAI;1561253093;Taip;0;3;0;3
433;Aušrelė;SMALSUČIAI;1322089393;Taip;0;3;0;3
434;Aušrelė;SMALSUČIAI;94997479625;Taip;0;2;0;2
435;Aušrelė;KODĖLČIUKAI;12032618723;Taip;5;2;0;7
436;Aušrelė;KODĖLČIUKAI;18676216802;Taip;0;2;1;3
437;Aušrelė;KODĖLČIUKAI;75580617180;Taip;7;2;0;9
438;Aušrelė;KODĖLČIUKAI;24202090947;Ne;10;2;1;13
439;Aušrelė;KODĖLČIUKAI;50864528673;Ne;0;2;0;2
440;Aušrelė;KODĖLČIUKAI;2427329184;Taip;0;2;4;6
441;Aušrelė;KODĖLČIUKAI;24201363476;Taip;6;1;0;7
442;Aušrelė;KODĖLČIUKAI;39887348225;Taip;0;6;0;6
443;Aušrelė;KODĖLČIUKAI;1535153901;Taip;0;2;3;5
444;Aušrelė;KODĖLČIUKAI;63497657826;Taip;0;1;0;1
445;Aušrelė;KODĖLČIUKAI;8837069458;Taip;0;2;2;4
446;Aušrelė;KODĖLČIUKAI;36096756485;Taip;0;6;0;6
447;Aušrelė;KODĖLČIUKAI;1058114795;Taip;5;2;1;8
448;Aušrelė;KODĖLČIUKAI;19415824416;Taip;0;2;0;2
449;Aušrelė;KODĖLČIUKAI;4476948928;Taip;0;2;0;2
450;Aušrelė;KODĖLČIUKAI;44971525276;Taip;10;1;0;11
451;Aušrelė;KODĖLČIUKAI;26185247513;Taip;0;21;0;21
452;Aušrelė;KODĖLČIUKAI;9107952292;Taip;0;2;4;6
453;Aušrelė;KODĖLČIUKAI;58007820848;Taip;0;2;4;6
454;Aušrelė;PELĖDŽIUKAI;34891640909;Taip;0;3;0;3
455;Aušrelė;PELĖDŽIUKAI;5955421544;Ne;4;1;4;9
456;Aušrelė;PELĖDŽIUKAI;1706417053;Taip;0;1;4;5
457;Aušrelė;PELĖDŽIUKAI;31441512644;Taip;0;3;0;3
458;Aušrelė;PELĖDŽIUKAI;2030362509;Taip;12;4;0;16
459;Aušrelė;PELĖDŽIUKAI;1296552763;Taip;10;5;2;17
460;Aušrelė;PELĖDŽIUKAI;1160772086;Taip;0;11;0;11
461;Aušrelė;PELĖDŽIUKAI;1599595256;Taip;0;6;0;6
462;Aušrelė;PELĖDŽIUKAI;2125080379;Taip;2;5;0;7
463;Aušrelė;PELĖDŽIUKAI;1539176090;Taip;0;4;0;4
464;Aušrelė;PELĖDŽIUKAI;1225272131;Taip;0;7;1;8
465;Aušrelė;PELĖDŽIUKAI;1868818387;Taip;5;0;1;6
466;Aušrelė;PELĖDŽIUKAI;2987088389;Ne;7;1;1;9
467;Aušrelė;PELĖDŽIUKAI;1506444915;Taip;0;7;0;7
468;Aušrelė;PELĖDŽIUKAI;5304765447;Taip;0;10;0;10
469;Aušrelė;PELĖDŽIUKAI;85739624682;Taip;12;1;3;16
470;Aušrelė;PELĖDŽIUKAI;6837623034;Taip;0;1;12;13
471;Aušrelė;PELĖDŽIUKAI;3974308431;Ne;0;1;2;3
472;Aušrelė;PELĖDŽIUKAI;1549596452;Taip;0;1;0;1
473;Aušrelė;AITVARIUKAI;49583107808;Taip;10;1;0;11
474;Aušrelė;AITVARIUKAI;2045076279;Taip;0;2;0;2
475;Aušrelė;AITVARIUKAI;1153416324;Taip;0;20;1;21
476;Aušrelė;AITVARIUKAI;1340754039;Taip;0;13;2;15
477;Aušrelė;AITVARIUKAI;42721248496;Taip;0;2;0;2
478;Aušrelė;AITVARIUKAI;79695989966;Taip;0;11;0;11
479;Aušrelė;AITVARIUKAI;1045290039;Taip;0;5;0;5
480;Aušrelė;AITVARIUKAI;51119593813;Taip;10;2;0;12
481;Aušrelė;AITVARIUKAI;5813735533;Taip;0;1;1;2
482;Aušrelė;AITVARIUKAI;18117725053;Taip;10;1;0;11
483;Aušrelė;AITVARIUKAI;27629722512;Taip;0;4;0;4
484;Aušrelė;AITVARIUKAI;1830501248;Ne;5;2;3;10
485;Aušrelė;AITVARIUKAI;65369497777;Taip;0;20;1;21
486;Aušrelė;AITVARIUKAI;1388327674;Taip;0;1;0;1
487;Aušrelė;AITVARIUKAI;1750555187;Taip;7;0;0;7
488;Aušrelė;AITVARIUKAI;8221635058;Taip;6;1;0;7
489;Aušrelė;AITVARIUKAI;1163757003;Taip;10;2;0;12
490;Aušrelė;AITVARIUKAI;1792774415;Taip;8;4;0;12
491;Aušrelė;AITVARIUKAI;21234588466;Taip;0;1;0;1
492;Aušrelė;BITUTĖS;5670986879;Ne;5;2;0;7
493;Aušrelė;BITUTĖS;2096291405;Taip;0;3;0;3
494;Aušrelė;BITUTĖS;6519246290;Taip;3;4;0;7
495;Aušrelė;BITUTĖS;54807413055;Taip;16;2;0;18
496;Aušrelė;BITUTĖS;7915176432;Taip;0;2;0;2
497;Aušrelė;BITUTĖS;2085252423;Ne;0;5;0;5
498;Aušrelė;BITUTĖS;1680740501;Taip;0;2;0;2
499;Aušrelė;BITUTĖS;1666951645;Taip;0;2;0;2
500;Aušrelė;BITUTĖS;1372660806;Taip;0;2;0;2
501;Aušrelė;BITUTĖS;1958425979;Taip;0;5;0;5
502;Aušrelė;BITUTĖS;72441793163;Ne;0;4;0;4
503;Aušrelė;BITUTĖS;6604163285;Ne;0;7;0;7
504;Aušrelė;BITUTĖS;1177022224;Taip;0;8;0;8
505;Aušrelė;BITUTĖS;5176016947;Taip;0;2;0;2
506;Aušrelė;BITUTĖS;1306572766;Ne;0;1;4;5
507;Aušrelė;BITUTĖS;3326145998;Taip;11;0;0;11
508;Aušrelė;BITUTĖS;8086305564;Ne;12;0;0;12
509;Aušrelė;ŽIRNIUKAI;6761263775;Taip;10;2;1;13
510;Aušrelė;ŽIRNIUKAI;3015028879;Taip;12;1;0;13
511;Aušrelė;ŽIRNIUKAI;8503309819;Taip;20;0;0;20
512;Aušrelė;ŽIRNIUKAI;2827216981;Taip;0;1;0;1
513;Aušrelė;ŽIRNIUKAI;2852596989;Taip;0;21;0;21
514;Aušrelė;ŽIRNIUKAI;7930717076;Taip;11;3;0;14
515;Aušrelė;ŽIRNIUKAI;4942168388;Taip;5;9;7;21
516;Aušrelė;ŽIRNIUKAI;6507218940;Taip;0;1;0;1
517;Aušrelė;ŽIRNIUKAI;2266390402;Taip;0;8;0;8
518;Aušrelė;ŽIRNIUKAI;8032661062;Taip;0;1;1;2
519;Aušrelė;ŽIRNIUKAI;4262596104;Taip;0;3;0;3
520;Aušrelė;ŽIRNIUKAI;2390128933;Taip;0;1;0;1
521;Aušrelė;ŽIRNIUKAI;9443641849;Taip;12;2;0;14
522;Aušrelė;ŽIRNIUKAI;1556010005;Taip;10;1;0;11
523;Aušrelė;ŽIRNIUKAI;7609339123;Taip;0;2;0;2
524;Aušrelė;ŽIRNIUKAI;7070013052;Taip;10;5;1;16
525;Aušrelė;ŽIRNIUKAI;5478028396;Ne;6;9;0;15
526;Aušrelė;ŽIRNIUKAI;5935579452;Taip;7;3;0;10
527;Aušrelė;ŽIRNIUKAI;2863655361;Taip;10;2;1;13
528;Aušrelė;ŽIRNIUKAI;3581155949;Taip;0;3;0;3
529;Aušrelė;ŽIRNIUKAI;2766357229;Taip;0;2;1;3
530;Aušrelė;GRYBUKAI;6911735462;Taip;15;1;0;16
531;Aušrelė;GRYBUKAI;5712867880;Taip;5;1;0;6
532;Aušrelė;GRYBUKAI;6002434911;Taip;0;3;0;3
533;Aušrelė;GRYBUKAI;4288695809;Taip;3;1;0;4
534;Aušrelė;GRYBUKAI;3807967685;Taip;16;0;0;16
535;Aušrelė;GRYBUKAI;5312189552;Taip;0;2;0;2
536;Aušrelė;GRYBUKAI;7327544406;Ne;12;2;0;14
537;Aušrelė;GRYBUKAI;5046027475;Taip;7;11;0;18
538;Aušrelė;GRYBUKAI;9566144610;Taip;5;0;0;5
539;Aušrelė;GRYBUKAI;3320399046;Taip;15;0;0;15
540;Aušrelė;GRYBUKAI;7723159748;Taip;6;1;0;7
541;Aušrelė;GRYBUKAI;7367268748;Taip;21;0;0;21
542;Aušrelė;GRYBUKAI;2030555139;Taip;7;6;0;13
543;Aušrelė;GRYBUKAI;1976613166;Taip;7;2;0;9
544;Aušrelė;GRYBUKAI;8338569001;Taip;8;5;0;13
545;Aušrelė;GRYBUKAI;6186758486;Taip;1;2;0;3
546;Aušrelė;GRYBUKAI;4248808572;Taip;13;1;0;14
547;Aušrelė;GRYBUKAI;3623813061;Taip;5;7;0;12
548;Aušrelė;GRYBUKAI;8771154216;Taip;0;1;0;1
549;Aušrelė;GRYBUKAI;8693750994;Taip;16;0;0;16
550;Aušrelė;GRYBUKAI;6308519574;Taip;16;0;0;16
551;Aušrelė;DRUGELIAI;2468245186;Taip;5;3;0;8
552;Aušrelė;DRUGELIAI;8780847265;Taip;3;0;0;3
553;Aušrelė;DRUGELIAI;8210698019;Taip;0;21;0;21
554;Aušrelė;DRUGELIAI;2545065554;Taip;0;1;0;1
555;Aušrelė;DRUGELIAI;8411336992;Taip;4;1;2;7
556;Aušrelė;DRUGELIAI;2656152037;Taip;11;4;0;15
557;Aušrelė;DRUGELIAI;8917907028;Taip;15;1;0;16
558;Aušrelė;DRUGELIAI;4012186237;Taip;9;1;2;12
559;Aušrelė;DRUGELIAI;3738923947;Ne;17;0;0;17
560;Aušrelė;DRUGELIAI;1741716341;Taip;0;21;0;21
561;Aušrelė;DRUGELIAI;3223092149;Taip;10;1;0;11
562;Aušrelė;DRUGELIAI;8580241126;Taip;7;1;1;9
563;Aušrelė;DRUGELIAI;9244715396;Taip;18;0;0;18
564;Aušrelė;DRUGELIAI;4227228548;Taip;3;1;3;7
565;Aušrelė;DRUGELIAI;8996445434;Taip;3;1;2;6
566;Aušrelė;DRUGELIAI;6109859056;Ne;8;1;0;9
567;Aušrelė;NYKŠTUKAI;5311181664;Taip;0;1;0;1
568;Aušrelė;NYKŠTUKAI;3717822715;Taip;10;0;2;12
569;Aušrelė;NYKŠTUKAI;1458580523;Taip;16;0;0;16
570;Aušrelė;NYKŠTUKAI;9158248746;Taip;13;0;0;13
571;Aušrelė;NYKŠTUKAI;5708459561;Taip;17;0;0;17
572;Aušrelė;NYKŠTUKAI;5125295651;Taip;7;1;0;8
573;Aušrelė;NYKŠTUKAI;6601922746;Taip;10;4;0;14
574;Aušrelė;NYKŠTUKAI;8661284187;Taip;16;0;0;16
575;Aušrelė;NYKŠTUKAI;8029484123;Taip;5;0;0;5
576;Aušrelė;NYKŠTUKAI;5602774323;Taip;9;0;0;9
577;Aušrelė;NYKŠTUKAI;1039180129;Taip;5;11;0;16
578;Beržynėlis;SVIRPLIUKAI;29356394553;Taip;12;6;0;18
579;Beržynėlis;SVIRPLIUKAI;45685658789;Taip;0;1;0;1
580;Beržynėlis;SVIRPLIUKAI;7649359221;Taip;4;1;0;5
581;Beržynėlis;SVIRPLIUKAI;74856278886;Taip;0;1;0;1
582;Beržynėlis;SVIRPLIUKAI;1207208151;Taip;9;0;0;9
583;Beržynėlis;SVIRPLIUKAI;1895493234;Taip;1;7;0;8
584;Beržynėlis;SVIRPLIUKAI;1583090840;Taip;3;1;0;4
585;Beržynėlis;SVIRPLIUKAI;7289803632;Taip;6;4;0;10
586;Beržynėlis;SVIRPLIUKAI;1682929565;Taip;0;4;0;4
587;Beržynėlis;SVIRPLIUKAI;1612137286;Taip;5;1;0;6
588;Beržynėlis;SVIRPLIUKAI;5196910604;Taip;4;1;0;5
589;Beržynėlis;SVIRPLIUKAI;1395819329;Taip;2;0;0;2
590;Beržynėlis;SVIRPLIUKAI;7248602510;Taip;1;3;0;4
591;Beržynėlis;SVIRPLIUKAI;3641421009;Ne;0;1;0;1
592;Beržynėlis;SVIRPLIUKAI;9566341884;Taip;3;1;0;4
593;Beržynėlis;SVIRPLIUKAI;3278699117;Taip;2;0;0;2
594;Beržynėlis;SVIRPLIUKAI;1838631438;Taip;2;1;0;3
595;Beržynėlis;SVIRPLIUKAI;2681482042;Taip;1;0;0;1
596;Beržynėlis;SVIRPLIUKAI;1136091326;Taip;3;0;0;3
597;Beržynėlis;SVIRPLIUKAI;1516309509;Taip;6;3;0;9
598;Beržynėlis;SVIRPLIUKAI;6395436937;Ne;13;1;0;14
599;Beržynėlis;PELEDŽIUKAI;9035951859;Taip;0;1;0;1
600;Beržynėlis;PELEDŽIUKAI;46844790286;Taip;0;1;0;1
601;Beržynėlis;PELEDŽIUKAI;69893760439;Taip;0;5;0;5
602;Beržynėlis;PELEDŽIUKAI;6082843533;Taip;1;1;0;2
603;Beržynėlis;PELEDŽIUKAI;23484694902;Taip;0;0;1;1
604;Beržynėlis;PELEDŽIUKAI;50686761208;Ne;0;1;0;1
605;Beržynėlis;PELEDŽIUKAI;6002421623;Ne;0;3;0;3
606;Beržynėlis;PELEDŽIUKAI;59717323779;Ne;0;1;0;1
607;Beržynėlis;PELEDŽIUKAI;73555363332;Taip;0;3;3;6
608;Beržynėlis;PELEDŽIUKAI;69508373227;Taip;9;1;0;10
609;Beržynėlis;PELEDŽIUKAI;80418262829;Taip;0;3;2;5
610;Beržynėlis;PELEDŽIUKAI;48768116923;Taip;8;0;3;11
611;Beržynėlis;PELEDŽIUKAI;48258183822;Taip;0;2;0;2
612;Beržynėlis;PELEDŽIUKAI;19892724367;Taip;0;2;1;3
613;Beržynėlis;PELEDŽIUKAI;75283423384;Taip;0;1;0;1
614;Beržynėlis;ŽIOGELIAI;1893270997;Taip;0;2;2;4
615;Beržynėlis;ŽIOGELIAI;7929997884;Taip;0;1;0;1
616;Beržynėlis;ŽIOGELIAI;5114301953;Taip;0;17;0;17
617;Beržynėlis;ŽIOGELIAI;5308596559;Taip;10;0;0;10
618;Beržynėlis;ŽIOGELIAI;4035764376;Taip;0;2;1;3
619;Beržynėlis;ŽIOGELIAI;4970999989;Taip;5;2;1;8
620;Beržynėlis;ŽIOGELIAI;1325972861;Taip;17;0;0;17
621;Beržynėlis;ŽIOGELIAI;8297427176;Taip;4;1;0;5
622;Beržynėlis;ŽIOGELIAI;8688852668;Taip;5;1;0;6
623;Beržynėlis;ŽIOGELIAI;9540292311;Taip;7;0;1;8
624;Beržynėlis;ŽIOGELIAI;9088059487;Taip;9;0;2;11
625;Beržynėlis;ŽIOGELIAI;5473666098;Taip;0;2;1;3
626;Beržynėlis;ŽIOGELIAI;7589778533;Taip;5;2;0;7
627;Beržynėlis;ŽIOGELIAI;8591800387;Taip;0;2;2;4
628;Beržynėlis;ŽIOGELIAI;6739927917;Taip;0;0;1;1
629;Beržynėlis;ŽIOGELIAI;2971686368;Taip;0;5;0;5
630;Beržynėlis;ŽIOGELIAI;9409317403;Taip;3;3;1;7
631;Beržynėlis;ŽIOGELIAI;6334152631;Taip;10;2;2;14
632;Beržynėlis;ŽVIRBLIUKAI;7520394353;Taip;0;1;0;1
633;Beržynėlis;ŽVIRBLIUKAI;95544821432;Taip;7;2;0;9
634;Beržynėlis;ŽVIRBLIUKAI;1426962644;Taip;0;1;0;1
635;Beržynėlis;ŽVIRBLIUKAI;1527942602;Taip;0;1;0;1
636;Beržynėlis;ŽVIRBLIUKAI;1910024785;Taip;11;2;1;14
637;Beržynėlis;ŽVIRBLIUKAI;1367442186;Taip;7;0;2;9
638;Beržynėlis;ŽVIRBLIUKAI;1823144276;Ne;0;2;0;2
639;Beržynėlis;ŽVIRBLIUKAI;1464556813;Taip;0;2;0;2
640;Beržynėlis;ŽVIRBLIUKAI;1945230630;Taip;0;0;8;8
641;Beržynėlis;ŽVIRBLIUKAI;1466742506;Taip;0;0;1;1
642;Beržynėlis;ŽVIRBLIUKAI;2023412985;Taip;0;1;0;1
643;Beržynėlis;ŽVIRBLIUKAI;1578089280;Taip;0;1;0;1
644;Beržynėlis;ŽVIRBLIUKAI;96946855305;Taip;0;1;0;1
645;Beržynėlis;ŽVIRBLIUKAI;2067928004;Taip;6;0;0;6
646;Beržynėlis;ŽVIRBLIUKAI;87592204193;Ne;0;3;2;5
647;Beržynėlis;ŽVIRBLIUKAI;62962970458;Taip;5;2;5;12
648;Beržynėlis;ŽVIRBLIUKAI;17743947386;Taip;0;3;0;3
649;Beržynėlis;ŽVIRBLIUKAI;30539063473;Taip;2;1;0;3
650;Beržynėlis;ŽVIRBLIUKAI;1885972165;Taip;0;1;0;1
651;Beržynėlis;ŽVIRBLIUKAI;1391844432;Taip;0;2;10;12
652;Beržynėlis;ŽVIRBLIUKAI;1014895926;Taip;0;2;10;12
653;Beržynėlis;ŽIRNIUKAI;8701990625;Taip;0;5;0;5
654;Beržynėlis;ŽIRNIUKAI;8880151537;Taip;10;5;0;15
655;Beržynėlis;ŽIRNIUKAI;2221708263;Taip;21;0;0;21
656;Beržynėlis;ŽIRNIUKAI;9580286493;Taip;7;0;0;7
657;Beržynėlis;ŽIRNIUKAI;6330033887;Taip;6;0;0;6
658;Beržynėlis;ŽIRNIUKAI;9503352345;Taip;14;0;0;14
659;Beržynėlis;ŽIRNIUKAI;5189335842;Taip;5;0;0;5
660;Beržynėlis;ŽIRNIUKAI;4161974847;Ne;0;1;0;1
661;Beržynėlis;ŽIRNIUKAI;4270889499;Taip;0;1;0;1
662;Beržynėlis;ŽIRNIUKAI;3209966996;Taip;0;2;0;2
663;Beržynėlis;ŽIRNIUKAI;3345231579;Taip;12;4;0;16
664;Beržynėlis;ŽIRNIUKAI;2273629510;Taip;0;3;0;3
665;Beržynėlis;ŽIRNIUKAI;1799326151;Taip;0;3;0;3
666;Beržynėlis;VIŠČIUKAI;4466393687;Taip;0;0;2;2
667;Beržynėlis;VIŠČIUKAI;8280378527;Taip;9;3;0;12
668;Beržynėlis;VIŠČIUKAI;3334994408;Taip;6;0;0;6
669;Beržynėlis;VIŠČIUKAI;4774769217;Taip;0;0;1;1
670;Beržynėlis;VIŠČIUKAI;8881566865;Taip;11;0;0;11
671;Beržynėlis;VIŠČIUKAI;5194416351;Taip;8;2;0;10
672;Beržynėlis;VIŠČIUKAI;9754455116;Taip;11;1;0;12
673;Beržynėlis;VIŠČIUKAI;5069929376;Taip;11;3;0;14
674;Beržynėlis;VIŠČIUKAI;6272047137;Ne;10;0;0;10
675;Beržynėlis;VIŠČIUKAI;8233464088;Taip;6;0;0;6
676;Beržynėlis;VIŠČIUKAI;4013099670;Taip;5;1;0;6
677;Beržynėlis;VIŠČIUKAI;2892553878;Taip;3;2;0;5
678;Bildukas;"Svetliački savaitinė";80327840821;Taip;0;1;0;1
679;Bildukas;"Svetliački savaitinė";96874940646;Taip;0;1;6;7
680;Bildukas;"Svetliački savaitinė";6441340680;Taip;5;6;0;11
681;Bildukas;"Svetliački savaitinė";1029617146;Taip;0;5;0;5
682;Bildukas;"Svetliački savaitinė";1643122874;Taip;0;15;0;15
683;Bildukas;"Svetliački savaitinė";70033583066;Taip;0;6;0;6
684;Bildukas;"Svetliački savaitinė";75301544496;Taip;3;2;0;5
685;Bildukas;"Svetliački savaitinė";1023163775;Ne;13;3;0;16
686;Bildukas;"Svetliački savaitinė";5026245712;Taip;0;8;0;8
687;Bildukas;"Svetliački savaitinė";9084423113;Ne;6;1;0;7
688;Bildukas;"Svetliački savaitinė";13885215871;Taip;0;1;0;1
689;Bildukas;"Svetliački savaitinė";25050688839;Ne;0;11;0;11
690;Bildukas;"Svetliački savaitinė";9535522910;Ne;0;6;0;6
691;Bildukas;"Svetliački savaitinė";1183272346;Ne;5;1;1;7
692;Bildukas;"Svetliački savaitinė";3226370339;Taip;4;0;11;15
693;Bildukas;"Svetliački savaitinė";6548776238;Taip;0;0;21;21
694;Bildukas;"Svetliački savaitinė";6219872984;Taip;16;0;3;19
695;Bildukas;"Svetliački savaitinė";2091204077;Taip;0;2;0;2
696;Bildukas;"Svetliački savaitinė";4112888719;Taip;0;0;21;21
697;Bildukas;"Svetliački savaitinė";3531285331;Taip;0;1;3;4
698;Bildukas;"Svetliački savaitinė";1409708149;Taip;0;3;0;3
699;Bildukas;"Zaičiata savaitinė ( keli alergiški vaikai)";8927489885;Taip;17;0;1;18
700;Bildukas;"Zaičiata savaitinė ( keli alergiški vaikai)";8694887879;Taip;9;0;0;9
701;Bildukas;"Zaičiata savaitinė ( keli alergiški vaikai)";1916522637;Taip;10;0;2;12
702;Bildukas;"Zaičiata savaitinė ( keli alergiški vaikai)";4168864882;Ne;15;0;0;15
703;Bildukas;"Zaičiata savaitinė ( keli alergiški vaikai)";1720671485;Taip;9;0;0;9
704;Bildukas;"Zaičiata savaitinė ( keli alergiški vaikai)";6376189019;Taip;4;1;3;8
705;Bildukas;"Zaičiata savaitinė ( keli alergiški vaikai)";5747277587;Taip;15;0;0;15
706;Bildukas;"Zaičiata savaitinė ( keli alergiški vaikai)";3239566139;Taip;13;1;0;14
707;Bildukas;"Zaičiata savaitinė ( keli alergiški vaikai)";3323226123;Ne;14;1;0;15
708;Bildukas;"Zaičiata savaitinė ( keli alergiški vaikai)";5794471794;Taip;8;0;0;8
709;Bildukas;"Zaičiata savaitinė ( keli alergiški vaikai)";4894478262;Taip;0;7;1;8
710;Bildukas;"Zaičiata savaitinė ( keli alergiški vaikai)";2539486337;Taip;12;5;0;17
711;Bildukas;"Zaičiata savaitinė ( keli alergiški vaikai)";8496678513;Taip;6;0;0;6
712;Bildukas;"Zaičiata savaitinė ( keli alergiški vaikai)";2154916232;Taip;15;1;0;16
713;Bildukas;"Zaičiata savaitinė ( keli alergiški vaikai)";1566191212;Taip;6;2;0;8
714;Bildukas;"Zaičiata savaitinė ( keli alergiški vaikai)";9155896981;Taip;20;0;1;21
715;Bildukas;"Zaičiata savaitinė ( keli alergiški vaikai)";2989922538;Ne;11;1;0;12
716;Bildukas;"Zaičiata savaitinė ( keli alergiški vaikai)";8080989574;Taip;16;0;0;16
717;Bildukas;Gnomiki;8382899180;Taip;12;1;0;13
718;Bildukas;Gnomiki;4392299046;Taip;0;0;4;4
719;Bildukas;Gnomiki;1486878343;Taip;0;2;0;2
720;Bildukas;Gnomiki;1987773024;Taip;9;5;0;14
721;Bildukas;Gnomiki;5217751936;Taip;0;13;0;13
722;Bildukas;Gnomiki;8999239172;Taip;0;1;1;2
723;Bildukas;Gnomiki;9156801640;Ne;4;1;2;7
724;Bildukas;Gnomiki;1047459617;Taip;0;1;0;1
725;Bildukas;Gnomiki;9756326725;Taip;0;0;2;2
726;Bildukas;Gnomiki;8835111916;Taip;5;0;1;6
727;Bildukas;Gnomiki;5724787637;Taip;0;0;1;1
728;Bildukas;Gnomiki;9835391223;Taip;10;5;0;15
729;Bildukas;Gnomiki;2429527586;Taip;0;1;3;4
730;Bildukas;Gnomiki;4116831802;Ne;5;1;0;6
731;Bildukas;Zvonočki;4866401336;Taip;3;3;0;6
732;Bildukas;Zvonočki;1180357950;Taip;5;5;0;10
733;Bildukas;Zvonočki;99302309410;Taip;0;3;0;3
734;Bildukas;Zvonočki;91777282521;Ne;9;3;0;12
735;Bildukas;Zvonočki;1713133196;Ne;2;0;0;2
736;Bildukas;Zvonočki;1956741726;Taip;1;0;4;5
737;Bildukas;Zvonočki;4404602365;Taip;0;5;0;5
738;Bildukas;Zvonočki;4014493868;Taip;5;9;0;14
739;Bildukas;Zvonočki;6388514464;Taip;5;9;0;14
740;Bildukas;Zvonočki;4377803110;Taip;5;1;0;6
741;Bildukas;Zvonočki;7898746258;Taip;8;0;3;11
742;Bildukas;Zvonočki;1502213914;Taip;0;10;1;11
743;Bildukas;Zvonočki;9569296370;Taip;0;0;14;14
744;Bildukas;Zvonočki;1113168085;Taip;0;0;1;1
745;Bildukas;Zvonočki;1125206576;Taip;0;11;0;11
746;Bildukas;Zvonočki;5844470373;Taip;0;1;0;1
747;Bildukas;Zvonočki;4623727349;Taip;0;2;7;9
748;Birutės;SKRUZDELIUKŲ;4968068043;Taip;0;5;1;6
749;Birutės;SKRUZDELIUKŲ;1761065941;Taip;16;0;0;16
750;Birutės;SKRUZDELIUKŲ;9610268046;Taip;21;0;0;21
751;Birutės;SKRUZDELIUKŲ;4027700332;Taip;1;5;0;6
752;Birutės;SKRUZDELIUKŲ;7685356079;Ne;0;0;1;1
753;Birutės;SKRUZDELIUKŲ;4375683234;Taip;0;0;1;1
754;Birutės;SKRUZDELIUKŲ;1105133326;Taip;21;0;0;21
755;Birutės;SKRUZDELIUKŲ;8413760872;Taip;12;0;0;12
756;Birutės;SKRUZDELIUKŲ;8636113039;Taip;0;8;0;8
757;Birutės;SKRUZDELIUKŲ;3893693567;Taip;3;0;8;11
758;Birutės;SKRUZDELIUKŲ;7119951690;Taip;2;4;0;6
759;Birutės;SKRUZDELIUKŲ;1945532852;Taip;3;0;2;5
760;Birutės;SKRUZDELIUKŲ;9541516589;Taip;16;0;0;16
761;Birutės;SKRUZDELIUKŲ;5811810714;Ne;11;4;0;15
762;Birutės;SKRUZDELIUKŲ;6815916679;Taip;0;9;0;9
763;Birutės;SKRUZDELIUKŲ;7251592439;Taip;15;0;0;15
764;Birutės;SKRUZDELIUKŲ;7940403585;Taip;11;0;0;11
765;Birutės;BITUČIŲ;1599159924;Taip;7;1;1;9
766;Birutės;BITUČIŲ;33770983649;Taip;0;2;0;2
767;Birutės;BITUČIŲ;87693588654;Taip;3;1;0;4
768;Birutės;BITUČIŲ;1234596925;Taip;3;1;1;5
769;Birutės;BITUČIŲ;2975442228;Ne;12;0;2;14
770;Birutės;BITUČIŲ;5770026060;Taip;4;0;0;4
771;Birutės;BITUČIŲ;98391790116;Taip;16;0;1;17
772;Birutės;BITUČIŲ;5947971037;Taip;0;6;0;6
773;Birutės;BITUČIŲ;3870702348;Taip;0;0;2;2
774;Birutės;BITUČIŲ;7149060118;Ne;0;7;0;7
775;Birutės;BITUČIŲ;1064449916;Taip;0;9;0;9
776;Birutės;BITUČIŲ;3436637062;Taip;0;1;0;1
777;Birutės;BITUČIŲ;9769645272;Taip;13;0;0;13
778;Birutės;BITUČIŲ;8465645434;Taip;9;0;2;11
779;Birutės;BITUČIŲ;9722922540;Ne;5;0;2;7
780;Birutės;BITUČIŲ;4427232735;Ne;0;0;7;7
781;Birutės;BITUČIŲ;6006110601;Ne;0;0;1;1
782;Birutės;BITUČIŲ;5164196372;Taip;0;0;1;1
783;Birutės;BITUČIŲ;3061210677;Taip;0;0;8;8
784;Birutės;BITUČIŲ;6431396285;Taip;16;0;0;16
785;Birutės;BITUČIŲ;6081472534;Taip;0;0;1;1
786;Birutės;BITUČIŲ;1719394957;Taip;3;0;6;9
787;Birutės;BITUČIŲ;5099524382;Taip;8;5;0;13
788;Birutės;BORUŽIUKAI;83627433055;Taip;0;6;0;6
789;Birutės;BORUŽIUKAI;44098551169;Taip;0;0;3;3
790;Birutės;BORUŽIUKAI;1228407191;Taip;5;0;0;5
791;Birutės;BORUŽIUKAI;76900751891;Taip;4;1;0;5
792;Birutės;BORUŽIUKAI;78441249067;Taip;0;2;0;2
793;Birutės;BORUŽIUKAI;1735549924;Taip;6;0;3;9
794;Birutės;BORUŽIUKAI;1427891290;Taip;0;3;0;3
795;Birutės;BORUŽIUKAI;44844176536;Taip;0;0;1;1
796;Birutės;BORUŽIUKAI;22452517583;Taip;0;4;0;4
797;Birutės;BORUŽIUKAI;1596098119;Ne;0;1;1;2
798;Birutės;BORUŽIUKAI;60466633757;Taip;16;0;0;16
799;Birutės;BORUŽIUKAI;9936423295;Ne;3;0;6;9
800;Birutės;BORUŽIUKAI;4217246188;Taip;9;2;0;11
801;Birutės;BORUŽIUKAI;70370187632;Taip;0;8;0;8
802;Birutės;BORUŽIUKAI;1471448452;Taip;6;0;3;9
803;Birutės;BORUŽIUKAI;2167759374;Ne;5;0;0;5
804;Birutės;BORUŽIUKAI;1264545164;Taip;0;1;20;21
805;Birutės;DRUGELIAI;1884820602;Taip;0;2;0;2
806;Birutės;DRUGELIAI;1447494370;Taip;0;1;0;1
807;Birutės;DRUGELIAI;79438789443;Ne;0;1;1;2
808;Birutės;DRUGELIAI;77244600491;Taip;0;1;11;12
809;Birutės;DRUGELIAI;49162494334;Taip;0;0;1;1
810;Birutės;DRUGELIAI;22036269009;Taip;5;2;0;7
811;Birutės;DRUGELIAI;3213573357;Taip;0;1;0;1
812;Birutės;DRUGELIAI;23540610503;Ne;0;1;0;1
813;Birutės;DRUGELIAI;1163666527;Taip;0;0;8;8
814;Birutės;DRUGELIAI;32780299044;Taip;6;0;0;6
815;Birutės;DRUGELIAI;1346957081;Taip;3;0;0;3
816;Birutės;DRUGELIAI;88939598407;Taip;0;7;0;7
817;Birutės;DRUGELIAI;1950295916;Taip;5;0;4;9
818;Birutės;DRUGELIAI;9662009307;Ne;10;0;11;21
819;Birutės;DRUGELIAI;9860683556;Taip;1;0;0;1
820;Birutės;DRUGELIAI;53416654439;Taip;0;1;0;1
821;Birutės;DRUGELIAI;9886554192;Ne;6;0;0;6
822;Birutės;DRUGELIAI;6880300182;Taip;0;1;0;1
823;Birutės;DRUGELIAI;18503890312;Taip;0;3;0;3
824;Birutės;DRUGELIAI;5574120561;Taip;0;0;5;5
825;Birutės;DRUGELIAI;7215289265;Taip;0;0;2;2
826;Bitutė;Aitvariukų;90943054285;Taip;0;6;0;6
827;Bitutė;Aitvariukų;3254061362;Taip;3;1;0;4
828;Bitutė;Aitvariukų;6674923740;Taip;0;1;0;1
829;Bitutė;Aitvariukų;8394685672;Taip;0;2;0;2
830;Bitutė;Aitvariukų;3796188100;Taip;0;4;1;5
831;Bitutė;Aitvariukų;1846974702;Taip;0;4;0;4
832;Bitutė;Aitvariukų;1162903905;Taip;9;0;0;9
833;Bitutė;Aitvariukų;1560715159;Taip;12;5;0;17
834;Bitutė;Aitvariukų;2518730247;Taip;0;14;0;14
835;Bitutė;Aitvariukų;5895868876;Taip;4;7;2;13
836;Bitutė;Aitvariukų;8743734366;Taip;0;5;0;5
837;Bitutė;Aitvariukų;2804203556;Taip;9;10;0;19
838;Bitutė;Aitvariukų;5455919343;Taip;8;2;0;10
839;Bitutė;Aitvariukų;6737174004;Taip;6;5;2;13
840;Bitutė;Aitvariukų;3432065233;Taip;14;1;0;15
841;Bitutė;Aitvariukų;5679397165;Taip;0;12;0;12
842;Bitutė;Aitvariukų;7456328992;Taip;0;3;0;3
843;Bitutė;Aitvariukų;5810344229;Taip;0;1;0;1
844;Bitutė;Ežiukų;78233050805;Taip;0;9;0;9
845;Bitutė;Ežiukų;43167655810;Ne;0;7;1;8
846;Bitutė;Ežiukų;38137764071;Taip;0;6;0;6
847;Bitutė;Ežiukų;40949937934;Taip;0;3;0;3
848;Bitutė;Ežiukų;67601917966;Taip;0;12;0;12
849;Bitutė;Ežiukų;89380579477;Taip;3;1;0;4
850;Bitutė;Ežiukų;1824939092;Taip;0;1;1;2
851;Bitutė;Ežiukų;1262030751;Taip;0;5;3;8
852;Bitutė;Ežiukų;57841590670;Taip;5;9;0;14
853;Bitutė;Ežiukų;56287634684;Taip;9;4;0;13
854;Bitutė;Ežiukų;4315172747;Taip;0;5;0;5
855;Bitutė;Ežiukų;5126303823;Taip;0;5;0;5
856;Bitutė;Ežiukų;9838379838;Taip;6;16;0;22
857;Bitutė;Ežiukų;42098027592;Ne;7;10;1;18
858;Bitutė;Ežiukų;17953339860;Taip;0;10;0;10
859;Bitutė;Ežiukų;4764586168;Taip;0;5;3;8
860;Bitutė;Ežiukų;8905075899;Taip;10;10;0;20
861;Bitutė;Ežiukų;1709788155;Taip;0;4;1;5
862;Bitutė;Žvirbliukų;3804171750;Taip;0;2;0;2
863;Bitutė;Žvirbliukų;8545377054;Taip;0;1;0;1
864;Bitutė;Žvirbliukų;3723040682;Taip;0;7;0;7
865;Bitutė;Žvirbliukų;7113693496;Taip;13;0;0;13
866;Bitutė;Žvirbliukų;4177331531;Taip;5;2;0;7
867;Bitutė;Žvirbliukų;2483462846;Taip;0;5;0;5
868;Bitutė;Žvirbliukų;8186706520;Taip;0;24;0;24
869;Bitutė;Žvirbliukų;7678106084;Taip;0;2;0;2
870;Bitutė;Žvirbliukų;6044969600;Taip;5;1;0;6
871;Bitutė;Žvirbliukų;2444289145;Taip;0;2;0;2
872;Bitutė;Žvirbliukų;3517750478;Taip;0;3;0;3
873;Bitutė;Žvirbliukų;5291764696;Taip;5;1;6;12
874;Bitutė;Žvirbliukų;1942685472;Taip;0;0;1;1
875;Bitutė;Žvirbliukų;4303490614;Taip;10;4;0;14
876;Bitutė;Žvirbliukų;9523588597;Taip;8;1;3;12
877;Bitutė;Žvirbliukų;3654065124;Taip;11;2;0;13
878;Bitutė;Žvirbliukų;9166624750;Taip;24;0;0;24
879;Bitutė;Gandriukų;20823074269;Taip;0;1;0;1
880;Bitutė;Gandriukų;20308800957;Taip;0;2;0;2
881;Bitutė;Gandriukų;83034164893;Taip;0;10;0;10
882;Bitutė;Gandriukų;28698703670;Taip;0;1;0;1
883;Bitutė;Gandriukų;51014007755;Taip;0;9;0;9
884;Bitutė;Gandriukų;85845989245;Taip;0;1;0;1
885;Bitutė;Gandriukų;55763538285;Taip;0;2;0;2
886;Bitutė;Gandriukų;55722176820;Taip;9;1;0;10
887;Bitutė;Gandriukų;41836931870;Taip;0;2;0;2
888;Bitutė;Gandriukų;1926912966;Taip;2;5;2;9
889;Bitutė;Gandriukų;2004589442;Taip;0;5;0;5
890;Bitutė;Gandriukų;1514919519;Taip;0;1;0;1
891;Bitutė;Gandriukų;1756799209;Ne;0;7;0;7
892;Bitutė;Gandriukų;7858925572;Taip;15;1;0;16
893;Bitutė;Gandriukų;41659768159;Taip;0;4;0;4
894;Bitutė;Pelėdžiukai;2045667491;Taip;0;4;0;4
895;Bitutė;Pelėdžiukai;76504719475;Taip;9;6;0;15
896;Bitutė;Pelėdžiukai;29837823635;Taip;0;2;2;4
897;Bitutė;Pelėdžiukai;96246198900;Taip;0;4;0;4
898;Bitutė;Pelėdžiukai;40578882341;Taip;0;4;0;4
899;Bitutė;Pelėdžiukai;73214901448;Taip;0;10;0;10
900;Bitutė;Pelėdžiukai;239058855;Ne;11;6;0;17
901;Bitutė;Pelėdžiukai;94263857872;Taip;0;8;0;8
902;Bitutė;Pelėdžiukai;4311138099;Ne;0;10;0;10
903;Bitutė;Pelėdžiukai;27177678441;Taip;0;1;0;1
904;Bitutė;Pelėdžiukai;87682328632;Taip;3;4;0;7
905;Bitutė;Pelėdžiukai;13826670333;Taip;0;1;0;1
906;Bitutė;Pelėdžiukai;2004079473;Taip;0;4;0;4
907;Bitutė;Pelėdžiukai;5513662035;Taip;0;6;0;6
908;Bitutė;Pelėdžiukai;1799005979;Taip;0;4;3;7
909;Bitutė;Pelėdžiukai;1342209916;Taip;3;4;0;7
910;Bitutė;Pelėdžiukai;1235354320;Taip;0;4;1;5
911;Bitutė;Pelėdžiukai;1086803168;Taip;5;4;0;9
912;Bitutė;Pelėdžiukai;54838528906;Taip;3;6;0;9
913;Bitutė;Boružėlių;6586888742;Taip;4;4;0;8
914;Bitutė;Boružėlių;5783154071;Taip;0;11;0;11
915;Bitutė;Boružėlių;6052204491;Taip;0;0;1;1
916;Bitutė;Boružėlių;37105491775;Ne;5;1;1;7
917;Bitutė;Boružėlių;50869152455;Taip;0;1;0;1
918;Bitutė;Boružėlių;1783776913;Taip;2;0;1;3
919;Bitutė;Boružėlių;7352524951;Taip;8;4;0;12
920;Bitutė;Boružėlių;27144303911;Taip;0;4;0;4
921;Bitutė;Boružėlių;1802887869;Ne;15;0;3;18
922;Bitutė;Boružėlių;51054491845;Taip;19;0;0;19
923;Bitutė;Boružėlių;5653055907;Taip;5;7;0;12
924;Bitutė;Boružėlių;1809034174;Taip;5;1;0;6
925;Bitutė;Boružėlių;5644789669;Taip;0;1;1;2
926;Bitutė;Boružėlių;2350260809;Taip;17;0;0;17
927;Bitutė;Boružėlių;1307749129;Taip;5;0;1;6
928;Bitutė;Boružėlių;3980455738;Taip;9;2;1;12
929;Bitutė;Boružėlių;6678928989;Taip;9;5;1;15
930;Bitutė;Boružėlių;8519978626;Taip;2;0;4;6
931;Bitutė;Šokliukų;8754340459;Taip;0;9;0;9
932;Bitutė;Šokliukų;91649072251;Taip;11;0;0;11
933;Bitutė;Šokliukų;22504941477;Taip;7;0;0;7
934;Bitutė;Šokliukų;4054959628;Taip;0;6;0;6
935;Bitutė;Šokliukų;74038944722;Taip;0;5;0;5
936;Bitutė;Šokliukų;9314363274;Taip;0;24;0;24
937;Bitutė;Šokliukų;1703630417;Taip;3;3;0;6
938;Bitutė;Šokliukų;14787330368;Taip;0;2;0;2
939;Bitutė;Šokliukų;6591291681;Taip;8;7;0;15
940;Bitutė;Šokliukų;86636444738;Taip;0;5;0;5
941;Bitutė;Šokliukų;1956718350;Ne;0;8;1;9
942;Bitutė;Šokliukų;11128936533;Taip;0;0;1;1
943;Bitutė;Šokliukų;2775304620;Taip;6;2;0;8
944;Bitutė;Šokliukų;2104500642;Taip;21;3;0;24
945;Bitutė;Šokliukų;84694903978;Taip;0;5;0;5
946;Bitutė;Šokliukų;98029500731;Taip;0;14;0;14
947;Bitutė;Drugelių;57770829048;Taip;0;1;0;1
948;Bitutė;Drugelių;2531472741;Taip;0;10;0;10
949;Bitutė;Drugelių;74525712637;Taip;5;3;0;8
950;Bitutė;Drugelių;56620848568;Taip;0;8;0;8
951;Bitutė;Drugelių;2049938111;Taip;0;2;0;2
952;Bitutė;Drugelių;58668298206;Taip;9;2;0;11
953;Bitutė;Drugelių;1863634233;Taip;6;0;0;6
954;Bitutė;Drugelių;9550491607;Taip;0;5;0;5
955;Bitutė;Drugelių;3982159333;Taip;0;5;2;7
956;Bitutė;Drugelių;29300327608;Taip;0;5;1;6
957;Bitutė;Drugelių;50605497381;Taip;0;18;0;18
958;Bitutė;Drugelių;1030677273;Taip;0;7;0;7
959;Bitutė;Drugelių;92700808654;Ne;0;1;0;1
960;Bitutė;Drugelių;3319657847;Taip;0;6;0;6
961;Bitutė;Drugelių;1861373542;Taip;0;1;0;1
962;Bitutė;Drugelių;48695762145;Taip;0;2;0;2
963;Bitutė;Drugelių;72872147664;Taip;0;10;0;10
964;Bitutė;Drugelių;7236048627;Taip;0;1;0;1
965;Bitutė;Kiškučių;9451529077;Taip;0;3;0;3
966;Bitutė;Kiškučių;2812580726;Taip;0;0;1;1
967;Bitutė;Kiškučių;1662815358;Taip;0;0;2;2
968;Bitutė;Kiškučių;1733189730;Taip;9;10;0;19
969;Bitutė;Kiškučių;3227252972;Taip;0;1;0;1
970;Bitutė;Kiškučių;9966437881;Taip;0;7;1;8
971;Bitutė;Kiškučių;8373296210;Taip;1;5;0;6
972;Bitutė;Kiškučių;1985958540;Taip;0;1;2;3
973;Bitutė;Kiškučių;8743960488;Taip;1;5;0;6
974;Bitutė;Kiškučių;9337144831;Taip;18;0;5;23
975;Bitutė;Kiškučių;4639968278;Taip;0;24;0;24
976;Bitutė;Kiškučių;1024337077;Taip;10;8;1;19
977;Bitutė;Kiškučių;4566919587;Taip;6;7;0;13
978;Bitutė;Kiškučių;6569166515;Taip;1;0;3;4
979;Bitutė;Kiškučių;2806899030;Taip;1;5;0;6
980;Bitutė;Kiškučių;5443722813;Taip;4;0;0;4
981;Bitutė;Kiškučių;1241863345;Taip;0;0;2;2
982;Bitutė;Kiškučių;8789574593;Taip;15;5;0;20
983;Bitutė;Kiškučių;8799003374;Taip;0;3;5;8
984;Bitutė;"Viščiukų ";1348548294;Taip;4;11;0;15
985;Bitutė;"Viščiukų ";8872286273;Taip;0;7;1;8
986;Bitutė;"Viščiukų ";5169768042;Taip;10;0;0;10
987;Bitutė;"Viščiukų ";7165511381;Taip;0;6;1;7
988;Bitutė;"Viščiukų ";4527880105;Taip;7;3;0;10
989;Bitutė;"Viščiukų ";1012702386;Taip;5;4;2;11
990;Bitutė;"Viščiukų ";9465186207;Taip;11;0;0;11
991;Bitutė;"Viščiukų ";9924340801;Taip;16;0;0;16
992;Bitutė;"Viščiukų ";4917599786;Taip;19;0;4;23
993;Bitutė;"Viščiukų ";7979566741;Taip;3;14;0;17
994;Bitutė;"Viščiukų ";9855080887;Taip;3;1;0;4
995;Bitutė;"Viščiukų ";8211710975;Taip;11;1;0;12
996;Bitutė;"Viščiukų ";7318555933;Taip;5;0;1;6
997;Bitutė;"Viščiukų ";4513783927;Ne;0;21;1;22
998;Bitutė;"Skruzdėliukai ";37364063140;Ne;2;4;0;6
999;Bitutė;"Skruzdėliukai ";5910842956;Taip;11;1;0;12
1000;Bitutė;"Skruzdėliukai ";1913421864;Taip;5;1;0;6
1001;Bitutė;"Skruzdėliukai ";38436660859;Taip;3;6;0;9
1002;Bitutė;"Skruzdėliukai ";2126118124;Taip;5;9;2;16
1003;Bitutė;"Skruzdėliukai ";87960363246;Taip;0;0;1;1
1004;Bitutė;"Skruzdėliukai ";1064809221;Taip;22;0;0;22
1005;Bitutė;"Skruzdėliukai ";1521753712;Taip;10;10;4;24
1006;Bitutė;"Skruzdėliukai ";1307910515;Taip;0;16;0;16
1007;Bitutė;"Skruzdėliukai ";5886190377;Taip;0;1;1;2
1008;Bitutė;"Skruzdėliukai ";61233878620;Taip;8;5;0;13
1009;Bitutė;"Skruzdėliukai ";1130379531;Taip;0;8;0;8
1010;Bitutė;"Skruzdėliukai ";2031043488;Taip;0;1;0;1
1011;Bitutė;"Skruzdėliukai ";55469634385;Taip;0;1;1;2
1012;Bitutė;"Skruzdėliukai ";95252521365;Taip;5;3;0;8
1013;Bitutė;"Skruzdėliukai ";26206836171;Ne;0;7;4;11
1014;Bitutė;"Skruzdėliukai ";6969112590;Ne;1;1;0;2
1015;Bitutė;"Nykštukų ";5188828679;Taip;14;0;0;14
1016;Bitutė;"Nykštukų ";8109028957;Taip;14;0;0;14
1017;Bitutė;"Nykštukų ";1904108612;Taip;0;4;1;5
1018;Bitutė;"Nykštukų ";6169426273;Taip;0;3;0;3
1019;Bitutė;"Nykštukų ";2252157473;Taip;5;6;0;11
1020;Bitutė;"Nykštukų ";8439759353;Taip;0;3;1;4
1021;Bitutė;"Nykštukų ";2853616585;Taip;6;1;0;7
1022;Bitutė;"Nykštukų ";5686278261;Taip;3;0;0;3
1023;Bitutė;"Nykštukų ";7145036085;Taip;10;3;0;13
1024;Bitutė;"Nykštukų ";9602659259;Taip;0;1;4;5
1025;Bitutė;"Nykštukų ";6311396261;Taip;10;2;0;12
1026;Bitutė;"Nykštukų ";5378885117;Taip;0;1;0;1
1027;Coliukė;DRUGELIAI;6011110970;Ne;9;0;0;9
1028;Coliukė;DRUGELIAI;5450167562;Taip;7;0;1;8
1029;Coliukė;DRUGELIAI;7248705010;Taip;5;0;0;5
1030;Coliukė;DRUGELIAI;8835394030;Taip;7;6;0;13
1031;Coliukė;DRUGELIAI;3427704550;Taip;0;3;0;3
1032;Coliukė;DRUGELIAI;9885547263;Taip;8;0;0;8
1033;Coliukė;DRUGELIAI;5139645108;Taip;13;5;0;18
1034;Coliukė;DRUGELIAI;8209209881;Taip;8;0;0;8
1035;Coliukė;DRUGELIAI;3499575148;Taip;8;0;0;8
1036;Coliukė;DRUGELIAI;9462610674;Taip;0;17;0;17
1037;Coliukė;DRUGELIAI;2167230398;Taip;8;0;0;8
1038;Coliukė;DRUGELIAI;3323738649;Taip;0;2;0;2
1039;Coliukė;DRUGELIAI;9331485675;Taip;16;0;0;16
1040;Coliukė;DRUGELIAI;2275327607;Taip;14;0;0;14
1041;Coliukė;DRUGELIAI;4188233426;Taip;1;0;3;4
1042;Coliukė;DRUGELIAI;4845247006;Taip;5;1;0;6
1043;Coliukė;DRUGELIAI;5349969025;Taip;3;0;0;3
1044;Coliukė;DRUGELIAI;3318808813;Taip;13;0;0;13
1045;Coliukė;BITUTĖS;93361426448;Taip;10;3;1;14
1046;Coliukė;BITUTĖS;82989338835;Taip;0;3;0;3
1047;Coliukė;BITUTĖS;37161702858;Taip;0;6;0;6
1048;Coliukė;BITUTĖS;1199350941;Taip;6;9;0;15
1049;Coliukė;BITUTĖS;1960898805;Taip;0;5;0;5
1050;Coliukė;BITUTĖS;58421006265;Taip;0;9;0;9
1051;Coliukė;BITUTĖS;8457120425;Taip;0;5;0;5
1052;Coliukė;BITUTĖS;9311775782;Taip;18;1;0;19
1053;Coliukė;BITUTĖS;81003830638;Taip;7;0;0;7
1054;Coliukė;BITUTĖS;36554487034;Taip;0;1;0;1
1055;Coliukė;BITUTĖS;1423711475;Taip;11;1;0;12
1056;Coliukė;BITUTĖS;7920728387;Taip;8;4;0;12
1057;Coliukė;BITUTĖS;1240946719;Taip;0;4;0;4
1058;Coliukė;BITUTĖS;4408284518;Taip;0;9;0;9
1059;Coliukė;BITUTĖS;3346269598;Taip;10;2;0;12
1060;Coliukė;BITUTĖS;6860757091;Taip;0;1;0;1
1061;Coliukė;BITUTĖS;1458763954;Taip;0;10;0;10
1062;Coliukė;BITUTĖS;1968467455;Taip;9;0;0;9
1063;Coliukė;BITUTĖS;3919482569;Taip;3;1;0;4
1064;Coliukė;BITUTĖS;1328505569;Ne;0;6;0;6
1065;Coliukė;BITUTĖS;4645245689;Taip;3;0;0;3
1066;Coliukė;VABALIUKAI;62876576078;Taip;0;4;0;4
1067;Coliukė;VABALIUKAI;26698840369;Taip;5;3;0;8
1068;Coliukė;VABALIUKAI;78760440826;Taip;0;8;0;8
1069;Coliukė;VABALIUKAI;1556841186;Taip;8;0;0;8
1070;Coliukė;VABALIUKAI;22951260339;Taip;6;6;0;12
1071;Coliukė;VABALIUKAI;33158793202;Taip;12;0;0;12
1072;Coliukė;VABALIUKAI;33587152454;Taip;10;3;0;13
1073;Coliukė;VABALIUKAI;82064520362;Taip;8;2;0;10
1074;Coliukė;VABALIUKAI;57504928606;Taip;18;1;0;19
1075;Coliukė;VABALIUKAI;4649987214;Taip;8;2;0;10
1076;Coliukė;VABALIUKAI;63258983714;Taip;0;8;0;8
1077;Coliukė;VABALIUKAI;99200764707;Taip;9;0;0;9
1078;Coliukė;VABALIUKAI;1476750428;Ne;17;1;0;18
1079;Coliukė;VABALIUKAI;6775470024;Taip;0;0;1;1
1080;Coliukė;VABALIUKAI;8323242104;Taip;0;13;0;13
1081;Coliukė;VABALIUKAI;6333099356;Taip;9;0;1;10
1082;Coliukė;VABALIUKAI;9526108197;Ne;21;0;0;21
1083;Coliukė;VABALIUKAI;3539878011;Taip;2;1;0;3
1084;Coliukė;VABALIUKAI;4739310916;Taip;0;5;0;5
1085;Coliukė;VABALIUKAI;5541328815;Taip;21;0;0;21
1086;Coliukė;VABALIUKAI;1318558913;Taip;9;0;0;9
1087;Coliukė;VABALIUKAI;4010374947;Taip;10;0;0;10
1088;Coliukė;VABALIUKAI;7622526793;Taip;15;0;0;15
1089;Coliukė;NYKŠTUKAI;1659532709;Taip;0;4;0;4
1090;Coliukė;NYKŠTUKAI;1812071213;Taip;0;8;0;8
1091;Coliukė;NYKŠTUKAI;3738703854;Taip;3;8;0;11
1092;Coliukė;NYKŠTUKAI;83027842354;Taip;2;8;0;10
1093;Coliukė;NYKŠTUKAI;2168987649;Taip;8;0;1;9
1094;Coliukė;NYKŠTUKAI;2684151591;Taip;0;11;0;11
1095;Coliukė;NYKŠTUKAI;4499924331;Taip;9;0;0;9
1096;Coliukė;NYKŠTUKAI;4806478786;Taip;1;0;1;2
1097;Coliukė;NYKŠTUKAI;7566429633;Taip;0;10;0;10
1098;Coliukė;NYKŠTUKAI;9542366183;Taip;1;7;0;8
1099;Coliukė;NYKŠTUKAI;7670166244;Taip;19;0;0;19
1100;Coliukė;NYKŠTUKAI;1166820133;Ne;5;0;0;5
1101;Coliukė;NYKŠTUKAI;4845049639;Taip;9;1;0;10
1102;Coliukė;NYKŠTUKAI;1537341012;Taip;15;6;0;21
1103;Coliukė;NYKŠTUKAI;6403149921;Ne;12;0;1;13
1104;Coliukė;NYKŠTUKAI;1105879142;Taip;20;0;0;20
1105;Coliukė;NYKŠTUKAI;1600495468;Taip;0;6;0;6
1106;Coliukė;NYKŠTUKAI;6781303455;Taip;5;0;2;7
1107;Coliukė;GĖLYTĖS;4498253271;Taip;7;0;0;7
1108;Coliukė;GĖLYTĖS;8149118599;Taip;8;2;0;10
1109;Coliukė;GĖLYTĖS;1390751418;Taip;2;0;0;2
1110;Coliukė;GĖLYTĖS;7345905007;Taip;10;0;0;10
1111;Coliukė;GĖLYTĖS;9752408693;Taip;6;0;2;8
1112;Coliukė;GĖLYTĖS;7216221020;Taip;4;0;0;4
1113;Coliukė;GĖLYTĖS;7358018315;Taip;7;0;3;10
1114;Coliukė;"BORUŽĖLĖS (SPEC.)";1988394967;Taip;19;2;0;21
1115;Coliukė;"BORUŽĖLĖS (SPEC.)";3746858489;Taip;8;1;0;9
1116;Coliukė;"BORUŽĖLĖS (SPEC.)";2080118127;Taip;2;3;0;5
1117;Coliukė;"BORUŽĖLĖS (SPEC.)";8070499557;Taip;0;8;0;8
1118;Coliukė;"BORUŽĖLĖS (SPEC.)";9368334915;Taip;16;1;0;17
1119;Coliukė;"BORUŽĖLĖS (SPEC.)";1644303265;Taip;0;0;1;1
1120;Coliukė;"BORUŽĖLĖS (SPEC.)";2555073719;Ne;16;0;0;16
1121;Coliukė;"BORUŽĖLĖS (SPEC.)";6170362846;Taip;4;0;0;4
1122;Coliukė;"BORUŽĖLĖS (SPEC.)";5706671963;Taip;3;0;0;3
1123;Čiauškutis;BITUTĖS;3499391608;Taip;3;0;0;3
1124;Čiauškutis;BITUTĖS;1443155220;Taip;10;6;0;16
1125;Čiauškutis;BITUTĖS;1804509009;Taip;0;1;0;1
1126;Čiauškutis;BITUTĖS;22717947028;Taip;0;10;0;10
1127;Čiauškutis;BITUTĖS;3917667527;Taip;3;0;2;5
1128;Čiauškutis;BITUTĖS;5900996969;Taip;0;1;0;1
1129;Čiauškutis;BITUTĖS;54635137954;Taip;0;0;1;1
1130;Čiauškutis;BITUTĖS;7060197354;Taip;0;0;5;5
1131;Čiauškutis;BITUTĖS;30480486366;Taip;6;0;0;6
1132;Čiauškutis;BITUTĖS;1732370199;Ne;15;0;0;15
1133;Čiauškutis;BITUTĖS;3370047940;Taip;11;0;0;11
1134;Čiauškutis;BITUTĖS;9208388159;Ne;0;0;2;2
1135;Čiauškutis;ŽVIRBLIUKAI;2044220236;Taip;7;0;6;13
1136;Čiauškutis;ŽVIRBLIUKAI;4037117222;Taip;10;0;2;12
1137;Čiauškutis;ŽVIRBLIUKAI;4239145386;Taip;0;5;2;7
1138;Čiauškutis;ŽVIRBLIUKAI;3490305325;Taip;11;0;0;11
1139;Čiauškutis;ŽVIRBLIUKAI;2633243682;Taip;0;2;1;3
1140;Čiauškutis;ŽVIRBLIUKAI;7009893338;Taip;9;0;3;12
1141;Čiauškutis;ŽVIRBLIUKAI;6705934636;Taip;5;2;0;7
1142;Čiauškutis;ŽVIRBLIUKAI;2511568496;Taip;15;6;0;21
1143;Čiauškutis;ŽVIRBLIUKAI;5957587644;Taip;17;0;4;21
1144;Čiauškutis;ŽVIRBLIUKAI;1733251156;Ne;10;0;0;10
1145;Čiauškutis;SAULUTĖS;6279678482;Taip;0;1;0;1
1146;Čiauškutis;SAULUTĖS;93468721158;Taip;0;6;0;6
1147;Čiauškutis;SAULUTĖS;2012201854;Taip;0;6;0;6
1148;Čiauškutis;SAULUTĖS;27158851138;Taip;0;2;0;2
1149;Čiauškutis;SAULUTĖS;78373250443;Taip;3;1;0;4
1150;Čiauškutis;SAULUTĖS;1417978731;Taip;0;2;0;2
1151;Čiauškutis;SAULUTĖS;1503190001;Taip;0;1;0;1
1152;Čiauškutis;SAULUTĖS;4817007142;Taip;0;6;0;6
1153;Čiauškutis;SAULUTĖS;1719875491;Taip;4;0;0;4
1154;Čiauškutis;SAULUTĖS;1486206292;Taip;0;1;0;1
1155;Čiauškutis;EŽIUKAI;7746580858;Taip;17;0;0;17
1156;Čiauškutis;EŽIUKAI;2411714732;Taip;0;0;3;3
1157;Čiauškutis;EŽIUKAI;1928404791;Taip;15;0;2;17
1158;Čiauškutis;EŽIUKAI;6056618348;Taip;0;0;8;8
1159;Čiauškutis;EŽIUKAI;7489733038;Taip;15;0;0;15
1160;Čiauškutis;EŽIUKAI;9959952114;Taip;8;0;0;8
1161;Čiauškutis;EŽIUKAI;1158816422;Ne;5;0;6;11
1162;Čiauškutis;EŽIUKAI;5910818962;Ne;11;0;0;11
1163;Čiauškutis;DRUGELIAI;8500010303;Taip;18;0;0;18
1164;Čiauškutis;DRUGELIAI;7080320173;Taip;0;4;0;4
1165;Čiauškutis;DRUGELIAI;7312776041;Ne;16;0;0;16
1166;Čiauškutis;DRUGELIAI;1301573542;Ne;0;0;9;9
1167;Čiauškutis;DRUGELIAI;9072764004;Ne;2;0;0;2
1168;Čiauškutis;DRUGELIAI;1036358147;Ne;3;1;0;4
1169;Čiauškutis;DRUGELIAI;1750040659;Taip;17;1;0;18
1170;Čiauškutis;DRUGELIAI;8346845876;Taip;0;0;1;1
1171;Čiauškutis;DRUGELIAI;1426744251;Taip;10;0;0;10
1172;Čiauškutis;GENELIAI;3888278518;Ne;0;1;1;2
1173;Čiauškutis;GENELIAI;47866559654;Taip;0;6;0;6
1174;Čiauškutis;GENELIAI;1404146538;Taip;0;1;0;1
1175;Čiauškutis;GENELIAI;8974089037;Taip;0;1;0;1
1176;Čiauškutis;GENELIAI;45303538716;Taip;0;1;0;1
1177;Čiauškutis;GENELIAI;7011763860;Taip;0;0;10;10
1178;Čiauškutis;GENELIAI;2273215873;Ne;0;1;1;2
1179;Čiauškutis;GENELIAI;7332285452;Taip;17;0;0;17
1180;Čiauškutis;GENELIAI;1233059816;Taip;0;1;0;1
1181;Čiauškutis;LINKSMUČIAI;4600623461;Taip;0;2;0;2
1182;Čiauškutis;LINKSMUČIAI;1332686904;Taip;0;1;0;1
1183;Čiauškutis;LINKSMUČIAI;1380571576;Taip;9;4;0;13
1184;Čiauškutis;LINKSMUČIAI;1109018212;Taip;8;1;0;9
1185;Čiauškutis;LINKSMUČIAI;26779062894;Ne;0;1;0;1
1186;Čiauškutis;LINKSMUČIAI;8884708945;Taip;9;0;0;9
1187;Čiauškutis;LINKSMUČIAI;67405154291;Taip;1;2;3;6
1188;Čiauškutis;LINKSMUČIAI;1778900145;Taip;2;1;8;11
1189;Čiauškutis;KIŠKUČIAI;72264057427;Taip;0;3;0;3
1190;Čiauškutis;KIŠKUČIAI;8808041204;Taip;3;0;0;3
1191;Čiauškutis;KIŠKUČIAI;2099735647;Taip;0;1;3;4
1192;Čiauškutis;KIŠKUČIAI;8992775168;Taip;0;7;5;12
1193;Čiauškutis;KIŠKUČIAI;1480363762;Taip;2;2;0;4
1194;Čiauškutis;KIŠKUČIAI;1849532875;Ne;11;0;0;11
1195;Čiauškutis;KIŠKUČIAI;2218793969;Ne;3;0;0;3
1196;Čiauškutis;KIŠKUČIAI;6115354862;Taip;0;0;2;2
1197;Čiauškutis;KIŠKUČIAI;5759367884;Taip;5;2;0;7
1198;Čiauškutis;KIŠKUČIAI;1456067541;Ne;5;1;2;8
1199;Čiauškutis;KIŠKUČIAI;7367933940;Ne;2;0;0;2
1200;Čiauškutis;LAPIUKAI;60265156684;Taip;8;0;1;9
1201;Čiauškutis;LAPIUKAI;31203540590;Taip;9;0;2;11
1202;Čiauškutis;LAPIUKAI;8857039064;Taip;0;1;0;1
1203;Čiauškutis;LAPIUKAI;1657452686;Ne;3;0;1;4
1204;Čiauškutis;LAPIUKAI;43313173294;Taip;4;1;2;7
1205;Čiauškutis;LAPIUKAI;5513758257;Taip;0;0;1;1
1206;Čiauškutis;LAPIUKAI;1739403100;Taip;2;0;0;2
1207;Čiauškutis;MEŠKUČIAI;1923832961;Taip;3;0;0;3
1208;Čiauškutis;MEŠKUČIAI;8375416027;Taip;10;0;0;10
1209;Čiauškutis;PELĖDŽIUKAI;7961309940;Taip;15;0;0;15
1210;Čiauškutis;PELĖDŽIUKAI;8728572783;Ne;6;1;0;7
1211;Čiauškutis;PELĖDŽIUKAI;1253449294;Taip;0;0;2;2
1212;Čiauškutis;PELĖDŽIUKAI;82575455120;Taip;15;0;0;15
1213;Čiauškutis;PELĖDŽIUKAI;6165710260;Taip;6;0;0;6
1214;Čiauškutis;PELĖDŽIUKAI;1546096184;Taip;0;0;1;1
1215;Čiauškutis;PELĖDŽIUKAI;4135020826;Taip;0;0;9;9
1216;Čiauškutis;PELĖDŽIUKAI;70690874267;Taip;4;0;2;6
1217;Čiauškutis;PELĖDŽIUKAI;5897061482;Taip;0;0;4;4
1218;Čiauškutis;NYKŠTUKAI;6258150407;Taip;0;6;0;6
1219;Čiauškutis;NYKŠTUKAI;4846025153;Taip;2;0;0;2
1220;Čiauškutis;NYKŠTUKAI;4898534899;Ne;7;1;0;8
1221;Čiauškutis;NYKŠTUKAI;8896526358;Taip;1;2;0;3
1222;Čiauškutis;NYKŠTUKAI;8030685444;Ne;0;4;0;4
1223;Čiauškutis;NYKŠTUKAI;1809511815;Taip;0;4;0;4
1224;Čiauškutis;NYKŠTUKAI;1422589887;Taip;0;1;0;1
1225;Čiauškutis;NYKŠTUKAI;8709039752;Taip;13;0;0;13
1226;Delfinukas;Boružėlių;6935992202;Taip;0;2;0;2
1227;Delfinukas;Boružėlių;7904803011;Taip;0;1;4;5
1228;Delfinukas;Boružėlių;8186312409;Taip;11;0;0;11
1229;Delfinukas;Boružėlių;8148610460;Taip;0;5;0;5
1230;Delfinukas;Boružėlių;1484123788;Taip;0;1;0;1
1231;Delfinukas;Boružėlių;1873630966;Taip;0;1;0;1
1232;Delfinukas;Boružėlių;6531930806;Taip;0;0;1;1
1233;Delfinukas;Boružėlių;8076961367;Ne;0;1;2;3
1234;Delfinukas;Boružėlių;8439204095;Taip;0;1;0;1
1235;Delfinukas;Boružėlių;4989239822;Taip;0;0;1;1
1236;Delfinukas;Boružėlių;7638190553;Taip;0;1;6;7
1237;Delfinukas;Boružėlių;2010703982;Ne;0;1;0;1
1238;Delfinukas;Boružėlių;8728791932;Taip;0;0;1;1
1239;Delfinukas;Boružėlių;6700068320;Taip;0;5;0;5
1240;Delfinukas;Boružėlių;7277680544;Ne;12;0;0;12
1241;Delfinukas;Boružėlių;9099945815;Ne;11;0;0;11
1242;Delfinukas;Boružėlių;1212995285;Taip;0;1;0;1
1243;Delfinukas;Saulytės;65798709244;Ne;21;0;0;21
1244;Delfinukas;Saulytės;76643778833;Ne;10;3;0;13
1245;Delfinukas;Saulytės;35058841521;Taip;7;1;0;8
1246;Delfinukas;Saulytės;1260108624;Taip;0;1;0;1
1247;Delfinukas;Saulytės;79934072325;Taip;0;2;0;2
1248;Delfinukas;Saulytės;2096874518;Taip;0;2;0;2
1249;Delfinukas;Saulytės;2009324145;Taip;0;3;0;3
1250;Delfinukas;Saulytės;27140729689;Taip;9;2;0;11
1251;Delfinukas;Saulytės;46847640903;Taip;19;0;0;19
1252;Delfinukas;Saulytės;4142864015;Ne;3;2;0;5
1253;Delfinukas;Saulytės;86601289023;Taip;4;3;0;7
1254;Delfinukas;Saulytės;16785309188;Taip;2;3;0;5
1255;Delfinukas;Saulytės;34563800372;Taip;8;2;0;10
1256;Delfinukas;Saulytės;2074439295;Taip;0;5;0;5
1257;Delfinukas;Saulytės;1939499375;Taip;5;2;0;7
1258;Delfinukas;Saulytės;1813240176;Taip;5;0;0;5
1259;Delfinukas;Saulytės;1293348150;Taip;0;2;0;2
1260;Delfinukas;Saulytės;1364873935;Taip;3;1;0;4
1261;Delfinukas;Saulytės;5912904296;Taip;7;1;0;8
1262;Delfinukas;Saulytės;1988406276;Taip;0;7;1;8
1263;Delfinukas;Pelėdžiukų;3940838205;Taip;13;1;0;14
1264;Delfinukas;Pelėdžiukų;8774145277;Taip;10;2;0;12
1265;Delfinukas;Pelėdžiukų;1395257200;Taip;5;0;0;5
1266;Delfinukas;Pelėdžiukų;7249857412;Taip;20;0;0;20
1267;Delfinukas;Pelėdžiukų;2658828200;Taip;0;2;0;2
1268;Delfinukas;Pelėdžiukų;3770227955;Taip;10;0;0;10
1269;Delfinukas;Pelėdžiukų;6113662246;Taip;8;4;0;12
1270;Delfinukas;Pelėdžiukų;4710894128;Taip;5;0;0;5
1271;Delfinukas;Pelėdžiukų;1526129772;Taip;1;0;0;1
1272;Delfinukas;Pelėdžiukų;8659309242;Taip;2;0;0;2
1273;Delfinukas;Pelėdžiukų;1227257543;Taip;16;0;0;16
1274;Delfinukas;Pelėdžiukų;8882370994;Ne;12;2;0;14
1275;Delfinukas;Pelėdžiukų;8267992425;Taip;0;2;0;2
1276;Delfinukas;Pelėdžiukų;9319874239;Taip;6;0;0;6
1277;Delfinukas;Pelėdžiukų;2809947323;Taip;12;0;0;12
1278;Delfinukas;Pelėdžiukų;3465186420;Taip;13;0;0;13
1279;Delfinukas;Varliukų;1153333591;Ne;0;3;0;3
1280;Delfinukas;Varliukų;1091165849;Taip;5;0;0;5
1281;Delfinukas;Varliukų;1421633312;Taip;0;0;3;3
1282;Delfinukas;Varliukų;9573336239;Ne;0;2;0;2
1283;Delfinukas;Varliukų;1251961268;Taip;2;3;0;5
1284;Delfinukas;Varliukų;1789047913;Taip;0;15;4;19
1285;Delfinukas;Varliukų;1194444282;Taip;6;1;0;7
1286;Delfinukas;Varliukų;8875479631;Taip;0;13;0;13
1287;Delfinukas;Varliukų;3344476309;Taip;0;2;1;3
1288;Delfinukas;Varliukų;3955783379;Taip;10;8;0;18
1289;Delfinukas;Varliukų;9502789660;Taip;5;0;0;5
1290;Delfinukas;Varliukų;3489297719;Taip;0;1;1;2
1291;Delfinukas;Varliukų;1948438336;Ne;0;4;0;4
1292;Delfinukas;Varliukų;9266646602;Taip;16;0;1;17
1293;Delfinukas;Varliukų;3674481373;Taip;0;3;0;3
1294;Delfinukas;Varliukų;9516852657;Taip;0;19;0;19
1295;Delfinukas;Varliukų;1338476746;Taip;5;5;0;10
1296;Delfinukas;Varliukų;2819283284;Taip;0;0;6;6
1297;Delfinukas;Varpelių;62769117892;Ne;4;8;0;12
1298;Delfinukas;Varpelių;8855690221;Taip;16;0;0;16
1299;Delfinukas;Varpelių;3093606855;Taip;6;1;0;7
1300;Delfinukas;Varpelių;6393090675;Taip;9;1;0;10
1301;Delfinukas;Varpelių;1268754720;Taip;0;3;0;3
1302;Delfinukas;Varpelių;3718612458;Taip;20;1;0;21
1303;Delfinukas;Varpelių;43859975789;Taip;0;1;0;1
1304;Delfinukas;Varpelių;2531571615;Taip;0;1;0;1
1305;Delfinukas;Varpelių;91028452879;Taip;0;2;0;2
1306;Delfinukas;Varpelių;1325054642;Ne;0;5;0;5
1307;Delfinukas;Varpelių;7163839896;Ne;0;1;0;1
1308;Delfinukas;Varpelių;7493037613;Ne;0;1;0;1
1309;Delfinukas;Varpelių;4239224971;Taip;7;0;2;9
1310;Delfinukas;Varpelių;1650166115;Ne;0;3;0;3
1311;Delfinukas;Varpelių;5123666058;Ne;8;1;0;9
1312;Delfinukas;Varpelių;4713803167;Taip;0;0;21;21
1313;Delfinukas;Varpelių;8936645508;Taip;6;0;0;6
1314;Delfinukas;Varpelių;26626004000;Taip;6;0;0;6
1315;Delfinukas;Varpelių;6047881184;Taip;2;0;0;2
1316;Delfinukas;Delfinukai;5093418481;Taip;3;0;1;4
1317;Delfinukas;Delfinukai;6190642132;Taip;0;5;0;5
1318;Delfinukas;Delfinukai;17266052771;Taip;0;1;0;1
1319;Delfinukas;Delfinukai;57676205527;Taip;0;2;0;2
1320;Delfinukas;Delfinukai;71523999168;Taip;0;2;0;2
1321;Delfinukas;Delfinukai;46276990963;Taip;4;2;0;6
1322;Delfinukas;Delfinukai;7528505426;Taip;10;2;0;12
1323;Delfinukas;Delfinukai;545765924;Taip;10;0;1;11
1324;Delfinukas;Delfinukai;2402524470;Taip;6;0;0;6
1325;Delfinukas;Delfinukai;9168812609;Taip;0;0;4;4
1326;Delfinukas;Delfinukai;2135364149;Taip;0;0;3;3
1327;Delfinukas;Delfinukai;34706967888;Taip;0;0;21;21
1328;Delfinukas;Delfinukai;1848598718;Ne;2;0;7;9
1329;Delfinukas;Delfinukai;4435982727;Taip;0;2;8;10
1330;Delfinukas;Delfinukai;9821969586;Taip;5;4;0;9
1331;Delfinukas;Delfinukai;4569691896;Taip;0;1;3;4
1332;Delfinukas;Drugeliai;2402204674;Taip;13;0;0;13
1333;Delfinukas;Drugeliai;4179507316;Taip;0;2;0;2
1334;Delfinukas;Drugeliai;2701448160;Ne;16;2;0;18
1335;Delfinukas;Drugeliai;8440546956;Taip;6;0;0;6
1336;Delfinukas;Drugeliai;6201567680;Taip;6;0;5;11
1337;Delfinukas;Drugeliai;1672021829;Ne;4;0;0;4
1338;Delfinukas;Drugeliai;2429427703;Ne;10;0;0;10
1339;Delfinukas;Drugeliai;9921730735;Taip;0;0;20;20
1340;Delfinukas;Drugeliai;7826428639;Ne;10;0;0;10
1341;Delfinukas;Drugeliai;1000049779;Taip;14;0;0;14
1342;Delfinukas;Drugeliai;3071312399;Ne;9;0;6;15
1343;Delfinukas;Drugeliai;7886801955;Taip;0;0;21;21
1344;Delfinukas;Drugeliai;8227660508;Taip;3;0;0;3
1345;Delfinukas;Drugeliai;2883959240;Taip;0;1;2;3
1346;Delfinukas;Drugeliai;1160537966;Taip;11;1;0;12
1347;Delfinukas;Drugeliai;1430155044;Taip;6;0;1;7
1348;Delfinukas;Žuvytės;6578506861;Taip;10;0;0;10
1349;Delfinukas;Žuvytės;6572690788;Taip;8;2;0;10
1350;Delfinukas;Žuvytės;3397350274;Taip;0;1;0;1
1351;Delfinukas;Žuvytės;9520598359;Taip;3;2;0;5
1352;Delfinukas;Žuvytės;3804996594;Taip;0;1;4;5
1353;Delfinukas;Žuvytės;7873373923;Taip;0;0;2;2
1354;Delfinukas;Žuvytės;2066127119;Ne;0;6;0;6
1355;Delfinukas;Žuvytės;7487111570;Taip;0;3;0;3
1356;Delfinukas;Žuvytės;6844500395;Taip;3;2;0;5
1357;Delfinukas;Žuvytės;9074294473;Taip;0;0;12;12
1358;Delfinukas;Žuvytės;2445742257;Taip;0;0;21;21
1359;Delfinukas;Žuvytės;8938997208;Taip;11;0;1;12
1360;Delfinukas;Žuvytės;9934325492;Taip;0;0;8;8
1361;Delfinukas;Žuvytės;8160982025;Taip;9;0;0;9
1362;Delfinukas;Žuvytės;6949000708;Taip;0;0;1;1
1363;Delfinukas;Žuvytės;6322255194;Taip;9;1;0;10
1364;Delfinukas;Žuvytės;9898412288;Taip;0;2;5;7
1365;Delfinukas;Žuvytės;8702718951;Taip;6;0;0;6
1366;Delfinukas;Žuvytės;6445868759;Taip;0;1;0;1
1367;Delfinukas;Delfinai;9628317328;Taip;10;1;0;11
1368;Delfinukas;Delfinai;8038737019;Taip;7;0;1;8
1369;Delfinukas;Delfinai;5797308373;Taip;11;0;0;11
1370;Delfinukas;Delfinai;6337962165;Taip;4;1;0;5
1371;Delfinukas;Delfinai;5241426445;Taip;14;1;0;15
1372;Delfinukas;Delfinai;8099120371;Taip;6;1;0;7
1373;Delfinukas;Delfinai;3108430680;Taip;14;0;2;16
1374;Delfinukas;Delfinai;7663934825;Taip;11;1;0;12
1375;Delfinukas;Delfinai;2382077576;Taip;10;0;0;10
1376;Delfinukas;Delfinai;1200205376;Taip;10;1;0;11
1377;Delfinukas;Delfinai;7629622746;Ne;9;2;0;11
1378;Delfinukas;Delfinai;4347116918;Taip;13;0;0;13
1379;Delfinukas;Delfinai;2784942324;Ne;6;1;0;7
1380;Delfinukas;Delfinai;1922513830;Taip;11;2;0;13
1381;Delfinukas;Paukšteliai;7609115506;Taip;0;0;21;21
1382;Delfinukas;Paukšteliai;6873181103;Taip;0;0;21;21
1383;Delfinukas;Paukšteliai;2756574162;Taip;0;0;21;21
1384;Delfinukas;Paukšteliai;6992505341;Ne;0;0;21;21
1385;Delfinukas;Paukšteliai;9927854348;Taip;6;0;5;11
1386;Delfinukas;Paukšteliai;8028279246;Taip;0;0;21;21
1387;Delfinukas;Paukšteliai;6884260821;Taip;0;0;21;21
1388;Delfinukas;Paukšteliai;2985669766;Taip;0;0;6;6
1389;Delfinukas;Paukšteliai;8328481987;Taip;0;0;21;21
1390;Delfinukas;Kiškučiai;7766292005;Taip;0;1;0;1
1391;Delfinukas;Kiškučiai;98742243823;Taip;8;2;0;10
1392;Delfinukas;Kiškučiai;1498120150;Taip;10;1;0;11
1393;Delfinukas;Kiškučiai;7920401664;Taip;0;1;0;1
1394;Delfinukas;Kiškučiai;1767369189;Ne;8;2;0;10
1395;Delfinukas;Kiškučiai;1495145663;Ne;0;0;3;3
1396;Delfinukas;Kiškučiai;1301231548;Taip;0;2;2;4
1397;Delfinukas;Kiškučiai;1613911039;Taip;0;2;0;2
1398;Delfinukas;Kiškučiai;1477374660;Taip;1;1;3;5
1399;Delfinukas;Kiškučiai;2993704795;Taip;0;2;0;2
1400;Delfinukas;Kiškučiai;1487082744;Ne;0;1;0;1
1401;Delfinukas;Kiškučiai;99919425286;Taip;6;0;0;6
1402;Delfinukas;Kiškučiai;1011101007;Ne;6;1;0;7
1403;Delfinukas;Kiškučiai;2063259303;Taip;10;3;0;13
1404;Delfinukas;Kiškučiai;1166370228;Taip;0;2;0;2
1405;Delfinukas;Kiškučiai;60320557464;Ne;9;2;0;11
1406;Delfinukas;Kiškučiai;1594700604;Taip;0;8;0;8
1407;Delfinukas;Kiškučiai;7509276953;Ne;5;1;0;6
1408;Delfinukas;Kiškučiai;49489087212;Taip;0;1;0;1
1409;Delfinukas;Kiškučiai;83920976768;Taip;0;6;0;6
1410;Drevinukas;ZUIKUČIAI;1720464417;Taip;0;1;2;3
1411;Drevinukas;ZUIKUČIAI;6095020718;Ne;0;0;4;4
1412;Drevinukas;ZUIKUČIAI;3981507849;Taip;5;0;1;6
1413;Drevinukas;ZUIKUČIAI;5679723776;Taip;0;3;0;3
1414;Drevinukas;ZUIKUČIAI;2857797268;Taip;0;0;3;3
1415;Drevinukas;ZUIKUČIAI;7753238387;Taip;15;0;0;15
1416;Drevinukas;ZUIKUČIAI;3875062228;Taip;0;0;1;1
1417;Drevinukas;ZUIKUČIAI;8479979176;Taip;6;0;1;7
1418;Drevinukas;ZUIKUČIAI;2531207946;Taip;3;0;1;4
1419;Drevinukas;ZUIKUČIAI;3972897839;Taip;0;4;1;5
1420;Drevinukas;ZUIKUČIAI;1152161183;Taip;20;0;0;20
1421;Drevinukas;ZUIKUČIAI;6256572875;Taip;4;1;0;5
1422;Drevinukas;ZUIKUČIAI;8936058501;Taip;0;0;3;3
1423;Drevinukas;ZUIKUČIAI;7520907833;Taip;0;4;0;4
1424;Drevinukas;ZUIKUČIAI;1099462840;Taip;8;0;1;9
1425;Drevinukas;ZUIKUČIAI;8611131264;Taip;5;8;0;13
1426;Drevinukas;ZUIKUČIAI;6833120798;Taip;0;0;5;5
1427;Drevinukas;ZUIKUČIAI;7607135647;Taip;3;0;4;7
1428;Drevinukas;AŽUOLIUKŲ;1970787957;Taip;0;7;0;7
1429;Drevinukas;AŽUOLIUKŲ;39014589824;Taip;0;1;0;1
1430;Drevinukas;AŽUOLIUKŲ;3625661236;Taip;8;2;0;10
1431;Drevinukas;AŽUOLIUKŲ;46323011887;Taip;0;1;0;1
1432;Drevinukas;AŽUOLIUKŲ;17722412785;Taip;0;1;1;2
1433;Drevinukas;AŽUOLIUKŲ;1437074990;Taip;0;1;0;1
1434;Drevinukas;AŽUOLIUKŲ;8325320616;Taip;0;1;1;2
1435;Drevinukas;AŽUOLIUKŲ;1577311253;Taip;0;1;0;1
1436;Drevinukas;AŽUOLIUKŲ;6539595624;Taip;15;0;0;15
1437;Drevinukas;AŽUOLIUKŲ;7570410899;Ne;0;1;6;7
1438;Drevinukas;AŽUOLIUKŲ;1929303009;Ne;0;1;5;6
1439;Drevinukas;AŽUOLIUKŲ;64093448834;Ne;7;0;1;8
1440;Drevinukas;AŽUOLIUKŲ;59090501289;Taip;8;0;0;8
1441;Drevinukas;AŽUOLIUKŲ;1585468549;Taip;0;8;0;8
1442;Drevinukas;AŽUOLIUKŲ;1276720097;Taip;0;2;0;2
1443;Drevinukas;AŽUOLIUKŲ;3604979285;Taip;0;7;0;7
1444;Drevinukas;AŽUOLIUKŲ;78348414683;Taip;1;5;1;7
1445;Drevinukas;AŽUOLIUKŲ;30667895560;Taip;0;5;1;6
1446;Drevinukas;AŽUOLIUKŲ;83194462453;Taip;0;1;0;1
1447;Drevinukas;AŽUOLIUKŲ;5521378389;Taip;0;3;0;3
1448;Drevinukas;PELĖDŽIUKAI;13638194271;Taip;0;1;0;1
1449;Drevinukas;PELĖDŽIUKAI;64560340218;Taip;0;2;0;2
1450;Drevinukas;PELĖDŽIUKAI;17456144256;Taip;12;1;0;13
1451;Drevinukas;PELĖDŽIUKAI;3066586415;Taip;0;1;5;6
1452;Drevinukas;PELĖDŽIUKAI;1250033881;Taip;6;0;0;6
1453;Drevinukas;PELĖDŽIUKAI;22050717457;Taip;0;5;2;7
1454;Drevinukas;PELĖDŽIUKAI;74690633233;Taip;0;2;0;2
1455;Drevinukas;PELĖDŽIUKAI;73923305630;Ne;0;1;4;5
1456;Drevinukas;PELĖDŽIUKAI;29000633056;Taip;0;1;0;1
1457;Drevinukas;PELĖDŽIUKAI;1254845545;Taip;0;6;0;6
1458;Drevinukas;PELĖDŽIUKAI;46006802320;Taip;5;1;0;6
1459;Drevinukas;PELĖDŽIUKAI;49704496121;Taip;0;1;0;1
1460;Drevinukas;PELĖDŽIUKAI;9657606451;Taip;20;1;0;21
1461;Drevinukas;PELĖDŽIUKAI;4150306697;Taip;5;1;2;8
1462;Drevinukas;PELĖDŽIUKAI;71447591085;Taip;1;4;0;5
1463;Drevinukas;PELĖDŽIUKAI;2483043689;Taip;0;1;1;2
1464;Drevinukas;PELĖDŽIUKAI;4980076288;Taip;0;3;0;3
1465;Drevinukas;BORUŽĖLĖS;1123115847;Taip;17;0;0;17
1466;Drevinukas;BORUŽĖLĖS;1987939679;Taip;0;0;1;1
1467;Drevinukas;BORUŽĖLĖS;9336227821;Taip;0;1;0;1
1468;Drevinukas;BORUŽĖLĖS;4784716615;Taip;3;0;0;3
1469;Drevinukas;BORUŽĖLĖS;2070374746;Taip;0;0;3;3
1470;Drevinukas;BORUŽĖLĖS;8661862777;Taip;0;7;1;8
1471;Drevinukas;BORUŽĖLĖS;9803670483;Taip;3;0;0;3
1472;Drevinukas;BORUŽĖLĖS;2074070030;Taip;0;1;3;4
1473;Drevinukas;BORUŽĖLĖS;3657451903;Taip;7;1;4;12
1474;Drevinukas;BORUŽĖLĖS;8180027849;Taip;0;1;12;13
1475;Drevinukas;BORUŽĖLĖS;4332606643;Ne;0;0;4;4
1476;Drevinukas;BORUŽĖLĖS;6304169257;Taip;3;0;0;3
1477;Drevinukas;BORUŽĖLĖS;5686116320;Ne;0;7;0;7
1478;Drevinukas;BORUŽĖLĖS;56028675283;Taip;0;4;0;4
1479;Drevinukas;BORUŽĖLĖS;85288014888;Taip;3;1;1;5
1480;Drevinukas;BORUŽĖLĖS;1019214451;Taip;0;10;2;12
1481;Drevinukas;BITUTĖS;24300552411;Taip;18;0;0;18
1482;Drevinukas;BITUTĖS;96688324084;Taip;0;2;0;2
1483;Drevinukas;BITUTĖS;70347618653;Taip;6;1;0;7
1484;Drevinukas;BITUTĖS;30808032808;Taip;0;1;0;1
1485;Drevinukas;BITUTĖS;7088781332;Taip;0;10;0;10
1486;Drevinukas;BITUTĖS;67343152327;Taip;0;4;0;4
1487;Drevinukas;BITUTĖS;91352351942;Taip;4;1;1;6
1488;Drevinukas;BITUTĖS;43573400232;Taip;0;2;0;2
1489;Drevinukas;BITUTĖS;43087053446;Taip;5;0;0;5
1490;Drevinukas;BITUTĖS;62294117396;Taip;0;0;2;2
1491;Drevinukas;BITUTĖS;7670120949;Ne;0;1;0;1
1492;Drevinukas;BITUTĖS;1180916359;Taip;8;1;1;10
1493;Drevinukas;BITUTĖS;8943620706;Taip;17;0;0;17
1494;Drevinukas;BITUTĖS;4352184625;Taip;0;1;0;1
1495;Drevinukas;BITUTĖS;1025218361;Taip;2;1;1;4
1496;Drevinukas;BITUTĖS;1711831210;Taip;2;1;1;4
1497;Drevinukas;NYKŠTUKAI;7334626684;Taip;0;0;8;8
1498;Drevinukas;NYKŠTUKAI;2423143170;Taip;1;0;4;5
1499;Drevinukas;NYKŠTUKAI;8313674636;Taip;0;0;7;7
1500;Drevinukas;NYKŠTUKAI;5236292764;Taip;0;0;1;1
1501;Drevinukas;NYKŠTUKAI;1098647410;Taip;0;0;3;3
1502;Drevinukas;NYKŠTUKAI;2935175014;Taip;14;0;0;14
1503;Drevinukas;NYKŠTUKAI;5348609358;Taip;1;5;1;7
1504;Drevinukas;NYKŠTUKAI;2312241894;Taip;7;4;0;11
1505;Drevinukas;NYKŠTUKAI;5394143000;Taip;0;8;0;8
1506;Drevinukas;NYKŠTUKAI;4260123123;Taip;0;0;7;7
1507;Drevinukas;NYKŠTUKAI;5754055310;Taip;0;0;4;4
1508;Drevinukas;NYKŠTUKAI;3871506691;Taip;5;2;1;8
1509;Drevinukas;NYKŠTUKAI;6914111231;Taip;5;2;1;8
1510;Drevinukas;NYKŠTUKAI;3046196006;Taip;4;3;0;7
1511;Drevinukas;NYKŠTUKAI;3377957769;Taip;0;0;3;3
1512;Drevinukas;NYKŠTUKAI;3779983775;Taip;9;0;0;9
1513;Drevinukas;NYKŠTUKAI;1343431478;Taip;3;0;0;3
1514;Drevinukas;NYKŠTUKAI;1829421385;Taip;11;0;2;13
1515;Drevinukas;NYKŠTUKAI;8262224710;Taip;9;1;0;10
1516;Drevinukas;SMALSUČIAI;1644656704;Taip;5;1;1;7
1517;Drevinukas;SMALSUČIAI;5673244101;Taip;14;1;0;15
1518;Drevinukas;SMALSUČIAI;1564065835;Taip;0;8;0;8
1519;Drevinukas;SMALSUČIAI;7689145214;Ne;5;6;0;11
1520;Drevinukas;SMALSUČIAI;8143614891;Ne;13;0;0;13
1521;Drevinukas;SMALSUČIAI;4262951360;Taip;13;0;1;14
1522;Drevinukas;SMALSUČIAI;9174977150;Taip;0;1;0;1
1523;Drevinukas;SMALSUČIAI;5928234487;Taip;0;0;1;1
1524;Drevinukas;SMALSUČIAI;3617533357;Taip;4;1;0;5
1525;Drevinukas;SMALSUČIAI;5323434566;Taip;3;0;0;3
1526;Drevinukas;SMALSUČIAI;8744467866;Taip;8;0;0;8
1527;Drevinukas;SMALSUČIAI;3725760478;Taip;5;1;0;6
1528;Drevinukas;SMALSUČIAI;8239000041;Ne;0;1;6;7
1529;Drevinukas;ŽVIRBLIUKAI;3032536983;Taip;15;0;0;15
1530;Drevinukas;ŽVIRBLIUKAI;8556218971;Taip;5;6;0;11
1531;Drevinukas;ŽVIRBLIUKAI;5524567803;Taip;0;0;3;3
1532;Drevinukas;ŽVIRBLIUKAI;6373230526;Taip;16;0;0;16
1533;Drevinukas;ŽVIRBLIUKAI;4404254932;Taip;0;0;5;5
1534;Drevinukas;ŽVIRBLIUKAI;2378493422;Taip;3;0;0;3
1535;Drevinukas;ŽVIRBLIUKAI;8984653958;Taip;5;6;0;11
1536;Drevinukas;ŽVIRBLIUKAI;5620887702;Ne;0;5;0;5
1537;Drevinukas;ŽVIRBLIUKAI;2281463885;Ne;5;0;0;5
1538;Drevinukas;ŽVIRBLIUKAI;4662426451;Ne;5;1;0;6
1539;Drevinukas;ŽVIRBLIUKAI;7218201733;Taip;0;9;4;13
1540;Drevinukas;ŽVIRBLIUKAI;4076576850;Taip;0;4;4;8
1541;Drevinukas;ŽVIRBLIUKAI;4471405682;Taip;7;0;0;7
1542;Drevinukas;ŽVIRBLIUKAI;1859208322;Taip;6;0;1;7
1543;Drevinukas;ŽVIRBLIUKAI;5875459639;Taip;6;3;1;10
1544;Drevinukas;ŽVIRBLIUKAI;4312429104;Taip;5;0;1;6
1545;Drugelis;NYKŠTUKŲ;6452921695;Taip;3;0;0;3
1546;Drugelis;NYKŠTUKŲ;4927896706;Ne;5;0;0;5
1547;Drugelis;NYKŠTUKŲ;9316073597;Taip;0;3;0;3
1548;Drugelis;NYKŠTUKŲ;3551095669;Taip;0;2;0;2
1549;Drugelis;NYKŠTUKŲ;1785724340;Taip;0;10;0;10
1550;Drugelis;NYKŠTUKŲ;6632884258;Taip;9;3;0;12
1551;Drugelis;NYKŠTUKŲ;3061896520;Taip;4;0;0;4
1552;Drugelis;NYKŠTUKŲ;8070030439;Taip;8;0;0;8
1553;Drugelis;NYKŠTUKŲ;9612696781;Taip;5;0;1;6
1554;Drugelis;NYKŠTUKŲ;7447519502;Taip;4;2;0;6
1555;Drugelis;NYKŠTUKŲ;4523513611;Taip;9;1;0;10
1556;Drugelis;NYKŠTUKŲ;5692743298;Taip;0;0;1;1
1557;Drugelis;NYKŠTUKŲ;6594452094;Ne;0;5;3;8
1558;Drugelis;NYKŠTUKŲ;5122256823;Taip;10;1;0;11
1559;Drugelis;NYKŠTUKŲ;4825232236;Ne;0;1;0;1
1560;Drugelis;NYKŠTUKŲ;7477547789;Taip;5;1;0;6
1561;Drugelis;NYKŠTUKŲ;8752459733;Taip;0;2;1;3
1562;Drugelis;NYKŠTUKŲ;8717445483;Taip;6;2;0;8
1563;Drugelis;NYKŠTUKŲ;4158475365;Ne;0;1;0;1
1564;Drugelis;NYKŠTUKŲ;7609530453;Taip;0;0;2;2
1565;Drugelis;NYKŠTUKŲ;4867387611;Taip;16;1;0;17
1566;Drugelis;SMALSUČIŲ;3096906506;Taip;3;3;0;6
1567;Drugelis;SMALSUČIŲ;1576853049;Taip;3;0;2;5
1568;Drugelis;SMALSUČIŲ;1856912386;Ne;21;0;0;21
1569;Drugelis;SMALSUČIŲ;7406396614;Taip;4;1;0;5
1570;Drugelis;SMALSUČIŲ;1217635751;Taip;0;0;5;5
1571;Drugelis;SMALSUČIŲ;68223183150;Ne;0;2;3;5
1572;Drugelis;SMALSUČIŲ;3479833265;Taip;0;4;1;5
1573;Drugelis;SMALSUČIŲ;3202149560;Taip;0;2;1;3
1574;Drugelis;SMALSUČIŲ;27569805506;Taip;0;8;0;8
1575;Drugelis;SMALSUČIŲ;1901608445;Taip;0;7;1;8
1576;Drugelis;SMALSUČIŲ;1160161173;Taip;0;5;1;6
1577;Drugelis;SMALSUČIŲ;1843605624;Taip;0;5;0;5
1578;Drugelis;SMALSUČIŲ;1506988472;Taip;0;2;0;2
1579;Drugelis;SMALSUČIŲ;1991420008;Taip;0;2;0;2
1580;Drugelis;SMALSUČIŲ;1421438458;Ne;0;11;0;11
1581;Drugelis;SMALSUČIŲ;53874036107;Taip;0;2;0;2
1582;Drugelis;SMALSUČIŲ;1961898730;Taip;0;2;3;5
1583;Drugelis;SMALSUČIŲ;4788423265;Taip;0;0;5;5
1584;Drugelis;SMALSUČIŲ;1541276266;Taip;0;2;0;2
1585;Drugelis;SMALSUČIŲ;5954059321;Ne;21;0;0;21
1586;Drugelis;SMALSUČIŲ;1888002607;Taip;0;2;1;3
1587;Drugelis;MUMINUKŲ;51963723965;Taip;5;7;0;12
1588;Drugelis;MUMINUKŲ;10841811704;Taip;5;3;0;8
1589;Drugelis;MUMINUKŲ;55662263930;Taip;5;3;0;8
1590;Drugelis;MUMINUKŲ;78391738678;Taip;0;2;0;2
1591;Drugelis;MUMINUKŲ;44627668646;Ne;3;4;0;7
1592;Drugelis;MUMINUKŲ;78311619943;Taip;0;3;0;3
1593;Drugelis;MUMINUKŲ;35386244403;Taip;19;1;0;20
1594;Drugelis;MUMINUKŲ;16512391370;Taip;0;1;0;1
1595;Drugelis;MUMINUKŲ;88073976875;Ne;0;1;0;1
1596;Drugelis;MUMINUKŲ;85362607749;Taip;0;1;0;1
1597;Drugelis;MUMINUKŲ;13989264253;Taip;4;1;1;6
1598;Drugelis;MUMINUKŲ;25002448923;Taip;0;2;0;2
1599;Drugelis;MUMINUKŲ;55339135155;Ne;0;2;0;2
1600;Drugelis;MUMINUKŲ;82465836364;Taip;5;1;0;6
1601;Drugelis;MUMINUKŲ;63173368598;Taip;0;6;0;6
1602;Drugelis;MUMINUKŲ;29713921940;Taip;0;1;0;1
1603;Drugelis;MUMINUKŲ;82441447907;Taip;12;1;0;13
1604;Drugelis;MUMINUKŲ;70288969200;Taip;0;2;0;2
1605;Drugelis;MUMINUKŲ;72147158912;Taip;0;4;0;4
1606;Drugelis;MUMINUKŲ;1240607928;Taip;0;9;0;9
1607;Drugelis;MUMINUKŲ;59819126556;Taip;2;1;1;4
1608;Drugelis;PŪKUOTUKAI;49035429728;Taip;0;2;1;3
1609;Drugelis;PŪKUOTUKAI;3156382280;Taip;2;2;0;4
1610;Drugelis;PŪKUOTUKAI;26436464504;Taip;0;6;0;6
1611;Drugelis;PŪKUOTUKAI;1657445173;Taip;6;1;1;8
1612;Drugelis;PŪKUOTUKAI;27379769302;Taip;0;1;0;1
1613;Drugelis;PŪKUOTUKAI;68716515660;Taip;6;0;1;7
1614;Drugelis;PŪKUOTUKAI;1162058481;Taip;0;2;2;4
1615;Drugelis;PŪKUOTUKAI;3161396176;Taip;3;1;0;4
1616;Drugelis;PŪKUOTUKAI;20943932955;Taip;0;0;3;3
1617;Drugelis;PŪKUOTUKAI;1667056936;Taip;0;1;8;9
1618;Drugelis;PŪKUOTUKAI;63777226415;Taip;0;2;0;2
1619;Drugelis;PŪKUOTUKAI;1005872691;Taip;5;4;0;9
1620;Drugelis;PŪKUOTUKAI;3403116175;Taip;0;0;12;12
1621;Drugelis;PŪKUOTUKAI;9654611393;Taip;13;1;0;14
1622;Drugelis;PŪKUOTUKAI;1651512363;Taip;0;0;3;3
1623;Drugelis;PŪKUOTUKAI;1546655542;Taip;10;0;1;11
1624;Drugelis;SPINDULIUKAI;1858504360;Taip;16;1;0;17
1625;Drugelis;SPINDULIUKAI;8107970910;Taip;10;0;0;10
1626;Drugelis;SPINDULIUKAI;1666992752;Taip;9;1;0;10
1627;Drugelis;SPINDULIUKAI;9029137302;Taip;11;0;0;11
1628;Drugelis;SPINDULIUKAI;9907121223;Taip;3;0;2;5
1629;Drugelis;SPINDULIUKAI;3293212749;Taip;0;0;1;1
1630;Drugelis;SPINDULIUKAI;8500348389;Taip;1;0;1;2
1631;Drugelis;SPINDULIUKAI;1142209285;Taip;2;1;0;3
1632;Drugelis;SPINDULIUKAI;9510744779;Taip;0;8;0;8
1633;Drugelis;SPINDULIUKAI;9836193857;Taip;0;2;0;2
1634;Drugelis;SPINDULIUKAI;5515894973;Taip;0;1;0;1
1635;Drugelis;SPINDULIUKAI;8282807535;Taip;0;0;1;1
1636;Drugelis;KIŠKUČIAI;6321332888;Taip;13;0;0;13
1637;Drugelis;KIŠKUČIAI;7253876812;Taip;12;0;1;13
1638;Drugelis;KIŠKUČIAI;7390061272;Taip;5;0;1;6
1639;Drugelis;KIŠKUČIAI;2146963673;Taip;13;0;0;13
1640;Drugelis;KIŠKUČIAI;2256221485;Taip;0;1;0;1
1641;Drugelis;KIŠKUČIAI;8812550811;Taip;12;0;0;12
1642;Drugelis;KIŠKUČIAI;3085309902;Ne;11;0;0;11
1643;Drugelis;KIŠKUČIAI;5661335344;Taip;10;0;0;10
1644;Drugelis;KIŠKUČIAI;3037496936;Taip;0;0;11;11
1645;Drugelis;KIŠKUČIAI;9345527734;Taip;7;0;0;7
1646;Drugelis;KIŠKUČIAI;6038184222;Taip;5;0;1;6
1647;Drugelis;KIŠKUČIAI;8591548746;Taip;10;0;0;10
1648;"Du gaideliai";Uodelių;3507387826;Taip;11;1;0;12
1649;"Du gaideliai";Uodelių;4144269068;Taip;6;3;0;9
1650;"Du gaideliai";Uodelių;1785976627;Taip;0;1;5;6
1651;"Du gaideliai";Uodelių;5894974508;Taip;0;8;0;8
1652;"Du gaideliai";Uodelių;1135098595;Taip;0;8;0;8
1653;"Du gaideliai";Uodelių;3370029981;Taip;0;1;0;1
1654;"Du gaideliai";Uodelių;5652662610;Taip;2;2;0;4
1655;"Du gaideliai";Uodelių;5103483956;Taip;0;1;0;1
1656;"Du gaideliai";Uodelių;6348951959;Taip;12;0;0;12
1657;"Du gaideliai";Uodelių;3854355215;Taip;0;10;5;15
1658;"Du gaideliai";Uodelių;3849899284;Taip;6;0;0;6
1659;"Du gaideliai";Uodelių;7373413569;Taip;0;2;0;2
1660;"Du gaideliai";Uodelių;6783206132;Taip;0;4;0;4
1661;"Du gaideliai";Uodelių;2262425557;Taip;0;0;3;3
1662;"Du gaideliai";Uodelių;6417648753;Taip;11;0;1;12
1663;"Du gaideliai";Uodelių;2240947701;Taip;0;0;6;6
1664;"Du gaideliai";Uodelių;6247706405;Taip;11;0;0;11
1665;"Du gaideliai";OŽIUKŲ;2159833613;Taip;0;11;0;11
1666;"Du gaideliai";OŽIUKŲ;1549762923;Ne;0;1;5;6
1667;"Du gaideliai";OŽIUKŲ;5430986033;Taip;5;2;0;7
1668;"Du gaideliai";OŽIUKŲ;2601122166;Taip;13;0;0;13
1669;"Du gaideliai";OŽIUKŲ;6750787450;Taip;0;2;0;2
1670;"Du gaideliai";OŽIUKŲ;4387568448;Taip;0;7;0;7
1671;"Du gaideliai";OŽIUKŲ;1211005513;Taip;0;0;2;2
1672;"Du gaideliai";OŽIUKŲ;1500684755;Taip;0;2;0;2
1673;"Du gaideliai";OŽIUKŲ;6715434585;Taip;0;1;0;1
1674;"Du gaideliai";OŽIUKŲ;9324740716;Ne;1;0;0;1
1675;"Du gaideliai";OŽIUKŲ;1230622413;Taip;0;7;0;7
1676;"Du gaideliai";OŽIUKŲ;94639433266;Taip;0;1;0;1
1677;"Du gaideliai";OŽIUKŲ;7783203480;Taip;7;2;0;9
1678;"Du gaideliai";OŽIUKŲ;1758546983;Taip;0;10;0;10
1679;"Du gaideliai";OŽIUKŲ;6203383711;Taip;0;0;1;1
1680;"Du gaideliai";OŽIUKŲ;1876870081;Taip;13;2;0;15
1681;"Du gaideliai";OŽIUKŲ;1962859229;Taip;18;0;0;18
1682;"Du gaideliai";OŽIUKŲ;1557413692;Taip;0;7;0;7
1683;"Du gaideliai";OŽIUKŲ;3560637865;Taip;5;3;0;8
1684;"Du gaideliai";OŽIUKŲ;3771563320;Taip;0;1;0;1
1685;"Du gaideliai";Vištyčių;1512578437;Ne;0;2;0;2
1686;"Du gaideliai";Vištyčių;1791530261;Taip;0;1;0;1
1687;"Du gaideliai";Vištyčių;1479672134;Taip;0;1;0;1
1688;"Du gaideliai";Vištyčių;50087080642;Taip;0;3;0;3
1689;"Du gaideliai";Vištyčių;25738622801;Taip;0;3;0;3
1690;"Du gaideliai";Vištyčių;1628346439;Taip;10;5;0;15
1691;"Du gaideliai";Vištyčių;14681393632;Taip;0;2;0;2
1692;"Du gaideliai";Vištyčių;1128234653;Taip;2;2;0;4
1693;"Du gaideliai";Vištyčių;6161829923;Taip;0;11;0;11
1694;"Du gaideliai";Vištyčių;30562958921;Ne;0;0;4;4
1695;"Du gaideliai";Vištyčių;1261678548;Taip;5;11;0;16
1696;"Du gaideliai";Vištyčių;73447542654;Taip;0;2;0;2
1697;"Du gaideliai";Vištyčių;1304400387;Taip;7;1;0;8
1698;"Du gaideliai";Vištyčių;1291620608;Taip;0;1;1;2
1699;"Du gaideliai";Vištyčių;1923863232;Taip;0;1;0;1
1700;"Du gaideliai";Vištyčių;1906486044;Taip;7;2;0;9
1701;"Du gaideliai";Vištyčių;13384312035;Taip;0;11;0;11
1702;"Du gaideliai";Vištyčių;80297570999;Taip;0;0;2;2
1703;"Du gaideliai";GAIDŽIUKŲ;2157315097;Taip;0;1;0;1
1704;"Du gaideliai";GAIDŽIUKŲ;25898248315;Taip;0;6;0;6
1705;"Du gaideliai";GAIDŽIUKŲ;14599820571;Taip;6;0;0;6
1706;"Du gaideliai";GAIDŽIUKŲ;73654636959;Taip;0;1;0;1
1707;"Du gaideliai";GAIDŽIUKŲ;82205925738;Taip;5;6;0;11
1708;"Du gaideliai";GAIDŽIUKŲ;1258859998;Taip;0;2;0;2
1709;"Du gaideliai";GAIDŽIUKŲ;56826255179;Ne;0;3;0;3
1710;"Du gaideliai";GAIDŽIUKŲ;9173656753;Ne;0;5;0;5
1711;"Du gaideliai";GAIDŽIUKŲ;1888402861;Taip;0;2;0;2
1712;"Du gaideliai";GAIDŽIUKŲ;8087660692;Taip;7;0;0;7
1713;"Du gaideliai";GAIDŽIUKŲ;31139048776;Taip;4;3;0;7
1714;"Du gaideliai";GAIDŽIUKŲ;59558745879;Ne;0;1;0;1
1715;"Du gaideliai";GAIDŽIUKŲ;1277603882;Taip;0;1;0;1
1716;"Du gaideliai";GAIDŽIUKŲ;46193129936;Taip;0;6;0;6
1717;"Du gaideliai";GAIDŽIUKŲ;1850550387;Taip;0;4;0;4
1718;"Du gaideliai";GAIDŽIUKŲ;11621795110;Taip;0;1;0;1
1719;"Du gaideliai";GAIDŽIUKŲ;5159654440;Taip;0;12;0;12
1720;"Du gaideliai";GAIDŽIUKŲ;8634553012;Ne;12;0;0;12
1721;"Du gaideliai";GAIDŽIUKŲ;1469877068;Taip;0;1;0;1
1722;"Du gaideliai";Musyčių;1633544390;Taip;0;0;12;12
1723;"Du gaideliai";Musyčių;7033276798;Taip;7;1;0;8
1724;"Du gaideliai";Musyčių;3247101840;Taip;3;0;4;7
1725;"Du gaideliai";Musyčių;5998344519;Taip;7;2;0;9
1726;"Du gaideliai";Musyčių;4798503931;Taip;2;4;0;6
1727;"Du gaideliai";Musyčių;6870356241;Taip;4;0;0;4
1728;"Du gaideliai";Musyčių;6053941133;Taip;16;0;0;16
1729;"Du gaideliai";Musyčių;6522707709;Taip;16;0;1;17
1730;"Du gaideliai";Musyčių;6120647567;Taip;0;11;0;11
1731;"Du gaideliai";Musyčių;8043896286;Taip;0;5;0;5
1732;"Du gaideliai";Musyčių;1156396094;Taip;13;0;1;14
1733;"Du gaideliai";Musyčių;7297661383;Taip;11;1;1;13
1734;"Du gaideliai";Musyčių;9356275460;Taip;0;2;1;3
1735;"Du gaideliai";Musyčių;6204233540;Taip;0;4;0;4
1736;"Du gaideliai";Musyčių;6015360076;Taip;0;13;0;13
1737;"Du gaideliai";Musyčių;5788923258;Taip;5;0;0;5
1738;"Du gaideliai";Musyčių;8047413507;Taip;12;1;0;13
1739;"Du gaideliai";MALŪNO;1968978650;Taip;7;0;0;7
1740;"Du gaideliai";MALŪNO;6762171696;Taip;7;1;0;8
1741;"Du gaideliai";MALŪNO;2100449108;Taip;10;0;0;10
1742;"Du gaideliai";MALŪNO;2905083899;Taip;8;0;0;8
1743;"Du gaideliai";MALŪNO;2764732768;Taip;11;0;1;12
1744;"Du gaideliai";MALŪNO;9126780620;Taip;4;1;0;5
1745;"Du gaideliai";MALŪNO;3019797369;Taip;6;0;0;6
1746;"Du gaideliai";MALŪNO;6074296305;Taip;4;0;3;7
1747;"Du gaideliai";MALŪNO;2151825222;Taip;0;1;0;1
1748;"Du gaideliai";MALŪNO;7575534590;Taip;7;0;0;7
1749;"Du gaideliai";MALŪNO;5728374219;Taip;5;1;0;6
1750;"Du gaideliai";MALŪNO;7726490359;Taip;9;0;2;11
1751;"Du gaideliai";MALŪNO;8410547195;Taip;6;0;0;6
1752;"Du gaideliai";MALŪNO;4408537397;Taip;6;0;2;8
1753;Aušrinė;Varpeliai;2948716989;Taip;0;7;0;7
1754;Aušrinė;Varpeliai;6525761466;Taip;0;10;0;10
1755;Aušrinė;Varpeliai;3346154143;Taip;0;0;1;1
1756;Aušrinė;Varpeliai;8092890260;Taip;0;1;0;1
1757;Aušrinė;Varpeliai;3998988004;Taip;6;4;0;10
1758;Aušrinė;Varpeliai;5204445760;Ne;4;1;0;5
1759;Aušrinė;Varpeliai;9641020899;Taip;4;1;0;5
1760;Aušrinė;Varpeliai;5277217733;Ne;17;0;0;17
1761;Aušrinė;Varpeliai;1502013942;Taip;4;6;0;10
1762;Aušrinė;Varpeliai;2190583964;Taip;11;0;0;11
1763;Aušrinė;Varpeliai;3920229653;Taip;12;0;0;12
1764;Aušrinė;Varpeliai;5563356449;Taip;0;0;1;1
1765;Aušrinė;Varpeliai;9501262918;Taip;0;0;2;2
1766;Aušrinė;Varpeliai;8756465854;Taip;11;0;5;16
1767;Aušrinė;Varpeliai;2304972692;Taip;17;0;0;17
1768;Aušrinė;Varpeliai;6756184787;Ne;10;0;2;12
1769;Aušrinė;Varpeliai;4288487063;Taip;9;0;2;11
1770;Aušrinė;Varpeliai;5768470608;Taip;12;0;0;12
1771;Aušrinė;Varpeliai;4969561425;Taip;0;6;2;8
1772;Aušrinė;Bitutės;17061806895;Taip;0;6;1;7
1773;Aušrinė;Bitutės;7796318812;Taip;0;3;0;3
1774;Aušrinė;Bitutės;83017543760;Ne;0;1;0;1
1775;Aušrinė;Bitutės;6318538591;Taip;16;0;0;16
1776;Aušrinė;Bitutės;5090847702;Taip;5;0;0;5
1777;Aušrinė;Bitutės;1399518471;Taip;10;0;0;10
1778;Aušrinė;Bitutės;7507448059;Taip;7;4;0;11
1779;Aušrinė;Bitutės;1291308838;Ne;0;9;0;9
1780;Aušrinė;Bitutės;63299644698;Taip;6;6;0;12
1781;Aušrinė;Bitutės;5206206080;Taip;6;6;0;12
1782;Aušrinė;Bitutės;2263818210;Taip;0;6;0;6
1783;Aušrinė;Bitutės;1061646244;Ne;7;1;0;8
1784;Aušrinė;Bitutės;5738278121;Taip;11;0;0;11
1785;Aušrinė;Bitutės;4965640386;Taip;12;0;0;12
1786;Aušrinė;Bitutės;4686825392;Taip;5;0;1;6
1787;Aušrinė;Bitutės;1908486900;Ne;0;3;0;3
1788;Aušrinė;Bitutės;1724192337;Taip;15;1;0;16
1789;Aušrinė;Bitutės;6608657740;Ne;16;0;0;16
1790;Aušrinė;Drugeliai;1996032555;Taip;8;1;5;14
1791;Aušrinė;Drugeliai;2043278242;Taip;7;0;0;7
1792;Aušrinė;Drugeliai;1343667707;Taip;0;0;1;1
1793;Aušrinė;Drugeliai;96010737590;Ne;5;5;0;10
1794;Aušrinė;Drugeliai;1133359254;Taip;6;0;15;21
1795;Aušrinė;Drugeliai;30244366906;Taip;0;2;0;2
1796;Aušrinė;Drugeliai;1184543607;Taip;9;0;1;10
1797;Aušrinė;Drugeliai;48118825872;Taip;0;14;0;14
1798;Aušrinė;Drugeliai;2069277030;Taip;8;0;0;8
1799;Aušrinė;Drugeliai;1206863546;Taip;0;1;0;1
1800;Aušrinė;Drugeliai;2022412040;Taip;12;1;0;13
1801;Aušrinė;Drugeliai;6265909152;Taip;11;0;3;14
1802;Aušrinė;Drugeliai;1532235421;Taip;5;0;4;9
1803;Aušrinė;Drugeliai;2212814026;Ne;11;2;0;13
1804;Aušrinė;Drugeliai;1927141701;Taip;0;1;0;1
1805;Aušrinė;Drugeliai;3356127625;Taip;9;0;2;11
1806;Aušrinė;Drugeliai;1151612627;Taip;0;4;0;4
1807;Aušrinė;Drugeliai;1515536619;Taip;9;0;0;9
1808;Aušrinė;Boružėlės;1298127839;Taip;0;5;0;5
1809;Aušrinė;Boružėlės;8364033602;Taip;10;0;1;11
1810;Aušrinė;Boružėlės;1009453682;Taip;3;4;0;7
1811;Aušrinė;Boružėlės;3544848804;Ne;7;0;2;9
1812;Aušrinė;Boružėlės;6136579994;Taip;0;10;0;10
1813;Aušrinė;Boružėlės;4579700769;Taip;0;2;0;2
1814;Aušrinė;Boružėlės;7268811782;Taip;0;5;0;5
1815;Aušrinė;Boružėlės;1831094707;Taip;8;2;0;10
1816;Aušrinė;Boružėlės;3593323270;Taip;0;0;1;1
1817;Aušrinė;Boružėlės;3795927209;Taip;8;6;0;14
1818;Aušrinė;Boružėlės;5283207520;Taip;0;1;10;11
1819;Aušrinė;Boružėlės;1116822936;Ne;0;0;2;2
1820;Aušrinė;Boružėlės;6226967695;Taip;0;1;4;5
1821;Aušrinė;Boružėlės;9226214856;Ne;0;0;1;1
1822;Aušrinė;Boružėlės;4562536818;Taip;2;0;0;2
1823;Aušrinė;Zuikučiai;8608907350;Taip;0;21;0;21
1824;Aušrinė;Zuikučiai;3291922401;Taip;18;0;0;18
1825;Aušrinė;Zuikučiai;8815055819;Taip;17;0;1;18
1826;Aušrinė;Zuikučiai;2199422694;Taip;21;0;0;21
1827;Aušrinė;Zuikučiai;1306244736;Taip;11;0;0;11
1828;Aušrinė;Zuikučiai;8186421282;Taip;5;0;2;7
1829;Aušrinė;Zuikučiai;9471287834;Taip;8;0;2;10
1830;Aušrinė;Zuikučiai;7071444498;Taip;0;10;0;10
1831;Aušrinė;Zuikučiai;6428753580;Taip;5;0;0;5
1832;Aušrinė;Zuikučiai;1336503878;Ne;11;0;2;13
1833;Aušrinė;Zuikučiai;3581180895;Taip;0;0;2;2
1834;Aušrinė;Zuikučiai;5821077318;Taip;5;12;2;19
1835;Aušrinė;Zuikučiai;9117896572;Taip;11;2;0;13
1836;Aušrinė;Meškiukai;3269357241;Taip;11;0;0;11
1837;Aušrinė;Meškiukai;2583331243;Taip;6;3;0;9
1838;Aušrinė;Meškiukai;2055282010;Taip;0;0;2;2
1839;Aušrinė;Meškiukai;2778931038;Taip;16;0;1;17
1840;Aušrinė;Meškiukai;8465864375;Taip;5;0;3;8
1841;Aušrinė;Meškiukai;7784329873;Taip;0;0;3;3
1842;Aušrinė;Meškiukai;7089883250;Taip;0;2;2;4
1843;Aušrinė;Meškiukai;5043122065;Taip;3;0;0;3
1844;Aušrinė;Meškiukai;7358925256;Taip;2;0;0;2
1845;Aušrinė;Meškiukai;5128863532;Ne;0;0;2;2
1846;Aušrinė;Meškiukai;7194803557;Ne;7;0;0;7
1847;Aušrinė;Meškiukai;1440531672;Taip;0;0;3;3
1848;Aušrinė;Meškiukai;9967737864;Taip;11;2;0;13
1849;Aušrinė;Meškiukai;4437786689;Taip;0;0;3;3
1850;Aušrinė;Meškiukai;9726826566;Taip;10;2;1;13
1851;"Geniukų kalvė";SAULUTĖS;9557055841;Taip;15;6;0;21
1852;"Geniukų kalvė";SAULUTĖS;3111400962;Taip;20;0;0;20
1853;"Geniukų kalvė";SAULUTĖS;4329782598;Taip;0;21;0;21
1854;"Geniukų kalvė";SAULUTĖS;8932671578;Taip;18;0;0;18
1855;"Geniukų kalvė";SAULUTĖS;9711047774;Taip;6;0;0;6
1856;"Geniukų kalvė";SAULUTĖS;1910363787;Taip;16;0;0;16
1857;"Geniukų kalvė";SAULUTĖS;7940706717;Taip;3;1;3;7
1858;"Geniukų kalvė";SAULUTĖS;9522911738;Taip;7;0;1;8
1859;"Geniukų kalvė";SAULUTĖS;4603185679;Taip;0;0;3;3
1860;"Geniukų kalvė";SAULUTĖS;5348211316;Taip;11;0;0;11
1861;"Geniukų kalvė";SAULUTĖS;7886553419;Taip;0;0;1;1
1862;"Geniukų kalvė";SAULUTĖS;6384832317;Taip;8;0;8;16
1863;"Geniukų kalvė";SAULUTĖS;4946218794;Taip;0;0;5;5
1864;"Geniukų kalvė";SAULUTĖS;4525874796;Taip;6;0;1;7
1865;"Geniukų kalvė";SAULUTĖS;2087798907;Taip;10;0;0;10
1866;"Geniukų kalvė";SAULUTĖS;7289942679;Taip;9;1;0;10
1867;"Geniukų kalvė";SAULUTĖS;4745451344;Taip;0;2;1;3
1868;"Geniukų kalvė";SAULUTĖS;9768077014;Taip;13;1;0;14
1869;"Geniukų kalvė";BITUTĖS;7745656622;Ne;10;0;2;12
1870;"Geniukų kalvė";BITUTĖS;6520429663;Taip;7;0;0;7
1871;"Geniukų kalvė";BITUTĖS;6466912385;Taip;0;10;0;10
1872;"Geniukų kalvė";BITUTĖS;2718961466;Taip;15;1;0;16
1873;"Geniukų kalvė";BITUTĖS;4967513360;Taip;0;4;0;4
1874;"Geniukų kalvė";BITUTĖS;2016254460;Taip;12;0;0;12
1875;"Geniukų kalvė";BITUTĖS;1897809684;Taip;15;0;0;15
1876;"Geniukų kalvė";BITUTĖS;4105170344;Taip;8;2;0;10
1877;"Geniukų kalvė";BITUTĖS;8872900558;Taip;0;1;1;2
1878;"Geniukų kalvė";BITUTĖS;6511955882;Taip;1;1;0;2
1879;"Geniukų kalvė";BITUTĖS;6500641378;Taip;0;4;0;4
1880;"Geniukų kalvė";BITUTĖS;2143334688;Ne;6;1;0;7
1881;"Geniukų kalvė";BITUTĖS;6498149304;Taip;0;1;0;1
1882;"Geniukų kalvė";BITUTĖS;3984265624;Taip;11;1;0;12
1883;"Geniukų kalvė";BITUTĖS;4813232640;Taip;3;0;0;3
1884;"Geniukų kalvė";BITUTĖS;9676782662;Taip;6;0;0;6
1885;"Geniukų kalvė";BITUTĖS;9666918437;Taip;15;0;0;15
1886;"Geniukų kalvė";BITUTĖS;2031800114;Taip;0;0;2;2
1887;"Geniukų kalvė";BITUTĖS;5542539934;Taip;0;0;5;5
1888;"Geniukų kalvė";KIŠKUČIAI;1568133009;Ne;16;1;0;17
1889;"Geniukų kalvė";KIŠKUČIAI;7664689396;Taip;12;0;0;12
1890;"Geniukų kalvė";KIŠKUČIAI;4844734556;Taip;5;1;0;6
1891;"Geniukų kalvė";KIŠKUČIAI;4758435835;Taip;0;1;3;4
1892;"Geniukų kalvė";KIŠKUČIAI;2729442911;Ne;0;1;0;1
1893;"Geniukų kalvė";KIŠKUČIAI;4661051023;Taip;0;1;3;4
1894;"Geniukų kalvė";KIŠKUČIAI;8668696743;Ne;5;0;0;5
1895;"Geniukų kalvė";KIŠKUČIAI;2262014110;Taip;13;0;0;13
1896;"Geniukų kalvė";KIŠKUČIAI;43097490633;Taip;0;7;0;7
1897;"Geniukų kalvė";KIŠKUČIAI;2043786151;Taip;7;1;0;8
1898;"Geniukų kalvė";KIŠKUČIAI;1460456166;Taip;6;0;0;6
1899;"Geniukų kalvė";KIŠKUČIAI;8939171238;Ne;6;6;0;12
1900;"Geniukų kalvė";KIŠKUČIAI;2140334255;Taip;8;1;0;9
1901;"Geniukų kalvė";KIŠKUČIAI;2301758912;Taip;6;2;0;8
1902;"Geniukų kalvė";KIŠKUČIAI;8635708009;Taip;19;0;0;19
1903;"Geniukų kalvė";KIŠKUČIAI;9081596975;Ne;15;0;0;15
1904;"Geniukų kalvė";KIŠKUČIAI;30932565379;Taip;5;2;4;11
1905;"Geniukų kalvė";KIŠKUČIAI;2337226175;Ne;5;1;0;6
1906;"Geniukų kalvė";VYTURĖLIAI;37670000746;Taip;0;2;0;2
1907;"Geniukų kalvė";VYTURĖLIAI;14839311346;Taip;4;1;0;5
1908;"Geniukų kalvė";VYTURĖLIAI;31140342871;Taip;0;4;1;5
1909;"Geniukų kalvė";VYTURĖLIAI;70097449722;Taip;0;15;0;15
1910;"Geniukų kalvė";VYTURĖLIAI;11476134327;Taip;10;0;0;10
1911;"Geniukų kalvė";VYTURĖLIAI;68752448767;Taip;0;1;0;1
1912;"Geniukų kalvė";VYTURĖLIAI;57595197116;Taip;4;2;0;6
1913;"Geniukų kalvė";VYTURĖLIAI;61225085978;Taip;0;2;0;2
1914;"Geniukų kalvė";VYTURĖLIAI;83623361401;Ne;0;5;0;5
1915;"Geniukų kalvė";VYTURĖLIAI;87751274075;Taip;0;1;0;1
1916;"Geniukų kalvė";VYTURĖLIAI;71884588832;Ne;6;0;1;7
1917;"Geniukų kalvė";VYTURĖLIAI;26733422046;Taip;0;1;0;1
1918;"Geniukų kalvė";VYTURĖLIAI;96267794763;Ne;0;1;0;1
1919;"Geniukų kalvė";VYTURĖLIAI;91734868433;Ne;0;2;0;2
1920;"Geniukų kalvė";VYTURĖLIAI;1933003833;Taip;10;1;0;11
1921;"Geniukų kalvė";VYTURĖLIAI;1829858221;Taip;2;1;0;3
1922;"Geniukų kalvė";VYTURĖLIAI;1658082075;Taip;6;1;2;9
1923;"Geniukų kalvė";VYTURĖLIAI;1239061261;Taip;0;11;0;11
1924;"Geniukų kalvė";DRUGELIAI;1073117547;Ne;6;6;0;12
1925;"Geniukų kalvė";DRUGELIAI;33438588586;Ne;13;1;0;14
1926;"Geniukų kalvė";DRUGELIAI;51353124475;Ne;0;1;0;1
1927;"Geniukų kalvė";DRUGELIAI;52431368754;Ne;2;1;0;3
1928;"Geniukų kalvė";DRUGELIAI;30865528880;Taip;9;0;0;9
1929;"Geniukų kalvė";DRUGELIAI;66632618838;Taip;0;2;0;2
1930;"Geniukų kalvė";DRUGELIAI;35180545728;Taip;0;1;1;2
1931;"Geniukų kalvė";DRUGELIAI;88543141650;Taip;0;7;0;7
1932;"Geniukų kalvė";DRUGELIAI;96954076142;Taip;0;3;0;3
1933;"Geniukų kalvė";DRUGELIAI;27479616927;Taip;21;0;0;21
1934;"Geniukų kalvė";DRUGELIAI;30015301622;Taip;15;1;0;16
1935;"Geniukų kalvė";DRUGELIAI;26912425905;Taip;0;0;1;1
1936;"Geniukų kalvė";DRUGELIAI;38949678625;Taip;0;1;0;1
1937;"Geniukų kalvė";DRUGELIAI;74161080879;Taip;5;0;0;5
1938;"Geniukų kalvė";DRUGELIAI;99051569551;Taip;5;1;0;6
1939;"Geniukų kalvė";DRUGELIAI;50218457812;Ne;0;1;0;1
1940;"Geniukų kalvė";DRUGELIAI;7837682774;Taip;0;0;1;1
1941;"Geniukų kalvė";DRUGELIAI;8916930503;Taip;6;1;0;7
1942;"Geniukų kalvė";DRUGELIAI;2038860438;Taip;0;3;0;3
1943;"Geniukų kalvė";DRUGELIAI;93542861144;Taip;0;1;0;1
1944;"Geniukų kalvė";DRUGELIAI;1923449545;Taip;0;2;0;2
1945;"Geniukų kalvė";DRUGELIAI;1246234700;Ne;8;1;0;9
1946;"Geniukų kalvė";"SAULĖS ZUIKUČIAI";37079991701;Taip;0;1;0;1
1947;"Geniukų kalvė";"SAULĖS ZUIKUČIAI";49352255237;Taip;0;1;0;1
1948;"Geniukų kalvė";"SAULĖS ZUIKUČIAI";90227736128;Taip;0;9;0;9
1949;"Geniukų kalvė";"SAULĖS ZUIKUČIAI";1806626063;Taip;0;8;0;8
1950;"Geniukų kalvė";"SAULĖS ZUIKUČIAI";88504194684;Taip;0;0;6;6
1951;"Geniukų kalvė";"SAULĖS ZUIKUČIAI";1776042329;Taip;0;1;6;7
1952;"Geniukų kalvė";"SAULĖS ZUIKUČIAI";1716204178;Ne;0;0;9;9
1953;"Geniukų kalvė";"SAULĖS ZUIKUČIAI";2120890722;Taip;0;7;0;7
1954;"Geniukų kalvė";"SAULĖS ZUIKUČIAI";87718471880;Taip;0;1;0;1
1955;"Geniukų kalvė";"SAULĖS ZUIKUČIAI";1415719190;Ne;0;8;0;8
1956;"Geniukų kalvė";"SAULĖS ZUIKUČIAI";83443339743;Taip;10;1;0;11
1957;"Geniukų kalvė";"SAULĖS ZUIKUČIAI";75791398203;Taip;0;3;0;3
1958;"Geniukų kalvė";"SAULĖS ZUIKUČIAI";2094764804;Taip;3;0;0;3
1959;"Geniukų kalvė";"SAULĖS ZUIKUČIAI";3553253934;Taip;0;0;6;6
1960;"Geniukų kalvė";"SAULĖS ZUIKUČIAI";9669281441;Ne;9;1;2;12
1961;"Geniukų kalvė";"SAULĖS ZUIKUČIAI";3599151643;Taip;1;0;1;2
1962;"Geniukų kalvė";"SAULĖS ZUIKUČIAI";1818485774;Taip;10;6;0;16
1963;"Geniukų kalvė";SMALSUČIAI;44345867922;Taip;5;0;0;5
1964;"Geniukų kalvė";SMALSUČIAI;6928979691;Ne;0;1;2;3
1965;"Geniukų kalvė";SMALSUČIAI;82277353185;Taip;0;0;5;5
1966;"Geniukų kalvė";SMALSUČIAI;19181427380;Taip;4;3;0;7
1967;"Geniukų kalvė";SMALSUČIAI;1684481833;Taip;21;0;0;21
1968;"Geniukų kalvė";SMALSUČIAI;14939415217;Taip;19;0;0;19
1969;"Geniukų kalvė";SMALSUČIAI;1990303616;Taip;7;3;0;10
1970;"Geniukų kalvė";SMALSUČIAI;62774512989;Ne;21;0;0;21
1971;"Geniukų kalvė";SMALSUČIAI;45542289762;Taip;3;0;4;7
1972;"Geniukų kalvė";SMALSUČIAI;23964009189;Taip;0;3;0;3
1973;"Geniukų kalvė";SMALSUČIAI;42328019754;Taip;0;1;0;1
1974;"Geniukų kalvė";SMALSUČIAI;90435684305;Taip;0;1;0;1
1975;"Geniukų kalvė";SMALSUČIAI;84974376966;Taip;0;1;0;1
1976;"Geniukų kalvė";SMALSUČIAI;97616612192;Taip;0;2;0;2
1977;"Geniukų kalvė";SMALSUČIAI;93834840514;Taip;0;2;0;2
1978;"Geniukų kalvė";SMALSUČIAI;67762121244;Ne;0;2;1;3
1979;"Geniukų kalvė";SMALSUČIAI;1663744490;Taip;0;1;1;2
1980;"Geniukų kalvė";SMALSUČIAI;2003986836;Taip;11;0;0;11
1981;"Geniukų kalvė";SMALSUČIAI;1248190435;Taip;0;2;0;2
1982;"Geniukų kalvė";SMALSUČIAI;5792552722;Taip;0;0;3;3
1983;"Geniukų kalvė";SMALSUČIAI;6253940549;Taip;0;1;2;3
1984;"Geniukų kalvė";SMALSUČIAI;65418822653;Taip;0;1;0;1
1985;"Geniukų kalvė";RUDNOSIUKAI;2082749897;Taip;0;11;0;11
1986;"Geniukų kalvė";RUDNOSIUKAI;7352976665;Ne;0;1;1;2
1987;"Geniukų kalvė";RUDNOSIUKAI;12109348143;Taip;0;1;2;3
1988;"Geniukų kalvė";RUDNOSIUKAI;87858628237;Taip;0;2;0;2
1989;"Geniukų kalvė";RUDNOSIUKAI;36553641202;Taip;0;1;0;1
1990;"Geniukų kalvė";RUDNOSIUKAI;36295276899;Ne;0;1;0;1
1991;"Geniukų kalvė";RUDNOSIUKAI;16810843163;Taip;6;2;0;8
1992;"Geniukų kalvė";RUDNOSIUKAI;75926614045;Taip;10;2;0;12
1993;"Geniukų kalvė";RUDNOSIUKAI;42849805342;Taip;0;6;0;6
1994;"Geniukų kalvė";RUDNOSIUKAI;96448080708;Taip;4;2;0;6
1995;"Geniukų kalvė";RUDNOSIUKAI;1727967870;Taip;3;0;0;3
1996;"Geniukų kalvė";RUDNOSIUKAI;1794537433;Taip;0;4;0;4
1997;"Geniukų kalvė";RUDNOSIUKAI;29353737550;Taip;0;1;0;1
1998;"Geniukų kalvė";RUDNOSIUKAI;22074236863;Taip;4;0;0;4
1999;"Geniukų kalvė";RUDNOSIUKAI;73331235731;Ne;2;1;0;3
2000;"Geniukų kalvė";RUDNOSIUKAI;7269049874;Taip;0;2;0;2
2001;"Geniukų kalvė";PELĖDŽIUKAI;2217221922;Taip;6;4;0;10
2002;"Geniukų kalvė";PELĖDŽIUKAI;3826265557;Taip;3;0;0;3
2003;"Geniukų kalvė";PELĖDŽIUKAI;8271041553;Taip;0;4;0;4
2004;"Geniukų kalvė";PELĖDŽIUKAI;1237228692;Taip;0;0;1;1
2005;"Geniukų kalvė";PELĖDŽIUKAI;2938446054;Taip;1;3;0;4
2006;"Geniukų kalvė";PELĖDŽIUKAI;3055777730;Taip;0;10;1;11
2007;"Geniukų kalvė";PELĖDŽIUKAI;9976423099;Taip;17;0;0;17
2008;"Geniukų kalvė";PELĖDŽIUKAI;6070945557;Taip;0;3;0;3
2009;"Geniukų kalvė";PELĖDŽIUKAI;9990243525;Taip;0;0;5;5
2010;"Geniukų kalvė";PELĖDŽIUKAI;1051563985;Taip;0;7;0;7
2011;"Geniukų kalvė";PELĖDŽIUKAI;6174114461;Ne;7;0;3;10
2012;"Geniukų kalvė";PELĖDŽIUKAI;6024288147;Taip;0;3;0;3
2013;"Geniukų kalvė";PELĖDŽIUKAI;6737863183;Taip;0;0;4;4
2014;"Geniukų kalvė";PELĖDŽIUKAI;5704223824;Taip;7;1;0;8
2015;"Geniukų kalvė";PELĖDŽIUKAI;1811866428;Taip;0;0;2;2
2016;"Geniukų kalvė";PELĖDŽIUKAI;6410008429;Taip;0;1;1;2
2017;"Geniukų kalvė";PELĖDŽIUKAI;4843411757;Taip;10;0;0;10
2018;"Geniukų kalvė";PELĖDŽIUKAI;8770345339;Taip;13;0;6;19
2019;"Geniukų kalvė";BORUŽĖLĖS;9613720001;Taip;8;0;2;10
2020;"Geniukų kalvė";BORUŽĖLĖS;4958738745;Taip;0;1;4;5
2021;"Geniukų kalvė";BORUŽĖLĖS;4271763719;Taip;14;0;0;14
2022;"Geniukų kalvė";BORUŽĖLĖS;9069256760;Taip;16;0;0;16
2023;"Geniukų kalvė";BORUŽĖLĖS;5161535756;Taip;5;2;1;8
2024;"Geniukų kalvė";BORUŽĖLĖS;3493492581;Taip;0;1;0;1
2025;"Geniukų kalvė";BORUŽĖLĖS;3085228868;Taip;0;2;0;2
2026;"Geniukų kalvė";BORUŽĖLĖS;3180116136;Taip;6;3;0;9
2027;"Geniukų kalvė";BORUŽĖLĖS;2904091819;Ne;5;1;0;6
2028;"Geniukų kalvė";BORUŽĖLĖS;6794151223;Taip;0;1;0;1
2029;"Geniukų kalvė";BORUŽĖLĖS;4777155321;Taip;5;0;0;5
2030;"Geniukų kalvė";BORUŽĖLĖS;2180860623;Ne;0;1;0;1
2031;"Geniukų kalvė";BORUŽĖLĖS;7471964981;Ne;10;0;1;11
2032;"Geniukų kalvė";BORUŽĖLĖS;2205515766;Taip;0;1;0;1
2033;"Geniukų kalvė";BORUŽĖLĖS;8769761434;Taip;0;9;0;9
2034;"Geniukų kalvė";BORUŽĖLĖS;1891205998;Ne;0;6;1;7
2035;"Geniukų kalvė";BORUŽĖLĖS;9643242164;Ne;9;0;0;9
2036;"Geniukų kalvė";BORUŽĖLĖS;2665955524;Taip;0;6;0;6
2037;"Geniukų kalvė";PAGRANDUKAI;9696452101;Taip;10;0;0;10
2038;"Geniukų kalvė";PAGRANDUKAI;2165793561;Taip;0;1;0;1
2039;"Geniukų kalvė";PAGRANDUKAI;1229056613;Taip;7;7;0;14
2040;"Geniukų kalvė";PAGRANDUKAI;7300853810;Taip;6;0;0;6
2041;"Geniukų kalvė";PAGRANDUKAI;2839299179;Taip;12;0;0;12
2042;"Geniukų kalvė";PAGRANDUKAI;6623491459;Taip;0;1;0;1
2043;"Geniukų kalvė";PAGRANDUKAI;2836282651;Taip;18;0;0;18
2044;"Geniukų kalvė";PAGRANDUKAI;9847003556;Taip;14;0;0;14
2045;"Geniukų kalvė";PAGRANDUKAI;3852896932;Taip;13;0;0;13
2046;"Geniukų kalvė";PAGRANDUKAI;1587839122;Taip;5;0;1;6
2047;"Geniukų kalvė";PAGRANDUKAI;4664026888;Taip;7;0;0;7
2048;"Geniukų kalvė";PAGRANDUKAI;5443596677;Taip;0;1;0;1
2049;"Geniukų kalvė";PAGRANDUKAI;5205178173;Taip;21;0;0;21
2050;"Geniukų kalvė";PAGRANDUKAI;7057284039;Taip;7;0;0;7
2051;"Geniukų kalvė";NYKŠTUKAI;5245434552;Taip;7;1;2;10
2052;"Geniukų kalvė";NYKŠTUKAI;4186376527;Taip;0;1;0;1
2053;"Geniukų kalvė";NYKŠTUKAI;1375674317;Taip;0;1;0;1
2054;"Geniukų kalvė";NYKŠTUKAI;7744441981;Taip;14;0;0;14
2055;"Geniukų kalvė";NYKŠTUKAI;1209268848;Taip;14;0;0;14
2056;"Geniukų kalvė";NYKŠTUKAI;5512172533;Taip;12;0;0;12
2057;"Geniukų kalvė";NYKŠTUKAI;1499735818;Taip;17;0;0;17
2058;"Geniukų kalvė";NYKŠTUKAI;8914605154;Taip;0;1;0;1
2059;"Geniukų kalvė";NYKŠTUKAI;1718428600;Taip;0;0;1;1
2060;"Geniukų kalvė";NYKŠTUKAI;4722801116;Taip;7;0;0;7
2061;"Geniukų kalvė";NYKŠTUKAI;2952604528;Taip;6;0;1;7
2062;"Geniukų kalvė";NYKŠTUKAI;5725034297;Taip;5;1;0;6
2063;"Geniukų kalvė";NYKŠTUKAI;8071493871;Taip;6;3;0;9
2064;"Geniukų kalvė";NYKŠTUKAI;2816691996;Taip;9;0;0;9
2065;"Geniukų kalvė";NYKŠTUKAI;5763009912;Taip;0;1;8;9
2066;Gelvonėlis;ĄŽUOLIUKAI;7919814808;Ne;0;4;0;4
2067;Gelvonėlis;ĄŽUOLIUKAI;9323579468;Taip;0;1;0;1
2068;Gelvonėlis;ĄŽUOLIUKAI;3830940009;Taip;0;5;0;5
2069;Gelvonėlis;ĄŽUOLIUKAI;2742000725;Taip;0;0;2;2
2070;Gelvonėlis;ĄŽUOLIUKAI;3147489259;Taip;0;10;0;10
2071;Gelvonėlis;ĄŽUOLIUKAI;2140799517;Taip;16;0;2;18
2072;Gelvonėlis;ĄŽUOLIUKAI;1284359362;Taip;0;2;0;2
2073;Gelvonėlis;ĄŽUOLIUKAI;9798684265;Taip;0;1;2;3
2074;Gelvonėlis;ĄŽUOLIUKAI;8775661719;Taip;10;1;0;11
2075;Gelvonėlis;ĄŽUOLIUKAI;21684706944;Taip;6;1;0;7
2076;Gelvonėlis;ĄŽUOLIUKAI;75676389361;Taip;16;0;0;16
2077;Gelvonėlis;ĄŽUOLIUKAI;2077783219;Taip;0;3;0;3
2078;Gelvonėlis;ĄŽUOLIUKAI;3089755141;Taip;0;6;0;6
2079;Gelvonėlis;ĄŽUOLIUKAI;1408313697;Taip;3;0;1;4
2080;Gelvonėlis;ĄŽUOLIUKAI;3670612781;Ne;12;5;0;17
2081;Gelvonėlis;ĄŽUOLIUKAI;69073786634;Taip;0;4;0;4
2082;Gelvonėlis;ĄŽUOLIUKAI;6255253658;Taip;14;0;0;14
2083;Gelvonėlis;ĄŽUOLIUKAI;5511174729;Taip;0;1;8;9
2084;Gelvonėlis;ĄŽUOLIUKAI;1624125024;Taip;5;1;8;14
2085;Gelvonėlis;ĄŽUOLIUKAI;9387523651;Ne;0;6;0;6
2086;Gelvonėlis;ŽVIRBLIUKAI;1772713183;Taip;2;0;1;3
2087;Gelvonėlis;ŽVIRBLIUKAI;1801724527;Ne;7;1;0;8
2088;Gelvonėlis;ŽVIRBLIUKAI;83360239551;Taip;0;0;19;19
2089;Gelvonėlis;ŽVIRBLIUKAI;21250325232;Taip;0;1;0;1
2090;Gelvonėlis;ŽVIRBLIUKAI;23181505838;Taip;0;8;0;8
2091;Gelvonėlis;ŽVIRBLIUKAI;2997738880;Taip;0;1;0;1
2092;Gelvonėlis;ŽVIRBLIUKAI;1373771258;Taip;0;4;0;4
2093;Gelvonėlis;ŽVIRBLIUKAI;92420286100;Taip;4;8;0;12
2094;Gelvonėlis;ŽVIRBLIUKAI;41610307448;Taip;0;1;5;6
2095;Gelvonėlis;ŽVIRBLIUKAI;87746258537;Taip;0;6;0;6
2096;Gelvonėlis;ŽVIRBLIUKAI;6635285387;Taip;0;0;5;5
2097;Gelvonėlis;ŽVIRBLIUKAI;1938913528;Taip;0;3;5;8
2098;Gelvonėlis;ŽVIRBLIUKAI;2096702999;Taip;0;2;2;4
2099;Gelvonėlis;ŽVIRBLIUKAI;17044138057;Taip;0;0;7;7
2100;Gelvonėlis;ŽVIRBLIUKAI;84863800926;Taip;0;4;0;4
2101;Gelvonėlis;ŽVIRBLIUKAI;1355742622;Taip;0;10;0;10
2102;Gelvonėlis;ŽVIRBLIUKAI;1827511187;Taip;0;0;1;1
2103;Gelvonėlis;ŽVIRBLIUKAI;9784762153;Taip;9;3;1;13
2104;Gelvonėlis;ŽVIRBLIUKAI;9919860358;Taip;0;1;0;1
2105;Gelvonėlis;ŽVIRBLIUKAI;86895427397;Ne;0;0;1;1
2106;Gelvonėlis;RASELĖS;3325116198;Taip;2;1;1;4
2107;Gelvonėlis;RASELĖS;9847156800;Ne;6;7;0;13
2108;Gelvonėlis;RASELĖS;2153676615;Ne;5;6;0;11
2109;Gelvonėlis;RASELĖS;47302438188;Taip;6;1;0;7
2110;Gelvonėlis;RASELĖS;32893563601;Taip;0;2;0;2
2111;Gelvonėlis;RASELĖS;11697172905;Taip;0;4;0;4
2112;Gelvonėlis;RASELĖS;1221420212;Taip;0;4;0;4
2113;Gelvonėlis;RASELĖS;43145774484;Ne;0;10;2;12
2114;Gelvonėlis;RASELĖS;18237108866;Taip;5;5;0;10
2115;Gelvonėlis;RASELĖS;79607769503;Ne;5;1;0;6
2116;Gelvonėlis;RASELĖS;96792124844;Ne;5;1;0;6
2117;Gelvonėlis;RASELĖS;1400871061;Taip;10;1;0;11
2118;Gelvonėlis;RASELĖS;69221565557;Taip;5;2;0;7
2119;Gelvonėlis;RASELĖS;79899652046;Taip;0;1;1;2
2120;Gelvonėlis;RASELĖS;9108760720;Taip;0;4;0;4
2121;Gelvonėlis;RASELĖS;1776015014;Taip;0;4;0;4
2122;Gelvonėlis;RASELĖS;1648307847;Ne;2;1;0;3
2123;Gelvonėlis;SAULUTĖ;11807134557;Taip;0;2;0;2
2124;Gelvonėlis;SAULUTĖ;72859950160;Taip;0;7;0;7
2125;Gelvonėlis;SAULUTĖ;9396676137;Taip;4;0;0;4
2126;Gelvonėlis;SAULUTĖ;9353066785;Taip;8;0;0;8
2127;Gelvonėlis;SAULUTĖ;3121251271;Taip;0;3;0;3
2128;Gelvonėlis;SAULUTĖ;1750552925;Taip;0;9;0;9
2129;Gelvonėlis;SAULUTĖ;5098282548;Taip;3;1;0;4
2130;Gelvonėlis;SAULUTĖ;26468121179;Taip;16;0;0;16
2131;Gelvonėlis;SAULUTĖ;59592904001;Taip;0;1;0;1
2132;Gelvonėlis;SAULUTĖ;19782508652;Ne;0;7;0;7
2133;Gelvonėlis;SAULUTĖ;3859776410;Taip;0;8;0;8
2134;Gelvonėlis;SAULUTĖ;19955601762;Taip;0;2;0;2
2135;Gelvonėlis;SAULUTĖ;6405741006;Taip;13;0;0;13
2136;Gelvonėlis;SAULUTĖ;71806077882;Taip;14;1;0;15
2137;Gelvonėlis;SAULUTĖ;8475204684;Taip;0;2;0;2
2138;Gelvonėlis;SAULUTĖ;2622967319;Taip;8;1;0;9
2139;Gelvonėlis;SAULUTĖ;4830374546;Taip;21;0;0;21
2140;Gelvonėlis;SAULUTĖ;6226970200;Taip;0;1;0;1
2141;Gelvonėlis;SAULUTĖ;5759356754;Taip;3;1;0;4
2142;Gelvonėlis;SAULUTĖ;1042715433;Ne;16;1;0;17
2143;Gelvonėlis;PELĖDŽIUKAI;87693970225;Taip;0;3;0;3
2144;Gelvonėlis;PELĖDŽIUKAI;17021411833;Taip;9;1;0;10
2145;Gelvonėlis;PELĖDŽIUKAI;48593832088;Taip;0;1;0;1
2146;Gelvonėlis;PELĖDŽIUKAI;22201650331;Taip;0;7;0;7
2147;Gelvonėlis;PELĖDŽIUKAI;98009116912;Taip;0;1;0;1
2148;Gelvonėlis;PELĖDŽIUKAI;51375531815;Taip;0;1;4;5
2149;Gelvonėlis;PELĖDŽIUKAI;70550528579;Taip;6;1;1;8
2150;Gelvonėlis;PELĖDŽIUKAI;91507293029;Taip;0;1;3;4
2151;Gelvonėlis;PELĖDŽIUKAI;71199691102;Taip;0;6;0;6
2152;Gelvonėlis;PELĖDŽIUKAI;43250059460;Taip;0;4;0;4
2153;Gelvonėlis;PELĖDŽIUKAI;2218767947;Taip;5;1;1;7
2154;Gelvonėlis;PELĖDŽIUKAI;7277516341;Taip;0;1;1;2
2155;Gelvonėlis;PELĖDŽIUKAI;5393404051;Taip;8;1;0;9
2156;Gelvonėlis;PELĖDŽIUKAI;89916945860;Ne;0;1;1;2
2157;Gelvonėlis;PELĖDŽIUKAI;40127507796;Taip;8;1;0;9
2158;Gelvonėlis;PELĖDŽIUKAI;36610437375;Taip;9;1;0;10
2159;Gelvonėlis;PELĖDŽIUKAI;9970883470;Taip;0;3;0;3
2160;Gelvonėlis;PELĖDŽIUKAI;1902998389;Taip;0;1;2;3
2161;Gelvonėlis;PELĖDŽIUKAI;71076083278;Taip;5;1;6;12
2162;Gelvonėlis;DRUGELIAI;8209225630;Taip;6;10;0;16
2163;Gelvonėlis;DRUGELIAI;7936622964;Taip;0;1;0;1
2164;Gelvonėlis;DRUGELIAI;6856800484;Taip;9;0;0;9
2165;Gelvonėlis;DRUGELIAI;6554989142;Taip;0;5;0;5
2166;Gelvonėlis;DRUGELIAI;8056058298;Taip;0;1;0;1
2167;Gelvonėlis;DRUGELIAI;3926733474;Taip;5;1;0;6
2168;Gelvonėlis;DRUGELIAI;2698853686;Taip;10;5;0;15
2169;Gelvonėlis;DRUGELIAI;6585504578;Taip;14;3;0;17
2170;Gelvonėlis;DRUGELIAI;6243360625;Taip;0;2;0;2
2171;Gelvonėlis;DRUGELIAI;5790038422;Taip;10;0;0;10
2172;Gelvonėlis;DRUGELIAI;1587584701;Taip;12;0;0;12
2173;Gelvonėlis;DRUGELIAI;8515746171;Taip;4;0;0;4
2174;Gelvonėlis;DRUGELIAI;9118102469;Taip;1;0;0;1
2175;Gelvonėlis;DRUGELIAI;2434789595;Taip;8;0;0;8
2176;Gelvonėlis;VARPELIAI;3059903126;Taip;4;0;3;7
2177;Gelvonėlis;VARPELIAI;9149117970;Taip;4;5;0;9
2178;Gelvonėlis;VARPELIAI;3483144401;Taip;0;12;2;14
2179;Gelvonėlis;VARPELIAI;6451557430;Taip;12;0;0;12
2180;Gelvonėlis;VARPELIAI;6225854165;Taip;0;0;6;6
2181;Gelvonėlis;VARPELIAI;2638430817;Ne;5;1;2;8
2182;Gelvonėlis;VARPELIAI;9600526942;Taip;8;5;0;13
2183;Gelvonėlis;VARPELIAI;1387948936;Taip;0;12;0;12
2184;Gelvonėlis;VARPELIAI;9650922918;Taip;5;4;0;9
2185;Gelvonėlis;VARPELIAI;1462716950;Taip;3;2;0;5
2186;Gelvonėlis;VARPELIAI;6949090250;Taip;21;0;0;21
2187;Gelvonėlis;VARPELIAI;9622818893;Taip;9;0;0;9
2188;Gelvonėlis;VARPELIAI;7194091189;Ne;5;0;0;5
2189;Gelvonėlis;VARPELIAI;3446593424;Taip;3;0;4;7
2190;Gelvonėlis;VARPELIAI;6478873536;Taip;21;0;0;21
2191;Gelvonėlis;VARPELIAI;6869418701;Taip;0;0;4;4
2192;Gelvonėlis;VARPELIAI;5207153784;Taip;0;9;0;9
2193;Gelvonėlis;VARPELIAI;3730493822;Taip;13;0;0;13
2194;Gelvonėlis;VARPELIAI;9304912028;Taip;0;0;1;1
2195;Gelvonėlis;BORUŽĖLĖS;1030246127;Taip;0;4;0;4
2196;Gelvonėlis;BORUŽĖLĖS;22575527531;Taip;0;2;0;2
2197;Gelvonėlis;BORUŽĖLĖS;1163833201;Taip;6;2;0;8
2198;Gelvonėlis;BORUŽĖLĖS;3379601736;Taip;16;4;0;20
2199;Gelvonėlis;BORUŽĖLĖS;1597669426;Taip;0;3;0;3
2200;Gelvonėlis;BORUŽĖLĖS;31744699590;Taip;5;1;0;6
2201;Gelvonėlis;BORUŽĖLĖS;9777094764;Taip;9;0;1;10
2202;Gelvonėlis;BORUŽĖLĖS;3936144045;Ne;0;2;0;2
2203;Gelvonėlis;BORUŽĖLĖS;12715604772;Taip;0;4;0;4
2204;Gelvonėlis;BORUŽĖLĖS;8050788182;Taip;12;7;0;19
2205;Gelvonėlis;BORUŽĖLĖS;30812081628;Taip;5;0;0;5
2206;Gelvonėlis;BORUŽĖLĖS;1183745610;Taip;0;10;0;10
2207;Gelvonėlis;BORUŽĖLĖS;6266298514;Ne;0;0;12;12
2208;Gelvonėlis;BORUŽĖLĖS;3284385491;Taip;9;0;0;9
2209;Gelvonėlis;BORUŽĖLĖS;1610362831;Ne;0;1;5;6
2210;Gelvonėlis;BORUŽĖLĖS;1836155450;Taip;4;9;0;13
2211;Gelvonėlis;BORUŽĖLĖS;7903272826;Taip;9;0;1;10
2212;Gelvonėlis;NYKŠTUKAI;6604992169;Taip;0;7;0;7
2213;Gelvonėlis;NYKŠTUKAI;6556472766;Taip;14;0;0;14
2214;Gelvonėlis;NYKŠTUKAI;7182180008;Taip;0;2;0;2
2215;Gelvonėlis;NYKŠTUKAI;6598178467;Taip;5;2;3;10
2216;Gelvonėlis;NYKŠTUKAI;8885088900;Taip;0;2;2;4
2217;Gelvonėlis;NYKŠTUKAI;8622621570;Taip;10;0;2;12
2218;Gelvonėlis;NYKŠTUKAI;2400289466;Taip;4;3;0;7
2219;Gelvonėlis;NYKŠTUKAI;5129492284;Taip;0;3;0;3
2220;Gelvonėlis;NYKŠTUKAI;9493536517;Taip;5;0;1;6
2221;Gelvonėlis;NYKŠTUKAI;2288951845;Taip;3;0;0;3
2222;Gelvonėlis;NYKŠTUKAI;2515471132;Taip;7;0;2;9
2223;Gelvonėlis;NYKŠTUKAI;6505814802;Taip;0;1;0;1
2224;Gelvonėlis;NYKŠTUKAI;6319058542;Ne;11;0;0;11
2225;Gelvonėlis;NYKŠTUKAI;9538571448;Taip;6;2;0;8
2226;Gelvonėlis;NYKŠTUKAI;9147186080;Taip;8;1;0;9
2227;Gelvonėlis;NYKŠTUKAI;9059244134;Taip;0;2;0;2
2228;Gelvonėlis;NYKŠTUKAI;1987204544;Taip;0;6;0;6
2229;Gelvonėlis;NYKŠTUKAI;1085845218;Taip;0;5;3;8
2230;Gelvonėlis;NYKŠTUKAI;7195164378;Taip;16;0;0;16
2231;Gelvonėlis;BITUTĖS;7759317220;Ne;0;4;0;4
2232;Gelvonėlis;BITUTĖS;6196065515;Taip;7;0;0;7
2233;Gelvonėlis;BITUTĖS;2504468098;Taip;13;1;0;14
2234;Gelvonėlis;BITUTĖS;7983982378;Taip;5;0;0;5
2235;Gelvonėlis;BITUTĖS;5721858659;Taip;10;3;0;13
2236;Gelvonėlis;BITUTĖS;9667024635;Taip;5;5;0;10
2237;Gelvonėlis;BITUTĖS;2108690954;Taip;15;0;1;16
2238;Gelvonėlis;BITUTĖS;4855800131;Taip;3;0;1;4
2239;Gelvonėlis;BITUTĖS;1753617545;Taip;10;4;0;14
2240;Gelvonėlis;BITUTĖS;6189110767;Taip;4;0;1;5
2241;Gelvonėlis;BITUTĖS;3843881329;Taip;5;8;0;13
2242;Gelvonėlis;BITUTĖS;6317822775;Taip;0;10;0;10
2243;Gelvonėlis;BITUTĖS;9184192787;Taip;0;6;0;6
2244;Gelvonėlis;BITUTĖS;9369121356;Taip;6;0;0;6
2245;Gelvonėlis;BITUTĖS;2119550116;Taip;0;6;0;6
2246;Gelvonėlis;BITUTĖS;7826522180;Taip;0;0;3;3
2247;Gelvonėlis;BITUTĖS;9286500887;Taip;0;0;3;3
2248;Gelvonėlis;BITUTĖS;5095782784;Taip;15;0;0;15
2249;Gelvonėlis;BITUTĖS;1516164123;Taip;11;2;0;13
2250;Gelvonėlis;BITUTĖS;7226051965;Taip;12;0;0;12
2251;Gelvonėlis;BITUTĖS;5047022305;Ne;11;0;0;11
2252;Gelvonėlis;RAMUNĖLĖS;3368423382;Taip;11;2;0;13
2253;Gelvonėlis;RAMUNĖLĖS;3973248307;Taip;6;0;0;6
2254;Gelvonėlis;RAMUNĖLĖS;5759407291;Taip;10;2;0;12
2255;Gelvonėlis;RAMUNĖLĖS;2163976198;Taip;17;0;0;17
2256;Gelvonėlis;RAMUNĖLĖS;5986018609;Taip;0;1;0;1
2257;Gelvonėlis;RAMUNĖLĖS;8766702456;Taip;3;0;0;3
2258;Gelvonėlis;RAMUNĖLĖS;1266479895;Taip;11;3;0;14
2259;Gelvonėlis;RAMUNĖLĖS;1004686756;Taip;6;0;4;10
2260;Gelvonėlis;RAMUNĖLĖS;5934077931;Taip;0;0;1;1
2261;Gelvonėlis;RAMUNĖLĖS;3271464159;Taip;15;1;0;16
2262;Gelvonėlis;RAMUNĖLĖS;2734462553;Taip;18;0;0;18
2263;Gelvonėlis;RAMUNĖLĖS;4280463938;Taip;0;3;0;3
2264;Gelvonėlis;RAMUNĖLĖS;4083370462;Taip;16;0;0;16
2265;Gelvonėlis;RAMUNĖLĖS;6068473734;Taip;7;1;0;8
2266;Gelvonėlis;RAMUNĖLĖS;8532801167;Taip;10;0;0;10
2267;Gervelė;ŽIRNIUKAI;9977349707;Taip;6;0;2;8
2268;Gervelė;ŽIRNIUKAI;7317091881;Taip;19;0;0;19
2269;Gervelė;ŽIRNIUKAI;4038179503;Taip;19;0;0;19
2270;Gervelė;ŽIRNIUKAI;4295743997;Taip;0;1;0;1
2271;Gervelė;ŽIRNIUKAI;7020599764;Taip;7;0;1;8
2272;Gervelė;ŽIRNIUKAI;4394752176;Taip;10;2;0;12
2273;Gervelė;ŽIRNIUKAI;6228025635;Taip;5;0;0;5
2274;Gervelė;ŽIRNIUKAI;6951455424;Taip;0;0;3;3
2275;Gervelė;ŽIRNIUKAI;9970293084;Taip;0;4;0;4
2276;Gervelė;ŽIRNIUKAI;8012122042;Taip;6;0;4;10
2277;Gervelė;ŽIRNIUKAI;1400044294;Taip;14;0;0;14
2278;Gervelė;ŽIRNIUKAI;7935059565;Taip;10;0;3;13
2279;Gervelė;ŽIRNIUKAI;5267617723;Taip;2;0;0;2
2280;Gervelė;ŽIRNIUKAI;5953552777;Taip;3;3;0;6
2281;Gervelė;ŽIRNIUKAI;7050837754;Taip;0;5;0;5
2282;Gervelė;ŽIRNIUKAI;6287806975;Taip;0;0;1;1
2283;Gervelė;ŽIRNIUKAI;6987657237;Taip;14;0;1;15
2284;Gervelė;LAŠIUKAI;8062089041;Taip;10;0;0;10
2285;Gervelė;LAŠIUKAI;2551280794;Taip;0;12;0;12
2286;Gervelė;LAŠIUKAI;1616949023;Taip;5;0;5;10
2287;Gervelė;LAŠIUKAI;9515308666;Taip;13;0;0;13
2288;Gervelė;LAŠIUKAI;3427400844;Taip;7;1;4;12
2289;Gervelė;LAŠIUKAI;8152446576;Taip;6;9;0;15
2290;Gervelė;LAŠIUKAI;6967078836;Taip;6;0;4;10
2291;Gervelė;LAŠIUKAI;7302238728;Ne;0;1;0;1
2292;Gervelė;LAŠIUKAI;7697761552;Taip;0;0;6;6
2293;Gervelė;LAŠIUKAI;5989713844;Taip;8;0;0;8
2294;Gervelė;LAŠIUKAI;4560752068;Taip;0;3;0;3
2295;Gervelė;LAŠIUKAI;1704033440;Taip;10;5;0;15
2296;Gervelė;LAŠIUKAI;4705514590;Ne;1;0;1;2
2297;Gervelė;LAŠIUKAI;89076506192;Taip;8;0;1;9
2298;Gervelė;LAŠIUKAI;87619285504;Taip;5;0;1;6
2299;Gervelė;LAŠIUKAI;1991238577;Taip;0;11;0;11
2300;Gervelė;LAŠIUKAI;2167744244;Taip;5;1;0;6
2301;Gervelė;LAŠIUKAI;3525060645;Taip;0;8;0;8
2302;Gervelė;PABIRUČIAI;2019214634;Taip;19;0;0;19
2303;Gervelė;PABIRUČIAI;88273293270;Taip;12;0;0;12
2304;Gervelė;PABIRUČIAI;3278950938;Taip;2;0;6;8
2305;Gervelė;PABIRUČIAI;52142182972;Taip;0;0;2;2
2306;Gervelė;PABIRUČIAI;62782512806;Taip;11;5;0;16
2307;Gervelė;PABIRUČIAI;1921567602;Taip;0;0;1;1
2308;Gervelė;PABIRUČIAI;8454703111;Taip;0;2;0;2
2309;Gervelė;PABIRUČIAI;1492459180;Taip;3;0;0;3
2310;Gervelė;PABIRUČIAI;1617055167;Taip;0;0;3;3
2311;Gervelė;PABIRUČIAI;1697536098;Taip;16;0;0;16
2312;Gervelė;PABIRUČIAI;49013139623;Taip;8;2;0;10
2313;Gervelė;PABIRUČIAI;2632272974;Taip;7;0;1;8
2314;Gervelė;PABIRUČIAI;1860333208;Taip;6;5;0;11
2315;Gervelė;PABIRUČIAI;2798349541;Ne;0;11;0;11
2316;Gervelė;PABIRUČIAI;6349428106;Taip;0;7;0;7
2317;Gervelė;PABIRUČIAI;8035942210;Taip;10;6;0;16
2318;Gervelė;BITUTĖS;1792726318;Ne;6;13;0;19
2319;Gervelė;BITUTĖS;85689668690;Taip;0;1;5;6
2320;Gervelė;BITUTĖS;44678807307;Ne;0;1;0;1
2321;Gervelė;BITUTĖS;1371549808;Taip;7;0;1;8
2322;Gervelė;BITUTĖS;15891512215;Taip;0;1;0;1
2323;Gervelė;BITUTĖS;24724452164;Taip;0;0;1;1
2324;Gervelė;BITUTĖS;27435616549;Taip;0;11;0;11
2325;Gervelė;BITUTĖS;1303396562;Ne;0;1;8;9
2326;Gervelė;BITUTĖS;32101040739;Ne;0;0;1;1
2327;Gervelė;BITUTĖS;5085234839;Taip;0;1;0;1
2328;Gervelė;BITUTĖS;97418410809;Ne;0;1;3;4
2329;Gervelė;BITUTĖS;65751519550;Ne;0;1;1;2
2330;Gervelė;BITUTĖS;1928679740;Taip;0;1;2;3
2331;Gervelė;BITUTĖS;1413157604;Taip;0;1;2;3
2332;Gervelė;BITUTĖS;65086547895;Taip;0;5;0;5
2333;Gervelė;BITUTĖS;2017094793;Taip;0;0;4;4
2334;Gervelė;BITUTĖS;8302493906;Ne;0;3;0;3
2335;Gervelė;BURATINO;1815418720;Taip;0;16;0;16
2336;Gervelė;BURATINO;6168558862;Taip;8;7;0;15
2337;Gervelė;BURATINO;92859033264;Taip;10;0;0;10
2338;Gervelė;BURATINO;1083567209;Taip;0;1;0;1
2339;Gervelė;BURATINO;3946391650;Taip;0;4;0;4
2340;Gervelė;BURATINO;7620764911;Taip;6;10;0;16
2341;Gervelė;BURATINO;5440557094;Taip;0;7;0;7
2342;Gervelė;BURATINO;9202293067;Taip;0;2;0;2
2343;Gervelė;BURATINO;9909794030;Taip;0;13;0;13
2344;Gervelė;BURATINO;2646901307;Taip;0;5;0;5
2345;Gervelė;BURATINO;9564303781;Taip;0;5;0;5
2346;Gervelė;BURATINO;78122408360;Taip;9;5;0;14
2347;Gervelė;BURATINO;9771780358;Taip;0;7;0;7
2348;Gervelė;BURATINO;9239897472;Taip;0;1;0;1
2349;Gervelė;BURATINO;8997525194;Taip;5;5;0;10
2350;Gervelė;VIŠČIUKŲ;6844406500;Taip;15;0;0;15
2351;Gervelė;VIŠČIUKŲ;8157865822;Taip;5;1;1;7
2352;Gervelė;VIŠČIUKŲ;2359854614;Taip;6;0;0;6
2353;Gervelė;VIŠČIUKŲ;8533480337;Taip;0;5;0;5
2354;Gervelė;VIŠČIUKŲ;2523056808;Taip;0;0;9;9
2355;Gervelė;VIŠČIUKŲ;6145405293;Taip;0;0;5;5
2356;Gervelė;VIŠČIUKŲ;1637204236;Taip;18;0;0;18
2357;Gervelė;VIŠČIUKŲ;2413995770;Taip;18;0;0;18
2358;Gervelė;VIŠČIUKŲ;6058944385;Taip;0;4;0;4
2359;Gervelė;VIŠČIUKŲ;1323074335;Taip;5;0;2;7
2360;Gervelė;VIŠČIUKŲ;4294916559;Taip;7;0;0;7
2361;Gervelė;VIŠČIUKŲ;3449674095;Taip;5;4;0;9
2362;Gervelė;VIŠČIUKŲ;5767158743;Taip;5;0;0;5
2363;Gervelė;VIŠČIUKŲ;4775822341;Taip;9;2;0;11
2364;Gervelė;VIŠČIUKŲ;3723783633;Taip;21;0;0;21
2365;Gilužis;Skruzdėliukų;35511006307;Taip;0;2;1;3
2366;Gilužis;Skruzdėliukų;44807904472;Taip;9;2;0;11
2367;Gilužis;Skruzdėliukų;1615293331;Taip;0;2;0;2
2368;Gilužis;Skruzdėliukų;9474400084;Taip;0;1;0;1
2369;Gilužis;Skruzdėliukų;5161095299;Taip;11;1;0;12
2370;Gilužis;Skruzdėliukų;70959404439;Taip;0;1;0;1
2371;Gilužis;Skruzdėliukų;8840822243;Taip;5;0;0;5
2372;Gilužis;Skruzdėliukų;4611735601;Taip;0;3;0;3
2373;Gilužis;Skruzdėliukų;4747769984;Taip;5;2;0;7
2374;Gilužis;Skruzdėliukų;5920357223;Taip;0;2;0;2
2375;Gilužis;Skruzdėliukų;8595541498;Taip;0;1;1;2
2376;Gilužis;Skruzdėliukų;5365582271;Taip;19;1;0;20
2377;Gilužis;Skruzdėliukų;7364297673;Taip;0;0;1;1
2378;Gilužis;Skruzdėliukų;4362244070;Ne;0;1;0;1
2379;Gilužis;Skruzdėliukų;2042514241;Taip;0;2;0;2
2380;Gilužis;Skruzdėliukų;3216004438;Taip;17;1;0;18
2381;Gilužis;Skruzdėliukų;7766747590;Taip;4;0;1;5
2382;Gilužis;Skruzdėliukų;4777937216;Taip;5;3;0;8
2383;Gilužis;Skruzdėliukų;48365991937;Ne;13;3;0;16
2384;Gilužis;Nykštukų;4147821853;Taip;4;0;0;4
2385;Gilužis;Nykštukų;7937643339;Taip;5;1;0;6
2386;Gilužis;Nykštukų;3473889426;Taip;14;0;0;14
2387;Gilužis;Nykštukų;9362581908;Taip;14;0;0;14
2388;Gilužis;Nykštukų;8899557365;Taip;0;1;0;1
2389;Gilužis;Nykštukų;2661894041;Taip;21;0;0;21
2390;Gilužis;Nykštukų;5109935385;Taip;0;4;0;4
2391;Gilužis;Nykštukų;7228498662;Taip;1;1;0;2
2392;Gilužis;Nykštukų;3335512812;Taip;0;3;0;3
2393;Gilužis;Nykštukų;1459273692;Taip;0;1;0;1
2394;Gilužis;Nykštukų;6093514885;Taip;17;0;0;17
2395;Gilužis;Nykštukų;4156613717;Ne;8;1;3;12
2396;Gilužis;Nykštukų;5713786735;Ne;20;0;0;20
2397;Gilužis;Nykštukų;2784416935;Taip;12;1;0;13
2398;Gilužis;Nykštukų;4956685016;Taip;0;3;0;3
2399;Gilužis;Nykštukų;6315155554;Taip;5;1;0;6
2400;Gilužis;Nykštukų;1146713023;Taip;3;3;0;6
2401;Gilužis;Nykštukų;9332056404;Taip;12;0;0;12
2402;Gilužis;Nykštukų;8522552650;Taip;7;3;2;12
2403;Gilužis;Bitučių;7667792304;Taip;0;1;0;1
2404;Gilužis;Bitučių;33601993265;Taip;0;5;0;5
2405;Gilužis;Bitučių;36591400178;Taip;0;1;0;1
2406;Gilužis;Bitučių;86856314276;Taip;0;2;0;2
2407;Gilužis;Bitučių;6761901941;Taip;5;1;0;6
2408;Gilužis;Bitučių;86204525039;Taip;7;0;0;7
2409;Gilužis;Bitučių;66936354561;Taip;0;4;0;4
2410;Gilužis;Bitučių;31841898314;Taip;0;0;1;1
2411;Gilužis;Bitučių;58788039263;Taip;14;0;0;14
2412;Gilužis;Bitučių;99678737297;Taip;0;2;0;2
2413;Gilužis;Bitučių;67925251330;Taip;0;3;0;3
2414;Gilužis;Bitučių;75877736009;Taip;0;1;0;1
2415;Gilužis;Bitučių;77265792587;Taip;0;1;0;1
2416;Gilužis;Bitučių;98929035480;Taip;0;8;0;8
2417;Gilužis;Bitučių;16441506448;Taip;4;1;0;5
2418;Gilužis;Bitučių;60029145569;Taip;11;1;0;12
2419;Gilužis;Bitučių;6748923923;Taip;11;1;0;12
2420;Gilužis;Bitučių;84012597609;Ne;0;5;0;5
2421;Gilužis;Bitučių;44591290522;Taip;0;1;0;1
2422;Gilužis;Kačiukų;64044950817;Taip;13;1;2;16
2423;Gilužis;Kačiukų;97044945526;Taip;2;0;0;2
2424;Gilužis;Kačiukų;2452430134;Taip;0;5;0;5
2425;Gilužis;Kačiukų;97366385111;Taip;0;1;0;1
2426;Gilužis;Kačiukų;98833692687;Taip;0;1;0;1
2427;Gilužis;Kačiukų;90653192774;Taip;0;1;0;1
2428;Gilužis;Kačiukų;69179380194;Taip;4;0;0;4
2429;Gilužis;Kačiukų;93911699181;Taip;7;0;1;8
2430;Gilužis;Kačiukų;27145205823;Taip;3;0;0;3
2431;Gilužis;Kačiukų;11999596704;Taip;0;2;0;2
2432;Gilužis;Kačiukų;40327951625;Ne;0;1;2;3
2433;Gilužis;Kačiukų;32385951346;Taip;0;2;0;2
2434;Gilužis;Kačiukų;69814504535;Ne;0;2;0;2
2435;Gilužis;Kačiukų;2826672081;Taip;0;1;0;1
2436;Gilužis;Kačiukų;48813257365;Ne;4;0;0;4
2437;Gilužis;Kačiukų;37836645040;Taip;2;0;0;2
2438;Gilužis;Kačiukų;71678818697;Taip;8;0;0;8
2439;Gilužis;Kačiukų;88997906780;Taip;0;6;0;6
2440;Gilužis;Kačiukų;1483999429;Taip;0;1;0;1
2441;Gilužis;Kačiukų;8442202778;Taip;5;1;2;8
2442;Gilužis;Kačiukų;51801100240;Taip;2;2;0;4
2443;Gilužis;Pelėdžiukų;5217748032;Ne;0;5;0;5
2444;Gilužis;Pelėdžiukų;5989314494;Taip;11;0;2;13
2445;Gilužis;Pelėdžiukų;7998695149;Taip;18;0;0;18
2446;Gilužis;Pelėdžiukų;7742783427;Taip;18;0;0;18
2447;Gilužis;Pelėdžiukų;7358572344;Taip;0;7;0;7
2448;Gilužis;Pelėdžiukų;4617259961;Taip;4;0;0;4
2449;Gilužis;Pelėdžiukų;1222370750;Ne;5;1;2;8
2450;Gilužis;Pelėdžiukų;9503516686;Taip;4;2;0;6
2451;Gilužis;Pelėdžiukų;9833451628;Taip;0;1;0;1
2452;Gilužis;Pelėdžiukų;6270071724;Taip;0;1;0;1
2453;Gilužis;Pelėdžiukų;7505729606;Taip;0;1;2;3
2454;Gilužis;Pelėdžiukų;7050440691;Taip;15;0;0;15
2455;Gilužis;Pelėdžiukų;4051726208;Taip;10;1;0;11
2456;Gilužis;Pelėdžiukų;7092060789;Taip;0;1;0;1
2457;Gilužis;Pelėdžiukų;1804218972;Taip;0;1;0;1
2458;Gilužis;Pelėdžiukų;2434419240;Taip;0;1;0;1
2459;Gilužis;Pelėdžiukų;1832039250;Taip;4;1;7;12
2460;Gilužis;Pelėdžiukų;3166161973;Taip;4;0;0;4
2461;Gilužis;Pelėdžiukų;5070988982;Taip;11;0;0;11
2462;Gilužis;Pelėdžiukų;7899274495;Taip;11;0;2;13
2463;Gilužis;Drugelių;1437220475;Taip;0;1;0;1
2464;Gilužis;Drugelių;36023384252;Taip;0;3;0;3
2465;Gilužis;Drugelių;44522730563;Taip;0;1;0;1
2466;Gilužis;Drugelių;9763902423;Ne;0;1;0;1
2467;Gilužis;Drugelių;1197884403;Ne;6;1;3;10
2468;Gilužis;Drugelių;6567065609;Taip;7;0;2;9
2469;Gilužis;Drugelių;1908578050;Taip;0;1;0;1
2470;Gilužis;Drugelių;6000255910;Taip;4;1;1;6
2471;Gilužis;Drugelių;96882209197;Ne;3;1;0;4
2472;Gilužis;Drugelių;79340379786;Ne;10;1;0;11
2473;Gilužis;Drugelių;6622443065;Ne;15;1;0;16
2474;Gilužis;Drugelių;1774912517;Taip;10;0;0;10
2475;Gilužis;Drugelių;80556519366;Taip;0;1;0;1
2476;Gilužis;Drugelių;1335467227;Taip;16;0;0;16
2477;Gilužis;Drugelių;2102777576;Taip;11;0;2;13
2478;Gilužis;Drugelių;82153346966;Ne;13;0;0;13
2479;Gilužis;Drugelių;7244188057;Ne;0;1;0;1
2480;Gilužis;Drugelių;93587767496;Taip;4;0;0;4
2481;Gilužis;Drugelių;55062344648;Taip;0;4;0;4
2482;Gilužis;Drugelių;2118119414;Ne;3;0;1;4
2483;Gilužis;Drugelių;82030031331;Taip;8;0;0;8
2484;Gilužis;Drugelių;7127446066;Taip;6;1;0;7
2485;Gilužis;Saulučių;17896774143;Taip;10;4;0;14
2486;Gilužis;Saulučių;9918995545;Taip;5;0;0;5
2487;Gilužis;Saulučių;4209000927;Taip;8;1;1;10
2488;Gilužis;Saulučių;8595551150;Taip;6;0;0;6
2489;Gilužis;Saulučių;4575619425;Taip;0;1;1;2
2490;Gilužis;Saulučių;8224691148;Taip;1;8;0;9
2491;Gilužis;Saulučių;4473810097;Taip;12;1;0;13
2492;Gilužis;Saulučių;1649256496;Taip;0;1;0;1
2493;Gilužis;Saulučių;96550272401;Taip;17;0;0;17
2494;Gilužis;Saulučių;69504888193;Taip;16;0;0;16
2495;Gilužis;Saulučių;2391630554;Taip;0;1;0;1
2496;Gilužis;Saulučių;18997894859;Taip;0;6;1;7
2497;Gilužis;Saulučių;7744997250;Ne;15;0;0;15
2498;Gilužis;Saulučių;32730847948;Taip;11;0;0;11
2499;Gilužis;Saulučių;3181765606;Taip;6;0;0;6
2500;Gilužis;Saulučių;5905237803;Taip;1;0;0;1
2501;Gilužis;Saulučių;2872439079;Taip;0;0;10;10
2502;Gilužis;Saulučių;28447690974;Taip;0;5;2;7
2503;Gilužis;Saulučių;87425898496;Taip;0;8;2;10
2504;Gilužis;Saulučių;35650138667;Taip;6;0;0;6
2505;Gilužis;Saulučių;9367673896;Taip;14;0;0;14
2506;Gilužis;Paukštelių;1911733577;Ne;0;1;0;1
2507;Gilužis;Paukštelių;1124568431;Ne;0;1;0;1
2508;Gilužis;Paukštelių;1120628451;Taip;0;1;0;1
2509;Gilužis;Paukštelių;1772207635;Taip;0;5;0;5
2510;Gilužis;Paukštelių;4265465127;Taip;0;1;0;1
2511;Gilužis;Paukštelių;1797199356;Taip;0;4;0;4
2512;Gilužis;Paukštelių;93844800610;Taip;0;1;0;1
2513;Gilužis;Paukštelių;92163197528;Taip;0;1;2;3
2514;Gilužis;Paukštelių;1962922981;Taip;13;0;0;13
2515;Gilužis;Paukštelių;2769830772;Taip;5;0;0;5
2516;Gilužis;Paukštelių;1259168003;Taip;0;1;0;1
2517;Gilužis;Paukštelių;91148708775;Taip;0;1;0;1
2518;Gilužis;Paukštelių;49114819476;Taip;0;5;0;5
2519;Gilužis;Paukštelių;1413931545;Taip;0;1;0;1
2520;Gilužis;Paukštelių;4754994261;Ne;1;1;0;2
2521;Gilužis;Paukštelių;49793977825;Taip;0;11;0;11
2522;Gilužis;Obuoliukų;27834192987;Taip;0;5;0;5
2523;Gilužis;Obuoliukų;1050659357;Taip;0;2;0;2
2524;Gilužis;Obuoliukų;72582220264;Taip;5;1;0;6
2525;Gilužis;Obuoliukų;1840213846;Taip;11;1;0;12
2526;Gilužis;Obuoliukų;1637726675;Taip;0;3;0;3
2527;Gilužis;Obuoliukų;1404236599;Taip;10;6;0;16
2528;Gilužis;Obuoliukų;1847232194;Taip;0;1;0;1
2529;Gilužis;Obuoliukų;93652771548;Taip;10;1;0;11
2530;Gilužis;Obuoliukų;2031851095;Taip;0;1;0;1
2531;Gilužis;Obuoliukų;8015495924;Taip;4;2;0;6
2532;Gilužis;Obuoliukų;96799037695;Taip;0;2;0;2
2533;Gilužis;Obuoliukų;2138402546;Taip;12;0;0;12
2534;Gilužis;Obuoliukų;1923605078;Taip;0;1;0;1
2535;Gilužis;Obuoliukų;1236164928;Taip;0;2;0;2
2536;Gilužis;Obuoliukų;84834458261;Taip;1;1;0;2
2537;Gilužis;Obuoliukų;5121769570;Taip;7;4;0;11
2538;Gilužis;Obuoliukų;1428994411;Taip;5;3;0;8
2539;Gilužis;Obuoliukų;5899163275;Taip;9;0;0;9
2540;Gilužis;Obuoliukų;2126527730;Taip;5;2;0;7
2541;Gilužis;Obuoliukų;53388692764;Taip;5;3;1;9
2542;Gilužis;Obuoliukų;1067512693;Taip;17;0;0;17
2543;Gilužis;KIŠKUČIŲ;1017937594;Taip;0;0;2;2
2544;Gilužis;KIŠKUČIŲ;98584480044;Taip;2;1;0;3
2545;Gilužis;KIŠKUČIŲ;1191967409;Taip;0;3;0;3
2546;Gilužis;KIŠKUČIŲ;1025400197;Taip;3;4;0;7
2547;Gilužis;KIŠKUČIŲ;1841556598;Taip;4;1;0;5
2548;Gilužis;KIŠKUČIŲ;1452016675;Taip;8;0;0;8
2549;Gilužis;KIŠKUČIŲ;24558082285;Taip;16;2;0;18
2550;Gilužis;KIŠKUČIŲ;31157032738;Taip;3;0;0;3
2551;Gilužis;KIŠKUČIŲ;69205729963;Taip;0;2;0;2
2552;Gilužis;KIŠKUČIŲ;1869058578;Taip;2;0;1;3
2553;Gilužis;KIŠKUČIŲ;1464348972;Taip;7;1;0;8
2554;Gilužis;KIŠKUČIŲ;7740703388;Taip;8;0;0;8
2555;Gilužis;KIŠKUČIŲ;1589884646;Taip;0;1;2;3
2556;Gilužis;KIŠKUČIŲ;54636558233;Taip;12;0;0;12
2557;Gilužis;KIŠKUČIŲ;1453976300;Taip;0;1;0;1
2558;Gilužis;KIŠKUČIŲ;57074114440;Taip;0;15;0;15
2559;Gilužis;KIŠKUČIŲ;15192433393;Taip;0;5;0;5
2560;Gilužis;KIŠKUČIŲ;1307302669;Taip;0;4;1;5
2561;Gilužis;KIŠKUČIŲ;1569805585;Taip;14;0;0;14
2562;Gilužis;KIŠKUČIŲ;1211233315;Taip;6;0;0;6
2563;Gilužis;Meškučių;5008795520;Taip;0;5;0;5
2564;Gilužis;Meškučių;82153247890;Taip;0;1;0;1
2565;Gilužis;Meškučių;9104396905;Taip;4;0;0;4
2566;Gilužis;Meškučių;15672746324;Taip;0;1;0;1
2567;Gilužis;Meškučių;8278207628;Ne;0;1;0;1
2568;Gilužis;Meškučių;5988529284;Taip;6;0;0;6
2569;Gilužis;Meškučių;2144919007;Taip;0;1;0;1
2570;Gilužis;Meškučių;6840555273;Taip;0;13;0;13
2571;Gilužis;Meškučių;2111997678;Taip;0;2;0;2
2572;Gilužis;Meškučių;1664140841;Ne;7;0;0;7
2573;Gilužis;Meškučių;1201973661;Taip;12;7;0;19
2574;Gilužis;Meškučių;99889836604;Taip;0;5;0;5
2575;Gilužis;Meškučių;93541096118;Taip;0;1;0;1
2576;Gilužis;Meškučių;41791785706;Ne;0;21;0;21
2577;Gilužis;Meškučių;3104707033;Ne;0;8;0;8
2578;Gilužis;Meškučių;3884351522;Ne;0;4;0;4
2579;Gilužis;Meškučių;48400196395;Taip;3;0;0;3
2580;Gilužis;Meškučių;57285847418;Taip;12;2;0;14
2581;Gilužis;Meškučių;37771334557;Taip;0;12;0;12
2582;Gilužis;Meškučių;3451034791;Ne;0;7;0;7
2583;Gilužis;Meškučių;1642252063;Taip;0;1;0;1
2584;Gilužis;Pagrandukai;6966795180;Taip;1;0;0;1
2585;Gilužis;Pagrandukai;7330938312;Taip;16;0;0;16
2586;Gilužis;Pagrandukai;6571132974;Taip;0;21;0;21
2587;Gilužis;Pagrandukai;7731169885;Taip;0;1;0;1
2588;Gilužis;Pagrandukai;1582241363;Taip;15;0;0;15
2589;Gilužis;Pagrandukai;8244385001;Taip;1;0;0;1
2590;Gilužis;Pagrandukai;4978922821;Taip;10;1;0;11
2591;Gilužis;Pagrandukai;2945406185;Taip;10;0;0;10
2592;Gilužis;Pagrandukai;9034842169;Taip;2;0;0;2
2593;Gilužis;Pagrandukai;7001112696;Taip;10;0;0;10
2594;Gilužis;Pagrandukai;8318405114;Taip;7;1;0;8
2595;Gilužis;Pagrandukai;6786334223;Taip;3;0;0;3
2596;Gilužis;Pagrandukai;1093643746;Taip;0;2;0;2
2597;Gilužis;Pagrandukai;6429142049;Taip;9;0;0;9
2598;Gilužis;Boružėlių;9421351780;Taip;9;0;1;10
2599;Gilužis;Boružėlių;5973671038;Taip;6;0;0;6
2600;Gilužis;Boružėlių;3399162399;Taip;6;0;0;6
2601;Gilužis;Boružėlių;4360261750;Taip;0;0;7;7
2602;Gilužis;Boružėlių;1634295583;Taip;0;0;6;6
2603;Gilužis;Boružėlių;6404411477;Taip;7;0;0;7
2604;Gilužis;Boružėlių;9186274541;Taip;18;0;0;18
2605;Gilužis;Boružėlių;6121625070;Taip;0;2;0;2
2606;Gilužis;Boružėlių;3419281756;Taip;12;0;1;13
2607;Gilužis;Boružėlių;4403218878;Taip;0;1;0;1
2608;Gilužis;Boružėlių;9097165155;Taip;6;0;0;6
2609;Gilužis;Boružėlių;1862524255;Taip;6;2;0;8
2610;Gilužis;Boružėlių;6960673767;Taip;1;2;0;3
2611;Gilužis;Boružėlių;5728341732;Taip;14;0;0;14
2612;Gilužis;Boružėlių;4841014668;Taip;13;0;0;13
2613;Gilužis;Boružėlių;2585736095;Ne;15;0;1;16
2614;Gilužis;Boružėlių;7826015897;Taip;10;2;0;12
2615;Gintarėlis;PAPŪGĖLĖS;8498936096;Taip;0;3;0;3
2616;Gintarėlis;PAPŪGĖLĖS;8913652291;Taip;0;11;0;11
2617;Gintarėlis;PAPŪGĖLĖS;2485750596;Taip;6;6;0;12
2618;Gintarėlis;PAPŪGĖLĖS;1033624080;Ne;0;13;0;13
2619;Gintarėlis;PAPŪGĖLĖS;2919700367;Ne;0;21;0;21
2620;Gintarėlis;PAPŪGĖLĖS;1768789948;Taip;4;1;0;5
2621;Gintarėlis;PAPŪGĖLĖS;2595566032;Taip;0;3;0;3
2622;Gintarėlis;PAPŪGĖLĖS;9141438560;Taip;0;5;0;5
2623;Gintarėlis;PAPŪGĖLĖS;2235045173;Taip;0;14;0;14
2624;Gintarėlis;PAPŪGĖLĖS;9494521554;Taip;0;12;0;12
2625;Gintarėlis;PAPŪGĖLĖS;7494884360;Taip;0;5;0;5
2626;Gintarėlis;PAPŪGĖLĖS;7147842224;Taip;0;17;0;17
2627;Gintarėlis;PAPŪGĖLĖS;9648982613;Taip;4;1;0;5
2628;Gintarėlis;PAPŪGĖLĖS;5783939567;Ne;3;1;0;4
2629;Gintarėlis;PAPŪGĖLĖS;7674351459;Taip;0;2;0;2
2630;Gintarėlis;PAPŪGĖLĖS;6292664833;Taip;0;17;0;17
2631;Gintarėlis;PAPŪGĖLĖS;8610886062;Taip;0;7;0;7
2632;Gintarėlis;PAPŪGĖLĖS;5811396263;Taip;0;9;0;9
2633;Gintarėlis;PAPŪGĖLĖS;4904966263;Taip;0;17;0;17
2634;Gintarėlis;PAPŪGĖLĖS;1648843117;Ne;0;8;0;8
2635;Gintarėlis;PAPŪGĖLĖS;1861324153;Taip;0;6;0;6
2636;Gintarėlis;PAPŪGĖLĖS;3457974670;Taip;0;18;0;18
2637;Gintarėlis;PAPŪGĖLĖS;9382662838;Taip;10;1;0;11
2638;Gintarėlis;SPINDULIUKAI;96694096944;Taip;0;5;0;5
2639;Gintarėlis;SPINDULIUKAI;88552701503;Taip;0;1;0;1
2640;Gintarėlis;SPINDULIUKAI;65950042767;Taip;0;1;0;1
2641;Gintarėlis;SPINDULIUKAI;33863655816;Ne;0;3;0;3
2642;Gintarėlis;SPINDULIUKAI;11384063236;Taip;0;4;0;4
2643;Gintarėlis;SPINDULIUKAI;8112379741;Ne;0;5;0;5
2644;Gintarėlis;SPINDULIUKAI;37848651606;Taip;0;18;0;18
2645;Gintarėlis;SPINDULIUKAI;56701557907;Ne;0;13;0;13
2646;Gintarėlis;SPINDULIUKAI;77140073438;Taip;5;1;0;6
2647;Gintarėlis;SPINDULIUKAI;92436759875;Taip;0;1;0;1
2648;Gintarėlis;SPINDULIUKAI;1360843628;Taip;0;6;0;6
2649;Gintarėlis;SPINDULIUKAI;63037561278;Taip;0;2;0;2
2650;Gintarėlis;SPINDULIUKAI;92996401082;Taip;0;2;0;2
2651;Gintarėlis;SPINDULIUKAI;19506557567;Ne;0;8;0;8
2652;Gintarėlis;SPINDULIUKAI;24915581271;Taip;0;11;0;11
2653;Gintarėlis;SPINDULIUKAI;18222675927;Ne;5;1;0;6
2654;Gintarėlis;SPINDULIUKAI;3035023250;Taip;9;1;0;10
2655;Gintarėlis;SPINDULIUKAI;99077732058;Taip;0;1;0;1
2656;Gintarėlis;GAIDŽIUKAI;29645999843;Taip;0;15;0;15
2657;Gintarėlis;GAIDŽIUKAI;45480802894;Taip;0;4;0;4
2658;Gintarėlis;GAIDŽIUKAI;1539226211;Taip;0;9;0;9
2659;Gintarėlis;GAIDŽIUKAI;2043878016;Taip;0;8;0;8
2660;Gintarėlis;GAIDŽIUKAI;90891401453;Taip;0;2;0;2
2661;Gintarėlis;GAIDŽIUKAI;1770479969;Taip;0;4;0;4
2662;Gintarėlis;GAIDŽIUKAI;53971205498;Taip;0;1;0;1
2663;Gintarėlis;GAIDŽIUKAI;1441282039;Taip;0;12;0;12
2664;Gintarėlis;GAIDŽIUKAI;5835437020;Ne;0;7;0;7
2665;Gintarėlis;GAIDŽIUKAI;1076400051;Taip;0;4;0;4
2666;Gintarėlis;GAIDŽIUKAI;4660581415;Taip;0;4;0;4
2667;Gintarėlis;GAIDŽIUKAI;3794027499;Taip;0;10;0;10
2668;Gintarėlis;GAIDŽIUKAI;9234476307;Taip;0;1;0;1
2669;Gintarėlis;GAIDŽIUKAI;8206947475;Taip;0;21;0;21
2670;Gintarėlis;GAIDŽIUKAI;5916948150;Ne;0;21;0;21
2671;Gintarėlis;MEŠKUČIAI;84375225995;Taip;0;1;0;1
2672;Gintarėlis;MEŠKUČIAI;29331294396;Taip;0;7;0;7
2673;Gintarėlis;MEŠKUČIAI;1230510614;Taip;0;1;0;1
2674;Gintarėlis;MEŠKUČIAI;33786299764;Taip;0;5;0;5
2675;Gintarėlis;MEŠKUČIAI;12332079305;Taip;0;6;0;6
2676;Gintarėlis;MEŠKUČIAI;86948612054;Taip;0;3;0;3
2677;Gintarėlis;MEŠKUČIAI;28514742083;Taip;0;12;0;12
2678;Gintarėlis;MEŠKUČIAI;8518137062;Taip;6;3;0;9
2679;Gintarėlis;MEŠKUČIAI;25360163411;Taip;0;14;0;14
2680;Gintarėlis;MEŠKUČIAI;1943647795;Ne;0;10;0;10
2681;Gintarėlis;MEŠKUČIAI;61739452519;Taip;0;3;0;3
2682;Gintarėlis;MEŠKUČIAI;2529363136;Taip;0;8;0;8
2683;Gintarėlis;MEŠKUČIAI;10771368524;Taip;0;4;0;4
2684;Gintarėlis;MEŠKUČIAI;47480197789;Taip;5;1;0;6
2685;Gintarėlis;MEŠKUČIAI;36019373990;Ne;0;3;0;3
2686;Gintarėlis;MEŠKUČIAI;76302896259;Taip;0;2;0;2
2687;Gintarėlis;DRUGELIAI;2127877544;Ne;0;4;0;4
2688;Gintarėlis;DRUGELIAI;14840692502;Ne;0;5;0;5
2689;Gintarėlis;DRUGELIAI;1462949250;Ne;11;8;0;19
2690;Gintarėlis;DRUGELIAI;9737200226;Taip;0;2;0;2
2691;Gintarėlis;DRUGELIAI;6655809299;Taip;0;14;0;14
2692;Gintarėlis;DRUGELIAI;2614258442;Taip;0;13;0;13
2693;Gintarėlis;DRUGELIAI;1452402931;Ne;0;9;0;9
2694;Gintarėlis;DRUGELIAI;4217329880;Ne;0;1;0;1
2695;Gintarėlis;DRUGELIAI;1759217543;Taip;0;12;0;12
2696;Gintarėlis;DRUGELIAI;7571352126;Taip;0;21;0;21
2697;Gintarėlis;DRUGELIAI;50896429585;Taip;0;6;0;6
2698;Gintarėlis;DRUGELIAI;1042222561;Taip;0;12;0;12
2699;Gintarėlis;DRUGELIAI;1331684725;Ne;0;1;0;1
2700;Gintarėlis;DRUGELIAI;9687974376;Taip;0;15;0;15
2701;Gintarėlis;DRUGELIAI;8704248985;Taip;0;2;0;2
2702;Gintarėlis;DRUGELIAI;8419453060;Taip;0;1;0;1
2703;Gintarėlis;DRUGELIAI;6655645997;Taip;0;21;0;21
2704;Gintarėlis;DRUGELIAI;6080108998;Taip;0;21;0;21
2705;Gintarėlis;DRUGELIAI;7449437199;Taip;0;9;0;9
2706;Gintarėlis;DRUGELIAI;4076421692;Ne;0;2;0;2
2707;Gintarėlis;DRUGELIAI;2016067859;Taip;0;3;0;3
2708;Gintarėlis;DRUGELIAI;5355691986;Taip;0;3;0;3
2709;Gintarėlis;DRUGELIAI;8116557698;Taip;0;6;0;6
2710;Gintarėlis;DRUGELIAI;6898320582;Ne;0;11;0;11
2711;Gintarėlis;KAČIUKAI;5451653510;Taip;0;4;0;4
2712;Gintarėlis;KAČIUKAI;9903314418;Taip;0;12;0;12
2713;Gintarėlis;KAČIUKAI;63243392161;Taip;0;2;0;2
2714;Gintarėlis;KAČIUKAI;37612987791;Taip;0;2;0;2
2715;Gintarėlis;KAČIUKAI;26259581924;Taip;0;14;0;14
2716;Gintarėlis;KAČIUKAI;70787488885;Ne;0;3;0;3
2717;Gintarėlis;KAČIUKAI;31365533022;Ne;0;1;0;1
2718;Gintarėlis;KAČIUKAI;50715082496;Taip;0;1;0;1
2719;Gintarėlis;KAČIUKAI;1159773367;Taip;0;8;0;8
2720;Gintarėlis;KAČIUKAI;2050020230;Taip;0;4;0;4
2721;Gintarėlis;KAČIUKAI;54145290842;Taip;0;20;0;20
2722;Gintarėlis;KAČIUKAI;19813827223;Ne;0;3;0;3
2723;Gintarėlis;KAČIUKAI;98684742007;Ne;0;21;0;21
2724;Gintarėlis;KAČIUKAI;2000986290;Taip;0;11;0;11
2725;Gintarėlis;KAČIUKAI;6421537455;Ne;0;10;0;10
2726;Gintarėlis;KAČIUKAI;1595816431;Taip;0;7;0;7
2727;Gintarėlis;KAČIUKAI;30446888177;Taip;0;1;0;1
2728;Gintarėlis;KAČIUKAI;63221497564;Taip;0;8;0;8
2729;Gintarėlis;KAČIUKAI;58701768194;Taip;0;3;0;3
2730;Gintarėlis;KAČIUKAI;29480359781;Ne;0;11;0;11
2731;Gintarėlis;KAČIUKAI;7610677403;Ne;0;2;0;2
2732;Gintarėlis;KIŠKUČIAI;8665467175;Taip;0;13;0;13
2733;Gintarėlis;KIŠKUČIAI;83754732536;Taip;0;12;0;12
2734;Gintarėlis;KIŠKUČIAI;89051269756;Ne;0;3;0;3
2735;Gintarėlis;KIŠKUČIAI;1593455162;Taip;0;3;0;3
2736;Gintarėlis;KIŠKUČIAI;2043405414;Taip;0;3;0;3
2737;Gintarėlis;KIŠKUČIAI;3828845515;Taip;0;3;0;3
2738;Gintarėlis;KIŠKUČIAI;1069395570;Taip;0;2;0;2
2739;Gintarėlis;KIŠKUČIAI;19402011412;Taip;0;1;0;1
2740;Gintarėlis;KIŠKUČIAI;96211766919;Taip;0;1;0;1
2741;Gintarėlis;KIŠKUČIAI;78697777550;Taip;0;1;0;1
2742;Gintarėlis;KIŠKUČIAI;85557344192;Taip;0;3;0;3
2743;Gintarėlis;KIŠKUČIAI;2970527490;Ne;0;7;0;7
2744;Gintarėlis;KIŠKUČIAI;4279681763;Taip;3;1;0;4
2745;Gintarėlis;KIŠKUČIAI;2032900352;Taip;0;9;0;9
2746;Gintarėlis;KIŠKUČIAI;3292572563;Taip;0;20;0;20
2747;Gintarėlis;KIŠKUČIAI;1543013649;Taip;0;16;0;16
2748;Gintarėlis;KIŠKUČIAI;24774460882;Ne;0;2;0;2
2749;Gintarėlis;KIŠKUČIAI;1028456578;Taip;0;12;0;12
2750;Gintarėlis;VYTURIUKAI;1553747935;Taip;0;10;0;10
2751;Gintarėlis;VYTURIUKAI;22394648690;Taip;0;11;0;11
2752;Gintarėlis;VYTURIUKAI;4902086873;Taip;0;11;0;11
2753;Gintarėlis;VYTURIUKAI;56124970238;Taip;0;1;0;1
2754;Gintarėlis;VYTURIUKAI;34606130829;Taip;0;19;0;19
2755;Gintarėlis;VYTURIUKAI;18715625324;Ne;0;10;0;10
2756;Gintarėlis;VYTURIUKAI;1191846491;Taip;0;1;0;1
2757;Gintarėlis;VYTURIUKAI;9740239182;Taip;0;7;0;7
2758;Gintarėlis;VYTURIUKAI;8405210216;Ne;0;8;0;8
2759;Gintarėlis;VYTURIUKAI;2721386855;Taip;0;1;0;1
2760;Gintarėlis;BORUŽĖLĖS;4971574875;Taip;0;2;0;2
2761;Gintarėlis;BORUŽĖLĖS;6277010268;Taip;0;13;0;13
2762;Gintarėlis;BORUŽĖLĖS;1771868868;Ne;0;11;0;11
2763;Gintarėlis;BORUŽĖLĖS;39372328122;Taip;0;10;0;10
2764;Gintarėlis;BORUŽĖLĖS;25451522701;Taip;0;12;0;12
2765;Gintarėlis;BORUŽĖLĖS;90216120878;Taip;0;19;0;19
2766;Gintarėlis;BORUŽĖLĖS;1929900615;Taip;0;5;0;5
2767;Gintarėlis;BORUŽĖLĖS;82344200095;Taip;0;7;0;7
2768;Gintarėlis;BORUŽĖLĖS;1168158494;Taip;0;5;0;5
2769;Gintarėlis;BORUŽĖLĖS;9255623049;Taip;0;21;0;21
2770;Gintarėlis;BORUŽĖLĖS;88451515187;Taip;0;4;0;4
2771;Gintarėlis;BORUŽĖLĖS;7703150488;Taip;0;1;0;1
2772;Gintarėlis;BORUŽĖLĖS;2145479870;Taip;0;6;0;6
2773;Gintarėlis;BORUŽĖLĖS;49506158711;Taip;0;7;0;7
2774;Gintarėlis;BORUŽĖLĖS;30066476338;Taip;0;4;0;4
2775;Gintarėlis;BORUŽĖLĖS;63146841406;Taip;0;21;0;21
2776;Gintarėlis;BORUŽĖLĖS;30334064319;Taip;0;18;0;18
2777;Gintarėlis;BORUŽĖLĖS;6426075546;Taip;0;4;0;4
2778;Gintarėlis;BORUŽĖLĖS;91798408335;Taip;0;8;0;8
2779;Gintarėlis;BORUŽĖLĖS;25684002087;Taip;0;21;0;21
2780;Gintarėlis;BORUŽĖLĖS;10826255781;Taip;0;11;0;11
2781;Gintarėlis;BORUŽĖLĖS;1505703905;Taip;0;12;0;12
2782;Gintarėlis;EŽIUKAI;1793785936;Taip;0;2;0;2
2783;Gintarėlis;EŽIUKAI;27890184523;Taip;0;3;0;3
2784;Gintarėlis;EŽIUKAI;1841482183;Taip;0;1;0;1
2785;Gintarėlis;EŽIUKAI;8074941282;Taip;0;2;0;2
2786;Gintarėlis;EŽIUKAI;2040989572;Taip;0;18;0;18
2787;Gintarėlis;EŽIUKAI;18008015227;Taip;0;6;0;6
2788;Gintarėlis;EŽIUKAI;1672037617;Taip;0;10;0;10
2789;Gintarėlis;EŽIUKAI;51418692259;Taip;0;2;0;2
2790;Gintarėlis;EŽIUKAI;1398810524;Taip;0;11;0;11
2791;Gintarėlis;EŽIUKAI;74295947670;Taip;0;1;0;1
2792;Gintarėlis;EŽIUKAI;52644122529;Taip;0;2;0;2
2793;Gintarėlis;EŽIUKAI;2732338838;Taip;0;5;0;5
2794;Gintarėlis;EŽIUKAI;7731823367;Taip;0;7;0;7
2795;Gintarėlis;EŽIUKAI;7053099543;Taip;0;7;0;7
2796;Gintarėlis;EŽIUKAI;56834651967;Taip;0;21;0;21
2797;Gintarėlis;EŽIUKAI;13416505188;Taip;3;5;0;8
2798;Gintarėlis;EŽIUKAI;36350623756;Taip;0;1;0;1
2799;Gintarėlis;EŽIUKAI;96404879029;Taip;0;1;0;1
2800;Gintarėlis;EŽIUKAI;1725007540;Ne;0;2;0;2
2801;Gintarėlis;VIŠČIUKAI;5436695400;Ne;0;10;0;10
2802;Gintarėlis;VIŠČIUKAI;5921751507;Taip;0;18;0;18
2803;Gintarėlis;VIŠČIUKAI;2212296954;Taip;0;21;0;21
2804;Gintarėlis;VIŠČIUKAI;9963329170;Taip;0;7;0;7
2805;Gintarėlis;VIŠČIUKAI;5569843168;Taip;0;5;0;5
2806;Gintarėlis;VIŠČIUKAI;3665764153;Taip;0;21;0;21
2807;Gintarėlis;VIŠČIUKAI;9774056578;Taip;0;21;0;21
2808;Gintarėlis;VIŠČIUKAI;3825700024;Taip;0;13;0;13
2809;Gintarėlis;VIŠČIUKAI;7057877483;Taip;0;13;0;13
2810;Gintarėlis;VIŠČIUKAI;7875981690;Taip;0;21;0;21
2811;Gintarėlis;VIŠČIUKAI;2544338275;Taip;0;21;0;21
2812;Gintarėlis;VIŠČIUKAI;7182964126;Taip;0;7;0;7
2813;Gintarėlis;VIŠČIUKAI;4754929282;Taip;0;7;0;7
2814;Gintarėlis;VIŠČIUKAI;1011749698;Taip;0;19;0;19
2815;Gintarėlis;VIŠČIUKAI;8261770154;Taip;0;16;0;16
2816;Gintarėlis;VIŠČIUKAI;8547544537;Taip;0;8;0;8
2817;Gintarėlis;VIŠČIUKAI;4976069028;Taip;0;8;0;8
2818;Gintarėlis;VIŠČIUKAI;8375475174;Taip;0;2;0;2
2819;Gintarėlis;VIŠČIUKAI;7061545258;Taip;0;11;0;11
2820;Gintarėlis;"SAULĖS ZUIKUČIAI";8287685690;Taip;0;8;0;8
2821;Gintarėlis;"SAULĖS ZUIKUČIAI";6914904213;Taip;0;1;0;1
2822;Gintarėlis;"SAULĖS ZUIKUČIAI";1696337909;Taip;0;1;0;1
2823;Gintarėlis;"SAULĖS ZUIKUČIAI";1778573935;Taip;0;3;0;3
2824;Gintarėlis;"SAULĖS ZUIKUČIAI";5796729245;Taip;0;13;0;13
2825;Gintarėlis;"SAULĖS ZUIKUČIAI";9915887420;Taip;0;13;0;13
2826;Gintarėlis;"SAULĖS ZUIKUČIAI";3398936974;Ne;0;15;0;15
2827;Gintarėlis;"SAULĖS ZUIKUČIAI";5153948767;Taip;0;5;0;5
2828;Gintarėlis;"SAULĖS ZUIKUČIAI";9675201979;Taip;0;2;0;2
2829;Gintarėlis;"SAULĖS ZUIKUČIAI";7971810025;Ne;0;19;0;19
2830;Gintarėlis;"SAULĖS ZUIKUČIAI";2814569415;Ne;0;11;0;11
2831;Gintarėlis;"SAULĖS ZUIKUČIAI";6862629244;Ne;0;16;0;16
2832;Gintarėlis;"SAULĖS ZUIKUČIAI";9279399214;Taip;0;1;0;1
2833;Gintarėlis;"SAULĖS ZUIKUČIAI";8000297636;Taip;0;21;0;21
2834;Gintarėlis;"SAULĖS ZUIKUČIAI";6142819210;Taip;0;7;0;7
2835;Gintarėlis;"SAULĖS ZUIKUČIAI";3359584322;Taip;0;7;0;7
2836;Gintarėlis;"SAULĖS ZUIKUČIAI";7815317644;Taip;0;5;0;5
2837;Gintarėlis;"SAULĖS ZUIKUČIAI";3814485627;Taip;0;13;0;13
2838;Gintarėlis;"SAULĖS ZUIKUČIAI";3921015919;Taip;0;1;0;1
2839;Gintarėlis;"SAULĖS ZUIKUČIAI";2165332442;Taip;0;18;0;18
2840;Gintarėlis;"SAULĖS ZUIKUČIAI";5919205817;Taip;0;7;0;7
2841;Gintarėlis;"SAULĖS ZUIKUČIAI";1571260478;Ne;0;21;0;21
2842;Giraitė;Aviliukas;62525988158;Taip;11;0;0;11
2843;Giraitė;Aviliukas;68804588518;Taip;2;8;0;10
2844;Giraitė;Aviliukas;809734624;Taip;6;2;0;8
2845;Giraitė;Aviliukas;44396075745;Taip;1;0;0;1
2846;Giraitė;Aviliukas;42330865487;Taip;2;0;0;2
2847;Giraitė;Aviliukas;34957067197;Taip;0;1;0;1
2848;Giraitė;Aviliukas;39627499338;Taip;0;1;0;1
2849;Giraitė;Aviliukas;86412433313;Ne;3;0;1;4
2850;Giraitė;Aviliukas;10778161174;Taip;0;3;0;3
2851;Giraitė;Aviliukas;94618756885;Taip;0;1;0;1
2852;Giraitė;Aviliukas;6449275481;Taip;2;0;0;2
2853;Giraitė;Aviliukas;37348466498;Taip;4;1;0;5
2854;Giraitė;Aviliukas;12568042778;Taip;5;0;0;5
2855;Giraitė;Aviliukas;24903085449;Taip;0;3;0;3
2856;Giraitė;Aviliukas;7868564343;Taip;0;5;0;5
2857;Giraitė;Aviliukas;5038998112;Ne;5;2;1;8
2858;Giraitė;Aviliukas;8423424896;Taip;0;4;0;4
2859;Giraitė;LapiukaI;6141730004;Taip;17;0;0;17
2860;Giraitė;LapiukaI;6325909670;Taip;1;0;0;1
2861;Giraitė;LapiukaI;7831526566;Taip;16;0;0;16
2862;Giraitė;LapiukaI;2740656695;Taip;9;0;0;9
2863;Giraitė;LapiukaI;5030697729;Taip;9;0;0;9
2864;Giraitė;LapiukaI;1921430434;Ne;11;0;0;11
2865;Giraitė;LapiukaI;5006156109;Taip;3;3;0;6
2866;Giraitė;LapiukaI;2393713210;Taip;12;0;0;12
2867;Giraitė;LapiukaI;4663343304;Taip;6;0;1;7
2868;Giraitė;LapiukaI;5382004098;Taip;6;0;0;6
2869;Giraitė;LapiukaI;9768754737;Ne;4;0;2;6
2870;Giraitė;LapiukaI;4296449093;Taip;0;2;0;2
2871;Giraitė;LapiukaI;1974159110;Taip;5;1;0;6
2872;Giraitė;LapiukaI;7428833348;Taip;3;0;1;4
2873;Giraitė;LapiukaI;8376809208;Taip;12;0;0;12
2874;Giraitė;LapiukaI;5532639133;Taip;12;1;0;13
2875;Giraitė;LapiukaI;4076402180;Taip;2;0;0;2
2876;Giraitė;LapiukaI;5902161665;Taip;8;0;0;8
2877;Giraitė;LapiukaI;4955786826;Taip;6;2;0;8
2878;Giraitė;LapiukaI;4260343903;Taip;13;0;0;13
2879;Giraitė;Voveriukai;7354834895;Taip;0;0;5;5
2880;Giraitė;Voveriukai;4387282125;Taip;7;1;0;8
2881;Giraitė;Voveriukai;2699984170;Taip;7;3;0;10
2882;Giraitė;Voveriukai;6265908751;Taip;0;0;1;1
2883;Giraitė;Voveriukai;4822168634;Taip;5;0;0;5
2884;Giraitė;Voveriukai;2074303013;Taip;0;1;1;2
2885;Giraitė;Voveriukai;6963656869;Ne;0;2;5;7
2886;Giraitė;Voveriukai;3875214088;Taip;9;3;0;12
2887;Giraitė;Voveriukai;5202562049;Ne;10;0;0;10
2888;Giraitė;Voveriukai;7441871219;Taip;0;1;0;1
2889;Giraitė;Voveriukai;7481895278;Taip;6;0;2;8
2890;Giraitė;Voveriukai;3607198556;Taip;0;1;1;2
2891;Giraitė;Voveriukai;1945918102;Ne;3;6;0;9
2892;Giraitė;Voveriukai;8799195526;Taip;0;0;3;3
2893;Giraitė;Voveriukai;6225092500;Taip;0;0;1;1
2894;Giraitė;Voveriukai;4137699629;Taip;7;0;1;8
2895;Giraitė;Voveriukai;4932174149;Taip;0;1;0;1
2896;Giraitė;Voveriukai;3896789232;Taip;8;1;0;9
2897;Giraitė;Voveriukai;7919088987;Taip;6;6;0;12
2898;Giraitė;Voveriukai;5616242311;Taip;3;0;3;6
2899;Giraitė;Voveriukai;7739516049;Ne;4;0;0;4
2900;Giraitė;Grybukai;61477798910;Ne;0;1;0;1
2901;Giraitė;Grybukai;83995022535;Taip;0;1;1;2
2902;Giraitė;Grybukai;70668076883;Taip;0;1;3;4
2903;Giraitė;Grybukai;482311593;Taip;9;0;0;9
2904;Giraitė;Grybukai;1313395982;Ne;0;3;0;3
2905;Giraitė;Grybukai;19218675078;Ne;0;3;1;4
2906;Giraitė;Grybukai;20082610200;Ne;0;1;0;1
2907;Giraitė;Grybukai;2816941652;Ne;0;0;1;1
2908;Giraitė;Grybukai;98106730833;Taip;0;2;1;3
2909;Giraitė;Grybukai;10070775660;Taip;0;3;0;3
2910;Giraitė;Grybukai;10108398683;Taip;0;7;0;7
2911;Giraitė;Grybukai;6159111262;Taip;0;2;0;2
2912;Giraitė;Grybukai;5824936903;Taip;5;0;0;5
2913;Giraitė;Grybukai;1458304464;Taip;0;10;1;11
2914;Giraitė;Grybukai;68502311448;Taip;0;1;0;1
2915;Giraitė;Grybukai;2107606245;Taip;0;1;0;1
2916;Giraitė;Grybukai;1965752607;Taip;0;1;2;3
2917;Giraitė;Grybukai;48623826572;Taip;1;0;0;1
2918;Giraitė;Grybukai;70629522964;Ne;0;3;1;4
2919;Giraitė;Riešutėliai;3683700626;Taip;3;2;2;7
2920;Giraitė;Riešutėliai;8596389737;Taip;0;1;3;4
2921;Giraitė;Riešutėliai;5167002022;Taip;0;0;4;4
2922;Giraitė;Riešutėliai;2425354598;Taip;0;0;4;4
2923;Giraitė;Riešutėliai;9495968363;Taip;5;0;0;5
2924;Giraitė;Riešutėliai;1253151830;Taip;5;0;0;5
2925;Giraitė;Riešutėliai;5892950503;Taip;5;7;0;12
2926;Giraitė;Riešutėliai;4336519836;Taip;8;0;0;8
2927;Giraitė;Riešutėliai;9026736929;Taip;16;0;0;16
2928;Giraitė;Riešutėliai;9882372025;Taip;9;0;1;10
2929;Giraitė;Riešutėliai;23319979302;Taip;0;16;0;16
2930;Giraitė;Riešutėliai;4785524898;Taip;0;6;0;6
2931;Giraitė;Riešutėliai;4839351300;Taip;14;2;1;17
2932;Giraitė;Riešutėliai;1817075429;Taip;0;0;1;1
2933;Giraitė;Riešutėliai;6836412890;Taip;2;0;0;2
2934;Giraitė;Riešutėliai;4687228561;Taip;6;3;4;13
2935;Giraitė;Meškiukai;27501094616;Taip;3;7;1;11
2936;Giraitė;Meškiukai;2513312448;Taip;6;1;0;7
2937;Giraitė;Meškiukai;5367392810;Taip;6;4;0;10
2938;Giraitė;Meškiukai;1608876140;Taip;3;1;0;4
2939;Giraitė;Meškiukai;5461837332;Taip;6;2;1;9
2940;Giraitė;Meškiukai;1355594003;Taip;9;1;0;10
2941;Giraitė;Meškiukai;1050699551;Taip;7;0;0;7
2942;Giraitė;Meškiukai;1876815077;Ne;0;0;1;1
2943;Giraitė;Meškiukai;1063628206;Taip;0;1;0;1
2944;Giraitė;Meškiukai;1318214394;Taip;0;6;0;6
2945;Giraitė;Meškiukai;65251975467;Taip;0;4;0;4
2946;Giraitė;Meškiukai;1704154980;Taip;7;0;1;8
2947;Giraitė;Meškiukai;1819657811;Taip;1;1;0;2
2948;Giraitė;Meškiukai;1512384599;Taip;0;1;0;1
2949;Giraitė;Meškiukai;2571892050;Taip;5;1;1;7
2950;Giraitė;Meškiukai;5544613599;Taip;0;0;12;12
2951;Giraitė;Meškiukai;6156715234;Taip;5;0;0;5
2952;Giraitė;Meškiukai;1594965200;Taip;0;0;2;2
2953;Giraitė;Meškiukai;9723242940;Taip;7;1;0;8
2954;Giraitė;Meškiukai;5726182600;Taip;8;0;0;8
2955;Giraitė;Meškiukai;1772790396;Ne;11;0;1;12
2956;Giraitė;Uogelės;3031181239;Taip;0;7;0;7
2957;Giraitė;Uogelės;99494458394;Taip;0;3;0;3
2958;Giraitė;Uogelės;1103462199;Taip;0;1;0;1
2959;Giraitė;Uogelės;1447893912;Taip;0;2;0;2
2960;Giraitė;Uogelės;49193108666;Ne;3;7;0;10
2961;Giraitė;Uogelės;31110630088;Taip;0;1;0;1
2962;Giraitė;Uogelės;1312761239;Taip;10;0;0;10
2963;Giraitė;Uogelės;43475840493;Taip;0;1;0;1
2964;Giraitė;Uogelės;30804922053;Taip;0;5;0;5
2965;Giraitė;Uogelės;2083472940;Taip;16;0;0;16
2966;Giraitė;Uogelės;1848908894;Taip;3;1;0;4
2967;Giraitė;Uogelės;5378240128;Taip;0;11;0;11
2968;Giraitė;Uogelės;74256775397;Ne;0;0;1;1
2969;Giraitė;Uogelės;65392345188;Taip;0;1;0;1
2970;Giraitė;Uogelės;8824642760;Taip;3;0;0;3
2971;Giraitė;Uogelės;1110792632;Taip;1;9;0;10
2972;Giraitė;Šaltinėlis;66760677758;Taip;0;0;1;1
2973;Giraitė;Šaltinėlis;33507817372;Taip;0;0;1;1
2974;Giraitė;Šaltinėlis;94197982724;Taip;0;5;0;5
2975;Giraitė;Šaltinėlis;22783526738;Taip;4;0;0;4
2976;Giraitė;Šaltinėlis;79459838218;Taip;0;1;0;1
2977;Giraitė;Šaltinėlis;1690407683;Taip;4;0;1;5
2978;Giraitė;Šaltinėlis;89948210310;Taip;2;4;0;6
2979;Giraitė;Šaltinėlis;26202357668;Taip;0;3;1;4
2980;Giraitė;Šaltinėlis;260305509;Taip;0;6;1;7
2981;Giraitė;Šaltinėlis;8986196352;Ne;0;1;0;1
2982;Giraitė;Šaltinėlis;9710265790;Taip;0;2;0;2
2983;Giraitė;Šaltinėlis;9493194946;Taip;0;2;0;2
2984;Giraitė;Šaltinėlis;17883856522;Taip;2;1;0;3
2985;Giraitė;Šaltinėlis;84373081236;Taip;5;0;0;5
2986;Giraitė;Šaltinėlis;1285310492;Taip;2;6;0;8
2987;Giraitė;Šaltinėlis;42953220489;Ne;4;3;0;7
2988;Giraitė;Šaltinėlis;1284187551;Taip;0;1;0;1
2989;Giraitė;Šaltinėlis;1533533163;Taip;0;0;3;3
2990;Giraitė;Boružėlės;5471577047;Taip;5;0;0;5
2991;Giraitė;Boružėlės;2307307454;Taip;18;0;0;18
2992;Giraitė;Boružėlės;9931533006;Taip;4;0;0;4
2993;Giraitė;Boružėlės;2102237550;Ne;13;0;0;13
2994;Giraitė;Boružėlės;1729871315;Taip;18;0;0;18
2995;Giraitė;Boružėlės;4121361794;Taip;7;0;1;8
2996;Giraitė;Boružėlės;6065010363;Taip;4;0;0;4
2997;Giraitė;Boružėlės;4450822125;Taip;9;0;0;9
2998;Giraitė;Boružėlės;4317544803;Taip;5;3;0;8
2999;Giraitė;Boružėlės;5255040944;Taip;6;0;0;6
3000;Giraitė;Boružėlės;4843415587;Ne;11;0;0;11
3001;Giraitė;Boružėlės;2732715332;Taip;1;0;3;4
3002;Giraitė;Boružėlės;9927102264;Taip;18;0;0;18
3003;Giraitė;Boružėlės;7931998640;Taip;3;0;0;3
3004;Giraitė;Boružėlės;8908602761;Taip;5;0;0;5
3005;Giraitė;Boružėlės;4717851198;Taip;5;0;0;5
3006;Giraitė;Gandriukai;69883334049;Taip;10;0;1;11
3007;Giraitė;Gandriukai;1025627643;Taip;3;0;1;4
3008;Giraitė;Gandriukai;7547897354;Taip;0;0;1;1
3009;Giraitė;Gandriukai;26032013284;Taip;0;2;0;2
3010;Giraitė;Gandriukai;82915040164;Taip;0;2;0;2
3011;Giraitė;Gandriukai;18968645937;Taip;5;0;0;5
3012;Giraitė;Gandriukai;64357457379;Taip;11;0;0;11
3013;Giraitė;Gandriukai;1022899992;Ne;0;0;1;1
3014;Giraitė;Gandriukai;1238299747;Ne;13;0;0;13
3015;Giraitė;Gandriukai;2016939046;Taip;0;1;0;1
3016;Giraitė;Gandriukai;1054132082;Taip;10;0;1;11
3017;Giraitė;Gandriukai;8941330547;Taip;4;0;0;4
3018;Giraitė;Gandriukai;1111614295;Taip;0;14;0;14
3019;Giraitė;Gandriukai;9918028862;Taip;20;0;0;20
3020;Giraitė;Gandriukai;4031993742;Taip;11;0;1;12
3021;Giraitė;Gandriukai;2190246729;Ne;0;7;0;7
3022;Giraitė;Gandriukai;5810648237;Taip;7;0;3;10
3023;Giraitė;Gandriukai;5862292995;Taip;0;0;1;1
3024;Giraitė;Gandriukai;1375377927;Ne;0;0;1;1
3025;Giraitė;ŽVIRBLIUKAI;4444292550;Ne;0;19;0;19
3026;Giraitė;ŽVIRBLIUKAI;77765768952;Taip;0;4;0;4
3027;Giraitė;ŽVIRBLIUKAI;56380808064;Taip;0;6;0;6
3028;Giraitė;ŽVIRBLIUKAI;1181578380;Ne;7;1;1;9
3029;Giraitė;ŽVIRBLIUKAI;1547711379;Taip;0;1;0;1
3030;Giraitė;ŽVIRBLIUKAI;1234136698;Taip;6;0;0;6
3031;Giraitė;ŽVIRBLIUKAI;2065944230;Taip;0;0;1;1
3032;Giraitė;ŽVIRBLIUKAI;1858146807;Ne;3;0;1;4
3033;Giraitė;ŽVIRBLIUKAI;1464444782;Taip;3;0;2;5
3034;Giraitė;ŽVIRBLIUKAI;1435017557;Taip;4;0;0;4
3035;Giraitė;ŽVIRBLIUKAI;1149254911;Taip;6;0;1;7
3036;Giraitė;ŽVIRBLIUKAI;48291239027;Taip;10;1;0;11
3037;Giraitė;ŽVIRBLIUKAI;3628448974;Ne;6;1;1;8
3038;Giraitė;ŽVIRBLIUKAI;8020051188;Taip;4;0;0;4
3039;Giraitė;ŽVIRBLIUKAI;6973378079;Taip;0;0;1;1
3040;Giraitė;ŽVIRBLIUKAI;8000958461;Taip;8;0;0;8
3041;Giraitė;ŽVIRBLIUKAI;6233020671;Taip;0;0;4;4
3042;Giraitė;ŽVIRBLIUKAI;2990968206;Taip;0;5;0;5
3043;Giraitė;Kiškeliai;7551981095;Taip;2;0;0;2
3044;Giraitė;Kiškeliai;1583733838;Taip;5;8;0;13
3045;Giraitė;Kiškeliai;4009092043;Taip;1;1;0;2
3046;Giraitė;Kiškeliai;9728453316;Ne;3;0;0;3
3047;Giraitė;Kiškeliai;9392127689;Taip;13;0;0;13
3048;Giraitė;Kiškeliai;6677278422;Taip;13;0;1;14
3049;Giraitė;Kiškeliai;6715354865;Taip;17;0;0;17
3050;Giraitė;Kiškeliai;8461725999;Taip;5;0;0;5
3051;Giraitė;Kiškeliai;3481695682;Taip;17;0;0;17
3052;Giraitė;Kiškeliai;5086296808;Taip;0;9;3;12
3053;Giraitė;Kiškeliai;7395332578;Taip;17;0;0;17
3054;Giraitė;Kiškeliai;9471560738;Taip;10;3;0;13
3055;Giraitė;Kiškeliai;7230351549;Taip;15;0;0;15
3056;Giraitė;Kiškeliai;9114364139;Taip;0;0;1;1
3057;Giraitė;Kiškeliai;7678134658;Taip;5;0;0;5
3058;Giraitė;Kiškeliai;8873231715;Taip;11;0;1;12
3059;Giraitė;Kiškeliai;2416162886;Taip;10;0;0;10
3060;Gudrutis;Gandriukų;4193661251;Ne;0;2;1;3
3061;Gudrutis;Gandriukų;2396379813;Ne;0;0;1;1
3062;Gudrutis;Gandriukų;9042793284;Taip;11;0;0;11
3063;Gudrutis;Gandriukų;3888849808;Taip;0;0;1;1
3064;Gudrutis;Gandriukų;9797417587;Taip;0;3;0;3
3065;Gudrutis;Gandriukų;5574287734;Taip;11;0;0;11
3066;Gudrutis;Gandriukų;2431077357;Ne;2;1;0;3
3067;Gudrutis;Gandriukų;7116979528;Taip;0;0;2;2
3068;Gudrutis;Gandriukų;6747372184;Taip;0;0;1;1
3069;Gudrutis;Gandriukų;1693306014;Taip;0;9;0;9
3070;Gudrutis;Gandriukų;2865995680;Taip;0;6;1;7
3071;Gudrutis;Gandriukų;2074151024;Taip;7;0;0;7
3072;Gudrutis;Gandriukų;1991658503;Taip;0;2;0;2
3073;Gudrutis;Gandriukų;9841172472;Taip;0;0;5;5
3074;Gudrutis;Gandriukų;3359028602;Taip;4;2;1;7
3075;Gudrutis;Gandriukų;4945755164;Taip;6;2;0;8
3076;Gudrutis;Gandriukų;1190408818;Taip;11;0;1;12
3077;Gudrutis;Gandriukų;6443631536;Taip;4;0;0;4
3078;Gudrutis;Gandriukų;3363824185;Taip;0;2;0;2
3079;Gudrutis;"Saulės zuikučių";5720427655;Taip;5;1;12;18
3080;Gudrutis;"Saulės zuikučių";6868387598;Taip;5;0;12;17
3081;Gudrutis;"Saulės zuikučių";7773150642;Taip;0;0;2;2
3082;Gudrutis;"Saulės zuikučių";6835038962;Taip;0;0;18;18
3083;Gudrutis;"Saulės zuikučių";2118727861;Taip;7;0;1;8
3084;Gudrutis;"Saulės zuikučių";1725920873;Taip;0;0;1;1
3085;Gudrutis;"Saulės zuikučių";1901358996;Taip;0;0;1;1
3086;Gudrutis;"Saulės zuikučių";7664517480;Taip;0;21;0;21
3087;Gudrutis;"Saulės zuikučių";6731806925;Taip;4;0;2;6
3088;Gudrutis;"Saulės zuikučių";9701111916;Taip;5;0;1;6
3089;Gudrutis;"Saulės zuikučių";1228190677;Taip;0;0;2;2
3090;Gudrutis;"Saulės zuikučių";6198012431;Taip;0;1;4;5
3091;Gudrutis;"Saulės zuikučių";3646335609;Taip;0;0;4;4
3092;Gudrutis;"Saulės zuikučių";7871991275;Taip;0;0;3;3
3093;Gudrutis;"Saulės zuikučių";5580618896;Taip;0;0;3;3
3094;Gudrutis;"Saulės zuikučių";3625838131;Taip;0;2;0;2
3095;Gudrutis;"Saulės zuikučių";2337493193;Taip;8;0;0;8
3096;Gudrutis;"Saulės zuikučių";2764843216;Taip;0;1;0;1
3097;Gudrutis;"Saulės zuikučių";7955353991;Taip;0;1;2;3
3098;Gudrutis;Pelėdžiukų;35401545938;Taip;0;1;0;1
3099;Gudrutis;Pelėdžiukų;1389133303;Taip;0;1;0;1
3100;Gudrutis;Pelėdžiukų;1823786522;Taip;0;1;0;1
3101;Gudrutis;Pelėdžiukų;1204945185;Taip;0;4;0;4
3102;Gudrutis;Pelėdžiukų;87981934125;Taip;0;1;0;1
3103;Gudrutis;Pelėdžiukų;1436950588;Taip;0;1;0;1
3104;Gudrutis;Pelėdžiukų;1592255250;Taip;0;0;2;2
3105;Gudrutis;Pelėdžiukų;4392872175;Taip;0;1;0;1
3106;Gudrutis;Pelėdžiukų;1618442704;Taip;4;0;1;5
3107;Gudrutis;Pelėdžiukų;77776725399;Taip;0;3;0;3
3108;Gudrutis;Pelėdžiukų;8768627605;Taip;0;2;3;5
3109;Gudrutis;Pelėdžiukų;21494647270;Taip;0;2;0;2
3110;Gudrutis;Pelėdžiukų;18320321051;Taip;12;0;0;12
3111;Gudrutis;Pelėdžiukų;1156575830;Taip;13;0;0;13
3112;Gudrutis;Pelėdžiukų;74605225026;Taip;0;0;3;3
3113;Gudrutis;Pelėdžiukų;11383212272;Taip;6;1;0;7
3114;Gudrutis;Pelėdžiukų;1434565790;Taip;3;1;0;4
3115;Gudrutis;Pelėdžiukų;1238607523;Taip;0;1;1;2
3116;Gudrutis;Pelėdžiukų;8128313792;Taip;0;0;1;1
3117;Gudrutis;Pelėdžiukų;1998630017;Taip;0;1;3;4
3118;Gudrutis;BITUČIŲ;98473509715;Taip;0;0;2;2
3119;Gudrutis;BITUČIŲ;2012092629;Taip;0;1;11;12
3120;Gudrutis;BITUČIŲ;4727651235;Ne;5;1;1;7
3121;Gudrutis;BITUČIŲ;18813895572;Taip;0;1;1;2
3122;Gudrutis;BITUČIŲ;81252457503;Taip;0;1;3;4
3123;Gudrutis;BITUČIŲ;28075147728;Ne;0;0;1;1
3124;Gudrutis;BITUČIŲ;69437346100;Ne;0;1;0;1
3125;Gudrutis;BITUČIŲ;38591847769;Taip;4;2;0;6
3126;Gudrutis;BITUČIŲ;14626533681;Taip;1;0;0;1
3127;Gudrutis;BITUČIŲ;1174040508;Taip;0;1;6;7
3128;Gudrutis;BITUČIŲ;1013150817;Taip;0;3;0;3
3129;Gudrutis;BITUČIŲ;71306450171;Taip;16;0;0;16
3130;Gudrutis;BITUČIŲ;13755502342;Taip;0;3;2;5
3131;Gudrutis;BITUČIŲ;1261390117;Ne;0;1;0;1
3132;Gudrutis;BITUČIŲ;33123804925;Taip;9;0;0;9
3133;Gudrutis;BITUČIŲ;11324963268;Taip;0;1;2;3
3134;Gudrutis;BITUČIŲ;15665148606;Taip;1;2;0;3
3135;Gudrutis;BITUČIŲ;62735575539;Taip;6;0;2;8
3136;Gudrutis;BITUČIŲ;85886111222;Ne;6;0;0;6
3137;Gudrutis;BITUČIŲ;74606626459;Taip;5;0;0;5
3138;Gudrutis;BITUČIŲ;3363640861;Taip;3;1;0;4
3139;Gudrutis;BITUČIŲ;6824283429;Taip;3;0;3;6
3140;Gudrutis;Boružėlių;7934673005;Taip;10;0;2;12
3141;Gudrutis;Boružėlių;7006545234;Ne;13;0;0;13
3142;Gudrutis;Boružėlių;2199222671;Taip;3;1;3;7
3143;Gudrutis;Boružėlių;4814488445;Taip;3;0;1;4
3144;Gudrutis;Boružėlių;1587454709;Taip;0;3;0;3
3145;Gudrutis;Boružėlių;4628728628;Taip;0;7;0;7
3146;Gudrutis;Boružėlių;1670550212;Taip;10;0;0;10
3147;Gudrutis;Boružėlių;5241856014;Taip;9;0;1;10
3148;Gudrutis;Boružėlių;2740093399;Taip;0;3;4;7
3149;Gudrutis;Boružėlių;8500911420;Taip;4;0;0;4
3150;Gudrutis;Boružėlių;5728436444;Taip;13;2;0;15
3151;Gudrutis;Boružėlių;9041133527;Taip;0;5;0;5
3152;Gudrutis;Boružėlių;9328365491;Taip;3;2;1;6
3153;Gudrutis;Boružėlių;2291393238;Taip;6;0;0;6
3154;Gudrutis;Boružėlių;1384696362;Taip;6;0;1;7
3155;Gudrutis;Drugeliai;7984911632;Taip;15;1;0;16
3156;Gudrutis;Drugeliai;8165828215;Taip;17;0;0;17
3157;Gudrutis;Drugeliai;1701035039;Taip;5;1;0;6
3158;Gudrutis;Drugeliai;1012579870;Ne;20;0;0;20
3159;Gudrutis;Drugeliai;5508723821;Taip;5;2;0;7
3160;Gudrutis;Drugeliai;7755882832;Taip;5;0;0;5
3161;Gudrutis;Drugeliai;8512130106;Taip;0;2;0;2
3162;Gudrutis;Drugeliai;3814794448;Taip;10;0;0;10
3163;Gudrutis;Drugeliai;3919786807;Taip;5;0;2;7
3164;Gudrutis;Drugeliai;8807008147;Taip;9;0;4;13
3165;Gudrutis;Drugeliai;9249913155;Taip;1;0;0;1
3166;Gudrutis;Drugeliai;2197278086;Taip;4;1;1;6
3167;Gudrutis;Drugeliai;4773564048;Taip;0;0;2;2
3168;Gudrutis;Drugeliai;9044566825;Taip;9;1;0;10
3169;Jurginėlis;Ąžuoliukai;7753784918;Ne;0;0;14;14
3170;Jurginėlis;Ąžuoliukai;4852619394;Taip;8;0;1;9
3171;Jurginėlis;Ąžuoliukai;8972814655;Taip;11;0;3;14
3172;Jurginėlis;Ąžuoliukai;1361108271;Taip;0;2;3;5
3173;Jurginėlis;Ąžuoliukai;1829089083;Taip;0;3;1;4
3174;Jurginėlis;Ąžuoliukai;8784076886;Taip;13;0;0;13
3175;Jurginėlis;Ąžuoliukai;47243459592;Taip;9;0;0;9
3176;Jurginėlis;Ąžuoliukai;1954364886;Taip;7;0;0;7
3177;Jurginėlis;Ąžuoliukai;1563317396;Taip;0;0;3;3
3178;Jurginėlis;Ąžuoliukai;3068120316;Taip;1;0;0;1
3179;Jurginėlis;Ąžuoliukai;1701720412;Taip;0;2;2;4
3180;Jurginėlis;Ąžuoliukai;6111863896;Taip;0;8;0;8
3181;Jurginėlis;Ąžuoliukai;4851923549;Taip;0;0;3;3
3182;Jurginėlis;Ąžuoliukai;1467200002;Taip;0;0;1;1
3183;Jurginėlis;Ąžuoliukai;1974388885;Taip;5;2;0;7
3184;Jurginėlis;Ąžuoliukai;8338173095;Taip;2;0;1;3
3185;Jurginėlis;Ąžuoliukai;9589394406;Taip;5;3;0;8
3186;Jurginėlis;Ąžuoliukai;3027573572;Taip;5;0;2;7
3187;Jurginėlis;Ąžuoliukai;2171115974;Taip;8;0;1;9
3188;Jurginėlis;Ąžuoliukai;8920304044;Taip;0;1;3;4
3189;Jurginėlis;Žiogeliai;5892180334;Taip;3;1;0;4
3190;Jurginėlis;Žiogeliai;8144038013;Taip;6;4;0;10
3191;Jurginėlis;Žiogeliai;7928799065;Taip;15;0;0;15
3192;Jurginėlis;Žiogeliai;2624313807;Taip;6;7;0;13
3193;Jurginėlis;Žiogeliai;1547101731;Taip;6;0;0;6
3194;Jurginėlis;Žiogeliai;9646318532;Taip;3;2;0;5
3195;Jurginėlis;Žiogeliai;5242359650;Taip;4;4;0;8
3196;Jurginėlis;Žiogeliai;1759218238;Taip;0;3;0;3
3197;Jurginėlis;Žiogeliai;1102466152;Taip;0;5;0;5
3198;Jurginėlis;Žiogeliai;4806248290;Taip;0;7;0;7
3199;Jurginėlis;Žiogeliai;1082593212;Taip;11;9;0;20
3200;Jurginėlis;Žiogeliai;1175441410;Ne;0;8;0;8
3201;Jurginėlis;Žiogeliai;1983924909;Taip;0;2;0;2
3202;Jurginėlis;Žiogeliai;2710889915;Taip;0;2;0;2
3203;Jurginėlis;Žiogeliai;1586599624;Taip;0;1;0;1
3204;Jurginėlis;Žiogeliai;7297672386;Taip;6;0;0;6
3205;Jurginėlis;Žiogeliai;1787311340;Taip;0;6;0;6
3206;Jurginėlis;Žiogeliai;2535601005;Taip;10;1;0;11
3207;Jurginėlis;Žiogeliai;2639125463;Ne;4;0;0;4
3208;Jurginėlis;Žiogeliai;6413324051;Taip;0;7;0;7
3209;Jurginėlis;Žiogeliai;3708774681;Taip;9;6;0;15
3210;Jurginėlis;Pelėdžiukų;49181526821;Taip;0;1;2;3
3211;Jurginėlis;Pelėdžiukų;35653034443;Taip;0;1;2;3
3212;Jurginėlis;Pelėdžiukų;59935106302;Taip;0;1;4;5
3213;Jurginėlis;Pelėdžiukų;91317327949;Taip;0;1;3;4
3214;Jurginėlis;Pelėdžiukų;52877525045;Taip;0;6;0;6
3215;Jurginėlis;Pelėdžiukų;36829106143;Taip;6;0;2;8
3216;Jurginėlis;Pelėdžiukų;97726131559;Taip;5;0;1;6
3217;Jurginėlis;Pelėdžiukų;45200409204;Taip;3;8;0;11
3218;Jurginėlis;Pelėdžiukų;2544904907;Taip;12;1;0;13
3219;Jurginėlis;Pelėdžiukų;8414893303;Taip;3;1;3;7
3220;Jurginėlis;Pelėdžiukų;70733592257;Taip;5;0;3;8
3221;Jurginėlis;Pelėdžiukų;7449558199;Taip;0;2;0;2
3222;Jurginėlis;Pelėdžiukų;6072633581;Taip;0;14;0;14
3223;Jurginėlis;Pelėdžiukų;57340494605;Taip;0;1;3;4
3224;Jurginėlis;Pelėdžiukų;7278855565;Ne;6;0;2;8
3225;Jurginėlis;Pelėdžiukų;1295024976;Taip;4;0;3;7
3226;Jurginėlis;Pelėdžiukų;1416995981;Taip;7;0;2;9
3227;Jurginėlis;Boružėlių;92559573466;Ne;7;7;0;14
3228;Jurginėlis;Boružėlių;7798931951;Taip;0;5;0;5
3229;Jurginėlis;Boružėlių;59618430487;Taip;7;0;0;7
3230;Jurginėlis;Boružėlių;8217773164;Taip;15;1;0;16
3231;Jurginėlis;Boružėlių;29601247012;Taip;0;1;0;1
3232;Jurginėlis;Boružėlių;75192831969;Taip;0;1;0;1
3233;Jurginėlis;Boružėlių;29155768493;Ne;6;12;0;18
3234;Jurginėlis;Boružėlių;10095155757;Taip;0;4;0;4
3235;Jurginėlis;Boružėlių;67578476769;Taip;16;5;0;21
3236;Jurginėlis;Boružėlių;64852957209;Taip;0;1;0;1
3237;Jurginėlis;Boružėlių;64641268493;Taip;5;2;0;7
3238;Jurginėlis;Boružėlių;56382554421;Taip;0;2;0;2
3239;Jurginėlis;Boružėlių;51856181602;Ne;9;0;0;9
3240;Jurginėlis;Boružėlių;23049094719;Taip;0;5;0;5
3241;Jurginėlis;Boružėlių;72190891827;Taip;0;1;0;1
3242;Jurginėlis;Boružėlių;1742217696;Ne;5;2;0;7
3243;Jurginėlis;Boružėlių;1868080361;Taip;0;1;0;1
3244;Jurginėlis;Bitučių;2106937059;Ne;0;7;0;7
3245;Jurginėlis;Bitučių;50470137888;Taip;0;10;0;10
3246;Jurginėlis;Bitučių;93055778306;Taip;0;3;0;3
3247;Jurginėlis;Bitučių;92688596347;Ne;0;5;0;5
3248;Jurginėlis;Bitučių;1175198086;Taip;0;1;0;1
3249;Jurginėlis;Bitučių;96017651718;Taip;0;10;2;12
3250;Jurginėlis;Bitučių;87566883270;Ne;0;3;0;3
3251;Jurginėlis;Bitučių;84691244839;Taip;0;6;0;6
3252;Jurginėlis;Bitučių;53783266582;Taip;11;1;0;12
3253;Jurginėlis;Bitučių;55253928424;Taip;0;1;1;2
3254;Jurginėlis;Bitučių;2557687323;Taip;0;5;0;5
3255;Jurginėlis;Bitučių;8149405217;Taip;0;1;0;1
3256;Jurginėlis;Bitučių;60988201430;Taip;0;1;0;1
3257;Jurginėlis;Bitučių;1421681717;Ne;9;0;1;10
3258;Jurginėlis;Bitučių;24615714793;Taip;0;2;0;2
3259;Jurginėlis;Bitučių;1058274970;Taip;0;0;17;17
3260;Jurginėlis;Bitučių;64524305038;Taip;0;2;0;2
3261;Jurginėlis;Bitučių;90786336005;Taip;5;0;0;5
3262;Jurginėlis;Bitučių;1191021311;Taip;0;6;0;6
3263;Jurginėlis;Skruzdeliukų;1343532870;Taip;0;3;0;3
3264;Jurginėlis;Skruzdeliukų;92602685294;Taip;10;0;0;10
3265;Jurginėlis;Skruzdeliukų;1485725580;Taip;0;2;0;2
3266;Jurginėlis;Skruzdeliukų;20527253593;Taip;0;6;0;6
3267;Jurginėlis;Skruzdeliukų;51685299187;Ne;0;1;0;1
3268;Jurginėlis;Skruzdeliukų;1881790340;Taip;0;11;0;11
3269;Jurginėlis;Skruzdeliukų;31143311410;Ne;3;1;0;4
3270;Jurginėlis;Skruzdeliukų;94107758268;Taip;0;9;0;9
3271;Jurginėlis;Skruzdeliukų;77480957625;Taip;0;1;0;1
3272;Jurginėlis;Skruzdeliukų;1258821883;Taip;0;2;3;5
3273;Jurginėlis;Skruzdeliukų;38755774035;Taip;0;1;0;1
3274;Jurginėlis;Skruzdeliukų;68109772993;Ne;18;0;0;18
3275;Jurginėlis;Skruzdeliukų;81064432153;Taip;0;1;0;1
3276;Jurginėlis;Skruzdeliukų;12659496203;Taip;0;0;4;4
3277;Jurginėlis;Skruzdeliukų;1828295769;Taip;0;11;0;11
3278;Jurginėlis;Skruzdeliukų;17286700686;Ne;0;0;1;1
3279;Jurginėlis;Skruzdeliukų;1506649972;Taip;0;2;0;2
3280;Jurginėlis;Drugelių;6181547354;Taip;9;5;2;16
3281;Jurginėlis;Drugelių;2221708420;Taip;12;0;0;12
3282;Jurginėlis;Drugelių;1340689348;Taip;12;5;0;17
3283;Jurginėlis;Drugelių;2925253653;Taip;0;1;0;1
3284;Jurginėlis;Drugelių;4967548277;Taip;7;7;2;16
3285;Jurginėlis;Drugelių;8443412187;Taip;9;0;1;10
3286;Jurginėlis;Drugelių;8779807396;Ne;14;0;0;14
3287;Jurginėlis;Drugelių;9507571301;Ne;0;0;1;1
3288;Jurginėlis;Drugelių;4292932046;Ne;0;0;1;1
3289;Jurginėlis;Drugelių;6968528293;Taip;18;1;0;19
3290;Jurginėlis;Drugelių;2417314519;Ne;9;1;0;10
3291;Jurginėlis;Drugelių;7809274980;Taip;5;0;1;6
3292;Jurginėlis;Drugelių;9946892497;Taip;24;0;0;24
3293;Jurginėlis;Drugelių;1455749921;Taip;22;2;0;24
3294;Jurginėlis;Drugelių;3079495897;Taip;7;0;2;9
3295;Jurginėlis;Drugelių;5984893389;Taip;0;16;0;16
3296;Jurginėlis;Drugelių;2490875633;Taip;24;0;0;24
3297;Jurginėlis;Drugelių;9882919290;Taip;0;11;0;11
3298;Jurginėlis;Drugelių;8727844649;Taip;11;0;3;14
3299;Jurginėlis;Drugelių;8876608072;Taip;0;0;5;5
3300;Jurginėlis;Žibučių;3284464951;Taip;19;2;0;21
3301;Jurginėlis;Žibučių;4158502752;Taip;11;6;0;17
3302;Jurginėlis;Žibučių;7990015623;Taip;0;4;1;5
3303;Jurginėlis;Žibučių;6579565337;Taip;3;0;0;3
3304;Jurginėlis;Žibučių;5921714669;Taip;0;3;0;3
3305;Jurginėlis;Žibučių;4463258777;Taip;4;4;0;8
3306;Jurginėlis;Žibučių;4827340942;Ne;24;0;0;24
3307;Jurginėlis;Žibučių;2627736026;Taip;20;2;0;22
3308;Jurginėlis;Žibučių;2548920722;Taip;5;0;2;7
3309;Jurginėlis;Žibučių;6806704355;Taip;10;5;3;18
3310;Jurginėlis;Žibučių;9288380246;Taip;5;0;2;7
3311;Jurginėlis;Žibučių;3627487971;Taip;0;3;5;8
3312;Jurginėlis;Žibučių;2214809186;Ne;0;0;5;5
3313;Jurginėlis;Žibučių;2225892248;Taip;20;0;0;20
3314;Jurginėlis;Žibučių;1414888906;Taip;0;0;2;2
3315;Jurginėlis;Žibučių;7288921301;Ne;19;0;0;19
3316;Jurginėlis;Žibučių;3031725530;Taip;0;2;0;2
3317;Jurginėlis;Žibučių;2364890732;Taip;3;1;1;5
3318;Jurginėlis;Zuikučių;6217229672;Taip;0;2;0;2
3319;Jurginėlis;Zuikučių;1762685527;Ne;0;2;0;2
3320;Jurginėlis;Zuikučių;1649208522;Ne;0;0;1;1
3321;Jurginėlis;Zuikučių;8084970770;Ne;8;0;1;9
3322;Jurginėlis;Zuikučių;87991288027;Ne;6;0;0;6
3323;Jurginėlis;Zuikučių;1400142372;Taip;5;0;0;5
3324;Jurginėlis;Zuikučių;1656300401;Taip;0;1;0;1
3325;Jurginėlis;Zuikučių;1759031589;Taip;0;0;4;4
3326;Jurginėlis;Zuikučių;1945098580;Taip;8;1;0;9
3327;Jurginėlis;Zuikučių;1409480187;Ne;0;1;0;1
3328;Jurginėlis;Zuikučių;8793129805;Taip;0;3;0;3
3329;Jurginėlis;Zuikučių;74303787465;Taip;5;3;0;8
3330;Jurginėlis;Zuikučių;9320841905;Taip;0;0;21;21
3331;Jurginėlis;Zuikučių;1434737480;Taip;14;0;0;14
3332;Jurginėlis;Zuikučių;7293372539;Ne;2;0;0;2
3333;Jurginėlis;Zuikučių;5386710069;Taip;16;0;0;16
3334;Jurginėlis;Zuikučių;7920082372;Ne;12;0;0;12
3335;Jurginėlis;Viščiukų;6729212950;Taip;5;0;0;5
3336;Jurginėlis;Viščiukų;5734506036;Taip;11;9;0;20
3337;Jurginėlis;Viščiukų;1726968598;Taip;0;15;0;15
3338;Jurginėlis;Viščiukų;5180951251;Taip;7;1;0;8
3339;Jurginėlis;Viščiukų;9550110246;Taip;17;0;0;17
3340;Jurginėlis;Viščiukų;9506129699;Taip;16;0;0;16
3341;Jurginėlis;Viščiukų;3038732180;Taip;12;6;0;18
3342;Jurginėlis;Viščiukų;3541542063;Taip;0;0;3;3
3343;Jurginėlis;Viščiukų;9961083854;Taip;6;5;0;11
3344;Jurginėlis;Viščiukų;3699180485;Taip;0;1;0;1
3345;Jurginėlis;Viščiukų;6542567172;Taip;11;4;0;15
3346;Jurginėlis;Viščiukų;3069264952;Taip;10;0;0;10
3347;Jurginėlis;Meškiukų;9850874714;Taip;0;0;3;3
3348;Jurginėlis;Meškiukų;6202225321;Taip;5;0;5;10
3349;Jurginėlis;Meškiukų;3530906368;Ne;0;0;1;1
3350;Jurginėlis;Meškiukų;8937404520;Ne;0;0;1;1
3351;Jurginėlis;Meškiukų;6587382160;Taip;18;0;0;18
3352;Jurginėlis;Meškiukų;1351306981;Taip;3;0;0;3
3353;Jurginėlis;Meškiukų;5652597514;Taip;6;0;0;6
3354;Jurginėlis;Meškiukų;4432849717;Taip;6;14;0;20
3355;Jurginėlis;Meškiukų;6671759364;Taip;14;0;1;15
3356;Jurginėlis;Meškiukų;9146039217;Taip;8;0;0;8
3357;Jurginėlis;Meškiukų;3558752347;Taip;13;0;0;13
3358;Jurginėlis;Meškiukų;8097652962;Taip;5;0;5;10
3359;Jurginėlis;Meškiukų;8161347781;Taip;6;1;0;7
3360;Jurginėlis;Meškiukų;4113264904;Taip;17;0;0;17
3361;Jurginėlis;Gandriukų;7419836868;Taip;6;0;0;6
3362;Jurginėlis;Gandriukų;51603579121;Ne;3;12;0;15
3363;Jurginėlis;Gandriukų;87444065733;Taip;10;5;0;15
3364;Jurginėlis;Gandriukų;2179884441;Taip;0;15;0;15
3365;Jurginėlis;Gandriukų;2264351097;Taip;0;0;4;4
3366;Jurginėlis;Gandriukų;78496894090;Ne;0;0;3;3
3367;Jurginėlis;Gandriukų;99523320519;Taip;0;7;1;8
3368;Jurginėlis;Gandriukų;1498351759;Ne;14;0;0;14
3369;Jurginėlis;Gandriukų;1159550277;Taip;0;13;0;13
3370;Jurginėlis;Gandriukų;75383941896;Taip;6;1;0;7
3371;Jurginėlis;Gandriukų;1508705709;Taip;0;14;0;14
3372;Jurginėlis;Gandriukų;1773100970;Taip;5;0;5;10
3373;Jurginėlis;Gandriukų;1500087367;Taip;5;0;5;10
3374;Jurginėlis;Gandriukų;43368987046;Taip;8;2;0;10
3375;Jurginėlis;Gandriukų;6707289955;Taip;1;0;0;1
3376;Jurginėlis;Gandriukų;1927843089;Taip;1;0;0;1
3377;Jurginėlis;Gandriukų;8178112926;Taip;0;2;0;2
3378;Jurginėlis;Gandriukų;6475508583;Taip;21;0;0;21
3379;Jurginėlis;Gandriukų;91517951071;Taip;4;0;0;4
3380;Jurginėlis;Gandriukų;9714764714;Ne;12;0;3;15
3381;Jurginėlis;Gandriukų;5756997642;Ne;5;2;3;10
3382;Karusėlė;PAGRANDUKAS;1621482372;Taip;11;1;0;12
3383;Karusėlė;PAGRANDUKAS;3330374479;Taip;15;0;1;16
3384;Karusėlė;PAGRANDUKAS;6183785840;Taip;0;4;0;4
3385;Karusėlė;PAGRANDUKAS;3984262482;Taip;10;0;2;12
3386;Karusėlė;PAGRANDUKAS;9130534156;Taip;12;0;0;12
3387;Karusėlė;PAGRANDUKAS;3660843696;Taip;7;3;0;10
3388;Karusėlė;PAGRANDUKAS;9805481603;Taip;11;0;0;11
3389;Karusėlė;PAGRANDUKAS;1412890120;Taip;0;6;0;6
3390;Karusėlė;PAGRANDUKAS;5132581245;Taip;0;2;0;2
3391;Karusėlė;PAGRANDUKAS;2160071272;Taip;0;5;0;5
3392;Karusėlė;PAGRANDUKAS;9462242426;Taip;10;0;3;13
3393;Karusėlė;PAGRANDUKAS;7393434659;Taip;0;0;1;1
3394;Karusėlė;PAGRANDUKAS;6826455161;Taip;0;0;3;3
3395;Karusėlė;PAGRANDUKAS;5695697634;Taip;6;0;2;8
3396;Karusėlė;PAGRANDUKAS;8127218866;Taip;0;1;3;4
3397;Karusėlė;PAGRANDUKAS;6062361348;Taip;11;0;0;11
3398;Karusėlė;PAGRANDUKAS;3620722907;Taip;14;0;0;14
3399;Karusėlė;PAGRANDUKAS;7013765804;Taip;11;0;6;17
3400;Karusėlė;PAGRANDUKAS;3429495073;Taip;11;1;0;12
3401;Karusėlė;PAGRANDUKAS;5951045233;Taip;0;6;2;8
3402;Karusėlė;PAGRANDUKAS;6252613489;Taip;9;0;1;10
3403;Karusėlė;PAGRANDUKAS;5595950213;Taip;5;0;1;6
3404;Karusėlė;NYKŠTUKAS;1560316431;Taip;6;5;0;11
3405;Karusėlė;NYKŠTUKAS;82963400142;Taip;11;0;0;11
3406;Karusėlė;NYKŠTUKAS;1567290218;Taip;0;6;0;6
3407;Karusėlė;NYKŠTUKAS;64652121316;Taip;16;0;0;16
3408;Karusėlė;NYKŠTUKAS;1250530261;Taip;10;5;0;15
3409;Karusėlė;NYKŠTUKAS;1397009220;Taip;0;14;0;14
3410;Karusėlė;NYKŠTUKAS;62938709605;Taip;0;5;0;5
3411;Karusėlė;NYKŠTUKAS;96150256487;Taip;0;6;0;6
3412;Karusėlė;NYKŠTUKAS;1680275369;Taip;0;1;0;1
3413;Karusėlė;NYKŠTUKAS;17728195505;Taip;4;1;0;5
3414;Karusėlė;NYKŠTUKAS;1534689679;Taip;0;0;1;1
3415;Karusėlė;NYKŠTUKAS;1226371512;Taip;21;0;0;21
3416;Karusėlė;NYKŠTUKAS;1311631554;Ne;5;0;1;6
3417;Karusėlė;NYKŠTUKAS;5481354767;Taip;6;5;0;11
3418;Karusėlė;NYKŠTUKAS;1135386852;Taip;12;1;0;13
3419;Karusėlė;NYKŠTUKAS;8419242504;Taip;7;0;2;9
3420;Karusėlė;NYKŠTUKAS;3875204515;Taip;0;0;2;2
3421;Karusėlė;NYKŠTUKAS;45634061915;Taip;0;11;0;11
3422;Karusėlė;BITUTĖ;33892845154;Taip;17;1;0;18
3423;Karusėlė;BITUTĖ;2526585854;Taip;5;1;0;6
3424;Karusėlė;BITUTĖ;15575896909;Taip;0;9;0;9
3425;Karusėlė;BITUTĖ;1839186035;Ne;7;1;0;8
3426;Karusėlė;BITUTĖ;2653604193;Taip;9;0;0;9
3427;Karusėlė;BITUTĖ;1065703569;Taip;19;0;0;19
3428;Karusėlė;BITUTĖ;4291893779;Ne;8;1;0;9
3429;Karusėlė;BITUTĖ;1295435839;Taip;0;2;0;2
3430;Karusėlė;BITUTĖ;1883944064;Ne;0;10;0;10
3431;Karusėlė;BITUTĖ;3870601809;Taip;6;2;0;8
3432;Karusėlė;BITUTĖ;2001623432;Taip;10;2;0;12
3433;Karusėlė;BITUTĖ;8033732937;Taip;4;3;0;7
3434;Karusėlė;BITUTĖ;1798723081;Ne;0;4;0;4
3435;Karusėlė;BITUTĖ;88371238657;Taip;17;0;0;17
3436;Karusėlė;BITUTĖ;1593728369;Taip;6;1;0;7
3437;Karusėlė;BITUTĖ;1809033214;Taip;0;4;0;4
3438;Karusėlė;BITUTĖ;9065247151;Taip;10;0;0;10
3439;Karusėlė;BITUTĖ;75574841532;Ne;6;1;0;7
3440;Karusėlė;BITUTĖ;25581881402;Taip;0;3;0;3
3441;Karusėlė;BITUTĖ;6417699445;Taip;15;1;0;16
3442;Karusėlė;BORUŽĖLĖ;1705790474;Taip;13;2;0;15
3443;Karusėlė;BORUŽĖLĖ;8608177987;Taip;0;9;0;9
3444;Karusėlė;BORUŽĖLĖ;4890393582;Taip;10;1;0;11
3445;Karusėlė;BORUŽĖLĖ;1311907441;Taip;2;1;0;3
3446;Karusėlė;BORUŽĖLĖ;6313010762;Taip;0;2;0;2
3447;Karusėlė;BORUŽĖLĖ;5859827168;Taip;1;1;0;2
3448;Karusėlė;BORUŽĖLĖ;37349219339;Taip;7;1;0;8
3449;Karusėlė;BORUŽĖLĖ;49110267692;Taip;17;1;0;18
3450;Karusėlė;BORUŽĖLĖ;6811862463;Taip;7;6;0;13
3451;Karusėlė;BORUŽĖLĖ;5471989295;Taip;11;1;0;12
3452;Karusėlė;BORUŽĖLĖ;9753876554;Taip;17;0;0;17
3453;Karusėlė;BORUŽĖLĖ;1204919995;Taip;21;0;0;21
3454;Karusėlė;BORUŽĖLĖ;8717484092;Taip;0;8;0;8
3455;Karusėlė;BORUŽĖLĖ;5351690991;Taip;14;1;0;15
3456;Karusėlė;BORUŽĖLĖ;1994682683;Taip;0;1;5;6
3457;Karusėlė;BORUŽĖLĖ;5632697184;Taip;0;2;0;2
3458;Karusėlė;BORUŽĖLĖ;2247913568;Taip;6;0;0;6
3459;Karusėlė;BORUŽĖLĖ;4262640017;Ne;14;0;0;14
3460;Karusėlė;BORUŽĖLĖ;4845558814;Taip;19;0;0;19
3461;Karusėlė;BORUŽĖLĖ;8406462155;Ne;0;2;0;2
3462;Karusėlė;BORUŽĖLĖ;6495631086;Ne;5;0;0;5
3463;Karusėlė;BORUŽĖLĖ;1183484176;Taip;15;0;0;15
3464;Karusėlė;UOGELĖ;8182071103;Taip;1;14;0;15
3465;Karusėlė;UOGELĖ;8175498192;Taip;10;1;2;13
3466;Karusėlė;UOGELĖ;3053539045;Taip;0;0;3;3
3467;Karusėlė;UOGELĖ;9992989896;Taip;0;2;10;12
3468;Karusėlė;UOGELĖ;2084276906;Taip;14;1;0;15
3469;Karusėlė;UOGELĖ;1098106063;Taip;0;1;2;3
3470;Karusėlė;UOGELĖ;8665314366;Taip;14;2;0;16
3471;Karusėlė;UOGELĖ;5651238035;Taip;1;0;0;1
3472;Karusėlė;UOGELĖ;4121668687;Taip;16;0;0;16
3473;Karusėlė;UOGELĖ;8316147204;Taip;5;7;0;12
3474;Karusėlė;UOGELĖ;5504719953;Taip;0;0;18;18
3475;Karusėlė;UOGELĖ;5919009583;Taip;9;0;6;15
3476;Karusėlė;UOGELĖ;4199597984;Taip;0;8;0;8
3477;Karusėlė;UOGELĖ;2383023280;Taip;0;8;0;8
3478;Karusėlė;UOGELĖ;1575408822;Taip;8;11;0;19
3479;Karusėlė;UOGELĖ;3917113787;Taip;10;2;0;12
3480;Karusėlė;UOGELĖ;4068106379;Taip;0;6;4;10
3481;Karusėlė;UOGELĖ;1428516421;Taip;18;3;0;21
3482;Karusėlė;UOGELĖ;4638918427;Taip;7;0;0;7
3483;Karusėlė;UOGELĖ;3615957761;Taip;21;0;0;21
3484;Karusėlė;UOGELĖ;3514026443;Taip;0;2;0;2
3485;Karusėlė;UOGELĖ;1891147022;Taip;0;0;7;7
3486;Karusėlė;UOGELĖ;9389017016;Taip;11;0;1;12
3487;Karusėlė;GINTARĖLIS;89669425763;Taip;6;0;0;6
3488;Karusėlė;GINTARĖLIS;1058129883;Taip;0;2;3;5
3489;Karusėlė;GINTARĖLIS;1625704473;Taip;0;1;0;1
3490;Karusėlė;GINTARĖLIS;5267055924;Ne;0;2;1;3
3491;Karusėlė;GINTARĖLIS;17254955427;Taip;0;3;1;4
3492;Karusėlė;GINTARĖLIS;1467237683;Taip;0;0;1;1
3493;Karusėlė;GINTARĖLIS;33935704865;Taip;0;5;0;5
3494;Karusėlė;GINTARĖLIS;92286460424;Taip;0;18;0;18
3495;Karusėlė;GINTARĖLIS;80377577910;Taip;0;8;0;8
3496;Karusėlė;GINTARĖLIS;1302846796;Taip;0;5;0;5
3497;Karusėlė;GINTARĖLIS;6181109173;Ne;0;1;1;2
3498;Karusėlė;GINTARĖLIS;90635580825;Taip;0;4;0;4
3499;Karusėlė;GINTARĖLIS;93635113154;Taip;0;5;0;5
3500;Karusėlė;GINTARĖLIS;2386140324;Taip;0;11;0;11
3501;Karusėlė;GINTARĖLIS;90731574209;Ne;0;2;12;14
3502;Karusėlė;GINTARĖLIS;77007130834;Taip;0;5;0;5
3503;Karusėlė;GINTARĖLIS;6596029324;Taip;2;2;0;4
3504;Karusėlė;GINTARĖLIS;1477282992;Taip;5;4;0;9
3505;Karusėlė;GINTARĖLIS;1487641646;Taip;0;0;1;1
3506;Karusėlė;GINTARĖLIS;8008000299;Taip;0;0;2;2
3507;Karusėlė;SAULUTĖ;1705251019;Taip;10;2;0;12
3508;Karusėlė;SAULUTĖ;64855471225;Taip;14;0;0;14
3509;Karusėlė;SAULUTĖ;45701480267;Taip;5;2;0;7
3510;Karusėlė;SAULUTĖ;35910852843;Taip;0;5;0;5
3511;Karusėlė;SAULUTĖ;1198992954;Taip;17;0;0;17
3512;Karusėlė;SAULUTĖ;1223992311;Taip;0;3;1;4
3513;Karusėlė;SAULUTĖ;6702329224;Taip;15;1;0;16
3514;Karusėlė;SAULUTĖ;1239411995;Ne;0;1;0;1
3515;Karusėlė;SAULUTĖ;4806666157;Ne;6;0;0;6
3516;Karusėlė;SAULUTĖ;10539595272;Taip;10;1;0;11
3517;Karusėlė;SAULUTĖ;52452661421;Taip;0;2;0;2
3518;Karusėlė;SAULUTĖ;54723578928;Taip;0;1;0;1
3519;Karusėlė;SAULUTĖ;2606829789;Ne;0;1;0;1
3520;Karusėlė;SAULUTĖ;91676265927;Taip;0;1;0;1
3521;Karusėlė;SAULUTĖ;63044693440;Taip;0;1;0;1
3522;Karusėlė;SAULUTĖ;23662916408;Taip;0;8;0;8
3523;Karusėlė;SAULUTĖ;99462674291;Taip;0;1;4;5
3524;Karusėlė;SAULUTĖ;59790578013;Taip;0;1;0;1
3525;Karusėlė;SAULUTĖ;2025180617;Taip;0;1;0;1
3526;Karusėlė;SAULUTĖ;7977835762;Taip;8;1;0;9
3527;Karusėlė;SAULUTĖ;1273810363;Taip;6;0;0;6
3528;Karusėlė;SAULUTĖ;25328680614;Taip;0;5;0;5
3529;Karusėlė;SAULUTĖ;2038274137;Taip;0;3;0;3
3530;Karusėlė;TIGRIUKAS;1982126099;Taip;12;0;0;12
3531;Karusėlė;TIGRIUKAS;1292576152;Taip;12;0;0;12
3532;Karusėlė;TIGRIUKAS;18831943978;Taip;8;0;0;8
3533;Karusėlė;TIGRIUKAS;1305485683;Taip;0;3;0;3
3534;Karusėlė;TIGRIUKAS;1817869518;Taip;15;0;0;15
3535;Karusėlė;TIGRIUKAS;1773362652;Taip;0;2;0;2
3536;Karusėlė;TIGRIUKAS;3752570475;Ne;7;1;0;8
3537;Karusėlė;TIGRIUKAS;8881750322;Taip;0;1;0;1
3538;Karusėlė;TIGRIUKAS;8946147763;Taip;9;0;0;9
3539;Karusėlė;TIGRIUKAS;3960354989;Taip;15;0;0;15
3540;Karusėlė;TIGRIUKAS;1947403400;Taip;0;2;0;2
3541;Karusėlė;TIGRIUKAS;3690179876;Ne;13;0;0;13
3542;Karusėlė;TIGRIUKAS;7947148051;Taip;11;0;0;11
3543;Karusėlė;TIGRIUKAS;8076851284;Ne;6;0;0;6
3544;Karusėlė;TIGRIUKAS;5135054911;Taip;16;0;0;16
3545;Karusėlė;TIGRIUKAS;4426462711;Taip;16;0;0;16
3546;Karusėlė;TIGRIUKAS;8656806219;Taip;10;0;0;10
3547;Karusėlė;TIGRIUKAS;9484773068;Ne;12;0;0;12
3548;Karusėlė;TIGRIUKAS;8678437720;Taip;5;1;0;6
3549;Karusėlė;TIGRIUKAS;9868386182;Taip;12;1;0;13
3550;Karusėlė;TIGRIUKAS;1698478530;Taip;10;0;0;10
3551;Karusėlė;VAIVORYKŠTĖ;89727334417;Taip;0;13;0;13
3552;Karusėlė;VAIVORYKŠTĖ;21474974272;Taip;0;1;2;3
3553;Karusėlė;VAIVORYKŠTĖ;1629901230;Taip;0;6;0;6
3554;Karusėlė;VAIVORYKŠTĖ;2092642601;Taip;0;8;0;8
3555;Karusėlė;VAIVORYKŠTĖ;1097025436;Taip;5;6;0;11
3556;Karusėlė;VAIVORYKŠTĖ;1886562437;Taip;0;4;0;4
3557;Karusėlė;VAIVORYKŠTĖ;1915396083;Taip;0;0;1;1
3558;Karusėlė;VAIVORYKŠTĖ;1094853107;Taip;0;7;0;7
3559;Karusėlė;VAIVORYKŠTĖ;40499469616;Ne;0;10;0;10
3560;Karusėlė;VAIVORYKŠTĖ;94058192792;Taip;0;0;1;1
3561;Karusėlė;VAIVORYKŠTĖ;78971949838;Taip;19;0;0;19
3562;Karusėlė;VAIVORYKŠTĖ;25859211954;Taip;5;0;0;5
3563;Karusėlė;VAIVORYKŠTĖ;47751458940;Taip;16;0;0;16
3564;Karusėlė;VAIVORYKŠTĖ;68537797465;Taip;0;10;0;10
3565;Karusėlė;VAIVORYKŠTĖ;11336671763;Ne;0;12;0;12
3566;Karusėlė;VAIVORYKŠTĖ;9482894921;Taip;13;2;0;15
3567;Karusėlė;VAIVORYKŠTĖ;6580115367;Taip;0;0;7;7
3568;Karusėlė;VAIVORYKŠTĖ;1982350605;Taip;10;0;2;12
3569;Karusėlė;"AUKSINĖ ŽUVELĖ";1289442716;Taip;7;1;0;8
3570;Karusėlė;"AUKSINĖ ŽUVELĖ";9855242602;Taip;6;0;2;8
3571;Karusėlė;"AUKSINĖ ŽUVELĖ";5627583683;Taip;19;0;0;19
3572;Karusėlė;"AUKSINĖ ŽUVELĖ";9561892809;Taip;16;0;0;16
3573;Karusėlė;"AUKSINĖ ŽUVELĖ";9726299722;Taip;13;1;0;14
3574;Karusėlė;"AUKSINĖ ŽUVELĖ";2894817418;Taip;9;0;6;15
3575;Karusėlė;"AUKSINĖ ŽUVELĖ";6546648346;Taip;10;5;0;15
3576;Karusėlė;"AUKSINĖ ŽUVELĖ";1581504806;Taip;12;1;0;13
3577;Karusėlė;"AUKSINĖ ŽUVELĖ";5985915835;Taip;10;0;0;10
3578;Karusėlė;"AUKSINĖ ŽUVELĖ";8063412271;Taip;15;1;0;16
3579;Karusėlė;"AUKSINĖ ŽUVELĖ";9408843254;Taip;0;0;2;2
3580;Karusėlė;"AUKSINĖ ŽUVELĖ";2242659064;Taip;5;0;6;11
3581;Karusėlė;"AUKSINĖ ŽUVELĖ";3514315636;Taip;10;0;0;10
3582;Karusėlė;"AUKSINĖ ŽUVELĖ";8085919723;Taip;10;0;0;10
3583;Karusėlė;"AUKSINĖ ŽUVELĖ";5444753290;Taip;8;7;0;15
3584;Karusėlė;RAMUNĖ;9344514262;Taip;20;0;0;20
3585;Karusėlė;RAMUNĖ;2215367063;Ne;14;4;0;18
3586;Karusėlė;RAMUNĖ;5146709341;Taip;0;8;0;8
3587;Karusėlė;RAMUNĖ;8331985564;Ne;5;1;0;6
3588;Karusėlė;RAMUNĖ;5803808409;Taip;0;1;0;1
3589;Karusėlė;RAMUNĖ;9400171357;Taip;21;0;0;21
3590;Karusėlė;RAMUNĖ;5766390337;Taip;0;2;0;2
3591;Karusėlė;RAMUNĖ;2007411601;Taip;11;6;0;17
3592;Karusėlė;RAMUNĖ;9996567374;Taip;0;1;0;1
3593;Karusėlė;RAMUNĖ;3696178849;Taip;17;0;0;17
3594;Karusėlė;RAMUNĖ;7814525717;Taip;3;0;0;3
3595;Karusėlė;RAMUNĖ;7489136297;Taip;9;1;0;10
3596;Karusėlė;RAMUNĖ;6424622497;Taip;13;1;1;15
3597;Kaštonas;NYKŠTUKAI;81834426663;Taip;5;4;0;9
3598;Kaštonas;NYKŠTUKAI;4806350914;Taip;17;0;0;17
3599;Kaštonas;NYKŠTUKAI;1781481896;Taip;14;0;0;14
3600;Kaštonas;NYKŠTUKAI;6701145026;Taip;0;1;0;1
3601;Kaštonas;NYKŠTUKAI;9287426151;Taip;0;9;0;9
3602;Kaštonas;NYKŠTUKAI;9168456496;Taip;0;2;0;2
3603;Kaštonas;NYKŠTUKAI;8990194475;Taip;5;10;0;15
3604;Kaštonas;NYKŠTUKAI;9702914628;Taip;10;2;0;12
3605;Kaštonas;NYKŠTUKAI;41221846403;Taip;0;2;0;2
3606;Kaštonas;NYKŠTUKAI;3773227028;Taip;8;1;0;9
3607;Kaštonas;NYKŠTUKAI;8564586014;Taip;10;4;0;14
3608;Kaštonas;NYKŠTUKAI;5099098185;Taip;0;1;0;1
3609;Kaštonas;NYKŠTUKAI;8166925991;Taip;4;6;0;10
3610;Kaštonas;NYKŠTUKAI;2165890763;Taip;2;0;0;2
3611;Kaštonas;NYKŠTUKAI;2417951642;Taip;0;1;0;1
3612;Kaštonas;NYKŠTUKAI;6511223066;Ne;7;1;0;8
3613;Kaštonas;NYKŠTUKAI;7519302152;Ne;0;6;0;6
3614;Kaštonas;NYKŠTUKAI;5884427036;Taip;1;0;0;1
3615;Kaštonas;DRUGELIAI;7641793210;Taip;0;5;0;5
3616;Kaštonas;DRUGELIAI;54580238237;Taip;0;1;0;1
3617;Kaštonas;DRUGELIAI;17123843027;Ne;0;4;0;4
3618;Kaštonas;DRUGELIAI;16395082273;Taip;0;3;0;3
3619;Kaštonas;DRUGELIAI;47802818774;Taip;0;1;0;1
3620;Kaštonas;DRUGELIAI;52064859848;Taip;0;4;0;4
3621;Kaštonas;DRUGELIAI;8748600333;Taip;0;7;0;7
3622;Kaštonas;DRUGELIAI;87941682538;Taip;0;1;0;1
3623;Kaštonas;DRUGELIAI;64168611850;Taip;0;1;0;1
3624;Kaštonas;DRUGELIAI;37382772659;Ne;0;5;0;5
3625;Kaštonas;DRUGELIAI;1186956315;Taip;0;1;0;1
3626;Kaštonas;DRUGELIAI;7481170301;Taip;0;9;0;9
3627;Kaštonas;DRUGELIAI;76576870173;Taip;0;12;0;12
3628;Kaštonas;DRUGELIAI;1313119270;Taip;0;2;0;2
3629;Kaštonas;DRUGELIAI;41926955433;Taip;4;2;0;6
3630;Kaštonas;DRUGELIAI;1668826784;Taip;0;1;0;1
3631;Kaštonas;DRUGELIAI;1152555202;Ne;0;3;0;3
3632;Kaštonas;DRUGELIAI;46191613797;Ne;0;5;0;5
3633;Kaštonas;DRUGELIAI;1626798162;Taip;0;3;0;3
3634;Kaštonas;DRUGELIAI;1931800904;Ne;0;3;0;3
3635;Kaštonas;DRUGELIAI;2764004779;Taip;21;0;0;21
3636;Kaštonas;DRUGELIAI;89221382880;Taip;0;2;0;2
3637;Kaštonas;KIŠKUČIAI;4444087861;Ne;0;3;0;3
3638;Kaštonas;KIŠKUČIAI;5610113641;Taip;0;10;0;10
3639;Kaštonas;KIŠKUČIAI;4824511567;Taip;2;3;0;5
3640;Kaštonas;KIŠKUČIAI;7553024183;Taip;0;8;0;8
3641;Kaštonas;KIŠKUČIAI;8151333699;Taip;9;3;0;12
3642;Kaštonas;KIŠKUČIAI;7841179083;Taip;0;21;0;21
3643;Kaštonas;KIŠKUČIAI;3649329598;Taip;0;9;0;9
3644;Kaštonas;KIŠKUČIAI;7508357392;Taip;0;1;0;1
3645;Kaštonas;KIŠKUČIAI;7956422880;Taip;0;12;0;12
3646;Kaštonas;KIŠKUČIAI;5328263421;Taip;5;0;0;5
3647;Kaštonas;KIŠKUČIAI;4033866425;Taip;0;4;0;4
3648;Kaštonas;KIŠKUČIAI;3961661158;Taip;0;5;0;5
3649;Kaštonas;KIŠKUČIAI;6251564828;Taip;0;13;0;13
3650;Kaštonas;KIŠKUČIAI;7291448857;Taip;10;0;0;10
3651;Kaštonas;KIŠKUČIAI;6175014441;Taip;0;1;0;1
3652;Kaštonas;KIŠKUČIAI;4450146424;Taip;0;6;0;6
3653;Kaštonas;KIŠKUČIAI;8257643251;Taip;7;2;0;9
3654;Kaštonas;KIŠKUČIAI;8318869054;Taip;0;12;0;12
3655;Kaštonas;KIŠKUČIAI;4215759647;Taip;4;7;0;11
3656;Kaštonas;BITUTĖS;2146285017;Taip;0;3;0;3
3657;Kaštonas;BITUTĖS;39974835155;Taip;0;1;0;1
3658;Kaštonas;BITUTĖS;1162926887;Taip;6;0;0;6
3659;Kaštonas;BITUTĖS;1459614385;Taip;0;1;0;1
3660;Kaštonas;BITUTĖS;9967553882;Taip;0;3;0;3
3661;Kaštonas;BITUTĖS;27082059521;Taip;10;1;0;11
3662;Kaštonas;BITUTĖS;1465714333;Taip;0;3;0;3
3663;Kaštonas;BITUTĖS;1252815477;Taip;0;7;0;7
3664;Kaštonas;BITUTĖS;9215070593;Taip;0;4;0;4
3665;Kaštonas;BITUTĖS;2149717496;Ne;21;0;0;21
3666;Kaštonas;BITUTĖS;2504312724;Taip;0;1;0;1
3667;Kaštonas;BITUTĖS;57362664278;Taip;0;1;0;1
3668;Kaštonas;BITUTĖS;1747580231;Ne;0;3;0;3
3669;Kaštonas;BITUTĖS;4449017708;Ne;0;10;0;10
3670;Kaštonas;BITUTĖS;3638565578;Ne;0;17;0;17
3671;Kaštonas;BITUTĖS;8906976150;Taip;4;2;0;6
3672;Kaštonas;BITUTĖS;7776071299;Taip;0;3;0;3
3673;Kaštonas;BITUTĖS;3039980710;Taip;0;7;0;7
3674;Kaštonas;BITUTĖS;3507672150;Taip;0;6;0;6
3675;Kaštonas;BITUTĖS;1826015013;Taip;3;2;0;5
3676;Kaštonas;BITUTĖS;5630659056;Taip;5;4;0;9
3677;Kaštonas;BITUTĖS;2007064959;Taip;0;21;0;21
3678;Kaštonas;BITUTĖS;1859126564;Ne;0;11;0;11
3679;Kaštonas;BITUTĖS;2797443202;Taip;0;7;0;7
3680;Kaštonas;BITUTĖS;8446233414;Taip;6;6;0;12
3681;Kaštonas;MEŠKIUKAI;8042807487;Taip;0;3;0;3
3682;Kaštonas;MEŠKIUKAI;8297662673;Taip;5;2;0;7
3683;Kaštonas;MEŠKIUKAI;2711819539;Taip;11;2;0;13
3684;Kaštonas;MEŠKIUKAI;1367704050;Taip;17;1;0;18
3685;Kaštonas;MEŠKIUKAI;65960895249;Taip;9;3;0;12
3686;Kaštonas;MEŠKIUKAI;5722934228;Taip;0;3;0;3
3687;Kaštonas;MEŠKIUKAI;1049699735;Taip;0;6;0;6
3688;Kaštonas;MEŠKIUKAI;5557487532;Taip;0;2;0;2
3689;Kaštonas;MEŠKIUKAI;2760501432;Ne;0;16;0;16
3690;Kaštonas;MEŠKIUKAI;70838449788;Ne;3;1;0;4
3691;Kaštonas;MEŠKIUKAI;8797584508;Taip;16;0;0;16
3692;Kaštonas;MEŠKIUKAI;7138581709;Taip;11;5;0;16
3693;Kaštonas;MEŠKIUKAI;9965517774;Taip;11;5;0;16
3694;Kaštonas;MEŠKIUKAI;1249299633;Taip;0;4;0;4
3695;Kaštonas;MEŠKIUKAI;1196590128;Taip;5;1;0;6
3696;Kaštonas;MEŠKIUKAI;1385352925;Taip;0;10;0;10
3697;Kaštonas;MEŠKIUKAI;2125410714;Ne;5;0;0;5
3698;Kaštonas;MEŠKIUKAI;5478395437;Taip;0;21;0;21
3699;Kaštonas;MEŠKIUKAI;6606094891;Taip;6;3;0;9
3700;Kaštonas;MEŠKIUKAI;1364391105;Taip;6;3;0;9
3701;Kaštonas;MEŠKIUKAI;6967725663;Taip;0;18;0;18
3702;Kaštonas;MEŠKIUKAI;4956177048;Taip;6;11;0;17
3703;Kaštonas;MEŠKIUKAI;5153948802;Taip;8;3;0;11
3704;Kaštonas;MEŠKIUKAI;5157500600;Ne;0;4;0;4
3705;Kaštonas;BORUŽĖLĖS;9069518153;Taip;0;10;0;10
3706;Kaštonas;BORUŽĖLĖS;8214699601;Taip;0;4;0;4
3707;Kaštonas;BORUŽĖLĖS;2106924435;Taip;0;1;0;1
3708;Kaštonas;BORUŽĖLĖS;5307755844;Taip;0;3;0;3
3709;Kaštonas;BORUŽĖLĖS;7408901858;Taip;0;9;0;9
3710;Kaštonas;BORUŽĖLĖS;8483888152;Taip;5;7;0;12
3711;Kaštonas;BORUŽĖLĖS;2877124424;Taip;0;7;0;7
3712;Kaštonas;BORUŽĖLĖS;8275673303;Taip;0;6;0;6
3713;Kaštonas;BORUŽĖLĖS;6289073634;Ne;0;20;0;20
3714;Kaštonas;BORUŽĖLĖS;8582453109;Taip;6;2;0;8
3715;Kaštonas;BORUŽĖLĖS;5391954600;Taip;0;10;0;10
3716;Kaštonas;BORUŽĖLĖS;4616084852;Taip;4;0;0;4
3717;Kaštonas;BORUŽĖLĖS;1748975865;Taip;5;10;0;15
3718;Kaštonas;BORUŽĖLĖS;9285927858;Taip;5;8;0;13
3719;Kaštonas;BORUŽĖLĖS;2434765663;Taip;0;8;0;8
3720;Kaštonas;BORUŽĖLĖS;4837002666;Taip;4;0;0;4
3721;Kaštonas;BORUŽĖLĖS;7813580782;Taip;8;1;0;9
3722;Kaštonas;BORUŽĖLĖS;5659508302;Taip;0;1;0;1
3723;Krivūlė;SPINDULIUKAI;59978148537;Taip;0;1;3;4
3724;Krivūlė;SPINDULIUKAI;10728010124;Taip;0;1;1;2
3725;Krivūlė;SPINDULIUKAI;45328749559;Ne;1;0;1;2
3726;Krivūlė;SPINDULIUKAI;88714209343;Taip;0;0;5;5
3727;Krivūlė;SPINDULIUKAI;50715118246;Taip;0;10;2;12
3728;Krivūlė;SPINDULIUKAI;43180342657;Taip;6;0;0;6
3729;Krivūlė;SPINDULIUKAI;78895964424;Taip;0;1;0;1
3730;Krivūlė;SPINDULIUKAI;9864428506;Taip;0;1;2;3
3731;Krivūlė;SPINDULIUKAI;58431942;Taip;0;1;4;5
3732;Krivūlė;SPINDULIUKAI;48514609257;Taip;8;1;0;9
3733;Krivūlė;SPINDULIUKAI;49698343392;Taip;0;15;0;15
3734;Krivūlė;SPINDULIUKAI;3157698386;Taip;0;2;2;4
3735;Krivūlė;SPINDULIUKAI;26046598666;Taip;3;1;0;4
3736;Krivūlė;SPINDULIUKAI;52632731467;Taip;0;1;4;5
3737;Krivūlė;SPINDULIUKAI;1443815293;Taip;0;1;2;3
3738;Krivūlė;SPINDULIUKAI;14824959974;Taip;0;2;0;2
3739;Krivūlė;SPINDULIUKAI;65962324027;Taip;5;0;1;6
3740;Krivūlė;BORUŽĖLĖS;4969782237;Taip;4;1;0;5
3741;Krivūlė;BORUŽĖLĖS;3605506478;Taip;8;0;0;8
3742;Krivūlė;BORUŽĖLĖS;4896656209;Taip;8;0;0;8
3743;Krivūlė;BORUŽĖLĖS;4845515196;Taip;5;1;4;10
3744;Krivūlė;BORUŽĖLĖS;5676562063;Taip;5;0;1;6
3745;Krivūlė;BORUŽĖLĖS;6935969502;Taip;16;0;0;16
3746;Krivūlė;BORUŽĖLĖS;4972360440;Taip;10;0;1;11
3747;Krivūlė;BORUŽĖLĖS;7318064702;Taip;5;0;1;6
3748;Krivūlė;BORUŽĖLĖS;3912620138;Taip;12;0;0;12
3749;Krivūlė;BORUŽĖLĖS;3246787504;Taip;4;0;1;5
3750;Krivūlė;BORUŽĖLĖS;5531566792;Taip;2;0;6;8
3751;Krivūlė;BORUŽĖLĖS;2386053480;Taip;14;0;2;16
3752;Krivūlė;BORUŽĖLĖS;8586287004;Taip;13;0;0;13
3753;Krivūlė;BORUŽĖLĖS;4540069843;Taip;0;0;2;2
3754;Krivūlė;BORUŽĖLĖS;4297876008;Taip;5;1;0;6
3755;Krivūlė;BORUŽĖLĖS;2138125571;Taip;0;1;1;2
3756;Krivūlė;BORUŽĖLĖS;4257468922;Taip;0;1;1;2
3757;Krivūlė;BORUŽĖLĖS;4177660973;Taip;0;18;0;18
3758;Krivūlė;BORUŽĖLĖS;2517785727;Taip;0;0;20;20
3759;Krivūlė;BORUŽĖLĖS;2711010212;Taip;10;0;6;16
3760;Krivūlė;BORUŽĖLĖS;4025821636;Taip;10;0;1;11
3761;Krivūlė;DRUGELIŲ;1414837177;Taip;0;0;2;2
3762;Krivūlė;DRUGELIŲ;42861843152;Ne;5;0;0;5
3763;Krivūlė;DRUGELIŲ;37447518757;Taip;0;2;6;8
3764;Krivūlė;DRUGELIŲ;91645642209;Taip;0;0;1;1
3765;Krivūlė;DRUGELIŲ;1091759903;Taip;0;0;3;3
3766;Krivūlė;DRUGELIŲ;8646753324;Ne;0;0;1;1
3767;Krivūlė;DRUGELIŲ;3594180341;Ne;5;0;0;5
3768;Krivūlė;DRUGELIŲ;7042541581;Ne;0;6;0;6
3769;Krivūlė;DRUGELIŲ;50967415904;Ne;5;1;6;12
3770;Krivūlė;DRUGELIŲ;80991786508;Taip;0;1;0;1
3771;Krivūlė;DRUGELIŲ;1265788772;Taip;5;1;0;6
3772;Krivūlė;DRUGELIŲ;8463621294;Taip;1;0;6;7
3773;Krivūlė;DRUGELIŲ;55356606791;Taip;0;1;0;1
3774;Krivūlė;DRUGELIŲ;88645409146;Taip;0;1;0;1
3775;Krivūlė;DRUGELIŲ;2913847919;Ne;6;0;5;11
3776;Krivūlė;DRUGELIŲ;4824008306;Taip;0;0;7;7
3777;Krivūlė;DRUGELIŲ;8500798014;Taip;0;0;5;5
3778;Krivūlė;"BITUTĖS (VALDOFRO)";46337826378;Taip;0;4;2;6
3779;Krivūlė;"BITUTĖS (VALDOFRO)";1588621536;Taip;0;0;1;1
3780;Krivūlė;"BITUTĖS (VALDOFRO)";97075230746;Taip;3;1;0;4
3781;Krivūlė;"BITUTĖS (VALDOFRO)";97859012083;Taip;0;1;0;1
3782;Krivūlė;"BITUTĖS (VALDOFRO)";2425023811;Taip;0;1;0;1
3783;Krivūlė;"BITUTĖS (VALDOFRO)";4838666934;Taip;0;1;0;1
3784;Krivūlė;"BITUTĖS (VALDOFRO)";3994278221;Taip;2;1;0;3
3785;Krivūlė;"BITUTĖS (VALDOFRO)";18486357195;Taip;0;11;1;12
3786;Krivūlė;"BITUTĖS (VALDOFRO)";4248042049;Taip;0;16;0;16
3787;Krivūlė;"BITUTĖS (VALDOFRO)";4982146852;Taip;0;16;0;16
3788;Krivūlė;"BITUTĖS (VALDOFRO)";3769812444;Taip;0;7;2;9
3789;Krivūlė;"BITUTĖS (VALDOFRO)";5128760019;Taip;0;7;2;9
3790;Krivūlė;"BITUTĖS (VALDOFRO)";1851097789;Taip;13;0;0;13
3791;Krivūlė;"BITUTĖS (VALDOFRO)";7789248863;Taip;4;0;0;4
3792;Krivūlė;"BITUTĖS (VALDOFRO)";2647149927;Ne;0;0;10;10
3793;Krivūlė;"BITUTĖS (VALDOFRO)";5113297248;Taip;0;1;0;1
3794;Krivūlė;"BITUTĖS (VALDOFRO)";9632352765;Ne;0;0;10;10
3795;Krivūlė;"BITUTĖS (VALDOFRO)";7848471009;Taip;0;6;2;8
3796;Krivūlė;"BITUTĖS (VALDOFRO)";5405660104;Taip;0;1;1;2
3797;Krivūlė;"BITUTĖS (VALDOFRO)";8834855616;Taip;0;0;3;3
3798;Krivūlė;EŽIUKAI;10433396718;Taip;0;1;1;2
3799;Krivūlė;EŽIUKAI;44741515819;Taip;0;1;1;2
3800;Krivūlė;EŽIUKAI;2099607493;Taip;11;2;0;13
3801;Krivūlė;EŽIUKAI;1290759541;Taip;11;1;1;13
3802;Krivūlė;EŽIUKAI;28308524979;Taip;10;1;4;15
3803;Krivūlė;EŽIUKAI;1699961817;Taip;0;1;8;9
3804;Krivūlė;EŽIUKAI;96319752378;Ne;12;0;0;12
3805;Krivūlė;EŽIUKAI;66981981114;Taip;0;6;1;7
3806;Krivūlė;EŽIUKAI;1113101710;Taip;0;0;1;1
3807;Krivūlė;EŽIUKAI;86659723162;Taip;4;1;0;5
3808;Krivūlė;EŽIUKAI;2125078552;Taip;0;1;2;3
3809;Krivūlė;EŽIUKAI;6753080815;Taip;0;0;8;8
3810;Krivūlė;EŽIUKAI;2903062788;Ne;9;0;0;9
3811;Krivūlė;EŽIUKAI;81401012140;Ne;0;0;5;5
3812;Krivūlė;EŽIUKAI;1039316424;Taip;0;1;0;1
3813;Krivūlė;NYKŠTUKAI;37502093836;Taip;0;2;4;6
3814;Krivūlė;NYKŠTUKAI;83840444975;Taip;0;2;3;5
3815;Krivūlė;NYKŠTUKAI;9267414141;Taip;0;1;0;1
3816;Krivūlė;NYKŠTUKAI;19674882649;Taip;0;1;1;2
3817;Krivūlė;NYKŠTUKAI;701438210;Taip;0;7;2;9
3818;Krivūlė;NYKŠTUKAI;73760357378;Taip;0;0;1;1
3819;Krivūlė;NYKŠTUKAI;3015266398;Taip;6;0;0;6
3820;Krivūlė;NYKŠTUKAI;7873123757;Taip;5;1;0;6
3821;Krivūlė;NYKŠTUKAI;97398901468;Taip;12;0;0;12
3822;Krivūlė;NYKŠTUKAI;10005041572;Taip;0;1;0;1
3823;Krivūlė;NYKŠTUKAI;1515185307;Taip;0;2;0;2
3824;Krivūlė;NYKŠTUKAI;1217856292;Ne;9;0;3;12
3825;Krivūlė;NYKŠTUKAI;3064591570;Taip;3;0;7;10
3826;Krivūlė;NYKŠTUKAI;9311270695;Taip;0;0;3;3
3827;Krivūlė;NYKŠTUKAI;6861483854;Ne;13;0;3;16
3828;Krivūlė;NYKŠTUKAI;3694497590;Taip;1;3;0;4
3829;Krivūlė;NYKŠTUKAI;7052198958;Taip;0;0;3;3
3830;Krivūlė;NYKŠTUKAI;5818988913;Taip;0;0;5;5
3831;Krivūlė;NYKŠTUKAI;6472138102;Taip;0;0;5;5
3832;Krivūlė;"PABIRUČIŲ (Vokiečių g. 1)";5753204752;Taip;5;0;1;6
3833;Krivūlė;"PABIRUČIŲ (Vokiečių g. 1)";2834012936;Taip;8;0;1;9
3834;Krivūlė;"PABIRUČIŲ (Vokiečių g. 1)";6241144079;Ne;0;0;1;1
3835;Krivūlė;"PABIRUČIŲ (Vokiečių g. 1)";7781918674;Taip;8;1;0;9
3836;Krivūlė;"PABIRUČIŲ (Vokiečių g. 1)";2659604299;Taip;7;0;2;9
3837;Krivūlė;"PABIRUČIŲ (Vokiečių g. 1)";2536472220;Taip;0;6;1;7
3838;Krivūlė;"PABIRUČIŲ (Vokiečių g. 1)";7436569684;Taip;14;0;0;14
3839;Krivūlė;"PABIRUČIŲ (Vokiečių g. 1)";1987255206;Taip;19;0;0;19
3840;Krivūlė;"PABIRUČIŲ (Vokiečių g. 1)";6072261879;Taip;5;10;1;16
3841;Krivūlė;"PABIRUČIŲ (Vokiečių g. 1)";5149419581;Taip;0;0;4;4
3842;Krivūlė;"PABIRUČIŲ (Vokiečių g. 1)";7789605738;Taip;21;0;0;21
3843;Krivūlė;"PABIRUČIŲ (Vokiečių g. 1)";2594217776;Taip;0;0;2;2
3844;Krivūlė;"PABIRUČIŲ (Vokiečių g. 1)";2408038213;Ne;10;0;1;11
3845;Krivūlė;"PABIRUČIŲ (Vokiečių g. 1)";9693693101;Taip;0;0;6;6
3846;Krivūlė;"PABIRUČIŲ (Vokiečių g. 1)";5462491857;Taip;0;1;0;1
3847;Krivūlė;"SMALSUČIŲ (Vokiečių g.1)";1113026818;Taip;4;1;1;6
3848;Krivūlė;"SMALSUČIŲ (Vokiečių g.1)";38355661182;Taip;5;1;4;10
3849;Krivūlė;"SMALSUČIŲ (Vokiečių g.1)";1371753067;Taip;0;0;5;5
3850;Krivūlė;"SMALSUČIŲ (Vokiečių g.1)";8301938009;Taip;0;0;5;5
3851;Krivūlė;"SMALSUČIŲ (Vokiečių g.1)";2717225575;Taip;0;0;1;1
3852;Krivūlė;"SMALSUČIŲ (Vokiečių g.1)";2769668641;Ne;0;0;3;3
3853;Krivūlė;"SMALSUČIŲ (Vokiečių g.1)";4668155071;Taip;0;0;1;1
3854;Krivūlė;"SMALSUČIŲ (Vokiečių g.1)";1774829898;Taip;10;0;0;10
3855;Krivūlė;"SMALSUČIŲ (Vokiečių g.1)";55527703561;Ne;0;1;3;4
3856;Krivūlė;"SMALSUČIŲ (Vokiečių g.1)";20999997254;Taip;0;0;2;2
3857;Krivūlė;"SMALSUČIŲ (Vokiečių g.1)";3583848327;Taip;0;1;5;6
3858;Krivūlė;"SMALSUČIŲ (Vokiečių g.1)";16591459661;Ne;0;16;0;16
3859;Krivūlė;"SMALSUČIŲ (Vokiečių g.1)";6429160371;Taip;8;0;2;10
3860;Krivūlė;"SMALSUČIŲ (Vokiečių g.1)";3924127476;Taip;0;4;0;4
3861;Krivūlė;"SMALSUČIŲ (Vokiečių g.1)";4261133734;Taip;11;0;0;11
3862;Krivūlė;"SMALSUČIŲ (Vokiečių g.1)";9388057389;Taip;0;1;3;4
3863;Krivūlė;"SMALSUČIŲ (Vokiečių g.1)";9801268758;Ne;0;0;1;1
3864;Krivūlė;"SMALSUČIŲ (Vokiečių g.1)";20743334216;Taip;0;0;1;1
3865;Krivūlė;"GUDRUČIŲ (Vokiečių g. 1)";8285580095;Taip;0;0;9;9
3866;Krivūlė;"GUDRUČIŲ (Vokiečių g. 1)";2096035763;Taip;0;1;0;1
3867;Krivūlė;"GUDRUČIŲ (Vokiečių g. 1)";80775017833;Taip;5;0;1;6
3868;Krivūlė;"GUDRUČIŲ (Vokiečių g. 1)";29755294214;Taip;0;0;1;1
3869;Krivūlė;"GUDRUČIŲ (Vokiečių g. 1)";6687699907;Taip;0;3;1;4
3870;Krivūlė;"GUDRUČIŲ (Vokiečių g. 1)";1587218379;Taip;3;2;0;5
3871;Krivūlė;"GUDRUČIŲ (Vokiečių g. 1)";2096927238;Ne;0;1;0;1
3872;Krivūlė;"GUDRUČIŲ (Vokiečių g. 1)";8301904575;Ne;7;0;2;9
3873;Krivūlė;"GUDRUČIŲ (Vokiečių g. 1)";76285364171;Taip;0;0;2;2
3874;Krivūlė;"GUDRUČIŲ (Vokiečių g. 1)";49106308532;Taip;0;1;4;5
3875;Krivūlė;"GUDRUČIŲ (Vokiečių g. 1)";1974755599;Taip;2;1;0;3
3876;Krivūlė;"GUDRUČIŲ (Vokiečių g. 1)";63657801249;Ne;0;1;0;1
3877;Krivūlė;"GUDRUČIŲ (Vokiečių g. 1)";2077383621;Taip;0;1;6;7
3878;Krivūlė;"GUDRUČIŲ (Vokiečių g. 1)";27151485531;Taip;0;1;0;1
3879;Krivūlė;"GUDRUČIŲ (Vokiečių g. 1)";1180183091;Taip;0;11;6;17
3880;Krivūlė;"GUDRUČIŲ (Vokiečių g. 1)";6543038595;Ne;0;1;0;1
3881;Krivūlė;"GUDRUČIŲ (Vokiečių g. 1)";1616662586;Taip;5;1;5;11
3882;Krivūlė;"GUDRUČIŲ (Vokiečių g. 1)";50186813736;Taip;8;0;1;9
3883;Kodėlčiukas;Saulutės;6517880481;Taip;0;0;1;1
3884;Kodėlčiukas;Saulutės;7080578299;Taip;18;0;0;18
3885;Kodėlčiukas;Saulutės;1725624698;Taip;16;0;0;16
3886;Kodėlčiukas;Saulutės;2464972409;Taip;5;1;0;6
3887;Kodėlčiukas;Saulutės;8393893311;Taip;0;4;6;10
3888;Kodėlčiukas;Saulutės;7509476161;Taip;5;1;0;6
3889;Kodėlčiukas;Saulutės;1645680526;Taip;0;1;0;1
3890;Kodėlčiukas;Saulutės;8992265000;Taip;10;0;4;14
3891;Kodėlčiukas;Saulutės;6285018663;Taip;5;2;1;8
3892;Kodėlčiukas;Saulutės;1033969800;Taip;13;0;0;13
3893;Kodėlčiukas;Saulutės;4179140476;Taip;21;0;0;21
3894;Kodėlčiukas;Saulutės;2433094435;Taip;0;0;1;1
3895;Kodėlčiukas;Saulutės;9042404309;Taip;0;0;5;5
3896;Kodėlčiukas;Saulutės;3276075664;Taip;7;0;1;8
3897;Kodėlčiukas;Saulutės;9476376350;Taip;0;6;1;7
3898;Kodėlčiukas;Saulutės;3141225891;Taip;16;0;0;16
3899;Kodėlčiukas;Saulutės;3315824027;Taip;0;0;10;10
3900;Kodėlčiukas;Saulutės;6692168722;Taip;12;0;0;12
3901;Kodėlčiukas;Saulutės;7611485881;Taip;15;1;0;16
3902;Kodėlčiukas;Nežiniukai;6045564826;Taip;12;1;2;15
3903;Kodėlčiukas;Nežiniukai;7136890681;Taip;0;2;0;2
3904;Kodėlčiukas;Nežiniukai;7971932716;Taip;0;2;0;2
3905;Kodėlčiukas;Nežiniukai;7282579315;Taip;0;0;2;2
3906;Kodėlčiukas;Nežiniukai;6905424567;Taip;0;4;0;4
3907;Kodėlčiukas;Nežiniukai;1233880820;Taip;13;0;0;13
3908;Kodėlčiukas;Nežiniukai;5443377251;Taip;0;1;0;1
3909;Kodėlčiukas;Nežiniukai;3150006441;Taip;0;1;1;2
3910;Kodėlčiukas;Nežiniukai;7626940433;Taip;0;7;0;7
3911;Kodėlčiukas;Nežiniukai;9803206596;Taip;7;0;0;7
3912;Kodėlčiukas;Nežiniukai;4917910801;Taip;6;0;0;6
3913;Kodėlčiukas;Nežiniukai;6248137523;Taip;0;5;2;7
3914;Kodėlčiukas;Nežiniukai;1699358514;Taip;9;0;1;10
3915;Kodėlčiukas;Nežiniukai;3473981974;Taip;0;0;4;4
3916;Kodėlčiukas;Nežiniukai;4038168647;Taip;8;1;1;10
3917;Kodėlčiukas;Nežiniukai;8378295683;Taip;0;12;0;12
3918;Kodėlčiukas;Nežiniukai;6000831611;Taip;5;0;0;5
3919;Kodėlčiukas;Nežiniukai;7286497455;Taip;10;0;3;13
3920;Kodėlčiukas;Nežiniukai;1603752483;Taip;6;0;0;6
3921;Kodėlčiukas;Nežiniukai;6074758814;Ne;0;3;0;3
3922;Kodėlčiukas;Gintarėliai;2560864315;Taip;0;0;2;2
3923;Kodėlčiukas;Gintarėliai;58406224468;Taip;0;3;1;4
3924;Kodėlčiukas;Gintarėliai;1485012710;Taip;6;3;0;9
3925;Kodėlčiukas;Gintarėliai;5520128823;Taip;0;1;0;1
3926;Kodėlčiukas;Gintarėliai;2062878300;Taip;6;5;0;11
3927;Kodėlčiukas;Gintarėliai;20084022099;Taip;0;0;3;3
3928;Kodėlčiukas;Gintarėliai;1950934087;Taip;9;0;0;9
3929;Kodėlčiukas;Gintarėliai;4884104023;Taip;0;0;1;1
3930;Kodėlčiukas;Gintarėliai;1632458573;Taip;0;5;0;5
3931;Kodėlčiukas;Gintarėliai;9332136116;Taip;13;0;0;13
3932;Kodėlčiukas;Gintarėliai;4944791330;Taip;5;5;0;10
3933;Kodėlčiukas;Gintarėliai;8219424737;Taip;9;0;2;11
3934;Kodėlčiukas;Gintarėliai;4849314647;Taip;0;0;1;1
3935;Kodėlčiukas;Gintarėliai;3758606327;Taip;6;0;1;7
3936;Kodėlčiukas;Gintarėliai;8647609373;Taip;16;0;1;17
3937;Kodėlčiukas;Gintarėliai;5093139270;Taip;0;0;2;2
3938;Kodėlčiukas;Gintarėliai;4738357524;Taip;0;0;6;6
3939;Kodėlčiukas;Gintarėliai;8075591032;Taip;11;0;0;11
3940;Kodėlčiukas;Gintarėliai;8873629130;Taip;10;0;1;11
3941;Kodėlčiukas;Šnekučiai;1844016431;Taip;0;0;1;1
3942;Kodėlčiukas;Šnekučiai;1550915654;Taip;0;0;1;1
3943;Kodėlčiukas;Šnekučiai;1935757837;Taip;0;5;0;5
3944;Kodėlčiukas;Šnekučiai;41123326737;Taip;0;1;0;1
3945;Kodėlčiukas;Šnekučiai;8114859362;Taip;12;1;1;14
3946;Kodėlčiukas;Šnekučiai;1666743304;Ne;6;0;0;6
3947;Kodėlčiukas;Šnekučiai;1432342305;Taip;0;4;6;10
3948;Kodėlčiukas;Šnekučiai;1584936719;Taip;10;0;0;10
3949;Kodėlčiukas;Šnekučiai;5988863934;Taip;0;6;7;13
3950;Kodėlčiukas;Šnekučiai;2742365461;Taip;0;6;0;6
3951;Kodėlčiukas;Šnekučiai;5386820408;Taip;0;0;3;3
3952;Kodėlčiukas;Šnekučiai;6194726931;Taip;7;8;0;15
3953;Kodėlčiukas;Šnekučiai;7074381835;Ne;20;0;0;20
3954;Kodėlčiukas;Šnekučiai;7757494295;Taip;6;0;5;11
3955;Kodėlčiukas;Šnekučiai;2988674717;Taip;10;3;1;14
3956;Kodėlčiukas;Šnekučiai;1834696935;Taip;0;6;1;7
3957;Kodėlčiukas;Šnekučiai;4273202718;Taip;8;0;0;8
3958;Kodėlčiukas;Pabiručiai;7630180473;Taip;10;1;1;12
3959;Kodėlčiukas;Pabiručiai;8140940288;Taip;0;1;0;1
3960;Kodėlčiukas;Pabiručiai;7246243975;Ne;0;6;0;6
3961;Kodėlčiukas;Pabiručiai;1600501494;Taip;0;5;0;5
3962;Kodėlčiukas;Pabiručiai;3782714343;Taip;5;5;0;10
3963;Kodėlčiukas;Pabiručiai;3880019350;Taip;0;1;1;2
3964;Kodėlčiukas;Pabiručiai;4818678923;Ne;14;0;0;14
3965;Kodėlčiukas;Pabiručiai;9589692031;Taip;7;0;0;7
3966;Kodėlčiukas;Pabiručiai;1906128091;Taip;0;0;4;4
3967;Kodėlčiukas;Pabiručiai;8302606312;Taip;0;5;2;7
3968;Kodėlčiukas;Pabiručiai;9460792167;Taip;6;1;2;9
3969;Kodėlčiukas;Pabiručiai;1218904283;Taip;2;0;1;3
3970;Kodėlčiukas;Pabiručiai;2929946390;Taip;0;12;0;12
3971;Kodėlčiukas;Pabiručiai;7324303899;Taip;1;0;5;6
3972;Kodėlčiukas;Pabiručiai;1256650715;Taip;10;0;0;10
3973;Kodėlčiukas;Pabiručiai;1052656432;Taip;2;0;0;2
3974;Kodėlčiukas;Pabiručiai;9794875862;Taip;8;0;0;8
3975;Kodėlčiukas;Pabiručiai;9528997865;Taip;15;5;0;20
3976;Kodėlčiukas;Pabiručiai;1919722425;Taip;0;1;0;1
3977;Kodėlčiukas;Pabiručiai;2593524511;Taip;4;0;2;6
3978;Kodėlčiukas;Pabiručiai;8879977943;Taip;0;13;0;13
3979;Kodėlčiukas;Smalsučiai;49317624340;Taip;6;1;1;8
3980;Kodėlčiukas;Smalsučiai;69860272843;Taip;0;15;0;15
3981;Kodėlčiukas;Smalsučiai;52040715568;Taip;0;8;0;8
3982;Kodėlčiukas;Smalsučiai;37852137155;Taip;0;1;0;1
3983;Kodėlčiukas;Smalsučiai;86134523927;Taip;0;3;0;3
3984;Kodėlčiukas;Smalsučiai;46307870009;Taip;0;1;5;6
3985;Kodėlčiukas;Smalsučiai;35337024913;Taip;0;2;0;2
3986;Kodėlčiukas;Smalsučiai;33432780322;Taip;5;4;0;9
3987;Kodėlčiukas;Smalsučiai;96270550335;Taip;0;3;0;3
3988;Kodėlčiukas;Smalsučiai;35779814505;Taip;0;1;6;7
3989;Kodėlčiukas;Smalsučiai;53066448447;Taip;0;1;0;1
3990;Kodėlčiukas;Smalsučiai;1518135854;Ne;0;0;7;7
3991;Kodėlčiukas;Smalsučiai;93698504377;Taip;0;3;2;5
3992;Kodėlčiukas;Smalsučiai;1951603132;Taip;0;5;0;5
3993;Kodėlčiukas;Smalsučiai;1614088526;Taip;5;0;0;5
3994;Kodėlčiukas;Smalsučiai;15211280060;Taip;0;3;0;3
3995;Kodėlčiukas;Smalsučiai;41664027247;Taip;0;9;0;9
3996;Kodėlčiukas;Giliukai;26010333641;Taip;0;1;1;2
3997;Kodėlčiukas;Giliukai;97902789189;Taip;0;1;0;1
3998;Kodėlčiukas;Giliukai;99164081259;Taip;0;1;0;1
3999;Kodėlčiukas;Giliukai;93684599166;Taip;10;2;0;12
4000;Kodėlčiukas;Giliukai;88371652763;Taip;5;1;0;6
4001;Kodėlčiukas;Giliukai;80767435810;Taip;0;1;2;3
4002;Kodėlčiukas;Giliukai;1825630143;Taip;0;1;20;21
4003;Kodėlčiukas;Giliukai;11130172902;Taip;5;1;1;7
4004;Kodėlčiukas;Giliukai;29830674331;Taip;0;1;0;1
4005;Kodėlčiukas;Giliukai;84905680496;Taip;0;0;2;2
4006;Kodėlčiukas;Giliukai;58893099621;Taip;0;0;7;7
4007;Kodėlčiukas;Giliukai;2637712514;Taip;3;1;1;5
4008;Kodėlčiukas;Giliukai;1354133871;Taip;0;0;6;6
4009;Kodėlčiukas;Giliukai;45393129631;Taip;0;0;2;2
4010;Kodėlčiukas;Giliukai;47667750562;Taip;0;1;0;1
4011;Kodėlčiukas;Giliukai;8204069897;Taip;3;1;2;6
4012;Kodėlčiukas;Giliukai;29319461634;Taip;2;1;0;3
4013;Kodėlčiukas;Gudručiai;20467065338;Taip;0;0;1;1
4014;Kodėlčiukas;Gudručiai;15580950604;Taip;0;0;1;1
4015;Kodėlčiukas;Gudručiai;32318234528;Ne;0;0;6;6
4016;Kodėlčiukas;Gudručiai;18557158044;Taip;0;0;3;3
4017;Kodėlčiukas;Gudručiai;3542081571;Ne;11;0;2;13
4018;Kodėlčiukas;Gudručiai;1234971388;Taip;0;1;2;3
4019;Kodėlčiukas;Gudručiai;1048653620;Ne;0;4;0;4
4020;Kodėlčiukas;Gudručiai;1662717348;Taip;5;0;1;6
4021;Kodėlčiukas;Gudručiai;1978279511;Taip;0;0;4;4
4022;Kodėlčiukas;Gudručiai;1251970125;Taip;0;0;1;1
4023;Kodėlčiukas;Gudručiai;6186365121;Taip;0;1;0;1
4024;Kodėlčiukas;Gudručiai;70940790491;Taip;3;0;8;11
4025;Kodėlčiukas;Gudručiai;6168432879;Taip;0;0;11;11
4026;Kodėlčiukas;Gudručiai;1106092960;Taip;0;1;0;1
4027;Kodėlčiukas;Gudručiai;8393750817;Taip;0;0;5;5
4028;Kodėlčiukas;Gudručiai;1115828736;Taip;4;0;1;5
4029;Kodėlčiukas;Gudručiai;1723716524;Taip;4;0;0;4
4030;Kodėlčiukas;Gudručiai;87784905691;Taip;0;1;0;1
4031;Kodėlčiukas;Žirniukai;6988515253;Taip;16;0;1;17
4032;Kodėlčiukas;Žirniukai;3385551650;Taip;13;0;0;13
4033;Kodėlčiukas;Žirniukai;7430239198;Taip;9;0;0;9
4034;Kodėlčiukas;Žirniukai;7116594055;Taip;0;0;3;3
4035;Kodėlčiukas;Žirniukai;8890987483;Taip;0;0;3;3
4036;Kodėlčiukas;Žirniukai;4687333060;Taip;6;2;1;9
4037;Kodėlčiukas;Žirniukai;2216791610;Taip;5;0;1;6
4038;Kodėlčiukas;Žirniukai;8400610717;Taip;13;0;0;13
4039;Kodėlčiukas;Žirniukai;9483378853;Ne;12;0;1;13
4040;Kodėlčiukas;Žirniukai;1191430672;Taip;14;0;0;14
4041;Kodėlčiukas;Žirniukai;3427610168;Taip;11;0;0;11
4042;Kodėlčiukas;Žirniukai;4543838852;Taip;15;0;0;15
4043;Kodėlčiukas;Žirniukai;7326475644;Taip;15;0;0;15
4044;Kodėlčiukas;Žirniukai;9865803714;Ne;0;0;17;17
4045;Kodėlčiukas;Žirniukai;1801366890;Taip;10;0;2;12
4046;Kodėlčiukas;Žirniukai;6985788287;Taip;10;2;0;12
4047;Kodėlčiukas;Katinėliai;2904858964;Taip;10;0;0;10
4048;Kodėlčiukas;Katinėliai;2987907651;Taip;6;0;1;7
4049;Kodėlčiukas;Katinėliai;3413659259;Taip;0;0;1;1
4050;Kodėlčiukas;Katinėliai;9278139998;Taip;17;0;0;17
4051;Kodėlčiukas;Katinėliai;9899236780;Taip;0;0;5;5
4052;Kodėlčiukas;Katinėliai;8784531004;Taip;15;0;0;15
4053;Kodėlčiukas;Katinėliai;6008027505;Taip;0;4;1;5
4054;Kodėlčiukas;Katinėliai;7318196860;Taip;18;0;0;18
4055;Kodėlčiukas;Katinėliai;6014084915;Taip;16;1;0;17
4056;Kodėlčiukas;Katinėliai;1588132166;Taip;16;0;0;16
4057;Kodėlčiukas;Katinėliai;1180399735;Taip;6;0;4;10
4058;Kodėlčiukas;Katinėliai;8189938439;Taip;15;0;1;16
4059;Kodėlčiukas;Katinėliai;1039982141;Taip;11;0;1;12
4060;Kodėlčiukas;Katinėliai;8427457478;Taip;12;0;0;12
4061;Kodėlčiukas;Nykštukai;3315862631;Taip;15;0;1;16
4062;Kodėlčiukas;Nykštukai;9645987751;Taip;14;0;0;14
4063;Kodėlčiukas;Nykštukai;8782155591;Taip;0;6;0;6
4064;Kodėlčiukas;Nykštukai;8104220950;Taip;10;0;1;11
4065;Kodėlčiukas;Nykštukai;3442449482;Taip;5;0;0;5
4066;Kodėlčiukas;Nykštukai;8563412043;Taip;7;0;1;8
4067;Kodėlčiukas;Nykštukai;1683506414;Taip;0;2;2;4
4068;Kodėlčiukas;Nykštukai;7946010973;Taip;0;9;0;9
4069;Kodėlčiukas;Nykštukai;8971395173;Taip;15;0;0;15
4070;Kodėlčiukas;Nykštukai;5896726125;Taip;15;0;3;18
4071;Kodėlčiukas;Nykštukai;3168418461;Taip;14;0;0;14
4072;Kodėlčiukas;Nykštukai;3068084704;Taip;21;0;0;21
4073;Kodėlčiukas;Nykštukai;5173730926;Taip;18;0;1;19
4074;Kodėlčiukas;ŽIOGELIAI;2921181385;Taip;9;0;1;10
4075;Kodėlčiukas;ŽIOGELIAI;8263945732;Taip;18;0;1;19
4076;Kodėlčiukas;ŽIOGELIAI;4218096561;Taip;0;8;3;11
4077;Kodėlčiukas;ŽIOGELIAI;4514764005;Taip;0;0;3;3
4078;Kodėlčiukas;ŽIOGELIAI;2169307879;Taip;15;0;0;15
4079;Kodėlčiukas;ŽIOGELIAI;8910195286;Taip;8;0;0;8
4080;Kodėlčiukas;ŽIOGELIAI;4585226357;Taip;11;0;0;11
4081;Kodėlčiukas;ŽIOGELIAI;4884233329;Taip;13;0;0;13
4082;Kodėlčiukas;ŽIOGELIAI;4937929385;Taip;8;5;2;15
4083;Kodėlčiukas;ŽIOGELIAI;4165123345;Taip;11;0;2;13
4084;Kodėlčiukas;ŽIOGELIAI;5513530983;Taip;13;0;0;13
4085;Kodėlčiukas;ŽIOGELIAI;9135807341;Taip;17;0;0;17
4086;Kodėlčiukas;ŽIOGELIAI;6476445296;Taip;11;0;1;12
4087;Kodėlčiukas;ŽIOGELIAI;7612531087;Taip;5;0;0;5
4088;Kodėlčiukas;ŽIOGELIAI;6714818379;Taip;10;0;6;16
4089;Kodėlčiukas;ŽIOGELIAI;2808361570;Taip;6;0;1;7
4090;Kodėlčiukas;BITUTĖS;3240221130;Taip;4;1;0;5
4091;Kodėlčiukas;BITUTĖS;5772071707;Taip;17;0;0;17
4092;Kodėlčiukas;BITUTĖS;5577154148;Taip;17;0;0;17
4093;Kodėlčiukas;BITUTĖS;1149682376;Taip;3;0;0;3
4094;Kodėlčiukas;BITUTĖS;8468458454;Taip;20;0;0;20
4095;Kodėlčiukas;BITUTĖS;9139424911;Taip;12;2;0;14
4096;Kodėlčiukas;BITUTĖS;5197946954;Taip;9;0;1;10
4097;Kodėlčiukas;BITUTĖS;2140552221;Taip;0;1;0;1
4098;Kodėlčiukas;BITUTĖS;9979034031;Taip;0;1;0;1
4099;Kodėlčiukas;BITUTĖS;4777496709;Taip;16;0;0;16
4100;Kodėlčiukas;BITUTĖS;7714816675;Taip;16;0;0;16
4101;Kodėlčiukas;BITUTĖS;3267687337;Taip;17;0;0;17
4102;Kodėlčiukas;BITUTĖS;4202423480;Taip;14;4;0;18
4103;Kodėlčiukas;BITUTĖS;9664432781;Taip;0;1;0;1
4104;Kodėlčiukas;BITUTĖS;8547039654;Taip;6;0;0;6
4105;Kodėlčiukas;BITUTĖS;5505788210;Taip;3;1;0;4
4106;Kodėlčiukas;BITUTĖS;6106526012;Taip;19;2;0;21
4107;Kodėlčiukas;VYŠNIUKAI;4116192711;Taip;15;0;0;15
4108;Kodėlčiukas;VYŠNIUKAI;2162480212;Taip;2;10;0;12
4109;Kodėlčiukas;VYŠNIUKAI;3482802557;Taip;13;0;0;13
4110;Kodėlčiukas;VYŠNIUKAI;3778271049;Ne;10;0;1;11
4111;Kodėlčiukas;VYŠNIUKAI;1074477043;Ne;5;5;3;13
4112;Kodėlčiukas;VYŠNIUKAI;2542104903;Taip;5;0;1;6
4113;Kodėlčiukas;VYŠNIUKAI;7510273691;Ne;11;0;0;11
4114;Kodėlčiukas;VYŠNIUKAI;4490196764;Ne;0;0;2;2
4115;Kodėlčiukas;VYŠNIUKAI;9527296531;Taip;0;7;0;7
4116;Kodėlčiukas;VYŠNIUKAI;2351468626;Taip;4;5;0;9
4117;Kodėlčiukas;VYŠNIUKAI;6764015170;Ne;7;0;0;7
4118;Kodėlčiukas;VYŠNIUKAI;8447045958;Taip;17;0;1;18
4119;Kodėlčiukas;VYŠNIUKAI;7647582987;Ne;0;0;2;2
4120;Kodėlčiukas;VYŠNIUKAI;3403889915;Taip;0;8;0;8
4121;Kodėlčiukas;VYŠNIUKAI;1160612316;Taip;17;0;0;17
4122;Kodėlčiukas;VYŠNIUKAI;8606551477;Taip;0;0;1;1
4123;Kodėlčiukas;VYŠNIUKAI;1992569595;Ne;12;0;0;12
4124;Kodėlčiukas;BORUŽĖLĖS;9109362006;Taip;8;0;0;8
4125;Kodėlčiukas;BORUŽĖLĖS;9169500252;Ne;17;0;0;17
4126;Kodėlčiukas;BORUŽĖLĖS;9724373368;Taip;0;3;4;7
4127;Kodėlčiukas;BORUŽĖLĖS;6941978169;Taip;6;0;0;6
4128;Kodėlčiukas;BORUŽĖLĖS;5075801618;Taip;0;1;0;1
4129;Kodėlčiukas;BORUŽĖLĖS;2819860331;Taip;4;0;0;4
4130;Kodėlčiukas;BORUŽĖLĖS;4941186694;Taip;0;0;4;4
4131;Kodėlčiukas;BORUŽĖLĖS;4866089623;Ne;5;0;3;8
4132;Kodėlčiukas;BORUŽĖLĖS;5952121209;Taip;9;2;0;11
4133;Kodėlčiukas;BORUŽĖLĖS;4230906452;Taip;0;2;4;6
4134;Kodėlčiukas;BORUŽĖLĖS;5985806014;Taip;21;0;0;21
4135;Kodėlčiukas;BORUŽĖLĖS;8779350309;Taip;7;0;0;7
4136;Kodėlčiukas;BORUŽĖLĖS;9208137169;Ne;5;0;4;9
4137;Kodėlčiukas;BORUŽĖLĖS;5876187643;Taip;2;0;0;2
4138;Kodėlčiukas;BORUŽĖLĖS;1206798597;Taip;3;4;2;9
4139;Kodėlčiukas;BORUŽĖLĖS;6587593805;Taip;0;0;3;3
4140;Kodėlčiukas;BORUŽĖLĖS;1827752731;Taip;5;1;2;8
4141;Kodėlčiukas;BORUŽĖLĖS;1005178052;Taip;8;0;1;9
4142;Kodėlčiukas;BORUŽĖLĖS;9252478832;Taip;10;0;1;11
4143;Kodėlčiukas;VYTURĖLIAI;42540143229;Taip;0;1;0;1
4144;Kodėlčiukas;VYTURĖLIAI;5922075420;Taip;0;1;0;1
4145;Kodėlčiukas;VYTURĖLIAI;82725509126;Taip;0;1;0;1
4146;Kodėlčiukas;VYTURĖLIAI;68236236113;Taip;0;1;0;1
4147;Kodėlčiukas;VYTURĖLIAI;62309098505;Taip;0;1;0;1
4148;Kodėlčiukas;VYTURĖLIAI;43335982030;Taip;0;1;0;1
4149;Kodėlčiukas;VYTURĖLIAI;49731697380;Taip;0;1;0;1
4150;Kodėlčiukas;VYTURĖLIAI;23065888472;Taip;0;3;5;8
4151;Kodėlčiukas;VYTURĖLIAI;98738524708;Taip;0;1;0;1
4152;Kodėlčiukas;VYTURĖLIAI;1905426469;Taip;0;4;0;4
4153;Kodėlčiukas;VYTURĖLIAI;1730913401;Taip;3;1;1;5
4154;Kodėlčiukas;VYTURĖLIAI;66109277013;Taip;0;1;0;1
4155;Kodėlčiukas;VYTURĖLIAI;1608321100;Taip;0;4;4;8
4156;Kodėlčiukas;VYTURĖLIAI;45910018746;Taip;0;1;0;1
4157;Kodėlčiukas;VYTURĖLIAI;48669541733;Taip;0;7;0;7
4158;Kodėlčiukas;VYTURĖLIAI;30952731344;Taip;0;1;0;1
4159;Kodėlčiukas;VYTURĖLIAI;1290630625;Taip;4;0;0;4
4160;Kodėlčiukas;VYTURĖLIAI;79090323340;Taip;0;1;0;1
4161;Kodėlčiukas;VYTURĖLIAI;49784617790;Taip;0;1;0;1
4162;Kodėlčiukas;DRUGELIAI;1850261935;Taip;11;0;1;12
4163;Kodėlčiukas;DRUGELIAI;6612336444;Taip;0;1;3;4
4164;Kodėlčiukas;DRUGELIAI;1645423279;Taip;7;1;1;9
4165;Kodėlčiukas;DRUGELIAI;1215911875;Taip;16;0;1;17
4166;Kodėlčiukas;DRUGELIAI;7479165635;Taip;0;16;0;16
4167;Kodėlčiukas;DRUGELIAI;56907458719;Ne;0;1;2;3
4168;Kodėlčiukas;DRUGELIAI;9645382151;Taip;0;1;2;3
4169;Kodėlčiukas;DRUGELIAI;1208194459;Taip;0;1;3;4
4170;Kodėlčiukas;DRUGELIAI;1111723773;Taip;0;1;3;4
4171;Kodėlčiukas;DRUGELIAI;1550337708;Ne;0;1;1;2
4172;Kodėlčiukas;DRUGELIAI;24138056567;Taip;0;0;1;1
4173;Kodėlčiukas;DRUGELIAI;44431255380;Taip;4;0;3;7
4174;Kodėlčiukas;DRUGELIAI;93275059990;Taip;8;4;0;12
4175;Kodėlčiukas;DRUGELIAI;82927457803;Taip;0;1;0;1
4176;Kodėlčiukas;DRUGELIAI;50411894014;Ne;0;1;1;2
4177;Kodėlčiukas;DRUGELIAI;4030981879;Taip;0;1;3;4
4178;Kodėlčiukas;DRUGELIAI;1782784297;Taip;0;6;0;6
4179;Klevelis;Gėlytės;1953918266;Taip;9;2;3;14
4180;Klevelis;Gėlytės;40799074112;Taip;0;8;0;8
4181;Klevelis;Gėlytės;68457250471;Ne;4;0;0;4
4182;Klevelis;Gėlytės;7309676894;Taip;8;11;0;19
4183;Klevelis;Gėlytės;1942666372;Taip;0;16;0;16
4184;Klevelis;Gėlytės;50441219517;Taip;0;6;0;6
4185;Klevelis;Gėlytės;8154620920;Ne;4;1;0;5
4186;Klevelis;Gėlytės;5075314234;Taip;7;1;0;8
4187;Klevelis;Gėlytės;8584120396;Taip;14;0;0;14
4188;Klevelis;Gėlytės;9689230151;Taip;0;1;0;1
4189;Klevelis;Gėlytės;23520576240;Taip;0;4;0;4
4190;Klevelis;Gėlytės;1851385706;Taip;0;9;0;9
4191;Klevelis;Gėlytės;5024289280;Taip;0;1;0;1
4192;Klevelis;Gėlytės;1685710938;Taip;0;7;0;7
4193;Klevelis;Gėlytės;5354831337;Ne;0;8;0;8
4194;Klevelis;Gėlytės;2744433344;Taip;5;12;0;17
4195;Klevelis;Gėlytės;7506522045;Taip;0;5;0;5
4196;Klevelis;Gėlytės;1606294984;Taip;6;1;0;7
4197;Klevelis;Gėlytės;2043650571;Ne;2;1;0;3
4198;Klevelis;Paukšteliai;7855598075;Taip;13;7;0;20
4199;Klevelis;Paukšteliai;5402403433;Taip;7;0;1;8
4200;Klevelis;Paukšteliai;1749117711;Taip;11;2;0;13
4201;Klevelis;Paukšteliai;3873345138;Ne;2;6;0;8
4202;Klevelis;Paukšteliai;9291855374;Taip;2;6;0;8
4203;Klevelis;Paukšteliai;7115198351;Taip;6;8;0;14
4204;Klevelis;Paukšteliai;8357021249;Taip;5;0;5;10
4205;Klevelis;Paukšteliai;4051246539;Ne;3;0;2;5
4206;Klevelis;Paukšteliai;6621769160;Taip;16;1;0;17
4207;Klevelis;Paukšteliai;4144247242;Ne;5;0;1;6
4208;Klevelis;Paukšteliai;5518309115;Taip;19;0;0;19
4209;Klevelis;Paukšteliai;4832348492;Taip;5;1;0;6
4210;Klevelis;Paukšteliai;8777858708;Ne;16;0;0;16
4211;Klevelis;Paukšteliai;6172016747;Taip;5;2;0;7
4212;Klevelis;Paukšteliai;4930308435;Taip;0;2;0;2
4213;Klevelis;Paukšteliai;4895554383;Taip;0;0;4;4
4214;Klevelis;Spindulėliai;36733972781;Ne;0;2;3;5
4215;Klevelis;Spindulėliai;71637673796;Taip;0;0;1;1
4216;Klevelis;Spindulėliai;85910214189;Ne;2;0;0;2
4217;Klevelis;Spindulėliai;27776527268;Ne;5;3;0;8
4218;Klevelis;Spindulėliai;1299222411;Taip;0;6;0;6
4219;Klevelis;Spindulėliai;2041814549;Taip;0;1;0;1
4220;Klevelis;Spindulėliai;30473769754;Taip;0;0;3;3
4221;Klevelis;Spindulėliai;1608781752;Taip;0;4;0;4
4222;Klevelis;Spindulėliai;32063805512;Taip;0;4;0;4
4223;Klevelis;Spindulėliai;5786557195;Taip;1;1;1;3
4224;Klevelis;Spindulėliai;1980755137;Taip;0;4;0;4
4225;Klevelis;Spindulėliai;4400576631;Taip;0;1;0;1
4226;Klevelis;Spindulėliai;9486892110;Taip;11;0;0;11
4227;Klevelis;Spindulėliai;2207041148;Taip;0;12;0;12
4228;Klevelis;Spindulėliai;58302265771;Ne;0;4;0;4
4229;Klevelis;Spindulėliai;9125827523;Taip;0;3;0;3
4230;Klevelis;Spindulėliai;3397741232;Ne;3;1;0;4
4231;Klevelis;Spindulėliai;4558350854;Ne;5;0;0;5
4232;Klevelis;BORUŽĖLĖS;5966215998;Taip;19;0;0;19
4233;Klevelis;BORUŽĖLĖS;4347007911;Taip;3;0;0;3
4234;Klevelis;BORUŽĖLĖS;2418583962;Taip;17;0;0;17
4235;Klevelis;BORUŽĖLĖS;1751440418;Taip;15;0;0;15
4236;Klevelis;BORUŽĖLĖS;5028027797;Taip;11;0;0;11
4237;Klevelis;BORUŽĖLĖS;9585785202;Taip;5;0;0;5
4238;Klevelis;BORUŽĖLĖS;7463376031;Taip;0;9;0;9
4239;Klevelis;BORUŽĖLĖS;6822089289;Taip;4;0;0;4
4240;Klevelis;BORUŽĖLĖS;6736740055;Taip;21;0;0;21
4241;Klevelis;BORUŽĖLĖS;3306549764;Taip;17;0;0;17
4242;Klevelis;BORUŽĖLĖS;6241611652;Taip;12;0;0;12
4243;Klevelis;BORUŽĖLĖS;3567687304;Taip;4;6;0;10
4244;Klevelis;BORUŽĖLĖS;6372245141;Taip;4;1;0;5
4245;Klevelis;BORUŽĖLĖS;2031118410;Taip;3;1;0;4
4246;Klevelis;BORUŽĖLĖS;6488139414;Taip;19;0;0;19
4247;Kurpaitė;Viščiukų;6568580994;Taip;0;17;0;17
4248;Kurpaitė;Viščiukų;1223396469;Taip;7;1;0;8
4249;Kurpaitė;Viščiukų;1095697246;Taip;0;1;0;1
4250;Kurpaitė;Viščiukų;4426311033;Taip;5;3;0;8
4251;Kurpaitė;Viščiukų;7703075096;Taip;6;0;0;6
4252;Kurpaitė;Viščiukų;6466518987;Taip;0;14;0;14
4253;Kurpaitė;Viščiukų;2757100599;Taip;10;0;0;10
4254;Kurpaitė;Viščiukų;9769835612;Taip;5;0;0;5
4255;Kurpaitė;Viščiukų;3627418555;Taip;0;19;0;19
4256;Kurpaitė;Viščiukų;5220314051;Taip;10;0;0;10
4257;Kurpaitė;Viščiukų;4188925256;Taip;0;21;0;21
4258;Kurpaitė;Viščiukų;1273426668;Taip;0;3;0;3
4259;Kurpaitė;Viščiukų;8831080716;Taip;14;0;0;14
4260;Kurpaitė;Viščiukų;4592795281;Taip;0;17;0;17
4261;Kurpaitė;Viščiukų;8868415451;Taip;7;3;0;10
4262;Kurpaitė;Viščiukų;4684525618;Taip;21;0;0;21
4263;Kurpaitė;Gėlyčių;3003517700;Taip;8;0;0;8
4264;Kurpaitė;Gėlyčių;7897713994;Taip;4;1;0;5
4265;Kurpaitė;Gėlyčių;1660650556;Taip;0;13;0;13
4266;Kurpaitė;Gėlyčių;1457318954;Taip;8;5;0;13
4267;Kurpaitė;Gėlyčių;9063294667;Ne;5;3;0;8
4268;Kurpaitė;Gėlyčių;3502355847;Taip;0;3;0;3
4269;Kurpaitė;Gėlyčių;9062514113;Taip;10;0;0;10
4270;Kurpaitė;Gėlyčių;4964063637;Taip;17;0;0;17
4271;Kurpaitė;Gėlyčių;7546409044;Taip;0;18;0;18
4272;Kurpaitė;Gėlyčių;5609161523;Taip;3;0;0;3
4273;Kurpaitė;Gėlyčių;8669676262;Taip;0;4;0;4
4274;Kurpaitė;Gėlyčių;9655585527;Taip;10;9;0;19
4275;Kurpaitė;Gėlyčių;3634641300;Taip;0;1;0;1
4276;Kurpaitė;Gėlyčių;9915241987;Taip;6;1;0;7
4277;Kurpaitė;Gėlyčių;2827617670;Taip;8;0;0;8
4278;Kurpaitė;Gėlyčių;4602268315;Taip;20;0;0;20
4279;Kurpaitė;Gėlyčių;4168882748;Taip;5;1;0;6
4280;Kurpaitė;Drugelių;1236147310;Taip;5;0;0;5
4281;Kurpaitė;Drugelių;1641562196;Taip;10;0;0;10
4282;Kurpaitė;Drugelių;2200676656;Taip;6;0;0;6
4283;Kurpaitė;Drugelių;24410351286;Ne;0;12;0;12
4284;Kurpaitė;Drugelių;58127430940;Taip;10;4;0;14
4285;Kurpaitė;Drugelių;1606617694;Ne;0;15;0;15
4286;Kurpaitė;Drugelių;2359555461;Taip;8;0;0;8
4287;Kurpaitė;Drugelių;1151128660;Taip;0;2;0;2
4288;Kurpaitė;Drugelių;2116580903;Taip;0;5;0;5
4289;Kurpaitė;Drugelių;65434834152;Taip;10;1;0;11
4290;Kurpaitė;Drugelių;72710210157;Taip;0;9;0;9
4291;Kurpaitė;Drugelių;1218040871;Taip;0;21;0;21
4292;Kurpaitė;Drugelių;3660687688;Taip;0;6;0;6
4293;Kurpaitė;Drugelių;2890934301;Taip;0;1;0;1
4294;Kurpaitė;Drugelių;9435979008;Taip;9;0;0;9
4295;Kurpaitė;Drugelių;7431793716;Taip;0;15;0;15
4296;Kurpaitė;Drugelių;1505783589;Taip;0;5;0;5
4297;Kurpaitė;Drugelių;7249931704;Taip;3;14;0;17
4298;Kurpaitė;Drugelių;3102257512;Taip;10;0;0;10
4299;Kurpaitė;Pelyčių;53385228310;Ne;5;3;0;8
4300;Kurpaitė;Pelyčių;42230129130;Taip;0;6;0;6
4301;Kurpaitė;Pelyčių;28569380108;Taip;0;7;0;7
4302;Kurpaitė;Pelyčių;97469119395;Taip;0;2;0;2
4303;Kurpaitė;Pelyčių;1936055251;Taip;0;4;0;4
4304;Kurpaitė;Pelyčių;5902371603;Taip;5;5;0;10
4305;Kurpaitė;Pelyčių;54840686231;Taip;0;6;0;6
4306;Kurpaitė;Pelyčių;49970457589;Taip;0;6;0;6
4307;Kurpaitė;Pelyčių;48526842780;Taip;0;6;0;6
4308;Kurpaitė;Pelyčių;85698687930;Taip;4;1;0;5
4309;Kurpaitė;Pelyčių;1730735673;Taip;0;5;0;5
4310;Kurpaitė;Pelyčių;62959992605;Taip;5;1;0;6
4311;Kurpaitė;Pelyčių;52852801754;Taip;0;1;8;9
4312;Kurpaitė;Pelyčių;43247754405;Taip;0;18;0;18
4313;Kurpaitė;Pelyčių;51115562424;Taip;4;3;0;7
4314;Kurpaitė;Pelyčių;66920939967;Taip;0;1;0;1
4315;Kurpaitė;Pelyčių;5394176979;Taip;5;0;6;11
4316;Kūlverstukas;Saulutės;74829986958;Ne;0;2;1;3
4317;Kūlverstukas;Saulutės;7440474403;Taip;4;0;1;5
4318;Kūlverstukas;Saulutės;2072009099;Taip;6;0;3;9
4319;Kūlverstukas;Saulutės;1000393691;Taip;5;0;0;5
4320;Kūlverstukas;Saulutės;6577897961;Taip;6;0;0;6
4321;Kūlverstukas;Saulutės;3937419139;Taip;9;0;0;9
4322;Kūlverstukas;Saulutės;3162189859;Taip;0;0;2;2
4323;Kūlverstukas;Saulutės;1452422691;Taip;5;0;0;5
4324;Kūlverstukas;Saulutės;1240006602;Taip;4;10;0;14
4325;Kūlverstukas;Saulutės;2130099456;Taip;0;9;0;9
4326;Kūlverstukas;Saulutės;1226883894;Taip;9;0;0;9
4327;Kūlverstukas;Saulutės;37991935289;Taip;10;7;4;21
4328;Kūlverstukas;Saulutės;1699783763;Taip;0;4;0;4
4329;Kūlverstukas;Saulutės;3991821717;Ne;0;5;0;5
4330;Kūlverstukas;Saulutės;5488011852;Taip;5;0;0;5
4331;Kūlverstukas;Saulutės;8891671739;Taip;0;0;1;1
4332;Kūlverstukas;Saulutės;1617844709;Taip;10;0;2;12
4333;Kūlverstukas;Saulutės;4396230034;Taip;0;0;1;1
4334;Kūlverstukas;Saulutės;6975324309;Taip;0;0;2;2
4335;Kūlverstukas;Peledžiukai;21138396996;Taip;14;1;0;15
4336;Kūlverstukas;Peledžiukai;4028937969;Taip;7;7;0;14
4337;Kūlverstukas;Peledžiukai;85330859485;Taip;3;1;1;5
4338;Kūlverstukas;Peledžiukai;2179050825;Taip;5;1;0;6
4339;Kūlverstukas;Peledžiukai;46254945540;Taip;3;1;0;4
4340;Kūlverstukas;Peledžiukai;1260193245;Taip;7;1;0;8
4341;Kūlverstukas;Peledžiukai;10716234461;Ne;2;0;0;2
4342;Kūlverstukas;Peledžiukai;89179106633;Ne;0;3;0;3
4343;Kūlverstukas;Peledžiukai;22294704115;Taip;0;1;0;1
4344;Kūlverstukas;Peledžiukai;1816105412;Taip;3;2;0;5
4345;Kūlverstukas;Peledžiukai;1570383265;Taip;0;5;0;5
4346;Kūlverstukas;Peledžiukai;3737085009;Taip;0;4;0;4
4347;Kūlverstukas;Peledžiukai;49788909084;Taip;2;1;2;5
4348;Kūlverstukas;Peledžiukai;1109035765;Taip;5;1;0;6
4349;Kūlverstukas;Peledžiukai;1471794813;Taip;2;0;1;3
4350;Kūlverstukas;Peledžiukai;1009117653;Taip;8;0;0;8
4351;Kūlverstukas;Peledžiukai;8362459952;Taip;5;0;1;6
4352;Kūlverstukas;Gelytės;6287636806;Ne;9;0;1;10
4353;Kūlverstukas;Gelytės;2716194746;Taip;0;3;13;16
4354;Kūlverstukas;Gelytės;2101490038;Taip;6;0;0;6
4355;Kūlverstukas;Gelytės;2450625415;Taip;6;0;0;6
4356;Kūlverstukas;Gelytės;8092104136;Taip;0;0;4;4
4357;Kūlverstukas;Gelytės;7480593611;Ne;0;6;0;6
4358;Kūlverstukas;Gelytės;5372936730;Taip;15;0;0;15
4359;Kūlverstukas;Gelytės;7359354944;Taip;3;0;0;3
4360;Kūlverstukas;Gelytės;8853848991;Taip;6;0;1;7
4361;Kūlverstukas;Gelytės;4285624305;Taip;16;0;0;16
4362;Kūlverstukas;Gelytės;4073233921;Ne;6;0;0;6
4363;Kūlverstukas;Gelytės;2087570702;Taip;8;1;0;9
4364;Kūlverstukas;Gelytės;1932066021;Ne;7;0;1;8
4365;Kūlverstukas;Gelytės;5488852698;Taip;8;0;0;8
4366;Kūlverstukas;Gelytės;5345423038;Taip;5;6;0;11
4367;Kūlverstukas;Gelytės;3270176280;Taip;6;0;0;6
4368;Kūlverstukas;Gelytės;2169480822;Taip;4;0;0;4
4369;Kūlverstukas;Gelytės;4173514390;Taip;10;0;0;10
4370;Kūlverstukas;Bitutės;9427388681;Taip;0;10;0;10
4371;Kūlverstukas;Bitutės;9096819614;Taip;0;0;6;6
4372;Kūlverstukas;Bitutės;4532151103;Taip;16;0;0;16
4373;Kūlverstukas;Bitutės;7505926208;Taip;4;7;0;11
4374;Kūlverstukas;Bitutės;1014630718;Taip;4;7;0;11
4375;Kūlverstukas;Bitutės;5103259175;Taip;0;1;2;3
4376;Kūlverstukas;Bitutės;9167460438;Taip;10;0;0;10
4377;Kūlverstukas;Bitutės;1898905623;Taip;5;10;6;21
4378;Kūlverstukas;Bitutės;2762230590;Taip;3;0;4;7
4379;Kūlverstukas;Bitutės;8319255735;Taip;11;0;1;12
4380;Kūlverstukas;Bitutės;6598688551;Taip;10;0;1;11
4381;Kūlverstukas;Bitutės;8556086501;Taip;5;0;0;5
4382;Kūlverstukas;Bitutės;3162808486;Taip;6;0;0;6
4383;Kūlverstukas;Bitutės;1067182820;Taip;6;0;1;7
4384;Lakštingala;Saulutės;95489864230;Taip;0;0;1;1
4385;Lakštingala;Saulutės;31221126819;Taip;0;1;0;1
4386;Lakštingala;Saulutės;57836156450;Taip;3;2;4;9
4387;Lakštingala;Saulutės;3426133948;Taip;5;5;0;10
4388;Lakštingala;Saulutės;79652151224;Ne;0;10;0;10
4389;Lakštingala;Saulutės;10653315095;Ne;0;1;0;1
4390;Lakštingala;Saulutės;50868279016;Taip;0;6;0;6
4391;Lakštingala;Saulutės;45850246980;Taip;0;1;1;2
4392;Lakštingala;Saulutės;2430795418;Ne;0;0;1;1
4393;Lakštingala;Saulutės;93222430249;Taip;0;1;0;1
4394;Lakštingala;Saulutės;74001349345;Taip;0;1;0;1
4395;Lakštingala;Saulutės;37722153251;Taip;4;1;2;7
4396;Lakštingala;Saulutės;98717827320;Taip;0;1;0;1
4397;Lakštingala;Saulutės;40682764019;Taip;0;1;0;1
4398;Lakštingala;Saulutės;79583726414;Taip;5;2;0;7
4399;Lakštingala;Saulutės;68037499606;Taip;0;1;0;1
4400;Lakštingala;Saulutės;51586922715;Taip;0;11;0;11
4401;Lakštingala;Saulutės;89747320378;Taip;0;9;1;10
4402;Lakštingala;Saulutės;62866040506;Taip;0;5;0;5
4403;Lakštingala;Nykštukai;7931292601;Taip;9;0;0;9
4404;Lakštingala;Nykštukai;4700135106;Taip;0;15;0;15
4405;Lakštingala;Nykštukai;1863034132;Taip;16;0;0;16
4406;Lakštingala;Nykštukai;9879064676;Ne;2;5;0;7
4407;Lakštingala;Nykštukai;2941128360;Taip;1;0;0;1
4408;Lakštingala;Nykštukai;8284565948;Taip;9;0;0;9
4409;Lakštingala;Nykštukai;9489982241;Taip;0;1;0;1
4410;Lakštingala;Nykštukai;4032030375;Taip;0;12;0;12
4411;Lakštingala;Nykštukai;3993759015;Taip;5;6;0;11
4412;Lakštingala;Nykštukai;3724324861;Ne;0;12;0;12
4413;Lakštingala;Nykštukai;2652305131;Taip;5;0;0;5
4414;Lakštingala;Nykštukai;9725851433;Taip;4;1;3;8
4415;Lakštingala;Nykštukai;6332498461;Taip;5;9;0;14
4416;Lakštingala;Nykštukai;1655202909;Taip;7;4;0;11
4417;Lakštingala;Nykštukai;9375002191;Taip;6;6;0;12
4418;Lakštingala;Nykštukai;3832669008;Taip;1;0;0;1
4419;Lakštingala;Nykštukai;4857448665;Taip;6;0;1;7
4420;Lakštingala;Nykštukai;2304340938;Taip;9;0;0;9
4421;Lakštingala;Nykštukai;8217315818;Taip;0;0;1;1
4422;Lakštingala;Nykštukai;6292331193;Taip;1;0;4;5
4423;Lakštingala;Bitutės;3544861594;Taip;0;5;0;5
4424;Lakštingala;Bitutės;1422696792;Taip;0;1;4;5
4425;Lakštingala;Bitutės;16039738423;Taip;0;0;1;1
4426;Lakštingala;Bitutės;95149875628;Taip;0;7;0;7
4427;Lakštingala;Bitutės;72834597919;Taip;0;1;0;1
4428;Lakštingala;Bitutės;2106666739;Taip;8;1;0;9
4429;Lakštingala;Bitutės;91158318909;Taip;0;1;0;1
4430;Lakštingala;Bitutės;92129853333;Taip;5;0;0;5
4431;Lakštingala;Bitutės;14826956710;Ne;5;2;0;7
4432;Lakštingala;Bitutės;63698553352;Taip;5;3;0;8
4433;Lakštingala;Bitutės;19356167631;Taip;0;1;0;1
4434;Lakštingala;Bitutės;45199150020;Taip;0;2;0;2
4435;Lakštingala;Bitutės;46426227002;Taip;0;0;1;1
4436;Lakštingala;Bitutės;24905526995;Taip;13;1;0;14
4437;Lakštingala;Bitutės;1056248263;Taip;10;1;0;11
4438;Lakštingala;Bitutės;56646163756;Taip;0;1;1;2
4439;Lakštingala;Bitutės;9610324086;Taip;0;1;1;2
4440;Lakštingala;Bitutės;7860949054;Taip;0;3;0;3
4441;Lakštingala;Bitutės;82319560992;Taip;0;14;0;14
4442;Lakštingala;Bitutės;2138306323;Taip;0;1;2;3
4443;Lakštingala;Pūkeliai;5598711072;Taip;16;0;0;16
4444;Lakštingala;Pūkeliai;8171357606;Taip;4;5;0;9
4445;Lakštingala;Pūkeliai;9774836470;Taip;5;7;0;12
4446;Lakštingala;Pūkeliai;1958696382;Taip;17;0;0;17
4447;Lakštingala;Pūkeliai;3811230983;Taip;9;0;0;9
4448;Lakštingala;Pūkeliai;4542992319;Taip;8;0;1;9
4449;Lakštingala;Pūkeliai;9346986726;Taip;8;0;0;8
4450;Lakštingala;Pūkeliai;6908873466;Taip;6;0;3;9
4451;Lakštingala;Pūkeliai;7929034243;Taip;12;1;0;13
4452;Lakštingala;Pūkeliai;5854794141;Taip;4;0;1;5
4453;Lakštingala;Pūkeliai;6234559044;Taip;10;0;1;11
4454;Lakštingala;Pūkeliai;2130192341;Taip;15;0;0;15
4455;Lakštingala;Pūkeliai;8165998647;Taip;10;0;0;10
4456;Lakštingala;Pūkeliai;1458348357;Taip;6;0;0;6
4457;Lakštingala;Pūkeliai;2430891944;Taip;5;0;0;5
4458;Lakštingala;Pūkeliai;5379344261;Taip;0;0;2;2
4459;Lakštingala;Pūkeliai;4722328994;Ne;5;0;0;5
4460;Lakštingala;Pūkeliai;7272454093;Taip;13;0;0;13
4461;Lakštingala;Pūkeliai;1587899391;Ne;11;0;0;11
4462;Lakštingala;Aitvariukai;3872205876;Taip;6;0;3;9
4463;Lakštingala;Aitvariukai;5851957031;Taip;0;1;1;2
4464;Lakštingala;Aitvariukai;4996777116;Taip;0;0;13;13
4465;Lakštingala;Aitvariukai;7448598447;Taip;18;0;0;18
4466;Lakštingala;Aitvariukai;9390342572;Taip;0;1;1;2
4467;Lakštingala;Aitvariukai;7918688955;Taip;5;2;0;7
4468;Lakštingala;Aitvariukai;6701912968;Taip;0;20;1;21
4469;Lakštingala;Aitvariukai;3509165175;Ne;16;0;0;16
4470;Lakštingala;Aitvariukai;9694524137;Taip;0;1;5;6
4471;Lakštingala;Aitvariukai;4179366572;Taip;0;0;8;8
4472;Lakštingala;Aitvariukai;5949665703;Taip;7;0;2;9
4473;Lakštingala;Aitvariukai;8679582358;Taip;21;0;0;21
4474;Lakštingala;Aitvariukai;9147821017;Taip;7;0;7;14
4475;Lakštingala;Aitvariukai;5445945319;Taip;2;0;1;3
4476;Lakštingala;Aitvariukai;6597540627;Taip;0;0;5;5
4477;Lakštingala;Aitvariukai;2266870318;Taip;10;0;2;12
4478;Lakštingala;Aitvariukai;3791118736;Taip;8;0;1;9
4479;Lakštingala;Aitvariukai;6565318145;Taip;10;0;1;11
4480;Lakštingala;Aitvariukai;4384468922;Ne;0;5;7;12
4481;Lakštingala;Aitvariukai;5162605666;Taip;16;0;1;17
4482;Lakštingala;Aitvariukai;2423761155;Taip;0;1;0;1
4483;Lakštingala;Boružiukai;9795993812;Taip;0;5;0;5
4484;Lakštingala;Boružiukai;3280380015;Taip;6;5;0;11
4485;Lakštingala;Boružiukai;9004336424;Ne;3;0;3;6
4486;Lakštingala;Boružiukai;8820053026;Taip;0;1;0;1
4487;Lakštingala;Boružiukai;2072883878;Taip;3;0;0;3
4488;Lakštingala;Boružiukai;8873445262;Taip;16;0;0;16
4489;Lakštingala;Boružiukai;4811759034;Taip;0;1;0;1
4490;Lakštingala;Boružiukai;1898853302;Ne;0;0;7;7
4491;Lakštingala;Boružiukai;7443563000;Taip;0;0;2;2
4492;Lakštingala;Boružiukai;2792618575;Taip;0;17;0;17
4493;Lakštingala;Boružiukai;55720630870;Taip;0;0;4;4
4494;Lakštingala;Boružiukai;4818524423;Taip;6;0;0;6
4495;Lakštingala;Boružiukai;1444534032;Taip;0;0;4;4
4496;Lakštingala;Boružiukai;6150013105;Taip;0;0;2;2
4497;Lakštingala;Boružiukai;9724531753;Ne;13;0;4;17
4498;Lakštingala;Boružiukai;3602820204;Taip;6;4;1;11
4499;Lakštingala;Boružiukai;9876388990;Taip;10;0;0;10
4500;Lakštingala;"KIŠKUČIAI (SAV.)";64992551832;Taip;5;4;0;9
4501;Lakštingala;"KIŠKUČIAI (SAV.)";1169891428;Taip;8;1;0;9
4502;Lakštingala;"KIŠKUČIAI (SAV.)";63039806752;Taip;0;8;0;8
4503;Lakštingala;"KIŠKUČIAI (SAV.)";1409132656;Taip;12;0;0;12
4504;Lakštingala;"KIŠKUČIAI (SAV.)";1236087612;Taip;14;0;0;14
4505;Lakštingala;"KIŠKUČIAI (SAV.)";80762133625;Taip;0;2;4;6
4506;Lakštingala;"KIŠKUČIAI (SAV.)";1128658722;Taip;6;1;0;7
4507;Lakštingala;"KIŠKUČIAI (SAV.)";9862985913;Taip;0;3;0;3
4508;Lakštingala;"KIŠKUČIAI (SAV.)";40853872375;Taip;0;3;2;5
4509;Lakštingala;"KIŠKUČIAI (SAV.)";1716046309;Ne;5;0;0;5
4510;Lakštingala;"KIŠKUČIAI (SAV.)";3660645944;Ne;0;6;0;6
4511;Lakštingala;"KIŠKUČIAI (SAV.)";7038977283;Taip;7;3;0;10
4512;Lakštingala;"KIŠKUČIAI (SAV.)";80142440362;Taip;0;2;1;3
4513;Lakštingala;"KIŠKUČIAI (SAV.)";7623300327;Taip;9;0;0;9
4514;Lakštingala;"KIŠKUČIAI (SAV.)";2241000661;Taip;9;0;0;9
4515;Lakštingala;"KIŠKUČIAI (SAV.)";78648398334;Ne;5;2;6;13
4516;Lakštingala;"KIŠKUČIAI (SAV.)";1408127186;Taip;0;3;0;3
4517;Lakštingala;Žiogeliai;2104150466;Taip;0;1;1;2
4518;Lakštingala;Žiogeliai;1832608585;Taip;0;5;0;5
4519;Lakštingala;Žiogeliai;9958821769;Taip;0;1;3;4
4520;Lakštingala;Žiogeliai;7953724873;Taip;0;1;0;1
4521;Lakštingala;Žiogeliai;9800992468;Taip;0;1;0;1
4522;Lakštingala;Žiogeliai;1411121466;Taip;0;1;0;1
4523;Lakštingala;Žiogeliai;8944088082;Taip;0;3;0;3
4524;Lakštingala;Žiogeliai;70798601578;Taip;6;4;0;10
4525;Lakštingala;Žiogeliai;1736130324;Taip;0;1;0;1
4526;Lakštingala;Žiogeliai;2039579203;Taip;0;1;0;1
4527;Lakštingala;Žiogeliai;6576202365;Taip;6;0;5;11
4528;Lakštingala;Žiogeliai;7900597697;Taip;0;9;2;11
4529;Lakštingala;Žiogeliai;8470575927;Taip;0;11;0;11
4530;Lakštingala;Žiogeliai;1265027238;Taip;0;2;0;2
4531;Lakštingala;SPINDULIUKAI;19003276281;Taip;13;0;0;13
4532;Lakštingala;SPINDULIUKAI;31911078405;Taip;13;0;0;13
4533;Lakštingala;SPINDULIUKAI;59343571746;Taip;0;0;2;2
4534;Lakštingala;SPINDULIUKAI;601001178;Taip;0;1;6;7
4535;Lakštingala;SPINDULIUKAI;1263184555;Taip;0;1;1;2
4536;Lakštingala;SPINDULIUKAI;42012300013;Taip;0;0;1;1
4537;Lakštingala;SPINDULIUKAI;2002196654;Taip;0;2;0;2
4538;Lakštingala;SPINDULIUKAI;4261431738;Taip;0;1;0;1
4539;Lakštingala;SPINDULIUKAI;58847206918;Taip;0;12;2;14
4540;Lakštingala;SPINDULIUKAI;5033145687;Taip;0;1;0;1
4541;Lakštingala;SPINDULIUKAI;26288159700;Ne;2;2;3;7
4542;Lakštingala;SPINDULIUKAI;11399672681;Taip;5;0;3;8
4543;Lakštingala;SPINDULIUKAI;95832669291;Taip;0;10;0;10
4544;Lakštingala;SPINDULIUKAI;4183492894;Taip;0;5;0;5
4545;Lakštingala;SPINDULIUKAI;65408046990;Taip;0;0;1;1
4546;Lakštingala;SPINDULIUKAI;48160996499;Ne;10;1;1;12
4547;Lakštingala;SPINDULIUKAI;70748679017;Taip;0;10;1;11
4548;Lakštingala;SPINDULIUKAI;4770775472;Taip;0;2;1;3
4549;Lakštingala;SPINDULIUKAI;8838078447;Ne;0;1;0;1
4550;Lakštingala;SPINDULIUKAI;7448175606;Taip;0;7;0;7
4551;Lakštingala;SPINDULIUKAI;73039119839;Taip;0;16;1;17
4552;Lakštingala;Pėledžiukai;98609129644;Taip;0;4;0;4
4553;Lakštingala;Pėledžiukai;2635399411;Taip;0;1;0;1
4554;Lakštingala;Pėledžiukai;7325183642;Taip;3;0;0;3
4555;Lakštingala;Pėledžiukai;1297637335;Taip;0;0;2;2
4556;Lakštingala;Pėledžiukai;1271455798;Taip;5;1;0;6
4557;Lakštingala;Pėledžiukai;1868573076;Taip;0;10;2;12
4558;Lakštingala;Pėledžiukai;14410791110;Taip;0;0;1;1
4559;Lakštingala;Pėledžiukai;30840899725;Taip;2;0;1;3
4560;Lakštingala;Pėledžiukai;1676655778;Taip;16;0;0;16
4561;Lakštingala;Pėledžiukai;15430318196;Taip;0;0;21;21
4562;Lakštingala;Pėledžiukai;9381815353;Taip;0;0;3;3
4563;Lakštingala;Pėledžiukai;25449089230;Taip;0;10;0;10
4564;Lakštingala;Pėledžiukai;36367286465;Taip;0;0;1;1
4565;Lakštingala;Pėledžiukai;91671174585;Taip;0;4;0;4
4566;Lakštingala;Pėledžiukai;1347480198;Ne;0;8;0;8
4567;Lakštingala;Pėledžiukai;88947243829;Taip;5;1;0;6
4568;Lakštingala;Pėledžiukai;6329787217;Taip;0;0;5;5
4569;Lakštingala;Pėledžiukai;58056130761;Taip;0;7;0;7
4570;Lakštingala;Pėledžiukai;1310400524;Taip;0;2;3;5
4571;Lakštingala;Pėledžiukai;2013216779;Taip;0;0;1;1
4572;Lakštingala;Pėledžiukai;8890852891;Taip;0;0;3;3
4573;Lakštingala;Pėledžiukai;9998322501;Taip;3;0;13;16
4574;Lakštingala;Katinėliai;6780591792;Ne;21;0;0;21
4575;Lakštingala;Katinėliai;8422745100;Taip;12;0;2;14
4576;Lakštingala;Katinėliai;2022621678;Taip;0;0;12;12
4577;Lakštingala;Katinėliai;9762500668;Taip;3;2;1;6
4578;Lakštingala;Katinėliai;8703818797;Taip;19;0;0;19
4579;Lakštingala;Katinėliai;4365413054;Taip;0;0;10;10
4580;Lakštingala;Katinėliai;7455063702;Ne;0;0;19;19
4581;Lakštingala;Katinėliai;7640007392;Taip;14;1;0;15
4582;Lakštingala;Katinėliai;4784677514;Taip;10;0;0;10
4583;Lakštingala;Katinėliai;1619201521;Taip;8;0;0;8
4584;Lakštingala;Katinėliai;8429523368;Taip;0;0;6;6
4585;Lakštingala;Katinėliai;6668075753;Taip;0;0;4;4
4586;Lakštingala;Katinėliai;9081653166;Taip;19;1;0;20
4587;Lakštingala;Katinėliai;8160825203;Taip;5;0;0;5
4588;Lakštingala;Katinėliai;2371619895;Taip;20;0;0;20
4589;Lakštingala;Katinėliai;7404386777;Taip;0;0;11;11
4590;Lakštingala;Katinėliai;4698879435;Taip;8;0;0;8
4591;Lakštingala;Katinėliai;8722490845;Taip;0;15;0;15
4592;Lakštingala;Katinėliai;1220858944;Taip;7;0;0;7
4593;Lakštingala;Deimantėliai;3568151046;Taip;9;0;1;10
4594;Lakštingala;Deimantėliai;3369263112;Taip;16;0;0;16
4595;Lakštingala;Deimantėliai;4774354751;Taip;0;0;5;5
4596;Lakštingala;Deimantėliai;3766779594;Taip;5;0;0;5
4597;Lakštingala;Deimantėliai;7139669240;Taip;0;17;0;17
4598;Lakštingala;Deimantėliai;3050655193;Taip;6;8;0;14
4599;Lakštingala;Deimantėliai;5969052108;Taip;0;0;3;3
4600;Lakštingala;Deimantėliai;2738882466;Taip;1;0;0;1
4601;Lakštingala;Deimantėliai;2663268027;Taip;0;0;5;5
4602;Lakštingala;Deimantėliai;6135103377;Taip;3;0;0;3
4603;Lakštingala;Deimantėliai;8075192528;Taip;0;0;5;5
4604;Lakštingala;Deimantėliai;9297542026;Taip;6;1;2;9
4605;Lakštingala;Deimantėliai;3618452008;Taip;0;7;0;7
4606;Lakštingala;Deimantėliai;3858771190;Taip;7;0;7;14
4607;Lakštingala;Deimantėliai;8375506323;Taip;0;0;1;1
4608;Lakštingala;Deimantėliai;8717764626;Taip;12;0;0;12
4609;Lakštingala;Deimantėliai;2962846236;Taip;13;8;0;21
4610;Lakštingala;Deimantėliai;1474796466;Taip;0;0;13;13
4611;Lašelis;VIŠČIUKAI;3982877012;Taip;17;0;1;18
4612;Lašelis;VIŠČIUKAI;6136792125;Ne;0;0;1;1
4613;Lašelis;VIŠČIUKAI;8324581018;Ne;10;1;1;12
4614;Lašelis;VIŠČIUKAI;6977000987;Taip;10;0;1;11
4615;Lašelis;VIŠČIUKAI;1268330178;Taip;11;1;5;17
4616;Lašelis;VIŠČIUKAI;1417989409;Taip;0;0;6;6
4617;Lašelis;VIŠČIUKAI;6090290046;Taip;7;1;0;8
4618;Lašelis;VIŠČIUKAI;1578956182;Taip;11;1;0;12
4619;Lašelis;VIŠČIUKAI;2500332755;Taip;8;2;0;10
4620;Lašelis;VIŠČIUKAI;1739797553;Taip;0;2;0;2
4621;Lašelis;VIŠČIUKAI;2113295854;Ne;9;0;0;9
4622;Lašelis;VIŠČIUKAI;65174922062;Ne;0;5;0;5
4623;Lašelis;VIŠČIUKAI;5046619730;Taip;0;4;0;4
4624;Lašelis;VIŠČIUKAI;1193336600;Taip;0;14;0;14
4625;Lašelis;VIŠČIUKAI;3741905080;Taip;0;21;0;21
4626;Lašelis;VIŠČIUKAI;6492909546;Ne;0;9;0;9
4627;Lašelis;VIŠČIUKAI;7471332824;Taip;9;4;0;13
4628;Lašelis;VIŠČIUKAI;4599789649;Ne;7;5;0;12
4629;Lašelis;ŠYPSENA;2635903222;Taip;0;9;0;9
4630;Lašelis;ŠYPSENA;2204859014;Taip;11;0;0;11
4631;Lašelis;ŠYPSENA;3239288878;Taip;16;1;0;17
4632;Lašelis;ŠYPSENA;3144718477;Taip;15;0;0;15
4633;Lašelis;ŠYPSENA;1777442316;Ne;0;0;4;4
4634;Lašelis;ŠYPSENA;7998812497;Taip;18;3;0;21
4635;Lašelis;ŠYPSENA;6669130831;Taip;3;0;0;3
4636;Lašelis;ŠYPSENA;7802622810;Taip;0;1;0;1
4637;Lašelis;ŠYPSENA;1886540733;Taip;10;0;0;10
4638;Lašelis;ŠYPSENA;6553762186;Taip;0;12;0;12
4639;Lašelis;ŠYPSENA;1085400709;Taip;10;8;0;18
4640;Lašelis;ŠYPSENA;6127747445;Taip;0;7;0;7
4641;Lašelis;ŠYPSENA;2912232814;Taip;10;0;1;11
4642;Lašelis;ŠYPSENA;4151582358;Taip;0;16;0;16
4643;Lašelis;ŠYPSENA;1646912457;Taip;11;6;0;17
4644;Lašelis;ŠYPSENA;6080664872;Taip;0;1;9;10
4645;Lašelis;ŠYPSENA;6829438486;Taip;13;0;0;13
4646;Lašelis;NYKŠTUKAI;4320017329;Taip;2;0;1;3
4647;Lašelis;NYKŠTUKAI;60394164372;Taip;0;3;0;3
4648;Lašelis;NYKŠTUKAI;1584708183;Taip;0;4;0;4
4649;Lašelis;NYKŠTUKAI;713862923;Taip;6;5;0;11
4650;Lašelis;NYKŠTUKAI;2118500745;Taip;8;0;2;10
4651;Lašelis;NYKŠTUKAI;14934740494;Ne;6;3;0;9
4652;Lašelis;NYKŠTUKAI;8332516807;Taip;0;0;2;2
4653;Lašelis;NYKŠTUKAI;10694830733;Ne;5;7;0;12
4654;Lašelis;NYKŠTUKAI;1282991939;Taip;8;0;0;8
4655;Lašelis;NYKŠTUKAI;82073061357;Taip;6;3;0;9
4656;Lašelis;NYKŠTUKAI;58391864442;Taip;0;0;2;2
4657;Lašelis;NYKŠTUKAI;5437008837;Taip;11;0;0;11
4658;Lašelis;NYKŠTUKAI;8873895533;Taip;21;0;0;21
4659;Lašelis;NYKŠTUKAI;2429224297;Taip;0;5;0;5
4660;Lašelis;NYKŠTUKAI;1383759549;Taip;11;0;4;15
4661;Lašelis;NYKŠTUKAI;86191407652;Taip;0;1;0;1
4662;Lašelis;NYKŠTUKAI;9391594216;Taip;6;6;0;12
4663;Lašelis;NYKŠTUKAI;1987591278;Taip;15;0;1;16
4664;Lašelis;SAULUTĖ;1171647193;Taip;10;0;0;10
4665;Lašelis;SAULUTĖ;1711262987;Taip;6;2;2;10
4666;Lašelis;SAULUTĖ;29417065142;Taip;0;12;0;12
4667;Lašelis;SAULUTĖ;37726695989;Taip;0;2;3;5
4668;Lašelis;SAULUTĖ;28071639285;Taip;0;3;0;3
4669;Lašelis;SAULUTĖ;1635550414;Taip;12;3;0;15
4670;Lašelis;SAULUTĖ;1833121579;Taip;0;0;1;1
4671;Lašelis;SAULUTĖ;1917927039;Taip;0;16;0;16
4672;Lašelis;SAULUTĖ;38601962350;Taip;0;2;0;2
4673;Lašelis;SAULUTĖ;1099685342;Taip;9;5;0;14
4674;Lašelis;SAULUTĖ;40927906931;Taip;0;0;5;5
4675;Lašelis;SAULUTĖ;1534313851;Taip;0;2;0;2
4676;Lašelis;SAULUTĖ;34947111596;Taip;0;1;0;1
4677;Lašelis;BORUŽĖLĖS;2886967297;Taip;1;6;0;7
4678;Lašelis;BORUŽĖLĖS;8132517365;Taip;18;3;0;21
4679;Lašelis;BORUŽĖLĖS;1175045927;Taip;7;0;0;7
4680;Lašelis;BORUŽĖLĖS;2401058384;Ne;13;0;2;15
4681;Lašelis;BORUŽĖLĖS;1244168190;Taip;7;4;0;11
4682;Lašelis;BORUŽĖLĖS;2034007263;Taip;6;0;0;6
4683;Lašelis;BORUŽĖLĖS;7367305924;Taip;9;0;4;13
4684;Lašelis;BORUŽĖLĖS;3297005183;Ne;6;0;0;6
4685;Lašelis;BORUŽĖLĖS;8318512396;Taip;0;1;0;1
4686;Lašelis;BORUŽĖLĖS;7657786815;Taip;0;4;0;4
4687;Lašelis;BORUŽĖLĖS;3843163586;Taip;4;2;0;6
4688;Lašelis;BORUŽĖLĖS;6304391719;Taip;3;0;0;3
4689;Lašelis;BORUŽĖLĖS;1085950130;Taip;1;0;0;1
4690;Lašelis;SKRUZDELIUKAI;5392759654;Ne;13;5;0;18
4691;Lašelis;SKRUZDELIUKAI;1824418095;Taip;0;5;0;5
4692;Lašelis;SKRUZDELIUKAI;7137348151;Taip;21;0;0;21
4693;Lašelis;SKRUZDELIUKAI;3995905195;Taip;13;0;0;13
4694;Lašelis;SKRUZDELIUKAI;6227091658;Taip;0;7;0;7
4695;Lašelis;SKRUZDELIUKAI;2223293390;Ne;6;0;0;6
4696;Lazdynėlis;BITUTĖS;4881322530;Taip;9;0;0;9
4697;Lazdynėlis;BITUTĖS;6643600680;Taip;5;1;0;6
4698;Lazdynėlis;BITUTĖS;5182241318;Ne;0;6;0;6
4699;Lazdynėlis;BITUTĖS;6762312809;Taip;5;2;0;7
4700;Lazdynėlis;BITUTĖS;8008332680;Taip;8;0;1;9
4701;Lazdynėlis;BITUTĖS;1748260780;Taip;0;21;0;21
4702;Lazdynėlis;BITUTĖS;4462819848;Taip;3;0;1;4
4703;Lazdynėlis;BITUTĖS;1574847460;Taip;0;1;4;5
4704;Lazdynėlis;BITUTĖS;5030400578;Taip;6;0;0;6
4705;Lazdynėlis;BITUTĖS;8159928299;Taip;5;0;1;6
4706;Lazdynėlis;BITUTĖS;9761942869;Taip;2;0;0;2
4707;Lazdynėlis;BITUTĖS;7911328294;Taip;8;1;0;9
4708;Lazdynėlis;BITUTĖS;1450181711;Taip;4;2;5;11
4709;Lazdynėlis;BITUTĖS;2044188250;Taip;14;1;0;15
4710;Lazdynėlis;BITUTĖS;4142277927;Taip;9;5;0;14
4711;Lazdynėlis;BITUTĖS;2032759165;Taip;0;2;0;2
4712;Lazdynėlis;BITUTĖS;4826167852;Taip;0;1;3;4
4713;Lazdynėlis;BITUTĖS;2802505435;Taip;0;6;0;6
4714;Lazdynėlis;BITUTĖS;6038907328;Ne;0;19;0;19
4715;Lazdynėlis;BITUTĖS;2586187455;Taip;13;0;0;13
4716;Lazdynėlis;BITUTĖS;2013752858;Taip;12;0;3;15
4717;Lazdynėlis;BITUTĖS;4545757725;Taip;10;0;0;10
4718;Lazdynėlis;EŽIUKAI;6787228086;Taip;0;9;0;9
4719;Lazdynėlis;EŽIUKAI;3091067158;Taip;0;9;0;9
4720;Lazdynėlis;EŽIUKAI;1593314326;Taip;5;1;0;6
4721;Lazdynėlis;EŽIUKAI;2041709821;Taip;0;21;0;21
4722;Lazdynėlis;EŽIUKAI;32856469893;Taip;10;1;0;11
4723;Lazdynėlis;EŽIUKAI;6542840562;Taip;0;2;0;2
4724;Lazdynėlis;EŽIUKAI;8975341347;Taip;0;1;0;1
4725;Lazdynėlis;EŽIUKAI;5301460250;Taip;5;0;1;6
4726;Lazdynėlis;EŽIUKAI;1265404063;Taip;2;1;1;4
4727;Lazdynėlis;EŽIUKAI;83586382037;Taip;0;1;2;3
4728;Lazdynėlis;EŽIUKAI;7313399153;Taip;0;1;0;1
4729;Lazdynėlis;EŽIUKAI;10727984477;Taip;0;1;3;4
4730;Lazdynėlis;EŽIUKAI;9081770664;Taip;5;0;0;5
4731;Lazdynėlis;EŽIUKAI;1479568714;Taip;0;12;1;13
4732;Lazdynėlis;EŽIUKAI;8271766964;Ne;0;21;0;21
4733;Lazdynėlis;EŽIUKAI;9668839027;Ne;0;3;0;3
4734;Lazdynėlis;EŽIUKAI;47861078891;Taip;0;2;0;2
4735;Lazdynėlis;EŽIUKAI;2841262230;Taip;0;21;0;21
4736;Lazdynėlis;EŽIUKAI;7499322078;Taip;10;1;0;11
4737;Lazdynėlis;EŽIUKAI;48860174942;Taip;4;1;0;5
4738;Lazdynėlis;EŽIUKAI;92889991874;Taip;5;1;0;6
4739;Lazdynėlis;EŽIUKAI;65806780298;Taip;0;0;3;3
4740;Lazdynėlis;EŽIUKAI;91720096560;Taip;0;1;0;1
4741;Lazdynėlis;BORUŽIUKAI;2168516394;Taip;0;11;0;11
4742;Lazdynėlis;BORUŽIUKAI;4961149717;Taip;0;7;0;7
4743;Lazdynėlis;BORUŽIUKAI;99475014554;Taip;3;1;0;4
4744;Lazdynėlis;BORUŽIUKAI;6156638726;Ne;0;8;0;8
4745;Lazdynėlis;BORUŽIUKAI;9570299877;Taip;0;21;0;21
4746;Lazdynėlis;BORUŽIUKAI;1715738053;Taip;0;10;0;10
4747;Lazdynėlis;BORUŽIUKAI;50390821034;Taip;0;2;0;2
4748;Lazdynėlis;BORUŽIUKAI;2112064241;Taip;8;0;0;8
4749;Lazdynėlis;BORUŽIUKAI;57448939020;Taip;7;1;0;8
4750;Lazdynėlis;BORUŽIUKAI;1789237348;Taip;6;5;0;11
4751;Lazdynėlis;BORUŽIUKAI;2007361692;Taip;4;0;0;4
4752;Lazdynėlis;BORUŽIUKAI;2105998927;Taip;0;10;0;10
4753;Lazdynėlis;BORUŽIUKAI;29288665418;Taip;21;0;0;21
4754;Lazdynėlis;BORUŽIUKAI;11379612306;Taip;0;1;3;4
4755;Lazdynėlis;BORUŽIUKAI;7237629135;Taip;10;0;0;10
4756;Lazdynėlis;BORUŽIUKAI;3863927885;Taip;0;3;0;3
4757;Lazdynėlis;BORUŽIUKAI;8945282683;Taip;0;2;0;2
4758;Lazdynėlis;BORUŽIUKAI;5838945434;Taip;0;4;0;4
4759;Lazdynėlis;BORUŽIUKAI;6230420677;Taip;4;5;0;9
4760;Lazdynėlis;KAČIUKAI;66134107213;Taip;7;1;0;8
4761;Lazdynėlis;KAČIUKAI;67819115627;Taip;2;0;0;2
4762;Lazdynėlis;KAČIUKAI;52949287680;Taip;0;1;0;1
4763;Lazdynėlis;KAČIUKAI;97795271362;Taip;11;1;3;15
4764;Lazdynėlis;KAČIUKAI;56747379453;Taip;0;1;0;1
4765;Lazdynėlis;KAČIUKAI;1634936961;Taip;21;0;0;21
4766;Lazdynėlis;KAČIUKAI;78302777769;Taip;2;5;0;7
4767;Lazdynėlis;KAČIUKAI;85340642919;Taip;4;1;0;5
4768;Lazdynėlis;KAČIUKAI;77950321376;Taip;0;1;0;1
4769;Lazdynėlis;KAČIUKAI;5068598385;Taip;3;0;0;3
4770;Lazdynėlis;KAČIUKAI;2491872016;Taip;3;0;0;3
4771;Lazdynėlis;KAČIUKAI;2740122426;Taip;8;2;0;10
4772;Lazdynėlis;KAČIUKAI;79847018203;Taip;0;5;0;5
4773;Lazdynėlis;KAČIUKAI;1126756897;Ne;0;1;0;1
4774;Lazdynėlis;KAČIUKAI;9881554733;Ne;0;1;0;1
4775;Lazdynėlis;KAČIUKAI;79583491543;Taip;0;1;0;1
4776;Lazdynėlis;KAČIUKAI;1878157118;Taip;0;1;2;3
4777;Lazdynėlis;KAČIUKAI;7242681767;Taip;7;1;0;8
4778;Lazdynėlis;VOVERIUKAI;4425724586;Taip;5;1;2;8
4779;Lazdynėlis;VOVERIUKAI;6684940385;Taip;0;0;5;5
4780;Lazdynėlis;VOVERIUKAI;9187681789;Taip;0;0;10;10
4781;Lazdynėlis;VOVERIUKAI;6307407620;Taip;0;0;2;2
4782;Lazdynėlis;VOVERIUKAI;14427234202;Taip;0;0;1;1
4783;Lazdynėlis;VOVERIUKAI;1107441074;Ne;7;1;0;8
4784;Lazdynėlis;VOVERIUKAI;25596458181;Taip;0;21;0;21
4785;Lazdynėlis;VOVERIUKAI;24978945607;Taip;2;0;0;2
4786;Lazdynėlis;VOVERIUKAI;158059657;Taip;2;0;1;3
4787;Lazdynėlis;VOVERIUKAI;1852865534;Taip;0;0;2;2
4788;Lazdynėlis;VOVERIUKAI;7789345652;Taip;0;0;5;5
4789;Lazdynėlis;VOVERIUKAI;3902772678;Taip;5;1;1;7
4790;Lazdynėlis;VOVERIUKAI;8822378464;Ne;11;0;0;11
4791;Lazdynėlis;VOVERIUKAI;6863715428;Taip;5;0;0;5
4792;Lazdynėlis;VOVERIUKAI;2587142646;Taip;0;0;2;2
4793;Lazdynėlis;VOVERIUKAI;2603427970;Taip;21;0;0;21
4794;Lazdynėlis;VOVERIUKAI;3043350186;Taip;6;0;7;13
4795;Lazdynėlis;VOVERIUKAI;44510351979;Taip;0;9;9;18
4796;Lazdynėlis;VOVERIUKAI;7965433882;Taip;0;1;3;4
4797;Lazdynėlis;VOVERIUKAI;1424382629;Taip;0;0;18;18
4798;Lazdynėlis;RIEŠUTĖLIAI;53141612488;Taip;0;1;1;2
4799;Lazdynėlis;RIEŠUTĖLIAI;81489861336;Taip;0;1;0;1
4800;Lazdynėlis;RIEŠUTĖLIAI;11830560488;Taip;11;3;0;14
4801;Lazdynėlis;RIEŠUTĖLIAI;24433496244;Taip;0;13;0;13
4802;Lazdynėlis;RIEŠUTĖLIAI;99158632198;Taip;0;1;0;1
4803;Lazdynėlis;RIEŠUTĖLIAI;4510916643;Taip;5;1;0;6
4804;Lazdynėlis;RIEŠUTĖLIAI;91895608057;Taip;0;6;0;6
4805;Lazdynėlis;RIEŠUTĖLIAI;95091154108;Taip;2;1;0;3
4806;Lazdynėlis;RIEŠUTĖLIAI;95539787778;Taip;0;12;0;12
4807;Lazdynėlis;RIEŠUTĖLIAI;3000783343;Taip;5;1;0;6
4808;Lazdynėlis;RIEŠUTĖLIAI;75017112973;Taip;0;1;0;1
4809;Lazdynėlis;RIEŠUTĖLIAI;66392058189;Taip;0;11;0;11
4810;Lazdynėlis;RIEŠUTĖLIAI;93311489447;Taip;0;12;0;12
4811;Lazdynėlis;RIEŠUTĖLIAI;3980826951;Taip;0;2;0;2
4812;Lazdynėlis;RIEŠUTĖLIAI;8338944978;Taip;0;1;0;1
4813;Lazdynėlis;RIEŠUTĖLIAI;1213657708;Taip;0;1;2;3
4814;Lazdynėlis;RIEŠUTĖLIAI;1169424024;Taip;0;1;0;1
4815;Lazdynėlis;RIEŠUTĖLIAI;1257093165;Taip;0;1;0;1
4816;Lazdynėlis;RIEŠUTĖLIAI;42460029042;Taip;0;1;0;1
4817;Lazdynėlis;RIEŠUTĖLIAI;1166968513;Taip;0;1;0;1
4818;Lazdynėlis;RIEŠUTĖLIAI;58985240094;Taip;5;1;0;6
4819;Lazdynėlis;RIEŠUTĖLIAI;7044338769;Taip;0;1;0;1
4820;Lazdynėlis;RIEŠUTĖLIAI;9186165264;Taip;10;1;0;11
4821;Lazdynėlis;RIEŠUTĖLIAI;90528749634;Ne;0;2;0;2
4822;Lazdynėlis;ANČIUKAI;5557752248;Taip;12;0;1;13
4823;Lazdynėlis;ANČIUKAI;5888646355;Taip;10;0;3;13
4824;Lazdynėlis;ANČIUKAI;8295967906;Taip;0;0;6;6
4825;Lazdynėlis;ANČIUKAI;7076664657;Taip;4;0;4;8
4826;Lazdynėlis;ANČIUKAI;7864896721;Taip;5;0;1;6
4827;Lazdynėlis;ANČIUKAI;8435203145;Taip;0;21;0;21
4828;Lazdynėlis;ANČIUKAI;4779025603;Taip;0;16;0;16
4829;Lazdynėlis;ANČIUKAI;1335000592;Ne;14;0;0;14
4830;Lazdynėlis;ANČIUKAI;8314002741;Taip;0;5;0;5
4831;Lazdynėlis;ANČIUKAI;2998606948;Taip;12;0;0;12
4832;Lazdynėlis;ANČIUKAI;9886856760;Taip;12;0;0;12
4833;Lazdynėlis;ANČIUKAI;3062408541;Ne;0;21;0;21
4834;Lazdynėlis;ANČIUKAI;7941793866;Taip;15;0;0;15
4835;Lazdynėlis;ANČIUKAI;5796381191;Taip;3;0;0;3
4836;Lazdynėlis;ANČIUKAI;7545621720;Taip;7;1;6;14
4837;Lazdynėlis;ANČIUKAI;9582702244;Taip;5;1;0;6
4838;Lazdynėlis;ANČIUKAI;9231049001;Taip;0;0;5;5
4839;Lazdynėlis;ANČIUKAI;6164180360;Taip;0;0;8;8
4840;Lazdynėlis;GUDRUČIAI;46106429615;Taip;3;8;0;11
4841;Lazdynėlis;GUDRUČIAI;11183641643;Taip;4;0;0;4
4842;Lazdynėlis;GUDRUČIAI;1543682603;Taip;0;1;1;2
4843;Lazdynėlis;GUDRUČIAI;6079498859;Ne;0;0;3;3
4844;Lazdynėlis;GUDRUČIAI;96599967318;Taip;0;1;1;2
4845;Lazdynėlis;GUDRUČIAI;16456265624;Taip;0;10;0;10
4846;Lazdynėlis;GUDRUČIAI;44974714364;Taip;0;1;0;1
4847;Lazdynėlis;GUDRUČIAI;57304690488;Taip;0;0;3;3
4848;Lazdynėlis;GUDRUČIAI;57619129301;Taip;0;2;1;3
4849;Lazdynėlis;GUDRUČIAI;64086512959;Taip;0;1;1;2
4850;Lazdynėlis;GUDRUČIAI;56719158862;Taip;4;2;1;7
4851;Lazdynėlis;GUDRUČIAI;76657029807;Taip;0;1;0;1
4852;Lazdynėlis;GUDRUČIAI;41094911675;Taip;5;1;0;6
4853;Lazdynėlis;GUDRUČIAI;70505428445;Taip;0;1;0;1
4854;Lazdynėlis;GUDRUČIAI;1349582895;Ne;10;1;0;11
4855;Lazdynėlis;GUDRUČIAI;34657435789;Taip;0;5;0;5
4856;Lazdynėlis;GUDRUČIAI;62863155757;Taip;0;1;0;1
4857;Lazdynėlis;GUDRUČIAI;34619798427;Taip;6;1;0;7
4858;Lazdynėlis;GUDRUČIAI;1909075641;Taip;5;1;0;6
4859;Lazdynėlis;GUDRUČIAI;2496563388;Taip;0;2;2;4
4860;Lazdynėlis;GUDRUČIAI;28670815274;Taip;0;1;0;1
4861;Lazdynėlis;GUDRUČIAI;8704566189;Taip;0;1;0;1
4862;Lazdynėlis;MEŠKIUKAI;3667994076;Taip;21;0;0;21
4863;Lazdynėlis;MEŠKIUKAI;3239107488;Ne;0;6;0;6
4864;Lazdynėlis;MEŠKIUKAI;1325204410;Taip;0;1;3;4
4865;Lazdynėlis;MEŠKIUKAI;3604282352;Taip;9;0;0;9
4866;Lazdynėlis;MEŠKIUKAI;3062924645;Taip;0;6;0;6
4867;Lazdynėlis;MEŠKIUKAI;8179584161;Taip;10;1;1;12
4868;Lazdynėlis;MEŠKIUKAI;8942906327;Ne;18;0;0;18
4869;Lazdynėlis;MEŠKIUKAI;7523052754;Taip;0;21;0;21
4870;Lazdynėlis;MEŠKIUKAI;8248185061;Taip;5;0;1;6
4871;Lazdynėlis;MEŠKIUKAI;8627994583;Taip;0;21;0;21
4872;Lazdynėlis;MEŠKIUKAI;9548653584;Taip;0;21;0;21
4873;Lazdynėlis;MEŠKIUKAI;8337458289;Taip;0;21;0;21
4874;Lazdynėlis;MEŠKIUKAI;3040417651;Taip;0;21;0;21
4875;Lazdynėlis;MEŠKIUKAI;3362193379;Taip;0;1;0;1
4876;Linelis;Giliukai;4443285231;Taip;0;1;3;4
4877;Linelis;Giliukai;79543604124;Taip;0;0;5;5
4878;Linelis;Giliukai;3300710386;Taip;8;0;1;9
4879;Linelis;Giliukai;1505058152;Ne;6;0;5;11
4880;Linelis;Giliukai;4644771654;Taip;14;1;0;15
4881;Linelis;Giliukai;94514045159;Taip;6;0;1;7
4882;Linelis;Giliukai;1270931913;Taip;0;1;5;6
4883;Linelis;Giliukai;1237521453;Taip;0;1;1;2
4884;Linelis;Giliukai;1270843542;Taip;0;1;1;2
4885;Linelis;Giliukai;1159267747;Taip;13;3;0;16
4886;Linelis;Giliukai;58467930454;Taip;0;1;6;7
4887;Linelis;Giliukai;5075219728;Taip;0;1;0;1
4888;Linelis;Giliukai;5302605429;Taip;9;0;2;11
4889;Linelis;Giliukai;1891722948;Ne;3;0;1;4
4890;Linelis;Giliukai;71647031404;Ne;7;0;0;7
4891;Linelis;Giliukai;1148540808;Taip;7;0;1;8
4892;Linelis;Giliukai;46788785414;Taip;0;1;2;3
4893;Linelis;Giliukai;3483401448;Ne;0;1;9;10
4894;Linelis;Giliukai;61862257310;Taip;0;0;1;1
4895;Linelis;Giliukai;1526473615;Ne;6;0;1;7
4896;Linelis;Saulutė;1374116898;Ne;0;1;3;4
4897;Linelis;Saulutė;76034696439;Taip;0;0;4;4
4898;Linelis;Saulutė;77154624822;Taip;0;1;0;1
4899;Linelis;Saulutė;54594020356;Ne;0;1;6;7
4900;Linelis;Saulutė;68038417200;Taip;10;0;0;10
4901;Linelis;Saulutė;13522521866;Taip;0;1;0;1
4902;Linelis;Saulutė;92658776822;Taip;0;4;0;4
4903;Linelis;Saulutė;29074930927;Taip;5;0;0;5
4904;Linelis;Saulutė;68089107580;Taip;0;1;0;1
4905;Linelis;Saulutė;1646521870;Taip;0;0;3;3
4906;Linelis;Saulutė;93959783827;Taip;0;1;2;3
4907;Linelis;Saulutė;73386013083;Taip;4;10;1;15
4908;Linelis;Saulutė;32821891070;Ne;0;9;3;12
4909;Linelis;Saulutė;18414199111;Taip;16;0;0;16
4910;Linelis;Saulutė;1908259203;Taip;0;1;5;6
4911;Linelis;Nykštukai;8339073780;Taip;0;0;9;9
4912;Linelis;Nykštukai;7530950218;Ne;5;1;0;6
4913;Linelis;Nykštukai;1194624252;Taip;0;0;1;1
4914;Linelis;Nykštukai;2391319590;Taip;10;0;0;10
4915;Linelis;Nykštukai;9666785036;Ne;0;0;4;4
4916;Linelis;Nykštukai;8095635609;Ne;0;0;4;4
4917;Linelis;Nykštukai;4253571334;Taip;0;0;1;1
4918;Linelis;Nykštukai;4126444564;Taip;11;0;0;11
4919;Linelis;Nykštukai;8837847094;Taip;0;0;5;5
4920;Linelis;Nykštukai;4738909947;Ne;0;1;0;1
4921;Linelis;Nykštukai;3189188757;Taip;4;5;0;9
4922;Linelis;Nykštukai;1351957198;Taip;10;0;1;11
4923;Linelis;Nykštukai;3682550072;Taip;0;0;1;1
4924;Linelis;Nykštukai;2857645329;Taip;7;1;1;9
4925;Linelis;Nykštukai;6130634131;Taip;0;0;3;3
4926;Linelis;Nykštukai;8654487151;Taip;8;0;0;8
4927;Linelis;Nykštukai;6160295507;Taip;0;0;5;5
4928;Linelis;Nykštukai;6374352500;Taip;9;7;0;16
4929;Linelis;Daigiukai;9775865557;Taip;10;0;0;10
4930;Linelis;Daigiukai;4456549120;Taip;14;0;1;15
4931;Linelis;Daigiukai;7320085613;Taip;16;0;0;16
4932;Linelis;Daigiukai;2194387139;Taip;5;0;1;6
4933;Linelis;Daigiukai;6460217912;Taip;0;0;4;4
4934;Linelis;Daigiukai;1612049897;Taip;4;0;3;7
4935;Linelis;Daigiukai;2228682366;Taip;4;5;0;9
4936;Linelis;Daigiukai;7011836009;Taip;13;0;0;13
4937;Linelis;Daigiukai;6735037523;Taip;0;0;8;8
4938;Linelis;Daigiukai;7881263225;Taip;11;0;0;11
4939;Linelis;Daigiukai;9920959446;Taip;9;0;0;9
4940;Linelis;Daigiukai;8623441952;Taip;17;0;0;17
4941;Linelis;Daigiukai;9154573489;Taip;7;0;3;10
4942;Linelis;Daigiukai;9024362190;Taip;0;0;21;21
4943;Linelis;Daigiukai;8609248429;Taip;6;0;10;16
4944;Markučiai;Žirniukų;4934200922;Taip;0;8;0;8
4945;Markučiai;Žirniukų;89393452327;Taip;0;1;1;2
4946;Markučiai;Žirniukų;61354140820;Taip;0;3;0;3
4947;Markučiai;Žirniukų;86073430849;Taip;0;1;2;3
4948;Markučiai;Žirniukų;23712199138;Taip;2;1;0;3
4949;Markučiai;Žirniukų;59514770545;Taip;5;0;0;5
4950;Markučiai;Žirniukų;68178936347;Taip;3;1;0;4
4951;Markučiai;Žirniukų;1193600084;Taip;0;3;0;3
4952;Markučiai;Žirniukų;3498150320;Taip;4;0;1;5
4953;Markučiai;Žirniukų;1150675918;Taip;0;1;3;4
4954;Markučiai;Žirniukų;95347461846;Taip;4;0;0;4
4955;Markučiai;Žirniukų;1962169822;Taip;0;2;0;2
4956;Markučiai;Žirniukų;1986626575;Taip;12;0;0;12
4957;Markučiai;Žirniukų;2397953983;Taip;10;0;0;10
4958;Markučiai;Nykštukų;46647877230;Taip;5;4;0;9
4959;Markučiai;Nykštukų;37101160556;Taip;0;2;2;4
4960;Markučiai;Nykštukų;1473258832;Taip;10;4;0;14
4961;Markučiai;Nykštukų;92394309416;Taip;0;1;5;6
4962;Markučiai;Nykštukų;5026941590;Taip;7;1;0;8
4963;Markučiai;Nykštukų;81140027425;Taip;0;0;1;1
4964;Markučiai;Nykštukų;6915912992;Taip;0;1;5;6
4965;Markučiai;Nykštukų;88304161598;Taip;11;2;0;13
4966;Markučiai;Nykštukų;76003071176;Taip;0;10;0;10
4967;Markučiai;Nykštukų;1464123752;Taip;5;1;0;6
4968;Markučiai;Nykštukų;1937352406;Taip;0;1;0;1
4969;Markučiai;Nykštukų;1821127640;Taip;0;1;0;1
4970;Markučiai;Nykštukų;6639579832;Taip;14;3;0;17
4971;Markučiai;Nykštukų;9985442003;Taip;0;8;0;8
4972;Markučiai;Nykštukų;1507368475;Taip;7;1;0;8
4973;Markučiai;Nykštukų;1817367317;Taip;0;1;2;3
4974;Markučiai;Nykštukų;5954207590;Taip;13;2;0;15
4975;Markučiai;Pelėdžiukų;3386071459;Taip;1;0;1;2
4976;Markučiai;Pelėdžiukų;4653663237;Ne;16;0;0;16
4977;Markučiai;Pelėdžiukų;6260010822;Taip;0;10;1;11
4978;Markučiai;Pelėdžiukų;5727655114;Taip;0;2;0;2
4979;Markučiai;Pelėdžiukų;6740434675;Taip;20;0;1;21
4980;Markučiai;Pelėdžiukų;6707310242;Taip;21;0;0;21
4981;Markučiai;Pelėdžiukų;2256262371;Taip;12;3;0;15
4982;Markučiai;Pelėdžiukų;7947287013;Taip;15;1;0;16
4983;Markučiai;Pelėdžiukų;2543313198;Taip;9;0;2;11
4984;Markučiai;Pelėdžiukų;4418580273;Taip;0;0;2;2
4985;Markučiai;Pelėdžiukų;5522654429;Taip;10;0;1;11
4986;Markučiai;Pelėdžiukų;4860961508;Taip;21;0;0;21
4987;Markučiai;Pelėdžiukų;9219710045;Ne;9;0;0;9
4988;Markučiai;Boružėlių;9059302464;Taip;6;0;5;11
4989;Markučiai;Boružėlių;9220749889;Taip;20;1;0;21
4990;Markučiai;Boružėlių;2962530721;Taip;0;2;1;3
4991;Markučiai;Boružėlių;6574037877;Taip;4;0;0;4
4992;Markučiai;Boružėlių;5752762229;Taip;0;1;0;1
4993;Markučiai;Boružėlių;4383421917;Taip;0;3;0;3
4994;Markučiai;Boružėlių;9789274040;Taip;0;0;4;4
4995;Markučiai;Boružėlių;1171899107;Taip;3;0;0;3
4996;Markučiai;Boružėlių;8092642447;Ne;0;0;3;3
4997;Markučiai;Boružėlių;8078777204;Taip;12;0;0;12
4998;Markučiai;Boružėlių;8605357678;Taip;4;1;1;6
4999;Markučiai;Boružėlių;3755794133;Taip;10;1;3;14
5000;Markučiai;Boružėlių;8244065962;Ne;0;1;0;1
5001;Markučiai;Boružėlių;5902165968;Taip;0;5;0;5
5002;Markučiai;Boružėlių;6055058096;Taip;19;0;0;19
5003;Markučiai;Boružėlių;5981692282;Taip;6;0;1;7
5004;Markučiai;Boružėlių;3739566642;Taip;15;1;0;16
5005;Markučiai;Boružėlių;6868394315;Taip;0;1;1;2
5006;Markučiai;Bitučių;8792524832;Taip;5;1;0;6
5007;Markučiai;Bitučių;1717624510;Taip;5;0;4;9
5008;Markučiai;Bitučių;9518247571;Taip;12;0;0;12
5009;Markučiai;Bitučių;4836298058;Taip;5;0;0;5
5010;Markučiai;Bitučių;9027071539;Taip;0;1;0;1
5011;Markučiai;Bitučių;8748794886;Taip;0;0;6;6
5012;Markučiai;Bitučių;7387460586;Taip;8;0;0;8
5013;Markučiai;Bitučių;8950442843;Taip;5;0;2;7
5014;Markučiai;Bitučių;2840564082;Ne;5;0;1;6
5015;Markučiai;Bitučių;3926993383;Taip;2;0;5;7
5016;Markučiai;Bitučių;6530101961;Taip;12;0;0;12
5017;Markučiai;Bitučių;1908302738;Taip;0;0;7;7
5018;Markučiai;Bitučių;7056367646;Taip;12;1;0;13
5019;Markučiai;Bitučių;2049497686;Taip;14;0;0;14
5020;Markučiai;Bitučių;9303448709;Taip;0;11;5;16
5021;Markučiai;Bitučių;8541042547;Taip;15;0;4;19
5022;Markučiai;Bitučių;1447116821;Taip;3;0;3;6
5023;Markučiai;Bitučių;6600535396;Taip;6;0;4;10
5024;Markučiai;Drugelių;2851424931;Taip;2;0;0;2
5025;Markučiai;Drugelių;1719927769;Taip;1;0;0;1
5026;Markučiai;Drugelių;1411292558;Taip;2;1;0;3
5027;Markučiai;Drugelių;63211076619;Taip;0;1;1;2
5028;Markučiai;Drugelių;2608111078;Taip;7;0;3;10
5029;Markučiai;Drugelių;9428254633;Taip;0;2;1;3
5030;Markučiai;Drugelių;61666612833;Taip;0;1;0;1
5031;Markučiai;Drugelių;20261053601;Taip;0;1;0;1
5032;Markučiai;Drugelių;4573605085;Ne;15;0;0;15
5033;Markučiai;Drugelių;19415636420;Taip;11;0;0;11
5034;Markučiai;Drugelių;24315961901;Taip;0;0;5;5
5035;Markučiai;Drugelių;45698891062;Taip;1;0;0;1
5036;Markučiai;Drugelių;22197471483;Taip;0;5;0;5
5037;Markučiai;Drugelių;9028932081;Taip;1;12;0;13
5038;Markučiai;Drugelių;11203825718;Taip;10;0;0;10
5039;Markučiai;Drugelių;7194049189;Taip;0;2;0;2
5040;Markučiai;Drugelių;1964223995;Taip;0;0;1;1
5041;Markučiai;Drugelių;23081602011;Ne;10;0;6;16
5042;Markučiai;Drugelių;9295954145;Taip;7;0;2;9
5043;Markučiai;Skruzdėliukų;1471334430;Taip;0;0;4;4
5044;Markučiai;Skruzdėliukų;9825799013;Ne;0;1;0;1
5045;Markučiai;Skruzdėliukų;8803226424;Taip;0;0;3;3
5046;Markučiai;Skruzdėliukų;55093673733;Taip;0;0;4;4
5047;Markučiai;Skruzdėliukų;39971140989;Taip;0;1;0;1
5048;Markučiai;Skruzdėliukų;54732351634;Taip;0;1;4;5
5049;Markučiai;Skruzdėliukų;1419433247;Taip;10;5;0;15
5050;Markučiai;Skruzdėliukų;1089500743;Taip;0;14;2;16
5051;Markučiai;Skruzdėliukų;2939795063;Taip;2;6;0;8
5052;Markučiai;Skruzdėliukų;9285037135;Taip;0;0;1;1
5053;Markučiai;Skruzdėliukų;1699369138;Taip;0;0;10;10
5054;Markučiai;Skruzdėliukų;1881218133;Taip;3;1;1;5
5055;Markučiai;Skruzdėliukų;8863238710;Ne;0;0;11;11
5056;Markučiai;Skruzdėliukų;68193563408;Taip;8;0;0;8
5057;Markučiai;Skruzdėliukų;92854605649;Taip;7;0;3;10
5058;Markučiai;Skruzdėliukų;7114409929;Taip;0;0;2;2
5059;Markučiai;Skruzdėliukų;1529531638;Taip;0;10;0;10
5060;Markučiai;Skruzdėliukų;4511936094;Taip;0;1;0;1
5061;Markučiai;ZUIKUČIŲ;82320812575;Taip;0;1;0;1
5062;Markučiai;ZUIKUČIŲ;4861535057;Taip;3;0;0;3
5063;Markučiai;ZUIKUČIŲ;2045207175;Taip;6;0;0;6
5064;Markučiai;ZUIKUČIŲ;11751635395;Taip;7;0;0;7
5065;Markučiai;ZUIKUČIŲ;1184908076;Taip;5;0;3;8
5066;Markučiai;ZUIKUČIŲ;7729045227;Taip;19;0;0;19
5067;Markučiai;ZUIKUČIŲ;1392582514;Taip;5;2;0;7
5068;Markučiai;ZUIKUČIŲ;7691410556;Taip;10;1;0;11
5069;Markučiai;ZUIKUČIŲ;7969520467;Taip;10;0;0;10
5070;Markučiai;ZUIKUČIŲ;6453095915;Taip;10;0;0;10
5071;Markučiai;ZUIKUČIŲ;6808291628;Taip;10;0;0;10
5072;Markučiai;ZUIKUČIŲ;5387571295;Taip;8;0;0;8
5073;Markučiai;ZUIKUČIŲ;3794643964;Taip;7;1;0;8
5074;Markučiai;ZUIKUČIŲ;91228262895;Taip;11;0;0;11
5075;Markučiai;ZUIKUČIŲ;7481923902;Taip;2;0;0;2
5076;Markučiai;ZUIKUČIŲ;1025406111;Taip;0;13;0;13
5077;Markučiai;ZUIKUČIŲ;5749873170;Taip;0;0;3;3
5078;Markučiai;ZUIKUČIŲ;7778551869;Ne;0;0;5;5
5079;Markučiai;ŽIOGELIŲ;5099997904;Taip;0;0;6;6
5080;Markučiai;ŽIOGELIŲ;3163226803;Taip;6;0;1;7
5081;Markučiai;ŽIOGELIŲ;1244026489;Taip;0;0;6;6
5082;Markučiai;ŽIOGELIŲ;76025616287;Taip;8;4;0;12
5083;Markučiai;ŽIOGELIŲ;1323922187;Taip;6;1;0;7
5084;Markučiai;ŽIOGELIŲ;54892037118;Taip;0;2;5;7
5085;Markučiai;ŽIOGELIŲ;1054802708;Taip;0;1;0;1
5086;Markučiai;ŽIOGELIŲ;67074776419;Taip;0;1;0;1
5087;Markučiai;ŽIOGELIŲ;1007919702;Taip;5;10;0;15
5088;Markučiai;ŽIOGELIŲ;7850311496;Taip;6;0;0;6
5089;Markučiai;ŽIOGELIŲ;2169583290;Taip;7;9;0;16
5090;Markučiai;ŽIOGELIŲ;3340385503;Taip;6;7;0;13
5091;Markučiai;ŽIOGELIŲ;4152184290;Taip;0;0;2;2
5092;Markučiai;ŽIOGELIŲ;1742944578;Taip;0;0;2;2
5093;Markučiai;ŽIOGELIŲ;23267867195;Taip;0;0;5;5
5094;Markučiai;Ežiukių;1827829954;Taip;0;2;0;2
5095;Markučiai;Ežiukių;4925856706;Taip;0;17;0;17
5096;Markučiai;Ežiukių;6570638672;Taip;0;6;0;6
5097;Markučiai;Ežiukių;3771563320;Taip;1;0;0;1
5098;Markučiai;Ežiukių;1648283497;Taip;10;5;0;15
5099;Markučiai;Ežiukių;4186684938;Taip;11;0;0;11
5100;Markučiai;Ežiukių;5975331223;Taip;6;0;0;6
5101;Markučiai;Ežiukių;2687320408;Ne;3;1;0;4
5102;Markučiai;Ežiukių;1309122110;Taip;0;1;1;2
5103;Markučiai;Ežiukių;8990923872;Taip;12;0;0;12
5104;Markučiai;Ežiukių;2738553283;Taip;17;0;4;21
5105;Markučiai;Ežiukių;5246980173;Ne;5;0;0;5
5106;Markučiai;Ežiukių;1599633295;Taip;0;3;0;3
5107;Markučiai;Ežiukių;6308368050;Ne;21;0;0;21
5108;Markučiai;Ežiukių;5958705106;Taip;0;10;0;10
5109;Markučiai;Ežiukių;3770972703;Taip;7;0;8;15
5110;Mažylis;"2 DARŽELIO GR.";2979849055;Ne;0;0;1;1
5111;Mažylis;"2 DARŽELIO GR.";4503734408;Taip;0;0;2;2
5112;Mažylis;"2 DARŽELIO GR.";6162880220;Taip;0;0;1;1
5113;Mažylis;"2 DARŽELIO GR.";9362249595;Taip;12;0;3;15
5114;Mažylis;"2 DARŽELIO GR.";1077493584;Taip;5;0;1;6
5115;Mažylis;"2 DARŽELIO GR.";6854350717;Taip;0;0;4;4
5116;Mažylis;"2 DARŽELIO GR.";5870983755;Ne;0;1;2;3
5117;Mažylis;"2 DARŽELIO GR.";7185347381;Taip;0;0;2;2
5118;Mažylis;"2 DARŽELIO GR.";3327673298;Ne;3;0;1;4
5119;Mažylis;"2 DARŽELIO GR.";4280547746;Taip;7;0;2;9
5120;Mažylis;"2 DARŽELIO GR.";9447747294;Taip;0;0;5;5
5121;Mažylis;"2 DARŽELIO GR.";2126108232;Taip;0;0;10;10
5122;Mažylis;"2 DARŽELIO GR.";9382248260;Taip;0;0;4;4
5123;Mažylis;"2 DARŽELIO GR.";1762105763;Taip;0;1;0;1
5124;Mažylis;"2 DARŽELIO GR.";2672500259;Taip;0;0;4;4
5125;Mažylis;"2 DARŽELIO GR.";8135596731;Taip;18;0;0;18
5126;Mažylis;"2 DARŽELIO GR.";8866980930;Taip;0;0;2;2
5127;Mažylis;"2 DARŽELIO GR.";4542742002;Taip;0;0;7;7
5128;Mažylis;"4 PRIEŠMOKYKLINĖ GR.";4899739075;Taip;0;5;0;5
5129;Mažylis;"4 PRIEŠMOKYKLINĖ GR.";1217081615;Taip;0;0;2;2
5130;Mažylis;"4 PRIEŠMOKYKLINĖ GR.";67697608754;Taip;0;1;0;1
5131;Mažylis;"4 PRIEŠMOKYKLINĖ GR.";71414598607;Taip;0;1;0;1
5132;Mažylis;"4 PRIEŠMOKYKLINĖ GR.";2249845212;Taip;0;1;7;8
5133;Mažylis;"4 PRIEŠMOKYKLINĖ GR.";10093289570;Ne;0;0;1;1
5134;Mažylis;"4 PRIEŠMOKYKLINĖ GR.";94128544096;Taip;0;1;0;1
5135;Mažylis;"4 PRIEŠMOKYKLINĖ GR.";99612915803;Taip;5;0;7;12
5136;Mažylis;"4 PRIEŠMOKYKLINĖ GR.";72018918082;Taip;0;0;2;2
5137;Mažylis;"4 PRIEŠMOKYKLINĖ GR.";88409362086;Taip;3;1;0;4
5138;Mažylis;"4 PRIEŠMOKYKLINĖ GR.";34677678888;Ne;0;5;0;5
5139;Mažylis;"4 PRIEŠMOKYKLINĖ GR.";44917962136;Taip;6;1;0;7
5140;Mažylis;"4 PRIEŠMOKYKLINĖ GR.";1023886258;Ne;0;0;7;7
5141;Mažylis;"4 PRIEŠMOKYKLINĖ GR.";68630915872;Taip;0;0;2;2
5142;Mažylis;"4 PRIEŠMOKYKLINĖ GR.";1418120714;Taip;0;0;1;1
5143;Mažylis;"4 PRIEŠMOKYKLINĖ GR.";1381948803;Taip;0;0;6;6
5144;Mažylis;"4 PRIEŠMOKYKLINĖ GR.";33428832459;Taip;0;0;3;3
5145;Mažylis;"4 PRIEŠMOKYKLINĖ GR.";1355103006;Taip;6;2;0;8
5146;Mažylis;"4 PRIEŠMOKYKLINĖ GR.";5570166468;Taip;0;0;2;2
5147;Mažylis;"5 DARŽ.GR.";7774469604;Taip;0;0;7;7
5148;Mažylis;"5 DARŽ.GR.";9095049088;Taip;0;2;0;2
5149;Mažylis;"5 DARŽ.GR.";1692808423;Taip;0;0;6;6
5150;Mažylis;"5 DARŽ.GR.";76814348181;Taip;0;0;3;3
5151;Mažylis;"5 DARŽ.GR.";18640177395;Taip;0;0;5;5
5152;Mažylis;"5 DARŽ.GR.";37676161966;Ne;0;0;2;2
5153;Mažylis;"5 DARŽ.GR.";91436869919;Taip;0;1;5;6
5154;Mažylis;"5 DARŽ.GR.";36307201422;Taip;0;1;1;2
5155;Mažylis;"5 DARŽ.GR.";37179412928;Taip;6;0;2;8
5156;Mažylis;"5 DARŽ.GR.";9958976870;Taip;0;1;2;3
5157;Mažylis;"5 DARŽ.GR.";56438009944;Ne;0;3;0;3
5158;Mažylis;"5 DARŽ.GR.";11471986928;Taip;0;1;1;2
5159;Mažylis;"5 DARŽ.GR.";87637767247;Taip;0;0;1;1
5160;Mažylis;"5 DARŽ.GR.";1391395429;Taip;0;0;4;4
5161;Mažylis;"5 DARŽ.GR.";43986953632;Ne;0;0;3;3
5162;Mažylis;"5 DARŽ.GR.";8439933210;Taip;0;0;2;2
5163;Mažylis;"5 DARŽ.GR.";3436690709;Taip;0;0;1;1
5164;Mažylis;"5 DARŽ.GR.";8318476578;Taip;19;0;0;19
5165;Mažylis;"5 DARŽ.GR.";8490035231;Taip;0;14;0;14
5166;Mažylis;"3 DARŽELIO GR.";98057700570;Taip;0;1;1;2
5167;Mažylis;"3 DARŽELIO GR.";24303144913;Taip;0;0;1;1
5168;Mažylis;"3 DARŽELIO GR.";50868656860;Taip;10;1;0;11
5169;Mažylis;"3 DARŽELIO GR.";2070067356;Ne;0;1;0;1
5170;Mažylis;"3 DARŽELIO GR.";81907805809;Taip;18;0;0;18
5171;Mažylis;"3 DARŽELIO GR.";1999937720;Taip;0;0;5;5
5172;Mažylis;"3 DARŽELIO GR.";98251642256;Taip;0;1;0;1
5173;Mažylis;"3 DARŽELIO GR.";90336289067;Ne;0;1;2;3
5174;Mažylis;"3 DARŽELIO GR.";1021183555;Taip;4;1;2;7
5175;Mažylis;"3 DARŽELIO GR.";2299288258;Taip;0;0;8;8
5176;Mažylis;"3 DARŽELIO GR.";1520251270;Taip;4;0;6;10
5177;Mažylis;"3 DARŽELIO GR.";5271395545;Taip;5;0;1;6
5178;Mažylis;"6 DARŽELIO GR.";9411559447;Taip;0;0;2;2
5179;Mažylis;"6 DARŽELIO GR.";79181926145;Taip;3;0;2;5
5180;Mažylis;"6 DARŽELIO GR.";45148418456;Taip;0;1;2;3
5181;Mažylis;"6 DARŽELIO GR.";8352202912;Taip;1;0;0;1
5182;Mažylis;"6 DARŽELIO GR.";38277640135;Taip;0;1;1;2
5183;Mažylis;"6 DARŽELIO GR.";8899463988;Taip;5;0;1;6
5184;Mažylis;"6 DARŽELIO GR.";1663347167;Ne;14;0;2;16
5185;Mažylis;"6 DARŽELIO GR.";5063094678;Taip;9;0;2;11
5186;Mažylis;"6 DARŽELIO GR.";3860760654;Taip;3;0;2;5
5187;Mažylis;"6 DARŽELIO GR.";6851169340;Taip;0;0;1;1
5188;Mažylis;"6 DARŽELIO GR.";4486742281;Taip;10;0;2;12
5189;Mažylis;"6 DARŽELIO GR.";4252408251;Ne;5;0;0;5
5190;Mažylis;"6 DARŽELIO GR.";3217527771;Taip;0;1;1;2
5191;Mažylis;"6 DARŽELIO GR.";6134051712;Taip;0;1;0;1
5192;Mažylis;"6 DARŽELIO GR.";7416381505;Ne;11;0;1;12
5193;Mažylis;"6 DARŽELIO GR.";1514640197;Taip;0;0;11;11
5194;Mažylis;"6 DARŽELIO GR.";1002832487;Taip;0;3;0;3
5195;Mažylis;"6 DARŽELIO GR.";9608529135;Taip;4;0;6;10
5196;Mažylis;"1 NAUJA (LOPŠELIS)";6100650710;Taip;0;0;5;5
5197;Mažylis;"1 NAUJA (LOPŠELIS)";5685988186;Taip;3;0;0;3
5198;Mažylis;"1 NAUJA (LOPŠELIS)";7754956214;Taip;0;0;5;5
5199;Mažylis;"1 NAUJA (LOPŠELIS)";8589124394;Taip;6;0;1;7
5200;Mažylis;"1 NAUJA (LOPŠELIS)";8639480781;Taip;6;0;2;8
5201;Mažylis;"1 NAUJA (LOPŠELIS)";2672864291;Taip;0;0;3;3
5202;Mažylis;"1 NAUJA (LOPŠELIS)";9401388775;Taip;0;0;13;13
5203;Mažylis;"1 NAUJA (LOPŠELIS)";6009637985;Taip;0;0;2;2
5204;Mažylis;"1 NAUJA (LOPŠELIS)";3400122626;Taip;0;0;2;2
5205;Mažylis;"1 NAUJA (LOPŠELIS)";6809320247;Taip;13;0;0;13
5206;Mažylis;"1 NAUJA (LOPŠELIS)";7052112957;Taip;0;0;2;2
5207;Mažylis;"1 NAUJA (LOPŠELIS)";9341935211;Taip;15;0;1;16
5208;Mažylis;"1 NAUJA (LOPŠELIS)";4817146074;Taip;0;0;3;3
5209;Mažylis;"1 NAUJA (LOPŠELIS)";2656290898;Taip;0;0;1;1
5210;Medynėlis;BITUTĖS;1721728772;Taip;4;1;0;5
5211;Medynėlis;BITUTĖS;1870621987;Taip;0;1;2;3
5212;Medynėlis;BITUTĖS;51942577095;Taip;0;2;0;2
5213;Medynėlis;BITUTĖS;57858019710;Ne;0;1;0;1
5214;Medynėlis;BITUTĖS;78341557395;Taip;7;1;0;8
5215;Medynėlis;BITUTĖS;38838111813;Taip;0;1;0;1
5216;Medynėlis;BITUTĖS;72334464245;Ne;0;1;0;1
5217;Medynėlis;BITUTĖS;39476010274;Ne;7;1;0;8
5218;Medynėlis;BITUTĖS;7522506857;Taip;0;1;0;1
5219;Medynėlis;BITUTĖS;2055140361;Taip;0;1;0;1
5220;Medynėlis;BITUTĖS;1663988144;Taip;0;1;0;1
5221;Medynėlis;BITUTĖS;3684709853;Taip;0;1;0;1
5222;Medynėlis;BITUTĖS;65852278020;Taip;0;1;0;1
5223;Medynėlis;BITUTĖS;34879998108;Taip;0;1;0;1
5224;Medynėlis;DRUGELIAI;29673282359;Taip;0;2;0;2
5225;Medynėlis;DRUGELIAI;56207399170;Taip;0;1;0;1
5226;Medynėlis;DRUGELIAI;77267420461;Taip;21;0;0;21
5227;Medynėlis;DRUGELIAI;64020246327;Taip;0;1;0;1
5228;Medynėlis;DRUGELIAI;82368415455;Ne;1;0;0;1
5229;Medynėlis;DRUGELIAI;22422832248;Taip;16;0;0;16
5230;Medynėlis;DRUGELIAI;69233446672;Taip;0;3;0;3
5231;Medynėlis;DRUGELIAI;1673034349;Ne;0;3;0;3
5232;Medynėlis;DRUGELIAI;22845549109;Taip;0;3;0;3
5233;Medynėlis;DRUGELIAI;20592655649;Taip;0;2;0;2
5234;Medynėlis;DRUGELIAI;64603154583;Taip;0;2;0;2
5235;Medynėlis;DRUGELIAI;27434992072;Ne;3;0;0;3
5236;Medynėlis;DRUGELIAI;68940537831;Taip;0;8;0;8
5237;Medynėlis;DRUGELIAI;75083011184;Taip;21;0;0;21
5238;Medynėlis;DRUGELIAI;5748498291;Ne;0;2;0;2
5239;Medynėlis;DRUGELIAI;76282032727;Taip;0;2;0;2
5240;Medynėlis;DRUGELIAI;97943522374;Taip;10;1;0;11
5241;Medynėlis;DRUGELIAI;1864572888;Taip;6;1;0;7
5242;Medynėlis;DRUGELIAI;1828684971;Taip;0;9;0;9
5243;Medynėlis;DRUGELIAI;30399789674;Taip;6;7;0;13
5244;Medynėlis;SKRUZDĖLIUKAI;4024866819;Taip;4;5;0;9
5245;Medynėlis;SKRUZDĖLIUKAI;2418225089;Taip;4;1;0;5
5246;Medynėlis;SKRUZDĖLIUKAI;1827495325;Taip;0;1;0;1
5247;Medynėlis;SKRUZDĖLIUKAI;9413309043;Taip;0;0;5;5
5248;Medynėlis;SKRUZDĖLIUKAI;4581683292;Taip;21;0;0;21
5249;Medynėlis;SKRUZDĖLIUKAI;4137297035;Taip;5;0;0;5
5250;Medynėlis;SKRUZDĖLIUKAI;9009316740;Taip;5;4;0;9
5251;Medynėlis;SKRUZDĖLIUKAI;1795479738;Taip;6;5;0;11
5252;Medynėlis;SKRUZDĖLIUKAI;5530782065;Taip;11;0;0;11
5253;Medynėlis;SKRUZDĖLIUKAI;5269927048;Taip;11;0;6;17
5254;Medynėlis;SKRUZDĖLIUKAI;2427349194;Taip;3;7;0;10
5255;Medynėlis;SKRUZDĖLIUKAI;8948133343;Taip;0;4;0;4
5256;Medynėlis;SKRUZDĖLIUKAI;7244497661;Ne;6;5;0;11
5257;Medynėlis;SKRUZDĖLIUKAI;5995034919;Taip;0;5;2;7
5258;Medynėlis;SKRUZDĖLIUKAI;8775219704;Taip;0;5;0;5
5259;Medynėlis;SKRUZDĖLIUKAI;1658457155;Taip;4;1;3;8
5260;Medynėlis;SKRUZDĖLIUKAI;33981260502;Taip;0;1;4;5
5261;Medynėlis;SKRUZDĖLIUKAI;3773215372;Taip;0;2;0;2
5262;Medynėlis;SKRUZDĖLIUKAI;6343851636;Ne;0;0;4;4
5263;Medynėlis;VOVERIUKAI;2834559432;Taip;3;0;2;5
5264;Medynėlis;VOVERIUKAI;2310200034;Ne;4;4;0;8
5265;Medynėlis;VOVERIUKAI;90556319090;Taip;0;2;0;2
5266;Medynėlis;VOVERIUKAI;6999562417;Taip;15;1;1;17
5267;Medynėlis;VOVERIUKAI;5586407412;Taip;7;0;5;12
5268;Medynėlis;VOVERIUKAI;7108619017;Taip;5;10;0;15
5269;Medynėlis;VOVERIUKAI;8441104709;Taip;0;0;1;1
5270;Medynėlis;VOVERIUKAI;1820113382;Taip;0;6;0;6
5271;Medynėlis;VOVERIUKAI;9304002459;Taip;3;0;0;3
5272;Medynėlis;VOVERIUKAI;5982453884;Taip;10;0;0;10
5273;Medynėlis;VOVERIUKAI;1173510831;Taip;0;1;0;1
5274;Medynėlis;VOVERIUKAI;6406459222;Taip;10;6;0;16
5275;Medynėlis;VOVERIUKAI;2335108073;Ne;9;0;1;10
5276;Medynėlis;VOVERIUKAI;4985243068;Taip;5;0;1;6
5277;Medynėlis;VOVERIUKAI;2057309788;Taip;0;0;4;4
5278;Medynėlis;VOVERIUKAI;9073514151;Taip;0;8;0;8
5279;Medynėlis;VOVERIUKAI;4238860287;Ne;0;0;1;1
5280;Medynėlis;VOVERIUKAI;1750775033;Taip;0;4;0;4
5281;Medynėlis;VOVERIUKAI;9800678364;Taip;20;0;1;21
5282;Medynėlis;VOVERIUKAI;1237589979;Taip;16;0;3;19
5283;Medynėlis;MEŠKIUKAI;1434648803;Ne;5;0;0;5
5284;Medynėlis;MEŠKIUKAI;1975763240;Ne;0;5;0;5
5285;Medynėlis;MEŠKIUKAI;5347745655;Ne;9;0;2;11
5286;Medynėlis;MEŠKIUKAI;1781906016;Taip;0;2;0;2
5287;Medynėlis;MEŠKIUKAI;91658912153;Taip;0;5;0;5
5288;Medynėlis;MEŠKIUKAI;1269734734;Taip;0;10;0;10
5289;Medynėlis;MEŠKIUKAI;46445461622;Taip;7;2;0;9
5290;Medynėlis;MEŠKIUKAI;7226012217;Taip;11;0;2;13
5291;Medynėlis;MEŠKIUKAI;5007624930;Ne;4;7;0;11
5292;Medynėlis;MEŠKIUKAI;9476336240;Ne;18;0;0;18
5293;Medynėlis;MEŠKIUKAI;8629622922;Ne;0;0;3;3
5294;Medynėlis;MEŠKIUKAI;1479759021;Taip;3;1;1;5
5295;Medynėlis;MEŠKIUKAI;1635649525;Ne;0;3;0;3
5296;Medynėlis;MEŠKIUKAI;6479758789;Taip;10;0;0;10
5297;Medynėlis;MEŠKIUKAI;12287981032;Taip;11;1;0;12
5298;Medynėlis;MEŠKIUKAI;12812096047;Taip;7;0;0;7
5299;Medynėlis;MEŠKIUKAI;2326848026;Taip;0;0;4;4
5300;Medynėlis;MEŠKIUKAI;5924711043;Taip;0;1;0;1
5301;Medynėlis;MEŠKIUKAI;8143370943;Taip;11;0;5;16
5302;Medynėlis;MEŠKIUKAI;32683798983;Taip;13;0;0;13
5303;Medynėlis;MEŠKIUKAI;99799126572;Taip;7;2;0;9
5304;Medynėlis;PELĖDŽIUKAI;1379827887;Taip;18;0;0;18
5305;Medynėlis;PELĖDŽIUKAI;1829338208;Ne;7;2;0;9
5306;Medynėlis;PELĖDŽIUKAI;88240380945;Taip;0;6;0;6
5307;Medynėlis;PELĖDŽIUKAI;1129265551;Taip;0;3;0;3
5308;Medynėlis;PELĖDŽIUKAI;76668029492;Taip;13;0;0;13
5309;Medynėlis;PELĖDŽIUKAI;1080058205;Taip;6;0;3;9
5310;Medynėlis;PELĖDŽIUKAI;38759466139;Taip;5;3;0;8
5311;Medynėlis;PELĖDŽIUKAI;1968892466;Taip;0;8;0;8
5312;Medynėlis;PELĖDŽIUKAI;1194247621;Taip;9;0;5;14
5313;Medynėlis;PELĖDŽIUKAI;1755767517;Taip;15;0;0;15
5314;Medynėlis;PELĖDŽIUKAI;37435525923;Taip;0;10;0;10
5315;Medynėlis;PELĖDŽIUKAI;1415208530;Taip;0;1;3;4
5316;Medynėlis;PELĖDŽIUKAI;7804751416;Ne;15;0;0;15
5317;Medynėlis;PELĖDŽIUKAI;6182500688;Ne;9;0;1;10
5318;Medynėlis;PELĖDŽIUKAI;8122944228;Taip;9;1;2;12
5319;Medynėlis;PELĖDŽIUKAI;15047814683;Taip;0;0;1;1
5320;Medynėlis;PELĖDŽIUKAI;1937403950;Ne;0;1;0;1
5321;Medynėlis;PELĖDŽIUKAI;12150004702;Ne;0;1;0;1
5322;Medynėlis;BORUŽIUKAI;1657676226;Taip;0;3;0;3
5323;Medynėlis;BORUŽIUKAI;1314163134;Taip;1;1;0;2
5324;Medynėlis;BORUŽIUKAI;1010025777;Taip;0;1;0;1
5325;Medynėlis;BORUŽIUKAI;96544597673;Taip;5;1;0;6
5326;Medynėlis;BORUŽIUKAI;79786316561;Taip;10;2;0;12
5327;Medynėlis;BORUŽIUKAI;1693185124;Taip;0;2;0;2
5328;Medynėlis;BORUŽIUKAI;1563329598;Taip;0;4;0;4
5329;Medynėlis;BORUŽIUKAI;1611512841;Taip;0;4;0;4
5330;Medynėlis;BORUŽIUKAI;55848491611;Taip;7;2;0;9
5331;Medynėlis;BORUŽIUKAI;1192592678;Ne;17;0;0;17
5332;Medynėlis;BORUŽIUKAI;7628899696;Taip;0;2;0;2
5333;Medynėlis;BORUŽIUKAI;2044676215;Taip;6;0;0;6
5334;Medynėlis;BORUŽIUKAI;48636516521;Taip;1;0;0;1
5335;Medynėlis;BORUŽIUKAI;4929075779;Taip;0;1;0;1
5336;Medynėlis;EŽIUKAI;1409464952;Taip;0;1;0;1
5337;Medynėlis;EŽIUKAI;2026582294;Taip;1;5;0;6
5338;Medynėlis;EŽIUKAI;1437000615;Taip;0;8;0;8
5339;Medynėlis;EŽIUKAI;1995078812;Taip;0;0;5;5
5340;Medynėlis;EŽIUKAI;1208227740;Taip;0;3;0;3
5341;Medynėlis;EŽIUKAI;31443674861;Taip;0;1;0;1
5342;Medynėlis;EŽIUKAI;3165639252;Ne;9;0;2;11
5343;Medynėlis;EŽIUKAI;1882919126;Taip;10;3;0;13
5344;Medynėlis;EŽIUKAI;1472082682;Taip;4;0;0;4
5345;Medynėlis;EŽIUKAI;50558260808;Taip;0;1;1;2
5346;Medynėlis;EŽIUKAI;61158254770;Taip;0;3;0;3
5347;Medynėlis;EŽIUKAI;1216195798;Taip;0;8;0;8
5348;Medynėlis;EŽIUKAI;2406561273;Taip;0;2;1;3
5349;Medynėlis;EŽIUKAI;3225662051;Taip;0;3;0;3
5350;Medynėlis;EŽIUKAI;1311654913;Taip;0;1;0;1
5351;Medynėlis;EŽIUKAI;1915791061;Taip;0;1;0;1
5352;Medynėlis;EŽIUKAI;1036752305;Taip;2;6;0;8
5353;Medynėlis;ZUIKUČIAI;6706028300;Taip;0;0;1;1
5354;Medynėlis;ZUIKUČIAI;9438854582;Taip;7;0;0;7
5355;Medynėlis;ZUIKUČIAI;9079900803;Taip;9;0;0;9
5356;Medynėlis;ZUIKUČIAI;3856908872;Ne;6;0;0;6
5357;Medynėlis;ZUIKUČIAI;8276864168;Ne;0;0;2;2
5358;Medynėlis;ZUIKUČIAI;8074251036;Taip;5;5;0;10
5359;Medynėlis;ZUIKUČIAI;2932544910;Taip;6;0;0;6
5360;Medynėlis;ZUIKUČIAI;6955467123;Taip;3;0;0;3
5361;Medynėlis;ZUIKUČIAI;5785463517;Taip;2;0;0;2
5362;Medynėlis;ZUIKUČIAI;9184868565;Taip;6;0;0;6
5363;Medynėlis;ZUIKUČIAI;1621499650;Taip;5;2;0;7
5364;Medynėlis;ZUIKUČIAI;4222917765;Taip;5;2;0;7
5365;Medynėlis;ZUIKUČIAI;4323515017;Taip;6;0;3;9
5366;Medynėlis;ZUIKUČIAI;5571641847;Taip;11;1;0;12
5367;Medynėlis;ZUIKUČIAI;6681155625;Taip;3;6;0;9
5368;Medynėlis;ZUIKUČIAI;6073797962;Taip;3;3;0;6
5369;Medynėlis;ZUIKUČIAI;9355165862;Taip;2;2;0;4
5370;Medynėlis;ZUIKUČIAI;1901805808;Taip;5;0;0;5
5371;Medynėlis;ZUIKUČIAI;5784691118;Taip;5;0;0;5
5372;Medynėlis;KAČIUKAI;7740591575;Taip;0;1;0;1
5373;Medynėlis;KAČIUKAI;3761845905;Taip;3;1;0;4
5374;Medynėlis;KAČIUKAI;9825580191;Taip;6;0;0;6
5375;Medynėlis;KAČIUKAI;1475701065;Taip;4;7;0;11
5376;Medynėlis;KAČIUKAI;7638618099;Ne;16;0;1;17
5377;Medynėlis;KAČIUKAI;2627655353;Ne;0;7;4;11
5378;Medynėlis;KAČIUKAI;4100792567;Taip;0;0;1;1
5379;Medynėlis;KAČIUKAI;2086963376;Taip;0;3;0;3
5380;Medynėlis;KAČIUKAI;1056744101;Taip;0;21;0;21
5381;Medynėlis;KAČIUKAI;7455041214;Taip;6;6;2;14
5382;Medynėlis;KAČIUKAI;3554823424;Taip;8;1;0;9
5383;Medynėlis;KAČIUKAI;7272017225;Taip;3;0;0;3
5384;Medynėlis;KAČIUKAI;4092824377;Taip;6;0;0;6
5385;Medynėlis;KAČIUKAI;6826790492;Taip;2;0;0;2
5386;Medynėlis;KAČIUKAI;4488439037;Taip;5;1;1;7
5387;Medynėlis;KAČIUKAI;6485314750;Taip;10;0;0;10
5388;Medynėlis;KAČIUKAI;6101613567;Ne;0;1;1;2
5389;Medynėlis;KAČIUKAI;2234994999;Taip;0;6;0;6
5390;Medynėlis;PELIUKAI;9314893329;Taip;0;5;0;5
5391;Medynėlis;PELIUKAI;3787172254;Taip;0;0;2;2
5392;Medynėlis;PELIUKAI;5051773825;Taip;9;0;0;9
5393;Medynėlis;PELIUKAI;1525185037;Ne;0;2;2;4
5394;Medynėlis;PELIUKAI;6218943275;Taip;0;1;2;3
5395;Medynėlis;PELIUKAI;1406029765;Taip;2;0;3;5
5396;Medynėlis;PELIUKAI;1162859552;Taip;0;3;0;3
5397;Medynėlis;PELIUKAI;6032067904;Ne;1;0;0;1
5398;Medynėlis;PELIUKAI;7232396755;Taip;0;5;2;7
5399;Medynėlis;PELIUKAI;9919108302;Taip;9;2;0;11
5400;Medynėlis;PELIUKAI;1463263793;Taip;5;4;0;9
5401;Medynėlis;PELIUKAI;1333848517;Taip;0;3;3;6
5402;Medynėlis;PELIUKAI;3270413614;Taip;7;1;0;8
5403;Medynėlis;PELIUKAI;5532880670;Taip;7;0;3;10
5404;Medynėlis;PELIUKAI;7651663404;Taip;0;0;4;4
5405;Medynėlis;PELIUKAI;5446430319;Taip;0;0;5;5
5406;Medynėlis;PELIUKAI;8271170887;Ne;5;0;0;5
5407;Medynėlis;PELIUKAI;4315717555;Taip;5;0;6;11
5408;Molinukas;NYKŠTUKAI;6353165459;Taip;6;0;0;6
5409;Molinukas;NYKŠTUKAI;5876669121;Taip;10;0;0;10
5410;Molinukas;NYKŠTUKAI;6087698882;Taip;10;0;1;11
5411;Molinukas;NYKŠTUKAI;2211909678;Taip;0;0;1;1
5412;Molinukas;NYKŠTUKAI;2348120316;Taip;0;0;3;3
5413;Molinukas;NYKŠTUKAI;8053608348;Taip;5;1;0;6
5414;Molinukas;NYKŠTUKAI;6014990150;Ne;5;5;2;12
5415;Molinukas;NYKŠTUKAI;7623051674;Ne;8;1;0;9
5416;Molinukas;NYKŠTUKAI;9448910819;Taip;0;5;2;7
5417;Molinukas;NYKŠTUKAI;1651650182;Taip;0;0;1;1
5418;Molinukas;NYKŠTUKAI;5580968328;Ne;7;6;4;17
5419;Molinukas;NYKŠTUKAI;8536615996;Ne;4;0;2;6
5420;Molinukas;NYKŠTUKAI;1849018608;Taip;0;1;4;5
5421;Molinukas;NYKŠTUKAI;4171978721;Taip;6;0;0;6
5422;Molinukas;NYKŠTUKAI;7134802574;Taip;9;0;0;9
5423;Molinukas;NYKŠTUKAI;8260101075;Taip;9;0;0;9
5424;Molinukas;NYKŠTUKAI;9293819449;Taip;11;5;0;16
5425;Molinukas;NYKŠTUKAI;9244598883;Taip;11;0;0;11
5426;Molinukas;NYKŠTUKAI;5525772579;Taip;9;0;1;10
5427;Molinukas;ZUIKUČIŲ;5387818175;Ne;0;0;1;1
5428;Molinukas;ZUIKUČIŲ;1138255845;Taip;0;5;2;7
5429;Molinukas;ZUIKUČIŲ;6326031969;Taip;0;4;0;4
5430;Molinukas;ZUIKUČIŲ;7398075402;Taip;9;1;1;11
5431;Molinukas;ZUIKUČIŲ;4534279257;Ne;12;0;0;12
5432;Molinukas;ZUIKUČIŲ;8688180482;Ne;7;1;0;8
5433;Molinukas;ZUIKUČIŲ;1686122652;Taip;5;1;0;6
5434;Molinukas;ZUIKUČIŲ;2324578741;Taip;0;14;2;16
5435;Molinukas;ZUIKUČIŲ;4918181437;Taip;5;0;3;8
5436;Molinukas;ZUIKUČIŲ;8604288346;Taip;5;0;1;6
5437;Molinukas;ZUIKUČIŲ;1856269656;Taip;0;1;0;1
5438;Molinukas;ZUIKUČIŲ;6636118069;Taip;0;12;0;12
5439;Molinukas;ZUIKUČIŲ;2774371800;Ne;21;0;0;21
5440;Molinukas;ZUIKUČIŲ;8913137310;Ne;0;8;0;8
5441;Molinukas;ZUIKUČIŲ;8416644024;Taip;10;0;3;13
5442;Molinukas;ZUIKUČIŲ;4766547534;Taip;14;0;0;14
5443;Molinukas;SRAIGIUKŲ;25761685637;Taip;0;1;0;1
5444;Molinukas;SRAIGIUKŲ;24664585525;Taip;0;1;0;1
5445;Molinukas;SRAIGIUKŲ;96140904528;Taip;10;1;0;11
5446;Molinukas;SRAIGIUKŲ;25402100091;Taip;0;1;0;1
5447;Molinukas;SRAIGIUKŲ;62719013867;Taip;0;0;2;2
5448;Molinukas;SRAIGIUKŲ;81968957100;Taip;11;0;1;12
5449;Molinukas;SRAIGIUKŲ;96366441416;Taip;0;1;1;2
5450;Molinukas;SRAIGIUKŲ;41890709428;Taip;0;1;1;2
5451;Molinukas;SRAIGIUKŲ;19007912410;Taip;0;1;4;5
5452;Molinukas;SRAIGIUKŲ;94725766823;Taip;0;8;0;8
5453;Molinukas;SRAIGIUKŲ;48613608109;Taip;1;1;0;2
5454;Molinukas;SRAIGIUKŲ;70883949824;Taip;0;2;5;7
5455;Molinukas;SRAIGIUKŲ;46887752521;Taip;6;1;2;9
5456;Molinukas;SRAIGIUKŲ;25562159395;Taip;0;3;1;4
5457;Molinukas;SRAIGIUKŲ;81952213381;Taip;0;1;1;2
5458;Molinukas;SRAIGIUKŲ;51421193001;Taip;0;1;0;1
5459;Molinukas;SRAIGIUKŲ;1388074160;Taip;5;1;0;6
5460;Molinukas;SRAIGIUKŲ;78355703743;Ne;0;0;1;1
5461;Molinukas;SRAIGIUKŲ;74040038141;Taip;8;1;0;9
5462;Molinukas;SRAIGIUKŲ;21462500359;Ne;10;1;0;11
5463;Molinukas;SRAIGIUKŲ;10647191823;Taip;0;1;0;1
5464;Molinukas;SRAIGIUKŲ;95409535650;Taip;0;2;0;2
5465;Molinukas;SRAIGIUKŲ;73542178867;Taip;3;0;0;3
5466;Molinukas;SRAIGIUKŲ;6155259547;Taip;5;1;0;6
5467;Molinukas;SRAIGIUKŲ;11787953136;Taip;8;7;0;15
5468;Molinukas;SRAIGIUKŲ;81983716075;Taip;12;0;0;12
5469;Molinukas;SRAIGIUKŲ;2048642721;Taip;4;5;1;10
5470;Molinukas;SRAIGIUKŲ;2041132581;Taip;3;1;0;4
5471;Molinukas;VOVERIUKAI;49733379099;Taip;0;3;0;3
5472;Molinukas;VOVERIUKAI;7991320348;Taip;0;1;0;1
5473;Molinukas;VOVERIUKAI;1816951665;Taip;0;0;1;1
5474;Molinukas;VOVERIUKAI;8674220663;Taip;10;1;0;11
5475;Molinukas;VOVERIUKAI;1151672597;Taip;0;2;0;2
5476;Molinukas;VOVERIUKAI;13856993048;Taip;0;0;3;3
5477;Molinukas;VOVERIUKAI;41153045448;Taip;9;0;2;11
5478;Molinukas;VOVERIUKAI;43651915331;Taip;0;6;10;16
5479;Molinukas;VOVERIUKAI;12208955611;Taip;0;4;0;4
5480;Molinukas;VOVERIUKAI;1241069188;Taip;5;1;0;6
5481;Molinukas;VOVERIUKAI;10482714545;Taip;15;2;0;17
5482;Molinukas;VOVERIUKAI;1880434477;Taip;10;0;0;10
5483;Molinukas;VOVERIUKAI;54948831792;Taip;0;0;2;2
5484;Molinukas;VOVERIUKAI;45801826827;Taip;13;1;1;15
5485;Molinukas;VOVERIUKAI;1538778372;Taip;0;0;1;1
5486;Molinukas;VOVERIUKAI;2931616290;Taip;5;0;1;6
5487;Molinukas;VOVERIUKAI;7987658567;Ne;0;6;0;6
5488;Molinukas;ŽVIRBLIUKŲ;3207373459;Taip;11;0;0;11
5489;Molinukas;ŽVIRBLIUKŲ;8247270556;Taip;8;0;0;8
5490;Molinukas;ŽVIRBLIUKŲ;9318837973;Taip;6;0;1;7
5491;Molinukas;ŽVIRBLIUKŲ;7378643086;Taip;10;1;0;11
5492;Molinukas;ŽVIRBLIUKŲ;4957226547;Taip;0;1;0;1
5493;Molinukas;ŽVIRBLIUKŲ;6832647220;Taip;11;0;7;18
5494;Molinukas;ŽVIRBLIUKŲ;4950808381;Taip;11;0;0;11
5495;Molinukas;ŽVIRBLIUKŲ;8865966572;Taip;0;1;2;3
5496;Molinukas;ŽVIRBLIUKŲ;6795839380;Taip;6;3;7;16
5497;Molinukas;ŽVIRBLIUKŲ;5597119459;Taip;11;0;0;11
5498;Molinukas;ŽVIRBLIUKŲ;4209143136;Taip;14;0;0;14
5499;Molinukas;ŽVIRBLIUKŲ;5648861702;Taip;14;0;0;14
5500;Molinukas;KAČIUKŲ;3516132254;Ne;18;0;0;18
5501;Molinukas;KAČIUKŲ;5685582215;Taip;6;3;5;14
5502;Molinukas;KAČIUKŲ;8541456847;Taip;0;1;6;7
5503;Molinukas;KAČIUKŲ;9379171183;Taip;5;0;3;8
5504;Molinukas;KAČIUKŲ;2356814145;Taip;0;0;1;1
5505;Molinukas;KAČIUKŲ;4000190261;Taip;5;0;0;5
5506;Molinukas;KAČIUKŲ;9667704959;Taip;6;0;8;14
5507;Molinukas;KAČIUKŲ;7446607510;Taip;4;2;3;9
5508;Molinukas;KAČIUKŲ;3469196411;Taip;0;2;4;6
5509;Molinukas;KAČIUKŲ;6638634402;Ne;21;0;0;21
5510;Molinukas;KAČIUKŲ;9413396859;Taip;1;0;0;1
5511;Molinukas;KAČIUKŲ;2286586693;Taip;7;0;0;7
5512;Molinukas;KAČIUKŲ;6898958282;Taip;6;0;2;8
5513;Molinukas;KAČIUKŲ;4583155940;Taip;3;0;0;3
5514;Molinukas;KAČIUKŲ;8516451290;Taip;10;0;0;10
5515;Naminukas;Drugeliai;6776805494;Taip;0;1;2;3
5516;Naminukas;Drugeliai;2395070574;Taip;0;3;1;4
5517;Naminukas;Drugeliai;5801695390;Taip;2;4;0;6
5518;Naminukas;Drugeliai;5534073614;Taip;9;2;1;12
5519;Naminukas;Drugeliai;7347998152;Taip;2;2;0;4
5520;Naminukas;Drugeliai;2606742144;Taip;0;1;1;2
5521;Naminukas;Drugeliai;9689866363;Taip;0;1;8;9
5522;Naminukas;Drugeliai;2132345627;Taip;10;0;0;10
5523;Naminukas;Drugeliai;3320805432;Taip;4;5;0;9
5524;Naminukas;Drugeliai;9312058190;Taip;10;0;0;10
5525;Naminukas;Drugeliai;1302119260;Taip;7;0;4;11
5526;Naminukas;Drugeliai;8760638670;Taip;0;0;21;21
5527;Naminukas;Drugeliai;2864905392;Taip;10;0;0;10
5528;Naminukas;Drugeliai;7406775925;Taip;12;0;0;12
5529;Naminukas;Drugeliai;1333462200;Taip;10;0;1;11
5530;Naminukas;Drugeliai;5468218968;Taip;5;1;0;6
5531;Naminukas;Drugeliai;5713661641;Ne;13;0;0;13
5532;Naminukas;Drugeliai;8299305464;Taip;11;0;5;16
5533;Naminukas;Drugeliai;8929071623;Taip;13;1;0;14
5534;Naminukas;Bitutės;4419568254;Taip;9;1;0;10
5535;Naminukas;Bitutės;1956749138;Taip;0;3;0;3
5536;Naminukas;Bitutės;6503569633;Taip;7;0;2;9
5537;Naminukas;Bitutės;3192885665;Taip;16;1;1;18
5538;Naminukas;Bitutės;9530232649;Taip;21;0;0;21
5539;Naminukas;Bitutės;8131328042;Ne;0;13;0;13
5540;Naminukas;Bitutės;2769848640;Taip;0;0;1;1
5541;Naminukas;Bitutės;7176287699;Taip;6;1;2;9
5542;Naminukas;Bitutės;7888950723;Taip;0;0;3;3
5543;Naminukas;Bitutės;1710002948;Taip;21;0;0;21
5544;Naminukas;Bitutės;3994190066;Taip;0;6;0;6
5545;Naminukas;Bitutės;6526207235;Taip;5;4;0;9
5546;Naminukas;Bitutės;9600303816;Taip;4;3;0;7
5547;Naminukas;Bitutės;5244682030;Taip;4;3;0;7
5548;Naminukas;Bitutės;9501202207;Taip;4;10;0;14
5549;Naminukas;Bitutės;9541388086;Taip;0;1;0;1
5550;Naminukas;Bitutės;2831224400;Taip;15;5;0;20
5551;Naminukas;Paukšteliai;37525846039;Taip;0;1;1;2
5552;Naminukas;Paukšteliai;2126182508;Taip;0;4;0;4
5553;Naminukas;Paukšteliai;3603079488;Ne;0;0;2;2
5554;Naminukas;Paukšteliai;1870907311;Taip;0;1;0;1
5555;Naminukas;Paukšteliai;69952843049;Taip;0;5;0;5
5556;Naminukas;Paukšteliai;59473696226;Taip;0;1;1;2
5557;Naminukas;Paukšteliai;1946057668;Taip;10;2;0;12
5558;Naminukas;Paukšteliai;93648945843;Taip;3;0;0;3
5559;Naminukas;Paukšteliai;2100371376;Taip;0;1;1;2
5560;Naminukas;Paukšteliai;1439033627;Taip;2;0;0;2
5561;Naminukas;Paukšteliai;15748906161;Taip;0;1;2;3
5562;Naminukas;Paukšteliai;70836957729;Taip;0;1;0;1
5563;Naminukas;Paukšteliai;79166535343;Taip;0;1;0;1
5564;Naminukas;Paukšteliai;7386776624;Taip;0;0;1;1
5565;Naminukas;Paukšteliai;9039313646;Taip;0;0;1;1
5566;Naminukas;Paukšteliai;92882855386;Taip;0;1;0;1
5567;Naminukas;"NYKŠTUKAI ";1509433995;Ne;0;1;0;1
5568;Naminukas;"NYKŠTUKAI ";59020433000;Taip;0;4;0;4
5569;Naminukas;"NYKŠTUKAI ";2544422668;Taip;0;1;0;1
5570;Naminukas;"NYKŠTUKAI ";16946991001;Taip;2;0;0;2
5571;Naminukas;"NYKŠTUKAI ";46665774314;Taip;0;2;0;2
5572;Naminukas;"NYKŠTUKAI ";1490712871;Taip;5;0;2;7
5573;Naminukas;"NYKŠTUKAI ";1252481328;Ne;14;1;0;15
5574;Naminukas;"NYKŠTUKAI ";5918430817;Taip;10;0;0;10
5575;Naminukas;"NYKŠTUKAI ";1499464511;Ne;13;0;0;13
5576;Naminukas;"NYKŠTUKAI ";3826149605;Ne;0;3;0;3
5577;Naminukas;"NYKŠTUKAI ";6501046678;Taip;0;0;3;3
5578;Naminukas;"NYKŠTUKAI ";6029194403;Taip;4;5;0;9
5579;Naminukas;"NYKŠTUKAI ";70281612245;Taip;10;0;0;10
5580;Naminukas;"NYKŠTUKAI ";74291965804;Taip;11;0;0;11
5581;Naminukas;"NYKŠTUKAI ";10563508139;Taip;0;0;1;1
5582;Naminukas;"NYKŠTUKAI ";90045007984;Taip;4;1;0;5
5583;Naminukas;"NYKŠTUKAI ";6273977588;Ne;0;10;0;10
5584;Nykštukas;SMAGURIAI;8120626738;Taip;0;4;0;4
5585;Nykštukas;SMAGURIAI;9842748132;Taip;15;0;0;15
5586;Nykštukas;SMAGURIAI;4830484167;Taip;3;1;0;4
5587;Nykštukas;SMAGURIAI;1902253981;Taip;21;0;0;21
5588;Nykštukas;SMAGURIAI;4949895196;Taip;0;1;2;3
5589;Nykštukas;SMAGURIAI;9713859038;Taip;9;0;1;10
5590;Nykštukas;SMAGURIAI;7954996421;Taip;13;2;0;15
5591;Nykštukas;SMAGURIAI;4771072061;Taip;16;0;0;16
5592;Nykštukas;SMAGURIAI;6139988523;Taip;10;0;0;10
5593;Nykštukas;SMAGURIAI;5190754451;Taip;1;1;3;5
5594;Nykštukas;SMAGURIAI;8310484267;Taip;10;0;0;10
5595;Nykštukas;SMAGURIAI;1707956308;Taip;0;10;0;10
5596;Nykštukas;SMAGURIAI;8635571067;Taip;14;0;0;14
5597;Nykštukas;SMAGURIAI;9326131725;Taip;0;1;0;1
5598;Nykštukas;SMAGURIAI;5421090978;Taip;10;2;0;12
5599;Nykštukas;SMAGURIAI;7911842707;Taip;10;0;2;12
5600;Nykštukas;SMAGURIAI;7529677915;Taip;0;1;1;2
5601;Nykštukas;SMAGURIAI;4994727422;Taip;0;13;0;13
5602;Nykštukas;SMALSIUKAI;1213461702;Taip;0;1;0;1
5603;Nykštukas;SMALSIUKAI;5121027981;Taip;12;0;0;12
5604;Nykštukas;SMALSIUKAI;6958596223;Taip;11;0;0;11
5605;Nykštukas;SMALSIUKAI;3002966681;Taip;4;7;0;11
5606;Nykštukas;SMALSIUKAI;4612171029;Taip;0;3;0;3
5607;Nykštukas;SMALSIUKAI;3120577264;Taip;0;4;0;4
5608;Nykštukas;SMALSIUKAI;3852057722;Taip;0;1;0;1
5609;Nykštukas;SMALSIUKAI;2696384135;Taip;3;6;1;10
5610;Nykštukas;SMALSIUKAI;9532956150;Taip;5;0;0;5
5611;Nykštukas;SMALSIUKAI;3273579005;Taip;2;5;1;8
5612;Nykštukas;SMALSIUKAI;4040123876;Taip;5;3;0;8
5613;Nykštukas;SMALSIUKAI;3985610575;Taip;0;4;0;4
5614;Nykštukas;SMALSIUKAI;8948554271;Taip;5;1;0;6
5615;Nykštukas;SMALSIUKAI;4331906712;Taip;5;0;4;9
5616;Nykštukas;SMALSIUKAI;6112448299;Taip;0;1;0;1
5617;Nykštukas;SMALSIUKAI;1930357859;Taip;12;4;0;16
5618;Nykštukas;SMALSIUKAI;9100510105;Taip;2;1;0;3
5619;Nykštukas;SMALSIUKAI;2143857296;Ne;21;0;0;21
5620;Nykštukas;SMALSIUKAI;9303832542;Taip;15;0;0;15
5621;Nykštukas;AITVARIUKAI;1144228064;Ne;21;0;0;21
5622;Nykštukas;AITVARIUKAI;6787279403;Taip;0;4;0;4
5623;Nykštukas;AITVARIUKAI;2002197530;Taip;16;0;0;16
5624;Nykštukas;AITVARIUKAI;2113361929;Taip;5;1;0;6
5625;Nykštukas;AITVARIUKAI;1555891900;Taip;0;1;0;1
5626;Nykštukas;AITVARIUKAI;4256675710;Taip;0;10;0;10
5627;Nykštukas;AITVARIUKAI;1209871301;Taip;9;10;0;19
5628;Nykštukas;AITVARIUKAI;93527297465;Ne;0;5;0;5
5629;Nykštukas;AITVARIUKAI;1642172676;Taip;0;4;0;4
5630;Nykštukas;AITVARIUKAI;1603960759;Ne;0;3;0;3
5631;Nykštukas;AITVARIUKAI;4487291454;Taip;0;1;0;1
5632;Nykštukas;AITVARIUKAI;6274009442;Taip;5;2;1;8
5633;Nykštukas;AITVARIUKAI;1760718866;Taip;0;6;0;6
5634;Nykštukas;AITVARIUKAI;5772758127;Taip;0;5;0;5
5635;Nykštukas;AITVARIUKAI;9229795383;Ne;0;3;0;3
5636;Nykštukas;AITVARIUKAI;3479582264;Taip;0;7;0;7
5637;Nykštukas;AITVARIUKAI;1643843455;Taip;0;9;0;9
5638;Nykštukas;AITVARIUKAI;1965559069;Taip;8;2;0;10
5639;Nykštukas;AITVARIUKAI;6480026426;Taip;0;1;0;1
5640;Nykštukas;AITVARIUKAI;4556700510;Ne;0;4;0;4
5641;Nykštukas;DAINORĖLIAI;1505896987;Ne;6;0;0;6
5642;Nykštukas;DAINORĖLIAI;1070086244;Taip;0;2;1;3
5643;Nykštukas;DAINORĖLIAI;6105521992;Taip;5;1;0;6
5644;Nykštukas;DAINORĖLIAI;67968815055;Taip;0;9;0;9
5645;Nykštukas;DAINORĖLIAI;8027860617;Taip;4;0;1;5
5646;Nykštukas;DAINORĖLIAI;7498721887;Taip;0;0;2;2
5647;Nykštukas;DAINORĖLIAI;7660848578;Taip;9;5;0;14
5648;Nykštukas;DAINORĖLIAI;8370864547;Taip;0;1;0;1
5649;Nykštukas;DAINORĖLIAI;4720226790;Taip;6;0;0;6
5650;Nykštukas;DAINORĖLIAI;7546263542;Taip;0;3;0;3
5651;Nykštukas;DAINORĖLIAI;9778271272;Taip;0;0;1;1
5652;Nykštukas;DAINORĖLIAI;7150793310;Taip;3;1;0;4
5653;Nykštukas;DAINORĖLIAI;7584220414;Taip;0;2;0;2
5654;Nykštukas;DAINORĖLIAI;8323439041;Ne;1;0;0;1
5655;Nykštukas;DAINORĖLIAI;7615678714;Taip;0;2;0;2
5656;Nykštukas;DAINORĖLIAI;9567571526;Taip;0;0;1;1
5657;Nykštukas;DAINORĖLIAI;3970413055;Taip;0;4;0;4
5658;Nykštukas;DAINORĖLIAI;1755944368;Taip;8;2;0;10
5659;Nykštukas;DAINORĖLIAI;8781148130;Taip;0;1;2;3
5660;Nykštukas;DAINORĖLIAI;3904901392;Taip;4;8;0;12
5661;Nykštukas;POKŠTUKAI;40765421180;Ne;7;2;0;9
5662;Nykštukas;POKŠTUKAI;18018106215;Taip;0;5;0;5
5663;Nykštukas;POKŠTUKAI;74234678869;Taip;0;6;0;6
5664;Nykštukas;POKŠTUKAI;28276934404;Taip;0;3;0;3
5665;Nykštukas;POKŠTUKAI;43810892974;Taip;0;1;0;1
5666;Nykštukas;POKŠTUKAI;59343371023;Taip;0;6;0;6
5667;Nykštukas;POKŠTUKAI;50854821473;Taip;5;0;0;5
5668;Nykštukas;POKŠTUKAI;7598045357;Taip;0;2;0;2
5669;Nykštukas;POKŠTUKAI;4909057583;Taip;0;4;0;4
5670;Nykštukas;POKŠTUKAI;57664247691;Taip;6;6;0;12
5671;Nykštukas;POKŠTUKAI;51448568141;Taip;0;1;0;1
5672;Nykštukas;POKŠTUKAI;26248363243;Taip;0;7;0;7
5673;Nykštukas;POKŠTUKAI;60979950727;Taip;0;2;0;2
5674;Nykštukas;POKŠTUKAI;9779645295;Taip;0;2;0;2
5675;Nykštukas;POKŠTUKAI;50160103840;Taip;0;4;0;4
5676;Nykštukas;POKŠTUKAI;87609458114;Taip;3;1;0;4
5677;Nykštukas;POKŠTUKAI;2018631335;Taip;2;6;0;8
5678;Nykštukas;POKŠTUKAI;66105021371;Taip;0;4;0;4
5679;Nykštukas;POKŠTUKAI;38098661273;Taip;0;1;0;1
5680;Nykštukas;POKŠTUKAI;47375659986;Taip;0;1;0;1
5681;Nykštukas;POKŠTUKAI;26952411744;Ne;0;10;0;10
5682;Nykštukas;POKŠTUKAI;9506999469;Taip;0;1;0;1
5683;Nykštukas;KODĖLČIUKAI;1312775821;Taip;10;1;0;11
5684;Nykštukas;KODĖLČIUKAI;22907267392;Taip;7;6;0;13
5685;Nykštukas;KODĖLČIUKAI;51839683425;Taip;0;2;0;2
5686;Nykštukas;KODĖLČIUKAI;49403159088;Taip;0;3;2;5
5687;Nykštukas;KODĖLČIUKAI;279882740;Taip;0;2;0;2
5688;Nykštukas;KODĖLČIUKAI;65431970524;Taip;0;6;2;8
5689;Nykštukas;KODĖLČIUKAI;74269403579;Taip;12;6;0;18
5690;Nykštukas;KODĖLČIUKAI;57158850838;Taip;5;3;0;8
5691;Nykštukas;KODĖLČIUKAI;45998334166;Taip;0;3;0;3
5692;Nykštukas;KODĖLČIUKAI;21894285952;Taip;0;1;0;1
5693;Nykštukas;KODĖLČIUKAI;46457925178;Taip;0;2;0;2
5694;Nykštukas;KODĖLČIUKAI;40507821302;Taip;9;5;0;14
5695;Nykštukas;KODĖLČIUKAI;40791169410;Ne;0;2;0;2
5696;Nykštukas;KODĖLČIUKAI;21793281327;Taip;0;1;0;1
5697;Nykštukas;KODĖLČIUKAI;73015157334;Taip;5;1;0;6
5698;Nykštukas;KODĖLČIUKAI;87788435945;Taip;0;1;1;2
5699;Nykštukas;KODĖLČIUKAI;42662848704;Taip;0;1;0;1
5700;Nykštukas;PASAKORIAI;29477668697;Taip;0;1;0;1
5701;Nykštukas;PASAKORIAI;84548941865;Taip;0;2;0;2
5702;Nykštukas;PASAKORIAI;27650304509;Taip;0;7;0;7
5703;Nykštukas;PASAKORIAI;1754697121;Taip;5;6;0;11
5704;Nykštukas;PASAKORIAI;86393328886;Taip;0;6;0;6
5705;Nykštukas;PASAKORIAI;67433137766;Taip;0;6;0;6
5706;Nykštukas;PASAKORIAI;12777395170;Taip;0;6;0;6
5707;Nykštukas;PASAKORIAI;59971592045;Taip;0;7;0;7
5708;Nykštukas;PASAKORIAI;29414650504;Taip;0;3;0;3
5709;Nykštukas;PASAKORIAI;1412282356;Taip;0;2;0;2
5710;Nykštukas;PASAKORIAI;77231391186;Taip;0;1;0;1
5711;Nykštukas;PASAKORIAI;67209958343;Taip;0;8;0;8
5712;Nykštukas;PASAKORIAI;40012664626;Taip;0;3;0;3
5713;Nykštukas;PASAKORIAI;2106464061;Ne;0;7;0;7
5714;Nykštukas;PASAKORIAI;368045639;Ne;0;5;0;5
5715;Nykštukas;PASAKORIAI;53994799769;Taip;0;3;0;3
5716;Nykštukas;PASAKORIAI;1967445943;Taip;0;6;0;6
5717;Nykštukas;PASAKORIAI;88757197161;Taip;0;8;0;8
5718;Nykštukas;PASAKORIAI;301318033;Taip;0;6;0;6
5719;Nykštukas;PASAKORIAI;25431679881;Taip;6;0;3;9
5720;Nykštukas;PASAKORIAI;22318910984;Taip;5;0;1;6
5721;Nykštukas;PASAKORIAI;6154158870;Taip;0;15;0;15
5722;Nykštukas;PASAKORIAI;9728270999;Ne;0;2;0;2
5723;Nykštukas;PASAKORIAI;45917705129;Taip;0;10;0;10
5724;Nykštukas;PASAKORIAI;5185856324;Taip;7;1;1;9
5725;Nykštukas;GUDRUČIAI;90969634936;Taip;0;6;0;6
5726;Nykštukas;GUDRUČIAI;66071060125;Taip;16;0;0;16
5727;Nykštukas;GUDRUČIAI;53603222817;Taip;6;0;1;7
5728;Nykštukas;GUDRUČIAI;23684742279;Taip;12;3;0;15
5729;Nykštukas;GUDRUČIAI;84800943947;Taip;1;1;0;2
5730;Nykštukas;GUDRUČIAI;30508998297;Taip;0;7;0;7
5731;Nykštukas;GUDRUČIAI;1448977214;Taip;9;0;1;10
5732;Nykštukas;GUDRUČIAI;2109799405;Ne;6;3;0;9
5733;Nykštukas;GUDRUČIAI;83322635443;Taip;11;0;0;11
5734;Nykštukas;GUDRUČIAI;9041364129;Ne;15;1;0;16
5735;Nykštukas;GUDRUČIAI;7098812765;Taip;10;0;0;10
5736;Nykštukas;GUDRUČIAI;48718365302;Taip;0;3;0;3
5737;Nykštukas;GUDRUČIAI;2121319324;Taip;11;0;0;11
5738;Nykštukas;GUDRUČIAI;40386182073;Taip;10;3;0;13
5739;Nykštukas;GUDRUČIAI;54607001703;Taip;0;6;0;6
5740;Nykštukas;GUDRUČIAI;7356168681;Taip;0;6;0;6
5741;Nykštukas;GUDRUČIAI;27701482167;Taip;0;3;0;3
5742;Nykštukas;GUDRUČIAI;56267408803;Taip;0;1;1;2
5743;Nykštukas;GUDRUČIAI;26154640888;Taip;15;0;0;15
5744;Nykštukas;GUDRUČIAI;92898851752;Taip;4;7;0;11
5745;Nykštukas;GUDRUČIAI;85663477778;Taip;13;2;0;15
5746;Nykštukas;GUDRUČIAI;52614843907;Taip;3;0;0;3
5747;Nykštukas;GUDRUČIAI;94426618018;Taip;0;3;0;3
5748;Nykštukas;GUDRUČIAI;7325852578;Taip;0;5;0;5
5749;Nykštukas;NAMINUKAI;1856534241;Ne;0;1;0;1
5750;Nykštukas;NAMINUKAI;34930388032;Ne;0;1;0;1
5751;Nykštukas;NAMINUKAI;1178437485;Taip;0;6;0;6
5752;Nykštukas;NAMINUKAI;1608057875;Taip;0;1;0;1
5753;Nykštukas;NAMINUKAI;1285120987;Taip;0;5;0;5
5754;Nykštukas;NAMINUKAI;1994080785;Taip;0;2;0;2
5755;Nykštukas;NAMINUKAI;37253009284;Taip;5;3;0;8
5756;Nykštukas;NAMINUKAI;1630706629;Ne;0;2;0;2
5757;Nykštukas;NAMINUKAI;1350373348;Taip;0;4;0;4
5758;Nykštukas;NAMINUKAI;27896604498;Taip;0;2;0;2
5759;Nykštukas;NAMINUKAI;9422129964;Taip;0;1;0;1
5760;Nykštukas;NAMINUKAI;30762220262;Taip;0;6;3;9
5761;Nykštukas;NAMINUKAI;9184265280;Taip;0;1;0;1
5762;Nykštukas;NAMINUKAI;1687759661;Taip;0;1;0;1
5763;Nykštukas;NAMINUKAI;61896011340;Taip;0;4;0;4
5764;Nykštukas;NAMINUKAI;4191728865;Taip;5;2;0;7
5765;Nykštukas;NAMINUKAI;7645589206;Taip;0;3;1;4
5766;Nykštukas;NAMINUKAI;5270008748;Taip;0;4;0;4
5767;Nykštukas;NAMINUKAI;45693477409;Taip;7;2;0;9
5768;Nykštukas;NAMINUKAI;44921552171;Taip;2;8;0;10
5769;Nykštukas;NAMINUKAI;1978974359;Ne;3;0;0;3
5770;Nykštukas;NAMINUKAI;58741201573;Taip;0;6;0;6
5771;Nykštukas;KŪLVERSTUKAI;4064016871;Taip;0;1;1;2
5772;Nykštukas;KŪLVERSTUKAI;9575291096;Taip;0;1;0;1
5773;Nykštukas;KŪLVERSTUKAI;2205400512;Taip;14;1;0;15
5774;Nykštukas;KŪLVERSTUKAI;6106373554;Taip;0;2;0;2
5775;Nykštukas;KŪLVERSTUKAI;4925214655;Taip;10;5;0;15
5776;Nykštukas;KŪLVERSTUKAI;9686815141;Taip;21;0;0;21
5777;Nykštukas;KŪLVERSTUKAI;7976689381;Taip;0;0;6;6
5778;Nykštukas;KŪLVERSTUKAI;9054070492;Taip;7;0;0;7
5779;Nykštukas;KŪLVERSTUKAI;5439925385;Ne;12;1;0;13
5780;Nykštukas;KŪLVERSTUKAI;8625793820;Ne;12;1;0;13
5781;Nykštukas;KŪLVERSTUKAI;7176519994;Ne;15;3;0;18
5782;Nykštukas;KŪLVERSTUKAI;6338717583;Taip;8;0;1;9
5783;Nykštukas;KŪLVERSTUKAI;2440574056;Taip;12;7;0;19
5784;Nykštukas;KŪLVERSTUKAI;3925958632;Taip;13;0;0;13
5785;Nykštukas;KŪLVERSTUKAI;7494444468;Taip;13;0;0;13
5786;Nykštukas;KŪLVERSTUKAI;5032283848;Ne;0;1;2;3
5787;Nykštukas;KŪLVERSTUKAI;2988856911;Taip;16;2;0;18
5788;Nykštukas;KŪLVERSTUKAI;4992654449;Taip;0;6;0;6
5789;Nykštukas;KŪLVERSTUKAI;1579064341;Taip;5;0;1;6
5790;Nykštukas;TREPSIUKAI;4795301170;Taip;0;7;0;7
5791;Nykštukas;TREPSIUKAI;2661110617;Taip;11;0;0;11
5792;Nykštukas;TREPSIUKAI;1855278809;Taip;7;0;0;7
5793;Nykštukas;TREPSIUKAI;3040001373;Taip;1;0;0;1
5794;Nykštukas;TREPSIUKAI;5504584349;Taip;6;0;0;6
5795;Nykštukas;TREPSIUKAI;9714310539;Taip;8;0;0;8
5796;Nykštukas;TREPSIUKAI;8640715657;Taip;12;0;2;14
5797;Nykštukas;TREPSIUKAI;7990462246;Taip;7;6;0;13
5798;Nykštukas;TREPSIUKAI;7828733135;Taip;3;0;1;4
5799;Nykštukas;TREPSIUKAI;3026598985;Taip;5;0;0;5
5800;Nykštukas;TREPSIUKAI;4480184458;Taip;0;0;1;1
5801;Nykštukas;TREPSIUKAI;9413198245;Taip;2;0;2;4
5802;Nykštukas;TREPSIUKAI;2914822445;Taip;4;0;1;5
5803;Nykštukas;TREPSIUKAI;1379378120;Taip;3;2;0;5
5804;Nykštukas;TREPSIUKAI;4090494707;Taip;11;0;0;11
5805;Nykštukas;TREPSIUKAI;2518342041;Taip;11;0;0;11
5806;Nykštukas;TREPSIUKAI;1088633575;Ne;15;0;1;16
5807;Ozas;Smalsučiai;2641398988;Taip;0;8;0;8
5808;Ozas;Smalsučiai;9227939420;Taip;9;2;0;11
5809;Ozas;Smalsučiai;7917100888;Taip;8;2;0;10
5810;Ozas;Smalsučiai;87218067796;Taip;5;2;0;7
5811;Ozas;Smalsučiai;4397034031;Taip;0;2;0;2
5812;Ozas;Smalsučiai;1974320330;Taip;0;4;0;4
5813;Ozas;Smalsučiai;1173284700;Ne;1;2;1;4
5814;Ozas;Smalsučiai;67987032400;Taip;12;0;0;12
5815;Ozas;Smalsučiai;71695973592;Taip;7;0;1;8
5816;Ozas;Smalsučiai;57069047630;Taip;2;1;0;3
5817;Ozas;Smalsučiai;5150746885;Taip;4;2;0;6
5818;Ozas;Smalsučiai;9595277597;Taip;0;1;0;1
5819;Ozas;Smalsučiai;1893257809;Taip;0;2;0;2
5820;Ozas;Smalsučiai;6540803077;Taip;0;1;0;1
5821;Ozas;Smalsučiai;1248092034;Ne;5;2;0;7
5822;Ozas;Smalsučiai;43381497677;Ne;16;0;0;16
5823;Ozas;Smalsučiai;7351651916;Taip;0;1;0;1
5824;Ozas;Smalsučiai;3286170280;Taip;5;1;0;6
5825;Ozas;Smalsučiai;9521048381;Taip;15;1;0;16
5826;Ozas;Smalsučiai;2053832360;Taip;7;4;0;11
5827;Ozas;Smalsučiai;9905575489;Taip;5;1;0;6
5828;Ozas;Smalsučiai;5342394742;Taip;6;4;0;10
5829;Ozas;Drugeliai;1655808777;Taip;0;1;0;1
5830;Ozas;Drugeliai;7802699257;Taip;0;0;2;2
5831;Ozas;Drugeliai;8176840834;Ne;0;14;1;15
5832;Ozas;Drugeliai;6668470892;Taip;0;4;0;4
5833;Ozas;Drugeliai;2302999759;Taip;0;0;2;2
5834;Ozas;Drugeliai;8088330187;Taip;0;6;0;6
5835;Ozas;Drugeliai;9073973849;Taip;4;0;0;4
5836;Ozas;Drugeliai;9322806566;Taip;10;1;0;11
5837;Ozas;Drugeliai;2676747542;Taip;8;0;2;10
5838;Ozas;Drugeliai;2812687451;Taip;0;1;4;5
5839;Ozas;Drugeliai;8289643065;Taip;3;1;0;4
5840;Ozas;Drugeliai;5503766544;Taip;0;4;0;4
5841;Ozas;Drugeliai;2980799420;Taip;21;0;0;21
5842;Ozas;Drugeliai;4935698806;Taip;0;7;0;7
5843;Ozas;Drugeliai;8318380547;Taip;0;6;0;6
5844;Ozas;Drugeliai;4884054504;Taip;11;0;0;11
5845;Ozas;Drugeliai;2825614921;Taip;18;0;0;18
5846;Ozas;Drugeliai;43660054250;Taip;0;17;0;17
5847;Ozas;Drugeliai;1871542885;Taip;8;0;0;8
5848;Ozas;Boružėlės;1348960421;Taip;16;0;0;16
5849;Ozas;Boružėlės;1375643969;Ne;0;0;10;10
5850;Ozas;Boružėlės;63852147122;Taip;4;0;2;6
5851;Ozas;Boružėlės;8190314087;Taip;0;3;0;3
5852;Ozas;Boružėlės;3803998816;Taip;0;4;0;4
5853;Ozas;Boružėlės;1212358423;Taip;21;0;0;21
5854;Ozas;Boružėlės;7615907271;Taip;13;1;0;14
5855;Ozas;Boružėlės;1560342499;Taip;2;1;0;3
5856;Ozas;Boružėlės;8529654920;Taip;4;0;0;4
5857;Ozas;Boružėlės;60194872867;Taip;5;0;1;6
5858;Ozas;Boružėlės;2527574646;Taip;0;5;0;5
5859;Ozas;Boružėlės;9773251894;Taip;5;0;3;8
5860;Ozas;Boružėlės;36523514229;Taip;10;3;0;13
5861;Ozas;Boružėlės;1367050160;Taip;3;0;2;5
5862;Ozas;Boružėlės;68364031736;Taip;0;2;0;2
5863;Ozas;Boružėlės;2678629892;Taip;0;0;11;11
5864;Ozas;Boružėlės;1109113859;Ne;4;0;2;6
5865;Ozas;Boružėlės;1826499734;Taip;0;1;0;1
5866;Ozas;Boružėlės;6432357144;Taip;11;0;4;15
5867;Ozas;Boružėlės;1498656201;Taip;7;0;0;7
5868;Ozas;Boružėlės;8979747150;Taip;12;1;3;16
5869;Ozas;Boružėlės;1217496635;Taip;6;0;5;11
5870;Ozas;Boružėlės;1682529482;Taip;5;0;1;6
5871;Ozas;Boružėlės;9130645878;Taip;16;5;0;21
5872;Ozas;Žiogeliai;7461521320;Taip;8;4;0;12
5873;Ozas;Žiogeliai;3631049449;Taip;0;0;1;1
5874;Ozas;Žiogeliai;6257625501;Taip;5;0;1;6
5875;Ozas;Žiogeliai;7402290524;Taip;13;3;0;16
5876;Ozas;Žiogeliai;1562277866;Taip;0;0;1;1
5877;Ozas;Žiogeliai;4571583671;Taip;0;1;3;4
5878;Ozas;Žiogeliai;1837947633;Taip;18;0;0;18
5879;Ozas;Žiogeliai;5682027094;Taip;13;8;0;21
5880;Ozas;Žiogeliai;4966355020;Taip;11;0;0;11
5881;Ozas;Žiogeliai;6950802941;Taip;21;0;0;21
5882;Ozas;Žiogeliai;3770045761;Taip;0;0;5;5
5883;Ozas;Žiogeliai;9324647606;Taip;13;0;1;14
5884;Ozas;Žiogeliai;9392526836;Taip;0;0;1;1
5885;Ozas;Žiogeliai;5850824864;Taip;0;1;1;2
5886;Ozas;Žiogeliai;4942550213;Ne;12;0;0;12
5887;Ozas;Žiogeliai;8676986286;Ne;2;2;1;5
5888;Ozas;Žiogeliai;2345112767;Taip;17;0;1;18
5889;Ozas;Žiogeliai;5420952391;Taip;0;7;0;7
5890;Ozas;Žiogeliai;5156383727;Taip;0;4;0;4
5891;Ozas;Žiogeliai;9929822317;Taip;4;0;0;4
5892;Ozas;Žiogeliai;6108049183;Taip;6;0;0;6
5893;Ozas;Žiogeliai;2837228320;Taip;10;4;0;14
5894;Ozas;Žiogeliai;7264789334;Taip;5;0;2;7
5895;Ozas;Žiogeliai;2617258206;Ne;15;0;1;16
5896;Ozas;Bitutės;4220780257;Taip;5;9;0;14
5897;Ozas;Bitutės;1161776624;Taip;0;1;1;2
5898;Ozas;Bitutės;4227555342;Taip;0;8;2;10
5899;Ozas;Bitutės;7499756171;Taip;0;16;0;16
5900;Ozas;Bitutės;7494307084;Taip;5;0;2;7
5901;Ozas;Bitutės;1475005204;Taip;0;5;0;5
5902;Ozas;Bitutės;2705294874;Taip;5;0;0;5
5903;Ozas;Bitutės;2369544599;Taip;5;3;1;9
5904;Ozas;Bitutės;3329391600;Taip;0;1;0;1
5905;Ozas;Bitutės;4207160323;Taip;5;1;0;6
5906;Ozas;Bitutės;8416839037;Taip;0;0;2;2
5907;Ozas;Bitutės;4254601638;Taip;13;0;1;14
5908;Ozas;Bitutės;4699369567;Taip;0;0;5;5
5909;Ozas;Bitutės;8304671844;Taip;0;0;8;8
5910;Ozas;Bitutės;5968428143;Taip;15;0;1;16
5911;Ozas;Bitutės;5381187291;Taip;18;0;0;18
5912;Ozas;Bitutės;1895519949;Taip;0;2;1;3
5913;Ozas;Bitutės;9772085405;Taip;10;0;0;10
5914;Ozas;Bitutės;7051699003;Taip;11;0;2;13
5915;Ozas;Bitutės;7817387800;Taip;12;0;0;12
5916;Ozas;Bitutės;5383877034;Taip;8;0;0;8
5917;Ozas;Bitutės;1117208248;Taip;0;0;5;5
5918;Ozas;Bitutės;9050174230;Taip;0;0;12;12
5919;Ozas;Bitutės;6811181735;Taip;0;9;0;9
5920;Ozas;Aitvarėliai;1653285671;Taip;0;10;0;10
5921;Ozas;Aitvarėliai;65979490151;Taip;0;1;2;3
5922;Ozas;Aitvarėliai;36897118363;Taip;4;1;0;5
5923;Ozas;Aitvarėliai;25660709486;Ne;6;3;0;9
5924;Ozas;Aitvarėliai;87500216376;Taip;0;8;2;10
5925;Ozas;Aitvarėliai;62542133064;Taip;0;1;0;1
5926;Ozas;Aitvarėliai;77935174855;Taip;0;11;2;13
5927;Ozas;Aitvarėliai;74709964983;Taip;0;1;0;1
5928;Ozas;Aitvarėliai;28736160618;Taip;0;1;0;1
5929;Ozas;Aitvarėliai;31810796132;Taip;8;1;0;9
5930;Ozas;Aitvarėliai;49556201469;Taip;0;1;0;1
5931;Ozas;Aitvarėliai;3222282556;Taip;0;1;0;1
5932;Ozas;Aitvarėliai;46679332069;Taip;0;2;0;2
5933;Ozas;Aitvarėliai;1556404162;Taip;8;1;0;9
5934;Ozas;Aitvarėliai;20944134865;Taip;6;1;0;7
5935;Ozas;Aitvarėliai;2087307495;Taip;0;1;0;1
5936;Ozas;Aitvarėliai;99211100553;Taip;5;1;0;6
5937;Ozas;Aitvarėliai;56927777775;Taip;0;3;0;3
5938;Ozas;Aitvarėliai;84378491220;Taip;0;1;0;1
5939;Ozas;Aitvarėliai;71286685759;Taip;0;2;0;2
5940;Ozas;Aitvarėliai;83249479846;Taip;9;0;0;9
5941;Ozas;Aitvarėliai;1182573257;Taip;0;3;2;5
5942;Ozas;Aitvarėliai;85075096111;Taip;13;2;0;15
5943;Ozas;Voveraitės;89115682092;Taip;5;6;5;16
5944;Ozas;Voveraitės;97875471586;Taip;0;1;0;1
5945;Ozas;Voveraitės;42030629149;Taip;0;0;7;7
5946;Ozas;Voveraitės;8817179462;Taip;9;5;0;14
5947;Ozas;Voveraitės;87683044622;Taip;17;1;0;18
5948;Ozas;Voveraitės;88443183082;Taip;0;1;1;2
5949;Ozas;Voveraitės;94576453630;Taip;11;2;0;13
5950;Ozas;Voveraitės;26834809068;Taip;0;2;0;2
5951;Ozas;Voveraitės;88508505247;Taip;2;1;0;3
5952;Ozas;Voveraitės;47574756201;Taip;7;2;0;9
5953;Ozas;Voveraitės;24088059514;Taip;0;2;0;2
5954;Ozas;Voveraitės;29411948493;Taip;0;1;0;1
5955;Ozas;Voveraitės;27655773887;Taip;0;7;0;7
5956;Ozas;Voveraitės;62608717700;Taip;0;1;0;1
5957;Ozas;Voveraitės;88837027397;Taip;5;4;0;9
5958;Ozas;Voveraitės;46431348128;Taip;0;1;0;1
5959;Ozas;Voveraitės;66463185196;Taip;10;1;0;11
5960;Ozas;Voveraitės;93882562685;Taip;0;4;0;4
5961;Ozas;Voveraitės;37505558259;Taip;0;1;0;1
5962;Ozas;Voveraitės;90020306864;Taip;10;1;2;13
5963;Ozas;Voveraitės;34723844399;Taip;0;2;3;5
5964;Ozas;Voveraitės;16101439010;Taip;0;1;7;8
5965;Ozas;Voveraitės;5637273299;Taip;0;1;4;5
5966;Ozas;Kodelčiukai;2808066733;Taip;0;20;0;20
5967;Ozas;Kodelčiukai;71351371644;Taip;0;12;0;12
5968;Ozas;Kodelčiukai;13077342836;Taip;4;6;0;10
5969;Ozas;Kodelčiukai;1746778441;Taip;0;3;0;3
5970;Ozas;Kodelčiukai;1110232715;Taip;11;1;0;12
5971;Ozas;Kodelčiukai;28273919775;Taip;7;0;0;7
5972;Ozas;Kodelčiukai;88618151766;Taip;7;3;0;10
5973;Ozas;Kodelčiukai;3637786952;Taip;7;2;0;9
5974;Ozas;Kodelčiukai;39003781970;Taip;5;5;0;10
5975;Ozas;Kodelčiukai;1243205832;Taip;4;0;0;4
5976;Ozas;Kodelčiukai;1235925750;Ne;0;4;0;4
5977;Ozas;Kodelčiukai;69756875821;Taip;0;4;0;4
5978;Ozas;Kodelčiukai;19065860134;Taip;0;4;0;4
5979;Ozas;Kodelčiukai;1230455881;Taip;5;1;0;6
5980;Ozas;Kodelčiukai;9664748034;Taip;10;1;0;11
5981;Ozas;Kodelčiukai;1684454071;Taip;15;0;0;15
5982;Ozas;Kodelčiukai;1008366446;Ne;0;1;0;1
5983;Ozas;Kodelčiukai;1995302672;Taip;0;4;0;4
5984;Ozas;Kodelčiukai;1288477637;Taip;7;2;0;9
5985;Ozas;Kodelčiukai;82373453244;Taip;0;3;0;3
5986;Ozas;Kodelčiukai;94673981368;Taip;0;1;0;1
5987;Ozas;Kodelčiukai;19284606277;Taip;8;2;0;10
5988;Ozas;Pelėdžiukai;1462541264;Ne;0;7;0;7
5989;Ozas;Pelėdžiukai;3439351594;Taip;0;13;0;13
5990;Ozas;Pelėdžiukai;41795363180;Taip;0;2;0;2
5991;Ozas;Pelėdžiukai;60743195418;Ne;0;10;0;10
5992;Ozas;Pelėdžiukai;64778552590;Taip;0;5;0;5
5993;Ozas;Pelėdžiukai;1755283948;Taip;0;0;6;6
5994;Ozas;Pelėdžiukai;13375413701;Taip;0;2;0;2
5995;Ozas;Pelėdžiukai;16523707810;Taip;7;1;4;12
5996;Ozas;Pelėdžiukai;47291376629;Taip;7;2;0;9
5997;Ozas;Pelėdžiukai;34330362446;Taip;5;6;1;12
5998;Ozas;Pelėdžiukai;1450257399;Taip;0;1;0;1
5999;Ozas;Pelėdžiukai;88159158596;Taip;0;7;0;7
6000;Ozas;Pelėdžiukai;56346624523;Taip;5;1;0;6
6001;Ozas;Pelėdžiukai;4765249675;Taip;0;0;4;4
6002;Ozas;Pelėdžiukai;1814400303;Taip;5;0;0;5
6003;Ozas;Pelėdžiukai;1889249743;Taip;1;4;3;8
6004;Ozas;Pelėdžiukai;1099026003;Taip;0;1;0;1
6005;Ozas;Pelėdžiukai;15885510365;Taip;3;0;2;5
6006;Ozas;Pelėdžiukai;2058548464;Taip;0;0;2;2
6007;Ozas;Pelėdžiukai;4590847831;Taip;0;9;1;10
6008;Ozas;Pelėdžiukai;1910114048;Taip;0;4;0;4
6009;Ozas;"Kačiukai ";75077443996;Taip;0;3;0;3
6010;Ozas;"Kačiukai ";95179927759;Taip;5;4;4;13
6011;Ozas;"Kačiukai ";6618249243;Taip;7;5;3;15
6012;Ozas;"Kačiukai ";1151213934;Taip;0;1;2;3
6013;Ozas;"Kačiukai ";2114612776;Taip;0;9;3;12
6014;Ozas;"Kačiukai ";60155732637;Taip;0;7;0;7
6015;Ozas;"Kačiukai ";37159754070;Taip;0;0;3;3
6016;Ozas;"Kačiukai ";61398533877;Taip;5;3;2;10
6017;Ozas;"Kačiukai ";1580501935;Ne;0;6;1;7
6018;Ozas;"Kačiukai ";1210902341;Taip;0;1;0;1
6019;Ozas;"Kačiukai ";1316758924;Ne;1;3;2;6
6020;Ozas;"Kačiukai ";2018398634;Taip;0;1;10;11
6021;Ozas;"Kačiukai ";34196440412;Taip;0;6;0;6
6022;Ozas;"Kačiukai ";84277015523;Taip;0;3;0;3
6023;Ozas;"Kačiukai ";1822377180;Taip;14;0;3;17
6024;Ozas;"Kačiukai ";1551028882;Taip;0;1;1;2
6025;Ozas;"Kačiukai ";14760258125;Taip;0;1;1;2
6026;Ozas;"Kačiukai ";4400619617;Taip;0;0;7;7
6027;Ozas;"Kačiukai ";9345447142;Taip;2;1;1;4
6028;Ozas;"Kačiukai ";1681367373;Taip;0;13;0;13
6029;Ozas;"Kačiukai ";8248732706;Taip;0;11;3;14
6030;Ozas;"Kačiukai ";84845624912;Taip;15;0;6;21
6031;Ozas;Ančiukų;2635045515;Taip;10;1;2;13
6032;Ozas;Ančiukų;9195536968;Taip;0;0;3;3
6033;Ozas;Ančiukų;5822871838;Taip;10;0;1;11
6034;Ozas;Ančiukų;1997125531;Taip;5;1;1;7
6035;Ozas;Ančiukų;1240233169;Taip;17;0;0;17
6036;Ozas;Ančiukų;6666591428;Taip;10;0;0;10
6037;Ozas;Ančiukų;8874823029;Taip;8;0;0;8
6038;Ozas;Ančiukų;8178298861;Taip;8;0;0;8
6039;Ozas;Ančiukų;1564826076;Taip;15;0;0;15
6040;Ozas;Ančiukų;5016547315;Ne;14;0;5;19
6041;Ozas;Ančiukų;6088757991;Taip;15;4;0;19
6042;Ozas;Ančiukų;2991511872;Taip;15;0;0;15
6043;Ozas;Ančiukų;6053885086;Taip;17;0;0;17
6044;Ozas;Ančiukų;2511477658;Taip;8;0;0;8
6045;Ozas;Ančiukų;6499549095;Taip;10;2;0;12
6046;Ozas;Ančiukų;7978092840;Taip;0;0;5;5
6047;Ozas;Ančiukų;2637531106;Taip;17;0;0;17
6048;Ozas;Ančiukų;8470832744;Taip;14;1;0;15
6049;Ozas;Ančiukų;6263062055;Ne;19;0;0;19
6050;Ozas;Nykškukų;5216695220;Taip;10;0;0;10
6051;Ozas;Nykškukų;2773182934;Taip;5;0;1;6
6052;Ozas;Nykškukų;5102704846;Taip;2;0;5;7
6053;Ozas;Nykškukų;5642468671;Taip;5;0;0;5
6054;Ozas;Nykškukų;4583818638;Taip;12;0;0;12
6055;Ozas;Nykškukų;1073755384;Taip;10;0;0;10
6056;Ozas;Nykškukų;7686706482;Taip;21;0;0;21
6057;Ozas;Nykškukų;5769870711;Taip;6;2;0;8
6058;Ozas;Nykškukų;1543683077;Taip;0;1;0;1
6059;Ozas;Nykškukų;2922370952;Taip;0;0;2;2
6060;Ozas;Nykškukų;2395567376;Taip;0;2;3;5
6061;Ozas;Nykškukų;6783755555;Taip;0;2;2;4
6062;Ozas;Nykškukų;8987796218;Taip;10;1;0;11
6063;Ozas;Nykškukų;4357737538;Taip;8;0;0;8
6064;Ozas;Nykškukų;5744027226;Ne;21;0;0;21
6065;Ozas;Nykškukų;2544858937;Taip;11;0;0;11
6066;Ozas;Nykškukų;1045890394;Taip;17;0;1;18
6067;Ozas;Nykškukų;1144679735;Taip;8;0;1;9
6068;Ozas;Nykškukų;5383739203;Taip;10;0;1;11
6069;Pabiručiai;Voveriukų;2349337471;Taip;0;1;0;1
6070;Pabiručiai;Voveriukų;4069564285;Taip;0;6;0;6
6071;Pabiručiai;Voveriukų;7278334800;Ne;10;1;0;11
6072;Pabiručiai;Voveriukų;9468698553;Taip;9;0;0;9
6073;Pabiručiai;Voveriukų;5232678556;Ne;0;2;1;3
6074;Pabiručiai;Voveriukų;7066037017;Taip;0;1;0;1
6075;Pabiručiai;Voveriukų;4040533883;Taip;0;0;2;2
6076;Pabiručiai;Voveriukų;2514312233;Taip;0;4;0;4
6077;Pabiručiai;Voveriukų;7606274875;Taip;0;4;0;4
6078;Pabiručiai;Voveriukų;9356327400;Taip;0;2;0;2
6079;Pabiručiai;Voveriukų;7846758352;Taip;1;3;0;4
6080;Pabiručiai;Voveriukų;1498738549;Taip;0;7;0;7
6081;Pabiručiai;Voveriukų;4312364951;Taip;3;1;0;4
6082;Pabiručiai;Voveriukų;4813206044;Taip;18;0;0;18
6083;Pabiručiai;Voveriukų;3936426174;Taip;11;0;1;12
6084;Pabiručiai;Voveriukų;2989580886;Taip;21;0;0;21
6085;Pabiručiai;Voveriukų;7985360502;Taip;10;0;0;10
6086;Pabiručiai;Voveriukų;7403996266;Taip;14;0;0;14
6087;Pabiručiai;Voveriukų;6251432968;Taip;10;0;0;10
6088;Pabiručiai;Boružiukų;6401188653;Taip;1;0;1;2
6089;Pabiručiai;Boružiukų;1673473814;Taip;0;1;0;1
6090;Pabiručiai;Boružiukų;5686769648;Taip;5;5;0;10
6091;Pabiručiai;Boružiukų;7524993271;Taip;0;2;0;2
6092;Pabiručiai;Boružiukų;5708597471;Taip;0;1;0;1
6093;Pabiručiai;Boružiukų;7046122545;Taip;0;2;0;2
6094;Pabiručiai;Boružiukų;3096466200;Taip;0;5;0;5
6095;Pabiručiai;Boružiukų;4301904533;Taip;10;0;0;10
6096;Pabiručiai;Boružiukų;8175565139;Taip;4;0;0;4
6097;Pabiručiai;Boružiukų;8106446562;Taip;0;10;0;10
6098;Pabiručiai;Boružiukų;8236964683;Taip;0;2;0;2
6099;Pabiručiai;Boružiukų;1240057541;Taip;0;2;0;2
6100;Pabiručiai;Boružiukų;1671027282;Taip;4;2;0;6
6101;Pabiručiai;Boružiukų;3759350345;Taip;5;6;0;11
6102;Pabiručiai;Boružiukų;3151360288;Taip;0;6;0;6
6103;Pabiručiai;Boružiukų;9299393363;Taip;0;10;0;10
6104;Pabiručiai;Boružiukų;1484291546;Taip;0;1;2;3
6105;Pabiručiai;Boružiukų;2771769336;Taip;7;3;0;10
6106;Pabiručiai;Boružiukų;2853659708;Taip;10;0;5;15
6107;Pabiručiai;Katinėlių;1670938208;Taip;5;1;0;6
6108;Pabiručiai;Katinėlių;1224986101;Ne;14;1;1;16
6109;Pabiručiai;Katinėlių;3756365293;Taip;8;2;0;10
6110;Pabiručiai;Katinėlių;6283372742;Taip;8;2;0;10
6111;Pabiručiai;Katinėlių;1749155319;Ne;15;0;0;15
6112;Pabiručiai;Katinėlių;34883375155;Taip;20;0;0;20
6113;Pabiručiai;Katinėlių;1705085006;Taip;5;1;2;8
6114;Pabiručiai;Katinėlių;58112415466;Taip;0;9;0;9
6115;Pabiručiai;Katinėlių;42877891797;Taip;0;1;0;1
6116;Pabiručiai;Katinėlių;8284711578;Taip;5;8;0;13
6117;Pabiručiai;Katinėlių;8710389714;Taip;0;11;0;11
6118;Pabiručiai;Katinėlių;8503177793;Taip;17;0;0;17
6119;Pabiručiai;Katinėlių;95695057362;Taip;0;1;0;1
6120;Pabiručiai;Katinėlių;4339607826;Taip;3;10;0;13
6121;Pabiručiai;Katinėlių;8306688649;Taip;8;0;0;8
6122;Pabiručiai;Katinėlių;2572570925;Taip;7;2;2;11
6123;Pabiručiai;Katinėlių;6994301415;Taip;10;0;8;18
6124;Pabiručiai;Katinėlių;4205107384;Taip;3;0;0;3
6125;Pabiručiai;Žiogelių;3272576627;Taip;5;0;1;6
6126;Pabiručiai;Žiogelių;5522447437;Taip;15;0;0;15
6127;Pabiručiai;Žiogelių;7974345478;Taip;0;2;0;2
6128;Pabiručiai;Žiogelių;8367889753;Taip;0;2;0;2
6129;Pabiručiai;Žiogelių;8421025940;Taip;0;1;0;1
6130;Pabiručiai;Žiogelių;3028063887;Taip;0;1;0;1
6131;Pabiručiai;Žiogelių;1642658060;Taip;0;3;2;5
6132;Pabiručiai;Žiogelių;3206962828;Taip;0;2;0;2
6133;Pabiručiai;Žiogelių;3355875364;Taip;0;4;0;4
6134;Pabiručiai;Žiogelių;7085036701;Taip;0;6;0;6
6135;Pabiručiai;Žiogelių;8736658575;Taip;0;1;0;1
6136;Pabiručiai;Žiogelių;1311650644;Taip;0;1;0;1
6137;Pabiručiai;Žiogelių;5480714322;Taip;6;0;0;6
6138;Pabiručiai;Žiogelių;3585198013;Taip;0;6;0;6
6139;Pabiručiai;Žiogelių;2356833740;Taip;16;0;1;17
6140;Pabiručiai;Žiogelių;5311762824;Taip;5;1;3;9
6141;Pabiručiai;Žiogelių;1587905929;Taip;19;0;0;19
6142;Pabiručiai;Žiogelių;5761888906;Taip;0;11;0;11
6143;Pabiručiai;Žiogelių;4667769378;Taip;0;7;0;7
6144;Pabiručiai;Žiogelių;8025611655;Taip;3;0;1;4
6145;Pabiručiai;Smalsiukai;26744711510;Taip;0;1;0;1
6146;Pabiručiai;Smalsiukai;77665506359;Taip;5;2;0;7
6147;Pabiručiai;Smalsiukai;25404048436;Taip;4;1;0;5
6148;Pabiručiai;Smalsiukai;99245902550;Ne;0;3;0;3
6149;Pabiručiai;Smalsiukai;72030186300;Taip;5;5;0;10
6150;Pabiručiai;Smalsiukai;1461544209;Taip;0;1;0;1
6151;Pabiručiai;Smalsiukai;1749795353;Taip;21;0;0;21
6152;Pabiručiai;Smalsiukai;83758151778;Ne;0;3;0;3
6153;Pabiručiai;Smalsiukai;46891762701;Taip;0;5;0;5
6154;Pabiručiai;Smalsiukai;88469372129;Taip;0;11;0;11
6155;Pabiručiai;Smalsiukai;1052844376;Taip;0;6;0;6
6156;Pabiručiai;Smalsiukai;55812858767;Taip;0;1;0;1
6157;Pabiručiai;Smalsiukai;97516241743;Taip;8;1;2;11
6158;Pabiručiai;Smalsiukai;37299891873;Taip;9;2;0;11
6159;Pabiručiai;Smalsiukai;99612002248;Taip;0;5;1;6
6160;Pabiručiai;Smalsiukai;67029008630;Taip;0;3;0;3
6161;Pabiručiai;Smalsiukai;84458450123;Taip;7;0;0;7
6162;Pabiručiai;Smalsiukai;8690290547;Taip;0;8;0;8
6163;Pabiručiai;Smalsiukai;1961336031;Ne;0;8;0;8
6164;Pabiručiai;Kiškučiai;23334247840;Ne;0;2;0;2
6165;Pabiručiai;Kiškučiai;9756328087;Ne;0;10;0;10
6166;Pabiručiai;Kiškučiai;16153916925;Ne;0;2;0;2
6167;Pabiručiai;Kiškučiai;69948274186;Taip;0;1;0;1
6168;Pabiručiai;Kiškučiai;62817645726;Taip;0;3;0;3
6169;Pabiručiai;Kiškučiai;25986912111;Taip;0;6;0;6
6170;Pabiručiai;Kiškučiai;99405892035;Taip;6;11;0;17
6171;Pabiručiai;Kiškučiai;31043795418;Taip;0;5;0;5
6172;Pabiručiai;Kiškučiai;1189209435;Taip;0;2;0;2
6173;Pabiručiai;Kiškučiai;58410416452;Taip;0;12;0;12
6174;Pabiručiai;Kiškučiai;1457799587;Taip;0;1;0;1
6175;Pabiručiai;Kiškučiai;93595653770;Taip;0;1;0;1
6176;Pabiručiai;Kiškučiai;4463663862;Taip;0;4;0;4
6177;Pabiručiai;Kiškučiai;1780827082;Taip;12;1;0;13
6178;Pabiručiai;Kiškučiai;3767061583;Taip;4;3;0;7
6179;Pabiručiai;Kiškučiai;37991862437;Taip;0;5;0;5
6180;Pabiručiai;Kiškučiai;5327687404;Taip;6;2;0;8
6181;Pabiručiai;Kiškučiai;52281960273;Taip;5;2;0;7
6182;Pabiručiai;"Pėledžiukai ";7457099536;Taip;0;2;0;2
6183;Pabiručiai;"Pėledžiukai ";77273870334;Taip;14;1;0;15
6184;Pabiručiai;"Pėledžiukai ";80756439543;Taip;0;10;0;10
6185;Pabiručiai;"Pėledžiukai ";75098378597;Taip;0;5;0;5
6186;Pabiručiai;"Pėledžiukai ";90849312010;Taip;16;0;0;16
6187;Pabiručiai;"Pėledžiukai ";6112244077;Taip;6;2;0;8
6188;Pabiručiai;"Pėledžiukai ";18356992277;Taip;16;1;0;17
6189;Pabiručiai;"Pėledžiukai ";55197056543;Taip;0;1;0;1
6190;Pabiručiai;"Pėledžiukai ";28121667845;Taip;0;7;0;7
6191;Pabiručiai;"Pėledžiukai ";1474411801;Taip;0;1;0;1
6192;Pabiručiai;"Pėledžiukai ";1591342751;Taip;0;10;0;10
6193;Pabiručiai;"Pėledžiukai ";1701727758;Taip;0;1;0;1
6194;Pabiručiai;"Pėledžiukai ";1078387167;Taip;11;0;0;11
6195;Pabiručiai;"Pėledžiukai ";3733576400;Taip;0;6;0;6
6196;Pabiručiai;"Pėledžiukai ";34215100257;Taip;0;5;0;5
6197;Pabiručiai;"Pėledžiukai ";26940925728;Taip;0;3;0;3
6198;Pabiručiai;"Pėledžiukai ";2944433375;Taip;5;5;0;10
6199;Pabiručiai;"Kodelčiūkai ";1819457592;Ne;0;5;0;5
6200;Pabiručiai;"Kodelčiūkai ";38142737487;Taip;0;9;0;9
6201;Pabiručiai;"Kodelčiūkai ";62923769489;Taip;6;4;0;10
6202;Pabiručiai;"Kodelčiūkai ";65267728282;Taip;0;1;0;1
6203;Pabiručiai;"Kodelčiūkai ";81307674221;Taip;5;0;1;6
6204;Pabiručiai;"Kodelčiūkai ";15948930587;Taip;14;0;1;15
6205;Pabiručiai;"Kodelčiūkai ";61144974706;Taip;0;1;0;1
6206;Pabiručiai;"Kodelčiūkai ";78798062773;Taip;0;2;0;2
6207;Pabiručiai;"Kodelčiūkai ";66085180057;Ne;9;4;0;13
6208;Pabiručiai;"Kodelčiūkai ";1718014001;Taip;0;10;0;10
6209;Pabiručiai;"Kodelčiūkai ";2143676810;Taip;0;4;0;4
6210;Pabiručiai;"Kodelčiūkai ";46251218463;Taip;0;7;0;7
6211;Pabiručiai;"Kodelčiūkai ";1029743585;Taip;5;1;0;6
6212;Pabiručiai;"Kodelčiūkai ";1236499374;Taip;6;0;3;9
6213;Pabiručiai;"Kodelčiūkai ";8344476830;Taip;0;9;0;9
6214;Pabiručiai;"Kodelčiūkai ";8359296058;Ne;0;0;3;3
6215;Pabiručiai;"Kodelčiūkai ";4634305371;Taip;0;4;0;4
6216;Pabiručiai;"Kodelčiūkai ";4901977623;Taip;0;0;3;3
6217;Pabiručiai;"Peliukų ";9417138573;Taip;14;0;0;14
6218;Pabiručiai;"Peliukų ";1515270273;Taip;0;0;4;4
6219;Pabiručiai;"Peliukų ";4317656984;Taip;6;0;1;7
6220;Pabiručiai;"Peliukų ";2688728915;Taip;10;0;0;10
6221;Pabiručiai;"Peliukų ";3408518493;Taip;0;0;1;1
6222;Pabiručiai;"Peliukų ";7639362434;Taip;11;0;2;13
6223;Pabiručiai;"Peliukų ";4785878572;Taip;0;7;0;7
6224;Pabiručiai;"Peliukų ";8409455566;Taip;4;0;2;6
6225;Pabiručiai;"Viščiukų ";7090116276;Taip;0;1;11;12
6226;Pabiručiai;"Viščiukų ";8897462614;Taip;0;1;0;1
6227;Pabiručiai;"Viščiukų ";1663953648;Taip;0;1;0;1
6228;Pabiručiai;"Viščiukų ";2869383175;Taip;5;0;0;5
6229;Pabiručiai;"Viščiukų ";5790737929;Taip;8;0;4;12
6230;Pabiručiai;"Viščiukų ";7677235214;Taip;11;0;2;13
6231;Pabiručiai;"Viščiukų ";9676561758;Taip;0;5;0;5
6232;Pabiručiai;"Viščiukų ";7632969321;Ne;15;2;0;17
6233;Pabiručiai;"Viščiukų ";3700401383;Taip;0;14;0;14
6234;Pabiručiai;"Viščiukų ";9093137227;Taip;10;1;0;11
6235;Pabiručiai;"Viščiukų ";6935913132;Ne;12;0;1;13
6236;Pabiručiai;"Viščiukų ";7663581089;Taip;8;1;0;9
6237;Pabiručiai;"Viščiukų ";7248314871;Taip;21;0;0;21
6238;Pabiručiai;"Viščiukų ";9610623364;Taip;5;2;0;7
6239;Pabiručiai;"Viščiukų ";1344711015;Ne;0;2;0;2
6240;Pabiručiai;"Drugelių ";4462744848;Taip;0;4;0;4
6241;Pabiručiai;"Drugelių ";9589005897;Taip;21;0;0;21
6242;Pabiručiai;"Drugelių ";1582754284;Taip;0;5;0;5
6243;Pabiručiai;"Drugelių ";5497318373;Taip;10;0;0;10
6244;Pabiručiai;"Drugelių ";4408666547;Taip;0;1;0;1
6245;Pabiručiai;"Drugelių ";4080298620;Taip;9;4;0;13
6246;Pabiručiai;"Drugelių ";6697518151;Taip;0;7;0;7
6247;Pabiručiai;"Drugelių ";3497466298;Taip;4;2;0;6
6248;Pabiručiai;"Drugelių ";3368607302;Taip;15;0;0;15
6249;Pabiručiai;"Drugelių ";9353062804;Taip;15;1;0;16
6250;Pabiručiai;"Drugelių ";6421623010;Taip;15;0;0;15
6251;Pabiručiai;"Drugelių ";5621183663;Taip;0;1;0;1
6252;Pagrandukas;Saulytės;56985738094;Taip;0;6;0;6
6253;Pagrandukas;Saulytės;73747309137;Ne;0;1;0;1
6254;Pagrandukas;Saulytės;81225644879;Taip;0;1;0;1
6255;Pagrandukas;Saulytės;73094500140;Taip;0;1;0;1
6256;Pagrandukas;Saulytės;25042144265;Taip;0;3;0;3
6257;Pagrandukas;Saulytės;17860708643;Taip;0;1;0;1
6258;Pagrandukas;Saulytės;10275994267;Taip;0;1;0;1
6259;Pagrandukas;Saulytės;53442283517;Ne;5;3;0;8
6260;Pagrandukas;Saulytės;85893187794;Taip;0;1;0;1
6261;Pagrandukas;Saulytės;1735088719;Taip;0;1;0;1
6262;Pagrandukas;Saulytės;2240690677;Taip;0;5;0;5
6263;Pagrandukas;Saulytės;23836053268;Taip;0;2;0;2
6264;Pagrandukas;Saulytės;82076379343;Taip;0;5;0;5
6265;Pagrandukas;Saulytės;90244057040;Ne;0;10;0;10
6266;Pagrandukas;Saulytės;5179694773;Taip;0;5;0;5
6267;Pagrandukas;Saulytės;1432860651;Taip;0;6;0;6
6268;Pagrandukas;Saulytės;4550081974;Taip;5;6;0;11
6269;Pagrandukas;Saulytės;61332904191;Taip;0;2;0;2
6270;Pagrandukas;Zuikučiai;7834436515;Taip;0;4;0;4
6271;Pagrandukas;Zuikučiai;8417942459;Taip;0;0;3;3
6272;Pagrandukas;Zuikučiai;7435609306;Taip;0;0;7;7
6273;Pagrandukas;Zuikučiai;5903416384;Taip;8;0;0;8
6274;Pagrandukas;Zuikučiai;2439891231;Taip;0;0;5;5
6275;Pagrandukas;Zuikučiai;6710887776;Taip;0;0;5;5
6276;Pagrandukas;Zuikučiai;5649084353;Taip;13;0;1;14
6277;Pagrandukas;Zuikučiai;7665811353;Taip;9;0;0;9
6278;Pagrandukas;Zuikučiai;2212787835;Taip;0;2;0;2
6279;Pagrandukas;Zuikučiai;2711590019;Taip;3;0;0;3
6280;Pagrandukas;Zuikučiai;6449029299;Taip;5;0;0;5
6281;Pagrandukas;Zuikučiai;1405820070;Taip;3;0;1;4
6282;Pagrandukas;Zuikučiai;1054107640;Ne;12;0;0;12
6283;Pagrandukas;Zuikučiai;1795582354;Taip;10;1;0;11
6284;Pagrandukas;Zuikučiai;2822538227;Taip;8;0;3;11
6285;Pagrandukas;Boružėlių;3398225200;Taip;0;7;0;7
6286;Pagrandukas;Boružėlių;5752454925;Taip;6;0;0;6
6287;Pagrandukas;Boružėlių;3587941684;Ne;0;10;0;10
6288;Pagrandukas;Boružėlių;5946007985;Taip;0;2;3;5
6289;Pagrandukas;Boružėlių;7770852445;Taip;0;2;2;4
6290;Pagrandukas;Boružėlių;6304701617;Taip;9;0;0;9
6291;Pagrandukas;Boružėlių;1403569615;Ne;2;4;0;6
6292;Pagrandukas;Boružėlių;5511396314;Taip;15;2;0;17
6293;Pagrandukas;Boružėlių;5648658237;Taip;15;0;0;15
6294;Pagrandukas;Boružėlių;9651789217;Taip;0;7;0;7
6295;Pagrandukas;Boružėlių;6911951786;Taip;3;8;0;11
6296;Pagrandukas;Boružėlių;2926077771;Taip;0;2;1;3
6297;Pagrandukas;Boružėlių;5741021524;Taip;0;0;2;2
6298;Pagrandukas;Boružėlių;2361829423;Taip;10;0;0;10
6299;Pagrandukas;Bitutės;22146063631;Taip;0;14;0;14
6300;Pagrandukas;Bitutės;1654566158;Taip;3;1;0;4
6301;Pagrandukas;Bitutės;44029972943;Taip;0;3;0;3
6302;Pagrandukas;Bitutės;47836927832;Taip;0;1;0;1
6303;Pagrandukas;Bitutės;91591094393;Taip;0;3;4;7
6304;Pagrandukas;Bitutės;1503479321;Taip;5;1;0;6
6305;Pagrandukas;Bitutės;9313380552;Taip;0;3;4;7
6306;Pagrandukas;Bitutės;51982253355;Taip;10;2;0;12
6307;Pagrandukas;Bitutės;73259512452;Taip;0;6;0;6
6308;Pagrandukas;Bitutės;80939233319;Taip;0;6;0;6
6309;Pagrandukas;Bitutės;6044667668;Taip;0;0;1;1
6310;Pagrandukas;Bitutės;3227066520;Taip;5;1;0;6
6311;Pagrandukas;Bitutės;1813676320;Taip;0;1;0;1
6312;Pagrandukas;Bitutės;57471531440;Taip;0;12;0;12
6313;Pagrandukas;Bitutės;6315627367;Taip;4;0;0;4
6314;Pagrandukas;Bitutės;8529974367;Taip;10;0;0;10
6315;Pagrandukas;Bitutės;1938604743;Taip;0;2;0;2
6316;Pagrandukas;Bitutės;4079711515;Ne;8;0;0;8
6317;Pagrandukas;Pelėdžiukai;21409116617;Taip;0;1;0;1
6318;Pagrandukas;Pelėdžiukai;82163714693;Taip;0;1;0;1
6319;Pagrandukas;Pelėdžiukai;1590309916;Taip;11;1;0;12
6320;Pagrandukas;Pelėdžiukai;1964310988;Taip;6;1;0;7
6321;Pagrandukas;Pelėdžiukai;44044284874;Taip;0;9;0;9
6322;Pagrandukas;Pelėdžiukai;33750135077;Taip;0;5;0;5
6323;Pagrandukas;Pelėdžiukai;2066377478;Taip;6;0;7;13
6324;Pagrandukas;Pelėdžiukai;1189453012;Taip;0;11;0;11
6325;Pagrandukas;Pelėdžiukai;43539883053;Taip;7;0;0;7
6326;Pagrandukas;Pelėdžiukai;4391887554;Taip;5;0;0;5
6327;Pagrandukas;Pelėdžiukai;33909593470;Taip;0;1;0;1
6328;Pagrandukas;Pelėdžiukai;2068155037;Taip;0;0;6;6
6329;Pagrandukas;Pelėdžiukai;7751376696;Taip;4;1;0;5
6330;Pagrandukas;Pelėdžiukai;5818020587;Taip;0;0;2;2
6331;Pagrandukas;Pelėdžiukai;21544489661;Taip;7;0;0;7
6332;Pagrandukas;Pelėdžiukai;1232460221;Taip;6;0;0;6
6333;Pagrandukas;Pelėdžiukai;7611916563;Taip;0;1;0;1
6334;Pagrandukas;Pelėdžiukai;1451503127;Taip;18;0;0;18
6335;Pagrandukas;Žvaigždutė;1904462840;Taip;0;1;0;1
6336;Pagrandukas;Žvaigždutė;9329518124;Taip;0;1;0;1
6337;Pagrandukas;Žvaigždutė;75080308291;Taip;0;13;0;13
6338;Pagrandukas;Žvaigždutė;7876029445;Ne;0;7;0;7
6339;Pagrandukas;Žvaigždutė;1313716840;Taip;0;3;0;3
6340;Pagrandukas;Žvaigždutė;14043704729;Taip;0;2;2;4
6341;Pagrandukas;Žvaigždutė;51692261484;Ne;0;5;0;5
6342;Pagrandukas;Žvaigždutė;1511562720;Taip;0;1;0;1
6343;Pagrandukas;Žvaigždutė;35830862363;Ne;7;1;0;8
6344;Pagrandukas;Žvaigždutė;2079943643;Taip;7;2;0;9
6345;Pagrandukas;Žvaigždutė;2923517578;Taip;0;7;0;7
6346;Pagrandukas;Žvaigždutė;4724383814;Taip;0;2;1;3
6347;Pagrandukas;Žvaigždutė;7782678159;Ne;11;1;0;12
6348;Pagrandukas;Žvaigždutė;8879549409;Taip;0;3;0;3
6349;Pagrandukas;Žvaigždutė;6299298199;Taip;0;7;0;7
6350;Pagrandukas;Žvaigždutė;7543795007;Taip;0;2;0;2
6351;Pagrandukas;Žvaigždutė;3860781857;Taip;0;7;0;7
6352;Pagrandukas;Žvaigždutė;24287759126;Taip;0;1;0;1
6353;Pagrandukas;Žvaigždutė;1376514473;Taip;0;6;0;6
6354;Pakalnutė;Pagrandukai;22735454739;Taip;3;2;5;10
6355;Pakalnutė;Pagrandukai;1621947670;Ne;9;2;2;13
6356;Pakalnutė;Pagrandukai;2930341121;Taip;0;1;0;1
6357;Pakalnutė;Pagrandukai;18927141423;Taip;0;1;0;1
6358;Pakalnutė;Pagrandukai;70476217309;Ne;0;3;0;3
6359;Pakalnutė;Pagrandukai;39181323005;Taip;6;1;0;7
6360;Pakalnutė;Pagrandukai;86458592440;Taip;0;2;0;2
6361;Pakalnutė;Pagrandukai;46144634381;Taip;9;2;0;11
6362;Pakalnutė;Pagrandukai;85764245101;Taip;0;1;0;1
6363;Pakalnutė;Pagrandukai;57463392902;Taip;0;2;0;2
6364;Pakalnutė;Pagrandukai;97346486902;Taip;0;1;0;1
6365;Pakalnutė;Pagrandukai;24840895951;Taip;0;2;0;2
6366;Pakalnutė;Pagrandukai;7535589010;Taip;0;2;0;2
6367;Pakalnutė;Pagrandukai;1210432627;Taip;0;4;0;4
6368;Pakalnutė;Pagrandukai;3987920952;Ne;0;2;0;2
6369;Pakalnutė;Pagrandukai;34357752735;Ne;0;2;0;2
6370;Pakalnutė;Pagrandukai;28398386463;Taip;3;0;0;3
6371;Pakalnutė;Pagrandukai;1970792910;Taip;6;2;0;8
6372;Pakalnutė;"Pelėdžiukų ";7110858765;Taip;12;0;0;12
6373;Pakalnutė;"Pelėdžiukų ";8553182620;Taip;11;0;0;11
6374;Pakalnutė;"Pelėdžiukų ";3840499737;Taip;0;12;0;12
6375;Pakalnutė;"Pelėdžiukų ";4523766424;Taip;7;0;0;7
6376;Pakalnutė;"Pelėdžiukų ";6577255841;Taip;5;0;5;10
6377;Pakalnutė;"Pelėdžiukų ";7151877991;Taip;15;0;0;15
6378;Pakalnutė;"Pelėdžiukų ";3919560072;Ne;0;0;15;15
6379;Pakalnutė;"Pelėdžiukų ";4452372238;Taip;13;0;0;13
6380;Pakalnutė;"Pelėdžiukų ";2992768162;Taip;10;0;1;11
6381;Pakalnutė;"Pelėdžiukų ";9505524183;Taip;9;0;1;10
6382;Pakalnutė;"Pelėdžiukų ";3792697409;Taip;11;0;0;11
6383;Pakalnutė;"Pelėdžiukų ";8823232039;Taip;11;1;0;12
6384;Pakalnutė;"Pelėdžiukų ";8900756351;Taip;3;13;0;16
6385;Pakalnutė;"Pelėdžiukų ";2035060922;Taip;5;0;0;5
6386;Pakalnutė;"Pelėdžiukų ";7325137583;Taip;15;0;0;15
6387;Pakalnutė;"Pelėdžiukų ";4220368864;Ne;6;0;0;6
6388;Pakalnutė;"Pelėdžiukų ";1330092247;Taip;0;7;0;7
6389;Pakalnutė;"Pelėdžiukų ";3267680599;Ne;0;3;0;3
6390;Pakalnutė;Ežiukai;5058727058;Taip;0;0;3;3
6391;Pakalnutė;Ežiukai;2714905466;Taip;8;0;1;9
6392;Pakalnutė;Ežiukai;4052166895;Taip;6;0;2;8
6393;Pakalnutė;Ežiukai;3650483589;Taip;17;0;1;18
6394;Pakalnutė;Ežiukai;7962849592;Taip;16;0;0;16
6395;Pakalnutė;Ežiukai;1070172991;Taip;7;0;0;7
6396;Pakalnutė;Ežiukai;3660195990;Taip;15;2;0;17
6397;Pakalnutė;Ežiukai;9323200833;Taip;19;0;0;19
6398;Pakalnutė;Ežiukai;4153294595;Taip;1;0;0;1
6399;Pakalnutė;Ežiukai;8155327668;Taip;19;0;0;19
6400;Pakalnutė;Ežiukai;9781993614;Taip;18;0;0;18
6401;Pakalnutė;Ežiukai;9256219647;Taip;0;9;1;10
6402;Pakalnutė;Ežiukai;7853479591;Ne;16;0;0;16
6403;Pakalnutė;Skruzdėliukų;3583094831;Taip;10;0;0;10
6404;Pakalnutė;Skruzdėliukų;4033813807;Taip;11;0;0;11
6405;Pakalnutė;Skruzdėliukų;9382160515;Taip;0;10;0;10
6406;Pakalnutė;Skruzdėliukų;7503936754;Taip;1;0;0;1
6407;Pakalnutė;Skruzdėliukų;5409476517;Taip;21;0;0;21
6408;Pakalnutė;Skruzdėliukų;2670302354;Taip;14;0;0;14
6409;Pakalnutė;Skruzdėliukų;7105369111;Taip;17;0;0;17
6410;Pakalnutė;Skruzdėliukų;6944726166;Ne;9;0;0;9
6411;Pakalnutė;Skruzdėliukų;1195872320;Taip;4;2;0;6
6412;Pakalnutė;Skruzdėliukų;3211633472;Taip;5;0;0;5
6413;Pakalnutė;Skruzdėliukų;4423348418;Taip;12;0;0;12
6414;Pakalnutė;Skruzdėliukų;6934760468;Taip;16;0;0;16
6415;Pakalnutė;Skruzdėliukų;5911381706;Taip;14;0;0;14
6416;Pakalnutė;Skruzdėliukų;8797870379;Taip;0;10;0;10
6417;Pakalnutė;Skruzdėliukų;6055727963;Taip;16;0;0;16
6418;Pakalnutė;Bitučių;2993145079;Taip;0;3;0;3
6419;Pakalnutė;Bitučių;2367683002;Taip;5;0;0;5
6420;Pakalnutė;Bitučių;2765220889;Taip;11;1;0;12
6421;Pakalnutė;Bitučių;9445909071;Ne;6;4;0;10
6422;Pakalnutė;Bitučių;5532458706;Taip;5;2;0;7
6423;Pakalnutė;Bitučių;7526989580;Taip;10;0;1;11
6424;Pakalnutė;Bitučių;5941955322;Taip;10;0;0;10
6425;Pakalnutė;Bitučių;3306334576;Taip;11;4;0;15
6426;Pakalnutė;Bitučių;2095540372;Taip;16;0;2;18
6427;Pakalnutė;Bitučių;5342592825;Taip;16;0;0;16
6428;Pakalnutė;Bitučių;2932205226;Taip;5;6;0;11
6429;Pakalnutė;Bitučių;1238121406;Ne;0;6;0;6
6430;Pakalnutė;Bitučių;6117542654;Ne;18;0;0;18
6431;Pakalnutė;Bitučių;5464143742;Taip;16;0;0;16
6432;Pakalnutė;Bitučių;6351193702;Ne;0;3;0;3
6433;Pakalnutė;Bitučių;2070744110;Taip;8;0;0;8
6434;Pakalnutė;Bitučių;3965390135;Taip;5;4;0;9
6435;Pakalnutė;Bitučių;9365592664;Taip;18;0;0;18
6436;Pakalnutė;Bitučių;5355198213;Taip;16;0;0;16
6437;Pakalnutė;Boružiukų;5120176374;Taip;0;1;0;1
6438;Pakalnutė;Boružiukų;6798939288;Taip;0;2;0;2
6439;Pakalnutė;Boružiukų;7357431226;Taip;3;3;0;6
6440;Pakalnutė;Boružiukų;4934095931;Taip;5;1;0;6
6441;Pakalnutė;Boružiukų;5039000154;Taip;0;3;0;3
6442;Pakalnutė;Boružiukų;6575909478;Taip;0;0;4;4
6443;Pakalnutė;Boružiukų;2040992265;Taip;13;0;0;13
6444;Pakalnutė;Boružiukų;2835611316;Taip;10;5;0;15
6445;Pakalnutė;Boružiukų;5134342817;Taip;6;3;0;9
6446;Pakalnutė;Boružiukų;7672252382;Ne;0;1;0;1
6447;Pakalnutė;Boružiukų;7439220341;Taip;0;0;5;5
6448;Pakalnutė;Boružiukų;4950195858;Taip;15;0;0;15
6449;Pakalnutė;Boružiukų;1870528568;Taip;11;0;0;11
6450;Pakalnutė;Boružiukų;4927086034;Taip;6;0;0;6
6451;Pakalnutė;Boružiukų;6557165567;Ne;16;0;0;16
6452;Pakalnutė;Boružiukų;3677709759;Taip;2;0;1;3
6453;Pakalnutė;Boružiukų;2597900983;Taip;17;0;0;17
6454;Pakalnutė;Boružiukų;2062721289;Taip;14;0;0;14
6455;Pakalnutė;Boružiukų;1340022702;Ne;17;0;0;17
6456;Pakalnutė;Meškiukų;41008813511;Ne;21;0;0;21
6457;Pakalnutė;Meškiukų;64706392096;Ne;14;1;0;15
6458;Pakalnutė;Meškiukų;1411083263;Taip;0;0;1;1
6459;Pakalnutė;Meškiukų;2202341545;Taip;15;3;0;18
6460;Pakalnutė;Meškiukų;7180617984;Ne;0;2;0;2
6461;Pakalnutė;Meškiukų;7487278074;Taip;0;0;2;2
6462;Pakalnutė;Meškiukų;9355380341;Taip;11;0;1;12
6463;Pakalnutė;Meškiukų;7324846434;Taip;3;5;0;8
6464;Pakalnutė;Meškiukų;1396367371;Taip;7;0;5;12
6465;Pakalnutė;Meškiukų;2666441234;Taip;8;0;0;8
6466;Pakalnutė;Meškiukų;4256222944;Taip;5;9;0;14
6467;Pakalnutė;Meškiukų;6194464236;Taip;13;0;0;13
6468;Pakalnutė;Meškiukų;7659209862;Taip;21;0;0;21
6469;Pakalnutė;Meškiukų;2101821362;Taip;10;6;0;16
6470;Pakalnutė;Meškiukų;1532248269;Taip;15;2;0;17
6471;Pakalnutė;Meškiukų;3675401775;Taip;15;2;0;17
6472;Pakalnutė;Meškiukų;9001185744;Taip;0;0;2;2
6473;Pakalnutė;Meškiukų;4317305712;Taip;5;0;1;6
6474;Pakalnutė;Meškiukų;4818901769;Taip;21;0;0;21
6475;Pakalnutė;Meškiukų;2755412687;Taip;17;0;0;17
6476;Pakalnutė;Meškiukų;4533467194;Ne;12;0;0;12
6477;Pakalnutė;Nykštukai;6769352325;Taip;0;10;0;10
6478;Pakalnutė;Nykštukai;72137985328;Taip;0;1;0;1
6479;Pakalnutė;Nykštukai;11183301096;Taip;5;1;0;6
6480;Pakalnutė;Nykštukai;19773872429;Taip;0;0;2;2
6481;Pakalnutė;Nykštukai;85900847069;Taip;10;1;0;11
6482;Pakalnutė;Nykštukai;7452656662;Taip;6;0;0;6
6483;Pakalnutė;Nykštukai;7389600659;Taip;0;2;0;2
6484;Pakalnutė;Nykštukai;5309195407;Taip;0;6;0;6
6485;Pakalnutė;Nykštukai;1849396954;Taip;0;1;1;2
6486;Pakalnutė;Nykštukai;81963663668;Taip;0;5;0;5
6487;Pakalnutė;Nykštukai;76382908561;Taip;0;6;0;6
6488;Pakalnutė;Nykštukai;99344331316;Taip;5;0;0;5
6489;Pakalnutė;Nykštukai;33667858388;Taip;14;4;0;18
6490;Pakalnutė;Nykštukai;2815093249;Ne;8;1;0;9
6491;Pakalnutė;Nykštukai;61712002384;Taip;0;7;0;7
6492;Pakalnutė;Nykštukai;9647325689;Taip;14;0;0;14
6493;Pakalnutė;Nykštukai;2051737273;Taip;6;0;0;6
6494;Pakalnutė;"Zuikučių ";1198230323;Taip;0;1;2;3
6495;Pakalnutė;"Zuikučių ";6016791282;Taip;0;1;1;2
6496;Pakalnutė;"Zuikučių ";3609982613;Ne;4;3;0;7
6497;Pakalnutė;"Zuikučių ";5958653847;Taip;0;1;0;1
6498;Pakalnutė;"Zuikučių ";8513260520;Taip;21;0;0;21
6499;Pakalnutė;"Zuikučių ";2159430356;Taip;0;5;0;5
6500;Pakalnutė;"Zuikučių ";1147843795;Ne;6;0;0;6
6501;Pakalnutė;"Zuikučių ";6879558965;Taip;12;0;0;12
6502;Pakalnutė;"Zuikučių ";3555822605;Taip;13;1;0;14
6503;Pakalnutė;"Zuikučių ";1583462733;Taip;0;1;0;1
6504;Pakalnutė;"Zuikučių ";6377564215;Taip;7;0;0;7
6505;Pakalnutė;"Zuikučių ";3306670221;Taip;9;0;1;10
6506;Pakalnutė;"Zuikučių ";1159312512;Taip;21;0;0;21
6507;Pakalnutė;"Zuikučių ";1610847242;Taip;2;1;0;3
6508;Pakalnutė;"Zuikučių ";8813262660;Ne;11;1;0;12
6509;Pakalnutė;"Zuikučių ";5102345686;Taip;9;1;1;11
6510;Pakalnutė;"Zuikučių ";7949588551;Ne;5;0;1;6
6511;Pakalnutė;"Zuikučių ";81578522887;Ne;2;1;0;3
6512;Pakalnutė;"Zuikučių ";5949298584;Taip;0;1;0;1
6513;Pakalnutė;"Drugelių ";4046820545;Taip;0;2;0;2
6514;Pakalnutė;"Drugelių ";4742424647;Taip;5;0;6;11
6515;Pakalnutė;"Drugelių ";2075865543;Taip;16;0;0;16
6516;Pakalnutė;"Drugelių ";9562957603;Taip;0;1;0;1
6517;Pakalnutė;"Drugelių ";5435336235;Taip;6;0;3;9
6518;Pakalnutė;"Drugelių ";2050880681;Taip;2;1;0;3
6519;Pakalnutė;"Drugelių ";4514642887;Taip;6;1;0;7
6520;Pakalnutė;"Drugelių ";9274456755;Taip;0;1;0;1
6521;Pakalnutė;"Drugelių ";2721810040;Taip;0;0;11;11
6522;Pakalnutė;"Drugelių ";80818670065;Taip;9;1;3;13
6523;Pakalnutė;"Drugelių ";2049079012;Taip;0;6;0;6
6524;Pakalnutė;"Drugelių ";4681267749;Taip;16;1;0;17
6525;Pakalnutė;"Drugelių ";85356812538;Taip;6;2;0;8
6526;Pakalnutė;"Drugelių ";6771510589;Taip;7;1;2;10
6527;Pakalnutė;"Drugelių ";4264260466;Taip;17;0;1;18
6528;Pakalnutė;"Drugelių ";58670351468;Ne;10;0;2;12
6529;Pakalnutė;"Drugelių ";2901031642;Taip;5;1;0;6
6530;Panerių;Rūtelė;81949147104;Taip;6;0;0;6
6531;Panerių;Rūtelė;21661667266;Taip;8;0;0;8
6532;Panerių;Rūtelė;85473262607;Taip;0;0;1;1
6533;Panerių;Rūtelė;7324873912;Taip;0;0;4;4
6534;Panerių;Rūtelė;8388744329;Taip;0;0;1;1
6535;Panerių;Rūtelė;68313730462;Taip;0;0;4;4
6536;Panerių;Rūtelė;84672957234;Taip;4;2;0;6
6537;Panerių;Rūtelė;60738239005;Taip;0;0;1;1
6538;Panerių;Rūtelė;68231938043;Ne;3;0;2;5
6539;Panerių;Rūtelė;78838685571;Taip;0;0;5;5
6540;Panerių;Rūtelė;53384267657;Taip;0;0;2;2
6541;Panerių;Rūtelė;8666159951;Taip;0;0;3;3
6542;Panerių;Rūtelė;7753488216;Ne;15;0;0;15
6543;Panerių;Rūtelė;6227583229;Taip;8;0;0;8
6544;Panerių;Rūtelė;1894521927;Taip;0;0;4;4
6545;Panerių;Rūtelė;1303873524;Taip;7;0;3;10
6546;Panerių;Rūtelė;75034220223;Ne;7;0;0;7
6547;Panerių;Rūtelė;2069150261;Taip;0;2;0;2
6548;Panerių;Rūtelė;1386277428;Taip;0;0;1;1
6549;Panerių;Rūtelė;18963190527;Taip;2;0;4;6
6550;Panerių;Rūtelė;4103412131;Taip;21;0;0;21
6551;Panerių;Rūtelė;2786775879;Taip;0;9;0;9
6552;Panerių;Gėlytės;9604335101;Taip;21;0;0;21
6553;Panerių;Gėlytės;3843500717;Taip;0;0;4;4
6554;Panerių;Gėlytės;2195332401;Taip;0;0;5;5
6555;Panerių;Gėlytės;4023257875;Taip;0;4;0;4
6556;Panerių;Gėlytės;4689913361;Taip;11;0;0;11
6557;Panerių;Gėlytės;6182126113;Ne;0;0;2;2
6558;Panerių;Gėlytės;8299189235;Taip;12;0;0;12
6559;Panerių;Gėlytės;2571561865;Taip;0;11;0;11
6560;Panerių;Gėlytės;6908487075;Taip;11;0;0;11
6561;Panerių;Boružė;3190117304;Taip;0;5;0;5
6562;Panerių;Boružė;6583134855;Taip;0;6;0;6
6563;Panerių;Boružė;6468190149;Taip;0;0;1;1
6564;Panerių;Boružė;3550194241;Taip;15;1;0;16
6565;Panerių;Boružė;4646173276;Taip;13;0;0;13
6566;Panerių;Boružė;3913395809;Taip;13;0;4;17
6567;Panerių;Boružė;7239773684;Taip;10;0;0;10
6568;Panerių;Boružė;8514805919;Taip;4;0;2;6
6569;Panerių;Boružė;4867297993;Taip;0;0;1;1
6570;Panerių;Boružė;9630302749;Taip;21;0;0;21
6571;Panerių;Boružė;2308739823;Taip;6;0;2;8
6572;Panerių;Boružė;9631684972;Taip;3;0;1;4
6573;Panerių;Boružė;3057714143;Taip;1;1;0;2
6574;Panerių;Boružė;9506008651;Taip;15;0;0;15
6575;Panerių;Boružė;9188471756;Taip;0;0;1;1
6576;Panerių;Boružė;8693113275;Taip;18;0;0;18
6577;Panerių;Boružė;3346395516;Taip;0;0;3;3
6578;Papartis;ZUIKUČIAI;1065234123;Taip;12;0;3;15
6579;Papartis;ZUIKUČIAI;27900855758;Taip;2;0;1;3
6580;Papartis;ZUIKUČIAI;1219140467;Taip;5;0;0;5
6581;Papartis;ZUIKUČIAI;1260151691;Taip;0;6;1;7
6582;Papartis;ZUIKUČIAI;2412700197;Taip;0;6;6;12
6583;Papartis;ZUIKUČIAI;1554777403;Taip;5;0;2;7
6584;Papartis;ZUIKUČIAI;7703070601;Taip;0;11;0;11
6585;Papartis;ZUIKUČIAI;7902130389;Taip;2;1;0;3
6586;Papartis;ZUIKUČIAI;4992305227;Taip;5;0;0;5
6587;Papartis;ZUIKUČIAI;4346817695;Taip;5;0;1;6
6588;Papartis;ZUIKUČIAI;2447926422;Taip;0;8;0;8
6589;Papartis;ZUIKUČIAI;3182457453;Taip;5;3;0;8
6590;Papartis;ZUIKUČIAI;3275123842;Taip;1;3;0;4
6591;Papartis;ZUIKUČIAI;8190458132;Taip;0;6;0;6
6592;Papartis;ZUIKUČIAI;8952917454;Taip;3;6;1;10
6593;Papartis;ZUIKUČIAI;5410369044;Taip;19;0;0;19
6594;Papartis;ZUIKUČIAI;6126912448;Taip;0;5;5;10
6595;Papartis;ZUIKUČIAI;5675537250;Ne;8;1;0;9
6596;Papartis;ZUIKUČIAI;3221250267;Taip;1;0;0;1
6597;Papartis;ZUIKUČIAI;1065128993;Ne;0;1;2;3
6598;Papartis;ZUIKUČIAI;3895487270;Taip;12;1;0;13
6599;Papartis;DRUGELIAI;4508053349;Taip;1;1;0;2
6600;Papartis;DRUGELIAI;7387281720;Taip;0;2;0;2
6601;Papartis;DRUGELIAI;2778629398;Taip;3;18;0;21
6602;Papartis;DRUGELIAI;3475745012;Ne;18;0;1;19
6603;Papartis;DRUGELIAI;2535412635;Taip;3;0;1;4
6604;Papartis;DRUGELIAI;6797687614;Taip;2;0;0;2
6605;Papartis;DRUGELIAI;7606939822;Taip;0;0;1;1
6606;Papartis;DRUGELIAI;9719465384;Ne;0;6;0;6
6607;Papartis;DRUGELIAI;8148483438;Taip;5;0;0;5
6608;Papartis;DRUGELIAI;5265293240;Taip;11;1;0;12
6609;Papartis;DRUGELIAI;7590170146;Taip;0;0;2;2
6610;Papartis;DRUGELIAI;9134335737;Taip;0;1;11;12
6611;Papartis;DRUGELIAI;1836914270;Taip;0;0;2;2
6612;Papartis;DRUGELIAI;4935694347;Taip;7;0;1;8
6613;Papartis;DRUGELIAI;1672028156;Taip;0;0;3;3
6614;Papartis;DRUGELIAI;3267416367;Taip;1;1;0;2
6615;Papartis;DRUGELIAI;3107106078;Taip;5;0;0;5
6616;Papartis;DRUGELIAI;1205854439;Ne;0;0;6;6
6617;Papartis;DRUGELIAI;7067369268;Taip;18;0;0;18
6618;Papartis;DRUGELIAI;6746279237;Taip;0;0;11;11
6619;Papartis;DRUGELIAI;42803013754;Taip;0;1;1;2
6620;Papartis;ŽVIRBLIUKAI;19544040390;Ne;0;0;1;1
6621;Papartis;ŽVIRBLIUKAI;19852567505;Taip;0;2;0;2
6622;Papartis;ŽVIRBLIUKAI;32352993438;Taip;0;1;0;1
6623;Papartis;ŽVIRBLIUKAI;67237428983;Taip;4;1;0;5
6624;Papartis;ŽVIRBLIUKAI;89486863055;Taip;0;1;0;1
6625;Papartis;ŽVIRBLIUKAI;20002349512;Taip;0;1;0;1
6626;Papartis;ŽVIRBLIUKAI;4139884005;Taip;6;1;1;8
6627;Papartis;ŽVIRBLIUKAI;81734271362;Taip;0;1;1;2
6628;Papartis;ŽVIRBLIUKAI;87519747220;Taip;0;1;3;4
6629;Papartis;ŽVIRBLIUKAI;87353511647;Taip;0;1;0;1
6630;Papartis;ŽVIRBLIUKAI;25990216006;Taip;0;1;0;1
6631;Papartis;ŽVIRBLIUKAI;26912851152;Taip;0;3;0;3
6632;Papartis;ŽVIRBLIUKAI;60706816641;Taip;0;1;3;4
6633;Papartis;ŽVIRBLIUKAI;77686722867;Taip;0;1;2;3
6634;Papartis;ŽVIRBLIUKAI;1973027294;Taip;0;1;1;2
6635;Papartis;ŽVIRBLIUKAI;1403114386;Taip;0;1;0;1
6636;Papartis;ŽVIRBLIUKAI;2146286089;Taip;0;2;0;2
6637;Papartis;ŽVIRBLIUKAI;1876543445;Taip;1;1;0;2
6638;Papartis;ŽVIRBLIUKAI;7308118576;Taip;4;1;3;8
6639;Papartis;ŽVIRBLIUKAI;45289621684;Taip;0;5;0;5
6640;Papartis;PELĖDŽIUKAI;37759125130;Taip;12;1;1;14
6641;Papartis;PELĖDŽIUKAI;20862839950;Taip;4;1;0;5
6642;Papartis;PELĖDŽIUKAI;20907751423;Taip;0;1;0;1
6643;Papartis;PELĖDŽIUKAI;8564913801;Taip;0;1;0;1
6644;Papartis;PELĖDŽIUKAI;47876153590;Taip;0;1;0;1
6645;Papartis;PELĖDŽIUKAI;84260015363;Taip;0;2;0;2
6646;Papartis;PELĖDŽIUKAI;67226404925;Taip;11;1;1;13
6647;Papartis;PELĖDŽIUKAI;41330436046;Taip;10;1;0;11
6648;Papartis;PELĖDŽIUKAI;83927324420;Taip;0;1;0;1
6649;Papartis;PELĖDŽIUKAI;51857496843;Taip;0;1;0;1
6650;Papartis;PELĖDŽIUKAI;21840378271;Taip;0;1;0;1
6651;Papartis;PELĖDŽIUKAI;93141801552;Taip;4;0;0;4
6652;Papartis;PELĖDŽIUKAI;81006952163;Taip;0;2;0;2
6653;Papartis;PELĖDŽIUKAI;46076659264;Ne;0;1;0;1
6654;Papartis;PELĖDŽIUKAI;8593823543;Taip;0;1;3;4
6655;Papartis;PELĖDŽIUKAI;31606112621;Taip;0;1;0;1
6656;Papartis;PELĖDŽIUKAI;1727771667;Taip;4;1;1;6
6657;Papartis;PELĖDŽIUKAI;18164175829;Taip;3;7;0;10
6658;Papartis;PELĖDŽIUKAI;1045629158;Taip;0;1;0;1
6659;Papartis;PELĖDŽIUKAI;1903219436;Ne;10;1;0;11
6660;Papartis;PELĖDŽIUKAI;8958062862;Taip;0;2;0;2
6661;Papartis;SAULUTĖS;2022533158;Taip;0;2;0;2
6662;Papartis;SAULUTĖS;1246604915;Taip;0;1;0;1
6663;Papartis;SAULUTĖS;48182233276;Taip;3;1;0;4
6664;Papartis;SAULUTĖS;23218268605;Ne;0;1;0;1
6665;Papartis;SAULUTĖS;18124337938;Taip;0;1;0;1
6666;Papartis;SAULUTĖS;22443998204;Taip;0;1;0;1
6667;Papartis;SAULUTĖS;30982681803;Taip;0;4;0;4
6668;Papartis;SAULUTĖS;95139517078;Taip;0;3;0;3
6669;Papartis;SAULUTĖS;14978429821;Taip;0;1;0;1
6670;Papartis;SAULUTĖS;55573140983;Taip;0;1;0;1
6671;Papartis;SAULUTĖS;50090482473;Taip;5;3;0;8
6672;Papartis;SAULUTĖS;10078570352;Taip;0;2;0;2
6673;Papartis;SAULUTĖS;88700503601;Taip;0;1;0;1
6674;Papartis;SAULUTĖS;21963930874;Taip;0;3;0;3
6675;Papartis;SAULUTĖS;15207322802;Taip;0;2;0;2
6676;Papartis;SAULUTĖS;2115718328;Ne;0;1;0;1
6677;Papartis;SAULUTĖS;67966766974;Taip;0;1;0;1
6678;Papartis;SAULUTĖS;50658624766;Ne;9;2;1;12
6679;Papartis;SAULUTĖS;79080758672;Taip;0;1;0;1
6680;Papartis;GANDRIUKAI;9900023788;Taip;5;1;0;6
6681;Papartis;GANDRIUKAI;8946678515;Taip;8;0;1;9
6682;Papartis;GANDRIUKAI;2783708905;Taip;0;0;4;4
6683;Papartis;GANDRIUKAI;6883101103;Taip;11;0;0;11
6684;Papartis;GANDRIUKAI;2868899342;Taip;9;4;0;13
6685;Papartis;GANDRIUKAI;7768672610;Ne;1;1;1;3
6686;Papartis;GANDRIUKAI;9384670351;Taip;0;10;0;10
6687;Papartis;GANDRIUKAI;9968072478;Ne;0;2;5;7
6688;Papartis;GANDRIUKAI;2215846642;Taip;13;0;2;15
6689;Papartis;GANDRIUKAI;3320524073;Taip;0;0;3;3
6690;Papartis;GANDRIUKAI;9704930584;Taip;0;4;0;4
6691;Papartis;GANDRIUKAI;9804863902;Taip;0;1;0;1
6692;Papartis;GANDRIUKAI;9072635586;Taip;0;1;0;1
6693;Papartis;GANDRIUKAI;1974159967;Taip;0;2;1;3
6694;Papartis;GANDRIUKAI;5732853976;Taip;2;0;1;3
6695;Papartis;GANDRIUKAI;7859096984;Taip;9;3;0;12
6696;Papartis;GANDRIUKAI;1442806517;Taip;15;0;0;15
6697;Papartis;GANDRIUKAI;7252265838;Taip;0;3;0;3
6698;Papartis;GANDRIUKAI;4279580382;Taip;5;0;0;5
6699;Papartis;GANDRIUKAI;9978625382;Taip;18;0;0;18
6700;Papartis;AITVARELIAI;82454730189;Taip;0;1;0;1
6701;Papartis;AITVARELIAI;2398385967;Taip;6;1;0;7
6702;Papartis;AITVARELIAI;89525856173;Taip;0;1;0;1
6703;Papartis;AITVARELIAI;4216398263;Taip;6;0;0;6
6704;Papartis;AITVARELIAI;72182866449;Taip;0;1;0;1
6705;Papartis;AITVARELIAI;3287617252;Taip;0;1;1;2
6706;Papartis;AITVARELIAI;4823666725;Taip;0;1;0;1
6707;Papartis;AITVARELIAI;1406820323;Taip;0;8;0;8
6708;Papartis;AITVARELIAI;2092191603;Taip;0;1;0;1
6709;Papartis;AITVARELIAI;10659508171;Taip;2;0;0;2
6710;Papartis;AITVARELIAI;2067304804;Taip;0;4;0;4
6711;Papartis;AITVARELIAI;88418552221;Taip;0;3;0;3
6712;Papartis;AITVARELIAI;51899025231;Ne;4;1;0;5
6713;Papartis;AITVARELIAI;74972133115;Taip;0;0;1;1
6714;Papartis;AITVARELIAI;88722771438;Taip;5;10;0;15
6715;Papartis;AITVARELIAI;74734443304;Taip;10;1;0;11
6716;Papartis;AITVARELIAI;63087155760;Taip;0;1;0;1
6717;Papartis;AITVARELIAI;26193472997;Taip;0;1;0;1
6718;Papartis;AITVARELIAI;68478260102;Ne;0;2;0;2
6719;Papartis;SMALSUČIAI;6266095782;Taip;3;0;0;3
6720;Papartis;SMALSUČIAI;3054883426;Taip;16;0;1;17
6721;Papartis;SMALSUČIAI;1191546794;Taip;9;0;0;9
6722;Papartis;SMALSUČIAI;6073970691;Taip;18;0;0;18
6723;Papartis;SMALSUČIAI;8447326505;Taip;4;1;0;5
6724;Papartis;SMALSUČIAI;1919362027;Taip;3;0;3;6
6725;Papartis;SMALSUČIAI;9375751990;Taip;4;0;0;4
6726;Papartis;SMALSUČIAI;5786648402;Taip;11;1;1;13
6727;Papartis;SMALSUČIAI;8808902528;Taip;0;1;0;1
6728;Papartis;SMALSUČIAI;5361925390;Taip;0;0;1;1
6729;Papartis;SMALSUČIAI;4906248064;Taip;6;0;0;6
6730;Papartis;SMALSUČIAI;4640068595;Taip;6;0;0;6
6731;Papartis;SMALSUČIAI;5579899922;Taip;10;0;2;12
6732;Papartis;"ŽIRNIUKAI ";44833872631;Taip;0;0;1;1
6733;Papartis;"ŽIRNIUKAI ";1944730492;Taip;0;1;0;1
6734;Papartis;"ŽIRNIUKAI ";7845277151;Taip;7;3;0;10
6735;Papartis;"ŽIRNIUKAI ";30041894006;Taip;0;0;3;3
6736;Papartis;"ŽIRNIUKAI ";3630377970;Taip;11;1;0;12
6737;Papartis;"ŽIRNIUKAI ";38896771062;Taip;0;0;1;1
6738;Papartis;"ŽIRNIUKAI ";86735273559;Taip;0;1;0;1
6739;Papartis;"ŽIRNIUKAI ";29789530287;Taip;0;1;2;3
6740;Papartis;"ŽIRNIUKAI ";22570313128;Taip;10;0;0;10
6741;Papartis;"ŽIRNIUKAI ";51588027659;Taip;0;3;0;3
6742;Papartis;"ŽIRNIUKAI ";1703232380;Taip;0;2;0;2
6743;Papartis;"ŽIRNIUKAI ";64345875780;Ne;0;2;0;2
6744;Papartis;"ŽIRNIUKAI ";53040207725;Taip;6;2;0;8
6745;Papartis;"ŽIRNIUKAI ";7102350653;Taip;0;2;0;2
6746;Papartis;"ŽIRNIUKAI ";3408756311;Taip;0;0;1;1
6747;Papartis;BORUŽĖLĖS;7018190169;Taip;9;0;0;9
6748;Papartis;BORUŽĖLĖS;4918854899;Taip;6;8;0;14
6749;Papartis;BORUŽĖLĖS;6889782462;Ne;8;0;2;10
6750;Papartis;BORUŽĖLĖS;5252947502;Taip;0;5;0;5
6751;Papartis;BORUŽĖLĖS;4261270064;Taip;6;0;0;6
6752;Papartis;BORUŽĖLĖS;6136213985;Taip;17;0;0;17
6753;Papartis;BORUŽĖLĖS;7107692314;Taip;17;0;0;17
6754;Papartis;BORUŽĖLĖS;5736456872;Taip;0;3;2;5
6755;Papartis;BORUŽĖLĖS;3040269026;Taip;0;3;2;5
6756;Papartis;BORUŽĖLĖS;8891856856;Taip;0;7;0;7
6757;Papartis;BORUŽĖLĖS;8532558577;Taip;6;0;0;6
6758;Papartis;BORUŽĖLĖS;1916222143;Taip;6;8;0;14
6759;Papartis;BORUŽĖLĖS;3100013570;Taip;0;0;4;4
6760;Papartis;BORUŽĖLĖS;6416605464;Taip;10;0;0;10
6761;Papartis;BORUŽĖLĖS;7803854703;Taip;0;1;0;1
6762;Papartis;VARPELIAI;6585372451;Taip;5;0;6;11
6763;Papartis;VARPELIAI;6977513472;Taip;6;0;1;7
6764;Papartis;VARPELIAI;5070767260;Taip;15;0;0;15
6765;Papartis;VARPELIAI;3595627659;Taip;10;1;0;11
6766;Papartis;VARPELIAI;1231594320;Taip;0;0;1;1
6767;Papartis;VARPELIAI;4570512336;Taip;13;0;2;15
6768;Papartis;VARPELIAI;5538433120;Taip;7;0;1;8
6769;Papartis;VARPELIAI;7619963429;Taip;0;1;3;4
6770;Papartis;VARPELIAI;2669085057;Taip;0;11;4;15
6771;Papartis;VARPELIAI;3209491491;Taip;5;1;0;6
6772;Papartis;VARPELIAI;6931780900;Taip;5;1;0;6
6773;Papartis;VARPELIAI;3539507686;Taip;18;0;0;18
6774;Papartis;NYKŠTUKAI;5652769035;Taip;2;0;0;2
6775;Papartis;NYKŠTUKAI;5942160584;Taip;0;0;1;1
6776;Papartis;NYKŠTUKAI;9922091482;Ne;11;1;0;12
6777;Papartis;NYKŠTUKAI;1680412204;Taip;1;5;0;6
6778;Papartis;NYKŠTUKAI;6903057774;Ne;4;0;0;4
6779;Papartis;NYKŠTUKAI;9502229005;Taip;5;0;0;5
6780;Papartis;NYKŠTUKAI;6949120693;Taip;9;3;0;12
6781;Papartis;NYKŠTUKAI;6794076631;Taip;8;0;0;8
6782;Papartis;NYKŠTUKAI;5957889361;Taip;0;1;0;1
6783;Papartis;NYKŠTUKAI;5608868738;Ne;0;1;0;1
6784;Papartis;NYKŠTUKAI;4203241118;Taip;0;1;0;1
6785;Papartis;NYKŠTUKAI;4806652727;Taip;0;5;0;5
6786;Papartis;NYKŠTUKAI;9939850340;Taip;2;0;0;2
6787;Papartis;NYKŠTUKAI;3324647852;Taip;0;1;0;1
6788;Papartis;NYKŠTUKAI;5218101579;Ne;0;2;0;2
6789;Papartis;NYKŠTUKAI;8932290803;Taip;10;0;0;10
6790;Papartis;NYKŠTUKAI;5652560002;Taip;0;3;0;3
6791;Pasaka;Drugelių;60248064750;Taip;0;0;1;1
6792;Pasaka;Drugelių;18135410695;Taip;21;0;0;21
6793;Pasaka;Drugelių;1237568934;Taip;0;1;0;1
6794;Pasaka;Drugelių;37149227316;Taip;0;2;1;3
6795;Pasaka;Drugelių;57075224058;Taip;0;2;5;7
6796;Pasaka;Drugelių;2063660647;Taip;0;1;0;1
6797;Pasaka;Drugelių;44488699090;Taip;3;2;0;5
6798;Pasaka;Drugelių;5459272292;Taip;0;2;3;5
6799;Pasaka;Drugelių;93130495054;Taip;0;0;1;1
6800;Pasaka;Drugelių;27770796692;Taip;4;0;0;4
6801;Pasaka;Drugelių;53151161817;Taip;0;1;2;3
6802;Pasaka;Drugelių;55254934245;Taip;0;1;0;1
6803;Pasaka;Drugelių;91499940063;Taip;0;4;0;4
6804;Pasaka;Drugelių;40182594961;Taip;3;0;0;3
6805;Pasaka;Drugelių;2332865106;Taip;0;0;6;6
6806;Pasaka;Drugelių;6794437566;Taip;0;0;5;5
6807;Pasaka;Drugelių;5901704055;Ne;0;1;4;5
6808;Pasaka;Nykštukų;5665758011;Taip;0;4;2;6
6809;Pasaka;Nykštukų;8166051272;Taip;0;1;0;1
6810;Pasaka;Nykštukų;91546084785;Taip;0;3;3;6
6811;Pasaka;Nykštukų;7040953491;Taip;0;3;0;3
6812;Pasaka;Nykštukų;7546205285;Taip;0;1;0;1
6813;Pasaka;Nykštukų;1333499160;Taip;3;7;0;10
6814;Pasaka;Nykštukų;3088081091;Ne;0;1;0;1
6815;Pasaka;Nykštukų;3151916774;Taip;0;4;2;6
6816;Pasaka;Nykštukų;4773893970;Taip;11;2;0;13
6817;Pasaka;Nykštukų;1300996831;Ne;0;2;0;2
6818;Pasaka;Nykštukų;1313576071;Taip;0;0;1;1
6819;Pasaka;Nykštukų;7455544922;Ne;10;0;0;10
6820;Pasaka;Nykštukų;1630083619;Taip;6;2;3;11
6821;Pasaka;Nykštukų;7290184771;Taip;0;0;8;8
6822;Pasaka;Nykštukų;5027755073;Taip;0;2;0;2
6823;Pasaka;Nykštukų;2874308781;Taip;7;1;0;8
6824;Pasaka;Nykštukų;4082752808;Taip;10;0;2;12
6825;Pasaka;Montesori;47000824102;Taip;0;1;0;1
6826;Pasaka;Montesori;42973327518;Taip;0;1;0;1
6827;Pasaka;Montesori;1450566193;Taip;0;1;0;1
6828;Pasaka;Montesori;31880975983;Taip;0;7;0;7
6829;Pasaka;Montesori;79583667868;Taip;0;1;0;1
6830;Pasaka;Montesori;90472847444;Taip;0;1;0;1
6831;Pasaka;Montesori;17311912868;Taip;0;1;4;5
6832;Pasaka;Montesori;69250064506;Taip;0;1;1;2
6833;Pasaka;Montesori;1564467627;Taip;0;1;0;1
6834;Pasaka;Montesori;16974081144;Taip;11;1;0;12
6835;Pasaka;Montesori;1514381003;Taip;0;1;2;3
6836;Pasaka;Montesori;8996941733;Taip;4;0;0;4
6837;Pasaka;Montesori;4608655313;Ne;2;0;4;6
6838;Pasaka;Montesori;93994995081;Taip;5;1;0;6
6839;Pasaka;Montesori;5812041166;Taip;5;1;1;7
6840;Pasaka;Montesori;4305485747;Taip;0;0;1;1
6841;Pasaka;Montesori;79460661793;Taip;6;0;1;7
6842;Pasaka;Montesori;47140322803;Taip;0;0;4;4
6843;Pasaka;Montesori;3047931231;Ne;9;0;0;9
6844;Pasaka;Montesori;71026394541;Taip;18;0;0;18
6845;Pasaka;Žirniukų;9722435751;Taip;0;1;0;1
6846;Pasaka;Žirniukų;7648503006;Taip;0;0;12;12
6847;Pasaka;Žirniukų;2697014098;Taip;0;1;0;1
6848;Pasaka;Žirniukų;73703706115;Taip;0;1;4;5
6849;Pasaka;Žirniukų;2018620389;Taip;0;1;3;4
6850;Pasaka;Žirniukų;6441884677;Taip;0;2;0;2
6851;Pasaka;Žirniukų;5651452381;Taip;0;2;0;2
6852;Pasaka;Žirniukų;1720511696;Taip;0;2;1;3
6853;Pasaka;Žirniukų;1836826810;Ne;0;1;0;1
6854;Pasaka;Žirniukų;1826743229;Ne;0;1;0;1
6855;Pasaka;Žirniukų;9560190761;Ne;0;1;0;1
6856;Pasaka;Žirniukų;7286419663;Taip;0;0;1;1
6857;Pasaka;Žirniukų;2788679885;Taip;3;1;0;4
6858;Pasaka;Žirniukų;1565873178;Ne;0;0;2;2
6859;Pasaka;Žirniukų;7445696309;Taip;0;1;0;1
6860;Pasaka;Žirniukų;2400455036;Taip;0;2;0;2
6861;Pasaka;Žirniukų;79170702319;Taip;10;0;4;14
6862;Pasaka;Žirniukų;5965121999;Taip;0;0;2;2
6863;Pasaka;Žirniukų;5973028582;Taip;0;0;4;4
6864;Pasaka;"Voveriukų ";15051078156;Taip;0;2;0;2
6865;Pasaka;"Voveriukų ";50319234551;Taip;0;0;6;6
6866;Pasaka;"Voveriukų ";15500820772;Taip;5;0;0;5
6867;Pasaka;"Voveriukų ";12951124853;Taip;3;1;0;4
6868;Pasaka;"Voveriukų ";53523660848;Taip;2;1;0;3
6869;Pasaka;"Voveriukų ";89376142045;Taip;15;1;0;16
6870;Pasaka;"Voveriukų ";13944030346;Taip;0;1;0;1
6871;Pasaka;"Voveriukų ";52135673503;Taip;0;2;0;2
6872;Pasaka;"Voveriukų ";59491538033;Taip;0;1;0;1
6873;Pasaka;"Voveriukų ";20358771509;Taip;4;6;0;10
6874;Pasaka;"Voveriukų ";94514447596;Taip;0;2;0;2
6875;Pasaka;"Voveriukų ";35718732394;Taip;0;1;0;1
6876;Pasaka;"Voveriukų ";71316589358;Taip;0;3;0;3
6877;Pasaka;"Voveriukų ";61091610394;Taip;0;0;3;3
6878;Pasaka;"Voveriukų ";4344243194;Taip;0;1;0;1
6879;Pasaka;"Voveriukų ";8122815158;Ne;0;1;1;2
6880;Pasaka;"Voveriukų ";1719236931;Taip;0;1;2;3
6881;Pasaka;"Voveriukų ";1257775317;Taip;4;1;0;5
6882;Pasaka;"Voveriukų ";1268530885;Taip;0;1;5;6
6883;Pasaka;"VALDOFRO 12";7865658875;Taip;0;0;4;4
6884;Pasaka;"VALDOFRO 12";2141354232;Taip;0;1;0;1
6885;Pasaka;"VALDOFRO 12";4271029223;Taip;3;1;2;6
6886;Pasaka;"VALDOFRO 12";49627576872;Taip;5;5;0;10
6887;Pasaka;"VALDOFRO 12";75591036061;Taip;0;0;1;1
6888;Pasaka;"VALDOFRO 12";8042135600;Taip;0;3;3;6
6889;Pasaka;"VALDOFRO 12";20521208273;Taip;0;2;3;5
6890;Pasaka;"VALDOFRO 12";95288167171;Taip;3;6;0;9
6891;Pasaka;"VALDOFRO 12";3367120837;Ne;5;1;3;9
6892;Pasaka;"VALDOFRO 12";7010681103;Taip;0;9;1;10
6893;Pasaka;"VALDOFRO 12";1155273197;Taip;0;12;1;13
6894;Pasaka;"VALDOFRO 12";56766427323;Ne;5;0;1;6
6895;Pasaka;"VALDOFRO 12";4680456848;Taip;0;0;1;1
6896;Pasaka;"VALDOFRO 12";5141156728;Taip;14;0;0;14
6897;Pasaka;"VALDOFRO 12";2268625523;Taip;6;0;1;7
6898;Pasaka;"VALDOFRO 12";3195380938;Taip;0;0;1;1
6899;Pasaka;"VALDOFRO 12";8976424908;Taip;5;0;1;6
6900;Pasaka;"VALDORFO 2";48295303497;Taip;0;2;0;2
6901;Pasaka;"VALDORFO 2";27035873367;Taip;0;5;0;5
6902;Pasaka;"VALDORFO 2";95494862542;Taip;10;2;1;13
6903;Pasaka;"VALDORFO 2";25283698668;Taip;0;1;0;1
6904;Pasaka;"VALDORFO 2";61077353229;Taip;0;1;0;1
6905;Pasaka;"VALDORFO 2";2077818693;Taip;1;1;0;2
6906;Pasaka;"VALDORFO 2";71365777764;Taip;5;1;0;6
6907;Pasaka;"VALDORFO 2";1741935840;Taip;5;0;1;6
6908;Pasaka;"VALDORFO 2";77904202630;Taip;3;1;0;4
6909;Pasaka;"VALDORFO 2";4752117533;Taip;0;3;0;3
6910;Pasaka;"VALDORFO 2";7432241898;Taip;0;2;1;3
6911;Pasaka;"VALDORFO 2";10616073718;Ne;0;1;0;1
6912;Pasaka;"VALDORFO 2";7950962252;Taip;5;2;0;7
6913;Pasaka;"VALDORFO 2";1480107348;Taip;5;2;0;7
6914;Pasaka;"VALDORFO 2";8590385693;Taip;0;5;2;7
6915;Pasaka;"VALDORFO 2";4620573687;Taip;0;5;0;5
6916;Pasaka;"VALDORFO 2";9462745431;Taip;3;5;0;8
6917;Pasaka;"VALDORFO 2";5399148997;Taip;0;3;0;3
6918;Pasaka;Gudručiai;4895994309;Taip;0;0;3;3
6919;Pasaka;Gudručiai;62051806386;Taip;0;2;0;2
6920;Pasaka;Gudručiai;14080980324;Taip;0;1;0;1
6921;Pasaka;Gudručiai;72878659455;Taip;0;2;0;2
6922;Pasaka;Gudručiai;80567536745;Ne;0;1;1;2
6923;Pasaka;Gudručiai;78517147252;Taip;3;1;0;4
6924;Pasaka;Gudručiai;76899232405;Taip;0;1;0;1
6925;Pasaka;Gudručiai;45850914548;Ne;0;12;0;12
6926;Pasaka;Gudručiai;97012371435;Ne;0;12;0;12
6927;Pasaka;Gudručiai;52667398476;Taip;0;1;0;1
6928;Pasaka;Gudručiai;17537343699;Taip;8;0;0;8
6929;Pasaka;Gudručiai;45184972933;Taip;0;1;0;1
6930;Pasaka;Gudručiai;29836649248;Taip;11;0;0;11
6931;Pasaka;Gudručiai;1979028353;Taip;0;0;3;3
6932;Pasaka;Gudručiai;1920564803;Ne;4;0;3;7
6933;Pasaka;Bitelių;8651165520;Taip;17;0;0;17
6934;Pasaka;Bitelių;8132829016;Taip;17;0;0;17
6935;Pasaka;Bitelių;5351364328;Taip;18;0;0;18
6936;Pasaka;Bitelių;4635912654;Taip;18;0;0;18
6937;Pasaka;Bitelių;4137222204;Taip;2;0;3;5
6938;Pasaka;Bitelių;7248640367;Taip;13;0;0;13
6939;Pasaka;Bitelių;8277245475;Taip;0;2;2;4
6940;Pasaka;Bitelių;7103485358;Taip;3;0;0;3
6941;Pasaka;Bitelių;6868519179;Taip;1;0;8;9
6942;Pasaka;Bitelių;6759415053;Taip;0;0;8;8
6943;Pasaka;Bitelių;5723970763;Taip;6;1;4;11
6944;Pasaka;Bitelių;9136521759;Taip;1;0;1;2
6945;Pasaka;Bitelių;9737445077;Taip;7;0;0;7
6946;Pasaka;Bitelių;2638182985;Taip;0;0;6;6
6947;Pasaka;Bitelių;2293613528;Taip;0;17;0;17
6948;Pasaka;Bitelių;3367346582;Taip;11;0;1;12
6949;Pasaka;Bitelių;3351338617;Taip;0;0;2;2
6950;Pasaka;Bitelių;5371046207;Taip;0;4;0;4
6951;Pasaka;Bitelių;1335408890;Ne;0;1;0;1
6952;Pasaka;"Pabiručių ";2854919649;Taip;0;0;2;2
6953;Pasaka;"Pabiručių ";7176272684;Taip;5;8;0;13
6954;Pasaka;"Pabiručių ";4466963221;Taip;0;0;1;1
6955;Pasaka;"Pabiručių ";9588247759;Ne;2;0;0;2
6956;Pasaka;"Pabiručių ";1950145441;Taip;0;0;2;2
6957;Pasaka;"Pabiručių ";3709664132;Taip;19;0;0;19
6958;Pasaka;"Pabiručių ";1512874567;Taip;6;1;0;7
6959;Pasaka;"Pabiručių ";3606141216;Taip;10;4;0;14
6960;Pasaka;"Pabiručių ";5217688848;Taip;10;4;0;14
6961;Pasaka;"Pabiručių ";3536862796;Taip;10;0;0;10
6962;Pasaka;"Pabiručių ";8899289832;Taip;10;0;0;10
6963;Pasaka;"Pabiručių ";4171004263;Taip;15;0;0;15
6964;Pasaka;"Pabiručių ";4915357646;Taip;0;0;3;3
6965;Pasaka;"Pabiručių ";1488711275;Taip;10;0;0;10
6966;Pasaka;Šnekučių;31896116591;Taip;4;0;2;6
6967;Pasaka;Šnekučių;36716138833;Taip;0;0;5;5
6968;Pasaka;Šnekučių;49626651411;Taip;10;0;1;11
6969;Pasaka;Šnekučių;9549799936;Taip;0;1;0;1
6970;Pasaka;Šnekučių;34897359060;Taip;0;0;7;7
6971;Pasaka;Šnekučių;52912333520;Ne;0;0;4;4
6972;Pasaka;Šnekučių;49520139946;Taip;11;0;3;14
6973;Pasaka;Šnekučių;9973758979;Taip;0;0;1;1
6974;Pasaka;Šnekučių;1693530160;Taip;0;0;4;4
6975;Pasaka;Šnekučių;62303770229;Taip;0;0;1;1
6976;Pasaka;Šnekučių;23132755276;Taip;0;1;4;5
6977;Pasaka;Šnekučių;7082166681;Taip;3;0;0;3
6978;Pasaka;Šnekučių;8615661704;Ne;0;2;0;2
6979;Pasaka;Šnekučių;4178679491;Ne;0;2;0;2
6980;Pasaka;Šnekučių;56983167265;Taip;0;0;4;4
6981;Pasaka;Šnekučių;5021568651;Taip;0;0;3;3
6982;Pasaka;Šnekučių;10055061537;Ne;0;5;6;11
6983;Paslaptis;Priešmokyklinė;1259942408;Taip;0;1;3;4
6984;Paslaptis;Priešmokyklinė;36229769543;Taip;4;1;0;5
6985;Paslaptis;Priešmokyklinė;87862241593;Taip;21;0;0;21
6986;Paslaptis;Priešmokyklinė;1982955007;Ne;0;1;1;2
6987;Paslaptis;Priešmokyklinė;1273662366;Taip;0;6;0;6
6988;Paslaptis;Priešmokyklinė;99228588629;Ne;4;1;0;5
6989;Paslaptis;Priešmokyklinė;57773958059;Taip;0;10;0;10
6990;Paslaptis;Priešmokyklinė;73547132372;Ne;0;3;0;3
6991;Paslaptis;Priešmokyklinė;1950287365;Taip;0;1;6;7
6992;Paslaptis;Priešmokyklinė;1094068061;Taip;0;3;0;3
6993;Paslaptis;Priešmokyklinė;1195616749;Taip;0;2;0;2
6994;Paslaptis;Priešmokyklinė;8522925854;Taip;0;1;7;8
6995;Paslaptis;Priešmokyklinė;1445974659;Taip;0;1;0;1
6996;Paslaptis;Priešmokyklinė;2578713065;Ne;0;7;2;9
6997;Paslaptis;Priešmokyklinė;1868248793;Taip;0;9;0;9
6998;Paslaptis;Priešmokyklinė;1938288335;Taip;0;1;0;1
6999;Paslaptis;Priešmokyklinė;1530380043;Taip;0;1;0;1
7000;Paslaptis;Priešmokyklinė;1127602652;Taip;0;4;0;4
7001;Paslaptis;Priešmokyklinė;4674623065;Taip;0;2;0;2
7002;Paslaptis;Priešmokyklinė;40283689721;Taip;0;6;0;6
7003;Paslaptis;Priešmokyklinė;4731417201;Taip;5;1;0;6
7004;Paslaptis;Priešmokyklinė;3461773781;Taip;0;1;0;1
7005;Paslaptis;"Darželio mišraus amžiaus grupė";6375966771;Taip;0;2;0;2
7006;Paslaptis;"Darželio mišraus amžiaus grupė";3170216428;Ne;0;1;0;1
7007;Paslaptis;"Darželio mišraus amžiaus grupė";3093280943;Taip;4;0;0;4
7008;Paslaptis;"Darželio mišraus amžiaus grupė";9559318660;Taip;6;0;0;6
7009;Paslaptis;"Darželio mišraus amžiaus grupė";2705751628;Taip;0;0;2;2
7010;Paslaptis;"Darželio mišraus amžiaus grupė";8280740387;Taip;0;0;2;2
7011;Paslaptis;"Darželio mišraus amžiaus grupė";2891547963;Taip;0;3;0;3
7012;Paslaptis;"Darželio mišraus amžiaus grupė";3415869190;Taip;0;3;0;3
7013;Paslaptis;"Darželio mišraus amžiaus grupė";1983773762;Taip;0;1;0;1
7014;Paslaptis;"Darželio mišraus amžiaus grupė";5557019619;Taip;0;1;0;1
7015;Paslaptis;"Darželio mišraus amžiaus grupė";1782398974;Taip;6;0;0;6
7016;Paslaptis;"Darželio mišraus amžiaus grupė";4109288950;Taip;0;0;1;1
7017;Paslaptis;"Darželio mišraus amžiaus grupė";8083478190;Taip;16;0;0;16
7018;Paslaptis;"Darželio mišraus amžiaus grupė";2089780119;Taip;6;8;0;14
7019;Paslaptis;"Darželio mišraus amžiaus grupė";1029321312;Taip;0;1;0;1
7020;Paslaptis;"Darželio mišraus amžiaus grupė";6131831325;Taip;12;0;0;12
7021;Paslaptis;"Darželio mišraus amžiaus grupė";2879752620;Taip;0;11;0;11
7022;Paslaptis;"Darželio mišraus amžiaus grupė";3243226933;Taip;9;0;1;10
7023;Paslaptis;"Darželio mišraus amžiaus grupė";5852939221;Taip;6;2;0;8
7024;Paslaptis;"Darželio mišraus amžiaus grupė";2693910134;Taip;0;1;0;1
7025;Paslaptis;"Darželio mišraus amžiaus grupė";3104525540;Taip;10;0;0;10
7026;Paslaptis;"Darželio mišraus amžiaus grupė";8895770223;Ne;16;0;0;16
7027;Paslaptis;"Darželio mišraus amžiaus grupė";5206529350;Taip;0;10;0;10
7028;Paslaptis;"Darželio mišraus amžiaus grupė";1033910097;Taip;0;1;0;1
7029;Paslaptis;"NAUJA (LOPŠELIS)";3984799090;Taip;6;0;0;6
7030;Paslaptis;"NAUJA (LOPŠELIS)";5406800599;Taip;9;0;2;11
7031;Paslaptis;"NAUJA (LOPŠELIS)";3624299098;Taip;4;0;0;4
7032;Paslaptis;"NAUJA (LOPŠELIS)";4810686225;Taip;9;0;0;9
7033;Paslaptis;"NAUJA (LOPŠELIS)";1754621741;Taip;2;0;0;2
7034;Paslaptis;"NAUJA (LOPŠELIS)";6098345982;Taip;7;0;0;7
7035;Paslaptis;"NAUJA (LOPŠELIS)";6686352764;Taip;14;1;0;15
7036;Paslaptis;"NAUJA (LOPŠELIS)";1557783684;Taip;6;0;0;6
7037;Paslaptis;"NAUJA (LOPŠELIS)";5646806136;Taip;8;1;1;10
7038;Paslaptis;"NAUJA (LOPŠELIS)";9540612585;Taip;2;0;0;2
7039;Paslaptis;"NAUJA (LOPŠELIS)";7638521198;Taip;8;3;0;11
7040;Paslaptis;"NAUJA (LOPŠELIS)";9100003209;Ne;16;0;0;16
7041;Paslaptis;"NAUJA (LOPŠELIS)";5456011928;Taip;0;2;0;2
7042;Paslaptis;"NAUJA (LOPŠELIS)";5756338103;Taip;6;0;0;6
7043;Paslaptis;"NAUJA (LOPŠELIS)";5886364670;Taip;0;0;1;1
7044;Paslaptis;"NAUJA (LOPŠELIS)";3844066232;Taip;4;5;0;9
7045;Paslaptis;"NAUJA (LOPŠELIS)";2675089401;Taip;9;0;0;9
7046;Paslaptis;"NAUJA (LOPŠELIS)";4130010071;Taip;7;1;0;8
7047;Pasakaitė;Vieversėlių;7685647972;Taip;5;10;0;15
7048;Pasakaitė;Vieversėlių;6459145539;Taip;3;0;0;3
7049;Pasakaitė;Vieversėlių;2194313054;Taip;3;1;0;4
7050;Pasakaitė;Vieversėlių;9587489514;Taip;0;0;4;4
7051;Pasakaitė;Vieversėlių;3444442287;Taip;7;0;0;7
7052;Pasakaitė;Vieversėlių;2563725297;Taip;4;0;0;4
7053;Pasakaitė;Vieversėlių;2849753418;Taip;3;0;0;3
7054;Pasakaitė;Vieversėlių;8043493934;Taip;4;0;0;4
7055;Pasakaitė;Vieversėlių;7963057831;Taip;7;0;0;7
7056;Pasakaitė;Vieversėlių;9543991684;Taip;14;1;0;15
7057;Pasakaitė;Vieversėlių;7020773169;Taip;21;0;0;21
7058;Pasakaitė;Vieversėlių;3680596008;Taip;0;0;1;1
7059;Pasakaitė;Vieversėlių;4882856664;Taip;10;0;0;10
7060;Pasakaitė;Vieversėlių;5948958906;Taip;2;1;6;9
7061;Pasakaitė;Vieversėlių;1060914693;Taip;4;0;1;5
7062;Pasakaitė;Vieversėlių;7761162338;Taip;13;0;0;13
7063;Pasakaitė;Vieversėlių;8463220257;Taip;4;0;0;4
7064;Pasakaitė;Vieversėlių;9018830962;Taip;14;0;1;15
7065;Pasakaitė;Spindulėlių;8638071584;Ne;0;1;0;1
7066;Pasakaitė;Spindulėlių;75361056418;Taip;8;3;0;11
7067;Pasakaitė;Spindulėlių;99890448836;Taip;0;1;0;1
7068;Pasakaitė;Spindulėlių;4680949976;Taip;6;3;0;9
7069;Pasakaitė;Spindulėlių;3734935229;Ne;5;2;0;7
7070;Pasakaitė;Spindulėlių;2523842161;Taip;6;0;0;6
7071;Pasakaitė;Spindulėlių;4267488049;Taip;0;1;2;3
7072;Pasakaitė;Spindulėlių;1523034176;Taip;0;1;0;1
7073;Pasakaitė;Spindulėlių;7152349570;Taip;0;15;0;15
7074;Pasakaitė;Spindulėlių;1220619991;Taip;2;0;0;2
7075;Pasakaitė;Spindulėlių;3606601644;Taip;7;1;0;8
7076;Pasakaitė;Spindulėlių;3579498202;Taip;5;0;0;5
7077;Pasakaitė;Spindulėlių;3231283338;Taip;0;1;0;1
7078;Pasakaitė;Spindulėlių;7790937149;Taip;0;1;0;1
7079;Pasakaitė;Spindulėlių;5313360864;Ne;5;0;1;6
7080;Pasakaitė;Spindulėlių;3400305768;Taip;0;1;0;1
7081;Pasakaitė;Spindulėlių;6568538767;Taip;11;0;0;11
7082;Pasakaitė;Pasagėlių;3165658822;Taip;0;18;0;18
7083;Pasakaitė;Pasagėlių;61230317080;Ne;0;8;0;8
7084;Pasakaitė;Pasagėlių;1740419218;Taip;0;1;0;1
7085;Pasakaitė;Pasagėlių;5378855541;Taip;0;1;0;1
7086;Pasakaitė;Pasagėlių;9680682204;Taip;0;0;1;1
7087;Pasakaitė;Pasagėlių;8466086339;Taip;0;0;1;1
7088;Pasakaitė;Pasagėlių;1019010454;Taip;0;2;0;2
7089;Pasakaitė;Pasagėlių;4959175420;Taip;0;7;0;7
7090;Pasakaitė;Pasagėlių;3259688782;Taip;0;0;1;1
7091;Pasakaitė;Pasagėlių;1144813356;Taip;0;0;2;2
7092;Pasakaitė;Pasagėlių;83018133588;Taip;0;0;1;1
7093;Pasakaitė;Pasagėlių;4013900094;Taip;16;0;0;16
7094;Pasakaitė;Pasagėlių;5605619860;Ne;0;0;1;1
7095;Pasakaitė;Pasagėlių;1791015854;Taip;0;0;1;1
7096;Pasakaitė;Pasagėlių;39853246609;Taip;0;0;1;1
7097;Pasakaitė;Pasagėlių;4591161640;Ne;0;0;1;1
7098;Pasakaitė;Pasagėlių;1707428977;Taip;10;1;0;11
7099;Pasakaitė;Pasagėlių;5467179333;Taip;0;9;0;9
7100;Pasakaitė;Švyturėlių;24096031951;Taip;0;1;0;1
7101;Pasakaitė;Švyturėlių;11001677712;Taip;11;0;1;12
7102;Pasakaitė;Švyturėlių;9914689534;Taip;10;6;0;16
7103;Pasakaitė;Švyturėlių;75785125455;Taip;1;0;1;2
7104;Pasakaitė;Švyturėlių;88077831193;Taip;6;0;1;7
7105;Pasakaitė;Švyturėlių;8225188274;Taip;0;9;0;9
7106;Pasakaitė;Švyturėlių;73957497029;Taip;0;0;4;4
7107;Pasakaitė;Švyturėlių;1070409611;Taip;0;3;3;6
7108;Pasakaitė;Švyturėlių;2331486690;Taip;20;0;1;21
7109;Pasakaitė;Švyturėlių;8469043564;Taip;4;0;2;6
7110;Pasakaitė;Švyturėlių;5436985035;Ne;0;11;0;11
7111;Pasakaitė;Švyturėlių;4008826950;Taip;1;11;0;12
7112;Pasakaitė;Švyturėlių;2721048424;Taip;0;13;0;13
7113;Pasakaitė;Švyturėlių;1513903341;Taip;3;0;0;3
7114;Pasakaitė;Švyturėlių;8578521969;Taip;11;0;1;12
7115;Pasakaitė;Švyturėlių;8390366303;Ne;10;1;0;11
7116;Pasakaitė;Švyturėlių;3778906698;Taip;0;0;4;4
7117;Pasakaitė;Švyturėlių;1278198989;Taip;21;0;0;21
7118;Pasakaitė;Švyturėlių;22071058323;Taip;12;9;0;21
7119;Pasakaitė;Švyturėlių;1940545723;Ne;0;3;0;3
7120;Pasakaitė;Kodėlčiukų;82138492327;Taip;0;1;0;1
7121;Pasakaitė;Kodėlčiukų;94317654094;Taip;0;2;2;4
7122;Pasakaitė;Kodėlčiukų;2017823264;Taip;4;0;0;4
7123;Pasakaitė;Kodėlčiukų;72093762601;Taip;0;1;1;2
7124;Pasakaitė;Kodėlčiukų;11006810461;Taip;2;1;0;3
7125;Pasakaitė;Kodėlčiukų;1553678838;Taip;9;1;1;11
7126;Pasakaitė;Kodėlčiukų;92762645558;Taip;0;1;0;1
7127;Pasakaitė;Kodėlčiukų;1854100959;Taip;0;1;0;1
7128;Pasakaitė;Kodėlčiukų;93907096625;Taip;11;0;0;11
7129;Pasakaitė;Kodėlčiukų;4974486850;Ne;12;0;3;15
7130;Pasakaitė;Kodėlčiukų;9746401498;Ne;10;0;3;13
7131;Pasakaitė;Kodėlčiukų;6839399035;Ne;4;0;2;6
7132;Pasakaitė;Kodėlčiukų;99352468512;Taip;10;1;0;11
7133;Pasakaitė;Kodėlčiukų;1809383469;Taip;14;0;2;16
7134;Pasakaitė;Kodėlčiukų;2742595829;Taip;0;0;5;5
7135;Pasakaitė;Kodėlčiukų;6983619733;Taip;12;0;1;13
7136;Pasakaitė;Kodėlčiukų;9506178305;Taip;9;0;4;13
7137;Pasakaitė;Gudručių;70802215290;Taip;0;13;0;13
7138;Pasakaitė;Gudručių;48421643700;Taip;10;3;0;13
7139;Pasakaitė;Gudručių;6909280007;Taip;7;0;0;7
7140;Pasakaitė;Gudručių;82272856075;Taip;0;2;0;2
7141;Pasakaitė;Gudručių;1537944476;Taip;0;3;0;3
7142;Pasakaitė;Gudručių;1631919806;Taip;13;4;0;17
7143;Pasakaitė;Gudručių;1696228992;Taip;13;4;0;17
7144;Pasakaitė;Gudručių;41359431347;Taip;0;4;0;4
7145;Pasakaitė;Gudručių;18419655194;Taip;0;1;0;1
7146;Pasakaitė;Gudručių;1917342472;Ne;4;1;0;5
7147;Pasakaitė;Gudručių;91751201397;Taip;15;0;0;15
7148;Pasakaitė;Gudručių;23103636206;Taip;5;7;0;12
7149;Pasakaitė;Gudručių;94906317709;Taip;0;1;0;1
7150;Pasakaitė;Gudručių;47661428412;Taip;0;7;0;7
7151;Pasakaitė;Gudručių;35147041377;Taip;0;4;3;7
7152;Pasakaitė;Gudručių;725988513;Taip;0;3;0;3
7153;Pasakaitė;Gudručių;91109909258;Taip;0;1;0;1
7154;Pasakaitė;Gudručių;39926553926;Taip;0;4;3;7
7155;Pasakaitė;Gudručių;1139554564;Taip;10;6;0;16
7156;Pasakaitė;Gudručių;1627102470;Taip;0;3;0;3
7157;Pasakaitė;Čiulbonėlių;24235494284;Taip;0;1;0;1
7158;Pasakaitė;Čiulbonėlių;39762990812;Taip;0;2;1;3
7159;Pasakaitė;Čiulbonėlių;30460033968;Taip;0;7;0;7
7160;Pasakaitė;Čiulbonėlių;32235101944;Taip;4;0;2;6
7161;Pasakaitė;Čiulbonėlių;1159523006;Taip;0;4;1;5
7162;Pasakaitė;Čiulbonėlių;83737263199;Taip;0;4;0;4
7163;Pasakaitė;Čiulbonėlių;26826144324;Taip;0;6;0;6
7164;Pasakaitė;Čiulbonėlių;74338375162;Taip;0;6;1;7
7165;Pasakaitė;Čiulbonėlių;26485770641;Taip;0;8;0;8
7166;Pasakaitė;Čiulbonėlių;72232008007;Taip;7;3;0;10
7167;Pasakaitė;Čiulbonėlių;21872672491;Taip;0;2;1;3
7168;Pasakaitė;Čiulbonėlių;21284070194;Taip;0;6;0;6
7169;Pasakaitė;Čiulbonėlių;13787417933;Ne;8;0;1;9
7170;Pasakaitė;Čiulbonėlių;45451715428;Taip;0;1;0;1
7171;Pasakaitė;Čiulbonėlių;20667371334;Taip;0;4;8;12
7172;Pasakaitė;Čiulbonėlių;52127092749;Taip;0;6;4;10
7173;Pasakaitė;Čiulbonėlių;15644259897;Taip;0;3;0;3
7174;Pasakaitė;Čiulbonėlių;88951595986;Ne;0;6;0;6
7175;Pasakaitė;Čiulbonėlių;1381307997;Taip;3;13;0;16
7176;Pasakaitė;"Verpstelių ";12092268542;Taip;0;7;0;7
7177;Pasakaitė;"Verpstelių ";62677241195;Taip;0;1;0;1
7178;Pasakaitė;"Verpstelių ";600641021;Taip;0;7;0;7
7179;Pasakaitė;"Verpstelių ";26031226748;Taip;0;1;0;1
7180;Pasakaitė;"Verpstelių ";1407277414;Taip;0;0;1;1
7181;Pasakaitė;"Verpstelių ";17218793370;Taip;6;2;0;8
7182;Pasakaitė;"Verpstelių ";33418184802;Ne;10;0;1;11
7183;Pasakaitė;"Verpstelių ";46873849992;Taip;0;4;0;4
7184;Pasakaitė;"Verpstelių ";96648719544;Taip;0;12;0;12
7185;Pasakaitė;"Verpstelių ";82475369612;Taip;13;1;0;14
7186;Pasakaitė;"Verpstelių ";51040024089;Taip;0;0;1;1
7187;Pasakaitė;"Verpstelių ";88885227604;Taip;0;8;0;8
7188;Pasakaitė;"Verpstelių ";5954676615;Taip;0;1;0;1
7189;Pasakaitė;"Verpstelių ";2210519019;Taip;5;5;0;10
7190;Pasakaitė;"Verpstelių ";18105216772;Taip;0;4;0;4
7191;Pasakaitė;"Verpstelių ";50537059387;Taip;0;0;1;1
7192;Pasakaitė;"Verpstelių ";29699532850;Taip;0;12;0;12
7193;Pasakaitė;"Verpstelių ";46074425530;Taip;3;0;0;3
7194;Pasakaitė;"Verpstelių ";45157801238;Taip;0;1;0;1
7195;Pasakaitė;Smalsučiai;7451624229;Taip;6;0;1;7
7196;Pasakaitė;Smalsučiai;5556362727;Taip;0;0;7;7
7197;Pasakaitė;Smalsučiai;7759051761;Taip;12;0;0;12
7198;Pasakaitė;Smalsučiai;2404448954;Taip;0;0;1;1
7199;Pasakaitė;Smalsučiai;4728731352;Taip;12;0;1;13
7200;Pasakaitė;Smalsučiai;3710143250;Taip;0;0;7;7
7201;Pasakaitė;Smalsučiai;7621306769;Taip;0;0;2;2
7202;Pasakaitė;Smalsučiai;1744216870;Taip;0;15;0;15
7203;Pasakaitė;Smalsučiai;1533259056;Ne;0;1;3;4
7204;Pasakaitė;Smalsučiai;1425166722;Taip;9;0;5;14
7205;Pasakaitė;Smalsučiai;8315840473;Taip;0;0;6;6
7206;Pasakaitė;Smalsučiai;9821617981;Taip;8;0;1;9
7207;Pasakaitė;"Čiauškučiai ";6714500298;Taip;0;0;5;5
7208;Pasakaitė;"Čiauškučiai ";1962693480;Taip;0;0;1;1
7209;Pasakaitė;"Čiauškučiai ";1963102227;Taip;7;0;0;7
7210;Pasakaitė;"Čiauškučiai ";4758073190;Taip;9;0;0;9
7211;Pasakaitė;"Čiauškučiai ";7813221735;Taip;0;0;7;7
7212;Pasakaitė;"Čiauškučiai ";4864779439;Taip;0;1;5;6
7213;Pasakaitė;"Čiauškučiai ";1619513932;Taip;0;4;0;4
7214;Pasakaitė;"Čiauškučiai ";4246461594;Taip;11;0;0;11
7215;Pasakaitė;"Čiauškučiai ";8267725352;Taip;7;0;0;7
7216;Pasakaitė;"Čiauškučiai ";9166649594;Taip;5;0;0;5
7217;Pasakaitė;"Čiauškučiai ";2751828639;Taip;0;1;0;1
7218;Pasakaitė;"Čiauškučiai ";8223662339;Taip;16;0;0;16
7219;Pasakaitė;"Čiauškučiai ";6858356868;Taip;11;0;1;12
7220;Pasakaitė;Pabiručiai;1827070201;Taip;0;0;1;1
7221;Pasakaitė;Pabiručiai;9175612991;Taip;10;0;0;10
7222;Pasakaitė;Pabiručiai;26714845001;Taip;4;0;0;4
7223;Pasakaitė;Pabiručiai;46891856500;Taip;13;2;0;15
7224;Pasakaitė;Pabiručiai;3397132786;Ne;6;1;0;7
7225;Pasakaitė;Pabiručiai;1769070351;Taip;4;1;0;5
7226;Pasakaitė;Pabiručiai;49117693773;Taip;2;2;0;4
7227;Pasakaitė;Pabiručiai;1320898756;Taip;10;5;0;15
7228;Pasakaitė;Pabiručiai;1027136050;Taip;10;0;1;11
7229;Pasakaitė;Pabiručiai;1198248619;Taip;0;11;0;11
7230;Pasakaitė;Pabiručiai;1595057434;Taip;10;0;1;11
7231;Pasakaitė;Pabiručiai;1032113089;Taip;0;5;0;5
7232;Pasakaitė;Pabiručiai;21252086256;Taip;0;0;1;1
7233;Pasakaitė;Pabiručiai;6134483994;Taip;0;13;0;13
7234;Pasakaitė;Pabiručiai;1673576868;Taip;0;14;0;14
7235;Pasakaitė;Pabiručiai;2017275984;Taip;0;0;1;1
7236;Pasakaitė;Pabiručiai;27702516199;Taip;0;0;1;1
7237;Pasakaitė;Pabiručiai;6346678827;Ne;0;0;11;11
7238;Pelenė;Varpelis;25108428891;Taip;3;0;1;4
7239;Pelenė;Varpelis;59795549508;Taip;0;20;0;20
7240;Pelenė;Varpelis;83359560510;Taip;0;3;0;3
7241;Pelenė;Varpelis;75264382003;Taip;0;1;0;1
7242;Pelenė;Varpelis;3245982902;Taip;0;0;1;1
7243;Pelenė;Varpelis;534670514;Taip;0;1;1;2
7244;Pelenė;Varpelis;32716320977;Taip;0;8;0;8
7245;Pelenė;Varpelis;1733433768;Taip;5;1;1;7
7246;Pelenė;Varpelis;40968963343;Taip;0;1;0;1
7247;Pelenė;Varpelis;29587640966;Taip;0;6;0;6
7248;Pelenė;Varpelis;55350714718;Taip;0;1;4;5
7249;Pelenė;Varpelis;120966603;Taip;4;2;0;6
7250;Pelenė;Varpelis;30625065081;Taip;0;4;2;6
7251;Pelenė;Varpelis;33408520827;Taip;0;10;0;10
7252;Pelenė;Varpelis;62615483649;Taip;0;1;1;2
7253;Pelenė;Varpelis;35657264407;Ne;6;0;1;7
7254;Pelenė;Varpelis;12400151337;Taip;12;0;0;12
7255;Pelenė;Saulutės;99849461351;Taip;0;3;0;3
7256;Pelenė;Saulutės;93982153559;Taip;0;1;0;1
7257;Pelenė;Saulutės;93692312117;Taip;0;0;1;1
7258;Pelenė;Saulutės;12170216844;Taip;0;2;0;2
7259;Pelenė;Saulutės;1321060587;Taip;0;0;5;5
7260;Pelenė;Saulutės;11671895181;Taip;0;10;2;12
7261;Pelenė;Saulutės;89623266364;Taip;0;0;1;1
7262;Pelenė;Saulutės;55937499558;Taip;0;10;1;11
7263;Pelenė;Saulutės;1289416312;Taip;0;1;0;1
7264;Pelenė;Saulutės;29900302904;Taip;2;0;0;2
7265;Pelenė;Saulutės;96840961754;Taip;7;0;0;7
7266;Pelenė;Saulutės;52690820;Taip;0;0;1;1
7267;Pelenė;Saulutės;78648474464;Ne;0;0;1;1
7268;Pelenė;Saulutės;4178071578;Taip;0;2;0;2
7269;Pelenė;Saulutės;8813044848;Taip;0;0;4;4
7270;Pelenė;Saulutės;1807037374;Taip;0;0;6;6
7271;Pelenė;Saulutės;6559830470;Taip;8;0;0;8
7272;Pelenė;Saulutės;6937587856;Taip;0;1;0;1
7273;Pelenė;Raktelis;9019827941;Taip;0;0;1;1
7274;Pelenė;Raktelis;3465518545;Taip;0;0;4;4
7275;Pelenė;Raktelis;4386060612;Ne;5;0;1;6
7276;Pelenė;Raktelis;1568123491;Taip;0;5;0;5
7277;Pelenė;Raktelis;14200374671;Taip;5;0;0;5
7278;Pelenė;Raktelis;1418000665;Taip;1;0;9;10
7279;Pelenė;Raktelis;3299454566;Taip;0;0;1;1
7280;Pelenė;Raktelis;1038583766;Taip;0;0;1;1
7281;Pelenė;Raktelis;1127657620;Taip;0;5;0;5
7282;Pelenė;Raktelis;42431378466;Taip;0;0;1;1
7283;Pelenė;Raktelis;17572291941;Taip;0;1;0;1
7284;Pelenė;Raktelis;2072863178;Taip;0;1;0;1
7285;Pelenė;Raktelis;1050272821;Taip;0;6;0;6
7286;Pelenė;Raktelis;51979406888;Taip;0;8;0;8
7287;Pelenė;Raktelis;89920419797;Taip;5;1;0;6
7288;Pelenė;Raktelis;45589326259;Ne;0;0;1;1
7289;Pelenė;Raktelis;26010775076;Taip;0;7;0;7
7290;Pelenė;Raktelis;1483843416;Taip;0;14;0;14
7291;Pelenė;Raktelis;6289619123;Taip;6;0;0;6
7292;Pelenė;Žvaigždutės;8404317146;Taip;0;0;1;1
7293;Pelenė;Žvaigždutės;8466974910;Taip;0;1;1;2
7294;Pelenė;Žvaigždutės;1336431888;Taip;0;1;0;1
7295;Pelenė;Žvaigždutės;1114786936;Taip;1;0;1;2
7296;Pelenė;Žvaigždutės;1140030742;Taip;0;1;0;1
7297;Pelenė;Žvaigždutės;3497915398;Taip;0;4;0;4
7298;Pelenė;Žvaigždutės;2154553741;Taip;0;4;0;4
7299;Pelenė;Žvaigždutės;8598498275;Taip;0;10;0;10
7300;Pelenė;Žvaigždutės;69721118552;Taip;11;0;0;11
7301;Pelenė;Žvaigždutės;39705461573;Ne;15;0;1;16
7302;Pelenė;Žvaigždutės;3131930907;Taip;1;0;1;2
7303;Pelenė;Žvaigždutės;5804848640;Taip;4;0;1;5
7304;Pelenė;Žvaigždutės;1710249888;Taip;5;0;0;5
7305;Pelenė;Žvaigždutės;33009702783;Taip;1;0;1;2
7306;Pelenė;Žvaigždutės;61012202440;Taip;0;6;0;6
7307;Pelenė;Žvaigždutės;34765342495;Taip;1;1;0;2
7308;Pelenė;Žvaigždutės;45410683361;Taip;3;0;2;5
7309;Pelenė;Žvaigždutės;1305335939;Taip;0;0;1;1
7310;Pelenė;Žvaigždutės;62484999314;Taip;0;0;4;4
7311;Pelenė;Žvaigždutės;5081903157;Taip;2;1;0;3
7312;Pelenė;Nykštukas;9621197758;Taip;1;1;0;2
7313;Pelenė;Nykštukas;7144616734;Ne;4;0;1;5
7314;Pelenė;Nykštukas;3296147024;Taip;0;19;0;19
7315;Pelenė;Nykštukas;3189305906;Taip;0;7;0;7
7316;Pelenė;Nykštukas;8607110629;Taip;0;8;0;8
7317;Pelenė;Nykštukas;9584503078;Taip;6;0;1;7
7318;Pelenė;Nykštukas;8770771520;Taip;0;0;3;3
7319;Pelenė;Nykštukas;10457480694;Taip;12;0;1;13
7320;Pelenė;Nykštukas;6181604926;Ne;0;0;1;1
7321;Pelenė;Nykštukas;1750366978;Taip;18;0;1;19
7322;Pelenė;Nykštukas;2092775878;Taip;0;13;0;13
7323;Pelenė;Nykštukas;8675348688;Taip;3;0;0;3
7324;Pelenė;Nykštukas;7254981715;Ne;0;8;0;8
7325;Pelenė;Nykštukas;7836778389;Taip;0;10;0;10
7326;Pelenė;Nykštukas;8721423900;Taip;0;19;0;19
7327;Pelenė;Nykštukas;6579504852;Taip;5;0;0;5
7328;Pelenė;Nykštukas;6021833025;Taip;0;7;0;7
7329;Pelenė;Nykštukas;1978481168;Taip;6;0;0;6
7330;Pelenė;Nykštukas;3596386480;Taip;11;1;0;12
7331;Pelenė;Nykštukas;7205437280;Taip;0;0;1;1
7332;Pelenė;Nykštukas;3385568839;Taip;12;4;0;16
7333;Pelenė;Nykštukas;7589978427;Taip;0;1;0;1
7334;Pelenė;Žirniukai;4315677064;Taip;0;0;1;1
7335;Pelenė;Žirniukai;4624325473;Taip;0;12;0;12
7336;Pelenė;Žirniukai;1775717256;Ne;7;0;0;7
7337;Pelenė;Žirniukai;6632188229;Taip;0;7;0;7
7338;Pelenė;Žirniukai;5356756237;Ne;4;0;1;5
7339;Pelenė;Žirniukai;7587887488;Taip;5;1;0;6
7340;Pelenė;Žirniukai;8716395810;Taip;0;1;0;1
7341;Pelenė;Žirniukai;6191899254;Taip;0;0;2;2
7342;Pelenė;Žirniukai;2737277656;Taip;0;1;0;1
7343;Pelenė;Žirniukai;6481466282;Taip;0;0;3;3
7344;Pelenė;Žirniukai;5389865440;Ne;6;0;0;6
7345;Pelenė;Žirniukai;1902314385;Taip;0;0;2;2
7346;Pelenė;Žirniukai;6707167720;Taip;0;4;1;5
7347;Pelenė;Žirniukai;9009271610;Taip;0;12;0;12
7348;Pelenė;Žirniukai;5325176433;Taip;8;2;0;10
7349;Pelenė;Žirniukai;9186679454;Taip;0;3;0;3
7350;Pelenė;Žirniukai;8414727016;Taip;2;0;1;3
7351;Pelenė;Žirniukai;6221703608;Taip;14;0;0;14
7352;Pelenė;Lašeliai;4591637887;Taip;0;11;0;11
7353;Pelenė;Lašeliai;1067737206;Taip;5;11;0;16
7354;Pelenė;Lašeliai;6038229659;Taip;10;0;1;11
7355;Pelenė;Lašeliai;4090532624;Ne;8;0;1;9
7356;Pelenė;Lašeliai;9075193730;Ne;5;0;0;5
7357;Pelenė;Lašeliai;6419661741;Taip;0;0;1;1
7358;Pelenė;Lašeliai;8123162647;Taip;0;5;0;5
7359;Pelenė;Lašeliai;4366940539;Taip;4;3;0;7
7360;Pelenė;Lašeliai;7114993398;Ne;11;0;0;11
7361;Pelenė;Lašeliai;7659625628;Taip;8;0;2;10
7362;Pelenė;Lašeliai;2210314952;Taip;9;0;0;9
7363;Pelenė;Lašeliai;9063588699;Taip;0;13;0;13
7364;Pelenė;Lašeliai;7088493729;Taip;13;0;0;13
7365;Pelenė;Lašeliai;3573543545;Taip;15;3;0;18
7366;Pelenė;Lašeliai;4089199552;Taip;3;0;2;5
7367;Pelenė;Lašeliai;4546285993;Taip;0;0;4;4
7368;Pelenė;Lašeliai;4541391191;Taip;11;0;0;11
7369;Pelenė;Lašeliai;9195113444;Taip;0;9;0;9
7370;Pelenė;Lašeliai;7880284433;Taip;0;0;4;4
7371;Pelenė;Lašeliai;3238807604;Ne;0;3;0;3
7372;Pelenė;Lašeliai;6375060159;Taip;10;11;0;21
7373;Pelenė;Lašeliai;5063098703;Taip;0;3;0;3
7374;Pelenė;Lašeliai;5780697554;Taip;0;9;0;9
7375;Pelenė;Grūdelis;34209230034;Taip;5;0;0;5
7376;Pelenė;Grūdelis;55160554683;Taip;0;1;0;1
7377;Pelenė;Grūdelis;1283843474;Taip;2;2;1;5
7378;Pelenė;Grūdelis;3189769456;Taip;0;1;0;1
7379;Pelenė;Grūdelis;8483195434;Taip;0;4;0;4
7380;Pelenė;Grūdelis;66474157416;Taip;1;0;1;2
7381;Pelenė;Grūdelis;77504082241;Taip;0;6;0;6
7382;Pelenė;Grūdelis;1599336930;Taip;0;1;0;1
7383;Pelenė;Grūdelis;93234992958;Taip;0;1;0;1
7384;Pelenė;Grūdelis;2393068606;Taip;0;1;0;1
7385;Pelenė;Grūdelis;62544766703;Taip;2;6;0;8
7386;Pelenė;Grūdelis;43686344645;Ne;0;4;0;4
7387;Pelenė;Grūdelis;1157718969;Taip;0;1;0;1
7388;Pelenė;Grūdelis;39850314417;Taip;0;1;0;1
7389;Pelenė;Grūdelis;71274664713;Taip;0;4;0;4
7390;Pelenė;Grūdelis;1542958753;Taip;3;1;2;6
7391;Pelenė;Grūdelis;1908166570;Taip;0;1;1;2
7392;Pelenė;Grūdelis;1516249890;Taip;0;3;0;3
7393;Pelenė;Grūdelis;1846536895;Taip;0;6;0;6
7394;Pelenė;Grūdelis;1045206373;Taip;4;0;0;4
7395;Pelenė;Braškytė;8038559319;Taip;12;0;1;13
7396;Pelenė;Braškytė;5697826755;Taip;2;0;1;3
7397;Pelenė;Braškytė;6864263698;Taip;19;0;0;19
7398;Pelenė;Braškytė;9447223913;Taip;0;0;1;1
7399;Pelenė;Braškytė;4004975235;Taip;5;0;0;5
7400;Pelenė;Braškytė;8790613872;Taip;3;0;0;3
7401;Pelenė;Braškytė;8194354176;Taip;0;3;1;4
7402;Pelenė;Braškytė;8239650471;Taip;0;0;1;1
7403;Pelenė;Braškytė;5228983908;Taip;2;0;0;2
7404;Pelenė;Braškytė;3174009848;Taip;13;0;0;13
7405;Pelenė;Braškytė;6524101295;Taip;6;0;0;6
7406;Pelenė;Braškytė;7164790060;Taip;12;0;0;12
7407;Pelenė;Braškytė;4376033711;Taip;2;0;0;2
7408;Pelenė;Braškytė;6894978459;Taip;11;1;0;12
7409;Pelenė;Braškytė;4321705575;Taip;0;1;0;1
7410;Pelenė;Braškytė;2103177773;Taip;5;0;0;5
7411;Pelenė;Braškytė;1632490481;Taip;8;0;1;9
7412;Pelenė;Boružėlės;9218868317;Taip;0;1;0;1
7413;Pelenė;Boružėlės;2163737781;Taip;4;1;0;5
7414;Pelenė;Boružėlės;7565331966;Taip;4;0;2;6
7415;Pelenė;Boružėlės;9810123679;Taip;0;19;0;19
7416;Pelenė;Boružėlės;1048899958;Taip;7;0;0;7
7417;Pelenė;Boružėlės;4056676361;Taip;4;0;1;5
7418;Pelenė;Boružėlės;1278011268;Taip;8;0;0;8
7419;Pelenė;Boružėlės;2540405047;Taip;4;0;1;5
7420;Pelenė;Boružėlės;6469409776;Taip;14;0;1;15
7421;Pelenė;Boružėlės;4870187198;Taip;11;0;0;11
7422;Pelenė;Boružėlės;1274729537;Taip;5;0;1;6
7423;Pelenė;Boružėlės;3205331614;Taip;0;1;2;3
7424;Pelenė;Boružėlės;2322908067;Taip;0;21;0;21
7425;Pelenė;Boružėlės;5084452088;Taip;14;0;1;15
7426;Pelenė;Boružėlės;5074054534;Taip;0;0;8;8
7427;Pelenė;Saldainiukai;2040256240;Taip;13;0;1;14
7428;Pelenė;Saldainiukai;8623480143;Ne;9;0;1;10
7429;Pelenė;Saldainiukai;3662919521;Taip;21;0;0;21
7430;Pelenė;Saldainiukai;4856039707;Taip;7;5;1;13
7431;Pelenė;Saldainiukai;2765650058;Taip;20;0;0;20
7432;Pelenė;Saldainiukai;4695104609;Taip;15;5;0;20
7433;Pelenė;Saldainiukai;1852964349;Taip;14;0;0;14
7434;Pelenė;Saldainiukai;7578318198;Taip;13;0;2;15
7435;Pelenė;Saldainiukai;1080017906;Taip;6;0;0;6
7436;Pelenė;Saldainiukai;7714061272;Taip;0;2;0;2
7437;Pipiras;EŽIUKAI;56241147614;Taip;0;1;0;1
7438;Pipiras;EŽIUKAI;1112327896;Taip;0;3;0;3
7439;Pipiras;EŽIUKAI;52968399382;Taip;4;1;0;5
7440;Pipiras;EŽIUKAI;76685499613;Taip;0;2;0;2
7441;Pipiras;EŽIUKAI;24414917430;Taip;0;6;0;6
7442;Pipiras;EŽIUKAI;71881026465;Taip;4;1;0;5
7443;Pipiras;EŽIUKAI;32958963027;Taip;0;2;0;2
7444;Pipiras;EŽIUKAI;95904922548;Taip;0;8;0;8
7445;Pipiras;EŽIUKAI;55466909230;Taip;5;0;1;6
7446;Pipiras;EŽIUKAI;53468621826;Taip;19;0;0;19
7447;Pipiras;EŽIUKAI;9858798452;Taip;0;1;0;1
7448;Pipiras;EŽIUKAI;1213972436;Taip;0;2;1;3
7449;Pipiras;EŽIUKAI;4564046164;Ne;11;1;0;12
7450;Pipiras;EŽIUKAI;35225328018;Ne;12;1;1;14
7451;Pipiras;EŽIUKAI;1129409620;Taip;0;3;5;8
7452;Pipiras;EŽIUKAI;1095731795;Taip;12;5;0;17
7453;Pipiras;EŽIUKAI;24106575180;Ne;8;2;0;10
7454;Pipiras;BITUTĖS;3554786173;Taip;5;2;0;7
7455;Pipiras;BITUTĖS;5725956659;Taip;6;0;0;6
7456;Pipiras;BITUTĖS;7934365114;Taip;5;0;0;5
7457;Pipiras;BITUTĖS;2075041950;Taip;4;0;0;4
7458;Pipiras;BITUTĖS;9840040112;Taip;13;2;0;15
7459;Pipiras;BITUTĖS;3852848863;Taip;0;2;0;2
7460;Pipiras;BITUTĖS;5235868332;Taip;5;1;0;6
7461;Pipiras;BITUTĖS;6780333972;Taip;0;11;0;11
7462;Pipiras;BITUTĖS;7350131214;Taip;21;0;0;21
7463;Pipiras;BITUTĖS;5225533488;Taip;0;2;0;2
7464;Pipiras;BITUTĖS;5622119207;Taip;0;1;0;1
7465;Pipiras;BITUTĖS;6792777396;Taip;0;2;0;2
7466;Pipiras;BITUTĖS;1784839485;Taip;0;6;0;6
7467;Pipiras;BITUTĖS;3775916247;Taip;0;14;0;14
7468;Pipiras;BITUTĖS;5845498558;Taip;0;5;0;5
7469;Pipiras;BITUTĖS;4177166475;Taip;6;4;0;10
7470;Pipiras;BITUTĖS;9770780973;Taip;20;0;0;20
7471;Pipiras;NYKŠTUKAI;1045583136;Taip;16;1;0;17
7472;Pipiras;NYKŠTUKAI;4811029230;Taip;0;14;0;14
7473;Pipiras;NYKŠTUKAI;8895028305;Taip;0;1;0;1
7474;Pipiras;NYKŠTUKAI;8140314304;Taip;0;0;1;1
7475;Pipiras;NYKŠTUKAI;6791495556;Taip;0;1;0;1
7476;Pipiras;NYKŠTUKAI;5422547144;Taip;14;0;0;14
7477;Pipiras;NYKŠTUKAI;6363349541;Taip;0;4;0;4
7478;Pipiras;NYKŠTUKAI;4266424785;Taip;0;15;0;15
7479;Pipiras;NYKŠTUKAI;6748400056;Taip;0;12;0;12
7480;Pipiras;NYKŠTUKAI;2315614501;Taip;9;0;0;9
7481;Pipiras;NYKŠTUKAI;1242260242;Taip;0;1;0;1
7482;Pipiras;NYKŠTUKAI;6685567970;Taip;10;2;2;14
7483;Pipiras;NYKŠTUKAI;8520454289;Taip;0;2;0;2
7484;Pipiras;NYKŠTUKAI;4426479971;Taip;3;1;0;4
7485;Pipiras;NYKŠTUKAI;2267192782;Taip;0;7;0;7
7486;Pipiras;NYKŠTUKAI;3421769229;Taip;5;1;0;6
7487;Pipiras;NYKŠTUKAI;5445858240;Taip;5;1;0;6
7488;Pipiras;NYKŠTUKAI;4725221169;Taip;5;3;0;8
7489;Pipiras;PELĖDŽIUKAI;6694920607;Taip;5;0;0;5
7490;Pipiras;PELĖDŽIUKAI;3325511140;Taip;5;2;0;7
7491;Pipiras;PELĖDŽIUKAI;3341850450;Taip;8;0;0;8
7492;Pipiras;PELĖDŽIUKAI;7870521230;Taip;0;2;0;2
7493;Pipiras;PELĖDŽIUKAI;5778300856;Taip;0;2;0;2
7494;Pipiras;PELĖDŽIUKAI;3888552150;Taip;4;0;0;4
7495;Pipiras;PELĖDŽIUKAI;7026118693;Taip;10;2;0;12
7496;Pipiras;PELĖDŽIUKAI;1391682850;Taip;0;6;0;6
7497;Pipiras;PELĖDŽIUKAI;87924002679;Taip;16;1;0;17
7498;Pipiras;PELĖDŽIUKAI;6136423200;Taip;21;0;0;21
7499;Pipiras;PELĖDŽIUKAI;6805620664;Taip;21;0;0;21
7500;Pipiras;PELĖDŽIUKAI;7912217889;Ne;0;2;0;2
7501;Pipiras;PELĖDŽIUKAI;5502001191;Taip;2;2;0;4
7502;Pipiras;PELĖDŽIUKAI;9275905384;Taip;0;0;1;1
7503;Pipiras;PELĖDŽIUKAI;4496076326;Taip;0;0;3;3
7504;Pipiras;PELĖDŽIUKAI;3141822820;Taip;0;9;0;9
7505;Pipiras;PELĖDŽIUKAI;2044498561;Taip;0;17;0;17
7506;Pipiras;PELĖDŽIUKAI;2240865490;Taip;3;5;0;8
7507;Pipiras;PELĖDŽIUKAI;3357866319;Ne;0;4;2;6
7508;Pipiras;DRUGELIAI;41585818819;Taip;21;0;0;21
7509;Pipiras;DRUGELIAI;5577759167;Taip;16;3;0;19
7510;Pipiras;DRUGELIAI;7799786844;Ne;17;0;0;17
7511;Pipiras;DRUGELIAI;5014457985;Ne;17;1;0;18
7512;Pipiras;DRUGELIAI;4927845000;Ne;0;2;0;2
7513;Pipiras;DRUGELIAI;1904376366;Taip;0;20;0;20
7514;Pipiras;DRUGELIAI;1128674099;Taip;1;3;0;4
7515;Pipiras;DRUGELIAI;3422170541;Taip;0;1;0;1
7516;Pipiras;DRUGELIAI;1391958633;Taip;1;0;10;11
7517;Pipiras;DRUGELIAI;7784343130;Taip;10;2;0;12
7518;Pipiras;DRUGELIAI;3622164823;Taip;0;11;0;11
7519;Pipiras;DRUGELIAI;3008358842;Taip;20;0;0;20
7520;Pipiras;DRUGELIAI;2024777430;Taip;0;6;0;6
7521;Pipiras;DRUGELIAI;4959823035;Taip;2;2;0;4
7522;Pipiras;DRUGELIAI;6339186940;Taip;0;4;4;8
7523;Pipiras;DRUGELIAI;3314276870;Taip;11;1;0;12
7524;Pipiras;DRUGELIAI;5637557921;Taip;0;5;0;5
7525;Pipiras;DRUGELIAI;1050430252;Ne;5;3;0;8
7526;Pipiras;DRUGELIAI;2914156353;Taip;10;2;7;19
7527;Pipiras;GĖLYTĖS;48059975861;Taip;5;1;0;6
7528;Pipiras;GĖLYTĖS;81335131932;Taip;0;1;0;1
7529;Pipiras;GĖLYTĖS;23377947863;Taip;0;6;0;6
7530;Pipiras;GĖLYTĖS;87831792882;Taip;10;4;0;14
7531;Pipiras;GĖLYTĖS;1417855241;Taip;0;1;0;1
7532;Pipiras;GĖLYTĖS;1791226869;Taip;6;3;0;9
7533;Pipiras;GĖLYTĖS;1077104941;Taip;0;1;0;1
7534;Pipiras;GĖLYTĖS;27808576289;Taip;0;1;0;1
7535;Pipiras;GĖLYTĖS;5114553619;Taip;0;2;0;2
7536;Pipiras;GĖLYTĖS;1780531222;Taip;0;1;0;1
7537;Pipiras;GĖLYTĖS;18211174874;Taip;0;10;0;10
7538;Pipiras;GĖLYTĖS;4246712256;Taip;5;4;0;9
7539;Pipiras;GĖLYTĖS;25000181631;Taip;0;4;0;4
7540;Pipiras;GĖLYTĖS;2473644942;Taip;0;11;0;11
7541;Pipiras;GĖLYTĖS;56822466210;Taip;0;1;0;1
7542;Pipiras;GĖLYTĖS;23663823688;Taip;13;0;0;13
7543;Pipiras;GĖLYTĖS;6481320053;Ne;0;5;0;5
7544;Pipiras;BORUŽĖLĖS;68636458010;Taip;1;2;0;3
7545;Pipiras;BORUŽĖLĖS;31533878253;Taip;0;1;0;1
7546;Pipiras;BORUŽĖLĖS;20456702162;Taip;3;1;0;4
7547;Pipiras;BORUŽĖLĖS;57459408180;Taip;0;17;0;17
7548;Pipiras;BORUŽĖLĖS;7354253729;Ne;0;5;0;5
7549;Pipiras;BORUŽĖLĖS;99551392640;Taip;0;1;0;1
7550;Pipiras;BORUŽĖLĖS;9423015002;Taip;0;8;0;8
7551;Pipiras;BORUŽĖLĖS;68235713574;Taip;0;2;0;2
7552;Pipiras;BORUŽĖLĖS;63605758339;Taip;0;1;0;1
7553;Pipiras;BORUŽĖLĖS;23794561369;Taip;11;3;0;14
7554;Pipiras;BORUŽĖLĖS;46165404909;Taip;0;2;0;2
7555;Pipiras;BORUŽĖLĖS;6804964469;Taip;7;1;0;8
7556;Pipiras;BORUŽĖLĖS;81817710888;Taip;0;1;3;4
7557;Pipiras;BORUŽĖLĖS;7448924569;Taip;0;4;0;4
7558;Pipiras;BORUŽĖLĖS;1676986127;Taip;0;2;1;3
7559;Pipiras;BORUŽĖLĖS;1334584865;Taip;5;1;2;8
7560;Pipiras;BORUŽĖLĖS;9673674008;Taip;6;0;0;6
7561;Pipiras;BORUŽĖLĖS;1657721144;Taip;0;1;0;1
7562;Pipiras;BORUŽĖLĖS;6766596656;Taip;0;1;0;1
7563;Pipiras;SKRUZDĖLIUKAI;76840668343;Taip;0;9;0;9
7564;Pipiras;SKRUZDĖLIUKAI;1975780209;Taip;7;0;1;8
7565;Pipiras;SKRUZDĖLIUKAI;50739918812;Ne;0;6;0;6
7566;Pipiras;SKRUZDĖLIUKAI;75153377410;Taip;0;8;0;8
7567;Pipiras;SKRUZDĖLIUKAI;53426269440;Taip;0;3;0;3
7568;Pipiras;SKRUZDĖLIUKAI;7196519583;Taip;0;3;0;3
7569;Pipiras;SKRUZDĖLIUKAI;53180156021;Taip;0;1;0;1
7570;Pipiras;SKRUZDĖLIUKAI;96711811784;Taip;0;11;0;11
7571;Pipiras;SKRUZDĖLIUKAI;85339674885;Taip;0;8;0;8
7572;Pipiras;SKRUZDĖLIUKAI;61166497338;Taip;6;0;0;6
7573;Pipiras;SKRUZDĖLIUKAI;90202583208;Taip;0;1;0;1
7574;Pipiras;SKRUZDĖLIUKAI;84791674090;Ne;0;3;0;3
7575;Pipiras;SKRUZDĖLIUKAI;49361002482;Taip;0;1;0;1
7576;Pipiras;SKRUZDĖLIUKAI;53377928276;Taip;0;6;0;6
7577;Pipiras;SKRUZDĖLIUKAI;57731282074;Taip;6;0;0;6
7578;Pipiras;SKRUZDĖLIUKAI;1450882528;Taip;17;0;0;17
7579;Pipiras;SKRUZDĖLIUKAI;65132324180;Taip;0;10;0;10
7580;Pipiras;SKRUZDĖLIUKAI;71790101454;Taip;5;5;0;10
7581;Pipiras;SKRUZDĖLIUKAI;73564428514;Ne;11;5;0;16
7582;Pipiras;SKRUZDĖLIUKAI;3867978800;Ne;0;2;0;2
7583;Pipiras;ŽVIRBLIUKŲ;70940029154;Taip;0;1;0;1
7584;Pipiras;ŽVIRBLIUKŲ;1232620336;Taip;17;0;0;17
7585;Pipiras;ŽVIRBLIUKŲ;1549121029;Taip;0;2;0;2
7586;Pipiras;ŽVIRBLIUKŲ;37087220885;Taip;2;0;0;2
7587;Pipiras;ŽVIRBLIUKŲ;1700856741;Taip;5;2;0;7
7588;Pipiras;ŽVIRBLIUKŲ;1319863476;Ne;0;1;0;1
7589;Pipiras;ŽVIRBLIUKŲ;1757192919;Taip;5;3;0;8
7590;Pipiras;ŽVIRBLIUKŲ;1417086043;Taip;3;4;0;7
7591;Pipiras;ŽVIRBLIUKŲ;1441590033;Taip;0;1;0;1
7592;Pipiras;ŽVIRBLIUKŲ;2030665851;Taip;5;1;0;6
7593;Pipiras;ŽVIRBLIUKŲ;1182415963;Taip;0;2;0;2
7594;Pipiras;ŽVIRBLIUKŲ;8657924258;Taip;0;2;0;2
7595;Pipiras;ŽVIRBLIUKŲ;10750695428;Taip;15;2;0;17
7596;Pipiras;ŽVIRBLIUKŲ;66816368717;Ne;0;2;2;4
7597;Pipiras;ŽVIRBLIUKŲ;22190236403;Taip;0;1;0;1
7598;Pipiras;ŽVIRBLIUKŲ;7736031786;Taip;11;0;1;12
7599;Pipiras;ŽVIRBLIUKŲ;2402351134;Taip;2;0;0;2
7600;Pipiras;ZUIKUČIŲ;2016718354;Taip;0;1;0;1
7601;Pipiras;ZUIKUČIŲ;4017042461;Taip;0;9;0;9
7602;Pipiras;ZUIKUČIŲ;5141447649;Taip;9;6;0;15
7603;Pipiras;ZUIKUČIŲ;5908707752;Taip;6;7;0;13
7604;Pipiras;ZUIKUČIŲ;8422419380;Taip;6;1;0;7
7605;Pipiras;ZUIKUČIŲ;9892201598;Taip;3;10;0;13
7606;Pipiras;ZUIKUČIŲ;6775489564;Taip;11;0;2;13
7607;Pipiras;ZUIKUČIŲ;9499869533;Taip;16;0;0;16
7608;Pipiras;ZUIKUČIŲ;3980950261;Taip;18;0;0;18
7609;Pipiras;ZUIKUČIŲ;6696824728;Ne;2;1;2;5
7610;Pipiras;ZUIKUČIŲ;9372109848;Taip;2;5;0;7
7611;Pipiras;ZUIKUČIŲ;6310054093;Taip;5;1;0;6
7612;Pipiras;ZUIKUČIŲ;5137132420;Ne;6;1;0;7
7613;Pipiras;ZUIKUČIŲ;1019753152;Taip;0;1;0;1
7614;Pipiras;VARLIUKŲ;6810906239;Taip;21;0;0;21
7615;Pipiras;VARLIUKŲ;3465024013;Taip;21;0;0;21
7616;Pipiras;VARLIUKŲ;5214984111;Taip;5;0;0;5
7617;Pipiras;VARLIUKŲ;7969837759;Taip;12;3;0;15
7618;Pipiras;VARLIUKŲ;9625933545;Taip;0;2;0;2
7619;Pipiras;VARLIUKŲ;8819018248;Taip;8;1;0;9
7620;Pipiras;VARLIUKŲ;5888429623;Taip;0;1;3;4
7621;Pipiras;VARLIUKŲ;3768825314;Taip;14;0;0;14
7622;Pipiras;VARLIUKŲ;2296702730;Taip;3;2;6;11
7623;Pipiras;VARLIUKŲ;4510888337;Taip;1;3;0;4
7624;Pipiras;VARLIUKŲ;1711168196;Taip;5;5;0;10
7625;Pipiras;VARLIUKŲ;9968182443;Taip;5;4;0;9
7626;Pipiras;VARLIUKŲ;4309096743;Taip;5;0;0;5
7627;Pipiras;VARLIUKŲ;2483867901;Taip;3;0;0;3
7628;Pipiras;VARLIUKŲ;5059203266;Taip;0;2;0;2
7629;Pipiras;VARLIUKŲ;8296425777;Taip;0;1;0;1
7630;Pipiras;VARLIUKŲ;1315372873;Taip;0;4;0;4
7631;Pipiras;ŽIOGELIŲ;2096009051;Taip;13;4;0;17
7632;Pipiras;ŽIOGELIŲ;71283505646;Ne;0;7;0;7
7633;Pipiras;ŽIOGELIŲ;1485565125;Taip;0;0;1;1
7634;Pipiras;ŽIOGELIŲ;2061168407;Taip;6;2;0;8
7635;Pipiras;ŽIOGELIŲ;2030170020;Ne;0;1;0;1
7636;Pipiras;ŽIOGELIŲ;2637950013;Taip;21;0;0;21
7637;Pipiras;ŽIOGELIŲ;3652741639;Taip;16;0;0;16
7638;Pipiras;ŽIOGELIŲ;1082396096;Taip;6;2;0;8
7639;Pipiras;ŽIOGELIŲ;1324680675;Taip;0;1;0;1
7640;Pipiras;ŽIOGELIŲ;1371141047;Taip;0;2;0;2
7641;Pipiras;ŽIOGELIŲ;1420510354;Taip;1;0;0;1
7642;Pipiras;ŽIOGELIŲ;1293250996;Taip;0;14;0;14
7643;Pipiras;ŽIOGELIŲ;1751427121;Taip;7;0;0;7
7644;Pipiras;ŽIOGELIŲ;1114377378;Taip;0;7;0;7
7645;Pipiras;ŽIOGELIŲ;1694848410;Taip;2;0;0;2
7646;Pipiras;ŽIOGELIŲ;8088285579;Taip;0;10;0;10
7647;"Prie pasakų parko";PAUKŠČIUKŲ;7548653053;Taip;1;4;0;5
7648;"Prie pasakų parko";PAUKŠČIUKŲ;2168919559;Taip;0;2;0;2
7649;"Prie pasakų parko";PAUKŠČIUKŲ;8899375521;Ne;21;0;0;21
7650;"Prie pasakų parko";PAUKŠČIUKŲ;5186675623;Taip;0;0;3;3
7651;"Prie pasakų parko";PAUKŠČIUKŲ;9102872020;Taip;0;0;2;2
7652;"Prie pasakų parko";PAUKŠČIUKŲ;6710735721;Taip;16;0;0;16
7653;"Prie pasakų parko";PAUKŠČIUKŲ;8715851643;Taip;0;11;0;11
7654;"Prie pasakų parko";PAUKŠČIUKŲ;9476448601;Taip;4;0;0;4
7655;"Prie pasakų parko";PAUKŠČIUKŲ;6446562388;Taip;6;4;0;10
7656;"Prie pasakų parko";PAUKŠČIUKŲ;1445359221;Taip;13;0;1;14
7657;"Prie pasakų parko";PAUKŠČIUKŲ;6561145380;Taip;10;0;0;10
7658;"Prie pasakų parko";PAUKŠČIUKŲ;2898016639;Taip;3;1;0;4
7659;"Prie pasakų parko";PAUKŠČIUKŲ;2160081492;Taip;6;3;0;9
7660;"Prie pasakų parko";PAUKŠČIUKŲ;1849834345;Taip;4;0;0;4
7661;"Prie pasakų parko";PAUKŠČIUKŲ;3795705735;Taip;16;1;0;17
7662;"Prie pasakų parko";"LINKSMOJI ŠEIMYNĖLĖ (SPEC)";4908579339;Taip;21;0;0;21
7663;"Prie pasakų parko";"LINKSMOJI ŠEIMYNĖLĖ (SPEC)";1508800551;Taip;0;0;15;15
7664;"Prie pasakų parko";"LINKSMOJI ŠEIMYNĖLĖ (SPEC)";1658448860;Taip;0;3;0;3
7665;"Prie pasakų parko";"LINKSMOJI ŠEIMYNĖLĖ (SPEC)";78634860827;Taip;0;0;1;1
7666;"Prie pasakų parko";"LINKSMOJI ŠEIMYNĖLĖ (SPEC)";78012776060;Taip;5;0;1;6
7667;"Prie pasakų parko";NYKŠTUKŲ;6992830082;Taip;3;0;1;4
7668;"Prie pasakų parko";NYKŠTUKŲ;1588062393;Taip;0;0;7;7
7669;"Prie pasakų parko";NYKŠTUKŲ;1278065349;Taip;9;0;0;9
7670;"Prie pasakų parko";NYKŠTUKŲ;1482803930;Taip;5;0;0;5
7671;"Prie pasakų parko";NYKŠTUKŲ;3356307067;Ne;4;0;0;4
7672;"Prie pasakų parko";NYKŠTUKŲ;8574432191;Taip;2;0;0;2
7673;"Prie pasakų parko";NYKŠTUKŲ;4181676762;Taip;0;5;0;5
7674;"Prie pasakų parko";NYKŠTUKŲ;8318567916;Taip;10;0;0;10
7675;"Prie pasakų parko";NYKŠTUKŲ;5982019255;Ne;6;0;2;8
7676;"Prie pasakų parko";NYKŠTUKŲ;2741301903;Taip;10;0;0;10
7677;"Prie pasakų parko";NYKŠTUKŲ;2160440145;Taip;7;0;0;7
7678;"Prie pasakų parko";NYKŠTUKŲ;8189217660;Ne;6;8;0;14
7679;"Prie pasakų parko";NYKŠTUKŲ;8215830508;Ne;4;6;0;10
7680;"Prie pasakų parko";NYKŠTUKŲ;2216634402;Taip;14;0;2;16
7681;"Prie pasakų parko";NYKŠTUKŲ;5862570666;Taip;1;0;0;1
7682;"Prie pasakų parko";NYKŠTUKŲ;4548803933;Taip;6;1;0;7
7683;"Prie pasakų parko";NYKŠTUKŲ;4443834766;Taip;9;0;0;9
7684;"Prie pasakų parko";NYKŠTUKŲ;9926991259;Taip;7;5;0;12
7685;"Prie pasakų parko";NYKŠTUKŲ;8474308320;Taip;5;0;0;5
7686;"Prie pasakų parko";NYKŠTUKŲ;5304082676;Taip;5;0;4;9
7687;"Prie pasakų parko";LAŠELIŲ;1410161486;Ne;0;0;2;2
7688;"Prie pasakų parko";LAŠELIŲ;79438946697;Taip;0;3;4;7
7689;"Prie pasakų parko";LAŠELIŲ;72936036464;Taip;6;4;0;10
7690;"Prie pasakų parko";LAŠELIŲ;21605684303;Taip;0;0;1;1
7691;"Prie pasakų parko";LAŠELIŲ;6577763037;Taip;2;0;1;3
7692;"Prie pasakų parko";LAŠELIŲ;9511739352;Taip;2;0;0;2
7693;"Prie pasakų parko";LAŠELIŲ;2241142980;Taip;6;0;0;6
7694;"Prie pasakų parko";"KAČIUKAI (SPEC)";8949507250;Taip;0;0;1;1
7695;"Prie pasakų parko";"KAČIUKAI (SPEC)";1057427744;Ne;0;0;3;3
7696;"Prie pasakų parko";"KAČIUKAI (SPEC)";1783727978;Taip;0;0;3;3
7697;"Prie pasakų parko";"KAČIUKAI (SPEC)";3397410463;Ne;5;0;2;7
7698;"Prie pasakų parko";"KAČIUKAI (SPEC)";4574965127;Ne;0;0;1;1
7699;"Prie pasakų parko";"ANČIUKAI (SPEC)";9327121033;Ne;8;0;0;8
7700;"Prie pasakų parko";"ANČIUKAI (SPEC)";1182188784;Taip;0;0;3;3
7701;"Prie pasakų parko";"ANČIUKAI (SPEC)";7710346116;Ne;0;0;2;2
7702;"Prie pasakų parko";"ANČIUKAI (SPEC)";3825101647;Ne;12;0;0;12
7703;"Prie pasakų parko";"ANČIUKAI (SPEC)";9847622676;Ne;18;0;0;18
7704;"Prie pasakų parko";"ANČIUKAI (SPEC)";9469871636;Ne;0;0;4;4
7705;"Prie pasakų parko";"ANČIUKAI (SPEC)";2133790263;Ne;0;0;1;1
7706;"Prie pasakų parko";"ANČIUKAI (SPEC)";1212865434;Ne;12;0;2;14
7707;"Prie pasakų parko";"EŽIUKŲ (SPEC)";7851357992;Taip;0;0;19;19
7708;"Prie pasakų parko";"EŽIUKŲ (SPEC)";1549137154;Taip;6;0;1;7
7709;"Prie pasakų parko";"EŽIUKŲ (SPEC)";7545372781;Ne;0;0;1;1
7710;"Prie pasakų parko";"EŽIUKŲ (SPEC)";29445903073;Taip;11;4;0;15
7711;"Prie pasakų parko";"EŽIUKŲ (SPEC)";8849417734;Taip;10;0;1;11
7712;"Prie pasakų parko";"EŽIUKŲ (SPEC)";9190379838;Taip;0;0;5;5
7713;"Prie pasakų parko";"EŽIUKŲ (SPEC)";7327208141;Ne;10;0;2;12
7714;"Prie pasakų parko";"EŽIUKŲ (SPEC)";7115825217;Taip;10;0;4;14
7715;"Prie pasakų parko";"EŽIUKŲ (SPEC)";2952868428;Taip;4;0;4;8
7716;"Prie pasakų parko";"BORUŽIUKŲ (SPEC)";2080597774;Taip;0;1;0;1
7717;"Prie pasakų parko";"BORUŽIUKŲ (SPEC)";1348724947;Taip;0;0;21;21
7718;"Prie pasakų parko";"BORUŽIUKŲ (SPEC)";28574450739;Taip;0;3;0;3
7719;"Prie pasakų parko";"BORUŽIUKŲ (SPEC)";8817950372;Taip;0;2;0;2
7720;"Prie pasakų parko";"BORUŽIUKŲ (SPEC)";4203385836;Ne;6;1;0;7
7721;"Prie pasakų parko";"BORUŽIUKŲ (SPEC)";92307951922;Taip;10;0;0;10
7722;"Prie pasakų parko";"BORUŽIUKŲ (SPEC)";6215345468;Ne;0;1;1;2
7723;"Prie pasakų parko";"BORUŽIUKŲ (SPEC)";9139322116;Taip;0;0;3;3
7724;"Prie pasakų parko";SAULYTĖS;4501408366;Taip;6;0;0;6
7725;"Prie pasakų parko";SAULYTĖS;6361878877;Taip;17;0;1;18
7726;"Prie pasakų parko";SAULYTĖS;6762267582;Taip;15;0;0;15
7727;"Prie pasakų parko";SAULYTĖS;3453119286;Taip;4;0;0;4
7728;"Prie pasakų parko";SAULYTĖS;5169736542;Taip;0;4;0;4
7729;"Prie pasakų parko";SAULYTĖS;5494350183;Taip;0;1;0;1
7730;"Prie pasakų parko";SAULYTĖS;5102718403;Taip;19;0;0;19
7731;"Prie pasakų parko";SAULYTĖS;8285260113;Taip;0;11;0;11
7732;"Prie pasakų parko";SAULYTĖS;5438716880;Taip;0;5;0;5
7733;"Prie pasakų parko";SAULYTĖS;7459673719;Taip;2;1;2;5
7734;"Prie pasakų parko";SAULYTĖS;2023309512;Ne;7;0;1;8
7735;"Prie pasakų parko";SAULYTĖS;8324750958;Ne;18;0;0;18
7736;"Prie pasakų parko";SAULYTĖS;1371318901;Taip;0;10;0;10
7737;"Prie pasakų parko";SAULYTĖS;4351705573;Taip;13;0;0;13
7738;"Prie pasakų parko";SAULYTĖS;7390391804;Taip;7;0;0;7
7739;"Prie pasakų parko";SAULYTĖS;8942118356;Taip;0;0;1;1
7740;"Prie pasakų parko";SAULYTĖS;3042409414;Taip;0;1;0;1
7741;Pumpurėlis;RAMUNĖLIŲ;6165833101;Taip;2;1;0;3
7742;Pumpurėlis;RAMUNĖLIŲ;6977710645;Taip;6;1;2;9
7743;Pumpurėlis;RAMUNĖLIŲ;9431295796;Taip;6;0;5;11
7744;Pumpurėlis;RAMUNĖLIŲ;1395380236;Taip;10;0;0;10
7745;Pumpurėlis;RAMUNĖLIŲ;9424449290;Ne;10;5;0;15
7746;Pumpurėlis;RAMUNĖLIŲ;6955168163;Taip;0;7;0;7
7747;Pumpurėlis;RAMUNĖLIŲ;5171198109;Taip;0;5;0;5
7748;Pumpurėlis;RAMUNĖLIŲ;9726028397;Taip;0;15;0;15
7749;Pumpurėlis;RAMUNĖLIŲ;7229289985;Taip;0;19;0;19
7750;Pumpurėlis;RAMUNĖLIŲ;2969734731;Ne;3;1;1;5
7751;Pumpurėlis;RAMUNĖLIŲ;5663147778;Taip;6;1;0;7
7752;Pumpurėlis;RAMUNĖLIŲ;7559071945;Taip;3;1;0;4
7753;Pumpurėlis;RAMUNĖLIŲ;8373105196;Taip;7;3;1;11
7754;Pumpurėlis;RAMUNĖLIŲ;6574415196;Taip;0;1;0;1
7755;Pumpurėlis;RAMUNĖLIŲ;3953103488;Taip;5;0;0;5
7756;Pumpurėlis;RAMUNĖLIŲ;6511527480;Taip;0;0;1;1
7757;Pumpurėlis;RAMUNĖLIŲ;3838705973;Taip;6;9;0;15
7758;Pumpurėlis;RAMUNĖLIŲ;6726875853;Taip;0;0;6;6
7759;Pumpurėlis;RAMUNĖLIŲ;7996736781;Taip;0;0;5;5
7760;Pumpurėlis;VARPELIŲ;7160091629;Taip;20;1;0;21
7761;Pumpurėlis;VARPELIŲ;3101133244;Ne;11;0;0;11
7762;Pumpurėlis;VARPELIŲ;3893768713;Taip;0;17;0;17
7763;Pumpurėlis;VARPELIŲ;5023658988;Ne;0;2;0;2
7764;Pumpurėlis;VARPELIŲ;2668855786;Taip;6;5;0;11
7765;Pumpurėlis;VARPELIŲ;8258560345;Taip;9;1;0;10
7766;Pumpurėlis;VARPELIŲ;9612924972;Taip;10;0;0;10
7767;Pumpurėlis;VARPELIŲ;9884099545;Taip;4;1;0;5
7768;Pumpurėlis;VARPELIŲ;1687770779;Ne;0;21;0;21
7769;Pumpurėlis;VARPELIŲ;4451898302;Taip;11;0;0;11
7770;Pumpurėlis;VARPELIŲ;3733509497;Taip;10;2;0;12
7771;Pumpurėlis;VARPELIŲ;4508966729;Taip;3;0;1;4
7772;Pumpurėlis;VARPELIŲ;9552913910;Taip;3;1;0;4
7773;Pumpurėlis;VARPELIŲ;5196733185;Taip;0;1;0;1
7774;Pumpurėlis;VARPELIŲ;4928495108;Taip;0;2;0;2
7775;Pumpurėlis;VARPELIŲ;8886730333;Taip;14;0;0;14
7776;Pumpurėlis;VARPELIŲ;2247300456;Taip;4;1;0;5
7777;Pumpurėlis;VARPELIŲ;5564680653;Taip;0;1;1;2
7778;Pumpurėlis;VARPELIŲ;1411232443;Taip;0;1;0;1
7779;Pumpurėlis;VARPELIŲ;6726772655;Taip;5;0;0;5
7780;Pumpurėlis;DRUGELIŲ;1230058211;Taip;0;12;0;12
7781;Pumpurėlis;DRUGELIŲ;1225377038;Taip;2;0;0;2
7782;Pumpurėlis;DRUGELIŲ;1053338730;Taip;5;0;1;6
7783;Pumpurėlis;DRUGELIŲ;1261919194;Taip;0;1;0;1
7784;Pumpurėlis;DRUGELIŲ;1397924008;Taip;4;2;0;6
7785;Pumpurėlis;DRUGELIŲ;6230500803;Ne;0;6;0;6
7786;Pumpurėlis;DRUGELIŲ;2129779614;Taip;0;1;0;1
7787;Pumpurėlis;DRUGELIŲ;2102427499;Taip;5;1;0;6
7788;Pumpurėlis;DRUGELIŲ;9317495169;Taip;0;8;0;8
7789;Pumpurėlis;DRUGELIŲ;8262886949;Ne;0;1;0;1
7790;Pumpurėlis;DRUGELIŲ;6535398274;Taip;2;0;1;3
7791;Pumpurėlis;DRUGELIŲ;9078991043;Taip;4;1;0;5
7792;Pumpurėlis;DRUGELIŲ;9733380187;Taip;0;4;0;4
7793;Pumpurėlis;DRUGELIŲ;83388662869;Ne;0;5;0;5
7794;Pumpurėlis;DRUGELIŲ;7123915287;Taip;5;0;0;5
7795;Pumpurėlis;DRUGELIŲ;1690424790;Ne;11;1;0;12
7796;Pumpurėlis;DRUGELIŲ;4192641015;Ne;3;1;0;4
7797;Pumpurėlis;DRUGELIŲ;1248017244;Taip;0;1;2;3
7798;Pumpurėlis;KODĖLČIUKŲ;18928851032;Taip;0;2;0;2
7799;Pumpurėlis;KODĖLČIUKŲ;9224879966;Taip;0;10;0;10
7800;Pumpurėlis;KODĖLČIUKŲ;2468796972;Taip;0;2;0;2
7801;Pumpurėlis;KODĖLČIUKŲ;9583257172;Taip;9;1;0;10
7802;Pumpurėlis;KODĖLČIUKŲ;7533555059;Taip;5;5;0;10
7803;Pumpurėlis;KODĖLČIUKŲ;6669327226;Taip;10;4;0;14
7804;Pumpurėlis;KODĖLČIUKŲ;13952236905;Taip;8;0;0;8
7805;Pumpurėlis;KODĖLČIUKŲ;87061817106;Taip;15;0;0;15
7806;Pumpurėlis;KODĖLČIUKŲ;1835168438;Ne;5;1;0;6
7807;Pumpurėlis;KODĖLČIUKŲ;5615260965;Taip;0;2;0;2
7808;Pumpurėlis;KODĖLČIUKŲ;4344595328;Taip;0;11;0;11
7809;Pumpurėlis;KODĖLČIUKŲ;3298821054;Ne;5;0;0;5
7810;Pumpurėlis;KODĖLČIUKŲ;8806961007;Taip;15;6;0;21
7811;Pumpurėlis;KODĖLČIUKŲ;9439363363;Taip;2;0;0;2
7812;Pumpurėlis;KODĖLČIUKŲ;5964953923;Taip;5;2;0;7
7813;Pumpurėlis;KODĖLČIUKŲ;1492810528;Taip;0;8;0;8
7814;Pumpurėlis;LINELIS;44982629856;Taip;0;2;0;2
7815;Pumpurėlis;LINELIS;1754102092;Taip;0;1;0;1
7816;Pumpurėlis;LINELIS;5901659879;Taip;0;1;0;1
7817;Pumpurėlis;LINELIS;11052382671;Taip;0;12;0;12
7818;Pumpurėlis;LINELIS;46386981131;Taip;0;2;0;2
7819;Pumpurėlis;LINELIS;77110003421;Taip;1;1;0;2
7820;Pumpurėlis;LINELIS;56351492623;Taip;5;1;0;6
7821;Pumpurėlis;LINELIS;70522541316;Taip;0;4;0;4
7822;Pumpurėlis;LINELIS;465606233;Taip;0;2;0;2
7823;Pumpurėlis;LINELIS;40808677022;Taip;0;1;0;1
7824;Pumpurėlis;LINELIS;57426850391;Ne;0;1;0;1
7825;Pumpurėlis;LINELIS;36645787745;Taip;0;3;0;3
7826;Pumpurėlis;LINELIS;15256433275;Taip;0;1;0;1
7827;Pumpurėlis;LINELIS;47596248180;Taip;0;2;0;2
7828;Pumpurėlis;LINELIS;97145389284;Taip;8;0;0;8
7829;Pumpurėlis;LINELIS;1645287832;Taip;0;0;5;5
7830;Pumpurėlis;LINELIS;6025998706;Taip;0;1;0;1
7831;Pumpurėlis;LINELIS;89695456583;Taip;11;4;0;15
7832;Pumpurėlis;SAULUTĖS;6215273976;Taip;0;7;0;7
7833;Pumpurėlis;SAULUTĖS;1366801299;Ne;6;1;0;7
7834;Pumpurėlis;SAULUTĖS;1524688901;Ne;6;1;0;7
7835;Pumpurėlis;SAULUTĖS;1021043951;Taip;0;2;0;2
7836;Pumpurėlis;SAULUTĖS;1631951556;Taip;5;4;0;9
7837;Pumpurėlis;SAULUTĖS;9041599264;Taip;2;1;0;3
7838;Pumpurėlis;SAULUTĖS;45279361421;Taip;3;1;2;6
7839;Pumpurėlis;SAULUTĖS;1085633311;Taip;0;3;2;5
7840;Pumpurėlis;SAULUTĖS;66672997420;Taip;0;3;0;3
7841;Pumpurėlis;SAULUTĖS;27361939846;Taip;0;6;0;6
7842;Pumpurėlis;SAULUTĖS;2671657094;Taip;0;8;0;8
7843;Pumpurėlis;SAULUTĖS;61297074638;Taip;0;3;0;3
7844;Pumpurėlis;SAULUTĖS;24681852477;Taip;2;1;0;3
7845;Pumpurėlis;SAULUTĖS;33847164571;Taip;0;5;3;8
7846;Pumpurėlis;SAULUTĖS;20093100251;Taip;0;2;0;2
7847;Pumpurėlis;SAULUTĖS;87813594933;Taip;5;6;0;11
7848;Pumpurėlis;SAULUTĖS;15096075268;Taip;0;2;0;2
7849;Pumpurėlis;SAULUTĖS;72455192748;Taip;5;2;0;7
7850;Pumpurėlis;SAULUTĖS;7015779224;Taip;0;17;0;17
7851;Pumpurėlis;SAULUTĖS;1685401053;Taip;0;1;0;1
7852;Pumpurėlis;SAULUTĖS;16656067942;Taip;0;3;0;3
7853;Pumpurėlis;SAULUTĖS;91612536967;Taip;0;3;0;3
7854;Pumpurėlis;BITUTĖS;2028515310;Ne;0;5;0;5
7855;Pumpurėlis;BITUTĖS;1333429949;Taip;2;0;0;2
7856;Pumpurėlis;BITUTĖS;8747439652;Taip;5;1;0;6
7857;Pumpurėlis;BITUTĖS;92238719397;Taip;0;1;0;1
7858;Pumpurėlis;BITUTĖS;1400057487;Taip;0;1;0;1
7859;Pumpurėlis;BITUTĖS;1274293175;Ne;0;5;0;5
7860;Pumpurėlis;BITUTĖS;7786926187;Taip;6;3;0;9
7861;Pumpurėlis;BITUTĖS;74144468541;Taip;0;2;0;2
7862;Pumpurėlis;BITUTĖS;1640573725;Taip;2;1;2;5
7863;Pumpurėlis;BITUTĖS;1473237607;Taip;0;3;1;4
7864;Pumpurėlis;BITUTĖS;71979455611;Ne;0;3;0;3
7865;Pumpurėlis;BITUTĖS;1001114367;Taip;5;1;0;6
7866;Pumpurėlis;BITUTĖS;26859673794;Taip;14;2;0;16
7867;Pumpurėlis;BITUTĖS;1527144198;Ne;0;5;0;5
7868;Pumpurėlis;BITUTĖS;57949968899;Taip;0;1;4;5
7869;Pumpurėlis;BITUTĖS;1298302188;Taip;0;0;1;1
7870;Pumpurėlis;BITUTĖS;1255753542;Ne;19;0;0;19
7871;Pumpurėlis;BITUTĖS;3231167303;Taip;0;1;0;1
7872;Pumpurėlis;DOBILIUKAI;1273831078;Taip;6;1;0;7
7873;Pumpurėlis;DOBILIUKAI;1264017142;Ne;0;0;2;2
7874;Pumpurėlis;DOBILIUKAI;98061041685;Taip;0;13;0;13
7875;Pumpurėlis;DOBILIUKAI;1287902351;Taip;0;5;0;5
7876;Pumpurėlis;DOBILIUKAI;1209654095;Taip;0;6;1;7
7877;Pumpurėlis;DOBILIUKAI;40267078306;Taip;0;10;6;16
7878;Pumpurėlis;DOBILIUKAI;51793437519;Taip;0;5;0;5
7879;Pumpurėlis;DOBILIUKAI;1921332565;Taip;4;0;1;5
7880;Pumpurėlis;DOBILIUKAI;1055683170;Taip;0;4;0;4
7881;Pumpurėlis;DOBILIUKAI;1620037477;Taip;0;14;0;14
7882;Pumpurėlis;DOBILIUKAI;1307929787;Taip;0;1;0;1
7883;Pumpurėlis;DOBILIUKAI;1511761574;Taip;0;12;0;12
7884;Pumpurėlis;DOBILIUKAI;1346602122;Taip;0;6;0;6
7885;Pumpurėlis;DOBILIUKAI;88732170322;Taip;0;2;0;2
7886;Pumpurėlis;DOBILIUKAI;94636926281;Ne;0;3;0;3
7887;Pumpurėlis;DOBILIUKAI;1027125361;Taip;0;1;0;1
7888;Pumpurėlis;DOBILIUKAI;77346378580;Taip;0;1;0;1
7889;Pumpurėlis;PUPYČIŲ;3214652626;Taip;0;0;1;1
7890;Pumpurėlis;PUPYČIŲ;2028068230;Taip;0;0;2;2
7891;Pumpurėlis;PUPYČIŲ;5587118874;Taip;0;0;1;1
7892;Pumpurėlis;PUPYČIŲ;7825190756;Taip;8;0;1;9
7893;Pumpurėlis;PUPYČIŲ;9058493247;Taip;11;0;0;11
7894;Pumpurėlis;PUPYČIŲ;3374174445;Taip;0;1;0;1
7895;Pumpurėlis;PUPYČIŲ;6307988067;Taip;0;0;1;1
7896;Pumpurėlis;PUPYČIŲ;1961282282;Taip;11;0;0;11
7897;Pumpurėlis;PUPYČIŲ;9509051946;Taip;0;3;0;3
7898;Pumpurėlis;PUPYČIŲ;5444879430;Taip;18;0;0;18
7899;Pumpurėlis;PUPYČIŲ;7276322999;Taip;7;0;0;7
7900;Pumpurėlis;PUPYČIŲ;1438740562;Taip;7;0;0;7
7901;Pumpurėlis;ŽIRNIUKŲ;1768239820;Taip;7;0;0;7
7902;Pumpurėlis;ŽIRNIUKŲ;7363814444;Taip;0;9;0;9
7903;Pumpurėlis;ŽIRNIUKŲ;4426697956;Taip;5;0;5;10
7904;Pumpurėlis;ŽIRNIUKŲ;1130280140;Taip;14;0;0;14
7905;Pumpurėlis;ŽIRNIUKŲ;3951445693;Taip;9;0;1;10
7906;Pumpurėlis;ŽIRNIUKŲ;9612924316;Taip;0;4;0;4
7907;Pumpurėlis;ŽIRNIUKŲ;8655389224;Taip;17;0;0;17
7908;Pumpurėlis;ŽIRNIUKŲ;4985045047;Taip;2;0;0;2
7909;Pumpurėlis;ŽIRNIUKŲ;3405169131;Taip;5;0;1;6
7910;Pumpurėlis;ŽIRNIUKŲ;1674341906;Taip;5;1;0;6
7911;Pumpurėlis;ŽIRNIUKŲ;2566557351;Taip;6;2;1;9
7912;Pumpurėlis;ŽIRNIUKŲ;5559833356;Taip;14;0;1;15
7913;Pumpurėlis;ŽIRNIUKŲ;2651037375;Taip;20;0;0;20
7914;Pumpurėlis;BORUŽĖLIŲ;49767198843;Taip;2;0;0;2
7915;Pumpurėlis;BORUŽĖLIŲ;42611228425;Ne;3;1;0;4
7916;Pumpurėlis;BORUŽĖLIŲ;68035717481;Taip;15;0;0;15
7917;Pumpurėlis;BORUŽĖLIŲ;1594436797;Taip;0;1;0;1
7918;Pumpurėlis;BORUŽĖLIŲ;1842097360;Taip;0;0;9;9
7919;Pumpurėlis;BORUŽĖLIŲ;82659096039;Taip;0;3;0;3
7920;Pumpurėlis;BORUŽĖLIŲ;1098875585;Ne;0;2;0;2
7921;Pumpurėlis;BORUŽĖLIŲ;1034745510;Taip;0;0;1;1
7922;Pumpurėlis;BORUŽĖLIŲ;5364345261;Taip;0;3;0;3
7923;Pumpurėlis;BORUŽĖLIŲ;1617303626;Taip;0;2;1;3
7924;Pumpurėlis;BORUŽĖLIŲ;1306102772;Taip;10;2;0;12
7925;Pumpurėlis;BORUŽĖLIŲ;1436627913;Taip;4;7;0;11
7926;Pumpurėlis;BORUŽĖLIŲ;1075914140;Ne;0;1;0;1
7927;Pumpurėlis;BORUŽĖLIŲ;2345116167;Taip;0;7;0;7
7928;Pumpurėlis;BORUŽĖLIŲ;63610860077;Taip;6;1;0;7
7929;Pumpurėlis;BORUŽĖLIŲ;1257222112;Ne;0;4;7;11
7930;Pumpurėlis;BORUŽĖLIŲ;1508245418;Ne;11;0;0;11
7931;Pumpurėlis;BORUŽĖLIŲ;81595634697;Taip;0;4;0;4
7932;Pumpurėlis;BORUŽĖLIŲ;1061975374;Taip;0;8;0;8
7933;Puriena;Ančiukų;5026857195;Taip;0;3;0;3
7934;Puriena;Ančiukų;88588968229;Taip;0;3;0;3
7935;Puriena;Ančiukų;1758690169;Taip;0;1;0;1
7936;Puriena;Ančiukų;25112307864;Taip;0;1;0;1
7937;Puriena;Ančiukų;1240190350;Taip;9;2;0;11
7938;Puriena;Ančiukų;19157486407;Taip;0;3;0;3
7939;Puriena;Ančiukų;1557814435;Taip;0;1;0;1
7940;Puriena;Ančiukų;87523460146;Taip;0;6;0;6
7941;Puriena;Ančiukų;61241768982;Taip;16;0;0;16
7942;Puriena;Ančiukų;26980342372;Taip;20;0;0;20
7943;Puriena;Ančiukų;4260334053;Taip;0;7;0;7
7944;Puriena;Ančiukų;71778035373;Taip;3;12;0;15
7945;Puriena;Ančiukų;1184946421;Taip;6;2;1;9
7946;Puriena;Ančiukų;59193676476;Taip;0;9;0;9
7947;Puriena;Ančiukų;61117212576;Taip;0;3;0;3
7948;Puriena;Ančiukų;91069175088;Taip;4;0;0;4
7949;Puriena;Ančiukų;16572830524;Taip;0;2;0;2
7950;Puriena;Ančiukų;18592085188;Taip;12;0;0;12
7951;Puriena;Ančiukų;1418776789;Ne;6;2;0;8
7952;Puriena;Ančiukų;3327714361;Taip;11;0;4;15
7953;Puriena;Ančiukų;41863686552;Taip;0;6;0;6
7954;Puriena;Drugeliai;83821680276;Taip;5;0;2;7
7955;Puriena;Drugeliai;7337038503;Taip;9;2;0;11
7956;Puriena;Drugeliai;47316276655;Taip;8;2;2;12
7957;Puriena;Drugeliai;48468411549;Taip;6;0;1;7
7958;Puriena;Drugeliai;20286870431;Ne;10;3;0;13
7959;Puriena;Drugeliai;63196502622;Taip;9;0;0;9
7960;Puriena;Drugeliai;11497629767;Taip;14;0;0;14
7961;Puriena;Drugeliai;2146036332;Taip;4;0;0;4
7962;Puriena;Drugeliai;1443945321;Taip;3;0;1;4
7963;Puriena;Drugeliai;1703078658;Taip;1;2;0;3
7964;Puriena;Drugeliai;2083071198;Taip;5;1;0;6
7965;Puriena;Drugeliai;8213725698;Taip;21;0;0;21
7966;Puriena;Drugeliai;2378865002;Taip;3;0;0;3
7967;Puriena;Drugeliai;5891404983;Ne;20;0;0;20
7968;Puriena;Drugeliai;9239618299;Taip;0;17;0;17
7969;Puriena;Drugeliai;2089174669;Taip;8;0;0;8
7970;Puriena;Drugeliai;2131343339;Taip;3;0;0;3
7971;Puriena;Drugeliai;1748337587;Taip;7;0;2;9
7972;Puriena;Drugeliai;8618298134;Taip;12;0;2;14
7973;Puriena;Drugeliai;8707076857;Taip;7;0;0;7
7974;Puriena;Drugeliai;1820719083;Taip;8;0;0;8
7975;Puriena;Pelėdžiukai;11431481909;Taip;0;5;0;5
7976;Puriena;Pelėdžiukai;53451774513;Taip;0;4;0;4
7977;Puriena;Pelėdžiukai;12499791115;Taip;0;2;0;2
7978;Puriena;Pelėdžiukai;54048579160;Taip;0;1;0;1
7979;Puriena;Pelėdžiukai;43490363874;Taip;0;3;0;3
7980;Puriena;Pelėdžiukai;34689084311;Taip;0;1;0;1
7981;Puriena;Pelėdžiukai;21611180390;Taip;10;2;0;12
7982;Puriena;Pelėdžiukai;15016729899;Taip;5;1;0;6
7983;Puriena;Pelėdžiukai;11677252767;Taip;0;1;0;1
7984;Puriena;Pelėdžiukai;16437608299;Taip;0;6;0;6
7985;Puriena;Pelėdžiukai;69494886505;Taip;0;1;0;1
7986;Puriena;Pelėdžiukai;95972862152;Taip;12;2;0;14
7987;Puriena;Pelėdžiukai;58791977007;Taip;0;2;0;2
7988;Puriena;Pelėdžiukai;53286108187;Taip;0;1;0;1
7989;Puriena;Pelėdžiukai;81806945761;Taip;0;12;0;12
7990;Puriena;Pelėdžiukai;43963341624;Ne;0;1;0;1
7991;Puriena;Pelėdžiukai;26040866189;Taip;0;1;0;1
7992;Puriena;Pelėdžiukai;90508354565;Taip;5;1;0;6
7993;Puriena;Pelėdžiukai;95822432988;Taip;0;6;0;6
7994;Puriena;Pelėdžiukai;45627148409;Taip;0;2;0;2
7995;Puriena;Pelėdžiukai;2011809589;Taip;0;2;0;2
7996;Puriena;Voveriukai;23746358787;Taip;0;1;0;1
7997;Puriena;Voveriukai;6285846517;Taip;0;3;0;3
7998;Puriena;Voveriukai;5501308683;Ne;5;1;0;6
7999;Puriena;Voveriukai;92604925140;Taip;5;1;0;6
8000;Puriena;Voveriukai;1263637124;Taip;0;5;0;5
8001;Puriena;Voveriukai;1290933817;Taip;11;1;0;12
8002;Puriena;Voveriukai;7429832136;Taip;14;0;0;14
8003;Puriena;Voveriukai;2663832596;Taip;0;3;0;3
8004;Puriena;Voveriukai;2203259310;Taip;0;0;2;2
8005;Puriena;Voveriukai;40573980976;Taip;0;6;0;6
8006;Puriena;Voveriukai;1381379515;Taip;8;2;0;10
8007;Puriena;Voveriukai;1290962809;Taip;10;7;0;17
8008;Puriena;Voveriukai;11242620566;Ne;0;2;2;4
8009;Puriena;Voveriukai;9139110598;Ne;7;1;0;8
8010;Puriena;Voveriukai;8112003551;Taip;6;0;0;6
8011;Puriena;Voveriukai;9106525954;Taip;10;0;0;10
8012;Puriena;Voveriukai;5999564879;Ne;9;1;0;10
8013;Puriena;Voveriukai;9146447088;Taip;2;1;0;3
8014;Puriena;Voveriukai;8478901457;Taip;6;0;2;8
8015;Puriena;Voveriukai;5257713434;Taip;8;0;0;8
8016;Puriena;Voveriukai;4647433927;Taip;8;0;0;8
8017;Puriena;Bitučių;71773966341;Taip;0;0;16;16
8018;Puriena;Bitučių;1945542034;Taip;0;5;0;5
8019;Puriena;Bitučių;79194353091;Taip;5;2;0;7
8020;Puriena;Bitučių;1629458651;Taip;7;1;0;8
8021;Puriena;Bitučių;91735621242;Taip;10;2;0;12
8022;Puriena;Bitučių;1116529845;Taip;0;0;4;4
8023;Puriena;Bitučių;98967026878;Taip;1;0;0;1
8024;Puriena;Bitučių;5284316470;Taip;5;2;0;7
8025;Puriena;Bitučių;84527348236;Ne;10;4;0;14
8026;Puriena;Bitučių;24572685191;Taip;8;0;0;8
8027;Puriena;Bitučių;8719239663;Taip;5;2;0;7
8028;Puriena;Bitučių;63944407195;Ne;0;1;0;1
8029;Puriena;Bitučių;95153406240;Taip;0;2;2;4
8030;Puriena;Bitučių;1125102675;Ne;7;0;0;7
8031;Puriena;Bitučių;29217326976;Taip;0;16;0;16
8032;Puriena;Bitučių;9666714143;Taip;0;2;0;2
8033;Puriena;Bitučių;1376708741;Taip;8;1;0;9
8034;Puriena;Bitučių;1507059980;Taip;2;4;0;6
8035;Puriena;Bitučių;5807510456;Taip;0;1;0;1
8036;Puriena;Bitučių;85334594528;Taip;0;2;0;2
8037;Puriena;Bitučių;1206969296;Taip;0;2;5;7
8038;Puriena;Zylutės;1892751625;Taip;0;5;0;5
8039;Puriena;Zylutės;37213422962;Ne;2;2;0;4
8040;Puriena;Zylutės;29931607789;Ne;0;5;0;5
8041;Puriena;Zylutės;14052847763;Taip;0;1;0;1
8042;Puriena;Zylutės;46510003255;Taip;2;2;0;4
8043;Puriena;Zylutės;64733952400;Ne;0;2;0;2
8044;Puriena;Zylutės;1993142891;Ne;9;1;0;10
8045;Puriena;Zylutės;6539425730;Taip;4;1;0;5
8046;Puriena;Zylutės;88483773966;Taip;5;2;0;7
8047;Puriena;Zylutės;61706928693;Taip;6;1;0;7
8048;Puriena;Zylutės;45128021817;Ne;0;4;0;4
8049;Puriena;Zylutės;7285127722;Ne;0;2;0;2
8050;Puriena;Zylutės;87711542948;Taip;6;1;0;7
8051;Puriena;Zylutės;50199557129;Taip;3;0;0;3
8052;Puriena;Zylutės;88595039240;Ne;0;4;0;4
8053;Puriena;Zylutės;65137815385;Taip;0;3;0;3
8054;Puriena;Zylutės;14780389529;Taip;0;1;0;1
8055;Puriena;Zylutės;54604607448;Taip;0;1;0;1
8056;Puriena;Zylutės;1994224209;Taip;0;1;0;1
8057;Puriena;Zylutės;27546501673;Taip;0;1;0;1
8058;Puriena;Meškučių;9251058353;Ne;16;0;0;16
8059;Puriena;Meškučių;1030958414;Taip;15;0;4;19
8060;Puriena;Meškučių;7967288875;Taip;16;0;0;16
8061;Puriena;Meškučių;6158842119;Taip;0;21;0;21
8062;Puriena;Meškučių;3557013127;Taip;0;3;0;3
8063;Puriena;Meškučių;3681811493;Taip;4;2;1;7
8064;Puriena;Meškučių;4060087185;Taip;0;8;0;8
8065;Puriena;Meškučių;3033562627;Taip;0;4;3;7
8066;Puriena;Meškučių;5777076971;Taip;0;4;3;7
8067;Puriena;Meškučių;8310231540;Taip;0;6;0;6
8068;Puriena;Meškučių;4460575818;Taip;5;0;1;6
8069;Puriena;Meškučių;8120597514;Taip;0;7;0;7
8070;Puriena;Meškučių;5336923102;Taip;0;2;0;2
8071;Puriena;Meškučių;4605662701;Taip;14;3;0;17
8072;Puriena;Meškučių;1819876614;Taip;0;2;4;6
8073;Puriena;Meškučių;4776745276;Taip;16;0;1;17
8074;Puriena;Meškučių;7769252165;Taip;0;2;1;3
8075;Puriena;Meškučių;2170025682;Taip;6;0;0;6
8076;Puriena;Meškučių;3772941726;Taip;8;3;0;11
8077;Puriena;Meškučių;1428098802;Taip;8;3;0;11
8078;Puriena;Nykštukų;8237149969;Taip;3;0;0;3
8079;Puriena;Nykštukų;8416003733;Taip;0;2;2;4
8080;Puriena;Nykštukų;5224135638;Taip;17;0;0;17
8081;Puriena;Nykštukų;9209209113;Taip;10;0;2;12
8082;Puriena;Nykštukų;4017644414;Ne;0;2;7;9
8083;Puriena;Nykštukų;6780164845;Taip;16;0;2;18
8084;Puriena;Nykštukų;1398572100;Taip;10;0;2;12
8085;Puriena;Nykštukų;9962011647;Taip;0;0;1;1
8086;Puriena;Nykštukų;1339162214;Taip;10;2;0;12
8087;Puriena;Nykštukų;7573536525;Taip;11;0;0;11
8088;Puriena;Nykštukų;8022809059;Taip;16;0;0;16
8089;Puriena;Nykštukų;5395382717;Taip;11;10;0;21
8090;Puriena;Nykštukų;4444523140;Taip;5;2;5;12
8091;Puriena;Nykštukų;7622407056;Taip;6;0;0;6
8092;Puriena;Nykštukų;6813480086;Taip;10;2;0;12
8093;Puriena;Nykštukų;9854244405;Taip;6;2;0;8
8094;Puriena;Nykštukų;4498919764;Taip;12;0;0;12
8095;Puriena;Nykštukų;1175665781;Taip;5;0;1;6
8096;Puriena;Ežiukai;1704296685;Taip;0;2;0;2
8097;Puriena;Ežiukai;1174355613;Taip;6;1;0;7
8098;Puriena;Ežiukai;2255508780;Taip;0;4;0;4
8099;Puriena;Ežiukai;35226601932;Taip;3;1;0;4
8100;Puriena;Ežiukai;2072874096;Taip;11;2;0;13
8101;Puriena;Ežiukai;11011727269;Taip;0;4;0;4
8102;Puriena;Ežiukai;87416314075;Taip;0;0;3;3
8103;Puriena;Ežiukai;1175577834;Taip;0;2;2;4
8104;Puriena;Ežiukai;1134539790;Taip;0;3;5;8
8105;Puriena;Ežiukai;9471669903;Taip;5;1;1;7
8106;Puriena;Ežiukai;1707413291;Taip;0;2;0;2
8107;Puriena;Ežiukai;1773431155;Taip;0;1;0;1
8108;Puriena;Ežiukai;1710087159;Taip;0;1;0;1
8109;Puriena;Ežiukai;21180207545;Taip;0;6;3;9
8110;Puriena;Ežiukai;1762395617;Taip;0;3;0;3
8111;Puriena;Ežiukai;2560477213;Taip;2;1;0;3
8112;Puriena;Ežiukai;1786569222;Taip;0;7;0;7
8113;Puriena;Ežiukai;4792538031;Taip;0;2;0;2
8114;Puriena;"Boružiukų ";8061605125;Taip;6;1;0;7
8115;Puriena;"Boružiukų ";5619637663;Taip;13;0;0;13
8116;Puriena;"Boružiukų ";4858971990;Taip;13;1;0;14
8117;Puriena;"Boružiukų ";2701942325;Taip;1;6;0;7
8118;Puriena;"Boružiukų ";4608801156;Taip;0;1;0;1
8119;Puriena;"Boružiukų ";6463129806;Taip;7;6;0;13
8120;Puriena;"Boružiukų ";4501239330;Taip;7;0;0;7
8121;Puriena;"Boružiukų ";6197840105;Taip;18;0;0;18
8122;Puriena;"Boružiukų ";3175917649;Taip;0;0;3;3
8123;Puriena;"Boružiukų ";6786694796;Taip;21;0;0;21
8124;Puriena;"Boružiukų ";1417566073;Taip;13;0;1;14
8125;Puriena;"Boružiukų ";3671297035;Taip;9;0;1;10
8126;Puriena;"Boružiukų ";6352605894;Ne;5;0;0;5
8127;Puriena;"Boružiukų ";2579402981;Taip;17;0;0;17
8128;Puriena;"Boružiukų ";6413337915;Taip;6;1;0;7
8129;Puriena;"Boružiukų ";5341228269;Taip;15;0;0;15
8130;Puriena;"Zuikučių ";6883573289;Taip;11;10;0;21
8131;Puriena;"Zuikučių ";7120683581;Taip;13;1;0;14
8132;Puriena;"Zuikučių ";8144488922;Taip;0;0;2;2
8133;Puriena;"Zuikučių ";4283608124;Taip;0;1;0;1
8134;Puriena;"Zuikučių ";8130975863;Taip;10;0;0;10
8135;Puriena;"Zuikučių ";2813562677;Taip;2;1;1;4
8136;Puriena;"Zuikučių ";3542374463;Taip;4;2;0;6
8137;Puriena;"Zuikučių ";1933733714;Taip;10;8;0;18
8138;Puriena;"Zuikučių ";6150437624;Taip;3;0;0;3
8139;Puriena;"Zuikučių ";4070825932;Taip;5;0;4;9
8140;Puriena;"Zuikučių ";4653085762;Taip;16;0;0;16
8141;Puriena;"Zuikučių ";8952508230;Taip;14;0;0;14
8142;Puriena;"Zuikučių ";7169054113;Ne;0;1;0;1
8143;Puriena;"Zuikučių ";8476986855;Taip;0;3;0;3
8144;Puriena;"Zuikučių ";3309219271;Taip;0;11;1;12
8145;Pušaitė;Kodėlčiukai;44525744411;Taip;6;0;0;6
8146;Pušaitė;Kodėlčiukai;1434600898;Ne;0;4;0;4
8147;Pušaitė;Kodėlčiukai;92087943993;Ne;0;1;0;1
8148;Pušaitė;Kodėlčiukai;79462284429;Taip;0;2;0;2
8149;Pušaitė;Kodėlčiukai;51875651426;Taip;7;1;0;8
8150;Pušaitė;Kodėlčiukai;35587797387;Taip;0;0;5;5
8151;Pušaitė;Kodėlčiukai;12300222260;Ne;0;1;0;1
8152;Pušaitė;Kodėlčiukai;37480908997;Taip;0;1;0;1
8153;Pušaitė;Kodėlčiukai;81773729142;Taip;8;0;0;8
8154;Pušaitė;Kodėlčiukai;15593642938;Taip;0;1;0;1
8155;Pušaitė;Kodėlčiukai;10955132610;Taip;0;0;7;7
8156;Pušaitė;Kodėlčiukai;7680945149;Taip;0;2;1;3
8157;Pušaitė;Kodėlčiukai;89687717250;Taip;8;2;2;12
8158;Pušaitė;Kodėlčiukai;36677285052;Taip;1;2;1;4
8159;Pušaitė;Kodėlčiukai;3554790718;Taip;0;0;2;2
8160;Pušaitė;Kodėlčiukai;1912176781;Taip;0;4;0;4
8161;Pušaitė;Kodėlčiukai;20960105409;Taip;20;1;0;21
8162;Pušaitė;Kodėlčiukai;95522616207;Taip;0;0;1;1
8163;Pušaitė;Kodėlčiukai;66025911973;Taip;0;1;0;1
8164;Pušaitė;Saulutės;58885325641;Taip;5;1;0;6
8165;Pušaitė;Saulutės;29899199427;Taip;0;3;0;3
8166;Pušaitė;Saulutės;36646217833;Taip;6;4;4;14
8167;Pušaitė;Saulutės;40449072854;Taip;4;1;0;5
8168;Pušaitė;Saulutės;46097491628;Taip;0;8;0;8
8169;Pušaitė;Saulutės;34210048269;Taip;8;2;0;10
8170;Pušaitė;Saulutės;2066639203;Taip;0;7;0;7
8171;Pušaitė;Saulutės;99740435577;Ne;6;1;0;7
8172;Pušaitė;Saulutės;34324686486;Taip;0;3;1;4
8173;Pušaitė;Saulutės;88286687854;Taip;0;5;0;5
8174;Pušaitė;Saulutės;1302087452;Taip;0;3;3;6
8175;Pušaitė;Saulutės;12326544543;Taip;0;1;0;1
8176;Pušaitė;Saulutės;61624123734;Taip;10;1;0;11
8177;Pušaitė;Saulutės;10115195053;Taip;0;1;4;5
8178;Pušaitė;Saulutės;22491605433;Taip;0;2;0;2
8179;Pušaitė;Saulutės;81155033460;Taip;0;1;0;1
8180;Pušaitė;Saulutės;1389123203;Taip;0;1;1;2
8181;Pušaitė;Saulutės;2030939996;Ne;0;2;0;2
8182;Pušaitė;Saulutės;1444313482;Taip;0;7;0;7
8183;Pušaitė;Zuikučiai;2115591523;Taip;0;0;7;7
8184;Pušaitė;Zuikučiai;8738827821;Taip;5;0;2;7
8185;Pušaitė;Zuikučiai;2181510181;Taip;0;2;0;2
8186;Pušaitė;Zuikučiai;7477429922;Taip;0;3;0;3
8187;Pušaitė;Zuikučiai;2099169654;Taip;0;0;4;4
8188;Pušaitė;Zuikučiai;6355379926;Ne;0;0;2;2
8189;Pušaitė;Zuikučiai;9389544351;Taip;0;21;0;21
8190;Pušaitė;Zuikučiai;80743691769;Taip;0;0;1;1
8191;Pušaitė;Zuikučiai;1296700534;Taip;5;0;3;8
8192;Pušaitė;Zuikučiai;51500717235;Taip;0;21;0;21
8193;Pušaitė;Zuikučiai;5398532705;Taip;0;9;0;9
8194;Pušaitė;Zuikučiai;8309000712;Taip;0;6;2;8
8195;Pušaitė;Zuikučiai;3813761666;Ne;0;0;18;18
8196;Pušaitė;Zuikučiai;4762094720;Taip;0;0;2;2
8197;Pušaitė;Zuikučiai;6600314608;Taip;17;0;0;17
8198;Pušaitė;Zuikučiai;2130767942;Taip;0;21;0;21
8199;Pušaitė;Vėžliukai;1386420328;Taip;0;1;6;7
8200;Pušaitė;Vėžliukai;1863885754;Taip;1;0;5;6
8201;Pušaitė;Vėžliukai;4050198577;Taip;10;1;4;15
8202;Pušaitė;Vėžliukai;1412632976;Taip;0;1;5;6
8203;Pušaitė;Vėžliukai;8361761447;Taip;9;1;0;10
8204;Pušaitė;Vėžliukai;97738851561;Taip;0;1;4;5
8205;Pušaitė;Vėžliukai;1502634518;Taip;0;1;5;6
8206;Pušaitė;Vėžliukai;57025420993;Taip;0;0;1;1
8207;Pušaitė;Vėžliukai;73291156409;Taip;0;0;5;5
8208;Pušaitė;Vėžliukai;5262505407;Ne;0;1;9;10
8209;Pušaitė;Vėžliukai;1569413876;Taip;13;0;0;13
8210;Pušaitė;Vėžliukai;2892138891;Taip;0;1;7;8
8211;Pušaitė;Vėžliukai;3745881982;Taip;0;5;0;5
8212;Pušaitė;Vėžliukai;3577616212;Taip;1;0;1;2
8213;Pušaitė;Vėžliukai;8155746120;Taip;0;0;5;5
8214;Pušaitė;Vėžliukai;6752676513;Taip;9;0;0;9
8215;Pušaitė;Vėžliukai;1972872969;Taip;0;21;0;21
8216;Pušaitė;Vėžliukai;2856902024;Taip;0;21;0;21
8217;Pušaitė;Vėžliukai;1878172874;Ne;1;0;0;1
8218;Pušaitė;"Linksmieji nykštukai";9265357004;Taip;0;11;0;11
8219;Pušaitė;"Linksmieji nykštukai";3150144924;Taip;4;6;0;10
8220;Pušaitė;"Linksmieji nykštukai";7520393710;Taip;0;2;0;2
8221;Pušaitė;"Linksmieji nykštukai";4517181474;Ne;0;3;0;3
8222;Pušaitė;"Linksmieji nykštukai";9033615485;Taip;7;0;0;7
8223;Pušaitė;"Linksmieji nykštukai";3130824742;Taip;8;0;0;8
8224;Pušaitė;"Linksmieji nykštukai";4605161267;Taip;0;7;0;7
8225;Pušaitė;"Linksmieji nykštukai";6160825713;Taip;3;1;1;5
8226;Pušaitė;"Linksmieji nykštukai";1781601521;Taip;0;1;0;1
8227;Pušaitė;"Linksmieji nykštukai";1024996364;Taip;3;0;3;6
8228;Pušaitė;"Linksmieji nykštukai";4662871524;Taip;4;2;0;6
8229;Pušaitė;"Linksmieji nykštukai";8438652029;Taip;6;0;0;6
8230;Pušaitė;"Linksmieji nykštukai";6578483902;Taip;0;0;1;1
8231;Pušaitė;"Linksmieji nykštukai";3350461304;Ne;0;1;0;1
8232;Pušaitė;"Linksmieji nykštukai";9327636862;Taip;3;3;2;8
8233;Pušaitė;"Linksmieji nykštukai";4175909754;Taip;0;7;0;7
8234;Pušaitė;"Linksmieji nykštukai";3788392895;Taip;5;0;1;6
8235;Pušaitė;"Linksmieji nykštukai";3195191374;Taip;0;1;0;1
8236;Pušaitė;"Linksmieji nykštukai";9127444013;Taip;0;1;1;2
8237;Pušaitė;"Linksmieji nykštukai";5422784898;Taip;11;0;1;12
8238;Pušaitė;"Linksmieji nykštukai";5104111840;Taip;7;0;1;8
8239;Pušaitė;"Linksmieji nykštukai";9866431097;Taip;13;0;0;13
8240;Pušaitė;"Kačiukų trobelė";3695016765;Taip;10;0;0;10
8241;Pušaitė;"Kačiukų trobelė";5415680731;Taip;0;21;0;21
8242;Pušaitė;"Kačiukų trobelė";7983115812;Taip;0;2;0;2
8243;Pušaitė;"Kačiukų trobelė";1122112207;Taip;0;6;4;10
8244;Pušaitė;"Kačiukų trobelė";1635528919;Taip;4;0;2;6
8245;Pušaitė;"Kačiukų trobelė";2837439334;Taip;8;0;0;8
8246;Pušaitė;"Kačiukų trobelė";8793102437;Ne;0;14;0;14
8247;Pušaitė;"Kačiukų trobelė";9056933586;Taip;5;6;0;11
8248;Pušaitė;"Kačiukų trobelė";7898355721;Taip;5;0;1;6
8249;Pušaitė;"Kačiukų trobelė";4374232593;Taip;0;1;2;3
8250;Pušaitė;"Kačiukų trobelė";6323180798;Taip;0;0;1;1
8251;Pušaitė;"Kačiukų trobelė";5191894075;Taip;0;18;0;18
8252;Pušaitė;"Kačiukų trobelė";1161519408;Taip;0;21;0;21
8253;Pušaitė;"Kačiukų trobelė";8822285103;Taip;6;1;0;7
8254;Pušaitė;"Kačiukų trobelė";9313564235;Taip;16;0;0;16
8255;Pušaitė;"Kačiukų trobelė";5564338170;Taip;21;0;0;21
8256;Pušaitė;"Kačiukų trobelė";2865062081;Taip;5;0;0;5
8257;Pušaitė;Ežiukai;2090143259;Taip;0;0;2;2
8258;Pušaitė;Ežiukai;9524002395;Taip;1;1;1;3
8259;Pušaitė;Ežiukai;7305350540;Ne;0;21;0;21
8260;Pušaitė;Ežiukai;1111143593;Taip;5;3;1;9
8261;Pušaitė;Ežiukai;5394378197;Taip;9;0;0;9
8262;Pušaitė;Ežiukai;15270671089;Taip;0;1;0;1
8263;Pušaitė;Ežiukai;69869396094;Taip;0;3;2;5
8264;Pušaitė;Ežiukai;3359574190;Taip;0;1;0;1
8265;Pušaitė;Ežiukai;1143122778;Taip;0;1;2;3
8266;Pušaitė;Ežiukai;9461292576;Taip;3;6;0;9
8267;Pušaitė;Ežiukai;5185787803;Taip;6;1;1;8
8268;Pušaitė;Ežiukai;4671293211;Taip;0;2;0;2
8269;Pušaitė;Ežiukai;8958364766;Taip;9;0;0;9
8270;Pušaitė;Ežiukai;2983890410;Taip;4;1;0;5
8271;Pušaitė;Ežiukai;7575143890;Taip;0;1;2;3
8272;Pušaitė;Ežiukai;7808186865;Taip;0;9;1;10
8273;Pušaitė;Ežiukai;4842783897;Taip;6;1;0;7
8274;Pušaitė;Ežiukai;5436168234;Taip;9;0;1;10
8275;Pušaitė;Ežiukai;6472169278;Ne;0;2;0;2
8276;Pušaitė;Ežiukai;8021494509;Taip;0;21;0;21
8277;Pušaitė;Ežiukai;2172342063;Taip;19;2;0;21
8278;Pušaitė;"Gudručių šalis";6470721291;Taip;0;1;0;1
8279;Pušaitė;"Gudručių šalis";24768657107;Taip;0;1;0;1
8280;Pušaitė;"Gudručių šalis";55304000825;Taip;0;1;0;1
8281;Pušaitė;"Gudručių šalis";15550007793;Taip;5;1;3;9
8282;Pušaitė;"Gudručių šalis";4386242143;Taip;9;2;1;12
8283;Pušaitė;"Gudručių šalis";9997642887;Taip;0;4;2;6
8284;Pušaitė;"Gudručių šalis";15546035138;Taip;0;2;0;2
8285;Pušaitė;"Gudručių šalis";1275885492;Taip;0;3;3;6
8286;Pušaitė;"Gudručių šalis";40886746431;Taip;0;0;4;4
8287;Pušaitė;"Gudručių šalis";90178990466;Taip;0;0;3;3
8288;Pušaitė;"Gudručių šalis";89985930634;Taip;12;0;0;12
8289;Pušaitė;"Gudručių šalis";4266368627;Ne;0;2;4;6
8290;Pušaitė;"Gudručių šalis";49973513385;Taip;0;1;0;1
8291;Pušaitė;"Gudručių šalis";89212112638;Taip;0;5;3;8
8292;Pušaitė;"Gudručių šalis";11297426946;Taip;7;0;0;7
8293;Pušaitė;"Gudručių šalis";67365323950;Taip;0;1;0;1
8294;Pušaitė;"Gudručių šalis";35947321028;Taip;0;21;0;21
8295;Pušaitė;"Gudručių šalis";87504481892;Ne;0;1;0;1
8296;Pušaitė;"Gudručių šalis";6915619931;Ne;0;2;0;2
8297;Pušaitė;"Gudručių šalis";41026183089;Taip;0;1;0;1
8298;Pušaitė;"Lapučių mokyklėlė";1102988768;Taip;0;1;0;1
8299;Pušaitė;"Lapučių mokyklėlė";40417586835;Taip;0;2;0;2
8300;Pušaitė;"Lapučių mokyklėlė";91960884985;Taip;6;0;0;6
8301;Pušaitė;"Lapučių mokyklėlė";60394388920;Taip;0;2;0;2
8302;Pušaitė;"Lapučių mokyklėlė";2044213583;Taip;0;21;0;21
8303;Pušaitė;"Lapučių mokyklėlė";1394847204;Taip;0;2;0;2
8304;Pušaitė;"Lapučių mokyklėlė";97778827111;Taip;0;6;0;6
8305;Pušaitė;"Lapučių mokyklėlė";21992678312;Taip;0;1;0;1
8306;Pušaitė;"Lapučių mokyklėlė";6667124375;Taip;0;1;0;1
8307;Pušaitė;"Lapučių mokyklėlė";77082825248;Taip;4;1;1;6
8308;Pušaitė;"Lapučių mokyklėlė";1487637695;Taip;0;1;0;1
8309;Pušaitė;"Lapučių mokyklėlė";53766202712;Taip;10;2;0;12
8310;Pušaitė;"Lapučių mokyklėlė";3231637165;Taip;0;1;0;1
8311;Pušaitė;"Lapučių mokyklėlė";6542917863;Taip;0;7;0;7
8312;Pušaitė;"Lapučių mokyklėlė";9179757395;Taip;0;1;0;1
8313;Pušaitė;"Lapučių mokyklėlė";8470059012;Ne;0;1;0;1
8314;Pušaitė;"Lapučių mokyklėlė";9031044414;Taip;0;0;21;21
8315;Pušaitė;"Lapučių mokyklėlė";1798044901;Ne;5;0;0;5
8316;Pušaitė;"Lapučių mokyklėlė";7251064118;Taip;0;4;0;4
8317;Pušaitė;"VOVERIUKAI ";8135552679;Taip;10;0;0;10
8318;Pušaitė;"VOVERIUKAI ";1978339054;Taip;0;0;1;1
8319;Pušaitė;"VOVERIUKAI ";9414554800;Taip;0;9;0;9
8320;Pušaitė;"VOVERIUKAI ";5569407817;Taip;6;15;0;21
8321;Pušaitė;"VOVERIUKAI ";8775608339;Taip;21;0;0;21
8322;Pušaitė;"VOVERIUKAI ";1326581025;Taip;0;12;0;12
8323;Pušaitė;"VOVERIUKAI ";5161142520;Taip;18;0;0;18
8324;Pušaitė;"VOVERIUKAI ";3014867515;Taip;6;1;0;7
8325;Pušaitė;"VOVERIUKAI ";9527253696;Taip;7;0;0;7
8326;Pušaitė;"VOVERIUKAI ";3485234259;Taip;9;0;1;10
8327;Pušaitė;"VOVERIUKAI ";4473930703;Taip;10;0;4;14
8328;Pušaitė;"VOVERIUKAI ";1996544496;Taip;17;0;0;17
8329;Pušaitė;"VOVERIUKAI ";6739253961;Taip;14;0;0;14
8330;Pušaitė;"VOVERIUKAI ";8412276797;Taip;5;0;0;5
8331;Pušaitė;"VOVERIUKAI ";9470667227;Taip;4;0;0;4
8332;Pušaitė;MEŠKUČIAI;8702361596;Ne;0;0;1;1
8333;Pušaitė;MEŠKUČIAI;3014180020;Taip;0;1;6;7
8334;Pušaitė;MEŠKUČIAI;7890577174;Taip;10;1;0;11
8335;Pušaitė;MEŠKUČIAI;2253477550;Taip;7;6;0;13
8336;Pušaitė;MEŠKUČIAI;4103149433;Taip;0;18;3;21
8337;Pušaitė;MEŠKUČIAI;6186545163;Taip;7;2;0;9
8338;Pušaitė;MEŠKUČIAI;4838345510;Taip;0;3;0;3
8339;Pušaitė;MEŠKUČIAI;7068451014;Ne;2;0;0;2
8340;Pušaitė;MEŠKUČIAI;5281161835;Taip;11;0;0;11
8341;Pušaitė;MEŠKUČIAI;6275090953;Taip;5;1;0;6
8342;Pušaitė;MEŠKUČIAI;7117784038;Taip;5;16;0;21
8343;Pušaitė;MEŠKUČIAI;4747611989;Taip;0;20;1;21
8344;Pušaitė;MEŠKUČIAI;8750774616;Taip;21;0;0;21
8345;Pušaitė;MEŠKUČIAI;3832434608;Taip;0;0;2;2
8346;Pušaitė;PELIUKAI;3698808100;Ne;11;0;0;11
8347;Pušaitė;PELIUKAI;6833083982;Taip;0;0;1;1
8348;Pušaitė;PELIUKAI;2793941689;Taip;0;1;0;1
8349;Pušaitė;PELIUKAI;6445790780;Taip;6;0;0;6
8350;Pušaitė;PELIUKAI;2004615252;Taip;18;0;0;18
8351;Pušaitė;PELIUKAI;6794867560;Taip;0;0;1;1
8352;Pušaitė;PELIUKAI;5296435012;Taip;5;0;2;7
8353;Pušaitė;PELIUKAI;8399589954;Taip;7;0;0;7
8354;Pušaitė;PELIUKAI;4615270419;Taip;11;0;0;11
8355;Pušaitė;PELIUKAI;7652706756;Taip;0;2;0;2
8356;Pušaitė;PELIUKAI;4743105731;Taip;8;0;0;8
8357;Pušaitė;PELIUKAI;5318602924;Taip;6;0;3;9
8358;Pušaitė;PELIUKAI;7945713337;Taip;11;1;1;13
8359;Pušaitė;PELIUKAI;1935059739;Taip;10;11;0;21
8360;Pušaitė;PELIUKAI;9364887123;Taip;6;0;0;6
8361;Pušaitė;PELIUKAI;6180888008;Taip;7;3;0;10
8362;Pušaitė;PELIUKAI;9391350218;Taip;0;2;0;2
8363;Pušynėlis;PUMPURĖLIAI;7177725663;Taip;0;17;0;17
8364;Pušynėlis;PUMPURĖLIAI;1891728904;Ne;0;2;2;4
8365;Pušynėlis;PUMPURĖLIAI;3100230874;Taip;0;11;0;11
8366;Pušynėlis;PUMPURĖLIAI;1102029570;Taip;0;0;2;2
8367;Pušynėlis;PUMPURĖLIAI;4030500100;Taip;0;1;0;1
8368;Pušynėlis;PUMPURĖLIAI;8172450090;Taip;0;1;0;1
8369;Pušynėlis;PUMPURĖLIAI;9039274775;Taip;9;0;1;10
8370;Pušynėlis;PUMPURĖLIAI;6077698697;Taip;0;0;1;1
8371;Pušynėlis;PUMPURĖLIAI;7046421581;Taip;0;0;5;5
8372;Pušynėlis;PUMPURĖLIAI;7729392498;Taip;5;7;3;15
8373;Pušynėlis;PUMPURĖLIAI;4380948433;Taip;0;2;2;4
8374;Pušynėlis;PUMPURĖLIAI;4668634909;Ne;0;0;1;1
8375;Pušynėlis;PUMPURĖLIAI;1610132076;Taip;0;0;3;3
8376;Pušynėlis;PUMPURĖLIAI;2793982816;Ne;10;1;2;13
8377;Pušynėlis;PUMPURĖLIAI;4920818548;Taip;13;1;7;21
8378;Pušynėlis;PUMPURĖLIAI;2508640229;Taip;10;0;0;10
8379;Pušynėlis;PUMPURĖLIAI;5236219294;Taip;0;0;20;20
8380;Pušynėlis;PUMPURĖLIAI;4052132379;Taip;0;1;0;1
8381;Pušynėlis;PUMPURĖLIAI;8451160808;Ne;10;0;0;10
8382;Pušynėlis;PUMPURĖLIAI;2141785580;Ne;1;1;0;2
8383;Pušynėlis;PUMPURĖLIAI;6560054869;Taip;0;2;0;2
8384;Pušynėlis;SAULUTĖS;1118012248;Ne;0;0;1;1
8385;Pušynėlis;SAULUTĖS;48050606382;Taip;0;0;3;3
8386;Pušynėlis;SAULUTĖS;74952593070;Taip;15;0;0;15
8387;Pušynėlis;SAULUTĖS;1610449906;Taip;0;8;0;8
8388;Pušynėlis;SAULUTĖS;51835639636;Ne;0;6;0;6
8389;Pušynėlis;SAULUTĖS;1811758590;Taip;16;0;0;16
8390;Pušynėlis;SAULUTĖS;9192206804;Taip;0;0;2;2
8391;Pušynėlis;SAULUTĖS;3037031809;Taip;0;0;2;2
8392;Pušynėlis;SAULUTĖS;25261143142;Taip;0;5;0;5
8393;Pušynėlis;SAULUTĖS;6549217377;Taip;21;0;0;21
8394;Pušynėlis;SAULUTĖS;2048377076;Taip;0;0;6;6
8395;Pušynėlis;SAULUTĖS;9466109315;Taip;0;0;5;5
8396;Pušynėlis;SAULUTĖS;23816147491;Ne;0;6;2;8
8397;Pušynėlis;SAULUTĖS;9154108688;Taip;2;0;0;2
8398;Pušynėlis;SAULUTĖS;2012089695;Taip;5;0;2;7
8399;Pušynėlis;SAULUTĖS;1284674882;Taip;8;5;0;13
8400;Pušynėlis;SAULUTĖS;35538053975;Taip;0;2;0;2
8401;Pušynėlis;SAULUTĖS;1573574250;Taip;0;1;0;1
8402;Pušynėlis;SAULUTĖS;76597184985;Taip;0;0;1;1
8403;Pušynėlis;SAULUTĖS;3510202379;Ne;0;0;5;5
8404;Pušynėlis;SAULUTĖS;1817179601;Taip;19;0;0;19
8405;Pušynėlis;SAULUTĖS;9665845150;Ne;0;2;0;2
8406;Pušynėlis;SAULUTĖS;2765869141;Taip;0;0;3;3
8407;Pušynėlis;PRIEŠMOKYKLINĖ;3527543120;Ne;0;0;1;1
8408;Pušynėlis;PRIEŠMOKYKLINĖ;6862900911;Taip;0;1;4;5
8409;Pušynėlis;PRIEŠMOKYKLINĖ;4291894982;Taip;16;1;0;17
8410;Pušynėlis;PRIEŠMOKYKLINĖ;16192036601;Taip;5;1;0;6
8411;Pušynėlis;PRIEŠMOKYKLINĖ;93484950406;Ne;5;1;2;8
8412;Pušynėlis;PRIEŠMOKYKLINĖ;1955967062;Taip;6;7;1;14
8413;Pušynėlis;PRIEŠMOKYKLINĖ;79386112020;Taip;0;1;0;1
8414;Pušynėlis;PRIEŠMOKYKLINĖ;2042833795;Taip;0;2;0;2
8415;Pušynėlis;PRIEŠMOKYKLINĖ;58252435610;Taip;0;1;1;2
8416;Pušynėlis;PRIEŠMOKYKLINĖ;51866074822;Taip;0;1;0;1
8417;Pušynėlis;PRIEŠMOKYKLINĖ;75716791245;Taip;0;1;1;2
8418;Pušynėlis;PRIEŠMOKYKLINĖ;39796631884;Taip;7;4;0;11
8419;Pušynėlis;PRIEŠMOKYKLINĖ;1863758087;Taip;0;2;0;2
8420;Pušynėlis;PRIEŠMOKYKLINĖ;91759717760;Taip;0;6;0;6
8421;Pušynėlis;PRIEŠMOKYKLINĖ;2431940444;Taip;0;7;0;7
8422;Pušynėlis;PRIEŠMOKYKLINĖ;40478713455;Taip;1;6;0;7
8423;Pušynėlis;PRIEŠMOKYKLINĖ;1415916851;Taip;13;1;0;14
8424;Pušynėlis;PRIEŠMOKYKLINĖ;1367922475;Taip;15;1;0;16
8425;Pušynėlis;PRIEŠMOKYKLINĖ;1585572669;Taip;0;3;0;3
8426;Pušynėlis;LOPŠELIS;2718421498;Taip;5;1;0;6
8427;Pušynėlis;LOPŠELIS;8218331977;Taip;4;4;0;8
8428;Pušynėlis;LOPŠELIS;1818077465;Taip;0;1;0;1
8429;Pušynėlis;LOPŠELIS;1251787066;Taip;6;0;6;12
8430;Pušynėlis;LOPŠELIS;4052365035;Taip;0;0;2;2
8431;Pušynėlis;LOPŠELIS;7896617995;Taip;0;0;2;2
8432;Pušynėlis;LOPŠELIS;9483417104;Taip;5;0;0;5
8433;Pušynėlis;LOPŠELIS;9081582524;Taip;7;0;0;7
8434;Pušynėlis;LOPŠELIS;3882064516;Taip;7;0;0;7
8435;Pušynėlis;LOPŠELIS;1034336110;Taip;0;0;3;3
8436;Pušynėlis;LOPŠELIS;1164201286;Taip;0;1;0;1
8437;Pušynėlis;LOPŠELIS;6709692748;Taip;10;1;0;11
8438;Pušynėlis;LOPŠELIS;8799095053;Taip;0;1;0;1
8439;Pušynėlis;LOPŠELIS;5318223378;Taip;6;0;3;9
8440;Pušynėlis;LOPŠELIS;5897839636;Taip;0;5;0;5
8441;Pušynėlis;LOPŠELIS;7401066252;Taip;0;0;4;4
8442;Pušynėlis;LOPŠELIS;7787646910;Taip;3;0;0;3
8443;Raktelis;LAŠIUKAI;55504358470;Ne;0;3;0;3
8444;Raktelis;LAŠIUKAI;61367764807;Ne;1;1;0;2
8445;Raktelis;LAŠIUKAI;1453259901;Taip;0;6;1;7
8446;Raktelis;LAŠIUKAI;6935703343;Taip;0;2;0;2
8447;Raktelis;LAŠIUKAI;30483797110;Taip;0;1;0;1
8448;Raktelis;LAŠIUKAI;5430563880;Taip;0;2;0;2
8449;Raktelis;LAŠIUKAI;874585350;Taip;6;1;0;7
8450;Raktelis;LAŠIUKAI;82549894936;Taip;7;1;0;8
8451;Raktelis;LAŠIUKAI;24160611392;Taip;5;7;0;12
8452;Raktelis;LAŠIUKAI;79301972646;Taip;5;1;2;8
8453;Raktelis;LAŠIUKAI;54361317676;Taip;0;9;0;9
8454;Raktelis;LAŠIUKAI;12333424396;Taip;0;1;0;1
8455;Raktelis;LAŠIUKAI;34960672068;Taip;2;0;0;2
8456;Raktelis;LAŠIUKAI;61636842808;Taip;0;1;0;1
8457;Raktelis;LAŠIUKAI;69445577844;Ne;3;1;0;4
8458;Raktelis;LAŠIUKAI;1224477393;Ne;5;9;0;14
8459;Raktelis;LAŠIUKAI;76758476679;Taip;18;0;0;18
8460;Raktelis;LAŠIUKAI;83366206408;Taip;0;2;0;2
8461;Raktelis;LAŠIUKAI;38068336379;Taip;0;0;1;1
8462;Raktelis;LAŠIUKAI;68578915107;Taip;1;6;2;9
8463;Raktelis;LAŠIUKAI;49216690763;Taip;0;1;0;1
8464;Raktelis;LAŠIUKAI;1586157196;Taip;0;5;0;5
8465;Raktelis;LAŠIUKAI;62754553467;Taip;5;1;0;6
8466;Raktelis;LAŠIUKAI;78841101231;Taip;0;1;0;1
8467;Raktelis;BITUTĖS;37587869107;Taip;0;2;3;5
8468;Raktelis;BITUTĖS;63051817818;Taip;0;3;0;3
8469;Raktelis;BITUTĖS;5663304735;Ne;4;2;4;10
8470;Raktelis;BITUTĖS;8559758812;Taip;5;0;0;5
8471;Raktelis;BITUTĖS;7265543701;Taip;0;4;0;4
8472;Raktelis;BITUTĖS;5627179884;Taip;0;2;0;2
8473;Raktelis;BITUTĖS;5405322552;Taip;0;0;12;12
8474;Raktelis;BITUTĖS;5492437864;Taip;4;2;2;8
8475;Raktelis;BITUTĖS;3880578523;Taip;2;2;0;4
8476;Raktelis;BITUTĖS;8796557675;Taip;11;0;2;13
8477;Raktelis;BITUTĖS;24323703041;Ne;0;0;1;1
8478;Raktelis;BITUTĖS;53034039807;Taip;0;0;2;2
8479;Raktelis;BITUTĖS;5711863758;Ne;10;1;0;11
8480;Raktelis;BITUTĖS;1747834520;Taip;5;0;3;8
8481;Raktelis;BITUTĖS;5000264125;Taip;0;19;0;19
8482;Raktelis;BITUTĖS;1820583792;Taip;21;0;0;21
8483;Raktelis;BITUTĖS;5802689482;Taip;4;4;0;8
8484;Raktelis;BITUTĖS;17270742947;Taip;0;12;0;12
8485;Raktelis;BITUTĖS;5392514118;Taip;6;2;6;14
8486;Raktelis;BITUTĖS;7048022562;Taip;0;1;0;1
8487;Raktelis;BITUTĖS;9774706725;Taip;1;8;0;9
8488;Raktelis;BITUTĖS;1455550617;Taip;0;10;4;14
8489;Raktelis;BITUTĖS;5218387088;Taip;10;0;0;10
8490;Raktelis;BORUŽĖLĖS;8117871963;Taip;16;1;0;17
8491;Raktelis;BORUŽĖLĖS;5031703240;Taip;0;11;0;11
8492;Raktelis;BORUŽĖLĖS;95104355224;Taip;0;2;0;2
8493;Raktelis;BORUŽĖLĖS;6049420030;Ne;8;0;0;8
8494;Raktelis;BORUŽĖLĖS;9313156299;Taip;4;1;1;6
8495;Raktelis;BORUŽĖLĖS;54221331553;Taip;8;2;0;10
8496;Raktelis;BORUŽĖLĖS;2070196225;Taip;5;2;0;7
8497;Raktelis;BORUŽĖLĖS;2303286473;Taip;0;5;0;5
8498;Raktelis;BORUŽĖLĖS;1192775994;Ne;3;4;0;7
8499;Raktelis;BORUŽĖLĖS;8245310502;Ne;6;2;0;8
8500;Raktelis;BORUŽĖLĖS;7487507324;Ne;5;0;0;5
8501;Raktelis;BORUŽĖLĖS;93271260871;Taip;6;10;0;16
8502;Raktelis;BORUŽĖLĖS;6779413882;Taip;13;0;0;13
8503;Raktelis;BORUŽĖLĖS;9584164290;Taip;0;2;0;2
8504;Raktelis;BORUŽĖLĖS;2055530718;Taip;2;0;0;2
8505;Raktelis;BORUŽĖLĖS;6854111162;Ne;0;2;0;2
8506;Raktelis;BORUŽĖLĖS;5818899732;Taip;16;0;0;16
8507;Raktelis;BORUŽĖLĖS;9348898875;Taip;5;1;0;6
8508;Raktelis;BORUŽĖLĖS;3762141936;Taip;0;5;0;5
8509;Raktelis;BORUŽĖLĖS;3713386556;Taip;0;8;0;8
8510;Raktelis;BORUŽĖLĖS;9230053040;Taip;11;1;0;12
8511;Raktelis;BORUŽĖLĖS;4671391106;Taip;7;0;0;7
8512;Raktelis;KAČIUKAI;8579864696;Ne;3;1;0;4
8513;Raktelis;KAČIUKAI;1393351147;Taip;3;1;0;4
8514;Raktelis;KAČIUKAI;27084497916;Taip;0;1;0;1
8515;Raktelis;KAČIUKAI;1063413424;Ne;0;15;0;15
8516;Raktelis;KAČIUKAI;4449411816;Taip;19;1;0;20
8517;Raktelis;KAČIUKAI;89139880068;Taip;2;3;0;5
8518;Raktelis;KAČIUKAI;1623046697;Taip;0;0;3;3
8519;Raktelis;KAČIUKAI;1468915955;Ne;5;0;0;5
8520;Raktelis;KAČIUKAI;87211875672;Taip;18;0;0;18
8521;Raktelis;KAČIUKAI;21063882404;Ne;0;1;0;1
8522;Raktelis;KAČIUKAI;78145437124;Taip;11;2;0;13
8523;Raktelis;KAČIUKAI;2143998936;Ne;0;2;0;2
8524;Raktelis;KAČIUKAI;1957572199;Taip;5;1;0;6
8525;Raktelis;KAČIUKAI;4906678347;Ne;5;4;0;9
8526;Raktelis;KAČIUKAI;1567546511;Taip;7;6;0;13
8527;Raktelis;KAČIUKAI;86883305675;Taip;3;3;0;6
8528;Raktelis;KAČIUKAI;9380332489;Taip;3;2;0;5
8529;Raktelis;KAČIUKAI;26727657814;Taip;8;1;0;9
8530;Raktelis;KAČIUKAI;30092089456;Taip;10;2;0;12
8531;Raktelis;KAČIUKAI;50372098009;Taip;14;1;0;15
8532;Raktelis;KAČIUKAI;1378192491;Taip;0;4;0;4
8533;Raktelis;KAČIUKAI;3180109604;Taip;19;0;0;19
8534;Raktelis;KAČIUKAI;1046075234;Taip;0;3;0;3
8535;Raktelis;KAČIUKAI;1457880868;Ne;17;0;0;17
8536;Raktelis;KAČIUKAI;4071338645;Taip;10;3;0;13
8537;Raktelis;KIŠKUČIAI;1983808547;Taip;4;0;0;4
8538;Raktelis;KIŠKUČIAI;4317705126;Taip;1;0;0;1
8539;Raktelis;KIŠKUČIAI;1843086151;Taip;0;9;0;9
8540;Raktelis;KIŠKUČIAI;2295251060;Taip;6;1;0;7
8541;Raktelis;KIŠKUČIAI;4160091258;Taip;10;1;0;11
8542;Raktelis;KIŠKUČIAI;5042538956;Taip;19;0;0;19
8543;Raktelis;KIŠKUČIAI;4471813998;Taip;0;1;0;1
8544;Raktelis;KIŠKUČIAI;6550851582;Taip;0;1;0;1
8545;Raktelis;KIŠKUČIAI;3775306030;Taip;11;1;0;12
8546;Raktelis;KIŠKUČIAI;4009105487;Taip;11;0;1;12
8547;Raktelis;KIŠKUČIAI;7260767942;Taip;8;1;0;9
8548;Raktelis;KIŠKUČIAI;6265489540;Taip;0;10;0;10
8549;Raktelis;KIŠKUČIAI;4187804340;Ne;5;0;1;6
8550;Raktelis;NYKŠTUKAI;3271931810;Taip;11;0;0;11
8551;Raktelis;NYKŠTUKAI;4933650089;Taip;6;6;0;12
8552;Raktelis;NYKŠTUKAI;4622683599;Taip;9;0;1;10
8553;Raktelis;NYKŠTUKAI;5270430511;Ne;21;0;0;21
8554;Raktelis;NYKŠTUKAI;4979657165;Taip;9;0;0;9
8555;Raktelis;NYKŠTUKAI;6007823584;Taip;5;0;0;5
8556;Raktelis;NYKŠTUKAI;4676213966;Taip;9;0;1;10
8557;Raktelis;NYKŠTUKAI;3733786043;Taip;8;3;0;11
8558;Raktelis;NYKŠTUKAI;4319176525;Taip;18;0;0;18
8559;Raktelis;NYKŠTUKAI;6929358401;Taip;0;3;0;3
8560;Raktelis;NYKŠTUKAI;8600632097;Taip;0;1;0;1
8561;Raktelis;NYKŠTUKAI;4444129040;Taip;5;0;0;5
8562;Raktelis;NYKŠTUKAI;7630501672;Taip;11;0;0;11
8563;Raktelis;NYKŠTUKAI;9965855682;Taip;2;2;0;4
8564;Raktelis;NYKŠTUKAI;2700148968;Taip;17;0;0;17
8565;Raktelis;NYKŠTUKAI;4631375439;Taip;13;0;0;13
8566;Raktelis;PELIUKAI;2967941870;Taip;3;0;1;4
8567;Raktelis;PELIUKAI;8146076115;Taip;3;2;0;5
8568;Raktelis;PELIUKAI;2731096860;Taip;11;0;0;11
8569;Raktelis;PELIUKAI;2809458453;Taip;14;0;0;14
8570;Raktelis;PELIUKAI;6892006495;Taip;12;1;0;13
8571;Raktelis;PELIUKAI;3884068578;Taip;0;1;0;1
8572;Raktelis;PELIUKAI;1322912585;Taip;0;3;0;3
8573;Raktelis;PELIUKAI;4228614834;Taip;11;2;0;13
8574;Raktelis;PELIUKAI;4755892641;Taip;6;5;0;11
8575;Raktelis;PELIUKAI;8353427144;Ne;0;5;0;5
8576;Raktelis;PELIUKAI;7869495911;Taip;10;0;1;11
8577;Raktelis;PELIUKAI;3395720463;Taip;17;0;0;17
8578;Raktelis;PELIUKAI;9151796053;Taip;10;0;0;10
8579;Raktelis;PELIUKAI;7142823740;Taip;0;0;1;1
8580;Raktelis;PELIUKAI;7055894770;Taip;9;0;0;9
8581;Raktelis;AGUONOS;6102196040;Taip;2;1;0;3
8582;Raktelis;AGUONOS;1622504968;Taip;7;0;0;7
8583;Raktelis;AGUONOS;6199212999;Taip;0;3;0;3
8584;Raktelis;AGUONOS;7334310944;Taip;9;1;0;10
8585;Raktelis;AGUONOS;6281687751;Taip;10;3;0;13
8586;Raktelis;AGUONOS;3661917922;Taip;8;6;0;14
8587;Raktelis;AGUONOS;1975411457;Ne;9;0;0;9
8588;Raktelis;AGUONOS;6367875352;Taip;8;3;0;11
8589;Raktelis;AGUONOS;7170546710;Taip;21;0;0;21
8590;Raktelis;AGUONOS;4905982507;Taip;3;6;0;9
8591;Raktelis;AGUONOS;6014726741;Taip;1;1;0;2
8592;Raktelis;AGUONOS;9779789133;Taip;2;1;0;3
8593;Raktelis;AGUONOS;2219712757;Ne;9;2;0;11
8594;Raktelis;AGUONOS;9593639791;Taip;0;3;0;3
8595;Raktelis;AGUONOS;1392036584;Taip;7;0;0;7
8596;Raktelis;AGUONOS;6608224825;Taip;1;9;0;10
8597;Raktelis;AGUONOS;4658530212;Taip;9;1;0;10
8598;Raktelis;AGUONOS;4335378625;Taip;3;0;0;3
8599;Raktelis;AGUONOS;8873203690;Taip;5;9;0;14
8600;Raktelis;AGUONOS;9357757604;Taip;6;9;0;15
8601;Raktelis;AGUONOS;8459980712;Taip;11;3;0;14
8602;Raktelis;AGUONOS;7973137015;Taip;21;0;0;21
8603;Raktelis;AGUONOS;9591285702;Taip;2;2;0;4
8604;Raktelis;AGUONOS;9210856228;Taip;11;0;0;11
8605;Raktelis;LAPIUKŲ;7962509432;Taip;15;1;0;16
8606;Raktelis;LAPIUKŲ;9501202273;Taip;4;3;0;7
8607;Raktelis;LAPIUKŲ;98616285680;Taip;0;1;0;1
8608;Raktelis;LAPIUKŲ;67972824332;Taip;4;0;0;4
8609;Raktelis;LAPIUKŲ;54341630847;Taip;7;1;0;8
8610;Raktelis;LAPIUKŲ;4569798381;Taip;15;1;0;16
8611;Raktelis;LAPIUKŲ;67304194087;Taip;13;0;0;13
8612;Raktelis;LAPIUKŲ;15583558585;Taip;8;5;0;13
8613;Raktelis;LAPIUKŲ;2753402906;Taip;0;7;0;7
8614;Raktelis;LAPIUKŲ;4583377785;Taip;16;0;1;17
8615;Raktelis;LAPIUKŲ;8869030487;Taip;7;0;1;8
8616;Raktelis;LAPIUKŲ;5082785025;Taip;12;2;0;14
8617;Raktelis;LAPIUKŲ;8320696048;Taip;3;3;0;6
8618;Raktelis;LAPIUKŲ;9130613710;Taip;5;7;0;12
8619;Raktelis;LAPIUKŲ;1453677708;Taip;11;2;0;13
8620;Raktelis;LAPIUKŲ;9072312203;Taip;0;1;0;1
8621;Raktelis;LAPIUKŲ;2282754345;Taip;8;0;0;8
8622;Raktelis;LAPIUKŲ;1109105359;Ne;8;2;0;10
8623;Raktelis;LAPIUKŲ;5768653399;Taip;19;0;0;19
8624;Raktelis;LAPIUKŲ;5595087767;Taip;0;1;0;1
8625;Raktelis;LAPIUKŲ;6385127914;Taip;0;6;0;6
8626;Raktelis;LAPIUKŲ;3423529085;Taip;0;4;0;4
8627;Raktelis;LAPIUKŲ;5925441742;Taip;6;1;0;7
8628;Raktelis;LAPIUKŲ;9053427316;Taip;3;2;0;5
8629;Raktelis;LAPIUKŲ;8207675881;Taip;0;6;0;6
8630;Raktelis;PELĖDŽIUKAI;68390568000;Taip;6;0;0;6
8631;Raktelis;PELĖDŽIUKAI;68570148753;Taip;0;4;0;4
8632;Raktelis;PELĖDŽIUKAI;27403835292;Taip;0;2;0;2
8633;Raktelis;PELĖDŽIUKAI;25141529581;Taip;5;1;0;6
8634;Raktelis;PELĖDŽIUKAI;43500434912;Taip;0;4;0;4
8635;Raktelis;PELĖDŽIUKAI;51237034253;Taip;0;3;0;3
8636;Raktelis;PELĖDŽIUKAI;45028887854;Taip;0;2;0;2
8637;Raktelis;PELĖDŽIUKAI;77512682081;Taip;0;1;0;1
8638;Raktelis;PELĖDŽIUKAI;5943583254;Taip;0;1;0;1
8639;Raktelis;PELĖDŽIUKAI;53270411090;Ne;0;1;0;1
8640;Raktelis;PELĖDŽIUKAI;92373834478;Ne;0;3;0;3
8641;Raktelis;PELĖDŽIUKAI;1819514057;Ne;0;1;0;1
8642;Raktelis;PELĖDŽIUKAI;86120193313;Taip;5;0;0;5
8643;Raktelis;PELĖDŽIUKAI;5914986262;Taip;0;2;2;4
8644;Raktelis;PELĖDŽIUKAI;67378900057;Ne;3;1;0;4
8645;Raktelis;PELĖDŽIUKAI;40006848965;Taip;6;0;1;7
8646;Raktelis;PELĖDŽIUKAI;38001876942;Taip;6;0;2;8
8647;Raktelis;PELĖDŽIUKAI;67756822733;Taip;0;2;0;2
8648;Raktelis;PELĖDŽIUKAI;82492627;Taip;0;1;0;1
8649;Raktelis;PELĖDŽIUKAI;1197826066;Taip;5;1;2;8
8650;Rasa;Nykštukai;3664125930;Ne;15;0;0;15
8651;Rasa;Nykštukai;5176175108;Taip;0;3;3;6
8652;Rasa;Nykštukai;3979273111;Taip;0;5;0;5
8653;Rasa;Nykštukai;4847544355;Taip;5;3;2;10
8654;Rasa;Nykštukai;9723040721;Taip;5;4;0;9
8655;Rasa;Nykštukai;7004232909;Taip;0;3;4;7
8656;Rasa;Nykštukai;1223962374;Taip;0;6;0;6
8657;Rasa;Nykštukai;3200377629;Ne;15;0;0;15
8658;Rasa;Nykštukai;1336291828;Taip;0;2;0;2
8659;Rasa;Nykštukai;5861229664;Taip;23;0;0;23
8660;Rasa;Nykštukai;1386880644;Taip;2;1;6;9
8661;Rasa;Nykštukai;7228037580;Taip;0;3;0;3
8662;Rasa;Nykštukai;2093263887;Taip;5;0;0;5
8663;Rasa;Nykštukai;2540124793;Taip;5;3;0;8
8664;Rasa;Nykštukai;5363748728;Taip;0;0;2;2
8665;Rasa;Nykštukai;2977737634;Taip;15;0;0;15
8666;Rasa;Nykštukai;8310400946;Taip;14;0;0;14
8667;Rasa;Nykštukai;7520665472;Taip;0;9;0;9
8668;Rasa;Nykštukai;3508648715;Ne;8;0;0;8
8669;Rasa;Meškiukai;8278928396;Taip;13;3;0;16
8670;Rasa;Meškiukai;8052120247;Taip;6;0;0;6
8671;Rasa;Meškiukai;1013865195;Taip;0;6;0;6
8672;Rasa;Meškiukai;2110008545;Ne;0;0;6;6
8673;Rasa;Meškiukai;72772661373;Taip;5;1;1;7
8674;Rasa;Meškiukai;63673920646;Taip;5;0;1;6
8675;Rasa;Meškiukai;52913880917;Taip;9;8;0;17
8676;Rasa;Meškiukai;5932187584;Taip;19;0;0;19
8677;Rasa;Meškiukai;5145978804;Ne;16;4;1;21
8678;Rasa;Meškiukai;8438563545;Taip;5;0;0;5
8679;Rasa;Meškiukai;6356448094;Taip;0;0;24;24
8680;Rasa;Meškiukai;2683897055;Taip;16;8;0;24
8681;Rasa;Meškiukai;4790859112;Taip;4;0;3;7
8682;Rasa;Meškiukai;7534548604;Taip;7;0;7;14
8683;Rasa;Meškiukai;5606722133;Taip;0;0;1;1
8684;Rasa;Meškiukai;7544963724;Taip;0;8;0;8
8685;Rasa;Meškiukai;3567565920;Taip;15;0;3;18
8686;Rasa;Meškiukai;6734478649;Taip;0;1;0;1
8687;Rasa;Meškiukai;4837280374;Ne;11;0;1;12
8688;Rasa;Sauliukai;3001023535;Ne;0;3;0;3
8689;Rasa;Sauliukai;95625598016;Taip;2;3;0;5
8690;Rasa;Sauliukai;1067614202;Ne;15;3;0;18
8691;Rasa;Sauliukai;29141190550;Taip;0;8;0;8
8692;Rasa;Sauliukai;59695217278;Taip;2;3;0;5
8693;Rasa;Sauliukai;87310376118;Taip;4;3;0;7
8694;Rasa;Sauliukai;32724807082;Taip;5;10;0;15
8695;Rasa;Sauliukai;69640669835;Taip;0;4;0;4
8696;Rasa;Sauliukai;36336738780;Taip;0;3;0;3
8697;Rasa;Sauliukai;1549153022;Taip;0;2;0;2
8698;Rasa;Sauliukai;59339333069;Taip;3;3;0;6
8699;Rasa;Sauliukai;1846631921;Taip;0;4;0;4
8700;Rasa;Sauliukai;96518910021;Taip;3;1;0;4
8701;Rasa;Sauliukai;59127440556;Taip;2;4;0;6
8702;Rasa;Sauliukai;99521832856;Taip;0;4;0;4
8703;Rasa;Sauliukai;26384431360;Taip;2;1;8;11
8704;Rasa;Sauliukai;1004116597;Taip;2;1;0;3
8705;Rasa;Sauliukai;1560278351;Taip;2;4;0;6
8706;Rasa;Sauliukai;1916783052;Ne;4;5;0;9
8707;Rasa;Sauliukai;6795591746;Ne;2;4;0;6
8708;Rasa;Smalsučiai;3281315532;Taip;0;1;0;1
8709;Rasa;Smalsučiai;13135367451;Taip;0;2;1;3
8710;Rasa;Smalsučiai;91941960564;Taip;0;1;0;1
8711;Rasa;Smalsučiai;1883458628;Taip;0;1;0;1
8712;Rasa;Smalsučiai;4601657045;Taip;3;1;0;4
8713;Rasa;Smalsučiai;1339376048;Taip;0;6;2;8
8714;Rasa;Smalsučiai;5201341227;Taip;0;1;0;1
8715;Rasa;Smalsučiai;2879767810;Taip;0;1;1;2
8716;Rasa;Smalsučiai;1267340581;Taip;6;1;0;7
8717;Rasa;Smalsučiai;88779978297;Taip;0;3;0;3
8718;Rasa;Smalsučiai;13286984288;Taip;10;1;0;11
8719;Rasa;Smalsučiai;1558712079;Taip;0;2;0;2
8720;Rasa;Smalsučiai;99911904705;Taip;0;0;1;1
8721;Rasa;Smalsučiai;79439306932;Taip;7;0;0;7
8722;Rasa;Smalsučiai;9890493148;Taip;5;2;0;7
8723;Rasa;Smalsučiai;25918582395;Ne;5;2;0;7
8724;Rasa;Smalsučiai;1311346161;Taip;0;11;1;12
8725;Rasa;Smalsučiai;77589878141;Taip;0;2;1;3
8726;Rasa;Smalsučiai;1581241275;Taip;15;1;1;17
8727;Rasa;Smalsučiai;1658948426;Taip;0;4;0;4
8728;Rasa;Smalsučiai;1803769089;Taip;5;1;0;6
8729;Rasa;"Pelėdžiukai ";1176606744;Taip;10;0;0;10
8730;Rasa;"Pelėdžiukai ";2121070882;Taip;0;0;13;13
8731;Rasa;"Pelėdžiukai ";3884105235;Taip;0;7;2;9
8732;Rasa;"Pelėdžiukai ";1726266997;Ne;6;0;0;6
8733;Rasa;"Pelėdžiukai ";6704162447;Taip;11;0;0;11
8734;Rasa;"Pelėdžiukai ";7558966891;Taip;8;0;2;10
8735;Rasa;"Pelėdžiukai ";6773004268;Taip;16;0;3;19
8736;Rasa;"Pelėdžiukai ";3023088027;Taip;6;0;0;6
8737;Rasa;"Pelėdžiukai ";8953448462;Ne;16;0;0;16
8738;Rasa;"Pelėdžiukai ";5325275053;Taip;10;4;0;14
8739;Rasa;"Pelėdžiukai ";4758605343;Taip;7;0;3;10
8740;Rasa;"Pelėdžiukai ";3848448401;Taip;4;0;1;5
8741;Rasa;"Pelėdžiukai ";4542122478;Taip;0;0;1;1
8742;Rasa;"Pelėdžiukai ";2962815301;Taip;17;0;0;17
8743;Rasa;"Pelėdžiukai ";4084236196;Taip;0;0;5;5
8744;Rasa;"Pelėdžiukai ";8912031554;Taip;19;0;0;19
8745;Rasa;"Pelėdžiukai ";3091012313;Taip;13;0;2;15
8746;Rasa;Katinėliai;5885520521;Taip;8;0;1;9
8747;Rasa;Katinėliai;7730322729;Taip;0;4;2;6
8748;Rasa;Katinėliai;2170134084;Taip;0;0;2;2
8749;Rasa;Katinėliai;3657956842;Ne;9;0;1;10
8750;Rasa;Katinėliai;6891623055;Taip;6;0;3;9
8751;Rasa;Katinėliai;9010812748;Taip;6;4;0;10
8752;Rasa;Katinėliai;7220007488;Taip;4;2;0;6
8753;Rasa;Katinėliai;8235869241;Taip;5;6;1;12
8754;Rasa;Katinėliai;3135828190;Ne;0;7;2;9
8755;Rasa;Katinėliai;2984661168;Taip;8;0;0;8
8756;Rasa;Katinėliai;4913483444;Taip;4;0;4;8
8757;Rasa;Katinėliai;7142481458;Taip;15;0;1;16
8758;Rasa;Katinėliai;7314537168;Taip;0;0;2;2
8759;Rasa;Katinėliai;4734775151;Taip;5;0;5;10
8760;Rasa;Katinėliai;4758138905;Taip;6;0;0;6
8761;Rasa;Katinėliai;9447346901;Taip;5;0;3;8
8762;Rasa;Ančiukai;7185331699;Taip;14;1;0;15
8763;Rasa;Ančiukai;1060810039;Taip;14;1;0;15
8764;Rasa;Ančiukai;9599510902;Taip;7;0;0;7
8765;Rasa;Ančiukai;7037958994;Taip;5;7;0;12
8766;Rasa;Ančiukai;9668538340;Taip;5;12;0;17
8767;Rasa;Ančiukai;4795339259;Taip;11;5;0;16
8768;Rasa;Ančiukai;6019853365;Taip;18;3;0;21
8769;Rasa;Ančiukai;4694111253;Taip;1;3;1;5
8770;Rasa;Ančiukai;7028605422;Taip;0;6;0;6
8771;Rasa;Ančiukai;2711923397;Taip;16;0;1;17
8772;Rasa;Ančiukai;2800420481;Taip;0;0;5;5
8773;Rasa;Ančiukai;5869253167;Taip;2;0;2;4
8774;Rasa;Ančiukai;3475601049;Taip;4;0;1;5
8775;Rasa;Ančiukai;6887471189;Taip;7;0;0;7
8776;Rasa;Ančiukai;6011243039;Taip;0;0;2;2
8777;Rasa;"Vyturiukai ";1210203141;Taip;0;4;1;5
8778;Rasa;"Vyturiukai ";7575833127;Taip;0;0;8;8
8779;Rasa;"Vyturiukai ";27131705540;Taip;0;3;0;3
8780;Rasa;"Vyturiukai ";1823276800;Taip;0;2;0;2
8781;Rasa;"Vyturiukai ";1651905746;Taip;0;2;0;2
8782;Rasa;"Vyturiukai ";1940633287;Taip;0;1;0;1
8783;Rasa;"Vyturiukai ";66103644564;Taip;0;0;4;4
8784;Rasa;"Vyturiukai ";73115061371;Taip;0;8;0;8
8785;Rasa;"Vyturiukai ";1049242346;Taip;5;0;4;9
8786;Rasa;"Vyturiukai ";1179402963;Taip;0;12;0;12
8787;Rasa;"Vyturiukai ";1210340955;Taip;2;8;0;10
8788;Rasa;"Vyturiukai ";83227920971;Ne;0;11;0;11
8789;Rasa;"Vyturiukai ";34934099958;Taip;0;5;0;5
8790;Rasa;"Vyturiukai ";84161884493;Taip;0;2;6;8
8791;Rasa;"Vyturiukai ";1214055260;Taip;0;5;0;5
8792;Rasa;"Vyturiukai ";2041098301;Taip;0;14;0;14
8793;Rasa;"Vyturiukai ";71420694152;Ne;5;0;6;11
8794;Rasa;"Vyturiukai ";1477555365;Taip;10;8;0;18
8795;Rasa;"Vyturiukai ";6344169010;Taip;0;1;0;1
8796;Rasa;"Vyturiukai ";9438727789;Taip;0;3;12;15
8797;Rasa;Voveriukai;1728275988;Taip;4;0;0;4
8798;Rasa;Voveriukai;74744565967;Taip;17;0;0;17
8799;Rasa;Voveriukai;1093723298;Ne;0;0;1;1
8800;Rasa;Voveriukai;2158444381;Taip;9;1;0;10
8801;Rasa;Voveriukai;5589971159;Taip;5;0;1;6
8802;Rasa;Voveriukai;2980868154;Ne;0;7;0;7
8803;Rasa;Voveriukai;8749177123;Ne;0;3;0;3
8804;Rasa;Voveriukai;4065614217;Taip;10;5;0;15
8805;Rasa;Voveriukai;15257986685;Taip;0;9;0;9
8806;Rasa;Voveriukai;6198612392;Taip;0;4;0;4
8807;Rasa;Voveriukai;1900027524;Ne;0;4;0;4
8808;Rasa;Voveriukai;5108279813;Ne;0;0;4;4
8809;Rasa;Voveriukai;2349860704;Taip;20;0;0;20
8810;Rasa;Voveriukai;1704518157;Taip;6;0;0;6
8811;Rasa;Voveriukai;8983800071;Ne;0;1;0;1
8812;Rasa;"DRUGELIAI ";9140875020;Ne;4;3;0;7
8813;Rasa;"DRUGELIAI ";9229817861;Ne;6;0;6;12
8814;Rasa;"DRUGELIAI ";2191720088;Taip;20;0;0;20
8815;Rasa;"DRUGELIAI ";3233000497;Taip;20;0;0;20
8816;Rasa;"DRUGELIAI ";6535561634;Taip;3;0;7;10
8817;Rasa;"DRUGELIAI ";1206005039;Taip;18;0;0;18
8818;Rasa;"DRUGELIAI ";9788282861;Taip;10;3;0;13
8819;Rasa;"DRUGELIAI ";6311322617;Taip;9;0;0;9
8820;Rasa;"DRUGELIAI ";8595804874;Taip;0;1;2;3
8821;Rasa;"DRUGELIAI ";3073804713;Taip;5;0;5;10
8822;Rasa;"DRUGELIAI ";9677810607;Taip;21;0;2;23
8823;Rasa;"DRUGELIAI ";1466616814;Taip;5;5;1;11
8824;Rasa;"DRUGELIAI ";5165588335;Taip;5;0;1;6
8825;Rasa;"DRUGELIAI ";1796573723;Taip;5;14;0;19
8826;Rasa;Zuikučiai;4554377449;Taip;0;4;0;4
8827;Rasa;Zuikučiai;2137321989;Taip;6;8;0;14
8828;Rasa;Zuikučiai;1993471951;Taip;0;1;9;10
8829;Rasa;Zuikučiai;1860462451;Taip;15;5;0;20
8830;Rasa;Zuikučiai;42609897431;Taip;0;0;2;2
8831;Rasa;Zuikučiai;55374082940;Taip;0;18;0;18
8832;Rasa;Zuikučiai;2114613635;Taip;0;1;2;3
8833;Rasa;Zuikučiai;56016538926;Taip;0;0;1;1
8834;Rasa;Zuikučiai;7397794681;Taip;0;6;0;6
8835;Rasa;Zuikučiai;13297122928;Taip;0;6;0;6
8836;Rasa;Zuikučiai;6108187043;Taip;0;5;0;5
8837;Rasa;Zuikučiai;1690518970;Taip;0;4;0;4
8838;Rasa;Zuikučiai;1131418692;Taip;0;4;0;4
8839;Rasa;Zuikučiai;7065597550;Ne;15;2;0;17
8840;Rasa;Zuikučiai;72152762554;Taip;1;0;3;4
8841;Rasa;Zuikučiai;9432880035;Taip;0;16;0;16
8842;Rasa;Širdelė;56168039878;Taip;0;5;0;5
8843;Rasa;Širdelė;8424049317;Taip;10;5;0;15
8844;Rasa;Širdelė;5599182715;Taip;0;12;0;12
8845;Rasa;Širdelė;9648034081;Ne;0;5;0;5
8846;Rasa;Širdelė;33479419656;Taip;5;7;0;12
8847;Rasa;Širdelė;8236464670;Ne;0;6;0;6
8848;Rasa;Širdelė;1271820053;Ne;6;2;4;12
8849;Rasa;Širdelė;2626361958;Taip;12;0;0;12
8850;Rasa;Širdelė;5426981046;Taip;0;12;0;12
8851;Rasa;Širdelė;2840872613;Taip;9;6;0;15
8852;Rasa;Širdelė;23600769349;Taip;0;5;0;5
8853;Rasa;Širdelė;6976298054;Taip;4;0;0;4
8854;Rasa;Širdelė;91931863004;Taip;3;1;0;4
8855;Rasa;Širdelė;3668598028;Taip;3;1;0;4
8856;Rasa;Širdelė;58858081077;Taip;10;6;0;16
8857;Rasa;Širdelė;2132535297;Taip;0;6;1;7
8858;Rasa;Širdelė;2133989183;Taip;0;6;0;6
8859;Rasa;Širdelė;8866896989;Taip;0;19;0;19
8860;Rasa;Širdelė;9938280570;Taip;3;5;0;8
8861;Rasa;Širdelė;2333938367;Taip;5;8;0;13
8862;Riešutėlis;Viščiukų;1782544949;Taip;5;4;0;9
8863;Riešutėlis;Viščiukų;91799192513;Taip;6;1;0;7
8864;Riešutėlis;Viščiukų;50427986973;Taip;15;2;0;17
8865;Riešutėlis;Viščiukų;4098825502;Taip;0;1;0;1
8866;Riešutėlis;Viščiukų;28855582790;Taip;10;1;0;11
8867;Riešutėlis;Viščiukų;41275727334;Taip;5;0;3;8
8868;Riešutėlis;Viščiukų;98456292572;Taip;0;2;0;2
8869;Riešutėlis;Viščiukų;63919369801;Taip;10;1;0;11
8870;Riešutėlis;Viščiukų;2146831972;Taip;5;1;0;6
8871;Riešutėlis;Viščiukų;61571638960;Taip;10;1;0;11
8872;Riešutėlis;Viščiukų;8857939937;Taip;0;1;0;1
8873;Riešutėlis;Viščiukų;1957794151;Taip;15;1;0;16
8874;Riešutėlis;Viščiukų;5520818573;Taip;0;1;0;1
8875;Riešutėlis;Viščiukų;1743324657;Taip;5;3;0;8
8876;Riešutėlis;Viščiukų;1792212841;Taip;0;1;6;7
8877;Riešutėlis;Viščiukų;86455801201;Taip;0;1;0;1
8878;Riešutėlis;Viščiukų;1532275496;Taip;2;1;0;3
8879;Riešutėlis;Viščiukų;4311016578;Taip;3;1;0;4
8880;Riešutėlis;Viščiukų;2201158918;Taip;0;1;0;1
8881;Riešutėlis;Viščiukų;8927730307;Ne;3;1;4;8
8882;Riešutėlis;Viščiukų;6855553238;Taip;0;0;4;4
8883;Riešutėlis;Viščiukų;1930481567;Taip;5;0;0;5
8884;Riešutėlis;Viščiukų;4229384438;Taip;0;1;0;1
8885;Riešutėlis;"Riešutėliai ";8077135868;Ne;12;1;0;13
8886;Riešutėlis;"Riešutėliai ";84116863778;Taip;0;6;0;6
8887;Riešutėlis;"Riešutėliai ";1077680441;Ne;13;3;0;16
8888;Riešutėlis;"Riešutėliai ";55620350407;Taip;19;0;0;19
8889;Riešutėlis;"Riešutėliai ";57437627642;Ne;0;1;0;1
8890;Riešutėlis;"Riešutėliai ";2035669978;Taip;0;5;0;5
8891;Riešutėlis;"Riešutėliai ";1105598415;Taip;0;1;0;1
8892;Riešutėlis;"Riešutėliai ";11913461630;Taip;5;1;0;6
8893;Riešutėlis;"Riešutėliai ";1674871670;Taip;13;2;0;15
8894;Riešutėlis;"Riešutėliai ";1853283967;Taip;10;1;1;12
8895;Riešutėlis;"Riešutėliai ";49061075792;Taip;0;5;0;5
8896;Riešutėlis;"Riešutėliai ";1858221034;Ne;0;1;0;1
8897;Riešutėlis;"Riešutėliai ";3806836220;Taip;5;2;0;7
8898;Riešutėlis;"Riešutėliai ";16308059025;Taip;13;0;0;13
8899;Riešutėlis;"Riešutėliai ";9023304543;Taip;10;1;0;11
8900;Riešutėlis;"Riešutėliai ";1941869661;Taip;0;2;0;2
8901;Riešutėlis;"Riešutėliai ";4404544549;Taip;16;2;1;19
8902;Riešutėlis;"Riešutėliai ";85356230208;Taip;0;4;0;4
8903;Riešutėlis;"Riešutėliai ";85066293475;Taip;0;1;0;1
8904;Riešutėlis;Ežiukai;7030346495;Taip;15;0;1;16
8905;Riešutėlis;Ežiukai;9750713954;Taip;0;9;0;9
8906;Riešutėlis;Ežiukai;9476688736;Taip;18;0;0;18
8907;Riešutėlis;Ežiukai;7601776182;Taip;0;6;0;6
8908;Riešutėlis;Ežiukai;7381623086;Taip;5;2;0;7
8909;Riešutėlis;Ežiukai;9964688413;Taip;10;0;0;10
8910;Riešutėlis;Ežiukai;1548585448;Taip;0;0;5;5
8911;Riešutėlis;Ežiukai;9088123796;Taip;17;0;2;19
8912;Riešutėlis;Ežiukai;8954127616;Taip;2;0;2;4
8913;Riešutėlis;Ežiukai;2092933906;Taip;9;6;0;15
8914;Riešutėlis;Ežiukai;6813024366;Taip;11;1;0;12
8915;Riešutėlis;Ežiukai;7913381005;Taip;3;5;0;8
8916;Riešutėlis;Ežiukai;3460145784;Ne;6;1;2;9
8917;Riešutėlis;Ežiukai;8480059272;Ne;6;0;1;7
8918;Riešutėlis;Ežiukai;5728858361;Ne;9;2;0;11
8919;Riešutėlis;Ežiukai;8721736343;Taip;9;0;1;10
8920;Riešutėlis;Ežiukai;5327627748;Taip;0;5;0;5
8921;Riešutėlis;Ežiukai;2397854323;Taip;10;1;1;12
8922;Riešutėlis;Ežiukai;6194259707;Taip;0;0;5;5
8923;Riešutėlis;Pelėdžiukai;6303767779;Taip;10;0;3;13
8924;Riešutėlis;Pelėdžiukai;8018914251;Taip;3;1;3;7
8925;Riešutėlis;Pelėdžiukai;8012201566;Taip;12;0;0;12
8926;Riešutėlis;Pelėdžiukai;8751571852;Taip;14;0;0;14
8927;Riešutėlis;Pelėdžiukai;5479780116;Taip;9;0;0;9
8928;Riešutėlis;Pelėdžiukai;7225365172;Taip;7;1;0;8
8929;Riešutėlis;Pelėdžiukai;9839084885;Taip;1;0;0;1
8930;Riešutėlis;Pelėdžiukai;6928558714;Ne;0;0;1;1
8931;Riešutėlis;Pelėdžiukai;9040123535;Ne;0;1;0;1
8932;Riešutėlis;Pelėdžiukai;6405116059;Taip;7;0;3;10
8933;Riešutėlis;Pelėdžiukai;5995176001;Taip;0;2;0;2
8934;Riešutėlis;Pelėdžiukai;2430518637;Taip;9;1;0;10
8935;Riešutėlis;Pelėdžiukai;3970874098;Taip;0;0;3;3
8936;Riešutėlis;Pelėdžiukai;4451419273;Taip;15;0;2;17
8937;Riešutėlis;Pelėdžiukai;1638021880;Taip;12;0;0;12
8938;Riešutėlis;Pelėdžiukai;4581184004;Taip;0;0;1;1
8939;Riešutėlis;Pelėdžiukai;5598052531;Taip;1;0;0;1
8940;Riešutėlis;Pelėdžiukai;5282039544;Ne;6;0;1;7
8941;Riešutėlis;Meškiukai;1999979060;Ne;0;5;0;5
8942;Riešutėlis;Meškiukai;4004669930;Taip;0;4;4;8
8943;Riešutėlis;Meškiukai;3920525584;Taip;17;0;0;17
8944;Riešutėlis;Meškiukai;6721758785;Taip;8;0;3;11
8945;Riešutėlis;Meškiukai;5753609922;Taip;16;1;0;17
8946;Riešutėlis;Meškiukai;3694146893;Taip;2;0;3;5
8947;Riešutėlis;Meškiukai;1748151109;Ne;5;5;3;13
8948;Riešutėlis;Meškiukai;4233170371;Taip;21;0;0;21
8949;Riešutėlis;Meškiukai;8738716660;Taip;13;0;0;13
8950;Riešutėlis;Meškiukai;1528972517;Taip;10;0;0;10
8951;Riešutėlis;Meškiukai;7177632315;Taip;5;3;1;9
8952;Riešutėlis;Meškiukai;6292679662;Taip;2;0;8;10
8953;Riešutėlis;Meškiukai;3077468722;Taip;10;1;1;12
8954;Riešutėlis;Meškiukai;4293402095;Taip;0;21;0;21
8955;Riešutėlis;Meškiukai;4828635362;Taip;13;0;0;13
8956;Riešutėlis;Meškiukai;8504832383;Taip;3;0;0;3
8957;Riešutėlis;Kiškučiai;90088217854;Ne;7;1;0;8
8958;Riešutėlis;Kiškučiai;49061132665;Taip;0;3;0;3
8959;Riešutėlis;Kiškučiai;92159110899;Taip;0;5;2;7
8960;Riešutėlis;Kiškučiai;1623455993;Taip;5;4;0;9
8961;Riešutėlis;Kiškučiai;96066602684;Ne;0;7;2;9
8962;Riešutėlis;Kiškučiai;55715445788;Taip;11;0;0;11
8963;Riešutėlis;Kiškučiai;1747328573;Taip;13;2;1;16
8964;Riešutėlis;Kiškučiai;1250209796;Ne;1;8;0;9
8965;Riešutėlis;Kiškučiai;1526573984;Taip;17;0;0;17
8966;Riešutėlis;Kiškučiai;50338275044;Taip;0;1;0;1
8967;Riešutėlis;Kiškučiai;18310744085;Taip;5;1;0;6
8968;Riešutėlis;Kiškučiai;35876952602;Taip;5;1;0;6
8969;Riešutėlis;Kiškučiai;93192056557;Taip;0;3;6;9
8970;Riešutėlis;Kiškučiai;9205961122;Taip;0;0;1;1
8971;Riešutėlis;Kiškučiai;2163433983;Taip;4;0;0;4
8972;Riešutėlis;Kiškučiai;4916885450;Taip;0;21;0;21
8973;Riešutėlis;Kiškučiai;8864100655;Taip;0;1;0;1
8974;Riešutėlis;Kiškučiai;6149891188;Taip;0;2;0;2
8975;Riešutėlis;Voveriukų;6130980726;Taip;8;2;0;10
8976;Riešutėlis;Voveriukų;6500567162;Taip;0;9;0;9
8977;Riešutėlis;Voveriukų;9081486438;Taip;0;1;0;1
8978;Riešutėlis;Voveriukų;1212829190;Taip;5;0;0;5
8979;Riešutėlis;Voveriukų;59279444190;Taip;0;5;0;5
8980;Riešutėlis;Voveriukų;31417468379;Taip;0;3;0;3
8981;Riešutėlis;Voveriukų;1065105725;Taip;4;1;0;5
8982;Riešutėlis;Voveriukų;36176126840;Taip;0;2;0;2
8983;Riešutėlis;Voveriukų;26053212952;Taip;5;1;0;6
8984;Riešutėlis;Voveriukų;51840071269;Taip;5;1;0;6
8985;Riešutėlis;Voveriukų;70549617521;Taip;0;3;0;3
8986;Riešutėlis;Voveriukų;36161702165;Ne;4;7;0;11
8987;Riešutėlis;Voveriukų;46444683383;Taip;0;3;0;3
8988;Riešutėlis;Voveriukų;92166220283;Taip;10;1;0;11
8989;Riešutėlis;Voveriukų;2163248156;Taip;0;2;0;2
8990;Riešutėlis;Voveriukų;43038393551;Taip;0;1;0;1
8991;Riešutėlis;Voveriukų;56426084480;Taip;0;3;0;3
8992;Riešutėlis;Voveriukų;65629075580;Taip;0;4;0;4
8993;Riešutėlis;Voveriukų;50971787753;Taip;0;3;0;3
8994;Riešutėlis;Voveriukų;89384403521;Taip;0;4;0;4
8995;Riešutėlis;Voveriukų;64736615832;Ne;8;1;0;9
8996;Riešutėlis;Voveriukų;29751938918;Taip;11;1;0;12
8997;Riešutėlis;Saulutės;9198963882;Ne;0;2;0;2
8998;Riešutėlis;Saulutės;2111280879;Taip;0;2;2;4
8999;Riešutėlis;Saulutės;1190403952;Taip;0;1;0;1
9000;Riešutėlis;Saulutės;1160573638;Taip;0;4;0;4
9001;Riešutėlis;Saulutės;1056034480;Ne;0;2;2;4
9002;Riešutėlis;Saulutės;1136025173;Taip;0;0;21;21
9003;Riešutėlis;Saulutės;2097580659;Taip;9;0;0;9
9004;Riešutėlis;Saulutės;2112179980;Ne;12;0;0;12
9005;Riešutėlis;Saulutės;2851186469;Taip;4;0;0;4
9006;Riešutėlis;Saulutės;7207507008;Ne;0;2;1;3
9007;Riešutėlis;Saulutės;8749505821;Taip;0;5;0;5
9008;Riešutėlis;Saulutės;1169051233;Taip;5;0;0;5
9009;Riešutėlis;Saulutės;1091941952;Taip;0;4;0;4
9010;Riešutėlis;Saulutės;24776322315;Taip;7;0;2;9
9011;Riešutėlis;Saulutės;7912773569;Taip;0;0;1;1
9012;Riešutėlis;Saulutės;2655848313;Taip;4;0;3;7
9013;Riešutėlis;Saulutės;4898775561;Taip;0;1;0;1
9014;Riešutėlis;Saulutės;6402032861;Taip;3;0;0;3
9015;Riešutėlis;Saulutės;5717194707;Taip;0;7;0;7
9016;Riešutėlis;Saulutės;5537309549;Ne;3;4;0;7
9017;Riešutėlis;"Boruželės ";16561622902;Taip;16;1;0;17
9018;Riešutėlis;"Boruželės ";56117509354;Taip;9;5;0;14
9019;Riešutėlis;"Boruželės ";1936519033;Taip;15;2;0;17
9020;Riešutėlis;"Boruželės ";2611705234;Taip;19;0;0;19
9021;Riešutėlis;"Boruželės ";4131218911;Taip;6;2;0;8
9022;Riešutėlis;"Boruželės ";1455509576;Taip;5;5;0;10
9023;Riešutėlis;"Boruželės ";4701887030;Taip;0;2;0;2
9024;Riešutėlis;"Boruželės ";3577669231;Taip;16;2;0;18
9025;Riešutėlis;"Boruželės ";9670912357;Taip;5;1;0;6
9026;Riešutėlis;"Boruželės ";26781529460;Taip;7;0;3;10
9027;Riešutėlis;"Boruželės ";5097410462;Taip;6;0;0;6
9028;Riešutėlis;"Boruželės ";4344185375;Taip;0;6;0;6
9029;Riešutėlis;"Boruželės ";8936419431;Taip;0;5;0;5
9030;Riešutėlis;"Boruželės ";4041498684;Taip;0;1;0;1
9031;Riešutėlis;"Boruželės ";8087180983;Taip;10;0;5;15
9032;Riešutėlis;"Boruželės ";4276034784;Taip;6;0;1;7
9033;Riešutėlis;"Boruželės ";2566084613;Taip;18;3;0;21
9034;Riešutėlis;"Boruželės ";1640383686;Taip;14;0;2;16
9035;Riešutėlis;"Boruželės ";3851000866;Taip;0;2;0;2
9036;Riešutėlis;"Boruželės ";3982030863;Taip;0;0;1;1
9037;Riešutėlis;"Boruželės ";1623681835;Taip;0;6;0;6
9038;Riešutėlis;"Boruželės ";1818130297;Taip;10;5;0;15
9039;Riešutėlis;"Bitutės ";1000408690;Taip;13;1;0;14
9040;Riešutėlis;"Bitutės ";3149710709;Taip;6;0;0;6
9041;Riešutėlis;"Bitutės ";1918857028;Taip;0;5;0;5
9042;Riešutėlis;"Bitutės ";1686215195;Taip;0;5;0;5
9043;Riešutėlis;"Bitutės ";54011982803;Taip;0;1;0;1
9044;Riešutėlis;"Bitutės ";4366097328;Taip;16;0;0;16
9045;Riešutėlis;"Bitutės ";2395648260;Taip;0;17;0;17
9046;Riešutėlis;"Bitutės ";86647499063;Ne;0;1;0;1
9047;Riešutėlis;"Bitutės ";59796628656;Taip;0;2;1;3
9048;Riešutėlis;"Bitutės ";6852846350;Taip;7;1;2;10
9049;Riešutėlis;"Bitutės ";13815744901;Taip;5;0;0;5
9050;Riešutėlis;"Bitutės ";91430094368;Taip;0;3;0;3
9051;Riešutėlis;"Bitutės ";65873300738;Taip;5;1;0;6
9052;Riešutėlis;"Bitutės ";8313605541;Taip;0;1;3;4
9053;Riešutėlis;"Bitutės ";1921241349;Taip;0;1;9;10
9054;Riešutėlis;"Bitutės ";7987368969;Taip;0;8;0;8
9055;Riešutėlis;"Bitutės ";85564700996;Taip;2;0;0;2
9056;Riešutėlis;Drugelių;8266735624;Taip;6;1;0;7
9057;Riešutėlis;Drugelių;4776231497;Taip;6;1;0;7
9058;Riešutėlis;Drugelių;8578903763;Taip;10;5;0;15
9059;Riešutėlis;Drugelių;7769079730;Taip;5;1;3;9
9060;Riešutėlis;Drugelių;5811657782;Taip;13;0;0;13
9061;Riešutėlis;Drugelių;4221375847;Taip;0;4;5;9
9062;Riešutėlis;Drugelių;1075842434;Taip;0;1;0;1
9063;Riešutėlis;Drugelių;1942944625;Taip;5;1;0;6
9064;Riešutėlis;Drugelių;8845709386;Taip;8;0;6;14
9065;Riešutėlis;Drugelių;8128352818;Taip;6;0;4;10
9066;Riešutėlis;Drugelių;8352146446;Taip;0;0;2;2
9067;Riešutėlis;Drugelių;8180618419;Ne;4;1;1;6
9068;Riešutėlis;Drugelių;5412882446;Taip;15;0;1;16
9069;Riešutėlis;Drugelių;8020533200;Taip;5;3;3;11
9070;Riešutėlis;Drugelių;1164273595;Ne;15;0;0;15
9071;Riešutėlis;Drugelių;8918753084;Taip;0;0;2;2
9072;Riešutėlis;Drugelių;3836374000;Taip;0;2;2;4
9073;Riešutėlis;Drugelių;8016820352;Taip;11;0;0;11
9074;Riešutėlis;Drugelių;3975091711;Taip;0;1;4;5
9075;Riešutėlis;Drugelių;3071643137;Taip;0;1;0;1
9076;Riešutėlis;Drugelių;2599147931;Taip;0;1;2;3
9077;Ramunėlė;SAULUTĖS;19664665864;Ne;0;7;0;7
9078;Ramunėlė;SAULUTĖS;44016905818;Taip;0;1;0;1
9079;Ramunėlė;SAULUTĖS;19784681244;Ne;0;7;8;15
9080;Ramunėlė;SAULUTĖS;9266024764;Taip;0;9;0;9
9081;Ramunėlė;SAULUTĖS;94707638226;Taip;0;1;0;1
9082;Ramunėlė;SAULUTĖS;69367849602;Taip;0;3;0;3
9083;Ramunėlė;SAULUTĖS;27163734018;Taip;0;5;6;11
9084;Ramunėlė;SAULUTĖS;2089805114;Taip;3;6;1;10
9085;Ramunėlė;SAULUTĖS;1079295964;Ne;0;2;0;2
9086;Ramunėlė;SAULUTĖS;26568396284;Ne;0;3;0;3
9087;Ramunėlė;SAULUTĖS;1982905923;Taip;7;0;8;15
9088;Ramunėlė;SAULUTĖS;16577268434;Taip;0;1;0;1
9089;Ramunėlė;SAULUTĖS;3599929268;Taip;0;1;0;1
9090;Ramunėlė;SAULUTĖS;80319760551;Taip;5;1;0;6
9091;Ramunėlė;SAULUTĖS;43737882488;Taip;5;2;0;7
9092;Ramunėlė;SAULUTĖS;72681762872;Taip;0;1;0;1
9093;Ramunėlė;SAULUTĖS;37338389480;Taip;6;0;0;6
9094;Ramunėlė;SAULUTĖS;7736649569;Taip;0;3;0;3
9095;Ramunėlė;SAULUTĖS;97944093065;Taip;0;1;0;1
9096;Ramunėlė;SAULUTĖS;85972695257;Taip;0;1;0;1
9097;Ramunėlė;SAULUTĖS;99807372989;Taip;0;5;0;5
9098;Ramunėlė;SAULUTĖS;42746084302;Taip;0;3;0;3
9099;Ramunėlė;SAULUTĖS;18362159086;Taip;6;3;2;11
9100;Ramunėlė;ŽIBUTĖ;2127262855;Taip;0;4;0;4
9101;Ramunėlė;ŽIBUTĖ;71451001033;Taip;5;2;2;9
9102;Ramunėlė;ŽIBUTĖ;8943746426;Taip;0;4;0;4
9103;Ramunėlė;ŽIBUTĖ;57697488265;Taip;7;7;0;14
9104;Ramunėlė;ŽIBUTĖ;4103951942;Taip;4;9;0;13
9105;Ramunėlė;ŽIBUTĖ;37227575121;Ne;0;7;0;7
9106;Ramunėlė;ŽIBUTĖ;9615607625;Taip;0;6;0;6
9107;Ramunėlė;ŽIBUTĖ;24395304267;Ne;7;1;0;8
9108;Ramunėlė;ŽIBUTĖ;41210974793;Taip;8;2;1;11
9109;Ramunėlė;ŽIBUTĖ;78632810141;Taip;0;0;9;9
9110;Ramunėlė;ŽIBUTĖ;8826277893;Taip;0;5;0;5
9111;Ramunėlė;ŽIBUTĖ;573414969;Taip;0;2;0;2
9112;Ramunėlė;ŽIBUTĖ;1686559920;Taip;6;2;0;8
9113;Ramunėlė;ŽIBUTĖ;1383896021;Taip;12;1;0;13
9114;Ramunėlė;ŽIBUTĖ;1898089064;Ne;6;15;0;21
9115;Ramunėlė;ŽIBUTĖ;6126971384;Taip;10;0;0;10
9116;Ramunėlė;ŽIBUTĖ;21178777924;Taip;0;2;10;12
9117;Ramunėlė;ŽIBUTĖ;1845973626;Taip;0;2;0;2
9118;Ramunėlė;ŽIBUTĖ;1575204445;Ne;7;0;0;7
9119;Ramunėlė;ŽIBUTĖ;2069380818;Taip;0;0;6;6
9120;Ramunėlė;ŽIBUTĖ;1511271386;Ne;0;6;0;6
9121;Ramunėlė;ŽIRNIUKAI;11512621396;Taip;7;0;0;7
9122;Ramunėlė;ŽIRNIUKAI;3973083939;Taip;0;1;0;1
9123;Ramunėlė;ŽIRNIUKAI;53748116108;Taip;0;4;0;4
9124;Ramunėlė;ŽIRNIUKAI;1028730863;Taip;0;2;0;2
9125;Ramunėlė;ŽIRNIUKAI;1085668968;Taip;0;1;0;1
9126;Ramunėlė;ŽIRNIUKAI;2075485387;Taip;20;0;0;20
9127;Ramunėlė;ŽIRNIUKAI;2036562086;Taip;0;1;0;1
9128;Ramunėlė;ŽIRNIUKAI;57963557951;Taip;10;0;0;10
9129;Ramunėlė;ŽIRNIUKAI;1485876800;Taip;0;0;1;1
9130;Ramunėlė;ŽIRNIUKAI;9924675250;Taip;0;4;2;6
9131;Ramunėlė;ŽIRNIUKAI;1386186515;Taip;0;0;2;2
9132;Ramunėlė;ŽIRNIUKAI;1364997950;Taip;0;6;0;6
9133;Ramunėlė;ŽIRNIUKAI;1171170929;Taip;0;2;3;5
9134;Ramunėlė;ŽIRNIUKAI;10677635919;Taip;0;6;0;6
9135;Ramunėlė;ŽIRNIUKAI;1157861595;Taip;0;0;1;1
9136;Ramunėlė;ŽIRNIUKAI;1397784717;Taip;8;0;1;9
9137;Ramunėlė;ŽIRNIUKAI;17292085814;Taip;0;2;0;2
9138;Ramunėlė;ŽIRNIUKAI;1500685962;Ne;0;7;0;7
9139;Ramunėlė;ŽIRNIUKAI;4814208279;Ne;4;1;1;6
9140;Ramunėlė;ŽIRNIUKAI;8254302108;Taip;0;1;0;1
9141;Ramunėlė;ŽIRNIUKAI;60610765717;Taip;6;0;0;6
9142;Ramunėlė;BITUTĖS;23095478847;Taip;0;5;0;5
9143;Ramunėlė;BITUTĖS;1866642357;Ne;0;7;0;7
9144;Ramunėlė;BITUTĖS;1343249939;Taip;0;0;1;1
9145;Ramunėlė;BITUTĖS;95100104105;Ne;14;0;3;17
9146;Ramunėlė;BITUTĖS;32249506035;Taip;7;2;0;9
9147;Ramunėlė;BITUTĖS;42582811243;Taip;0;2;0;2
9148;Ramunėlė;BITUTĖS;3683430430;Taip;10;8;0;18
9149;Ramunėlė;BITUTĖS;16357824257;Taip;0;1;0;1
9150;Ramunėlė;BITUTĖS;1012658900;Taip;0;9;0;9
9151;Ramunėlė;BITUTĖS;1485483496;Taip;0;13;0;13
9152;Ramunėlė;BITUTĖS;1090204906;Taip;0;0;1;1
9153;Ramunėlė;BITUTĖS;9961229084;Taip;6;0;0;6
9154;Ramunėlė;BITUTĖS;8098492540;Taip;0;13;0;13
9155;Ramunėlė;BITUTĖS;17201639406;Taip;0;0;5;5
9156;Ramunėlė;BITUTĖS;3065727741;Taip;5;0;1;6
9157;Ramunėlė;BITUTĖS;19420482998;Ne;0;7;0;7
9158;Ramunėlė;BITUTĖS;9130637883;Taip;0;8;0;8
9159;Ramunėlė;BITUTĖS;8016643568;Taip;0;4;0;4
9160;Ramunėlė;BITUTĖS;6217540064;Ne;8;2;0;10
9161;Ramunėlė;BITUTĖS;4990982790;Taip;16;0;0;16
9162;Ramunėlė;BITUTĖS;9171690612;Taip;8;2;2;12
9163;Ramunėlė;BITUTĖS;3271832822;Ne;0;2;3;5
9164;Ramunėlė;DRUGELIAI;15310034187;Taip;0;7;0;7
9165;Ramunėlė;DRUGELIAI;25346770513;Ne;4;3;3;10
9166;Ramunėlė;DRUGELIAI;28838673166;Ne;0;1;0;1
9167;Ramunėlė;DRUGELIAI;1253351354;Taip;0;0;1;1
9168;Ramunėlė;DRUGELIAI;13195968349;Taip;0;3;0;3
9169;Ramunėlė;DRUGELIAI;84319432445;Ne;0;2;3;5
9170;Ramunėlė;DRUGELIAI;26152001976;Ne;0;2;0;2
9171;Ramunėlė;DRUGELIAI;76947701645;Taip;0;5;0;5
9172;Ramunėlė;DRUGELIAI;1478538572;Taip;0;1;0;1
9173;Ramunėlė;DRUGELIAI;72620475723;Ne;0;4;0;4
9174;Ramunėlė;DRUGELIAI;92929314036;Taip;4;0;0;4
9175;Ramunėlė;DRUGELIAI;67836032797;Taip;13;3;0;16
9176;Ramunėlė;DRUGELIAI;9017349382;Taip;0;0;1;1
9177;Ramunėlė;DRUGELIAI;1376538015;Ne;0;14;0;14
9178;Ramunėlė;DRUGELIAI;1783572058;Taip;0;2;0;2
9179;Ramunėlė;DRUGELIAI;30907738272;Ne;5;1;0;6
9180;Ramunėlė;DRUGELIAI;1891454355;Ne;8;1;0;9
9181;Ramunėlė;DRUGELIAI;1199690327;Taip;0;1;2;3
9182;Ramunėlė;DRUGELIAI;1988109236;Taip;5;2;0;7
9183;Ramunėlė;DRUGELIAI;52168460247;Taip;1;2;0;3
9184;Ramunėlė;DRUGELIAI;66630134164;Taip;0;0;1;1
9185;Ramunėlė;NEUŽMIRŠTUOLĖS;7220407572;Taip;3;0;1;4
9186;Ramunėlė;NEUŽMIRŠTUOLĖS;6342801407;Taip;7;0;0;7
9187;Ramunėlė;NEUŽMIRŠTUOLĖS;7307307882;Taip;0;10;0;10
9188;Ramunėlė;NEUŽMIRŠTUOLĖS;1916520056;Taip;13;0;0;13
9189;Ramunėlė;NEUŽMIRŠTUOLĖS;7692958269;Taip;12;0;0;12
9190;Ramunėlė;NEUŽMIRŠTUOLĖS;5865482869;Taip;6;0;2;8
9191;Ramunėlė;NEUŽMIRŠTUOLĖS;6843262303;Taip;5;0;0;5
9192;Ramunėlė;NEUŽMIRŠTUOLĖS;5975101402;Taip;19;2;0;21
9193;Ramunėlė;NEUŽMIRŠTUOLĖS;6870110390;Taip;10;2;0;12
9194;Ramunėlė;NEUŽMIRŠTUOLĖS;2245564567;Taip;10;2;0;12
9195;Ramunėlė;NEUŽMIRŠTUOLĖS;8940763540;Taip;5;6;1;12
9196;Ramunėlė;NEUŽMIRŠTUOLĖS;2225787182;Taip;0;12;0;12
9197;Ramunėlė;NEUŽMIRŠTUOLĖS;6329943991;Taip;6;0;2;8
9198;Ramunėlė;NEUŽMIRŠTUOLĖS;8086994543;Taip;0;1;0;1
9199;Ramunėlė;NEUŽMIRŠTUOLĖS;6165754839;Taip;0;1;0;1
9200;Ramunėlė;OBUOLIUKAI;2555810841;Taip;9;0;0;9
9201;Ramunėlė;OBUOLIUKAI;7228065409;Taip;10;4;0;14
9202;Ramunėlė;OBUOLIUKAI;8402889872;Taip;11;2;0;13
9203;Ramunėlė;OBUOLIUKAI;1745170057;Taip;0;3;0;3
9204;Ramunėlė;OBUOLIUKAI;5170325023;Taip;0;0;4;4
9205;Ramunėlė;OBUOLIUKAI;8768539595;Taip;0;7;0;7
9206;Ramunėlė;OBUOLIUKAI;2055332353;Taip;10;6;0;16
9207;Ramunėlė;OBUOLIUKAI;2567264851;Taip;0;0;2;2
9208;Ramunėlė;OBUOLIUKAI;9584620339;Taip;0;1;0;1
9209;Ramunėlė;OBUOLIUKAI;6930505887;Taip;10;1;0;11
9210;Ramunėlė;OBUOLIUKAI;1199673371;Taip;5;0;0;5
9211;Ramunėlė;OBUOLIUKAI;7955507702;Taip;6;0;0;6
9212;Ramunėlė;OBUOLIUKAI;1078618047;Taip;0;13;0;13
9213;Ramunėlė;OBUOLIUKAI;4392309015;Taip;0;0;1;1
9214;Ramunėlė;OBUOLIUKAI;5049415445;Taip;7;0;1;8
9215;Ramunėlė;OBUOLIUKAI;8656417794;Taip;9;0;3;12
9216;Ramunėlė;OBUOLIUKAI;8205893352;Taip;0;14;0;14
9217;Ramunėlė;SAULĖGRĄŽA;5465647281;Taip;11;3;0;14
9218;Ramunėlė;SAULĖGRĄŽA;9927068798;Taip;5;0;0;5
9219;Ramunėlė;SAULĖGRĄŽA;3852734401;Taip;8;1;0;9
9220;Ramunėlė;SAULĖGRĄŽA;1483391590;Taip;5;2;6;13
9221;Ramunėlė;SAULĖGRĄŽA;8929122197;Taip;0;7;0;7
9222;Ramunėlė;SAULĖGRĄŽA;5605444408;Taip;2;2;0;4
9223;Ramunėlė;SAULĖGRĄŽA;4575123456;Taip;8;2;0;10
9224;Ramunėlė;SAULĖGRĄŽA;1192743154;Taip;0;6;0;6
9225;Ramunėlė;SAULĖGRĄŽA;5562960498;Taip;0;16;0;16
9226;Ramunėlė;SAULĖGRĄŽA;6134554678;Taip;11;4;0;15
9227;Ramunėlė;SAULĖGRĄŽA;8726443989;Taip;0;13;0;13
9228;Ramunėlė;SAULĖGRĄŽA;1599595174;Taip;6;1;0;7
9229;Ramunėlė;SAULĖGRĄŽA;3779769727;Taip;0;7;0;7
9230;Ramunėlė;SAULĖGRĄŽA;8323020864;Taip;14;0;0;14
9231;Ramunėlė;SAULĖGRĄŽA;8912978935;Taip;7;1;0;8
9232;Ramunėlė;SAULĖGRĄŽA;5420360864;Taip;12;1;0;13
9233;Ramunėlė;SAULĖGRĄŽA;4209191105;Taip;18;0;0;18
9234;Ramunėlė;SAULĖGRĄŽA;7902931560;Taip;4;4;0;8
9235;Ramunėlė;SAULĖGRĄŽA;5714771643;Taip;6;0;0;6
9236;Ramunėlė;BORUŽĖLĖS;82024687579;Taip;4;7;0;11
9237;Ramunėlė;BORUŽĖLĖS;1563618796;Taip;9;2;0;11
9238;Ramunėlė;BORUŽĖLĖS;1946639898;Taip;5;2;0;7
9239;Ramunėlė;BORUŽĖLĖS;63470398650;Taip;4;0;0;4
9240;Ramunėlė;BORUŽĖLĖS;1827657363;Taip;3;2;0;5
9241;Ramunėlė;BORUŽĖLĖS;1642082135;Taip;0;1;0;1
9242;Ramunėlė;BORUŽĖLĖS;1176835101;Taip;0;1;0;1
9243;Ramunėlė;BORUŽĖLĖS;1341351994;Taip;0;11;0;11
9244;Ramunėlė;BORUŽĖLĖS;1041998279;Taip;5;1;0;6
9245;Ramunėlė;BORUŽĖLĖS;2859202237;Taip;0;1;0;1
9246;Ramunėlė;BORUŽĖLĖS;1709795078;Taip;0;7;0;7
9247;Ramunėlė;BORUŽĖLĖS;1077068878;Taip;5;2;0;7
9248;Ramunėlė;BORUŽĖLĖS;1207455851;Taip;0;1;0;1
9249;Ramunėlė;BORUŽĖLĖS;76195144469;Taip;0;1;0;1
9250;Ramunėlė;BORUŽĖLĖS;1690224857;Taip;0;1;3;4
9251;Ramunėlė;BORUŽĖLĖS;1058243928;Taip;0;4;0;4
9252;Ramunėlė;BORUŽĖLĖS;93125217886;Taip;0;1;0;1
9253;Ramunėlė;BORUŽĖLĖS;17273267465;Taip;2;1;0;3
9254;Ramunėlė;BORUŽĖLĖS;1033548164;Taip;3;3;0;6
9255;Ramunėlė;BORUŽĖLĖS;1439962940;Taip;0;1;0;1
9256;Ramunėlė;NYKŠTUKAS;7250951221;Taip;5;2;0;7
9257;Ramunėlė;NYKŠTUKAS;2427399083;Taip;0;2;0;2
9258;Ramunėlė;NYKŠTUKAS;5316468106;Taip;0;0;3;3
9259;Ramunėlė;NYKŠTUKAS;4233978236;Taip;12;0;0;12
9260;Ramunėlė;NYKŠTUKAS;7622952406;Taip;11;1;4;16
9261;Ramunėlė;NYKŠTUKAS;2983986428;Taip;6;0;0;6
9262;Ramunėlė;NYKŠTUKAS;6156792400;Taip;7;2;0;9
9263;Ramunėlė;NYKŠTUKAS;5117135860;Taip;0;4;0;4
9264;Ramunėlė;NYKŠTUKAS;5548358138;Taip;5;0;1;6
9265;Ramunėlė;NYKŠTUKAS;3683181174;Taip;6;0;1;7
9266;Ramunėlė;NYKŠTUKAS;2422656007;Taip;0;8;1;9
9267;Ramunėlė;NYKŠTUKAS;6809164145;Taip;3;0;0;3
9268;Ramunėlė;NYKŠTUKAS;9984243153;Taip;14;0;0;14
9269;Ramunėlė;NYKŠTUKAS;6184872126;Taip;6;0;0;6
9270;Ramunėlė;NYKŠTUKAS;7829765488;Taip;1;0;3;4
9271;Ramunėlė;NYKŠTUKAS;7364976547;Taip;5;0;0;5
9272;Ramunėlė;NYKŠTUKAS;9217815657;Taip;0;17;0;17
9273;Ramunėlė;UOGELĖ;3996453947;Taip;6;1;0;7
9274;Ramunėlė;UOGELĖ;2591052434;Taip;6;0;1;7
9275;Ramunėlė;UOGELĖ;5304803880;Taip;0;8;0;8
9276;Ramunėlė;UOGELĖ;6389008823;Taip;15;3;0;18
9277;Ramunėlė;UOGELĖ;1671759939;Taip;12;2;0;14
9278;Ramunėlė;UOGELĖ;5315953299;Taip;0;1;0;1
9279;Ramunėlė;UOGELĖ;9136437288;Taip;0;5;0;5
9280;Ramunėlė;UOGELĖ;2446375037;Taip;0;2;0;2
9281;Ramunėlė;UOGELĖ;5801760033;Taip;0;2;2;4
9282;Ramunėlė;UOGELĖ;6627399830;Taip;9;0;0;9
9283;Ramunėlė;UOGELĖ;2605941371;Taip;0;1;0;1
9284;Ramunėlė;UOGELĖ;3525444906;Taip;0;1;0;1
9285;Ramunėlė;UOGELĖ;8055844166;Taip;0;11;0;11
9286;Ramunėlė;UOGELĖ;2686455030;Taip;11;2;0;13
9287;Ramunėlė;UOGELĖ;2173425836;Taip;11;2;0;13
9288;Ramunėlė;UOGELĖ;5650659504;Taip;0;1;0;1
9289;Ramunėlė;UOGELĖ;4715809064;Taip;4;1;0;5
9290;Ramunėlė;VARPELIAI;1534723406;Taip;11;0;1;12
9291;Ramunėlė;VARPELIAI;6837072361;Taip;2;3;0;5
9292;Ramunėlė;VARPELIAI;3566074517;Taip;7;3;0;10
9293;Ramunėlė;VARPELIAI;3685786758;Taip;0;11;0;11
9294;Ramunėlė;VARPELIAI;2007790746;Taip;4;0;0;4
9295;Ramunėlė;VARPELIAI;6310921755;Taip;5;3;0;8
9296;Ramunėlė;VARPELIAI;1303053333;Taip;3;1;0;4
9297;Ramunėlė;VARPELIAI;4349250416;Taip;0;7;0;7
9298;Ramunėlė;VARPELIAI;4677819736;Taip;0;1;2;3
9299;Ramunėlė;VARPELIAI;2499280049;Taip;9;2;0;11
9300;Ramunėlė;VARPELIAI;9448369796;Taip;4;0;0;4
9301;Ramunėlė;VARPELIAI;7750405604;Taip;2;1;0;3
9302;Ramunėlė;VARPELIAI;7295041630;Taip;0;1;0;1
9303;Ramunėlė;VARPELIAI;6695672297;Taip;8;2;0;10
9304;Ramunėlė;VARPELIAI;7825538259;Taip;9;0;1;10
9305;Ramunėlė;VARPELIAI;58028743912;Taip;18;0;0;18
9306;Ramunėlė;VARPELIAI;6612728883;Taip;0;5;3;8
9307;Ramunėlė;VARPELIAI;1567537525;Taip;3;2;2;7
9308;Ramunėlė;VARPELIAI;1216101539;Taip;8;4;0;12
9309;Ramunėlė;VARPELIAI;7638038269;Taip;5;1;0;6
9310;Ramunėlė;VARPELIAI;3554787356;Taip;12;0;4;16
9311;Ramunėlė;VARPELIAI;8496322672;Taip;6;0;0;6
9312;Rūta;SMALSUČIAI;14391882157;Taip;0;2;0;2
9313;Rūta;SMALSUČIAI;18117978189;Taip;0;4;0;4
9314;Rūta;SMALSUČIAI;77285178781;Taip;0;2;0;2
9315;Rūta;SMALSUČIAI;78953568121;Ne;0;1;0;1
9316;Rūta;SMALSUČIAI;26152518052;Taip;21;0;0;21
9317;Rūta;SMALSUČIAI;68107516536;Ne;0;6;0;6
9318;Rūta;SMALSUČIAI;87692898919;Taip;0;1;0;1
9319;Rūta;SMALSUČIAI;3874247966;Taip;7;1;1;9
9320;Rūta;SMALSUČIAI;1323253379;Taip;0;1;0;1
9321;Rūta;SMALSUČIAI;8604212304;Taip;0;5;0;5
9322;Rūta;SMALSUČIAI;38837808144;Taip;0;0;1;1
9323;Rūta;SMALSUČIAI;50814418724;Ne;0;5;0;5
9324;Rūta;SMALSUČIAI;1364470800;Taip;0;0;2;2
9325;Rūta;SMALSUČIAI;1996690514;Taip;8;11;0;19
9326;Rūta;SMALSUČIAI;59694891781;Taip;0;11;0;11
9327;Rūta;SMALSUČIAI;83473072263;Taip;0;5;0;5
9328;Rūta;SMALSUČIAI;2986201324;Taip;0;0;1;1
9329;Rūta;KŪLVERSTUKAI;1080628212;Taip;0;0;4;4
9330;Rūta;KŪLVERSTUKAI;80410156050;Taip;5;1;0;6
9331;Rūta;KŪLVERSTUKAI;1150292834;Taip;5;2;0;7
9332;Rūta;KŪLVERSTUKAI;56171468735;Taip;0;4;0;4
9333;Rūta;KŪLVERSTUKAI;88159609117;Taip;0;6;0;6
9334;Rūta;KŪLVERSTUKAI;2084379688;Taip;0;2;0;2
9335;Rūta;KŪLVERSTUKAI;1807332522;Taip;6;2;0;8
9336;Rūta;KŪLVERSTUKAI;1674584707;Taip;0;7;0;7
9337;Rūta;KŪLVERSTUKAI;2079429418;Taip;0;5;0;5
9338;Rūta;KŪLVERSTUKAI;1972150300;Taip;5;2;0;7
9339;Rūta;KŪLVERSTUKAI;99777522247;Taip;8;3;0;11
9340;Rūta;KŪLVERSTUKAI;1971925569;Taip;0;8;0;8
9341;Rūta;KŪLVERSTUKAI;56470874552;Taip;5;1;0;6
9342;Rūta;KŪLVERSTUKAI;1363296753;Taip;0;1;0;1
9343;Rūta;KŪLVERSTUKAI;17349566042;Taip;0;5;0;5
9344;Rūta;KŪLVERSTUKAI;1043614414;Taip;0;1;0;1
9345;Rūta;KŪLVERSTUKAI;1703148668;Taip;6;0;0;6
9346;Rūta;KŪLVERSTUKAI;1177226887;Ne;1;1;0;2
9347;Rūta;KODĖLČIUKAI;2546023973;Taip;2;0;10;12
9348;Rūta;KODĖLČIUKAI;5007973484;Taip;0;0;1;1
9349;Rūta;KODĖLČIUKAI;1775029025;Taip;0;0;3;3
9350;Rūta;KODĖLČIUKAI;8958880558;Taip;10;2;1;13
9351;Rūta;KODĖLČIUKAI;2263820829;Taip;12;0;1;13
9352;Rūta;KODĖLČIUKAI;2485048971;Taip;14;0;0;14
9353;Rūta;KODĖLČIUKAI;5109138407;Taip;10;0;0;10
9354;Rūta;KODĖLČIUKAI;2286358230;Taip;0;0;7;7
9355;Rūta;KODĖLČIUKAI;8599313527;Taip;0;6;0;6
9356;Rūta;KODĖLČIUKAI;6186413364;Taip;0;16;0;16
9357;Rūta;KODĖLČIUKAI;6458458913;Taip;1;2;0;3
9358;Rūta;KODĖLČIUKAI;6585842434;Taip;2;0;0;2
9359;Rūta;BORUŽĖLĖS;1623968580;Taip;3;4;1;8
9360;Rūta;BORUŽĖLĖS;3043164521;Taip;0;2;1;3
9361;Rūta;BORUŽĖLĖS;8273644943;Taip;10;0;5;15
9362;Rūta;BORUŽĖLĖS;4293920701;Taip;0;0;1;1
9363;Rūta;BORUŽĖLĖS;9419809946;Taip;4;0;0;4
9364;Rūta;BORUŽĖLĖS;3454881685;Taip;2;0;1;3
9365;Rūta;BORUŽĖLĖS;1811055786;Taip;0;1;1;2
9366;Rūta;BORUŽĖLĖS;1510268514;Taip;2;1;2;5
9367;Rūta;BORUŽĖLĖS;2702537976;Taip;0;1;2;3
9368;Rūta;BORUŽĖLĖS;4044349935;Taip;20;0;0;20
9369;Rūta;BORUŽĖLĖS;7936198171;Taip;5;1;0;6
9370;Rūta;BORUŽĖLĖS;9243332756;Taip;8;0;0;8
9371;Rūta;BORUŽĖLĖS;8963959004;Taip;0;10;1;11
9372;Rūta;BORUŽĖLĖS;2772130413;Taip;7;1;0;8
9373;Rūta;VYTURĖLIAI;78925728976;Ne;0;1;2;3
9374;Rūta;VYTURĖLIAI;44365150696;Taip;0;6;0;6
9375;Rūta;VYTURĖLIAI;10957816153;Taip;0;1;0;1
9376;Rūta;VYTURĖLIAI;35843737071;Taip;0;1;0;1
9377;Rūta;VYTURĖLIAI;13023764979;Ne;2;0;0;2
9378;Rūta;VYTURĖLIAI;4409524323;Taip;0;1;1;2
9379;Rūta;VYTURĖLIAI;2033577529;Taip;0;5;0;5
9380;Rūta;VYTURĖLIAI;28332403249;Taip;0;2;2;4
9381;Rūta;VYTURĖLIAI;79762491266;Taip;6;1;0;7
9382;Rūta;VYTURĖLIAI;76831234529;Taip;0;3;0;3
9383;Rūta;VYTURĖLIAI;24211514845;Taip;0;2;0;2
9384;Rūta;VYTURĖLIAI;28158130932;Taip;0;1;0;1
9385;Rūta;VYTURĖLIAI;50266063379;Ne;0;2;0;2
9386;Rūta;VYTURĖLIAI;28676981495;Taip;0;1;0;1
9387;Rūta;VYTURĖLIAI;91072621203;Taip;0;7;0;7
9388;Rūta;VYTURĖLIAI;81049938466;Taip;11;0;0;11
9389;Rūta;VYTURĖLIAI;34935546673;Taip;0;15;0;15
9390;Rūta;VYTURĖLIAI;47869128534;Taip;0;15;0;15
9391;Rūta;VYTURĖLIAI;67740925555;Taip;0;6;0;6
9392;Rūta;"PABIRUČIAI (LOGOPEDINĖ)";1489564914;Taip;0;12;0;12
9393;Rūta;"PABIRUČIAI (LOGOPEDINĖ)";3055294324;Ne;0;4;0;4
9394;Rūta;"PABIRUČIAI (LOGOPEDINĖ)";3247709788;Taip;0;14;0;14
9395;Rūta;"PABIRUČIAI (LOGOPEDINĖ)";1035527190;Taip;0;0;7;7
9396;Rūta;"PABIRUČIAI (LOGOPEDINĖ)";6136733410;Taip;0;1;3;4
9397;Rūta;GUDRUČIAI;1967141665;Ne;6;5;2;13
9398;Rūta;GUDRUČIAI;3873876608;Taip;0;1;0;1
9399;Rūta;GUDRUČIAI;8851591109;Taip;9;0;4;13
9400;Rūta;GUDRUČIAI;1180144866;Taip;11;0;0;11
9401;Rūta;GUDRUČIAI;3478456813;Taip;0;2;0;2
9402;Rūta;GUDRUČIAI;8889388348;Taip;5;0;1;6
9403;Rūta;GUDRUČIAI;2116581815;Taip;0;0;5;5
9404;Rūta;GUDRUČIAI;4363571135;Taip;0;16;0;16
9405;Rūta;GUDRUČIAI;6006094035;Taip;0;21;0;21
9406;Rūta;GUDRUČIAI;1521231573;Ne;5;0;5;10
9407;Rūta;GUDRUČIAI;7552644990;Taip;10;0;4;14
9408;Rūta;GUDRUČIAI;1092908255;Taip;0;1;0;1
9409;Rūta;GUDRUČIAI;8673942478;Taip;6;1;2;9
9410;Rūta;GUDRUČIAI;4078957924;Taip;0;3;1;4
9411;Rūta;GUDRUČIAI;4754142240;Taip;0;1;3;4
9412;Rūta;GUDRUČIAI;1565896222;Taip;0;4;1;5
9413;Rūta;GUDRUČIAI;8704594038;Taip;3;0;2;5
9414;Rūta;GUDRUČIAI;7631229177;Taip;9;0;0;9
9415;Rūta;GUDRUČIAI;8026402652;Ne;10;0;0;10
9416;Rūta;SEKLYTĖLĖ;1800198849;Taip;0;2;0;2
9417;Rūta;SEKLYTĖLĖ;54140704807;Taip;0;5;3;8
9418;Rūta;SEKLYTĖLĖ;26830853793;Taip;0;0;2;2
9419;Rūta;SEKLYTĖLĖ;75322385068;Taip;0;3;0;3
9420;Rūta;SEKLYTĖLĖ;76518034714;Taip;0;1;0;1
9421;Rūta;SEKLYTĖLĖ;42791864630;Taip;10;2;0;12
9422;Rūta;SEKLYTĖLĖ;20967345257;Taip;0;1;1;2
9423;Rūta;SEKLYTĖLĖ;29240858006;Taip;10;3;0;13
9424;Rūta;SEKLYTĖLĖ;75730421646;Ne;0;15;0;15
9425;Rūta;SEKLYTĖLĖ;2711671531;Taip;0;1;2;3
9426;Rūta;SEKLYTĖLĖ;9994442882;Taip;0;2;0;2
9427;Rūta;SEKLYTĖLĖ;29483136582;Taip;0;1;0;1
9428;Rūta;SEKLYTĖLĖ;1545183162;Ne;2;0;0;2
9429;Rūta;SEKLYTĖLĖ;5733023163;Taip;0;7;2;9
9430;Rūta;SEKLYTĖLĖ;7061384784;Taip;0;0;9;9
9431;Rūta;"VARPELIAI (LOGOPEDINĖ)";38269797498;Ne;3;0;0;3
9432;Rūta;"VARPELIAI (LOGOPEDINĖ)";1863889584;Taip;0;1;4;5
9433;Rūta;"VARPELIAI (LOGOPEDINĖ)";70608720189;Taip;0;3;6;9
9434;Rūta;"VARPELIAI (LOGOPEDINĖ)";58313529531;Taip;9;1;0;10
9435;Rūta;KIŠKUČIŲ;4297300799;Taip;5;2;0;7
9436;Rūta;KIŠKUČIŲ;6207902435;Taip;0;9;0;9
9437;Rūta;KIŠKUČIŲ;9791861646;Taip;0;1;3;4
9438;Rūta;KIŠKUČIŲ;8182243701;Taip;0;1;10;11
9439;Rūta;KIŠKUČIŲ;4728904136;Taip;0;8;0;8
9440;Rūta;KIŠKUČIŲ;6316768460;Taip;10;0;0;10
9441;Rūta;KIŠKUČIŲ;2928803089;Taip;0;10;0;10
9442;Rūta;KIŠKUČIŲ;5899860543;Taip;0;3;0;3
9443;Rūta;KIŠKUČIŲ;8378318357;Ne;10;0;6;16
9444;Rūta;KIŠKUČIŲ;4962272621;Taip;0;0;4;4
9445;Rūta;KIŠKUČIŲ;9603105651;Taip;16;0;0;16
9446;Rūta;KIŠKUČIŲ;1951202550;Taip;9;0;0;9
9447;Rūta;KIŠKUČIŲ;9911151238;Taip;0;0;5;5
9448;Rūta;KIŠKUČIŲ;1346124133;Taip;3;0;0;3
9449;Rūta;ŽVIRBLIUKAI;3499727608;Taip;12;6;0;18
9450;Rūta;ŽVIRBLIUKAI;9765301038;Taip;12;6;0;18
9451;Rūta;ŽVIRBLIUKAI;8277677952;Taip;10;0;0;10
9452;Rūta;ŽVIRBLIUKAI;9638495757;Taip;6;0;0;6
9453;Rūta;ŽVIRBLIUKAI;3956912957;Ne;9;0;0;9
9454;Rūta;ŽVIRBLIUKAI;3055345528;Taip;0;7;5;12
9455;Rūta;ŽVIRBLIUKAI;4423305209;Ne;0;2;0;2
9456;Rūta;ŽVIRBLIUKAI;2890569107;Taip;0;0;7;7
9457;Rūta;ŽVIRBLIUKAI;3964922552;Taip;5;1;0;6
9458;Rūta;ŽVIRBLIUKAI;1216786487;Taip;0;5;0;5
9459;Rūta;ŽVIRBLIUKAI;9736567509;Taip;0;0;5;5
9460;Rūta;ŽVIRBLIUKAI;2474991135;Taip;9;1;0;10
9461;Rūta;ŽVIRBLIUKAI;7519931138;Taip;0;0;5;5
9462;Rūta;ŽVIRBLIUKAI;9400586178;Taip;0;0;4;4
9463;Rūta;ŽVIRBLIUKAI;8395765508;Taip;0;0;1;1
9464;Rūta;ŽVIRBLIUKAI;7222494215;Taip;0;0;4;4
9465;Rūta;ŽVIRBLIUKAI;5264690055;Taip;0;0;3;3
9466;Rūta;ŽVIRBLIUKAI;1962172243;Taip;0;1;2;3
9467;Rūta;ŽVIRBLIUKAI;7553844890;Taip;0;0;6;6
9468;Rūta;ŽVIRBLIUKAI;8605070655;Taip;0;1;3;4
9469;Rūta;SAULUTĖS;1671913833;Taip;0;1;3;4
9470;Rūta;SAULUTĖS;1186493111;Taip;0;7;0;7
9471;Rūta;SAULUTĖS;9675482322;Ne;0;1;2;3
9472;Rūta;SAULUTĖS;1415664888;Taip;0;0;7;7
9473;Rūta;SAULUTĖS;4426456302;Taip;7;0;1;8
9474;Rūta;SAULUTĖS;4282074540;Taip;0;5;1;6
9475;Rūta;SAULUTĖS;8607455403;Taip;0;4;0;4
9476;Rūta;SAULUTĖS;4168356825;Taip;0;0;2;2
9477;Rūta;SAULUTĖS;9569447586;Taip;0;5;0;5
9478;Rūta;SAULUTĖS;1579573872;Taip;0;1;1;2
9479;Rūta;SAULUTĖS;2677062861;Taip;6;0;0;6
9480;Rūta;SAULUTĖS;1390207547;Taip;0;2;0;2
9481;Rūta;SAULUTĖS;32004750783;Taip;0;0;5;5
9482;Rūta;SAULUTĖS;2912054049;Taip;0;0;2;2
9483;Rūta;SAULUTĖS;3567273206;Ne;0;0;3;3
9484;Rūta;SAULUTĖS;1368317570;Taip;6;0;0;6
9485;Sadutė;Kiškučiai;38918375280;Taip;0;2;0;2
9486;Sadutė;Kiškučiai;62408324442;Taip;13;0;0;13
9487;Sadutė;Kiškučiai;12421864073;Taip;0;3;0;3
9488;Sadutė;Kiškučiai;3253659165;Taip;0;1;0;1
9489;Sadutė;Kiškučiai;67439547513;Taip;0;1;0;1
9490;Sadutė;Kiškučiai;98527988102;Taip;10;1;0;11
9491;Sadutė;Kiškučiai;62077575922;Ne;3;1;1;5
9492;Sadutė;Kiškučiai;75149739907;Taip;4;0;0;4
9493;Sadutė;Kiškučiai;48298497;Taip;7;0;0;7
9494;Sadutė;Kiškučiai;69988140413;Taip;0;1;0;1
9495;Sadutė;Kiškučiai;61357382189;Taip;0;1;0;1
9496;Sadutė;Kiškučiai;1433422421;Taip;3;1;3;7
9497;Sadutė;Kiškučiai;73649870571;Taip;11;0;5;16
9498;Sadutė;Kiškučiai;1092421263;Taip;6;0;0;6
9499;Sadutė;Kiškučiai;64959385010;Taip;4;2;0;6
9500;Sadutė;Kiškučiai;9883685724;Taip;13;1;0;14
9501;Sadutė;Kiškučiai;4525909977;Taip;10;0;0;10
9502;Sadutė;Kiškučiai;1533081218;Taip;5;0;1;6
9503;Sadutė;Kiškučiai;3400524440;Taip;0;0;2;2
9504;Sadutė;Boružėlės;31020557647;Taip;3;0;0;3
9505;Sadutė;Boružėlės;99171108375;Taip;0;5;0;5
9506;Sadutė;Boružėlės;30046732620;Taip;2;1;0;3
9507;Sadutė;Boružėlės;91943880567;Taip;0;0;2;2
9508;Sadutė;Boružėlės;70505797915;Taip;0;1;0;1
9509;Sadutė;Boružėlės;48817619537;Taip;0;6;0;6
9510;Sadutė;Boružėlės;76464399248;Taip;0;1;0;1
9511;Sadutė;Boružėlės;47883796567;Taip;0;1;0;1
9512;Sadutė;Boružėlės;93561298785;Taip;0;1;0;1
9513;Sadutė;Boružėlės;48327367042;Taip;0;1;2;3
9514;Sadutė;Boružėlės;4064111008;Taip;0;1;1;2
9515;Sadutė;Boružėlės;35237170892;Taip;0;4;0;4
9516;Sadutė;Boružėlės;45569403734;Taip;0;1;0;1
9517;Sadutė;Boružėlės;84758378727;Taip;10;1;0;11
9518;Sadutė;Boružėlės;38373089101;Taip;4;0;0;4
9519;Sadutė;Boružėlės;13779484979;Taip;0;1;2;3
9520;Sadutė;Boružėlės;12989960431;Taip;0;0;1;1
9521;Sadutė;Boružėlės;2414632774;Taip;9;1;0;10
9522;Sadutė;Boružėlės;16493384211;Taip;7;0;2;9
9523;Sadutė;Boružėlės;71576294118;Ne;0;1;0;1
9524;Sadutė;Boružėlės;21011440269;Ne;0;1;0;1
9525;Sadutė;Boružėlės;39222963335;Taip;0;1;4;5
9526;Sadutė;Boružėlės;4695479762;Taip;0;8;0;8
9527;Sadutė;Boružėlės;1920496059;Taip;15;1;0;16
9528;Sadutė;Bitutės;1759479328;Taip;0;1;0;1
9529;Sadutė;Bitutės;1975767401;Taip;0;1;0;1
9530;Sadutė;Bitutės;4245873513;Taip;14;1;0;15
9531;Sadutė;Bitutės;1873928395;Taip;0;21;0;21
9532;Sadutė;Bitutės;8140354445;Taip;3;6;0;9
9533;Sadutė;Bitutės;5866461096;Taip;7;0;2;9
9534;Sadutė;Bitutės;4883934480;Ne;6;0;0;6
9535;Sadutė;Bitutės;9107727583;Ne;0;0;4;4
9536;Sadutė;Bitutės;7097653016;Ne;6;1;0;7
9537;Sadutė;Bitutės;4479315578;Taip;9;0;0;9
9538;Sadutė;Bitutės;2020766695;Taip;10;0;1;11
9539;Sadutė;Bitutės;5011320850;Taip;4;3;0;7
9540;Sadutė;Bitutės;4161502667;Taip;9;0;0;9
9541;Sadutė;Bitutės;5973513916;Taip;0;14;0;14
9542;Sadutė;Bitutės;3361904803;Taip;0;21;0;21
9543;Sadutė;Bitutės;1231048342;Ne;11;1;0;12
9544;Sadutė;Drugeliai;9090754149;Taip;0;1;0;1
9545;Sadutė;Drugeliai;1552350084;Taip;6;1;0;7
9546;Sadutė;Drugeliai;7910380894;Taip;0;1;0;1
9547;Sadutė;Drugeliai;4402558234;Taip;0;1;0;1
9548;Sadutė;Drugeliai;8713575864;Taip;9;0;0;9
9549;Sadutė;Drugeliai;6994547344;Taip;0;1;0;1
9550;Sadutė;Drugeliai;1782594187;Ne;1;11;0;12
9551;Sadutė;Drugeliai;5816844295;Taip;0;13;0;13
9552;Sadutė;Drugeliai;2095914442;Taip;1;6;0;7
9553;Sadutė;Drugeliai;8803249656;Taip;8;1;1;10
9554;Sadutė;Drugeliai;4901634532;Taip;6;0;0;6
9555;Sadutė;Drugeliai;6196282159;Taip;15;1;2;18
9556;Sadutė;Drugeliai;8953107298;Taip;14;0;3;17
9557;Sadutė;Drugeliai;1735450955;Taip;0;1;0;1
9558;Sadutė;Drugeliai;2064784580;Taip;0;1;0;1
9559;Sadutė;Drugeliai;2883991326;Taip;2;0;0;2
9560;Sadutė;Drugeliai;7731164484;Taip;0;2;0;2
9561;Sadutė;Drugeliai;2014660237;Taip;9;0;2;11
9562;Sadutė;Drugeliai;6124376554;Taip;12;0;0;12
9563;Sadutė;Drugeliai;8322941607;Taip;16;0;0;16
9564;Sadutė;Pėledžiukai;50662732693;Taip;5;6;0;11
9565;Sadutė;Pėledžiukai;26761581977;Taip;14;0;0;14
9566;Sadutė;Pėledžiukai;1885941594;Taip;0;4;0;4
9567;Sadutė;Pėledžiukai;4933574100;Taip;10;0;0;10
9568;Sadutė;Pėledžiukai;6105924871;Taip;6;0;4;10
9569;Sadutė;Pėledžiukai;8870465478;Taip;5;11;1;17
9570;Sadutė;Pėledžiukai;64835095908;Taip;11;0;5;16
9571;Sadutė;Pėledžiukai;3619323573;Taip;8;1;6;15
9572;Sadutė;Pėledžiukai;14962142857;Taip;10;0;0;10
9573;Sadutė;Pėledžiukai;92111253012;Taip;0;1;0;1
9574;Sadutė;Pėledžiukai;1594844154;Ne;0;10;1;11
9575;Sadutė;Pėledžiukai;1005751811;Taip;10;0;1;11
9576;Sadutė;Pėledžiukai;45981672295;Taip;0;2;0;2
9577;Sadutė;Pėledžiukai;5864572784;Taip;1;0;0;1
9578;Sadutė;Pėledžiukai;8667620186;Taip;3;1;0;4
9579;Sadutė;Pėledžiukai;9946417453;Ne;0;8;3;11
9580;Sadutė;Pėledžiukai;48818906299;Ne;5;10;2;17
9581;Sadutė;Pėledžiukai;1003580436;Taip;12;0;0;12
9582;Sadutė;Pėledžiukai;1190667513;Taip;17;0;0;17
9583;Sadutė;Pėledžiukai;1988169256;Taip;0;6;2;8
9584;Sadutė;Pėledžiukai;1985946393;Taip;0;6;0;6
9585;Sadutė;Kačiukų;1507052440;Taip;0;1;13;14
9586;Sadutė;Kačiukų;1903961488;Taip;0;1;1;2
9587;Sadutė;Kačiukų;2890916313;Taip;10;0;7;17
9588;Sadutė;Kačiukų;2733633163;Taip;0;0;3;3
9589;Sadutė;Kačiukų;3993181500;Taip;13;0;0;13
9590;Sadutė;Kačiukų;1871236869;Taip;2;1;0;3
9591;Sadutė;Kačiukų;8835627470;Taip;6;1;0;7
9592;Sadutė;Kačiukų;2532626934;Taip;0;1;6;7
9593;Sadutė;Kačiukų;2466024649;Taip;4;0;0;4
9594;Sadutė;Kačiukų;6253351299;Taip;0;1;2;3
9595;Sadutė;Kačiukų;2426974464;Taip;0;1;3;4
9596;Sadutė;Kačiukų;5438448926;Taip;6;0;0;6
9597;Sadutė;Kačiukų;8974374101;Taip;7;0;2;9
9598;Sadutė;Kačiukų;4401870028;Taip;0;0;1;1
9599;Sadutė;Kačiukų;8714168144;Taip;6;0;0;6
9600;Sadutė;Kačiukų;3927044011;Taip;0;0;2;2
9601;Sadutė;Kačiukų;8974225608;Taip;0;0;1;1
9602;Sadutė;Kačiukų;8770727233;Taip;3;0;0;3
9603;Sakalėlis;GIRINUKŲ;9566176151;Taip;19;0;0;19
9604;Sakalėlis;GIRINUKŲ;8606714134;Ne;0;1;0;1
9605;Sakalėlis;GIRINUKŲ;2895663259;Taip;4;0;0;4
9606;Sakalėlis;GIRINUKŲ;5405669698;Ne;6;0;1;7
9607;Sakalėlis;GIRINUKŲ;2474164013;Ne;21;0;0;21
9608;Sakalėlis;GIRINUKŲ;9493905856;Taip;11;0;1;12
9609;Sakalėlis;GIRINUKŲ;5496044442;Taip;2;1;2;5
9610;Sakalėlis;GIRINUKŲ;3165387995;Taip;0;0;3;3
9611;Sakalėlis;GIRINUKŲ;3418702674;Taip;0;1;3;4
9612;Sakalėlis;GIRINUKŲ;3748865437;Taip;6;0;0;6
9613;Sakalėlis;GIRINUKŲ;6700169944;Taip;1;0;1;2
9614;Sakalėlis;GIRINUKŲ;3333037807;Taip;7;0;0;7
9615;Sakalėlis;GIRINUKŲ;8667155756;Ne;5;0;2;7
9616;Sakalėlis;GIRINUKŲ;4596727938;Taip;0;0;2;2
9617;Sakalėlis;GIRINUKŲ;6706466627;Taip;10;0;1;11
9618;Sakalėlis;GIRINUKŲ;8790189865;Taip;12;3;0;15
9619;Sakalėlis;GIRINUKŲ;4458071075;Taip;5;0;0;5
9620;Sakalėlis;GIRINUKŲ;4209146744;Taip;2;0;0;2
9621;Sakalėlis;GIRINUKŲ;2780141413;Taip;0;7;0;7
9622;Sakalėlis;GIRINUKŲ;1347171934;Taip;5;0;1;6
9623;Sakalėlis;GIRINUKŲ;9823633774;Taip;12;0;0;12
9624;Sakalėlis;VYTURIUKŲ;21726291811;Taip;0;0;1;1
9625;Sakalėlis;VYTURIUKŲ;7852180045;Taip;0;1;1;2
9626;Sakalėlis;VYTURIUKŲ;27291131963;Taip;0;1;2;3
9627;Sakalėlis;VYTURIUKŲ;1822130260;Taip;0;6;3;9
9628;Sakalėlis;VYTURIUKŲ;25558438129;Taip;0;1;4;5
9629;Sakalėlis;VYTURIUKŲ;33360718659;Taip;0;1;0;1
9630;Sakalėlis;VYTURIUKŲ;59440026693;Taip;0;0;6;6
9631;Sakalėlis;VYTURIUKŲ;99937511623;Taip;0;1;0;1
9632;Sakalėlis;VYTURIUKŲ;14495611614;Taip;0;1;0;1
9633;Sakalėlis;VYTURIUKŲ;32956243898;Taip;5;1;0;6
9634;Sakalėlis;VYTURIUKŲ;87806505145;Taip;0;0;1;1
9635;Sakalėlis;VYTURIUKŲ;59067963901;Taip;19;1;0;20
9636;Sakalėlis;VYTURIUKŲ;1371469574;Taip;0;7;0;7
9637;Sakalėlis;VYTURIUKŲ;60351276074;Taip;0;1;0;1
9638;Sakalėlis;VYTURIUKŲ;74622921410;Taip;0;1;0;1
9639;Sakalėlis;VYTURIUKŲ;13953070987;Taip;11;1;0;12
9640;Sakalėlis;VYTURIUKŲ;12474715312;Taip;0;1;0;1
9641;Sakalėlis;VYTURIUKŲ;80747256105;Taip;14;0;0;14
9642;Sakalėlis;VYTURIUKŲ;77801416034;Taip;13;0;0;13
9643;Sakalėlis;VYTURIUKŲ;12601081196;Taip;0;1;4;5
9644;Sakalėlis;VYTURIUKŲ;60747121226;Taip;0;1;0;1
9645;Sakalėlis;DRUGELIŲ;1299944831;Taip;0;1;0;1
9646;Sakalėlis;DRUGELIŲ;97259304899;Taip;0;1;2;3
9647;Sakalėlis;DRUGELIŲ;1605682818;Taip;0;3;0;3
9648;Sakalėlis;DRUGELIŲ;57477662126;Taip;0;1;0;1
9649;Sakalėlis;DRUGELIŲ;78050507580;Taip;0;1;2;3
9650;Sakalėlis;DRUGELIŲ;19456041826;Taip;0;1;0;1
9651;Sakalėlis;DRUGELIŲ;28930740067;Taip;0;1;0;1
9652;Sakalėlis;DRUGELIŲ;88344653299;Taip;10;5;0;15
9653;Sakalėlis;DRUGELIŲ;15950016412;Ne;0;1;0;1
9654;Sakalėlis;DRUGELIŲ;87950904971;Taip;0;1;0;1
9655;Sakalėlis;DRUGELIŲ;44702801581;Taip;0;9;0;9
9656;Sakalėlis;DRUGELIŲ;1075787529;Taip;5;1;3;9
9657;Sakalėlis;DRUGELIŲ;1421038685;Taip;0;0;1;1
9658;Sakalėlis;DRUGELIŲ;2124748537;Ne;0;1;2;3
9659;Sakalėlis;DRUGELIŲ;9634589602;Taip;1;0;1;2
9660;Sakalėlis;DRUGELIŲ;4583569438;Taip;4;1;2;7
9661;Sakalėlis;DRUGELIŲ;1139467130;Taip;0;1;0;1
9662;Sakalėlis;GENIUKŲ;1526540031;Ne;3;3;0;6
9663;Sakalėlis;GENIUKŲ;4763858893;Taip;0;1;8;9
9664;Sakalėlis;GENIUKŲ;3337299648;Taip;13;0;0;13
9665;Sakalėlis;GENIUKŲ;9830907922;Taip;0;1;0;1
9666;Sakalėlis;GENIUKŲ;43677485606;Taip;15;4;0;19
9667;Sakalėlis;GENIUKŲ;8649226611;Taip;0;0;1;1
9668;Sakalėlis;GENIUKŲ;5717022080;Taip;0;1;0;1
9669;Sakalėlis;GENIUKŲ;4515180509;Taip;0;0;10;10
9670;Sakalėlis;GENIUKŲ;1027765680;Ne;9;1;0;10
9671;Sakalėlis;GENIUKŲ;96053733139;Taip;0;5;0;5
9672;Sakalėlis;GENIUKŲ;4612388683;Taip;17;1;0;18
9673;Sakalėlis;GENIUKŲ;7159705304;Taip;0;0;1;1
9674;Sakalėlis;GENIUKŲ;4775685174;Taip;12;1;0;13
9675;Sakalėlis;GENIUKŲ;69916351348;Taip;14;1;0;15
9676;Sakalėlis;GENIUKŲ;6727251397;Taip;20;0;0;20
9677;Sakalėlis;GENIUKŲ;1552929452;Taip;7;0;0;7
9678;Sakalėlis;GENIUKŲ;8936933971;Taip;0;0;11;11
9679;Sakalėlis;GENIUKŲ;2829386777;Taip;10;2;1;13
9680;Sakalėlis;GENIUKŲ;3371763993;Taip;4;2;0;6
9681;Sakalėlis;GENIUKŲ;7085108710;Taip;1;0;2;3
9682;Sakalėlis;GENIUKŲ;2902195855;Taip;0;1;1;2
9683;Sakalėlis;VOVERIUKŲ;6190741162;Ne;0;0;5;5
9684;Sakalėlis;VOVERIUKŲ;1702964714;Taip;7;0;1;8
9685;Sakalėlis;VOVERIUKŲ;1141943082;Taip;0;1;0;1
9686;Sakalėlis;VOVERIUKŲ;3962436122;Taip;0;2;1;3
9687;Sakalėlis;VOVERIUKŲ;1946531018;Taip;1;0;1;2
9688;Sakalėlis;VOVERIUKŲ;2796230671;Taip;3;0;2;5
9689;Sakalėlis;VOVERIUKŲ;1210451022;Taip;0;1;0;1
9690;Sakalėlis;VOVERIUKŲ;1912068116;Taip;12;0;0;12
9691;Sakalėlis;VOVERIUKŲ;8662137531;Taip;0;1;2;3
9692;Sakalėlis;VOVERIUKŲ;1104881142;Taip;0;1;0;1
9693;Sakalėlis;VOVERIUKŲ;46629941288;Taip;10;5;0;15
9694;Sakalėlis;VOVERIUKŲ;3678172501;Taip;8;2;0;10
9695;Sakalėlis;VOVERIUKŲ;1133377117;Taip;0;0;1;1
9696;Sakalėlis;VOVERIUKŲ;5782214279;Taip;6;0;0;6
9697;Sakalėlis;VOVERIUKŲ;22614338778;Taip;0;0;1;1
9698;Sakalėlis;VOVERIUKŲ;34464485043;Taip;11;0;3;14
9699;Sakalėlis;VOVERIUKŲ;30987215315;Taip;0;1;1;2
9700;Sakalėlis;VOVERIUKŲ;7567476424;Taip;14;0;0;14
9701;Sakalėlis;VOVERIUKŲ;6180987643;Taip;6;5;0;11
9702;Sakalėlis;VOVERIUKŲ;8852001037;Taip;5;1;3;9
9703;Sakalėlis;PĖLEDŽIUKŲ;1974955778;Taip;0;5;2;7
9704;Sakalėlis;PĖLEDŽIUKŲ;69254656227;Ne;0;0;1;1
9705;Sakalėlis;PĖLEDŽIUKŲ;4573623341;Taip;0;1;9;10
9706;Sakalėlis;PĖLEDŽIUKŲ;60463584826;Taip;0;0;2;2
9707;Sakalėlis;PĖLEDŽIUKŲ;1359444361;Taip;0;1;1;2
9708;Sakalėlis;PĖLEDŽIUKŲ;3781188811;Taip;0;1;0;1
9709;Sakalėlis;PĖLEDŽIUKŲ;58113060986;Taip;3;0;1;4
9710;Sakalėlis;PĖLEDŽIUKŲ;89579043958;Taip;4;4;0;8
9711;Sakalėlis;PĖLEDŽIUKŲ;54902207576;Taip;0;4;0;4
9712;Sakalėlis;PĖLEDŽIUKŲ;81593611262;Taip;7;0;0;7
9713;Sakalėlis;PĖLEDŽIUKŲ;33825546706;Taip;5;1;0;6
9714;Sakalėlis;PĖLEDŽIUKŲ;1790571847;Taip;0;1;0;1
9715;Sakalėlis;PĖLEDŽIUKŲ;81361557297;Taip;15;0;2;17
9716;Sakalėlis;PĖLEDŽIUKŲ;39504139934;Taip;0;1;4;5
9717;Sakalėlis;PĖLEDŽIUKŲ;2134118895;Taip;0;1;0;1
9718;Sakalėlis;PĖLEDŽIUKŲ;67193921335;Taip;5;0;1;6
9719;Sakalėlis;PĖLEDŽIUKŲ;6301366135;Taip;0;1;1;2
9720;Sakalėlis;PĖLEDŽIUKŲ;2055710873;Taip;0;1;0;1
9721;Sakalėlis;PĖLEDŽIUKŲ;49947049847;Taip;10;1;1;12
9722;Sakalėlis;PĖLEDŽIUKŲ;4364341933;Taip;5;0;0;5
9723;Sakalėlis;PĖLEDŽIUKŲ;79413947806;Taip;0;1;0;1
9724;Sakalėlis;"BITUČIŲ (LOGOPEDINĖ)";4649447372;Taip;8;0;5;13
9725;Sakalėlis;"BITUČIŲ (LOGOPEDINĖ)";16884257622;Taip;0;1;0;1
9726;Sakalėlis;"BITUČIŲ (LOGOPEDINĖ)";4086981816;Ne;8;0;1;9
9727;Sakalėlis;"BITUČIŲ (LOGOPEDINĖ)";4716949191;Taip;7;0;3;10
9728;Sakalėlis;"BITUČIŲ (LOGOPEDINĖ)";7241416465;Ne;0;0;1;1
9729;Sakalėlis;"BITUČIŲ (LOGOPEDINĖ)";6321575268;Ne;0;0;3;3
9730;Sakalėlis;"BITUČIŲ (LOGOPEDINĖ)";4857211754;Taip;9;0;1;10
9731;Sakalėlis;"BITUČIŲ (LOGOPEDINĖ)";8610668395;Taip;5;0;3;8
9732;Sakalėlis;"BITUČIŲ (LOGOPEDINĖ)";5377250664;Ne;5;0;4;9
9733;Sakalėlis;"BITUČIŲ (LOGOPEDINĖ)";1384225025;Ne;7;0;3;10
9734;Sakalėlis;"BITUČIŲ (LOGOPEDINĖ)";46481555688;Taip;20;0;1;21
9735;Sakalėlis;"BITUČIŲ (LOGOPEDINĖ)";5018151097;Taip;7;0;3;10
9736;Sakalėlis;"BORUŽIUKŲ (LOGOPEDINĖ)";68146506860;Taip;0;1;8;9
9737;Sakalėlis;"BORUŽIUKŲ (LOGOPEDINĖ)";92557587855;Ne;5;1;0;6
9738;Sakalėlis;"BORUŽIUKŲ (LOGOPEDINĖ)";1765370689;Ne;4;0;0;4
9739;Sakalėlis;"BORUŽIUKŲ (LOGOPEDINĖ)";22863239773;Taip;0;1;1;2
9740;Sakalėlis;"BORUŽIUKŲ (LOGOPEDINĖ)";70791762492;Taip;0;1;6;7
9741;Sakalėlis;"BORUŽIUKŲ (LOGOPEDINĖ)";9452901338;Taip;0;2;0;2
9742;Sakalėlis;"BORUŽIUKŲ (LOGOPEDINĖ)";1288160341;Ne;6;0;0;6
9743;Sakalėlis;"BORUŽIUKŲ (LOGOPEDINĖ)";4514546151;Ne;9;1;0;10
9744;Sakalėlis;"BORUŽIUKŲ (LOGOPEDINĖ)";50037388220;Taip;5;1;0;6
9745;Sakalėlis;"BORUŽIUKŲ (LOGOPEDINĖ)";9740003273;Taip;11;0;0;11
9746;Sakalėlis;"BORUŽIUKŲ (LOGOPEDINĖ)";2074868084;Taip;2;0;2;4
9747;Sakalėlis;"BORUŽIUKŲ (LOGOPEDINĖ)";4495453007;Taip;17;0;0;17
9748;Sakalėlis;MEŠKUČIŲ;4136266629;Taip;1;0;0;1
9749;Sakalėlis;MEŠKUČIŲ;6840368824;Taip;0;0;7;7
9750;Sakalėlis;MEŠKUČIŲ;6250400609;Taip;7;0;2;9
9751;Sakalėlis;MEŠKUČIŲ;1742362136;Taip;1;0;0;1
9752;Sakalėlis;MEŠKUČIŲ;9322351120;Taip;0;0;9;9
9753;Sakalėlis;MEŠKUČIŲ;7672947538;Taip;0;0;7;7
9754;Sakalėlis;MEŠKUČIŲ;5233697077;Taip;0;1;0;1
9755;Sakalėlis;MEŠKUČIŲ;3680732318;Ne;0;8;0;8
9756;Sakalėlis;MEŠKUČIŲ;4862004373;Ne;11;1;0;12
9757;Sakalėlis;MEŠKUČIŲ;6579827280;Taip;2;6;0;8
9758;Sakalėlis;MEŠKUČIŲ;6806170544;Taip;2;0;0;2
9759;Sakalėlis;MEŠKUČIŲ;8381310908;Taip;10;0;0;10
9760;Sakalėlis;MEŠKUČIŲ;7285833058;Taip;6;0;0;6
9761;Sakalėlis;MEŠKUČIŲ;5795250727;Taip;0;0;3;3
9762;Sakalėlis;MEŠKUČIŲ;2985239904;Taip;0;1;0;1
9763;Sakalėlis;MEŠKUČIŲ;3351218789;Ne;4;0;3;7
9764;Sakalėlis;MEŠKUČIŲ;4986131090;Taip;3;0;0;3
9765;Sakalėlis;MEŠKUČIŲ;3927363997;Taip;0;9;0;9
9766;Sakalėlis;MEŠKUČIŲ;9120873899;Taip;3;0;1;4
9767;Sakalėlis;MEŠKUČIŲ;2352118061;Taip;6;5;1;12
9768;Sakalėlis;KIŠKUČIŲ;1806698668;Taip;5;0;1;6
9769;Sakalėlis;KIŠKUČIŲ;2898006208;Taip;5;0;1;6
9770;Sakalėlis;KIŠKUČIŲ;1201086815;Taip;5;5;0;10
9771;Sakalėlis;KIŠKUČIŲ;4918228191;Taip;12;0;0;12
9772;Sakalėlis;KIŠKUČIŲ;7706606275;Taip;9;0;1;10
9773;Sakalėlis;KIŠKUČIŲ;9272347788;Taip;8;0;0;8
9774;Sakalėlis;KIŠKUČIŲ;1117800518;Taip;14;0;0;14
9775;Sakalėlis;KIŠKUČIŲ;6515519140;Taip;13;3;0;16
9776;Sakalėlis;KIŠKUČIŲ;6586215199;Taip;6;0;1;7
9777;Sakalėlis;KIŠKUČIŲ;8095359035;Taip;12;3;0;15
9778;Sakalėlis;KIŠKUČIŲ;5911341542;Taip;5;0;0;5
9779;Sakalėlis;KIŠKUČIŲ;8331612396;Taip;4;0;0;4
9780;Sakalėlis;KIŠKUČIŲ;7542322748;Taip;12;0;0;12
9781;Sakalėlis;KIŠKUČIŲ;3934295338;Taip;11;0;1;12
9782;Sakalėlis;SVIRPLIUKŲ;3574956316;Taip;0;1;3;4
9783;Sakalėlis;SVIRPLIUKŲ;7602249339;Taip;5;0;6;11
9784;Sakalėlis;SVIRPLIUKŲ;6027680514;Taip;6;0;0;6
9785;Sakalėlis;SVIRPLIUKŲ;1953356983;Taip;14;0;1;15
9786;Sakalėlis;SVIRPLIUKŲ;4358313171;Taip;11;0;0;11
9787;Sakalėlis;SVIRPLIUKŲ;6414564366;Taip;8;0;6;14
9788;Sakalėlis;SVIRPLIUKŲ;1200252225;Taip;0;2;0;2
9789;Sakalėlis;SVIRPLIUKŲ;2531146677;Taip;9;0;0;9
9790;Sakalėlis;SVIRPLIUKŲ;8133985842;Taip;10;0;0;10
9791;Sakalėlis;SVIRPLIUKŲ;7280513854;Taip;10;0;0;10
9792;Sakalėlis;SVIRPLIUKŲ;6778987483;Taip;16;0;5;21
9793;Salininkų;BORUŽIUKAI;2467926286;Taip;14;0;0;14
9794;Salininkų;BORUŽIUKAI;8774984357;Taip;0;0;1;1
9795;Salininkų;BORUŽIUKAI;6577237672;Taip;0;0;1;1
9796;Salininkų;BORUŽIUKAI;6125152143;Taip;5;1;0;6
9797;Salininkų;BORUŽIUKAI;2095952937;Taip;5;1;0;6
9798;Salininkų;BORUŽIUKAI;7115888747;Taip;10;0;0;10
9799;Salininkų;BORUŽIUKAI;6551489987;Taip;5;4;0;9
9800;Salininkų;BORUŽIUKAI;1928897962;Taip;8;0;0;8
9801;Salininkų;BORUŽIUKAI;5582091833;Taip;3;0;1;4
9802;Salininkų;BORUŽIUKAI;9996809930;Taip;0;0;5;5
9803;Salininkų;BORUŽIUKAI;8992580214;Taip;0;0;3;3
9804;Salininkų;BORUŽIUKAI;4480303856;Taip;15;0;0;15
9805;Salininkų;BORUŽIUKAI;3915336062;Taip;20;0;0;20
9806;Salininkų;BORUŽIUKAI;9902751686;Taip;9;0;0;9
9807;Salininkų;BORUŽIUKAI;3252151974;Taip;6;0;0;6
9808;Salininkų;GĖLYTĖS;3015863723;Taip;18;0;0;18
9809;Salininkų;GĖLYTĖS;3323233525;Taip;18;0;0;18
9810;Salininkų;GĖLYTĖS;1832393272;Taip;0;2;0;2
9811;Salininkų;GĖLYTĖS;7665409499;Taip;3;0;3;6
9812;Salininkų;GĖLYTĖS;9890660815;Taip;0;4;3;7
9813;Salininkų;GĖLYTĖS;6850925495;Taip;8;1;3;12
9814;Salininkų;GĖLYTĖS;3585435095;Taip;15;0;0;15
9815;Salininkų;GĖLYTĖS;2760231414;Taip;6;0;1;7
9816;Salininkų;GĖLYTĖS;9724367035;Taip;13;1;0;14
9817;Salininkų;GĖLYTĖS;1658695150;Taip;6;0;1;7
9818;Salininkų;GĖLYTĖS;7383557807;Taip;1;0;0;1
9819;Salininkų;GĖLYTĖS;9344614003;Taip;0;5;0;5
9820;Salininkų;GĖLYTĖS;2808778763;Taip;0;13;0;13
9821;Salininkų;GĖLYTĖS;6656578271;Ne;0;2;0;2
9822;Salininkų;GĖLYTĖS;8995565864;Taip;5;1;0;6
9823;Salininkų;GĖLYTĖS;8394582546;Taip;0;9;0;9
9824;Salininkų;GĖLYTĖS;6327046935;Taip;8;2;0;10
9825;Salininkų;GĖLYTĖS;4323257798;Taip;0;2;0;2
9826;Salininkų;GĖLYTĖS;5427013789;Taip;0;4;0;4
9827;Salininkų;GĖLYTĖS;3100499807;Taip;0;4;0;4
9828;Salininkų;GĖLYTĖS;7782972361;Taip;0;4;0;4
9829;Salininkų;GĖLYTĖS;5867676844;Taip;5;0;0;5
9830;Salininkų;GĖLYTĖS;7737045952;Taip;0;0;2;2
9831;Salininkų;DRUGELIAI;1641123436;Taip;17;0;0;17
9832;Salininkų;DRUGELIAI;1910467994;Taip;6;6;0;12
9833;Salininkų;DRUGELIAI;2812554783;Taip;16;0;0;16
9834;Salininkų;DRUGELIAI;14626363996;Taip;6;0;0;6
9835;Salininkų;DRUGELIAI;1883307260;Taip;0;1;0;1
9836;Salininkų;DRUGELIAI;1948988168;Taip;8;1;5;14
9837;Salininkų;DRUGELIAI;1868857584;Taip;0;0;4;4
9838;Salininkų;DRUGELIAI;8157811781;Taip;10;6;0;16
9839;Salininkų;DRUGELIAI;1963139815;Ne;7;0;2;9
9840;Salininkų;DRUGELIAI;45194646218;Taip;0;9;0;9
9841;Salininkų;DRUGELIAI;6301139299;Ne;4;0;0;4
9842;Salininkų;DRUGELIAI;6125334614;Taip;8;2;1;11
9843;Salininkų;DRUGELIAI;15199054558;Ne;0;6;0;6
9844;Salininkų;DRUGELIAI;1568780329;Taip;11;2;0;13
9845;Salininkų;DRUGELIAI;30123603107;Ne;10;0;1;11
9846;Salininkų;DRUGELIAI;8659656902;Ne;5;0;0;5
9847;Salininkų;DRUGELIAI;9074440999;Taip;4;4;2;10
9848;Salininkų;DRUGELIAI;8410624264;Taip;5;10;0;15
9849;Salininkų;ŽIRNIUKAI;5063792784;Taip;12;0;0;12
9850;Salininkų;ŽIRNIUKAI;73016259669;Ne;9;0;0;9
9851;Salininkų;ŽIRNIUKAI;41023354439;Taip;9;0;0;9
9852;Salininkų;ŽIRNIUKAI;76449285846;Ne;0;4;0;4
9853;Salininkų;ŽIRNIUKAI;1355032282;Taip;0;5;0;5
9854;Salininkų;ŽIRNIUKAI;35611320012;Taip;6;0;0;6
9855;Salininkų;ŽIRNIUKAI;22167560908;Taip;0;4;0;4
9856;Salininkų;ŽIRNIUKAI;9513785510;Taip;7;0;6;13
9857;Salininkų;ŽIRNIUKAI;2292919406;Taip;20;0;0;20
9858;Salininkų;ŽIRNIUKAI;8683841956;Taip;9;0;1;10
9859;Salininkų;ŽIRNIUKAI;10335028421;Taip;6;1;0;7
9860;Salininkų;ŽIRNIUKAI;8488127476;Taip;12;0;1;13
9861;Salininkų;ŽIRNIUKAI;1723241116;Taip;1;1;0;2
9862;Salininkų;ŽIRNIUKAI;46867660097;Taip;10;5;0;15
9863;Salininkų;ŽIRNIUKAI;4269202761;Taip;20;0;0;20
9864;Salininkų;ŽIRNIUKAI;3692008687;Taip;9;9;0;18
9865;Salininkų;ŽIRNIUKAI;91859774311;Taip;8;0;1;9
9866;Salininkų;ŽIRNIUKAI;1065549119;Taip;15;0;0;15
9867;Salininkų;ŽIRNIUKAI;8288199783;Taip;0;0;2;2
9868;Salininkų;ŽIRNIUKAI;1460694577;Taip;5;4;0;9
9869;Salininkų;PAUKŠČIUKAI;1202154135;Taip;0;1;0;1
9870;Salininkų;PAUKŠČIUKAI;1521333219;Taip;0;2;0;2
9871;Salininkų;PAUKŠČIUKAI;95919160139;Taip;10;1;0;11
9872;Salininkų;PAUKŠČIUKAI;25941514634;Ne;9;0;0;9
9873;Salininkų;PAUKŠČIUKAI;67593920224;Ne;5;9;0;14
9874;Salininkų;PAUKŠČIUKAI;81888649482;Taip;4;0;0;4
9875;Salininkų;PAUKŠČIUKAI;1153455356;Taip;0;5;0;5
9876;Salininkų;PAUKŠČIUKAI;1470744233;Taip;0;10;0;10
9877;Salininkų;PAUKŠČIUKAI;2031724954;Taip;0;5;0;5
9878;Salininkų;PAUKŠČIUKAI;52499970010;Taip;9;0;0;9
9879;Salininkų;PAUKŠČIUKAI;18178857793;Taip;7;4;0;11
9880;Salininkų;PAUKŠČIUKAI;1439852031;Taip;5;4;0;9
9881;Salininkų;PAUKŠČIUKAI;20609963605;Taip;11;1;0;12
9882;Salininkų;PAUKŠČIUKAI;1918440067;Taip;3;0;0;3
9883;Salininkų;PAUKŠČIUKAI;52194170807;Taip;0;3;0;3
9884;Salininkų;PAUKŠČIUKAI;86019335524;Taip;0;3;0;3
9885;Salininkų;PAUKŠČIUKAI;1586012117;Taip;0;4;0;4
9886;Salininkų;PAUKŠČIUKAI;2415539904;Taip;0;2;0;2
9887;Salininkų;PAUKŠČIUKAI;29341671329;Taip;0;6;0;6
9888;Salininkų;PAUKŠČIUKAI;3878896109;Taip;10;8;0;18
9889;Salininkų;PAUKŠČIUKAI;16967442608;Taip;6;5;0;11
9890;Salininkų;PAUKŠČIUKAI;7918995181;Taip;16;1;0;17
9891;Salvija;Daigelis(šatil);1261005294;Taip;0;0;2;2
9892;Salvija;Daigelis(šatil);3424917706;Ne;10;1;0;11
9893;Salvija;Daigelis(šatil);4152602039;Taip;20;0;0;20
9894;Salvija;Daigelis(šatil);7546216874;Taip;4;0;0;4
9895;Salvija;Daigelis(šatil);3856351749;Taip;3;0;2;5
9896;Salvija;Daigelis(šatil);1653831148;Taip;6;3;0;9
9897;Salvija;Daigelis(šatil);8023422294;Taip;8;0;12;20
9898;Salvija;Daigelis(šatil);7449993309;Taip;5;0;16;21
9899;Salvija;Daigelis(šatil);8981331532;Taip;0;6;1;7
9900;Salvija;Daigelis(šatil);8158680641;Taip;5;0;0;5
9901;Salvija;Daigelis(šatil);3487446998;Taip;10;0;0;10
9902;Salvija;Daigelis(šatil);6706565915;Taip;5;0;0;5
9903;Salvija;Daigelis(šatil);5723168506;Ne;10;1;0;11
9904;Salvija;Daigelis(šatil);7477171133;Taip;8;0;0;8
9905;Salvija;Daigelis(šatil);8853389268;Taip;3;4;0;7
9906;Salvija;"Pienė (savjon)";22615390885;Taip;10;1;0;11
9907;Salvija;"Pienė (savjon)";9168718017;Taip;12;0;0;12
9908;Salvija;"Pienė (savjon)";4167467237;Taip;0;0;12;12
9909;Salvija;"Pienė (savjon)";1641242817;Taip;0;3;0;3
9910;Salvija;"Pienė (savjon)";58888784609;Taip;0;6;0;6
9911;Salvija;"Pienė (savjon)";4845744417;Taip;0;6;0;6
9912;Salvija;"Pienė (savjon)";5494438837;Taip;0;0;2;2
9913;Salvija;"Pienė (savjon)";8798739147;Taip;10;5;0;15
9914;Salvija;"Pienė (savjon)";1103379012;Taip;0;1;0;1
9915;Salvija;"Pienė (savjon)";41158937437;Taip;0;0;2;2
9916;Salvija;"Pienė (savjon)";7361435128;Taip;0;0;1;1
9917;Salvija;"Pienė (savjon)";1777783229;Taip;10;1;0;11
9918;Salvija;"Pienė (savjon)";1396698456;Ne;0;0;10;10
9919;Salvija;"Pienė (savjon)";1478775998;Taip;8;1;0;9
9920;Salvija;"Pienė (savjon)";8802891478;Ne;5;12;0;17
9921;Salvija;"Pienė (savjon)";12326049516;Taip;3;0;0;3
9922;Salvija;"Pienė (savjon)";5784594015;Taip;5;1;0;6
9923;Salvija;"Pienė (savjon)";1517130961;Ne;0;0;2;2
9924;Salvija;"Pienė (savjon)";8725965215;Taip;0;1;0;1
9925;Saulėtekis;BERŽELIS;37001834066;Taip;0;0;9;9
9926;Saulėtekis;BERŽELIS;29935189464;Ne;6;1;0;7
9927;Saulėtekis;BERŽELIS;95214907923;Taip;0;7;0;7
9928;Saulėtekis;BERŽELIS;49102885577;Taip;0;2;0;2
9929;Saulėtekis;BERŽELIS;18801492293;Taip;0;1;6;7
9930;Saulėtekis;BERŽELIS;43809213927;Taip;0;7;0;7
9931;Saulėtekis;BERŽELIS;17046444483;Taip;11;0;0;11
9932;Saulėtekis;BERŽELIS;14357681543;Taip;0;1;0;1
9933;Saulėtekis;BERŽELIS;27109020149;Taip;0;4;0;4
9934;Saulėtekis;BERŽELIS;42952333477;Taip;5;1;0;6
9935;Saulėtekis;BERŽELIS;88165168902;Taip;0;3;0;3
9936;Saulėtekis;BERŽELIS;19786161536;Taip;0;1;0;1
9937;Saulėtekis;BERŽELIS;55975992548;Taip;0;0;1;1
9938;Saulėtekis;BERŽELIS;49746307178;Taip;0;1;1;2
9939;Saulėtekis;BERŽELIS;9632257866;Taip;11;0;0;11
9940;Saulėtekis;BERŽELIS;24403133622;Taip;6;2;0;8
9941;Saulėtekis;BERŽELIS;7440287746;Taip;7;1;0;8
9942;Saulėtekis;BERŽELIS;1359594045;Taip;0;0;1;1
9943;Saulėtekis;BERŽELIS;1502304241;Ne;0;1;3;4
9944;Saulėtekis;BERŽELIS;19209281962;Taip;0;0;4;4
9945;Saulėtekis;BERŽELIS;2096996257;Taip;0;1;2;3
9946;Saulėtekis;ŠYPSENA;1720125332;Taip;4;0;0;4
9947;Saulėtekis;ŠYPSENA;9972687066;Taip;3;5;0;8
9948;Saulėtekis;ŠYPSENA;7346852524;Ne;12;0;0;12
9949;Saulėtekis;ŠYPSENA;1902333363;Taip;8;0;0;8
9950;Saulėtekis;ŠYPSENA;7893982893;Taip;5;0;0;5
9951;Saulėtekis;ŠYPSENA;7505040675;Taip;8;0;0;8
9952;Saulėtekis;ŠYPSENA;6501250875;Taip;1;0;2;3
9953;Saulėtekis;ŠYPSENA;9791926936;Taip;13;2;0;15
9954;Saulėtekis;ŠYPSENA;8620689981;Taip;0;2;0;2
9955;Saulėtekis;ŠYPSENA;8143793642;Taip;0;4;0;4
9956;Saulėtekis;ŠYPSENA;9783450998;Taip;0;2;0;2
9957;Saulėtekis;ŠYPSENA;4909850069;Taip;0;2;0;2
9958;Saulėtekis;ŠYPSENA;7673965242;Taip;19;0;0;19
9959;Saulėtekis;ŠYPSENA;3166959569;Taip;6;3;1;10
9960;Saulėtekis;ŠYPSENA;9661075465;Taip;5;0;0;5
9961;Saulėtekis;ŠYPSENA;2154590089;Ne;0;5;0;5
9962;Saulėtekis;ŠYPSENA;9383567339;Taip;0;6;0;6
9963;Saulėtekis;ŠYPSENA;4610536784;Taip;1;3;0;4
9964;Saulėtekis;NYKŠTUKAI;81074197598;Taip;11;2;0;13
9965;Saulėtekis;NYKŠTUKAI;87539304992;Taip;0;1;0;1
9966;Saulėtekis;NYKŠTUKAI;75818502835;Taip;0;1;0;1
9967;Saulėtekis;NYKŠTUKAI;1623791240;Taip;0;6;0;6
9968;Saulėtekis;NYKŠTUKAI;46936348504;Taip;0;2;0;2
9969;Saulėtekis;NYKŠTUKAI;47570401883;Taip;7;0;0;7
9970;Saulėtekis;NYKŠTUKAI;40443812162;Taip;14;1;0;15
9971;Saulėtekis;NYKŠTUKAI;1288313734;Taip;0;1;0;1
9972;Saulėtekis;NYKŠTUKAI;9333073549;Taip;0;6;0;6
9973;Saulėtekis;NYKŠTUKAI;75785868657;Taip;5;2;0;7
9974;Saulėtekis;NYKŠTUKAI;45284061866;Taip;0;1;0;1
9975;Saulėtekis;NYKŠTUKAI;1064355395;Taip;0;6;0;6
9976;Saulėtekis;NYKŠTUKAI;1691667254;Taip;5;3;0;8
9977;Saulėtekis;NYKŠTUKAI;6736441901;Taip;12;2;0;14
9978;Saulėtekis;NYKŠTUKAI;1466627555;Taip;0;2;0;2
9979;Saulėtekis;NYKŠTUKAI;29552225924;Taip;0;4;0;4
9980;Saulėtekis;NYKŠTUKAI;1111323783;Taip;4;4;0;8
9981;Saulėtekis;NYKŠTUKAI;21569877958;Taip;0;3;0;3
9982;Saulėtekis;NYKŠTUKAI;5104259667;Taip;18;0;0;18
9983;Saulėtekis;PAGRANDUKAS;8102360466;Taip;10;3;0;13
9984;Saulėtekis;PAGRANDUKAS;2371396923;Taip;9;0;1;10
9985;Saulėtekis;PAGRANDUKAS;4152255439;Taip;0;10;0;10
9986;Saulėtekis;PAGRANDUKAS;2209156661;Taip;11;2;0;13
9987;Saulėtekis;PAGRANDUKAS;3220993253;Taip;5;0;1;6
9988;Saulėtekis;PAGRANDUKAS;5552614092;Taip;14;0;1;15
9989;Saulėtekis;PAGRANDUKAS;9497129509;Taip;6;3;0;9
9990;Saulėtekis;PAGRANDUKAS;9918219913;Taip;3;0;2;5
9991;Saulėtekis;PAGRANDUKAS;8517049464;Taip;13;0;0;13
9992;Saulėtekis;PAGRANDUKAS;7186085219;Taip;11;1;0;12
9993;Saulėtekis;PAGRANDUKAS;1020209414;Taip;9;0;0;9
9994;Saulėtekis;PAGRANDUKAS;8745921541;Taip;15;0;0;15
9995;Saulėtekis;PAGRANDUKAS;2728836108;Taip;0;6;0;6
9996;Saulėtekis;PAGRANDUKAS;8390615573;Ne;6;0;0;6
9997;Saulėtekis;PAGRANDUKAS;2698535938;Taip;0;1;0;1
9998;Saulėtekis;PAGRANDUKAS;2656659133;Taip;19;1;0;20
9999;Saulėtekis;PAGRANDUKAS;7164579375;Taip;5;3;0;8
10000;Saulėtekis;PAGRANDUKAS;5678858566;Taip;15;0;0;15
10001;Saulėtekis;PAGRANDUKAS;4101644021;Taip;0;6;0;6
10002;Saulėtekis;PAGRANDUKAS;3366064429;Taip;3;1;4;8
10003;Saulėtekis;PAGRANDUKAS;8574702901;Taip;0;0;1;1
10004;Saulėtekis;RAMUNĖLIŲ;21299038354;Taip;0;3;0;3
10005;Saulėtekis;RAMUNĖLIŲ;23797246535;Taip;0;0;1;1
10006;Saulėtekis;RAMUNĖLIŲ;16450627896;Ne;0;1;0;1
10007;Saulėtekis;RAMUNĖLIŲ;60662699125;Taip;3;1;0;4
10008;Saulėtekis;RAMUNĖLIŲ;77630031851;Taip;0;1;0;1
10009;Saulėtekis;RAMUNĖLIŲ;31291807930;Ne;7;4;0;11
10010;Saulėtekis;RAMUNĖLIŲ;42485505048;Ne;0;10;0;10
10011;Saulėtekis;RAMUNĖLIŲ;86593254070;Taip;0;1;0;1
10012;Saulėtekis;RAMUNĖLIŲ;40093795729;Taip;0;1;0;1
10013;Saulėtekis;RAMUNĖLIŲ;10524532865;Taip;0;8;0;8
10014;Saulėtekis;RAMUNĖLIŲ;80037388013;Taip;6;0;0;6
10015;Saulėtekis;RAMUNĖLIŲ;1219435678;Taip;0;2;0;2
10016;Saulėtekis;RAMUNĖLIŲ;29662148323;Taip;10;1;0;11
10017;Saulėtekis;RAMUNĖLIŲ;3394231244;Taip;13;0;1;14
10018;Saulėtekis;RAMUNĖLIŲ;7544912614;Taip;5;6;0;11
10019;Saulėtekis;RAMUNĖLIŲ;1349303787;Taip;5;1;2;8
10020;Saulėtekis;RAMUNĖLIŲ;1103824875;Taip;0;0;2;2
10021;Saulėtekis;RAMUNĖLIŲ;9611990012;Taip;0;1;0;1
10022;Saulėtekis;PASAKAITĖ;9428709415;Taip;0;3;0;3
10023;Saulėtekis;PASAKAITĖ;5086871001;Taip;15;1;0;16
10024;Saulėtekis;PASAKAITĖ;4681031693;Taip;0;1;0;1
10025;Saulėtekis;PASAKAITĖ;2446282019;Taip;7;1;0;8
10026;Saulėtekis;PASAKAITĖ;8572701238;Taip;7;1;0;8
10027;Saulėtekis;PASAKAITĖ;6979741482;Taip;5;0;0;5
10028;Saulėtekis;PASAKAITĖ;6063956790;Taip;5;1;0;6
10029;Saulėtekis;PASAKAITĖ;4437540996;Taip;21;0;0;21
10030;Saulėtekis;PASAKAITĖ;7407451018;Taip;0;1;0;1
10031;Saulėtekis;PASAKAITĖ;9226317303;Taip;0;1;1;2
10032;Saulėtekis;PASAKAITĖ;9267790598;Taip;5;0;3;8
10033;Saulėtekis;PASAKAITĖ;6670590135;Taip;7;0;2;9
10034;Saulėtekis;PASAKAITĖ;6720758829;Taip;0;0;1;1
10035;Saulėtekis;VARPELIAI;94326821425;Taip;10;8;0;18
10036;Saulėtekis;VARPELIAI;1069782559;Taip;2;1;0;3
10037;Saulėtekis;VARPELIAI;1339984127;Taip;0;8;0;8
10038;Saulėtekis;VARPELIAI;68563453302;Taip;0;8;0;8
10039;Saulėtekis;VARPELIAI;77901730057;Taip;0;8;0;8
10040;Saulėtekis;VARPELIAI;43127755042;Taip;0;1;0;1
10041;Saulėtekis;VARPELIAI;1154284625;Taip;5;0;0;5
10042;Saulėtekis;VARPELIAI;1335149249;Taip;7;2;0;9
10043;Saulėtekis;VARPELIAI;1108321396;Taip;0;1;1;2
10044;Saulėtekis;VARPELIAI;891603633;Taip;0;6;0;6
10045;Saulėtekis;VARPELIAI;36605502570;Taip;0;0;2;2
10046;Saulėtekis;VARPELIAI;2075281680;Taip;0;2;0;2
10047;Saulėtekis;VARPELIAI;1213567219;Ne;9;0;2;11
10048;Saulėtekis;VARPELIAI;61118132521;Ne;9;1;0;10
10049;Saulėtekis;VARPELIAI;7464965841;Taip;0;1;0;1
10050;Saulėtekis;VARPELIAI;6671771491;Taip;6;2;0;8
10051;Saulėtekis;VARPELIAI;8752857993;Taip;9;0;1;10
10052;Saulėtekis;VARPELIAI;2641849320;Ne;11;0;1;12
10053;Saulėtekis;GRŪDELIS;20794781914;Taip;7;0;0;7
10054;Saulėtekis;GRŪDELIS;9132383069;Taip;14;0;2;16
10055;Saulėtekis;GRŪDELIS;67951758325;Ne;8;0;0;8
10056;Saulėtekis;GRŪDELIS;41775536104;Taip;3;6;0;9
10057;Saulėtekis;GRŪDELIS;12954283491;Taip;0;1;0;1
10058;Saulėtekis;GRŪDELIS;21376960952;Ne;0;5;0;5
10059;Saulėtekis;GRŪDELIS;4027823257;Taip;0;0;2;2
10060;Saulėtekis;GRŪDELIS;86804497954;Taip;0;3;0;3
10061;Saulėtekis;GRŪDELIS;1180197203;Taip;0;1;0;1
10062;Saulėtekis;GRŪDELIS;98936544904;Taip;0;0;4;4
10063;Saulėtekis;GRŪDELIS;22570044589;Taip;5;0;3;8
10064;Saulėtekis;GRŪDELIS;1865278537;Taip;5;3;0;8
10065;Saulėtekis;GRŪDELIS;1220962473;Taip;0;6;0;6
10066;Saulėtekis;GRŪDELIS;20534872540;Taip;8;0;1;9
10067;Saulėtekis;GRŪDELIS;53906058088;Taip;0;0;2;2
10068;Saulėtekis;GRŪDELIS;1646943569;Taip;5;0;1;6
10069;Saulėtekis;GRŪDELIS;1456140823;Taip;0;0;2;2
10070;Saulėtekis;GRŪDELIS;49053923177;Taip;0;0;1;1
10071;Saulėtekis;JONVABALIS;5003645081;Ne;8;0;0;8
10072;Saulėtekis;JONVABALIS;1715634399;Taip;6;7;0;13
10073;Saulėtekis;JONVABALIS;1897872021;Taip;0;4;0;4
10074;Saulėtekis;JONVABALIS;1010906684;Taip;7;4;0;11
10075;Saulėtekis;JONVABALIS;97037457833;Taip;0;2;0;2
10076;Saulėtekis;JONVABALIS;7227802003;Taip;0;1;0;1
10077;Saulėtekis;JONVABALIS;84492261206;Taip;2;3;0;5
10078;Saulėtekis;JONVABALIS;72559769416;Taip;5;0;0;5
10079;Saulėtekis;JONVABALIS;1611009868;Taip;13;4;0;17
10080;Saulėtekis;JONVABALIS;4613040294;Taip;0;3;0;3
10081;Saulėtekis;JONVABALIS;1655720839;Taip;0;4;0;4
10082;Saulėtekis;JONVABALIS;5249014111;Taip;17;0;0;17
10083;Saulėtekis;JONVABALIS;2101902207;Taip;7;2;0;9
10084;Saulėtekis;JONVABALIS;3166181835;Taip;0;5;0;5
10085;Saulėtekis;JONVABALIS;2335031800;Taip;4;1;0;5
10086;Saulėtekis;JONVABALIS;6599452886;Taip;5;2;0;7
10087;Saulėtekis;JONVABALIS;8896065807;Taip;9;2;0;11
10088;Saulėtekis;JONVABALIS;1702638461;Taip;10;3;0;13
10089;Saulėtekis;JONVABALIS;3207128776;Taip;5;2;0;7
10090;Saulėtekis;JONVABALIS;2311184444;Taip;5;6;0;11
10091;Saulėtekis;JONVABALIS;1267706132;Ne;15;0;0;15
10092;Saulėtekis;SMALSUČIAI;40877542045;Taip;0;4;0;4
10093;Saulėtekis;SMALSUČIAI;9095968376;Taip;0;8;0;8
10094;Saulėtekis;SMALSUČIAI;86524549051;Taip;2;0;1;3
10095;Saulėtekis;SMALSUČIAI;7030227903;Taip;5;2;1;8
10096;Saulėtekis;SMALSUČIAI;81118611780;Taip;11;3;0;14
10097;Saulėtekis;SMALSUČIAI;32771808648;Taip;0;5;0;5
10098;Saulėtekis;SMALSUČIAI;38762730531;Ne;5;3;0;8
10099;Saulėtekis;SMALSUČIAI;1808644850;Taip;17;2;0;19
10100;Saulėtekis;SMALSUČIAI;1642031589;Taip;5;5;0;10
10101;Saulėtekis;SMALSUČIAI;1568300232;Ne;0;0;1;1
10102;Saulėtekis;SMALSUČIAI;97771948184;Taip;8;3;0;11
10103;Saulėtekis;SMALSUČIAI;7621094096;Taip;5;5;1;11
10104;Saulėtekis;SMALSUČIAI;13451381485;Taip;0;10;0;10
10105;Saulėtekis;SMALSUČIAI;19605249139;Taip;5;2;0;7
10106;Saulėtekis;SMALSUČIAI;1619134034;Taip;0;9;0;9
10107;Saulėtekis;SMALSUČIAI;8673024996;Taip;3;4;0;7
10108;Saulėtekis;SMALSUČIAI;1456865685;Taip;8;5;0;13
10109;Saulėtekis;SMALSUČIAI;92060861583;Taip;6;0;1;7
10110;Saulėtekis;BITUTĖS;7766084857;Taip;8;0;0;8
10111;Saulėtekis;BITUTĖS;4537254306;Taip;3;0;0;3
10112;Saulėtekis;BITUTĖS;60462712074;Taip;9;0;0;9
10113;Saulėtekis;BITUTĖS;9945647968;Taip;10;6;0;16
10114;Saulėtekis;BITUTĖS;1962914764;Taip;11;0;3;14
10115;Saulėtekis;BITUTĖS;1481503733;Taip;4;0;1;5
10116;Saulėtekis;BITUTĖS;8302260087;Taip;10;0;0;10
10117;Saulėtekis;BITUTĖS;2593106154;Taip;4;4;2;10
10118;Saulėtekis;BITUTĖS;2813949848;Taip;16;0;0;16
10119;Saulėtekis;BITUTĖS;6643388548;Taip;3;2;0;5
10120;Saulėtekis;BITUTĖS;3058991890;Taip;5;7;0;12
10121;Saulėtekis;BITUTĖS;9983577817;Taip;6;4;0;10
10122;Saulėtekis;BITUTĖS;7986712728;Taip;5;0;1;6
10123;Saulėtekis;BITUTĖS;6087170055;Taip;3;5;0;8
10124;Saulėtekis;BITUTĖS;7027103276;Taip;8;0;0;8
10125;Saulėtekis;BITUTĖS;7758268674;Taip;3;0;1;4
10126;Saulėtekis;BITUTĖS;2077976415;Taip;12;0;0;12
10127;Saulėtekis;BITUTĖS;9605052795;Taip;4;3;0;7
10128;Saulėtekis;BITUTĖS;7075757274;Taip;17;0;0;17
10129;Saulėtekis;BITUTĖS;2639872637;Taip;5;0;0;5
10130;Saulėtekis;RIEŠUTĖLIAI;3337160930;Taip;3;0;8;11
10131;Saulėtekis;RIEŠUTĖLIAI;2021901593;Taip;21;0;0;21
10132;Saulėtekis;RIEŠUTĖLIAI;7842280836;Taip;4;1;0;5
10133;Saulėtekis;RIEŠUTĖLIAI;2407911405;Taip;2;0;0;2
10134;Saulėtekis;RIEŠUTĖLIAI;5954194843;Taip;0;2;0;2
10135;Saulėtekis;RIEŠUTĖLIAI;2238947856;Taip;0;10;0;10
10136;Saulėtekis;RIEŠUTĖLIAI;84982517658;Taip;0;1;0;1
10137;Saulėtekis;RIEŠUTĖLIAI;3541535891;Taip;1;0;0;1
10138;Saulėtekis;RIEŠUTĖLIAI;8231869593;Taip;1;0;0;1
10139;Saulėtekis;RIEŠUTĖLIAI;36003078842;Taip;0;1;0;1
10140;Saulėtekis;RIEŠUTĖLIAI;4663268649;Taip;10;2;0;12
10141;Saulėtekis;RIEŠUTĖLIAI;25199011812;Taip;10;0;3;13
10142;Saulėtekis;RIEŠUTĖLIAI;81153273188;Taip;11;2;0;13
10143;Saulėtekis;RIEŠUTĖLIAI;7051608858;Taip;12;0;0;12
10144;Saulėtekis;RIEŠUTĖLIAI;9634949452;Taip;5;0;0;5
10145;Saulėtekis;RIEŠUTĖLIAI;4338502152;Taip;3;1;0;4
10146;Saulėtekis;RIEŠUTĖLIAI;8002806189;Taip;5;0;0;5
10147;Saulėtekis;RIEŠUTĖLIAI;9657195627;Taip;5;5;0;10
10148;Saulėtekis;RIEŠUTĖLIAI;1290215067;Taip;6;0;0;6
10149;Saulėtekis;RIEŠUTĖLIAI;1209960122;Taip;5;0;0;5
10150;Skroblinukas;SVIRPLIUKŲ;56496090956;Ne;0;0;5;5
10151;Skroblinukas;SVIRPLIUKŲ;70884771171;Taip;0;1;0;1
10152;Skroblinukas;SVIRPLIUKŲ;27948464942;Taip;0;0;2;2
10153;Skroblinukas;SVIRPLIUKŲ;92096423589;Taip;7;1;0;8
10154;Skroblinukas;SVIRPLIUKŲ;5992090518;Taip;0;1;0;1
10155;Skroblinukas;SVIRPLIUKŲ;69303322030;Taip;0;4;0;4
10156;Skroblinukas;SVIRPLIUKŲ;2034869306;Taip;0;2;1;3
10157;Skroblinukas;SVIRPLIUKŲ;2020866728;Taip;0;2;1;3
10158;Skroblinukas;SVIRPLIUKŲ;1059137398;Taip;0;1;0;1
10159;Skroblinukas;SVIRPLIUKŲ;91070212533;Taip;0;4;0;4
10160;Skroblinukas;SVIRPLIUKŲ;60291417607;Taip;0;2;0;2
10161;Skroblinukas;SVIRPLIUKŲ;31484348317;Taip;0;1;1;2
10162;Skroblinukas;SVIRPLIUKŲ;88601994922;Taip;0;6;0;6
10163;Skroblinukas;SVIRPLIUKŲ;72829437831;Taip;2;3;0;5
10164;Skroblinukas;SVIRPLIUKŲ;31670763980;Taip;0;1;2;3
10165;Skroblinukas;SVIRPLIUKŲ;89356084678;Ne;0;2;0;2
10166;Skroblinukas;SVIRPLIUKŲ;93644867290;Ne;0;1;0;1
10167;Skroblinukas;SVIRPLIUKŲ;30925721180;Taip;0;0;1;1
10168;Skroblinukas;SVIRPLIUKŲ;87902801288;Taip;7;3;0;10
10169;Skroblinukas;SVIRPLIUKŲ;1462404838;Ne;0;4;0;4
10170;Skroblinukas;SVIRPLIUKŲ;23551272822;Ne;1;1;1;3
10171;Skroblinukas;SVIRPLIUKŲ;2105394649;Taip;0;0;1;1
10172;Skroblinukas;GANDRIUKŲ;2197158518;Taip;4;0;2;6
10173;Skroblinukas;GANDRIUKŲ;2097758483;Taip;0;15;0;15
10174;Skroblinukas;GANDRIUKŲ;7921251819;Taip;0;9;0;9
10175;Skroblinukas;GANDRIUKŲ;9045708140;Taip;3;0;2;5
10176;Skroblinukas;GANDRIUKŲ;2406619611;Taip;0;1;0;1
10177;Skroblinukas;GANDRIUKŲ;9572912046;Taip;0;15;1;16
10178;Skroblinukas;GANDRIUKŲ;5646847921;Taip;0;0;1;1
10179;Skroblinukas;GANDRIUKŲ;1851920334;Ne;0;0;1;1
10180;Skroblinukas;GANDRIUKŲ;9377215921;Taip;16;0;0;16
10181;Skroblinukas;GANDRIUKŲ;6266609965;Ne;0;14;0;14
10182;Skroblinukas;GANDRIUKŲ;6489976163;Taip;0;0;2;2
10183;Skroblinukas;GANDRIUKŲ;1159546580;Taip;0;2;0;2
10184;Skroblinukas;GANDRIUKŲ;2630699296;Taip;0;1;0;1
10185;Skroblinukas;GANDRIUKŲ;4571530482;Taip;10;0;1;11
10186;Skroblinukas;GANDRIUKŲ;9541682085;Taip;5;0;0;5
10187;Skroblinukas;GANDRIUKŲ;2310750833;Taip;0;2;0;2
10188;Skroblinukas;GANDRIUKŲ;9888115079;Taip;0;11;2;13
10189;Skroblinukas;GANDRIUKŲ;9475514959;Ne;0;2;0;2
10190;Skroblinukas;VYTURIUKŲ;40320573258;Taip;11;1;0;12
10191;Skroblinukas;VYTURIUKŲ;94897926442;Ne;0;13;3;16
10192;Skroblinukas;VYTURIUKŲ;7416993749;Taip;0;2;0;2
10193;Skroblinukas;VYTURIUKŲ;30982591733;Taip;0;10;0;10
10194;Skroblinukas;VYTURIUKŲ;1935381164;Taip;0;1;3;4
10195;Skroblinukas;VYTURIUKŲ;58000101216;Taip;0;1;8;9
10196;Skroblinukas;VYTURIUKŲ;85704624097;Taip;0;1;0;1
10197;Skroblinukas;VYTURIUKŲ;72528180087;Taip;0;1;2;3
10198;Skroblinukas;VYTURIUKŲ;1096323930;Taip;0;1;0;1
10199;Skroblinukas;VYTURIUKŲ;60597534140;Ne;0;1;1;2
10200;Skroblinukas;VYTURIUKŲ;40602768192;Taip;0;2;0;2
10201;Skroblinukas;VYTURIUKŲ;3226377926;Ne;6;0;0;6
10202;Skroblinukas;VYTURIUKŲ;1175660577;Taip;0;1;2;3
10203;Skroblinukas;VYTURIUKŲ;1446835893;Taip;5;9;0;14
10204;Skroblinukas;VYTURIUKŲ;1710559060;Taip;0;2;0;2
10205;Skroblinukas;VYTURIUKŲ;21862553841;Taip;11;4;0;15
10206;Skroblinukas;VYTURIUKŲ;1611685585;Taip;11;5;0;16
10207;Skroblinukas;VYTURIUKŲ;42252673755;Taip;0;4;0;4
10208;Skroblinukas;GENIUKŲ;48655837755;Taip;0;1;0;1
10209;Skroblinukas;GENIUKŲ;2323980730;Taip;5;0;0;5
10210;Skroblinukas;GENIUKŲ;1325903217;Taip;8;7;0;15
10211;Skroblinukas;GENIUKŲ;8380073853;Taip;14;0;5;19
10212;Skroblinukas;GENIUKŲ;5766702969;Taip;0;1;6;7
10213;Skroblinukas;GENIUKŲ;4436698905;Taip;0;1;0;1
10214;Skroblinukas;GENIUKŲ;1905085978;Taip;10;0;0;10
10215;Skroblinukas;GENIUKŲ;1557733803;Taip;10;1;0;11
10216;Skroblinukas;GENIUKŲ;9433465007;Taip;10;0;0;10
10217;Skroblinukas;GENIUKŲ;1395950886;Ne;7;0;0;7
10218;Skroblinukas;GENIUKŲ;9777300890;Taip;6;0;8;14
10219;Skroblinukas;GENIUKŲ;1696303051;Taip;10;0;2;12
10220;Skroblinukas;GENIUKŲ;9846569195;Taip;0;1;3;4
10221;Skroblinukas;GENIUKŲ;3746278003;Taip;20;1;0;21
10222;Skroblinukas;GENIUKŲ;4773576465;Taip;0;1;5;6
10223;Skroblinukas;GENIUKŲ;2704157855;Taip;0;1;0;1
10224;Skroblinukas;GENIUKŲ;9564385215;Taip;12;0;0;12
10225;Skroblinukas;GENIUKŲ;6129591146;Taip;0;8;0;8
10226;Skroblinukas;GENIUKŲ;3128337104;Ne;5;0;1;6
10227;Skroblinukas;GENIUKŲ;4272941994;Taip;4;0;4;8
10228;Skroblinukas;BITUČIŲ;1255323441;Taip;0;3;1;4
10229;Skroblinukas;BITUČIŲ;1934804499;Taip;16;0;0;16
10230;Skroblinukas;BITUČIŲ;2134821488;Taip;7;0;0;7
10231;Skroblinukas;BITUČIŲ;2071447940;Taip;21;0;0;21
10232;Skroblinukas;BITUČIŲ;1659335142;Taip;0;10;0;10
10233;Skroblinukas;BITUČIŲ;6604496585;Ne;0;3;0;3
10234;Skroblinukas;BITUČIŲ;3736883850;Taip;2;0;1;3
10235;Skroblinukas;BITUČIŲ;7191689856;Taip;3;7;0;10
10236;Skroblinukas;BITUČIŲ;8778072326;Taip;8;0;0;8
10237;Skroblinukas;BITUČIŲ;2032621707;Taip;0;0;1;1
10238;Skroblinukas;BITUČIŲ;8374103872;Taip;0;4;0;4
10239;Skroblinukas;BITUČIŲ;8618587013;Taip;20;0;0;20
10240;Skroblinukas;BITUČIŲ;4945107862;Ne;9;0;4;13
10241;Skroblinukas;BITUČIŲ;9594078223;Ne;0;1;0;1
10242;Skroblinukas;BITUČIŲ;9075266818;Ne;3;4;0;7
10243;Skroblinukas;BITUČIŲ;1432694920;Taip;7;5;0;12
10244;Skroblinukas;BITUČIŲ;1967305501;Taip;3;5;4;12
10245;Skroblinukas;BITUČIŲ;1688990637;Taip;8;0;0;8
10246;Skroblinukas;BITUČIŲ;1957488412;Taip;0;1;3;4
10247;Skroblinukas;BITUČIŲ;1000804920;Taip;10;1;1;12
10248;Skroblinukas;BITUČIŲ;1544346282;Taip;0;11;0;11
10249;Skroblinukas;BITUČIŲ;1711568129;Taip;5;2;2;9
10250;Skroblinukas;BORUŽĖLIŲ;5665463557;Taip;7;0;1;8
10251;Skroblinukas;BORUŽĖLIŲ;3292517112;Taip;2;0;2;4
10252;Skroblinukas;BORUŽĖLIŲ;2481980627;Taip;9;0;0;9
10253;Skroblinukas;BORUŽĖLIŲ;3512297435;Taip;4;0;2;6
10254;Skroblinukas;BORUŽĖLIŲ;3594000419;Taip;4;0;2;6
10255;Skroblinukas;BORUŽĖLIŲ;2978284436;Taip;0;0;2;2
10256;Skroblinukas;BORUŽĖLIŲ;6293879765;Taip;0;0;2;2
10257;Skroblinukas;BORUŽĖLIŲ;9725125130;Taip;5;10;0;15
10258;Skroblinukas;BORUŽĖLIŲ;8946940285;Taip;0;5;0;5
10259;Skroblinukas;BORUŽĖLIŲ;3461165182;Taip;0;0;13;13
10260;Skroblinukas;BORUŽĖLIŲ;6433636135;Taip;3;10;2;15
10261;Skroblinukas;BORUŽĖLIŲ;7068452970;Taip;0;0;1;1
10262;Skroblinukas;BORUŽĖLIŲ;9985033530;Taip;10;0;3;13
10263;Skroblinukas;SKRUZDĖLIUKŲ;5688453546;Taip;0;2;8;10
10264;Skroblinukas;SKRUZDĖLIUKŲ;6890306112;Taip;0;5;0;5
10265;Skroblinukas;SKRUZDĖLIUKŲ;6445065388;Taip;5;3;0;8
10266;Skroblinukas;SKRUZDĖLIUKŲ;3771045336;Taip;0;5;0;5
10267;Skroblinukas;SKRUZDĖLIUKŲ;4424763028;Taip;0;7;0;7
10268;Skroblinukas;SKRUZDĖLIUKŲ;9353353289;Taip;8;2;0;10
10269;Skroblinukas;SKRUZDĖLIUKŲ;5252389111;Taip;0;2;0;2
10270;Skroblinukas;SKRUZDĖLIUKŲ;1970738675;Taip;0;0;21;21
10271;Skroblinukas;SKRUZDĖLIUKŲ;2883593274;Ne;0;1;0;1
10272;Skroblinukas;SKRUZDĖLIUKŲ;5157913924;Taip;0;6;0;6
10273;Skroblinukas;SKRUZDĖLIUKŲ;9368764758;Taip;0;4;0;4
10274;Skroblinukas;SKRUZDĖLIUKŲ;9958188318;Taip;10;7;0;17
10275;Skroblinukas;SKRUZDĖLIUKŲ;8576448571;Taip;2;0;0;2
10276;Skroblinukas;SKRUZDĖLIUKŲ;1002570367;Taip;5;0;0;5
10277;Skroblinukas;SKRUZDĖLIUKŲ;3290115134;Taip;1;1;0;2
10278;Skroblinukas;SKRUZDĖLIUKŲ;9813249677;Taip;9;0;0;9
10279;Skroblinukas;SKRUZDĖLIUKŲ;2706526326;Taip;9;0;1;10
10280;Skroblinukas;SKRUZDĖLIUKŲ;5915278745;Taip;1;1;0;2
10281;Skroblinukas;SKRUZDĖLIUKŲ;6640062847;Taip;15;0;2;17
10282;Skroblinukas;ŽVIRBLIUKŲ;3271736540;Taip;0;9;0;9
10283;Skroblinukas;ŽVIRBLIUKŲ;3065235192;Taip;11;0;1;12
10284;Skroblinukas;ŽVIRBLIUKŲ;5902713448;Taip;0;2;0;2
10285;Skroblinukas;ŽVIRBLIUKŲ;2330232287;Taip;0;0;4;4
10286;Skroblinukas;ŽVIRBLIUKŲ;7480611069;Taip;2;0;0;2
10287;Skroblinukas;ŽVIRBLIUKŲ;2071093890;Taip;0;12;1;13
10288;Skroblinukas;ŽVIRBLIUKŲ;6879979868;Taip;0;0;1;1
10289;Skroblinukas;ŽVIRBLIUKŲ;3954228349;Taip;5;0;0;5
10290;Skroblinukas;ŽVIRBLIUKŲ;4560580022;Taip;0;5;0;5
10291;Skroblinukas;ŽVIRBLIUKŲ;8206063106;Taip;5;0;1;6
10292;Skroblinukas;ŽVIRBLIUKŲ;9553242594;Taip;0;6;0;6
10293;Skroblinukas;ŽIOGELIŲ;8283516422;Taip;7;0;1;8
10294;Skroblinukas;ŽIOGELIŲ;1449037968;Taip;0;10;0;10
10295;Skroblinukas;ŽIOGELIŲ;9828486832;Taip;0;0;2;2
10296;Skroblinukas;ŽIOGELIŲ;1924714755;Taip;0;0;2;2
10297;Skroblinukas;ŽIOGELIŲ;8064713969;Taip;10;0;0;10
10298;Skroblinukas;ŽIOGELIŲ;8622930871;Taip;8;0;3;11
10299;Skroblinukas;ŽIOGELIŲ;4266945644;Taip;16;0;0;16
10300;Skroblinukas;ŽIOGELIŲ;7675772872;Taip;0;0;1;1
10301;Skroblinukas;ŽIOGELIŲ;7761972818;Taip;0;2;0;2
10302;Skroblinukas;ŽIOGELIŲ;8286842648;Taip;14;0;1;15
10303;Skroblinukas;ŽIOGELIŲ;6461678336;Taip;0;0;6;6
10304;Skroblinukas;ŽIOGELIŲ;7216760382;Taip;20;0;0;20
10305;Skroblinukas;ŽIOGELIŲ;5154111867;Taip;0;7;0;7
10306;Skroblinukas;ŽIOGELIŲ;4861971439;Taip;7;0;0;7
10307;Skroblinukas;ŽIOGELIŲ;9003855190;Taip;0;12;0;12
10308;Skroblinukas;STRAZDELIŲ;5433647187;Taip;6;0;8;14
10309;Skroblinukas;STRAZDELIŲ;9915130747;Taip;11;6;1;18
10310;Skroblinukas;STRAZDELIŲ;1669610397;Taip;6;5;3;14
10311;Skroblinukas;STRAZDELIŲ;5566457656;Ne;0;0;6;6
10312;Skroblinukas;STRAZDELIŲ;6254811026;Taip;14;0;0;14
10313;Skroblinukas;STRAZDELIŲ;4960825597;Taip;13;0;1;14
10314;Skroblinukas;STRAZDELIŲ;2195112297;Taip;9;0;2;11
10315;Skroblinukas;STRAZDELIŲ;8958893525;Taip;7;0;2;9
10316;Skroblinukas;STRAZDELIŲ;7750501815;Taip;11;0;0;11
10317;Skroblinukas;STRAZDELIŲ;6574558658;Taip;11;0;0;11
10318;Skroblinukas;STRAZDELIŲ;4198512202;Taip;13;0;0;13
10319;Skroblinukas;STRAZDELIŲ;1544598440;Taip;15;0;0;15
10320;Skroblinukas;STRAZDELIŲ;4168542339;Taip;8;3;1;12
10321;Skroblinukas;DRUGELIŲ;1792672886;Taip;0;0;11;11
10322;Skroblinukas;DRUGELIŲ;1964529755;Taip;0;17;4;21
10323;Skroblinukas;DRUGELIŲ;86231564690;Taip;0;1;0;1
10324;Skroblinukas;DRUGELIŲ;23687553212;Taip;7;5;0;12
10325;Skroblinukas;DRUGELIŲ;4532268875;Taip;0;2;6;8
10326;Skroblinukas;DRUGELIŲ;86542450905;Taip;11;0;0;11
10327;Skroblinukas;DRUGELIŲ;54750454175;Taip;0;1;1;2
10328;Skroblinukas;DRUGELIŲ;3636028890;Taip;6;0;6;12
10329;Skroblinukas;DRUGELIŲ;2079452635;Taip;0;0;1;1
10330;Skroblinukas;DRUGELIŲ;1510927547;Taip;0;0;2;2
10331;Skroblinukas;DRUGELIŲ;2325940694;Taip;0;8;0;8
10332;Skroblinukas;DRUGELIŲ;15977832913;Taip;3;6;0;9
10333;Skroblinukas;DRUGELIŲ;5068339590;Taip;6;0;0;6
10334;Skroblinukas;DRUGELIŲ;3580045988;Taip;8;1;0;9
10335;Skroblinukas;DRUGELIŲ;1005726705;Taip;3;0;4;7
10336;Skroblinukas;DRUGELIŲ;1388763405;Taip;0;1;0;1
10337;Skroblinukas;DRUGELIŲ;1791669956;Taip;0;1;1;2
10338;Skroblinukas;DRUGELIŲ;7184817010;Taip;0;1;2;3
10339;Skroblinukas;DRUGELIŲ;1109895463;Ne;0;7;0;7
10340;Skroblinukas;DRUGELIŲ;60061213883;Taip;0;6;2;8
10341;Skroblinukas;DRUGELIŲ;2116630768;Taip;0;8;0;8
10342;Skroblinukas;DRUGELIŲ;18955401411;Taip;12;1;0;13
10343;Skroblinukas;PELĖDŽIUKŲ;5975039463;Taip;0;0;2;2
10344;Skroblinukas;PELĖDŽIUKŲ;63514584063;Taip;0;12;0;12
10345;Skroblinukas;PELĖDŽIUKŲ;1000422430;Ne;0;4;0;4
10346;Skroblinukas;PELĖDŽIUKŲ;1556675902;Taip;5;1;0;6
10347;Skroblinukas;PELĖDŽIUKŲ;7666122737;Taip;7;0;0;7
10348;Skroblinukas;PELĖDŽIUKŲ;3864043251;Taip;0;1;0;1
10349;Skroblinukas;PELĖDŽIUKŲ;1759830058;Taip;0;5;0;5
10350;Skroblinukas;PELĖDŽIUKŲ;1471842192;Taip;0;1;0;1
10351;Skroblinukas;PELĖDŽIUKŲ;1382981497;Taip;0;1;0;1
10352;Skroblinukas;PELĖDŽIUKŲ;29908502973;Taip;0;6;0;6
10353;Skroblinukas;PELĖDŽIUKŲ;1220311458;Taip;0;1;0;1
10354;Skroblinukas;PELĖDŽIUKŲ;1599112927;Taip;0;2;0;2
10355;Skroblinukas;PELĖDŽIUKŲ;95946607624;Taip;0;8;0;8
10356;Skroblinukas;PELĖDŽIUKŲ;8150037173;Taip;2;6;0;8
10357;Skroblinukas;PELĖDŽIUKŲ;1898486832;Taip;4;4;0;8
10358;Skroblinukas;PELĖDŽIUKŲ;76523308405;Ne;0;8;0;8
10359;Skroblinukas;PELĖDŽIUKŲ;1602978649;Taip;0;1;0;1
10360;Skroblinukas;PELĖDŽIUKŲ;1258044022;Taip;0;4;0;4
10361;Skroblinukas;PELĖDŽIUKŲ;39209870512;Taip;0;8;0;8
10362;Skroblinukas;PELĖDŽIUKŲ;4914479407;Taip;0;0;1;1
10363;Skroblinukas;PELĖDŽIUKŲ;1847074960;Taip;0;0;6;6
10364;Smalsučiai;Žibuoklės;46376560575;Taip;0;3;1;4
10365;Smalsučiai;Žibuoklės;27034024515;Ne;0;1;0;1
10366;Smalsučiai;Žibuoklės;68726523946;Ne;4;2;0;6
10367;Smalsučiai;Žibuoklės;85358131888;Taip;6;1;0;7
10368;Smalsučiai;Žibuoklės;51861969442;Taip;0;1;0;1
10369;Smalsučiai;Žibuoklės;82746324948;Ne;0;1;0;1
10370;Smalsučiai;Žibuoklės;51889095612;Taip;0;2;0;2
10371;Smalsučiai;Žibuoklės;4258713607;Taip;0;4;0;4
10372;Smalsučiai;Žibuoklės;68097436766;Taip;0;7;0;7
10373;Smalsučiai;Žibuoklės;40922293471;Taip;0;1;0;1
10374;Smalsučiai;Žibuoklės;83056178108;Taip;0;1;0;1
10375;Smalsučiai;Žibuoklės;85342418658;Taip;0;4;0;4
10376;Smalsučiai;Žibuoklės;1023262986;Taip;0;1;0;1
10377;Smalsučiai;Žibuoklės;83033796468;Taip;5;1;0;6
10378;Smalsučiai;Žibuoklės;2099765750;Taip;0;1;0;1
10379;Smalsučiai;Žibuoklės;9512217842;Taip;1;1;0;2
10380;Smalsučiai;Žibuoklės;56779125767;Taip;0;2;0;2
10381;Smalsučiai;Aitvarų;2638709634;Taip;0;2;0;2
10382;Smalsučiai;Aitvarų;5441966713;Taip;0;11;0;11
10383;Smalsučiai;Aitvarų;8306946163;Taip;0;2;0;2
10384;Smalsučiai;Aitvarų;6469044880;Taip;2;0;0;2
10385;Smalsučiai;Aitvarų;8193410963;Ne;3;0;0;3
10386;Smalsučiai;Aitvarų;99467576480;Ne;0;0;1;1
10387;Smalsučiai;Aitvarų;2059832436;Taip;3;0;0;3
10388;Smalsučiai;Aitvarų;4795138729;Taip;0;1;0;1
10389;Smalsučiai;Aitvarų;1316590100;Taip;0;1;0;1
10390;Smalsučiai;Aitvarų;1997966082;Taip;0;6;0;6
10391;Smalsučiai;Aitvarų;1372591510;Taip;0;2;0;2
10392;Smalsučiai;Aitvarų;4585930202;Taip;16;0;0;16
10393;Smalsučiai;Aitvarų;8810690546;Taip;9;2;0;11
10394;Smalsučiai;Aitvarų;2365835087;Taip;0;2;0;2
10395;Smalsučiai;Aitvarų;1775539505;Taip;0;3;0;3
10396;Smalsučiai;Aitvarų;5761169841;Taip;0;0;3;3
10397;Smalsučiai;Aitvarų;4909226602;Taip;9;0;9;18
10398;Smalsučiai;Aitvarų;6536165801;Taip;7;3;0;10
10399;Smalsučiai;Aitvarų;3644256220;Taip;0;5;1;6
10400;Smalsučiai;Sraigiukų;1156210876;Taip;0;1;1;2
10401;Smalsučiai;Sraigiukų;37375504483;Taip;0;1;0;1
10402;Smalsučiai;Sraigiukų;5631758578;Taip;0;2;0;2
10403;Smalsučiai;Sraigiukų;76405732236;Taip;0;1;0;1
10404;Smalsučiai;Sraigiukų;48426272721;Taip;0;0;1;1
10405;Smalsučiai;Sraigiukų;26007606072;Taip;0;1;0;1
10406;Smalsučiai;Sraigiukų;31748074403;Taip;0;1;0;1
10407;Smalsučiai;Sraigiukų;55212746834;Taip;0;1;0;1
10408;Smalsučiai;Sraigiukų;67243805772;Taip;5;0;0;5
10409;Smalsučiai;Sraigiukų;68897306811;Taip;0;2;0;2
10410;Smalsučiai;Sraigiukų;1417945043;Taip;0;4;0;4
10411;Smalsučiai;Sraigiukų;12446167265;Taip;0;3;0;3
10412;Smalsučiai;Sraigiukų;45731306499;Ne;0;1;0;1
10413;Smalsučiai;Sraigiukų;70181610962;Ne;0;2;0;2
10414;Smalsučiai;Sraigiukų;71839472863;Taip;0;2;0;2
10415;Smalsučiai;Sraigiukų;97665693700;Taip;0;3;0;3
10416;Smalsučiai;Sraigiukų;95501158334;Taip;0;2;0;2
10417;Smalsučiai;Sraigiukų;1095159887;Taip;0;1;0;1
10418;Smalsučiai;Sraigiukų;1424532027;Ne;0;1;4;5
10419;Smalsučiai;Saulučių;4655599359;Taip;0;0;1;1
10420;Smalsučiai;Saulučių;2112871055;Taip;9;0;1;10
10421;Smalsučiai;Saulučių;50085798686;Taip;8;4;0;12
10422;Smalsučiai;Saulučių;1025164832;Taip;0;0;5;5
10423;Smalsučiai;Saulučių;4903800388;Taip;0;21;0;21
10424;Smalsučiai;Saulučių;52829213579;Taip;0;12;0;12
10425;Smalsučiai;Saulučių;1594035039;Taip;0;8;0;8
10426;Smalsučiai;Saulučių;8542926346;Taip;3;0;0;3
10427;Smalsučiai;Saulučių;4042979105;Taip;0;0;2;2
10428;Smalsučiai;Saulučių;1760728524;Taip;5;11;0;16
10429;Smalsučiai;Saulučių;28055409190;Taip;0;6;0;6
10430;Smalsučiai;Saulučių;7450298541;Ne;0;0;1;1
10431;Smalsučiai;Saulučių;1965194010;Taip;10;1;0;11
10432;Smalsučiai;Saulučių;1673246147;Taip;0;1;0;1
10433;Smalsučiai;Saulučių;62387945180;Taip;17;0;0;17
10434;Smalsučiai;Saulučių;1257427271;Taip;0;2;0;2
10435;Smalsučiai;Viščiukų;2802867649;Taip;0;1;0;1
10436;Smalsučiai;Viščiukų;30592434971;Taip;4;1;0;5
10437;Smalsučiai;Viščiukų;18717627431;Taip;3;0;0;3
10438;Smalsučiai;Viščiukų;26787916874;Taip;0;1;1;2
10439;Smalsučiai;Viščiukų;63575906792;Taip;4;4;0;8
10440;Smalsučiai;Viščiukų;27727844778;Taip;0;2;0;2
10441;Smalsučiai;Viščiukų;1514166474;Taip;0;8;0;8
10442;Smalsučiai;Viščiukų;37702522563;Taip;0;1;0;1
10443;Smalsučiai;Viščiukų;96002139110;Taip;5;1;0;6
10444;Smalsučiai;Viščiukų;1893910089;Taip;0;1;0;1
10445;Smalsučiai;Viščiukų;1786097164;Ne;0;4;0;4
10446;Smalsučiai;Viščiukų;78496301809;Taip;8;0;0;8
10447;Smalsučiai;Viščiukų;92961881271;Taip;0;11;0;11
10448;Smalsučiai;Viščiukų;66603023493;Taip;5;0;1;6
10449;Smalsučiai;Viščiukų;6264082741;Taip;5;8;0;13
10450;Smalsučiai;Viščiukų;30464130912;Taip;5;0;2;7
10451;Smalsučiai;Viščiukų;4732277124;Taip;0;0;1;1
10452;Smalsučiai;Boružėlių;9426629964;Ne;3;0;2;5
10453;Smalsučiai;Boružėlių;1703679877;Taip;4;0;0;4
10454;Smalsučiai;Boružėlių;2208462326;Taip;0;6;0;6
10455;Smalsučiai;Boružėlių;6643253926;Taip;0;3;0;3
10456;Smalsučiai;Boružėlių;1473016908;Ne;6;0;0;6
10457;Smalsučiai;Boružėlių;6610166355;Taip;8;0;0;8
10458;Smalsučiai;Boružėlių;7226242747;Taip;0;0;4;4
10459;Smalsučiai;Boružėlių;6085020049;Taip;10;4;0;14
10460;Smalsučiai;Boružėlių;8340768848;Ne;2;0;1;3
10461;Smalsučiai;Boružėlių;69450514879;Ne;16;2;0;18
10462;Smalsučiai;Boružėlių;4740303929;Taip;0;1;2;3
10463;Smalsučiai;Boružėlių;7364431725;Taip;21;0;0;21
10464;Smalsučiai;Boružėlių;2694575252;Ne;4;0;0;4
10465;Smalsučiai;Boružėlių;2737886714;Taip;0;8;0;8
10466;Smalsučiai;Boružėlių;4858914868;Taip;10;1;2;13
10467;Smalsučiai;Boružėlių;8523742213;Taip;16;1;0;17
10468;Smalsučiai;Zuikių;3792738445;Taip;5;1;7;13
10469;Smalsučiai;Zuikių;1453463899;Taip;0;0;1;1
10470;Smalsučiai;Zuikių;92129554371;Taip;0;1;0;1
10471;Smalsučiai;Zuikių;1830368274;Taip;5;0;1;6
10472;Smalsučiai;Zuikių;8604112256;Taip;0;2;0;2
10473;Smalsučiai;Zuikių;92460059853;Taip;0;2;0;2
10474;Smalsučiai;Zuikių;1968415573;Taip;0;1;0;1
10475;Smalsučiai;Zuikių;36701180571;Taip;0;2;0;2
10476;Smalsučiai;Zuikių;87920436781;Taip;0;1;0;1
10477;Smalsučiai;Zuikių;1597721199;Taip;0;2;0;2
10478;Smalsučiai;Zuikių;2036701320;Ne;1;2;0;3
10479;Smalsučiai;Zuikių;18980466605;Taip;0;3;1;4
10480;Smalsučiai;Zuikių;7243102874;Ne;0;1;1;2
10481;Smalsučiai;Zuikių;2057177596;Taip;11;0;0;11
10482;Smalsučiai;Zuikių;1788190385;Ne;0;1;1;2
10483;Smalsučiai;Nykštukų;2327930850;Taip;21;0;0;21
10484;Smalsučiai;Nykštukų;3787937467;Taip;11;3;0;14
10485;Smalsučiai;Nykštukų;4134975456;Taip;6;0;0;6
10486;Smalsučiai;Nykštukų;9155011285;Taip;0;8;0;8
10487;Smalsučiai;Nykštukų;9582225178;Ne;16;1;0;17
10488;Smalsučiai;Nykštukų;4566816316;Taip;0;1;0;1
10489;Smalsučiai;Nykštukų;1471941426;Taip;0;2;1;3
10490;Smalsučiai;Nykštukų;1458544456;Taip;10;0;0;10
10491;Smalsučiai;Nykštukų;6469604093;Taip;21;0;0;21
10492;Smalsučiai;Nykštukų;6358800570;Taip;10;0;0;10
10493;Smalsučiai;Nykštukų;7933302912;Taip;0;8;0;8
10494;Smalsučiai;Nykštukų;3757955200;Taip;5;7;0;12
10495;Smalsučiai;Nykštukų;5406430393;Taip;8;0;0;8
10496;Smalsučiai;Nykštukų;6899040199;Taip;8;1;0;9
10497;Smalsučiai;Nykštukų;4824786207;Taip;7;6;0;13
10498;Smalsučiai;Nykštukų;4629526320;Taip;0;0;1;1
10499;Smalsučiai;Nykštukų;9604182559;Taip;4;2;0;6
10500;Smalsučiai;Nykštukų;7396172351;Taip;0;1;0;1
10501;Smalsučiai;Katinėlių;8259056296;Taip;0;0;5;5
10502;Smalsučiai;Katinėlių;9864518144;Taip;0;1;0;1
10503;Smalsučiai;Katinėlių;2958335372;Taip;4;0;0;4
10504;Smalsučiai;Katinėlių;6090391818;Taip;19;0;0;19
10505;Smalsučiai;Katinėlių;6577214344;Taip;7;0;0;7
10506;Smalsučiai;Katinėlių;6478152041;Ne;0;11;3;14
10507;Smalsučiai;Katinėlių;8128348060;Taip;5;0;3;8
10508;Smalsučiai;Katinėlių;4847584492;Taip;5;0;2;7
10509;Smalsučiai;Katinėlių;6415906523;Taip;0;6;0;6
10510;Smalsučiai;Katinėlių;8763382361;Taip;5;0;2;7
10511;Smalsučiai;Katinėlių;4425714802;Taip;5;0;1;6
10512;Smalsučiai;Katinėlių;9732075162;Taip;3;2;3;8
10513;Smalsučiai;Katinėlių;7023531176;Taip;10;0;0;10
10514;Smalsučiai;Katinėlių;4565479092;Taip;6;0;1;7
10515;Smalsučiai;Katinėlių;7256557310;Taip;0;1;0;1
10516;Smalsučiai;PELĖDŽIUKAI;94734585174;Taip;5;0;0;5
10517;Smalsučiai;PELĖDŽIUKAI;63886240982;Taip;0;1;1;2
10518;Smalsučiai;PELĖDŽIUKAI;98196404299;Taip;0;4;0;4
10519;Smalsučiai;PELĖDŽIUKAI;25838645404;Taip;0;1;0;1
10520;Smalsučiai;PELĖDŽIUKAI;66154228179;Taip;0;3;0;3
10521;Smalsučiai;PELĖDŽIUKAI;16418705168;Taip;0;1;0;1
10522;Smalsučiai;PELĖDŽIUKAI;96461087926;Taip;3;1;0;4
10523;Smalsučiai;PELĖDŽIUKAI;55812291804;Taip;4;2;0;6
10524;Smalsučiai;PELĖDŽIUKAI;1276659532;Taip;0;1;0;1
10525;Smalsučiai;PELĖDŽIUKAI;513516143;Taip;2;1;0;3
10526;Smalsučiai;PELĖDŽIUKAI;47452987441;Taip;0;1;0;1
10527;Smalsučiai;PELĖDŽIUKAI;54610929862;Taip;0;1;0;1
10528;Smalsučiai;PELĖDŽIUKAI;32382108578;Taip;0;1;0;1
10529;Smalsučiai;PELĖDŽIUKAI;57622458673;Ne;0;12;2;14
10530;Smalsučiai;PELĖDŽIUKAI;73899364649;Taip;0;0;14;14
10531;Smalsučiai;PELĖDŽIUKAI;1575017231;Taip;11;0;0;11
10532;Smalsučiai;PELĖDŽIUKAI;1653798728;Taip;0;4;0;4
10533;Smalsučiai;PELĖDŽIUKAI;59594678142;Taip;0;1;0;1
10534;Smalsučiai;Pingvinukai;4288788194;Taip;13;0;4;17
10535;Smalsučiai;Pingvinukai;6535494814;Taip;4;0;1;5
10536;Smalsučiai;Pingvinukai;3309134310;Taip;13;3;0;16
10537;Smalsučiai;Pingvinukai;5402027714;Taip;2;12;0;14
10538;Smalsučiai;Pingvinukai;2326167599;Taip;20;0;0;20
10539;Smalsučiai;Pingvinukai;4094037708;Taip;8;1;3;12
10540;Smalsučiai;Pingvinukai;5893045664;Taip;0;1;1;2
10541;Smalsučiai;Pingvinukai;5482692473;Taip;5;9;0;14
10542;Smalsučiai;Pingvinukai;4379372200;Taip;0;0;10;10
10543;Smalsučiai;Pingvinukai;7070240693;Ne;0;0;4;4
10544;Smalsučiai;Pingvinukai;7726086066;Taip;17;0;0;17
10545;Smalsučiai;Pingvinukai;1380214235;Taip;15;0;1;16
10546;Smalsučiai;Pingvinukai;8644849194;Taip;13;0;2;15
10547;Smalsučiai;Pingvinukai;3071594259;Taip;16;0;0;16
10548;Smalsučiai;Pingvinukai;7107126092;Taip;16;0;0;16
10549;Smalsučiai;Pingvinukai;3877274360;Taip;16;0;1;17
10550;Smalsučiai;Voverikų;7713078413;Taip;0;2;0;2
10551;Smalsučiai;Voverikų;3607226859;Taip;6;11;0;17
10552;Smalsučiai;Voverikų;22791221635;Taip;0;3;0;3
10553;Smalsučiai;Voverikų;7794541741;Taip;11;0;1;12
10554;Smalsučiai;Voverikų;1467603676;Ne;0;4;0;4
10555;Smalsučiai;Voverikų;1181574676;Taip;0;7;0;7
10556;Smalsučiai;Voverikų;1599488035;Taip;0;8;0;8
10557;Smalsučiai;Voverikų;6207026048;Taip;0;11;0;11
10558;Smalsučiai;Voverikų;19592364606;Taip;0;2;0;2
10559;Smalsučiai;Voverikų;1824321380;Taip;16;0;0;16
10560;Smalsučiai;Voverikų;5611487967;Taip;7;0;1;8
10561;Smalsučiai;Voverikų;8520753848;Ne;0;1;0;1
10562;Smalsučiai;Voverikų;4145769042;Taip;10;2;0;12
10563;Smalsučiai;Voverikų;4727475042;Taip;21;0;0;21
10564;Smalsučiai;Voverikų;6529889121;Taip;15;0;1;16
10565;Smalsučiai;Voverikų;3627324317;Taip;0;7;0;7
10566;Spindulėlis;SAULUTĖS;6449284856;Ne;5;0;16;21
10567;Spindulėlis;SAULUTĖS;1180176295;Taip;0;1;0;1
10568;Spindulėlis;SAULUTĖS;1730248631;Taip;2;0;0;2
10569;Spindulėlis;SAULUTĖS;2234877411;Taip;0;0;1;1
10570;Spindulėlis;SAULUTĖS;4353031174;Ne;5;0;1;6
10571;Spindulėlis;SAULUTĖS;1346035733;Taip;0;3;0;3
10572;Spindulėlis;SAULUTĖS;9903990297;Taip;1;0;2;3
10573;Spindulėlis;SAULUTĖS;4077985773;Taip;7;0;0;7
10574;Spindulėlis;SAULUTĖS;6592057292;Taip;13;1;0;14
10575;Spindulėlis;SAULUTĖS;2890377876;Taip;5;5;0;10
10576;Spindulėlis;SAULUTĖS;9511051386;Taip;7;0;1;8
10577;Spindulėlis;SAULUTĖS;5578151523;Taip;4;0;2;6
10578;Spindulėlis;SAULUTĖS;8141324449;Taip;1;0;2;3
10579;Spindulėlis;SAULUTĖS;8923393066;Taip;2;0;1;3
10580;Spindulėlis;SAULUTĖS;5288557629;Taip;10;0;3;13
10581;Spindulėlis;SAULUTĖS;7099787230;Taip;9;0;5;14
10582;Spindulėlis;SAULUTĖS;4929866385;Taip;10;0;1;11
10583;Spindulėlis;SAULUTĖS;5233044803;Taip;0;0;3;3
10584;Spindulėlis;SAULUTĖS;3088386659;Taip;2;1;1;4
10585;Spindulėlis;DRUGELIAI;1528496272;Taip;0;1;0;1
10586;Spindulėlis;DRUGELIAI;2988630379;Taip;0;1;0;1
10587;Spindulėlis;DRUGELIAI;55250330957;Taip;0;1;2;3
10588;Spindulėlis;DRUGELIAI;80331157814;Taip;0;5;0;5
10589;Spindulėlis;DRUGELIAI;60956380679;Taip;0;1;4;5
10590;Spindulėlis;DRUGELIAI;2131409282;Taip;0;0;1;1
10591;Spindulėlis;DRUGELIAI;9348576749;Taip;0;1;4;5
10592;Spindulėlis;DRUGELIAI;63344816879;Taip;0;0;4;4
10593;Spindulėlis;DRUGELIAI;9145337789;Taip;2;0;7;9
10594;Spindulėlis;DRUGELIAI;96365393879;Taip;0;3;0;3
10595;Spindulėlis;DRUGELIAI;5050019035;Taip;9;3;0;12
10596;Spindulėlis;DRUGELIAI;1821231102;Taip;7;0;1;8
10597;Spindulėlis;DRUGELIAI;21152690883;Taip;5;1;5;11
10598;Spindulėlis;DRUGELIAI;1514479696;Taip;10;0;4;14
10599;Spindulėlis;DRUGELIAI;1391226466;Taip;10;1;0;11
10600;Spindulėlis;DRUGELIAI;27408123487;Taip;0;12;0;12
10601;Spindulėlis;DRUGELIAI;1694423628;Taip;0;4;0;4
10602;Spindulėlis;DRUGELIAI;1679106754;Taip;6;3;0;9
10603;Spindulėlis;DRUGELIAI;92417802345;Taip;0;2;0;2
10604;Spindulėlis;DRUGELIAI;4194714698;Taip;0;1;0;1
10605;Spindulėlis;DRUGELIAI;9977569249;Ne;11;0;0;11
10606;Spindulėlis;BITUTĖS;54387249420;Taip;2;0;0;2
10607;Spindulėlis;BITUTĖS;83785970474;Taip;0;1;0;1
10608;Spindulėlis;BITUTĖS;92803008887;Taip;0;4;0;4
10609;Spindulėlis;BITUTĖS;4539792030;Ne;10;1;1;12
10610;Spindulėlis;BITUTĖS;16045001090;Taip;7;2;0;9
10611;Spindulėlis;BITUTĖS;1399847362;Ne;0;1;0;1
10612;Spindulėlis;BITUTĖS;3986191435;Taip;0;1;4;5
10613;Spindulėlis;BITUTĖS;97661389553;Taip;6;2;0;8
10614;Spindulėlis;BITUTĖS;2137229669;Ne;0;1;0;1
10615;Spindulėlis;BITUTĖS;19541905006;Taip;0;1;0;1
10616;Spindulėlis;BITUTĖS;503164673;Taip;0;1;0;1
10617;Spindulėlis;BITUTĖS;27928352319;Taip;10;1;0;11
10618;Spindulėlis;BITUTĖS;18443825776;Taip;0;1;1;2
10619;Spindulėlis;BITUTĖS;1033202443;Taip;0;1;0;1
10620;Spindulėlis;BITUTĖS;30036722764;Ne;11;3;0;14
10621;Spindulėlis;BITUTĖS;1763306358;Taip;15;0;1;16
10622;Spindulėlis;BITUTĖS;27520164282;Taip;2;0;0;2
10623;Spindulėlis;BITUTĖS;29747353664;Taip;0;1;2;3
10624;Spindulėlis;VARPELIAI;7184471307;Taip;7;0;0;7
10625;Spindulėlis;VARPELIAI;4116151797;Taip;14;0;0;14
10626;Spindulėlis;VARPELIAI;3276656641;Taip;13;0;3;16
10627;Spindulėlis;VARPELIAI;8039086094;Taip;16;0;2;18
10628;Spindulėlis;VARPELIAI;3329587401;Taip;0;0;5;5
10629;Spindulėlis;VARPELIAI;6633031473;Taip;11;0;1;12
10630;Spindulėlis;VARPELIAI;6880075874;Taip;18;0;0;18
10631;Spindulėlis;VARPELIAI;4152722583;Taip;12;0;7;19
10632;Spindulėlis;VARPELIAI;8793327541;Taip;0;1;2;3
10633;Spindulėlis;VARPELIAI;6949857110;Taip;4;0;1;5
10634;Spindulėlis;VARPELIAI;2511267939;Ne;8;0;2;10
10635;Spindulėlis;VARPELIAI;4171789569;Taip;7;4;0;11
10636;Spindulėlis;VARPELIAI;1454039572;Taip;6;0;1;7
10637;Spindulėlis;VARPELIAI;9740815635;Taip;14;0;0;14
10638;Spindulėlis;VARPELIAI;4308169582;Taip;0;0;10;10
10639;Spragtukas;NYKŠTUKAI;4809829190;Taip;10;0;1;11
10640;Spragtukas;NYKŠTUKAI;4527798635;Taip;0;1;1;2
10641;Spragtukas;NYKŠTUKAI;8551195766;Taip;4;0;0;4
10642;Spragtukas;NYKŠTUKAI;8623311748;Taip;11;0;0;11
10643;Spragtukas;NYKŠTUKAI;9805841777;Taip;0;3;0;3
10644;Spragtukas;NYKŠTUKAI;2943832694;Taip;0;1;0;1
10645;Spragtukas;NYKŠTUKAI;8460527225;Taip;0;3;0;3
10646;Spragtukas;NYKŠTUKAI;9595221494;Ne;11;1;0;12
10647;Spragtukas;NYKŠTUKAI;6185016824;Taip;6;6;0;12
10648;Spragtukas;NYKŠTUKAI;8715073512;Taip;10;0;0;10
10649;Spragtukas;NYKŠTUKAI;6162830167;Taip;17;0;0;17
10650;Spragtukas;NYKŠTUKAI;1710184531;Taip;5;0;0;5
10651;Spragtukas;NYKŠTUKAI;2076126173;Taip;0;1;0;1
10652;Spragtukas;NYKŠTUKAI;3012345413;Taip;15;0;0;15
10653;Spragtukas;NYKŠTUKAI;8698492694;Taip;11;2;0;13
10654;Spragtukas;NYKŠTUKAI;1150002524;Taip;0;1;0;1
10655;Spragtukas;NYKŠTUKAI;4493810276;Taip;0;1;1;2
10656;Spragtukas;NYKŠTUKAI;8288793522;Taip;15;1;0;16
10657;Spragtukas;SAULUTĖ;89749837388;Ne;5;1;0;6
10658;Spragtukas;SAULUTĖ;3392224465;Taip;0;1;0;1
10659;Spragtukas;SAULUTĖ;1174566363;Taip;5;0;0;5
10660;Spragtukas;SAULUTĖ;10998123453;Taip;0;9;0;9
10661;Spragtukas;SAULUTĖ;48934106998;Ne;5;0;0;5
10662;Spragtukas;SAULUTĖ;34989165939;Ne;0;4;0;4
10663;Spragtukas;SAULUTĖ;1889153590;Taip;0;1;0;1
10664;Spragtukas;SAULUTĖ;53375921406;Ne;4;0;0;4
10665;Spragtukas;SAULUTĖ;50653432030;Taip;0;1;0;1
10666;Spragtukas;SAULUTĖ;4321780080;Taip;3;1;0;4
10667;Spragtukas;SAULUTĖ;51889437335;Taip;8;0;0;8
10668;Spragtukas;SAULUTĖ;94483480424;Taip;0;3;1;4
10669;Spragtukas;SAULUTĖ;7234682005;Taip;10;1;0;11
10670;Spragtukas;SAULUTĖ;42635888133;Taip;0;1;0;1
10671;Spragtukas;SAULUTĖ;80790750169;Taip;0;5;0;5
10672;Spragtukas;SAULUTĖ;96435499947;Taip;2;0;8;10
10673;Spragtukas;SAULUTĖ;91767288727;Taip;0;1;0;1
10674;Spragtukas;SAULUTĖ;94418271961;Taip;1;2;0;3
10675;Spragtukas;SAULUTĖ;5377198769;Taip;0;4;0;4
10676;Spragtukas;SPINDULĖLIAI;94650801877;Taip;2;4;2;8
10677;Spragtukas;SPINDULĖLIAI;4675031453;Taip;0;6;0;6
10678;Spragtukas;SPINDULĖLIAI;4004275398;Taip;0;2;0;2
10679;Spragtukas;SPINDULĖLIAI;4216521988;Taip;7;0;0;7
10680;Spragtukas;SPINDULĖLIAI;9781727236;Taip;4;0;2;6
10681;Spragtukas;SPINDULĖLIAI;1029392579;Taip;2;1;0;3
10682;Spragtukas;SPINDULĖLIAI;6417098461;Taip;0;2;1;3
10683;Spragtukas;SPINDULĖLIAI;1336973131;Taip;5;0;0;5
10684;Spragtukas;SPINDULĖLIAI;70413855110;Taip;13;0;0;13
10685;Spragtukas;SPINDULĖLIAI;47393966396;Taip;0;1;0;1
10686;Spragtukas;SPINDULĖLIAI;65692358082;Taip;0;1;1;2
10687;Spragtukas;SPINDULĖLIAI;6052538605;Taip;0;15;0;15
10688;Spragtukas;SPINDULĖLIAI;2138152514;Taip;0;1;1;2
10689;Spragtukas;SPINDULĖLIAI;1305123801;Taip;0;2;0;2
10690;Spragtukas;SPINDULĖLIAI;4485715299;Taip;15;0;1;16
10691;Spragtukas;SPINDULĖLIAI;4224693184;Taip;0;1;0;1
10692;Spragtukas;SPINDULĖLIAI;81928765016;Taip;5;0;0;5
10693;Spragtukas;SPINDULĖLIAI;8415429693;Taip;0;8;0;8
10694;Spragtukas;GINTARĖLIAI;37209001618;Taip;5;3;0;8
10695;Spragtukas;GINTARĖLIAI;82498261158;Taip;0;2;0;2
10696;Spragtukas;GINTARĖLIAI;32290835176;Taip;0;4;0;4
10697;Spragtukas;GINTARĖLIAI;68059396649;Ne;3;1;0;4
10698;Spragtukas;GINTARĖLIAI;39962240237;Taip;0;5;0;5
10699;Spragtukas;GINTARĖLIAI;1035579583;Taip;0;2;0;2
10700;Spragtukas;GINTARĖLIAI;95645593385;Taip;11;0;0;11
10701;Spragtukas;GINTARĖLIAI;8554047390;Taip;5;6;0;11
10702;Spragtukas;GINTARĖLIAI;69086864157;Taip;0;14;0;14
10703;Spragtukas;ČIPOLINO;2371848091;Taip;0;18;0;18
10704;Spragtukas;ČIPOLINO;6582680700;Taip;21;0;0;21
10705;Spragtukas;ČIPOLINO;1599958343;Taip;0;3;0;3
10706;Spragtukas;ČIPOLINO;1547670082;Taip;6;15;0;21
10707;Spragtukas;ČIPOLINO;7504632314;Taip;5;0;0;5
10708;Spragtukas;ČIPOLINO;1597988501;Taip;10;0;0;10
10709;Spragtukas;ČIPOLINO;6526633051;Taip;0;9;0;9
10710;Spragtukas;ČIPOLINO;1058970799;Taip;9;7;0;16
10711;Spragtukas;ČIPOLINO;45661532130;Taip;0;3;0;3
10712;Spragtukas;ČIPOLINO;7640805299;Taip;0;10;0;10
10713;Spragtukas;ČIPOLINO;1365907314;Taip;7;0;0;7
10714;Spragtukas;ČIPOLINO;4941531443;Taip;10;0;0;10
10715;Spragtukas;ČIPOLINO;3566797064;Taip;0;4;0;4
10716;Spragtukas;ČIPOLINO;2902550587;Taip;0;1;0;1
10717;Spragtukas;ČIPOLINO;1827458781;Taip;15;0;0;15
10718;Spragtukas;ČIPOLINO;3798118695;Taip;6;8;0;14
10719;Spragtukas;ČIPOLINO;69114720307;Taip;8;1;0;9
10720;Spragtukas;ČIPOLINO;9789977863;Taip;0;6;0;6
10721;Spragtukas;ČIPOLINO;1044112039;Taip;21;0;0;21
10722;Spragtukas;ČIPOLINO;5707084920;Taip;10;6;0;16
10723;Spragtukas;BORUŽĖLĖS;2356476212;Taip;5;3;0;8
10724;Spragtukas;BORUŽĖLĖS;8429135626;Taip;10;3;0;13
10725;Spragtukas;BORUŽĖLĖS;8287102733;Taip;9;4;0;13
10726;Spragtukas;BORUŽĖLĖS;5844437769;Ne;15;1;0;16
10727;Spragtukas;BORUŽĖLĖS;6584145176;Taip;8;4;0;12
10728;Spragtukas;BORUŽĖLĖS;8226921630;Ne;0;4;0;4
10729;Spragtukas;BORUŽĖLĖS;2946297529;Ne;10;4;0;14
10730;Spragtukas;BORUŽĖLĖS;9860876807;Taip;0;1;0;1
10731;Spragtukas;BORUŽĖLĖS;5633883897;Ne;3;2;0;5
10732;Spragtukas;BORUŽĖLĖS;1570206034;Taip;5;5;0;10
10733;Spragtukas;BORUŽĖLĖS;9965087132;Taip;0;4;0;4
10734;Spragtukas;BORUŽĖLĖS;7806145224;Taip;10;2;0;12
10735;Spragtukas;BORUŽĖLĖS;2909322678;Taip;0;6;0;6
10736;Spragtukas;BORUŽĖLĖS;5236797574;Ne;0;2;0;2
10737;Spragtukas;BORUŽĖLĖS;1306663967;Taip;3;10;0;13
10738;Spragtukas;BORUŽĖLĖS;4069044269;Taip;0;7;0;7
10739;Spragtukas;BORUŽĖLĖS;5150028968;Taip;0;4;0;4
10740;Spragtukas;BORUŽĖLĖS;9754594384;Ne;9;4;0;13
10741;Spragtukas;BORUŽĖLĖS;1756340613;Taip;0;3;0;3
10742;Spragtukas;DRUGELIAI;41147623084;Taip;0;3;0;3
10743;Spragtukas;DRUGELIAI;1138975383;Taip;0;2;0;2
10744;Spragtukas;DRUGELIAI;32858776091;Taip;9;1;0;10
10745;Spragtukas;DRUGELIAI;91794949460;Taip;10;0;0;10
10746;Spragtukas;DRUGELIAI;2118272247;Taip;0;17;0;17
10747;Spragtukas;DRUGELIAI;46794033116;Taip;2;1;0;3
10748;Spragtukas;DRUGELIAI;1418494757;Taip;0;1;1;2
10749;Spragtukas;DRUGELIAI;60980580078;Taip;0;4;0;4
10750;Spragtukas;DRUGELIAI;82801263312;Taip;0;1;2;3
10751;Spragtukas;DRUGELIAI;56384144331;Taip;0;2;0;2
10752;Spragtukas;DRUGELIAI;2032107153;Ne;0;2;1;3
10753;Spragtukas;DRUGELIAI;19580966465;Taip;0;2;1;3
10754;Spragtukas;DRUGELIAI;1731215395;Taip;5;0;0;5
10755;Spragtukas;DRUGELIAI;67679737675;Taip;0;1;0;1
10756;Spragtukas;DRUGELIAI;1953368351;Taip;0;0;6;6
10757;Spragtukas;DRUGELIAI;271958429;Taip;3;0;0;3
10758;Spragtukas;DRUGELIAI;1030688447;Taip;0;2;0;2
10759;Spragtukas;DRUGELIAI;22025568463;Ne;0;16;0;16
10760;Spragtukas;DRUGELIAI;38120721944;Taip;0;1;1;2
10761;Spragtukas;DRUGELIAI;20279570129;Ne;0;1;0;1
10762;Spragtukas;GAIDELIAI;71081903240;Taip;8;1;0;9
10763;Spragtukas;GAIDELIAI;79237309377;Taip;0;4;0;4
10764;Spragtukas;GAIDELIAI;54099559107;Taip;0;0;2;2
10765;Spragtukas;GAIDELIAI;19453957982;Taip;0;0;2;2
10766;Spragtukas;GAIDELIAI;1203266608;Taip;0;0;1;1
10767;Spragtukas;GAIDELIAI;11849369985;Taip;0;0;1;1
10768;Spragtukas;GAIDELIAI;2042294168;Taip;0;4;0;4
10769;Spragtukas;GAIDELIAI;1030566027;Taip;0;6;0;6
10770;Spragtukas;GAIDELIAI;8150653485;Taip;3;0;1;4
10771;Spragtukas;GAIDELIAI;1247838976;Taip;5;0;0;5
10772;Spragtukas;GAIDELIAI;2061441977;Taip;2;0;1;3
10773;Spragtukas;GAIDELIAI;9644808747;Ne;8;1;1;10
10774;Spragtukas;GAIDELIAI;78296815539;Taip;0;3;0;3
10775;Spragtukas;GAIDELIAI;4209118353;Taip;0;2;0;2
10776;Spragtukas;GAIDELIAI;2848207417;Taip;10;0;1;11
10777;Spragtukas;GAIDELIAI;1210698072;Taip;6;1;0;7
10778;Spragtukas;GAIDELIAI;1070119148;Taip;4;3;0;7
10779;Spragtukas;GAIDELIAI;9235972927;Taip;3;1;0;4
10780;Spragtukas;ŽUVELĖS;8762832644;Taip;12;0;0;12
10781;Spragtukas;ŽUVELĖS;8652973900;Taip;11;2;0;13
10782;Spragtukas;ŽUVELĖS;3261213140;Taip;0;1;0;1
10783;Spragtukas;ŽUVELĖS;5689392663;Taip;21;0;0;21
10784;Spragtukas;ŽUVELĖS;9592271053;Taip;4;1;0;5
10785;Spragtukas;ŽUVELĖS;1272075883;Taip;3;2;0;5
10786;Spragtukas;ŽUVELĖS;6465991136;Taip;8;7;0;15
10787;Spragtukas;ŽUVELĖS;9282940430;Taip;3;1;0;4
10788;Spragtukas;ŽUVELĖS;6503842956;Taip;0;1;0;1
10789;Spragtukas;ŽUVELĖS;2578400770;Taip;0;1;0;1
10790;Spragtukas;ŽUVELĖS;6757604305;Taip;13;0;0;13
10791;Spragtukas;ŽUVELĖS;3139748724;Taip;14;0;0;14
10792;Spragtukas;ŽUVELĖS;8640877497;Taip;11;0;0;11
10793;Spragtukas;ŽUVELĖS;2025314314;Taip;16;0;0;16
10794;Spragtukas;ŽUVELĖS;4848647219;Ne;17;0;0;17
10795;Spragtukas;ŽUVELĖS;3491418162;Taip;1;0;0;1
10796;Spragtukas;ŽUVELĖS;5836788916;Taip;8;1;2;11
10797;Spragtukas;ŽUVELĖS;5704941595;Taip;7;2;0;9
10798;Spragtukas;ŽUVELĖS;6545866812;Taip;8;0;0;8
10799;Spragtukas;ŽUVELĖS;3286456855;Taip;0;1;0;1
10800;Spragtukas;ŽUVELĖS;9662188102;Taip;12;1;0;13
10801;Spragtukas;ŽUVELĖS;2539660577;Ne;14;1;0;15
10802;Spragtukas;ŽUVELĖS;4331948700;Taip;0;0;2;2
10803;Spragtukas;RIEŠUTĖLIAI;8444759709;Taip;6;1;0;7
10804;Spragtukas;RIEŠUTĖLIAI;1384812263;Taip;5;0;0;5
10805;Spragtukas;RIEŠUTĖLIAI;8463747761;Taip;0;1;0;1
10806;Spragtukas;RIEŠUTĖLIAI;4131998934;Taip;0;4;0;4
10807;Spragtukas;RIEŠUTĖLIAI;1690400583;Taip;0;4;0;4
10808;Spragtukas;RIEŠUTĖLIAI;6419503965;Taip;0;16;0;16
10809;Spragtukas;RIEŠUTĖLIAI;8246512283;Ne;0;4;0;4
10810;Spragtukas;RIEŠUTĖLIAI;1627243902;Taip;6;1;0;7
10811;Spragtukas;RIEŠUTĖLIAI;1326603216;Taip;5;1;0;6
10812;Spragtukas;RIEŠUTĖLIAI;72636559695;Taip;0;6;0;6
10813;Spragtukas;RIEŠUTĖLIAI;6573750143;Taip;1;12;0;13
10814;Spragtukas;RIEŠUTĖLIAI;5306883933;Ne;1;1;0;2
10815;Spragtukas;RIEŠUTĖLIAI;3654640843;Taip;0;1;0;1
10816;Spragtukas;RIEŠUTĖLIAI;1849644444;Taip;4;2;0;6
10817;Spragtukas;RIEŠUTĖLIAI;9045185920;Taip;6;2;0;8
10818;Spragtukas;RIEŠUTĖLIAI;1800927281;Taip;5;1;0;6
10819;Spragtukas;RIEŠUTĖLIAI;4427123314;Taip;0;6;0;6
10820;Spragtukas;RIEŠUTĖLIAI;6322121173;Taip;0;5;0;5
10821;Spragtukas;RIEŠUTĖLIAI;3113106252;Taip;0;1;0;1
10822;Spragtukas;RIEŠUTĖLIAI;9314811354;Taip;0;5;0;5
10823;Spragtukas;VIŠČIUKAI;6493380877;Taip;5;0;0;5
10824;Spragtukas;VIŠČIUKAI;5556920140;Taip;17;0;0;17
10825;Spragtukas;VIŠČIUKAI;2255007161;Taip;0;2;0;2
10826;Spragtukas;VIŠČIUKAI;3471355267;Taip;9;1;0;10
10827;Spragtukas;VIŠČIUKAI;5427116799;Taip;19;0;0;19
10828;Spragtukas;VIŠČIUKAI;6121388208;Taip;7;0;1;8
10829;Spragtukas;VIŠČIUKAI;1747417905;Taip;2;0;8;10
10830;Spragtukas;VIŠČIUKAI;8339926929;Taip;10;2;0;12
10831;Spragtukas;VIŠČIUKAI;5724874569;Taip;0;19;0;19
10832;Spragtukas;VIŠČIUKAI;8698469979;Taip;6;7;0;13
10833;Spragtukas;VIŠČIUKAI;8625143071;Taip;12;2;0;14
10834;Spragtukas;VIŠČIUKAI;1430632638;Taip;8;0;0;8
10835;Spragtukas;VIŠČIUKAI;1525489137;Taip;5;0;1;6
10836;Spragtukas;VIŠČIUKAI;5697451914;Taip;0;1;2;3
10837;Spragtukas;MEŠKIUKAI;6192381779;Taip;0;18;0;18
10838;Spragtukas;MEŠKIUKAI;4586034709;Ne;0;0;1;1
10839;Spragtukas;MEŠKIUKAI;5687853390;Taip;0;0;1;1
10840;Spragtukas;MEŠKIUKAI;8235791891;Taip;10;0;0;10
10841;Spragtukas;MEŠKIUKAI;3948232692;Taip;0;1;1;2
10842;Spragtukas;MEŠKIUKAI;2879077913;Ne;0;6;0;6
10843;Spragtukas;MEŠKIUKAI;4669257062;Taip;1;1;0;2
10844;Spragtukas;MEŠKIUKAI;3968434618;Taip;2;0;0;2
10845;Spragtukas;MEŠKIUKAI;1150727381;Taip;11;2;0;13
10846;Spragtukas;MEŠKIUKAI;9191831532;Taip;7;6;0;13
10847;Spragtukas;MEŠKIUKAI;4344537391;Taip;21;0;0;21
10848;Spragtukas;MEŠKIUKAI;7859959104;Taip;5;0;0;5
10849;Spragtukas;MEŠKIUKAI;1865253659;Taip;3;0;0;3
10850;Spragtukas;MEŠKIUKAI;3692960591;Taip;0;1;0;1
10851;Spragtukas;MEŠKIUKAI;3337355440;Taip;11;1;0;12
10852;Spragtukas;MEŠKIUKAI;2987638580;Taip;0;9;0;9
10853;Spragtukas;MEŠKIUKAI;7511680722;Taip;1;1;4;6
10854;Spragtukas;MEŠKIUKAI;9149954373;Taip;3;1;0;4
10855;Spragtukas;MEŠKIUKAI;6679886985;Taip;0;0;1;1
10856;Strazdelis;Žiogelių;59969322783;Taip;10;0;0;10
10857;Strazdelis;Žiogelių;48052363003;Taip;0;5;0;5
10858;Strazdelis;Žiogelių;12739940649;Taip;0;3;5;8
10859;Strazdelis;Žiogelių;79443961061;Taip;0;3;0;3
10860;Strazdelis;Žiogelių;84548133061;Taip;0;10;0;10
10861;Strazdelis;Žiogelių;4013389618;Ne;16;5;0;21
10862;Strazdelis;Žiogelių;5449465531;Taip;0;1;0;1
10863;Strazdelis;Žiogelių;57514782479;Taip;0;9;0;9
10864;Strazdelis;Žiogelių;50984917126;Taip;0;2;0;2
10865;Strazdelis;Žiogelių;1058210612;Taip;0;2;0;2
10866;Strazdelis;Žiogelių;2110092578;Taip;0;4;0;4
10867;Strazdelis;Žiogelių;1858519255;Ne;13;2;0;15
10868;Strazdelis;Žiogelių;20845810823;Taip;0;3;1;4
10869;Strazdelis;Žiogelių;2086723106;Taip;0;17;0;17
10870;Strazdelis;Žiogelių;53114476996;Taip;0;1;0;1
10871;Strazdelis;Žiogelių;20510560289;Taip;12;0;0;12
10872;Strazdelis;Žiogelių;64076729200;Taip;9;0;0;9
10873;Strazdelis;Žiogelių;98433672584;Taip;0;3;4;7
10874;Strazdelis;Žiogelių;90936509570;Taip;2;0;4;6
10875;Strazdelis;Žiogelių;43128715501;Taip;10;2;0;12
10876;Strazdelis;Šeimynėlės;3662217925;Taip;10;2;0;12
10877;Strazdelis;Šeimynėlės;8274897977;Taip;18;0;0;18
10878;Strazdelis;Šeimynėlės;29586826889;Ne;4;1;0;5
10879;Strazdelis;Šeimynėlės;43314069648;Taip;5;1;0;6
10880;Strazdelis;Šeimynėlės;4697537943;Taip;0;7;0;7
10881;Strazdelis;Šeimynėlės;3943578036;Ne;10;2;1;13
10882;Strazdelis;Šeimynėlės;2802486859;Ne;0;8;0;8
10883;Strazdelis;Šeimynėlės;4791752179;Taip;6;0;0;6
10884;Strazdelis;Šeimynėlės;7215063033;Taip;4;4;0;8
10885;Strazdelis;Šeimynėlės;1665134387;Taip;0;4;0;4
10886;Strazdelis;Šeimynėlės;1481671624;Taip;0;7;0;7
10887;Strazdelis;Šeimynėlės;6014213362;Taip;0;10;0;10
10888;Strazdelis;Šeimynėlės;45083023033;Taip;5;5;0;10
10889;Strazdelis;Šeimynėlės;4454199703;Ne;15;0;0;15
10890;Strazdelis;Šeimynėlės;4698566091;Ne;10;2;0;12
10891;Strazdelis;Šeimynėlės;5698472204;Taip;12;2;0;14
10892;Strazdelis;Šeimynėlės;6528024720;Taip;4;0;0;4
10893;Strazdelis;Šeimynėlės;9835716116;Ne;15;0;0;15
10894;Strazdelis;Šeimynėlės;7149827850;Taip;9;2;0;11
10895;Strazdelis;Šeimynėlės;4633366779;Taip;6;3;0;9
10896;Strazdelis;Šeimynėlės;5749300013;Taip;0;2;0;2
10897;Strazdelis;Šeimynėlės;4929828091;Taip;2;1;0;3
10898;Strazdelis;Genelio;8754275576;Ne;0;3;0;3
10899;Strazdelis;Genelio;7216768880;Taip;0;2;0;2
10900;Strazdelis;Genelio;50350281905;Taip;21;0;0;21
10901;Strazdelis;Genelio;9198429790;Taip;0;1;0;1
10902;Strazdelis;Genelio;2871673641;Taip;0;3;0;3
10903;Strazdelis;Genelio;6147183190;Taip;5;2;0;7
10904;Strazdelis;Genelio;2078150337;Taip;3;3;0;6
10905;Strazdelis;Genelio;18461074207;Taip;0;3;0;3
10906;Strazdelis;Genelio;8634815556;Taip;0;0;1;1
10907;Strazdelis;Genelio;9904719582;Taip;14;0;0;14
10908;Strazdelis;Genelio;7308925265;Taip;7;2;0;9
10909;Strazdelis;Genelio;4655931716;Taip;3;8;0;11
10910;Strazdelis;Genelio;8182994112;Ne;0;1;0;1
10911;Strazdelis;Genelio;1362428967;Taip;0;8;0;8
10912;Strazdelis;Genelio;5981747175;Taip;5;5;1;11
10913;Strazdelis;Genelio;1847733888;Taip;2;0;2;4
10914;Strazdelis;Vikruolių;91962766970;Taip;8;1;0;9
10915;Strazdelis;Vikruolių;10196561042;Taip;0;1;0;1
10916;Strazdelis;Vikruolių;23376659452;Taip;3;1;0;4
10917;Strazdelis;Vikruolių;86783302100;Taip;0;1;0;1
10918;Strazdelis;Vikruolių;13220421668;Taip;0;3;0;3
10919;Strazdelis;Vikruolių;54050062292;Taip;0;4;0;4
10920;Strazdelis;Vikruolių;16453584376;Taip;8;3;0;11
10921;Strazdelis;Vikruolių;63720428545;Taip;0;1;0;1
10922;Strazdelis;Vikruolių;52790577750;Taip;0;2;0;2
10923;Strazdelis;Vikruolių;66197587093;Taip;0;3;0;3
10924;Strazdelis;Vikruolių;77589342371;Taip;0;4;0;4
10925;Strazdelis;Vikruolių;56012252629;Taip;2;1;0;3
10926;Strazdelis;Vikruolių;87689168341;Taip;1;1;0;2
10927;Strazdelis;Vikruolių;44566447637;Taip;3;0;0;3
10928;Strazdelis;Vikruolių;9065275674;Taip;8;0;0;8
10929;Strazdelis;Vikruolių;66254701944;Taip;0;11;0;11
10930;Strazdelis;Vikruolių;24001445236;Taip;0;7;0;7
10931;Strazdelis;Vikruolių;47547568043;Ne;0;1;0;1
10932;Strazdelis;Vikruolių;6523307315;Taip;15;0;0;15
10933;Strazdelis;Vikruolių;15920566059;Taip;6;4;0;10
10934;Strazdelis;Vikruolių;92799934389;Taip;0;7;0;7
10935;Strazdelis;Vikruolių;33123804487;Ne;0;2;0;2
10936;Strazdelis;Vyturėlių;72069723016;Taip;0;1;0;1
10937;Strazdelis;Vyturėlių;64675347442;Taip;0;1;0;1
10938;Strazdelis;Vyturėlių;18595696353;Taip;0;4;0;4
10939;Strazdelis;Vyturėlių;1426195737;Taip;0;3;0;3
10940;Strazdelis;Vyturėlių;2502465398;Taip;0;1;0;1
10941;Strazdelis;Vyturėlių;86957187003;Ne;12;1;0;13
10942;Strazdelis;Vyturėlių;1707225898;Ne;0;2;0;2
10943;Strazdelis;Vyturėlių;39502125227;Taip;0;9;0;9
10944;Strazdelis;Vyturėlių;52211473547;Taip;0;4;0;4
10945;Strazdelis;Vyturėlių;98553857685;Taip;0;1;0;1
10946;Strazdelis;Vyturėlių;43722400626;Taip;0;6;0;6
10947;Strazdelis;Vyturėlių;54646720821;Taip;0;5;0;5
10948;Strazdelis;Vyturėlių;47899514138;Taip;20;0;0;20
10949;Strazdelis;Vyturėlių;95260832237;Taip;0;1;0;1
10950;Strazdelis;Vyturėlių;17045991832;Taip;0;5;0;5
10951;Strazdelis;Vyturėlių;49277241025;Taip;7;5;0;12
10952;Strazdelis;Vyturėlių;58143176237;Taip;0;2;0;2
10953;Strazdelis;Vyturėlių;58440671129;Taip;3;2;0;5
10954;Strazdelis;Vyturėlių;62063592887;Taip;0;2;0;2
10955;Strazdelis;Vyturėlių;83919699672;Taip;0;10;0;10
10956;Strazdelis;Vyturėlių;96062922228;Taip;0;1;0;1
10957;Strazdelis;Varpelio;98818869900;Taip;5;0;0;5
10958;Strazdelis;Varpelio;8415383526;Taip;11;2;0;13
10959;Strazdelis;Varpelio;2580733127;Taip;5;0;0;5
10960;Strazdelis;Varpelio;2662549392;Taip;0;1;0;1
10961;Strazdelis;Varpelio;9502341478;Taip;0;9;0;9
10962;Strazdelis;Varpelio;2251157025;Taip;5;0;0;5
10963;Strazdelis;Varpelio;6931726275;Ne;4;1;0;5
10964;Strazdelis;Varpelio;6311710825;Taip;11;2;0;13
10965;Strazdelis;Varpelio;9401101407;Ne;0;4;0;4
10966;Strazdelis;Varpelio;1955166372;Taip;9;1;0;10
10967;Strazdelis;Varpelio;4873707286;Ne;10;2;0;12
10968;Strazdelis;Varpelio;6527855940;Taip;7;2;0;9
10969;Strazdelis;Varpelio;4076266466;Taip;0;13;0;13
10970;Strazdelis;Varpelio;2824416350;Taip;0;5;0;5
10971;Strazdelis;Varpelio;3610250359;Taip;6;2;0;8
10972;Strazdelis;Varpelio;2766970956;Taip;0;1;0;1
10973;Strazdelis;Varpelio;2329522074;Taip;10;5;0;15
10974;Strazdelis;Varpelio;1173067724;Taip;13;2;0;15
10975;Strazdelis;Varpelio;7393083827;Taip;0;11;0;11
10976;Strazdelis;Varpelio;6555803164;Taip;0;2;0;2
10977;Strazdelis;Varpelio;1021364759;Taip;12;2;0;14
10978;Strazdelis;Varpelio;1706026100;Ne;0;3;0;3
10979;Strazdelis;Pelėdžiukų;5892430004;Taip;4;0;0;4
10980;Strazdelis;Pelėdžiukų;1901641517;Taip;12;1;0;13
10981;Strazdelis;Pelėdžiukų;8637386316;Taip;0;2;0;2
10982;Strazdelis;Pelėdžiukų;1704292727;Taip;9;2;0;11
10983;Strazdelis;Pelėdžiukų;4617237063;Taip;13;3;0;16
10984;Strazdelis;Pelėdžiukų;3036380561;Taip;13;3;0;16
10985;Strazdelis;Pelėdžiukų;8371999002;Taip;3;0;0;3
10986;Strazdelis;Pelėdžiukų;8287554571;Ne;10;1;0;11
10987;Strazdelis;Pelėdžiukų;5580738386;Taip;6;1;0;7
10988;Strazdelis;Pelėdžiukų;4448556404;Taip;12;2;0;14
10989;Strazdelis;Pelėdžiukų;3943914976;Taip;9;0;0;9
10990;Strazdelis;Pelėdžiukų;8854150040;Taip;0;1;0;1
10991;Strazdelis;Pelėdžiukų;2238875354;Ne;5;0;0;5
10992;Strazdelis;Pelėdžiukų;4004930488;Taip;6;1;0;7
10993;Strazdelis;Pelėdžiukų;5768674837;Taip;5;0;0;5
10994;Strazdelis;Pelėdžiukų;7349106795;Taip;11;1;0;12
10995;Strazdelis;Pelėdžiukų;9761595867;Taip;16;0;0;16
10996;Strazdelis;Pelėdžiukų;8089585177;Taip;4;0;0;4
10997;Strazdelis;Pelėdžiukų;7876385010;Taip;4;1;0;5
10998;Strazdelis;Pelėdžiukų;2848984531;Taip;0;10;0;10
10999;Strazdelis;Pelėdžiukų;7471890377;Taip;5;0;0;5
11000;Strazdelis;Saulutės;1474503932;Taip;5;2;0;7
11001;Strazdelis;Saulutės;27177757900;Taip;0;5;1;6
11002;Strazdelis;Saulutės;40932140069;Taip;0;1;0;1
11003;Strazdelis;Saulutės;1523471662;Taip;9;3;0;12
11004;Strazdelis;Saulutės;2854642875;Taip;0;0;6;6
11005;Strazdelis;Saulutės;7578229276;Taip;0;1;0;1
11006;Strazdelis;Saulutės;6614184499;Taip;0;2;0;2
11007;Strazdelis;Saulutės;4129957131;Taip;6;2;0;8
11008;Strazdelis;Saulutės;3425430317;Taip;0;8;0;8
11009;Strazdelis;Saulutės;7081517417;Taip;3;5;0;8
11010;Strazdelis;Saulutės;67641340859;Taip;2;2;0;4
11011;Strazdelis;Saulutės;15298412755;Ne;12;1;0;13
11012;Strazdelis;Saulutės;1802092125;Taip;0;1;0;1
11013;Strazdelis;Saulutės;1391009140;Taip;8;2;0;10
11014;Strazdelis;Saulutės;6779352728;Taip;0;1;0;1
11015;Strazdelis;Saulutės;12713270671;Taip;2;0;0;2
11016;Strazdelis;Saulutės;1886601605;Taip;0;0;6;6
11017;Strazdelis;Saulutės;6113491562;Taip;1;0;0;1
11018;Strazdelis;Saulutės;8808299050;Taip;0;1;0;1
11019;Strazdelis;Saulutės;1693309238;Taip;0;7;0;7
11020;Strazdelis;Bitutės;99973904527;Taip;0;1;0;1
11021;Strazdelis;Bitutės;1111310766;Taip;0;1;0;1
11022;Strazdelis;Bitutės;24669852216;Taip;0;3;0;3
11023;Strazdelis;Bitutės;51702469375;Taip;10;0;0;10
11024;Strazdelis;Bitutės;59837435595;Ne;0;14;0;14
11025;Strazdelis;Bitutės;90089166514;Taip;11;2;0;13
11026;Strazdelis;Bitutės;1847755442;Taip;0;2;0;2
11027;Strazdelis;Bitutės;61820727992;Taip;0;3;0;3
11028;Strazdelis;Bitutės;7812253305;Taip;8;3;0;11
11029;Strazdelis;Bitutės;1140100663;Taip;6;1;0;7
11030;Strazdelis;Bitutės;60128913543;Taip;5;0;0;5
11031;Strazdelis;Bitutės;2090154632;Taip;0;7;0;7
11032;Strazdelis;Bitutės;76361365558;Ne;5;6;0;11
11033;Strazdelis;Bitutės;1735868807;Taip;0;3;0;3
11034;Strazdelis;Bitutės;2350690409;Taip;0;1;0;1
11035;Strazdelis;Bitutės;29225108934;Taip;0;2;0;2
11036;Strazdelis;Bitutės;68605763183;Taip;7;6;0;13
11037;Strazdelis;Bitutės;1785962711;Taip;3;6;0;9
11038;Strazdelis;Mažylių;8753316532;Taip;17;0;1;18
11039;Strazdelis;Mažylių;2081538505;Taip;6;0;6;12
11040;Strazdelis;Mažylių;3043580835;Taip;9;0;0;9
11041;Strazdelis;Mažylių;4369569609;Taip;0;0;4;4
11042;Strazdelis;Mažylių;1005082012;Ne;0;2;1;3
11043;Strazdelis;Mažylių;5232064496;Taip;15;1;0;16
11044;Strazdelis;Mažylių;4784401449;Ne;0;2;1;3
11045;Strazdelis;Mažylių;4020547762;Taip;0;2;2;4
11046;Strazdelis;Mažylių;9435593972;Ne;0;1;0;1
11047;Strazdelis;Mažylių;8485509145;Taip;0;8;0;8
11048;Strazdelis;Mažylių;1539984888;Taip;0;2;0;2
11049;Strazdelis;Mažylių;4400849922;Taip;0;2;0;2
11050;Strazdelis;Mažylių;9555240419;Taip;8;0;0;8
11051;Strazdelis;Mažylių;6508933324;Taip;0;0;1;1
11052;Strazdelis;Pabiručių;7913526787;Taip;14;0;0;14
11053;Strazdelis;Pabiručių;8277333786;Taip;6;0;0;6
11054;Strazdelis;Pabiručių;8686828982;Taip;18;0;0;18
11055;Strazdelis;Pabiručių;7768700192;Taip;8;0;0;8
11056;Strazdelis;Pabiručių;8581533423;Taip;17;0;0;17
11057;Strazdelis;Pabiručių;8111541739;Taip;4;1;0;5
11058;Strazdelis;Pabiručių;1194918926;Taip;0;9;0;9
11059;Strazdelis;Pabiručių;9933042249;Taip;9;5;0;14
11060;Strazdelis;Pabiručių;1141752802;Taip;4;0;4;8
11061;Strazdelis;Pabiručių;2753635198;Taip;0;1;0;1
11062;Strazdelis;Pabiručių;9567476872;Ne;21;0;0;21
11063;Strazdelis;Pabiručių;1683900907;Taip;16;0;0;16
11064;Strazdelis;Pabiručių;5346485534;Taip;1;2;0;3
11065;Strazdelis;Pabiručių;8209625399;Taip;12;2;0;14
11066;Strazdelis;Pabiručių;6651360492;Taip;11;3;0;14
11067;Šermukšnėlė;MOLINUKAI;68060386099;Taip;0;1;0;1
11068;Šermukšnėlė;MOLINUKAI;42211665091;Taip;0;0;1;1
11069;Šermukšnėlė;MOLINUKAI;61809452162;Taip;10;1;0;11
11070;Šermukšnėlė;MOLINUKAI;60863269031;Taip;0;2;0;2
11071;Šermukšnėlė;MOLINUKAI;39534021804;Taip;0;1;0;1
11072;Šermukšnėlė;MOLINUKAI;54312555311;Taip;0;0;3;3
11073;Šermukšnėlė;MOLINUKAI;3873114056;Taip;0;1;0;1
11074;Šermukšnėlė;MOLINUKAI;1561527473;Taip;1;0;0;1
11075;Šermukšnėlė;MOLINUKAI;841268127;Ne;5;0;0;5
11076;Šermukšnėlė;MOLINUKAI;83487643143;Taip;8;0;0;8
11077;Šermukšnėlė;MOLINUKAI;2012112541;Taip;0;7;3;10
11078;Šermukšnėlė;MOLINUKAI;1411650732;Ne;11;0;0;11
11079;Šermukšnėlė;MOLINUKAI;7830792252;Taip;0;0;1;1
11080;Šermukšnėlė;MOLINUKAI;8333291496;Ne;0;0;6;6
11081;Šermukšnėlė;MOLINUKAI;1756161106;Taip;5;0;0;5
11082;Šermukšnėlė;MOLINUKAI;1105249315;Ne;21;0;0;21
11083;Šermukšnėlė;MOLINUKAI;1543336828;Ne;5;0;2;7
11084;Šermukšnėlė;MOLINUKAI;2050855662;Ne;7;0;0;7
11085;Šermukšnėlė;MOLINUKAI;2561033248;Taip;4;4;0;8
11086;Šermukšnėlė;ŠIAUDINUKAI;85959255744;Taip;0;1;0;1
11087;Šermukšnėlė;ŠIAUDINUKAI;95999386401;Taip;0;1;0;1
11088;Šermukšnėlė;ŠIAUDINUKAI;2734502079;Taip;0;0;2;2
11089;Šermukšnėlė;ŠIAUDINUKAI;16859553972;Taip;0;6;0;6
11090;Šermukšnėlė;ŠIAUDINUKAI;99444734331;Taip;0;0;1;1
11091;Šermukšnėlė;ŠIAUDINUKAI;3851927973;Taip;0;1;6;7
11092;Šermukšnėlė;ŠIAUDINUKAI;87587621833;Taip;16;0;0;16
11093;Šermukšnėlė;ŠIAUDINUKAI;1738008915;Taip;0;1;1;2
11094;Šermukšnėlė;ŠIAUDINUKAI;28087351377;Taip;0;1;0;1
11095;Šermukšnėlė;ŠIAUDINUKAI;28007013244;Taip;0;1;0;1
11096;Šermukšnėlė;ŠIAUDINUKAI;87315703379;Taip;0;2;0;2
11097;Šermukšnėlė;ŠIAUDINUKAI;77238595800;Taip;0;0;1;1
11098;Šermukšnėlė;ŠIAUDINUKAI;82928987881;Taip;0;0;4;4
11099;Šermukšnėlė;ŠIAUDINUKAI;1189930137;Taip;9;0;0;9
11100;Šermukšnėlė;ŠIAUDINUKAI;1367964100;Taip;5;6;0;11
11101;Šermukšnėlė;ŠIAUDINUKAI;2100740973;Taip;3;1;0;4
11102;Šermukšnėlė;ŠIAUDINUKAI;63858537394;Taip;0;1;0;1
11103;Šermukšnėlė;TOŠINUKAI;1290319484;Taip;0;9;0;9
11104;Šermukšnėlė;TOŠINUKAI;1636627303;Ne;0;1;1;2
11105;Šermukšnėlė;TOŠINUKAI;1846720859;Taip;0;1;0;1
11106;Šermukšnėlė;TOŠINUKAI;51058072005;Taip;0;3;0;3
11107;Šermukšnėlė;TOŠINUKAI;1559325175;Taip;7;5;0;12
11108;Šermukšnėlė;TOŠINUKAI;1755108527;Taip;4;0;1;5
11109;Šermukšnėlė;TOŠINUKAI;2137141949;Taip;4;1;0;5
11110;Šermukšnėlė;TOŠINUKAI;1858862320;Taip;0;12;0;12
11111;Šermukšnėlė;TOŠINUKAI;42127117636;Taip;1;1;0;2
11112;Šermukšnėlė;TOŠINUKAI;85018940292;Ne;6;0;4;10
11113;Šermukšnėlė;TOŠINUKAI;92414041480;Taip;0;1;4;5
11114;Šermukšnėlė;TOŠINUKAI;288807384;Taip;0;1;0;1
11115;Šermukšnėlė;TOŠINUKAI;1138272220;Ne;5;1;0;6
11116;Šermukšnėlė;TOŠINUKAI;1112022308;Taip;11;0;1;12
11117;Šermukšnėlė;TOŠINUKAI;83448986084;Taip;1;6;0;7
11118;Šermukšnėlė;TOŠINUKAI;2840045901;Ne;14;0;0;14
11119;Šermukšnėlė;ODINUKAI;5545018656;Taip;13;0;2;15
11120;Šermukšnėlė;ODINUKAI;2176788727;Taip;8;0;0;8
11121;Šermukšnėlė;ODINUKAI;3148857617;Taip;9;6;0;15
11122;Šermukšnėlė;ODINUKAI;5575518612;Taip;2;0;0;2
11123;Šermukšnėlė;ODINUKAI;3322053946;Taip;3;9;0;12
11124;Šermukšnėlė;ODINUKAI;5733540837;Taip;10;1;0;11
11125;Šermukšnėlė;ODINUKAI;7262199284;Taip;3;5;0;8
11126;Šermukšnėlė;ODINUKAI;5159461963;Taip;8;3;0;11
11127;Šermukšnėlė;ODINUKAI;5354978646;Taip;15;0;1;16
11128;Šermukšnėlė;ODINUKAI;1882432812;Taip;20;0;0;20
11129;Šermukšnėlė;ODINUKAI;5151843494;Taip;2;0;2;4
11130;Šermukšnėlė;ODINUKAI;5242187638;Ne;11;0;0;11
11131;Šermukšnėlė;ODINUKAI;1148559284;Taip;4;0;8;12
11132;Šermukšnėlė;ODINUKAI;3949629658;Taip;11;0;2;13
11133;Šermukšnėlė;ODINUKAI;4201283154;Ne;3;0;1;4
11134;Šermukšnėlė;ODINUKAI;6105915822;Taip;5;0;0;5
11135;Šermukšnėlė;ODINUKAI;9742208172;Taip;10;1;0;11
11136;Šermukšnėlė;ODINUKAI;7667114310;Taip;2;0;0;2
11137;Šermukšnėlė;ODINUKAI;7245206247;Taip;6;0;0;6
11138;Šermukšnėlė;ODINUKAI;5397385093;Taip;0;0;2;2
11139;Šermukšnėlė;KRIAUKLELĖS;8123096990;Taip;0;5;0;5
11140;Šermukšnėlė;KRIAUKLELĖS;1492328724;Taip;6;0;0;6
11141;Šermukšnėlė;KRIAUKLELĖS;8511421692;Taip;0;0;4;4
11142;Šermukšnėlė;KRIAUKLELĖS;3639954786;Taip;10;0;1;11
11143;Šermukšnėlė;KRIAUKLELĖS;5757405893;Taip;0;0;1;1
11144;Šermukšnėlė;KRIAUKLELĖS;1902848560;Taip;0;4;0;4
11145;Šermukšnėlė;KRIAUKLELĖS;8407947566;Ne;21;0;0;21
11146;Šermukšnėlė;KRIAUKLELĖS;7843128263;Ne;11;0;0;11
11147;Šermukšnėlė;KRIAUKLELĖS;8859731179;Taip;8;0;1;9
11148;Šermukšnėlė;KRIAUKLELĖS;3513568460;Taip;0;0;5;5
11149;Šermukšnėlė;KRIAUKLELĖS;6067298318;Taip;13;0;0;13
11150;Šermukšnėlė;KRIAUKLELĖS;4230698872;Taip;6;1;0;7
11151;Šermukšnėlė;KRIAUKLELĖS;5159105661;Taip;15;0;0;15
11152;Šermukšnėlė;KRIAUKLELĖS;5660238634;Taip;13;0;0;13
11153;Šermukšnėlė;KRIAUKLELĖS;4569484117;Taip;7;3;0;10
11154;Šermukšnėlė;KRIAUKLELĖS;8064473083;Taip;0;0;1;1
11155;Šermukšnėlė;KRIAUKLELĖS;2837099502;Taip;0;1;6;7
11156;Šermukšnėlė;KRIAUKLELĖS;7548637091;Ne;18;0;0;18
11157;Šermukšnėlė;VYTINUKAI;97906920174;Ne;5;0;1;6
11158;Šermukšnėlė;VYTINUKAI;1523361932;Taip;0;3;0;3
11159;Šermukšnėlė;VYTINUKAI;8531953934;Ne;0;1;2;3
11160;Šermukšnėlė;VYTINUKAI;25189813939;Taip;12;0;0;12
11161;Šermukšnėlė;VYTINUKAI;83123267733;Taip;0;3;0;3
11162;Šermukšnėlė;VYTINUKAI;20028832329;Taip;0;1;0;1
11163;Šermukšnėlė;VYTINUKAI;3959795064;Taip;7;0;0;7
11164;Šermukšnėlė;VYTINUKAI;8498288021;Taip;5;1;0;6
11165;Šermukšnėlė;VYTINUKAI;3751769136;Taip;0;1;0;1
11166;Šermukšnėlė;VYTINUKAI;5905000902;Taip;5;0;0;5
11167;Šermukšnėlė;VYTINUKAI;1244964311;Ne;4;0;0;4
11168;Šermukšnėlė;VYTINUKAI;83882579952;Taip;0;8;0;8
11169;Šermukšnėlė;VYTINUKAI;60840526220;Taip;0;1;0;1
11170;Šermukšnėlė;VYTINUKAI;1025787925;Taip;0;1;0;1
11171;Šermukšnėlė;VYTINUKAI;1519623099;Taip;8;0;0;8
11172;Šermukšnėlė;VYTINUKAI;7106405983;Ne;5;0;1;6
11173;Šermukšnėlė;VYTINUKAI;9654198217;Ne;5;0;0;5
11174;Šermukšnėlė;VYTINUKAI;1670047548;Taip;19;0;0;19
11175;Šermukšnėlė;GINTARĖLIAI;3147809450;Taip;5;0;0;5
11176;Šermukšnėlė;GINTARĖLIAI;1167696952;Taip;10;1;1;12
11177;Šermukšnėlė;GINTARĖLIAI;85062380771;Taip;4;0;5;9
11178;Šermukšnėlė;GINTARĖLIAI;35389950541;Taip;0;1;1;2
11179;Šermukšnėlė;GINTARĖLIAI;82240400954;Taip;0;0;1;1
11180;Šermukšnėlė;GINTARĖLIAI;1944687724;Taip;0;1;0;1
11181;Šermukšnėlė;GINTARĖLIAI;1013698297;Taip;16;0;0;16
11182;Šermukšnėlė;GINTARĖLIAI;1521544270;Taip;11;0;0;11
11183;Šermukšnėlė;GINTARĖLIAI;3697936074;Taip;21;0;0;21
11184;Šermukšnėlė;GINTARĖLIAI;2686950289;Ne;0;1;0;1
11185;Šermukšnėlė;GINTARĖLIAI;27183547828;Ne;0;0;5;5
11186;Šermukšnėlė;GINTARĖLIAI;10728235594;Ne;7;0;3;10
11187;Šermukšnėlė;GINTARĖLIAI;42477406335;Taip;6;10;0;16
11188;Šermukšnėlė;GINTARĖLIAI;1425285365;Taip;0;1;2;3
11189;Šermukšnėlė;GINTARĖLIAI;6279210465;Taip;5;0;3;8
11190;Šermukšnėlė;GINTARĖLIAI;4601810772;Taip;0;11;0;11
11191;Šermukšnėlė;GINTARĖLIAI;1562494176;Taip;0;0;4;4
11192;Šermukšnėlė;AKMENUKAI;95089450234;Ne;3;0;2;5
11193;Šermukšnėlė;AKMENUKAI;80199267729;Taip;7;0;0;7
11194;Šermukšnėlė;AKMENUKAI;27139089487;Taip;4;5;0;9
11195;Šermukšnėlė;AKMENUKAI;42520543068;Taip;5;1;1;7
11196;Šermukšnėlė;AKMENUKAI;76682206033;Taip;6;3;0;9
11197;Šermukšnėlė;AKMENUKAI;42192131599;Taip;0;3;0;3
11198;Šermukšnėlė;AKMENUKAI;1316118025;Taip;0;1;0;1
11199;Šermukšnėlė;AKMENUKAI;3628734426;Taip;16;0;0;16
11200;Šermukšnėlė;AKMENUKAI;82161996761;Taip;15;1;0;16
11201;Šermukšnėlė;AKMENUKAI;98850511500;Taip;0;1;0;1
11202;Šermukšnėlė;AKMENUKAI;48653098796;Taip;0;1;0;1
11203;Šermukšnėlė;AKMENUKAI;26775257484;Taip;11;3;0;14
11204;Šermukšnėlė;AKMENUKAI;82028252228;Taip;7;0;1;8
11205;Šermukšnėlė;AKMENUKAI;23434568160;Taip;0;3;0;3
11206;Šermukšnėlė;AKMENUKAI;3543061360;Taip;0;10;0;10
11207;Šermukšnėlė;AKMENUKAI;80349025945;Taip;17;0;2;19
11208;Šermukšnėlė;AKMENUKAI;6255671190;Taip;8;0;2;10
11209;Šermukšnėlė;AKMENUKAI;7564745299;Taip;0;10;0;10
11210;Šermukšnėlė;AKMENUKAI;9617044855;Ne;6;4;0;10
11211;Šermukšnėlė;AKMENUKAI;1856012121;Taip;12;0;0;12
11212;Šermukšnėlė;SIŪLINUKAI;32417473492;Taip;0;3;0;3
11213;Šermukšnėlė;SIŪLINUKAI;35508499818;Taip;0;3;0;3
11214;Šermukšnėlė;SIŪLINUKAI;1054907277;Ne;0;0;1;1
11215;Šermukšnėlė;SIŪLINUKAI;30853722796;Taip;0;1;1;2
11216;Šermukšnėlė;SIŪLINUKAI;41661711151;Taip;4;0;0;4
11217;Šermukšnėlė;SIŪLINUKAI;62420710883;Taip;4;1;0;5
11218;Šermukšnėlė;SIŪLINUKAI;87646529363;Taip;0;1;0;1
11219;Šermukšnėlė;SIŪLINUKAI;25663713043;Taip;0;2;0;2
11220;Šermukšnėlė;SIŪLINUKAI;57211490716;Taip;0;1;0;1
11221;Šermukšnėlė;SIŪLINUKAI;88123535614;Taip;0;1;0;1
11222;Šermukšnėlė;SIŪLINUKAI;20160146304;Taip;5;1;0;6
11223;Šermukšnėlė;SIŪLINUKAI;1330471614;Taip;0;1;0;1
11224;Šermukšnėlė;SIŪLINUKAI;1127786451;Taip;1;1;0;2
11225;Šermukšnėlė;SIŪLINUKAI;18799838453;Taip;0;1;0;1
11226;Šermukšnėlė;SIŪLINUKAI;1891818706;Taip;0;0;1;1
11227;Šermukšnėlė;SIŪLINUKAI;78916223877;Taip;5;0;0;5
11228;Šermukšnėlė;SIŪLINUKAI;45632551657;Ne;0;1;0;1
11229;Šermukšnėlė;SIŪLINUKAI;7766292005;Taip;0;1;0;1
11230;Šermukšnėlė;MEDINUKAi;2380988728;Ne;7;0;0;7
11231;Šermukšnėlė;MEDINUKAi;2529526401;Taip;0;1;2;3
11232;Šermukšnėlė;MEDINUKAi;1753169856;Taip;3;0;0;3
11233;Šermukšnėlė;MEDINUKAi;8956573129;Taip;7;8;0;15
11234;Šermukšnėlė;MEDINUKAi;3222466449;Taip;7;0;0;7
11235;Šermukšnėlė;MEDINUKAi;5096946133;Taip;0;3;0;3
11236;Šermukšnėlė;MEDINUKAi;8279692394;Taip;0;1;0;1
11237;Šermukšnėlė;MEDINUKAi;1459253197;Taip;5;0;0;5
11238;Šermukšnėlė;MEDINUKAi;2160616078;Taip;5;0;0;5
11239;Šermukšnėlė;MEDINUKAi;78341448188;Taip;10;1;2;13
11240;Šermukšnėlė;MEDINUKAi;1661977128;Ne;0;0;6;6
11241;Šermukšnėlė;MEDINUKAi;6430627501;Taip;3;0;0;3
11242;Šermukšnėlė;MEDINUKAi;5832072195;Taip;11;7;0;18
11243;Šermukšnėlė;MEDINUKAi;9035625467;Taip;7;3;0;10
11244;Šermukšnėlė;MEDINUKAi;7038705221;Taip;3;0;0;3
11245;Šermukšnėlė;MEDINUKAi;3081548524;Ne;3;1;0;4
11246;Šermukšnėlė;MEDINUKAi;5140264695;Ne;9;2;0;11
11247;Šermukšnėlė;MEDINUKAi;3994316729;Taip;7;0;0;7
11248;Šermukšnėlė;MEDINUKAi;6413821285;Taip;19;0;0;19
11249;Šermukšnėlė;MEDINUKAi;4981204674;Taip;0;8;0;8
11250;Šermukšnėlė;SKUDURINUKAI;6351841889;Taip;16;0;0;16
11251;Šermukšnėlė;SKUDURINUKAI;2989011150;Taip;5;1;1;7
11252;Šermukšnėlė;SKUDURINUKAI;5069572637;Taip;1;1;0;2
11253;Šermukšnėlė;SKUDURINUKAI;1636944853;Taip;17;0;0;17
11254;Šermukšnėlė;SKUDURINUKAI;3747531232;Taip;11;0;0;11
11255;Šermukšnėlė;SKUDURINUKAI;1994737857;Taip;5;2;0;7
11256;Šermukšnėlė;SKUDURINUKAI;4619811264;Taip;5;1;0;6
11257;Šermukšnėlė;SKUDURINUKAI;4805637096;Taip;10;0;1;11
11258;Šermukšnėlė;SKUDURINUKAI;6249700552;Taip;10;0;1;11
11259;Šermukšnėlė;SKUDURINUKAI;4783726095;Taip;10;2;0;12
11260;Šermukšnėlė;SKUDURINUKAI;9714566919;Taip;5;1;0;6
11261;Šermukšnėlė;SKUDURINUKAI;6194188831;Taip;5;0;0;5
11262;Šermukšnėlė;SKUDURINUKAI;1437314920;Taip;5;1;0;6
11263;Šermukšnėlė;SKUDURINUKAI;7305013368;Taip;0;1;0;1
11264;Šermukšnėlė;PAGRANDUKAI;2447547509;Taip;6;0;4;10
11265;Šermukšnėlė;PAGRANDUKAI;9876533442;Taip;4;0;0;4
11266;Šermukšnėlė;PAGRANDUKAI;3613456202;Taip;0;0;1;1
11267;Šermukšnėlė;PAGRANDUKAI;8709426669;Taip;7;4;0;11
11268;Šermukšnėlė;PAGRANDUKAI;3170388518;Ne;8;1;0;9
11269;Šermukšnėlė;PAGRANDUKAI;6585484701;Ne;10;0;1;11
11270;Šermukšnėlė;PAGRANDUKAI;3653792683;Taip;0;2;6;8
11271;Šermukšnėlė;PAGRANDUKAI;9783673534;Taip;3;0;0;3
11272;Šermukšnėlė;PAGRANDUKAI;6599779539;Taip;5;5;0;10
11273;Šermukšnėlė;PAGRANDUKAI;8541743148;Taip;8;0;0;8
11274;Šypsena;NYKŠTUKAI;3809171499;Taip;0;0;3;3
11275;Šypsena;NYKŠTUKAI;1114341518;Taip;5;0;1;6
11276;Šypsena;NYKŠTUKAI;1558614852;Taip;10;0;2;12
11277;Šypsena;NYKŠTUKAI;1897176871;Taip;0;0;2;2
11278;Šypsena;NYKŠTUKAI;8715718525;Taip;0;5;2;7
11279;Šypsena;NYKŠTUKAI;2312828770;Taip;5;0;2;7
11280;Šypsena;NYKŠTUKAI;1181590127;Taip;6;11;1;18
11281;Šypsena;NYKŠTUKAI;4808041625;Taip;10;0;0;10
11282;Šypsena;NYKŠTUKAI;1422418997;Taip;5;1;0;6
11283;Šypsena;NYKŠTUKAI;5834057370;Taip;0;6;0;6
11284;Šypsena;NYKŠTUKAI;1515803985;Ne;0;4;0;4
11285;Šypsena;NYKŠTUKAI;5928432220;Taip;1;5;3;9
11286;Šypsena;NYKŠTUKAI;5504570516;Taip;0;0;2;2
11287;Šypsena;NYKŠTUKAI;1063834589;Taip;15;0;0;15
11288;Šypsena;NYKŠTUKAI;2798819321;Taip;0;3;0;3
11289;Šypsena;NYKŠTUKAI;4038279267;Taip;10;1;1;12
11290;Šypsena;NYKŠTUKAI;8950694484;Taip;5;0;2;7
11291;Šypsena;NYKŠTUKAI;4344780723;Taip;10;0;0;10
11292;Šypsena;NYKŠTUKAI;1893123775;Taip;7;1;0;8
11293;Šypsena;NYKŠTUKAI;6237208661;Taip;5;0;2;7
11294;Šypsena;NYKŠTUKAI;3506046076;Ne;3;1;4;8
11295;Šypsena;NYKŠTUKAI;7519967594;Taip;21;0;0;21
11296;Šypsena;SPINDULIUKAI;5568502083;Ne;10;0;0;10
11297;Šypsena;SPINDULIUKAI;1795366502;Taip;0;0;9;9
11298;Šypsena;SPINDULIUKAI;2706678026;Ne;11;0;0;11
11299;Šypsena;SPINDULIUKAI;3063226692;Ne;10;0;2;12
11300;Šypsena;SPINDULIUKAI;4766170132;Ne;0;2;0;2
11301;Šypsena;SPINDULIUKAI;4936775366;Taip;11;0;1;12
11302;Šypsena;SPINDULIUKAI;7569495879;Taip;0;6;0;6
11303;Šypsena;SPINDULIUKAI;2248628927;Taip;4;5;0;9
11304;Šypsena;SPINDULIUKAI;2995753269;Taip;0;0;4;4
11305;Šypsena;SPINDULIUKAI;4635232236;Taip;0;1;1;2
11306;Šypsena;SPINDULIUKAI;1796837022;Taip;10;0;2;12
11307;Šypsena;SPINDULIUKAI;6590285866;Taip;0;0;4;4
11308;Šypsena;SPINDULIUKAI;1343249939;Taip;0;0;2;2
11309;Šypsena;SPINDULIUKAI;5985974927;Taip;0;3;0;3
11310;Šypsena;SPINDULIUKAI;1387130727;Taip;10;0;0;10
11311;Šypsena;SPINDULIUKAI;3025437080;Taip;0;6;0;6
11312;Šypsena;SPINDULIUKAI;1669768648;Ne;19;0;0;19
11313;Šypsena;SPINDULIUKAI;1575413188;Taip;0;9;0;9
11314;Šypsena;SPINDULIUKAI;2005543016;Ne;0;0;2;2
11315;Šypsena;SKRUZDELIUKAI;5642959574;Ne;5;5;0;10
11316;Šypsena;SKRUZDELIUKAI;7538681006;Taip;10;0;0;10
11317;Šypsena;SKRUZDELIUKAI;1967590536;Taip;0;0;21;21
11318;Šypsena;SKRUZDELIUKAI;1659390234;Ne;0;3;0;3
11319;Šypsena;SKRUZDELIUKAI;1272973534;Ne;12;0;0;12
11320;Šypsena;SKRUZDELIUKAI;1917246860;Ne;0;9;0;9
11321;Šypsena;SKRUZDELIUKAI;46569341613;Ne;10;0;0;10
11322;Šypsena;SKRUZDELIUKAI;42130115068;Taip;0;16;0;16
11323;Šypsena;SKRUZDELIUKAI;6444616846;Taip;0;5;0;5
11324;Šypsena;SKRUZDELIUKAI;1712017606;Ne;0;1;0;1
11325;Šypsena;SKRUZDELIUKAI;3541189470;Ne;0;3;0;3
11326;Šypsena;SKRUZDELIUKAI;1996746426;Taip;10;1;0;11
11327;Šypsena;SKRUZDELIUKAI;4017777389;Taip;5;0;1;6
11328;Šypsena;SKRUZDELIUKAI;70188972463;Taip;6;0;1;7
11329;Šypsena;SKRUZDELIUKAI;76332370575;Taip;0;0;3;3
11330;Šypsena;SKRUZDELIUKAI;1906529989;Taip;10;1;0;11
11331;Šypsena;SKRUZDELIUKAI;2099216049;Taip;7;1;0;8
11332;Šypsena;SKRUZDELIUKAI;89503728819;Ne;0;5;0;5
11333;Šypsena;SKRUZDELIUKAI;8197460768;Taip;0;3;0;3
11334;Šypsena;SKRUZDELIUKAI;1133113196;Ne;2;0;0;2
11335;Šypsena;Bitutės;1702152247;Taip;0;1;0;1
11336;Šypsena;Bitutės;5971488796;Taip;6;4;0;10
11337;Šypsena;Bitutės;5680397153;Taip;0;4;0;4
11338;Šypsena;Bitutės;25175991441;Taip;0;1;1;2
11339;Šypsena;Bitutės;2117865969;Taip;3;5;0;8
11340;Šypsena;Bitutės;1329170686;Taip;0;3;0;3
11341;Šypsena;Bitutės;1369664461;Ne;3;0;0;3
11342;Šypsena;Bitutės;2368339278;Taip;0;1;0;1
11343;Šypsena;Bitutės;91846404526;Ne;0;4;0;4
11344;Šypsena;Bitutės;84526597847;Taip;6;5;0;11
11345;Šypsena;Bitutės;39296351965;Taip;0;4;0;4
11346;Šypsena;Bitutės;17041968817;Taip;0;1;0;1
11347;Šypsena;Bitutės;1972212253;Taip;0;6;0;6
11348;Šypsena;Bitutės;79177095462;Taip;13;0;0;13
11349;Šypsena;Bitutės;39495782526;Taip;5;3;0;8
11350;Šypsena;MEŠKIUKAI;7877396588;Taip;15;0;0;15
11351;Šypsena;MEŠKIUKAI;1287205292;Taip;17;0;0;17
11352;Šypsena;MEŠKIUKAI;1431850136;Taip;20;0;0;20
11353;Šypsena;MEŠKIUKAI;1324902555;Taip;10;0;1;11
11354;Šypsena;MEŠKIUKAI;7946379086;Taip;15;0;0;15
11355;Šypsena;MEŠKIUKAI;5611440056;Ne;0;1;0;1
11356;Šypsena;MEŠKIUKAI;7160466766;Taip;0;0;11;11
11357;Šypsena;MEŠKIUKAI;3823623458;Ne;3;0;0;3
11358;Šypsena;MEŠKIUKAI;4695547847;Taip;10;0;0;10
11359;Šypsena;MEŠKIUKAI;6713182218;Taip;20;0;0;20
11360;Šypsena;MEŠKIUKAI;7537442618;Taip;0;1;0;1
11361;Šypsena;MEŠKIUKAI;3968514430;Taip;0;7;0;7
11362;Šypsena;MEŠKIUKAI;6716558946;Taip;21;0;0;21
11363;Šypsena;BORUŽĖLĖS;8215278033;Taip;10;5;1;16
11364;Šypsena;BORUŽĖLĖS;2372820133;Taip;11;0;2;13
11365;Šypsena;BORUŽĖLĖS;5879506651;Taip;11;0;0;11
11366;Šypsena;BORUŽĖLĖS;8164410749;Taip;12;0;1;13
11367;Šypsena;BORUŽĖLĖS;7898387398;Taip;17;0;0;17
11368;Šypsena;BORUŽĖLĖS;1623728091;Taip;12;0;0;12
11369;Šypsena;BORUŽĖLĖS;2584574423;Taip;10;0;1;11
11370;Šypsena;BORUŽĖLĖS;6951845385;Taip;6;0;1;7
11371;Šypsena;BORUŽĖLĖS;5906001927;Taip;0;0;6;6
11372;Šypsena;BORUŽĖLĖS;6229905007;Taip;0;6;0;6
11373;Šypsena;BORUŽĖLĖS;7120597034;Taip;10;2;0;12
11374;Šypsena;BORUŽĖLĖS;4520148322;Taip;10;0;0;10
11375;Šnekutis;DRUGELIŲ;70663269171;Taip;0;1;2;3
11376;Šnekutis;DRUGELIŲ;81648325534;Taip;0;1;1;2
11377;Šnekutis;DRUGELIŲ;2000728679;Taip;0;0;1;1
11378;Šnekutis;DRUGELIŲ;50017415248;Taip;0;0;1;1
11379;Šnekutis;DRUGELIŲ;1956224017;Taip;6;0;1;7
11380;Šnekutis;DRUGELIŲ;2049447215;Taip;2;0;1;3
11381;Šnekutis;DRUGELIŲ;1159232792;Taip;10;0;4;14
11382;Šnekutis;DRUGELIŲ;2092637040;Taip;5;0;2;7
11383;Šnekutis;DRUGELIŲ;94289379983;Taip;0;0;1;1
11384;Šnekutis;DRUGELIŲ;13209811505;Taip;0;0;21;21
11385;Šnekutis;DRUGELIŲ;1836892386;Taip;0;1;4;5
11386;Šnekutis;DRUGELIŲ;5962885680;Taip;0;0;1;1
11387;Šnekutis;DRUGELIŲ;4743885834;Taip;21;0;0;21
11388;Šnekutis;DRUGELIŲ;18354631454;Taip;0;0;2;2
11389;Šnekutis;DRUGELIŲ;5029631107;Taip;0;10;1;11
11390;Šnekutis;DRUGELIŲ;2102893949;Taip;0;0;1;1
11391;Šnekutis;Kačiukų;9601932777;Taip;10;8;0;18
11392;Šnekutis;Kačiukų;4302555600;Taip;10;8;0;18
11393;Šnekutis;Kačiukų;3281475303;Taip;0;1;0;1
11394;Šnekutis;Kačiukų;5052137859;Taip;0;0;1;1
11395;Šnekutis;Kačiukų;8531521901;Taip;17;0;0;17
11396;Šnekutis;Kačiukų;9670205249;Taip;7;1;0;8
11397;Šnekutis;Kačiukų;7615716438;Taip;6;0;0;6
11398;Šnekutis;Kačiukų;9780684867;Ne;17;0;0;17
11399;Šnekutis;Kačiukų;3271262071;Taip;16;0;0;16
11400;Šnekutis;Kačiukų;4405567649;Taip;0;11;0;11
11401;Šnekutis;Kačiukų;3166309530;Taip;0;1;2;3
11402;Šnekutis;Kačiukų;4143844589;Taip;15;0;0;15
11403;Šnekutis;Kačiukų;9312935803;Taip;0;6;1;7
11404;Šnekutis;Kačiukų;4992188525;Ne;11;1;1;13
11405;Šnekutis;Kačiukų;7638626055;Taip;5;0;0;5
11406;Šnekutis;Kačiukų;9896249776;Taip;5;0;5;10
11407;Šnekutis;Kačiukų;9157136735;Taip;9;9;0;18
11408;Šnekutis;Kačiukų;9790803767;Taip;7;4;0;11
11409;Šnekutis;Kačiukų;7434438142;Taip;0;8;0;8
11410;Šnekutis;Kačiukų;4920263429;Taip;6;12;0;18
11411;Šnekutis;Pėlėdžiukų;3068754741;Taip;4;1;0;5
11412;Šnekutis;Pėlėdžiukų;77534335117;Taip;5;0;5;10
11413;Šnekutis;Pėlėdžiukų;3312928478;Taip;0;1;0;1
11414;Šnekutis;Pėlėdžiukų;42697936562;Taip;15;0;0;15
11415;Šnekutis;Pėlėdžiukų;7507857415;Taip;9;0;3;12
11416;Šnekutis;Pėlėdžiukų;8866360301;Taip;4;0;3;7
11417;Šnekutis;Pėlėdžiukų;8745465796;Taip;0;13;8;21
11418;Šnekutis;Pėlėdžiukų;3170928052;Taip;10;0;1;11
11419;Šnekutis;Pėlėdžiukų;5321817615;Taip;6;0;1;7
11420;Šnekutis;Pėlėdžiukų;2233161242;Taip;4;0;0;4
11421;Šnekutis;Pėlėdžiukų;3578045341;Taip;7;1;0;8
11422;Šnekutis;Pėlėdžiukų;5117544317;Taip;0;0;2;2
11423;Šnekutis;Pėlėdžiukų;5615869149;Ne;0;4;0;4
11424;Šnekutis;Pėlėdžiukų;1329958641;Taip;0;0;3;3
11425;Šnekutis;Pėlėdžiukų;9511116249;Taip;5;0;0;5
11426;Šnekutis;Pėlėdžiukų;1369660223;Taip;0;0;2;2
11427;Šnekutis;Pėlėdžiukų;1682748852;Taip;0;1;0;1
11428;Šnekutis;Boružėlių;1818789769;Taip;5;1;0;6
11429;Šnekutis;Boružėlių;4557629310;Taip;16;2;0;18
11430;Šnekutis;Boružėlių;84241751923;Taip;0;0;1;1
11431;Šnekutis;Boružėlių;79174984189;Taip;0;0;5;5
11432;Šnekutis;Boružėlių;1249451765;Taip;0;13;0;13
11433;Šnekutis;Boružėlių;1936021189;Taip;0;1;2;3
11434;Šnekutis;Boružėlių;1985052072;Taip;5;0;2;7
11435;Šnekutis;Boružėlių;1738802158;Taip;0;7;0;7
11436;Šnekutis;Boružėlių;1744313172;Taip;8;1;1;10
11437;Šnekutis;Boružėlių;1620268693;Taip;5;0;2;7
11438;Šnekutis;Boružėlių;54532738133;Taip;21;0;0;21
11439;Šnekutis;Boružėlių;1370696345;Taip;0;1;0;1
11440;Šnekutis;Boružėlių;1881531513;Taip;0;3;1;4
11441;Šnekutis;Boružėlių;6828079735;Taip;0;1;0;1
11442;Šnekutis;Meškučių;4835202527;Taip;5;0;1;6
11443;Šnekutis;Meškučių;5597629090;Taip;0;1;0;1
11444;Šnekutis;Meškučių;8440160819;Taip;5;0;1;6
11445;Šnekutis;Meškučių;2144568225;Taip;2;0;1;3
11446;Šnekutis;Meškučių;9862362744;Taip;2;0;0;2
11447;Šnekutis;Meškučių;9326455786;Taip;7;0;0;7
11448;Šnekutis;Meškučių;6081100604;Taip;3;2;0;5
11449;Šnekutis;Meškučių;3344425033;Taip;5;7;0;12
11450;Šnekutis;Viščiukų;5906320006;Taip;16;0;0;16
11451;Šnekutis;Viščiukų;5519015388;Taip;10;1;1;12
11452;Šnekutis;Viščiukų;3628210526;Taip;12;0;0;12
11453;Šnekutis;Viščiukų;3889176018;Taip;4;0;3;7
11454;Šnekutis;Viščiukų;6544973632;Taip;0;6;0;6
11455;Šnekutis;Viščiukų;2843483435;Taip;15;1;1;17
11456;Šnekutis;Viščiukų;7344776758;Taip;0;0;2;2
11457;Šnekutis;Viščiukų;1504945841;Taip;13;2;0;15
11458;Šnekutis;Viščiukų;6405894763;Taip;0;3;0;3
11459;Šnekutis;Viščiukų;7089000987;Taip;7;0;0;7
11460;Šnekutis;Viščiukų;3644413861;Taip;0;1;0;1
11461;Šnekutis;Viščiukų;6578568418;Taip;2;0;5;7
11462;Šnekutis;Viščiukų;6749848086;Taip;12;1;0;13
11463;Šnekutis;Viščiukų;6146988521;Taip;2;7;0;9
11464;Užupiukas;VYTURĖLIŲ;2922487622;Ne;6;2;0;8
11465;Užupiukas;VYTURĖLIŲ;5116564840;Taip;3;2;0;5
11466;Užupiukas;VYTURĖLIŲ;3861173268;Taip;4;0;0;4
11467;Užupiukas;VYTURĖLIŲ;7443013255;Ne;0;0;2;2
11468;Užupiukas;VYTURĖLIŲ;3656400244;Taip;5;11;0;16
11469;Užupiukas;VYTURĖLIŲ;3829013911;Taip;0;0;8;8
11470;Užupiukas;VYTURĖLIŲ;9212428150;Taip;0;0;1;1
11471;Užupiukas;VYTURĖLIŲ;8549733697;Taip;12;0;0;12
11472;Užupiukas;VYTURĖLIŲ;8001099421;Ne;11;0;0;11
11473;Užupiukas;VYTURĖLIŲ;4198148927;Taip;18;0;0;18
11474;Užupiukas;VYTURĖLIŲ;4401569800;Taip;3;0;3;6
11475;Užupiukas;VYTURĖLIŲ;1391826582;Taip;13;0;0;13
11476;Užupiukas;VYTURĖLIŲ;5021163099;Taip;0;0;9;9
11477;Užupiukas;VYTURĖLIŲ;6699322898;Taip;21;0;0;21
11478;Užupiukas;VYTURĖLIŲ;8960813016;Ne;11;0;4;15
11479;Užupiukas;VYTURĖLIŲ;9132605734;Taip;16;0;0;16
11480;Užupiukas;VYTURĖLIŲ;8245876832;Taip;0;0;3;3
11481;Užupiukas;VYTURĖLIŲ;6406285034;Taip;0;0;3;3
11482;Užupiukas;VYTURĖLIŲ;8114761925;Taip;16;0;0;16
11483;Užupiukas;VYTURĖLIŲ;7532497390;Taip;4;0;4;8
11484;Užupiukas;VYTURĖLIŲ;5168946019;Taip;0;0;7;7
11485;Užupiukas;KAČIUKŲ;3224193396;Taip;4;0;0;4
11486;Užupiukas;KAČIUKŲ;3567963511;Taip;7;1;4;12
11487;Užupiukas;KAČIUKŲ;9991552624;Ne;0;1;2;3
11488;Užupiukas;KAČIUKŲ;3048959458;Taip;8;0;4;12
11489;Užupiukas;KAČIUKŲ;3080668107;Taip;7;1;0;8
11490;Užupiukas;KAČIUKŲ;1809036046;Taip;0;5;2;7
11491;Užupiukas;KAČIUKŲ;1102468034;Taip;0;1;0;1
11492;Užupiukas;KAČIUKŲ;4460047281;Ne;15;0;1;16
11493;Užupiukas;KAČIUKŲ;1464016943;Taip;0;1;1;2
11494;Užupiukas;KAČIUKŲ;4485435274;Taip;21;0;0;21
11495;Užupiukas;KAČIUKŲ;2931958829;Taip;10;1;1;12
11496;Užupiukas;KAČIUKŲ;1102293237;Taip;0;11;0;11
11497;Užupiukas;KAČIUKŲ;9386211193;Taip;0;1;2;3
11498;Užupiukas;KAČIUKŲ;7048114101;Taip;1;0;1;2
11499;Užupiukas;KAČIUKŲ;8510764089;Ne;3;0;3;6
11500;Užupiukas;KAČIUKŲ;1388346927;Taip;7;3;0;10
11501;Užupiukas;KAČIUKŲ;9333587467;Taip;5;2;0;7
11502;Užupiukas;KAČIUKŲ;7574528186;Ne;6;0;2;8
11503;Užupiukas;KAČIUKŲ;7092857844;Taip;5;1;1;7
11504;Užupiukas;DRUGELIŲ;3579499796;Taip;0;0;3;3
11505;Užupiukas;DRUGELIŲ;7140606152;Taip;11;0;2;13
11506;Užupiukas;DRUGELIŲ;5406866873;Taip;12;1;0;13
11507;Užupiukas;DRUGELIŲ;9655636851;Taip;0;6;2;8
11508;Užupiukas;DRUGELIŲ;1662564735;Taip;0;1;2;3
11509;Užupiukas;DRUGELIŲ;9863097416;Taip;5;0;1;6
11510;Užupiukas;DRUGELIŲ;7298322865;Taip;21;0;0;21
11511;Užupiukas;DRUGELIŲ;8734960045;Ne;12;0;2;14
11512;Užupiukas;DRUGELIŲ;8724566014;Taip;0;10;0;10
11513;Užupiukas;DRUGELIŲ;3298267311;Taip;11;0;0;11
11514;Užupiukas;DRUGELIŲ;8341598147;Taip;10;6;0;16
11515;Užupiukas;DRUGELIŲ;9782972949;Taip;7;0;0;7
11516;Užupiukas;DRUGELIŲ;2348243399;Taip;21;0;0;21
11517;Užupiukas;DRUGELIŲ;8870229834;Taip;5;6;0;11
11518;Užupiukas;DRUGELIŲ;1679324943;Taip;4;1;0;5
11519;Užupiukas;DRUGELIŲ;1772019951;Taip;11;0;0;11
11520;Užupiukas;DRUGELIŲ;9617597828;Taip;14;0;1;15
11521;Užupiukas;DRUGELIŲ;1554333137;Taip;8;0;0;8
11522;Užupiukas;DRUGELIŲ;14139543365;Ne;0;1;0;1
11523;Užupiukas;DRUGELIŲ;9096157655;Ne;10;0;0;10
11524;Užupiukas;DRUGELIŲ;3231001225;Taip;14;1;0;15
11525;Užupiukas;DRUGELIŲ;3958071677;Taip;17;0;0;17
11526;Užupiukas;EŽIUKŲ;1718518621;Taip;6;0;1;7
11527;Užupiukas;EŽIUKŲ;2724216446;Taip;0;0;3;3
11528;Užupiukas;EŽIUKŲ;9446562736;Taip;5;0;1;6
11529;Užupiukas;EŽIUKŲ;5072363435;Taip;4;0;2;6
11530;Užupiukas;EŽIUKŲ;1651249962;Taip;0;1;0;1
11531;Užupiukas;EŽIUKŲ;1100574872;Taip;15;2;0;17
11532;Užupiukas;EŽIUKŲ;6531734067;Ne;12;0;1;13
11533;Užupiukas;EŽIUKŲ;5204808398;Taip;13;0;0;13
11534;Užupiukas;EŽIUKŲ;3171528288;Taip;20;0;0;20
11535;Užupiukas;EŽIUKŲ;7860601571;Taip;11;0;1;12
11536;Užupiukas;EŽIUKŲ;3611922301;Taip;5;0;2;7
11537;Užupiukas;EŽIUKŲ;8020138690;Taip;12;0;0;12
11538;Užupiukas;EŽIUKŲ;1624805701;Taip;0;0;9;9
11539;Užupiukas;EŽIUKŲ;6823724962;Taip;5;8;0;13
11540;Užupiukas;EŽIUKŲ;5538327364;Taip;7;0;0;7
11541;Užupiukas;EŽIUKŲ;3057147440;Taip;10;0;1;11
11542;Užupiukas;EŽIUKŲ;3365726271;Taip;9;0;0;9
11543;Užupiukas;EŽIUKŲ;6370918943;Taip;0;0;1;1
11544;Užupiukas;EŽIUKŲ;9357101972;Taip;0;1;7;8
11545;Užupiukas;EŽIUKŲ;6512355340;Taip;0;0;1;1
11546;Užupiukas;BORUŽĖLIŲ;7861121290;Taip;0;0;2;2
11547;Užupiukas;BORUŽĖLIŲ;12787288319;Ne;5;0;0;5
11548;Užupiukas;BORUŽĖLIŲ;6526550727;Ne;11;0;1;12
11549;Užupiukas;BORUŽĖLIŲ;1582921323;Taip;2;0;0;2
11550;Užupiukas;BORUŽĖLIŲ;6828175620;Taip;0;12;0;12
11551;Užupiukas;BORUŽĖLIŲ;1503714343;Taip;0;1;1;2
11552;Užupiukas;BORUŽĖLIŲ;8313812681;Taip;4;0;3;7
11553;Užupiukas;BORUŽĖLIŲ;9906475253;Taip;11;0;6;17
11554;Užupiukas;BORUŽĖLIŲ;9677572224;Taip;8;0;0;8
11555;Užupiukas;BORUŽĖLIŲ;2445335267;Taip;1;1;0;2
11556;Užupiukas;BORUŽĖLIŲ;38066177076;Taip;0;8;0;8
11557;Užupiukas;BORUŽĖLIŲ;1514268763;Taip;0;1;0;1
11558;Užupiukas;BORUŽĖLIŲ;7555702944;Ne;0;0;7;7
11559;Užupiukas;BORUŽĖLIŲ;2307600884;Taip;0;1;1;2
11560;Užupiukas;BORUŽĖLIŲ;6073039842;Taip;0;0;8;8
11561;Užupiukas;BORUŽĖLIŲ;6601099182;Taip;0;0;21;21
11562;Užupiukas;BORUŽĖLIŲ;3940264504;Taip;4;0;0;4
11563;Užupiukas;SPINDULIUKŲ;25118968273;Taip;0;0;5;5
11564;Užupiukas;SPINDULIUKŲ;75976703580;Taip;4;0;0;4
11565;Užupiukas;SPINDULIUKŲ;37684526869;Taip;0;5;0;5
11566;Užupiukas;SPINDULIUKŲ;29207590902;Taip;0;6;0;6
11567;Užupiukas;SPINDULIUKŲ;67899352746;Taip;0;21;0;21
11568;Užupiukas;SPINDULIUKŲ;53974652901;Taip;0;1;0;1
11569;Užupiukas;SPINDULIUKŲ;39058613355;Taip;5;2;0;7
11570;Užupiukas;SPINDULIUKŲ;31338755810;Taip;7;2;0;9
11571;Užupiukas;SPINDULIUKŲ;12401560384;Ne;7;1;0;8
11572;Užupiukas;SPINDULIUKŲ;67408169039;Taip;0;4;0;4
11573;Užupiukas;SPINDULIUKŲ;91115810366;Taip;1;1;0;2
11574;Užupiukas;SPINDULIUKŲ;77255831055;Taip;0;1;0;1
11575;Užupiukas;SPINDULIUKŲ;78184067796;Taip;8;7;0;15
11576;Užupiukas;SPINDULIUKŲ;85492444123;Taip;0;1;0;1
11577;Užupiukas;SPINDULIUKŲ;61670878339;Taip;0;1;0;1
11578;Užupiukas;SPINDULIUKŲ;7060019183;Taip;0;1;2;3
11579;Užupiukas;SPINDULIUKŲ;39079421361;Taip;0;0;7;7
11580;Užupiukas;SPINDULIUKŲ;33629222941;Taip;0;1;0;1
11581;Užupiukas;SPINDULIUKŲ;51802714332;Taip;0;2;0;2
11582;Užupiukas;SPINDULIUKŲ;266671806;Ne;10;2;0;12
11583;Užupiukas;SPINDULIUKŲ;3613132636;Taip;0;0;4;4
11584;Užupiukas;ŽVIRBLIUKŲ;31668159620;Ne;0;1;4;5
11585;Užupiukas;ŽVIRBLIUKŲ;27226172373;Taip;0;1;4;5
11586;Užupiukas;ŽVIRBLIUKŲ;42772205412;Taip;2;0;0;2
11587;Užupiukas;ŽVIRBLIUKŲ;22839159539;Ne;0;1;0;1
11588;Užupiukas;ŽVIRBLIUKŲ;86504628397;Taip;0;1;0;1
11589;Užupiukas;ŽVIRBLIUKŲ;84367190618;Taip;0;1;0;1
11590;Užupiukas;ŽVIRBLIUKŲ;20407315;Taip;0;0;3;3
11591;Užupiukas;ŽVIRBLIUKŲ;68812682685;Taip;10;1;0;11
11592;Užupiukas;ŽVIRBLIUKŲ;74913928694;Taip;0;1;1;2
11593;Užupiukas;ŽVIRBLIUKŲ;31618737243;Taip;0;1;6;7
11594;Užupiukas;ŽVIRBLIUKŲ;30335529070;Taip;0;0;4;4
11595;Užupiukas;ŽVIRBLIUKŲ;9263601354;Taip;0;6;1;7
11596;Užupiukas;ŽVIRBLIUKŲ;97966482763;Taip;4;0;1;5
11597;Užupiukas;ŽVIRBLIUKŲ;12905151141;Taip;0;1;4;5
11598;Užupiukas;ŽVIRBLIUKŲ;7659981079;Taip;0;0;1;1
11599;Užupiukas;ŽVIRBLIUKŲ;61560152825;Taip;0;0;1;1
11600;Užupiukas;ŽVIRBLIUKŲ;19777635011;Taip;0;1;0;1
11601;Užupiukas;ŽVIRBLIUKŲ;1700750771;Taip;0;1;4;5
11602;Užupiukas;ŽVIRBLIUKŲ;32651983670;Taip;0;3;0;3
11603;Užupiukas;ŽVIRBLIUKŲ;42027395287;Taip;0;1;2;3
11604;Užupiukas;ŽVIRBLIUKŲ;1617969472;Taip;5;1;3;9
11605;Užupiukas;PELĖDŽIUKŲ;73657553075;Taip;15;1;0;16
11606;Užupiukas;PELĖDŽIUKŲ;12023740118;Taip;0;0;5;5
11607;Užupiukas;PELĖDŽIUKŲ;1102150432;Taip;0;1;9;10
11608;Užupiukas;PELĖDŽIUKŲ;1593878778;Taip;0;7;0;7
11609;Užupiukas;PELĖDŽIUKŲ;1338561168;Taip;8;0;0;8
11610;Užupiukas;PELĖDŽIUKŲ;9843068906;Ne;5;3;0;8
11611;Užupiukas;PELĖDŽIUKŲ;94857555708;Taip;15;1;2;18
11612;Užupiukas;PELĖDŽIUKŲ;7616817709;Taip;0;1;1;2
11613;Užupiukas;PELĖDŽIUKŲ;3785893846;Taip;4;0;0;4
11614;Užupiukas;PELĖDŽIUKŲ;1159892685;Taip;10;1;0;11
11615;Užupiukas;PELĖDŽIUKŲ;6442996343;Taip;0;1;0;1
11616;Užupiukas;PELĖDŽIUKŲ;30379165882;Taip;0;1;0;1
11617;Užupiukas;PELĖDŽIUKŲ;27438104059;Taip;0;0;4;4
11618;Užupiukas;PELĖDŽIUKŲ;1535952427;Taip;0;1;2;3
11619;Užupiukas;PELĖDŽIUKŲ;95981297986;Taip;16;0;4;20
11620;Užupiukas;PELĖDŽIUKŲ;2419842168;Taip;0;1;2;3
11621;Užupiukas;PELĖDŽIUKŲ;1891595719;Taip;0;1;0;1
11622;Užupiukas;PELĖDŽIUKŲ;98209952363;Taip;4;0;2;6
11623;Užupiukas;PELĖDŽIUKŲ;79908666651;Taip;0;1;2;3
11624;Užupiukas;PELĖDŽIUKŲ;2924954048;Taip;0;1;0;1
11625;Užupiukas;PELĖDŽIUKŲ;9483673859;Taip;0;1;1;2
11626;Užupiukas;PELĖDŽIUKŲ;64962686221;Taip;0;0;5;5
11627;Užupiukas;PELĖDŽIUKŲ;1256526274;Ne;0;1;2;3
11628;Užupiukas;PELĖDŽIUKŲ;31833883832;Taip;0;1;0;1
11629;Užupiukas;VARPELIŲ;6790700398;Taip;0;5;0;5
11630;Užupiukas;VARPELIŲ;23723147269;Taip;0;6;0;6
11631;Užupiukas;VARPELIŲ;7874627355;Taip;0;0;1;1
11632;Užupiukas;VARPELIŲ;51243697666;Taip;0;0;1;1
11633;Užupiukas;VARPELIŲ;17651645880;Taip;0;4;0;4
11634;Užupiukas;VARPELIŲ;98428714407;Taip;0;0;3;3
11635;Užupiukas;VARPELIŲ;57439594934;Taip;0;0;3;3
11636;Užupiukas;VARPELIŲ;5079596604;Taip;0;0;1;1
11637;Užupiukas;VARPELIŲ;1294561841;Taip;6;0;1;7
11638;Užupiukas;VARPELIŲ;2031306814;Ne;0;1;0;1
11639;Užupiukas;VARPELIŲ;79092366287;Taip;0;0;1;1
11640;Užupiukas;VARPELIŲ;6188599930;Taip;2;0;6;8
11641;Užupiukas;VARPELIŲ;8358242714;Taip;11;0;0;11
11642;Užupiukas;VARPELIŲ;82632886488;Taip;0;0;2;2
11643;Užupiukas;VARPELIŲ;1103878937;Taip;10;0;1;11
11644;Užupiukas;VARPELIŲ;81986379983;Taip;0;1;0;1
11645;Užupiukas;VARPELIŲ;77950386276;Taip;0;0;10;10
11646;Užupiukas;VARPELIŲ;1483072450;Taip;7;0;2;9
11647;Užupiukas;VARPELIŲ;48032538853;Ne;5;2;2;9
11648;Užupiukas;SAULUČIŲ;2574149268;Ne;0;1;4;5
11649;Užupiukas;SAULUČIŲ;10681040398;Taip;0;1;0;1
11650;Užupiukas;SAULUČIŲ;64774033504;Taip;11;0;0;11
11651;Užupiukas;SAULUČIŲ;1656658765;Taip;4;1;1;6
11652;Užupiukas;SAULUČIŲ;1307564992;Taip;0;0;5;5
11653;Užupiukas;SAULUČIŲ;2740412091;Taip;0;0;1;1
11654;Užupiukas;SAULUČIŲ;1577630991;Taip;0;0;16;16
11655;Užupiukas;SAULUČIŲ;1158250810;Taip;5;4;0;9
11656;Užupiukas;SAULUČIŲ;48886679788;Taip;0;1;1;2
11657;Užupiukas;SAULUČIŲ;36820708170;Taip;0;1;4;5
11658;Užupiukas;SAULUČIŲ;52600923918;Taip;0;1;0;1
11659;Užupiukas;SAULUČIŲ;10522364665;Taip;0;1;0;1
11660;Užupiukas;SAULUČIŲ;31471265444;Taip;1;1;0;2
11661;Užupiukas;SAULUČIŲ;87017671664;Taip;11;1;7;19
11662;Užupiukas;SAULUČIŲ;15815468617;Taip;0;0;4;4
11663;Užupiukas;SAULUČIŲ;1592276956;Ne;0;1;7;8
11664;Užupiukas;SAULUČIŲ;6467238027;Taip;0;1;4;5
11665;Užupiukas;SAULUČIŲ;57642636356;Taip;0;1;0;1
11666;Užupiukas;SAULUČIŲ;2499414724;Taip;7;0;0;7
11667;Užupiukas;SAULUČIŲ;53272114855;Taip;0;1;0;1
11668;Užupiukas;LAPIUKŲ;3309195572;Taip;4;0;0;4
11669;Užupiukas;LAPIUKŲ;7563497568;Taip;0;0;18;18
11670;Užupiukas;LAPIUKŲ;2821350355;Taip;6;1;4;11
11671;Užupiukas;LAPIUKŲ;5665323444;Taip;6;1;1;8
11672;Užupiukas;LAPIUKŲ;22401995674;Taip;0;1;0;1
11673;Užupiukas;LAPIUKŲ;3774364829;Taip;8;0;0;8
11674;Užupiukas;LAPIUKŲ;6236652118;Ne;2;1;0;3
11675;Užupiukas;LAPIUKŲ;4247280316;Taip;5;8;2;15
11676;Užupiukas;LAPIUKŲ;2938276316;Taip;0;0;7;7
11677;Užupiukas;LAPIUKŲ;6478702476;Taip;3;1;2;6
11678;Užupiukas;LAPIUKŲ;4132760111;Taip;0;1;0;1
11679;Užupiukas;LAPIUKŲ;3205769002;Ne;6;1;1;8
11680;Užupiukas;LAPIUKŲ;5498369850;Taip;17;0;0;17
11681;Užupiukas;LAPIUKŲ;6110869303;Taip;0;0;1;1
11682;Užupiukas;LAPIUKŲ;79442829922;Taip;0;1;0;1
11683;Užupiukas;LAPIUKŲ;4608233152;Ne;5;0;3;8
11684;Užupiukas;LAPIUKŲ;9197242545;Taip;5;0;8;13
11685;Užupiukas;LAPIUKŲ;5320544400;Ne;0;0;2;2
11686;Užupiukas;LAPIUKŲ;4880828482;Ne;2;0;2;4
11687;Užupiukas;LAPIUKŲ;40704768956;Taip;0;1;0;1
11688;Užupiukas;NYKŠTUKŲ;1355954767;Taip;12;0;1;13
11689;Užupiukas;NYKŠTUKŲ;6001766518;Taip;2;0;4;6
11690;Užupiukas;NYKŠTUKŲ;2273766308;Taip;14;0;0;14
11691;Užupiukas;NYKŠTUKŲ;9428884149;Taip;0;5;5;10
11692;Užupiukas;NYKŠTUKŲ;8301340579;Taip;5;0;1;6
11693;Užupiukas;NYKŠTUKŲ;5085660507;Taip;1;0;8;9
11694;Užupiukas;NYKŠTUKŲ;1496541880;Taip;13;0;4;17
11695;Užupiukas;NYKŠTUKŲ;3528581949;Taip;6;0;2;8
11696;Užupiukas;NYKŠTUKŲ;7345579721;Taip;3;0;1;4
11697;Užupiukas;NYKŠTUKŲ;7530856195;Taip;5;0;4;9
11698;Užupiukas;NYKŠTUKŲ;9925592494;Taip;10;0;0;10
11699;Užupiukas;NYKŠTUKŲ;4054724625;Taip;5;0;1;6
11700;Užupiukas;NYKŠTUKŲ;1995228207;Taip;0;0;4;4
11701;Užupiukas;NYKŠTUKŲ;4710910251;Taip;0;0;4;4
11702;Užupiukas;NYKŠTUKŲ;2390955083;Taip;0;5;1;6
11703;Užupiukas;NYKŠTUKŲ;3768945773;Ne;8;0;0;8
11704;Užupiukas;NYKŠTUKŲ;2210437775;Taip;0;1;0;1
11705;Užupiukas;NYKŠTUKŲ;8519118225;Taip;10;0;2;12
11706;Užupiukas;NYKŠTUKŲ;7549628277;Taip;10;0;2;12
11707;Užupiukas;NYKŠTUKŲ;1684901495;Taip;10;0;0;10
11708;Vaidilutė;Rūtelė;2131127298;Taip;0;1;1;2
11709;Vaidilutė;Rūtelė;7319037375;Taip;6;3;0;9
11710;Vaidilutė;Rūtelė;6630603158;Taip;3;0;1;4
11711;Vaidilutė;Rūtelė;4838951446;Taip;0;0;4;4
11712;Vaidilutė;Rūtelė;7494818866;Taip;0;1;0;1
11713;Vaidilutė;Rūtelė;5500950179;Taip;10;0;1;11
11714;Vaidilutė;Rūtelė;1516903980;Taip;14;1;0;15
11715;Vaidilutė;Rūtelė;1140011879;Taip;5;0;2;7
11716;Vaidilutė;Rūtelė;9563257771;Taip;8;3;0;11
11717;Vaidilutė;Rūtelė;9652684068;Taip;0;0;7;7
11718;Vaidilutė;Rūtelė;2024078532;Taip;5;0;3;8
11719;Vaidilutė;Rūtelė;5482030284;Taip;0;1;0;1
11720;Vaidilutė;Rūtelė;8505156287;Taip;9;0;0;9
11721;Vaidilutė;Rūtelė;9568450630;Taip;17;0;0;17
11722;Vaidilutė;Rūtelė;7306768961;Taip;12;0;1;13
11723;Vaidilutė;Rūtelė;7532115462;Taip;0;0;3;3
11724;Vaidilutė;Rūtelė;6896047075;Taip;12;0;0;12
11725;Vaidilutė;Rūtelė;3059654988;Taip;5;5;0;10
11726;Vaidilutė;Rūtelė;1341696594;Ne;0;0;2;2
11727;Vaidilutė;Saulutė;8492055287;Taip;2;0;3;5
11728;Vaidilutė;Saulutė;6844372910;Taip;8;0;4;12
11729;Vaidilutė;Saulutė;4972645715;Taip;16;0;0;16
11730;Vaidilutė;Saulutė;1355005114;Taip;11;0;0;11
11731;Vaidilutė;Saulutė;4680645841;Taip;4;0;3;7
11732;Vaidilutė;Saulutė;2662468804;Taip;0;15;0;15
11733;Vaidilutė;Saulutė;2864731541;Ne;17;0;0;17
11734;Vaidilutė;Saulutė;1998872078;Taip;6;0;3;9
11735;Vaidilutė;Saulutė;2468220275;Taip;8;0;0;8
11736;Vaidilutė;Saulutė;3327975219;Taip;11;0;1;12
11737;Vaidilutė;Saulutė;1610262589;Taip;12;0;3;15
11738;Vaidilutė;Saulutė;2356037175;Taip;9;0;2;11
11739;Vaidilutė;Saulutė;5054640268;Taip;18;0;0;18
11740;Vaidilutė;Saulutė;6885473308;Taip;10;0;0;10
11741;Vaidilutė;Saulutė;7826111890;Taip;14;0;1;15
11742;Vaidilutė;Saulutė;1667275889;Taip;4;1;1;6
11743;Vaidilutė;"Boružėlių ";3381544575;Taip;5;0;0;5
11744;Vaidilutė;"Boružėlių ";1305478052;Taip;21;0;0;21
11745;Vaidilutė;"Boružėlių ";6586072228;Taip;12;0;0;12
11746;Vaidilutė;"Boružėlių ";9870763434;Taip;16;0;2;18
11747;Vaidilutė;"Boružėlių ";4761992071;Taip;12;0;0;12
11748;Vaidilutė;"Boružėlių ";5307486959;Taip;0;3;0;3
11749;Vaidilutė;"Boružėlių ";1653497170;Taip;0;3;0;3
11750;Vaidilutė;"Boružėlių ";5556351358;Taip;9;1;0;10
11751;Vaidilutė;"Boružėlių ";4954285515;Taip;10;4;0;14
11752;Vaidilutė;"Boružėlių ";5439973183;Taip;8;0;0;8
11753;Vaidilutė;"Boružėlių ";1440819171;Ne;5;9;0;14
11754;Vaidilutė;"Boružėlių ";3730573432;Taip;8;0;0;8
11755;Vaidilutė;"Boružėlių ";4901387311;Taip;13;0;0;13
11756;Vaidilutė;"Malūnelis ";9558983004;Taip;5;0;0;5
11757;Vaidilutė;"Malūnelis ";2081959307;Taip;14;0;0;14
11758;Vaidilutė;"Malūnelis ";2058071219;Ne;3;1;0;4
11759;Vaidilutė;"Malūnelis ";1417828163;Taip;0;1;1;2
11760;Vaidilutė;"Malūnelis ";1401180999;Taip;7;1;0;8
11761;Vaidilutė;"Malūnelis ";5326935037;Taip;10;0;0;10
11762;Vaidilutė;"Malūnelis ";2189753894;Taip;0;6;0;6
11763;Vaidilutė;"Malūnelis ";4230076320;Taip;14;0;0;14
11764;Vaidilutė;"Malūnelis ";2517524802;Taip;3;1;0;4
11765;Vaidilutė;"Malūnelis ";9584702487;Taip;12;1;0;13
11766;Vaidilutė;"Malūnelis ";2572809158;Taip;6;1;0;7
11767;Vaidilutė;"Malūnelis ";8882402632;Taip;15;0;0;15
11768;Vaidilutė;"Malūnelis ";1539700521;Taip;8;0;0;8
11769;Vaidilutė;"Riešutėlis ";1986162951;Taip;3;0;1;4
11770;Vaidilutė;"Riešutėlis ";1941081703;Taip;0;0;1;1
11771;Vaidilutė;"Riešutėlis ";87621682081;Taip;6;1;0;7
11772;Vaidilutė;"Riešutėlis ";76613866916;Taip;5;1;0;6
11773;Vaidilutė;"Riešutėlis ";1942402815;Ne;14;0;0;14
11774;Vaidilutė;"Riešutėlis ";13133501690;Taip;4;0;1;5
11775;Vaidilutė;"Riešutėlis ";8543285470;Taip;7;0;8;15
11776;Vaidilutė;"Riešutėlis ";3962268551;Ne;0;0;13;13
11777;Vaidilutė;"Riešutėlis ";19413698194;Taip;0;2;0;2
11778;Vaidilutė;"Riešutėlis ";83887347923;Taip;0;1;3;4
11779;Vaidilutė;"Riešutėlis ";69452750985;Taip;0;0;7;7
11780;Vaidilutė;"Riešutėlis ";44867291232;Taip;0;0;1;1
11781;Vaidilutė;"Riešutėlis ";38698526742;Ne;0;0;1;1
11782;Vaidilutė;"Riešutėlis ";1664595920;Taip;0;0;3;3
11783;Vaidilutė;"Riešutėlis ";1608286003;Taip;0;1;1;2
11784;Vaidilutė;"Riešutėlis ";1083096707;Ne;0;0;2;2
11785;Vaidilutė;"Riešutėlis ";1405802722;Taip;5;1;0;6
11786;Vaidilutė;"Riešutėlis ";67830476121;Taip;15;0;1;16
11787;Vaidilutė;"Riešutėlis ";3243266869;Taip;20;0;0;20
11788;Vandenis;ŽUVĖDRŲ;91659985965;Taip;0;1;0;1
11789;Vandenis;ŽUVĖDRŲ;52063106839;Taip;0;2;0;2
11790;Vandenis;ŽUVĖDRŲ;83799061370;Taip;0;1;1;2
11791;Vandenis;ŽUVĖDRŲ;72923438583;Taip;15;1;0;16
11792;Vandenis;ŽUVĖDRŲ;86007123;Taip;0;1;0;1
11793;Vandenis;ŽUVĖDRŲ;96459201904;Taip;0;0;3;3
11794;Vandenis;ŽUVĖDRŲ;49204161380;Taip;0;1;0;1
11795;Vandenis;ŽUVĖDRŲ;67472126318;Taip;0;1;0;1
11796;Vandenis;ŽUVĖDRŲ;32749176064;Taip;0;3;1;4
11797;Vandenis;ŽUVĖDRŲ;80186166441;Taip;21;0;0;21
11798;Vandenis;ŽUVĖDRŲ;4045401354;Taip;0;5;0;5
11799;Vandenis;ŽUVĖDRŲ;41376432095;Taip;0;6;0;6
11800;Vandenis;ŽUVĖDRŲ;62877843868;Ne;0;3;0;3
11801;Vandenis;ŽUVĖDRŲ;85287618619;Taip;0;5;0;5
11802;Vandenis;ŽUVĖDRŲ;3639803910;Taip;4;1;0;5
11803;Vandenis;ŽUVĖDRŲ;35581230147;Ne;0;2;0;2
11804;Vandenis;ŽUVĖDRŲ;22764351701;Taip;0;1;0;1
11805;Vandenis;ŽUVĖDRŲ;92857304500;Taip;0;2;0;2
11806;Vandenis;ŽUVĖDRŲ;55952119623;Taip;1;1;0;2
11807;Vandenis;ŽUVĖDRŲ;58324898715;Taip;0;1;0;1
11808;Vandenis;ŽUVĖDRŲ;56648967396;Taip;0;3;1;4
11809;Vandenis;ŽUVĖDRŲ;87398241763;Taip;3;0;0;3
11810;Vandenis;ŽUVĖDRŲ;48908599635;Taip;0;1;0;1
11811;Vandenis;PERLIUKŲ;8678508812;Taip;15;1;0;16
11812;Vandenis;PERLIUKŲ;2645775090;Taip;0;3;0;3
11813;Vandenis;PERLIUKŲ;5844576485;Taip;15;0;0;15
11814;Vandenis;PERLIUKŲ;6295009202;Taip;2;14;0;16
11815;Vandenis;PERLIUKŲ;7598257845;Taip;10;0;1;11
11816;Vandenis;PERLIUKŲ;7473692892;Taip;6;2;0;8
11817;Vandenis;PERLIUKŲ;5323428164;Taip;19;0;0;19
11818;Vandenis;PERLIUKŲ;6073002418;Taip;4;1;0;5
11819;Vandenis;PERLIUKŲ;1511740350;Taip;16;0;0;16
11820;Vandenis;PERLIUKŲ;2690536940;Ne;16;0;0;16
11821;Vandenis;PERLIUKŲ;2576575249;Taip;10;2;1;13
11822;Vandenis;PERLIUKŲ;7832674282;Ne;14;2;0;16
11823;Vandenis;PERLIUKŲ;9798192239;Taip;6;2;0;8
11824;Vandenis;PERLIUKŲ;1975385430;Taip;0;11;0;11
11825;Vandenis;PERLIUKŲ;3061606138;Ne;7;10;0;17
11826;Vandenis;PERLIUKŲ;8117385209;Taip;2;0;1;3
11827;Vandenis;PERLIUKŲ;5613067534;Taip;0;2;0;2
11828;Vandenis;PERLIUKŲ;2321919298;Taip;16;0;0;16
11829;Vandenis;PERLIUKŲ;5963181638;Ne;15;0;0;15
11830;Vandenis;PERLIUKŲ;5609737826;Taip;3;4;0;7
11831;Vandenis;ANČIUKŲ;8233407105;Taip;8;2;0;10
11832;Vandenis;ANČIUKŲ;1282499654;Taip;0;2;0;2
11833;Vandenis;ANČIUKŲ;3578947540;Taip;0;1;0;1
11834;Vandenis;ANČIUKŲ;5395847317;Taip;5;1;0;6
11835;Vandenis;ANČIUKŲ;3243079651;Taip;10;0;2;12
11836;Vandenis;ANČIUKŲ;3938359901;Taip;5;0;0;5
11837;Vandenis;ANČIUKŲ;1314724267;Taip;13;0;0;13
11838;Vandenis;ANČIUKŲ;8251169901;Ne;15;2;0;17
11839;Vandenis;ANČIUKŲ;4750141780;Taip;6;1;0;7
11840;Vandenis;ANČIUKŲ;6181866272;Taip;0;3;0;3
11841;Vandenis;ANČIUKŲ;7522472652;Taip;5;0;0;5
11842;Vandenis;ANČIUKŲ;7630017843;Taip;0;6;0;6
11843;Vandenis;ANČIUKŲ;1222539247;Taip;12;3;0;15
11844;Vandenis;ANČIUKŲ;3067868099;Taip;11;0;0;11
11845;Vandenis;ANČIUKŲ;8511948282;Ne;0;4;0;4
11846;Vandenis;ANČIUKŲ;33317650043;Taip;5;2;0;7
11847;Vandenis;ANČIUKŲ;1739780612;Taip;10;3;0;13
11848;Vandenis;ANČIUKŲ;2489776665;Taip;10;0;2;12
11849;Vandenis;ANČIUKŲ;71786730314;Taip;7;0;0;7
11850;Vandenis;ANČIUKŲ;1621481561;Taip;4;3;0;7
11851;Vandenis;ANČIUKŲ;33782837791;Taip;6;0;0;6
11852;Vandenis;VĖŽLIUKŲ;2309166304;Taip;5;0;0;5
11853;Vandenis;VĖŽLIUKŲ;2872343656;Taip;16;0;0;16
11854;Vandenis;VĖŽLIUKŲ;5454049563;Taip;0;1;0;1
11855;Vandenis;VĖŽLIUKŲ;9805578141;Taip;0;1;0;1
11856;Vandenis;VĖŽLIUKŲ;8921666108;Taip;8;0;0;8
11857;Vandenis;VĖŽLIUKŲ;8116532445;Taip;0;4;0;4
11858;Vandenis;VĖŽLIUKŲ;7069369080;Taip;0;3;0;3
11859;Vandenis;VĖŽLIUKŲ;6011280420;Taip;11;0;0;11
11860;Vandenis;VĖŽLIUKŲ;7924399684;Taip;0;9;0;9
11861;Vandenis;VĖŽLIUKŲ;7091356848;Taip;0;4;0;4
11862;Vandenis;VĖŽLIUKŲ;1081385111;Taip;4;0;0;4
11863;Vandenis;VĖŽLIUKŲ;5126732658;Taip;5;0;0;5
11864;Vandenis;VĖŽLIUKŲ;7059385610;Taip;0;1;0;1
11865;Vandenis;VĖŽLIUKŲ;9158541919;Taip;10;0;0;10
11866;Vandenis;VĖŽLIUKŲ;5959181898;Taip;10;0;0;10
11867;Vandenis;VĖŽLIUKŲ;1707354287;Taip;6;0;0;6
11868;Vandenis;VĖŽLIUKŲ;2061017760;Taip;10;0;0;10
11869;Vandenis;VĖŽLIUKŲ;6894180651;Taip;10;0;0;10
11870;Vandenis;VĖŽLIUKŲ;4413648496;Taip;10;0;0;10
11871;Vandenis;AŠTUNKOJŲ;39832993343;Taip;0;1;0;1
11872;Vandenis;AŠTUNKOJŲ;70732367996;Ne;12;0;0;12
11873;Vandenis;AŠTUNKOJŲ;88097898349;Taip;0;1;0;1
11874;Vandenis;AŠTUNKOJŲ;20843785079;Taip;0;1;0;1
11875;Vandenis;AŠTUNKOJŲ;56883076424;Taip;2;0;0;2
11876;Vandenis;AŠTUNKOJŲ;2056980868;Ne;0;2;0;2
11877;Vandenis;AŠTUNKOJŲ;16402149104;Taip;0;1;0;1
11878;Vandenis;AŠTUNKOJŲ;17644420312;Taip;0;1;0;1
11879;Vandenis;AŠTUNKOJŲ;26057060619;Taip;0;1;0;1
11880;Vandenis;AŠTUNKOJŲ;55331810310;Taip;0;1;0;1
11881;Vandenis;AŠTUNKOJŲ;48194812760;Taip;0;3;0;3
11882;Vandenis;AŠTUNKOJŲ;84025519453;Taip;0;1;0;1
11883;Vandenis;AŠTUNKOJŲ;5363853315;Taip;0;5;0;5
11884;Vandenis;AŠTUNKOJŲ;85054617489;Taip;4;0;0;4
11885;Vandenis;AŠTUNKOJŲ;61521559336;Taip;0;1;0;1
11886;Vandenis;AŠTUNKOJŲ;87310831307;Taip;0;1;0;1
11887;Vandenis;AŠTUNKOJŲ;63629799884;Taip;7;1;0;8
11888;Vandenis;AŠTUNKOJŲ;92286914041;Taip;0;1;0;1
11889;Vandenis;AŠTUNKOJŲ;8447593747;Taip;5;0;0;5
11890;Vandenis;AŠTUNKOJŲ;1646554203;Taip;0;1;0;1
11891;Vandenis;GANDRIUKŲ;8367599264;Taip;8;0;0;8
11892;Vandenis;GANDRIUKŲ;94471245079;Taip;5;1;0;6
11893;Vandenis;GANDRIUKŲ;53737587501;Taip;0;2;0;2
11894;Vandenis;GANDRIUKŲ;67409458110;Taip;0;0;5;5
11895;Vandenis;GANDRIUKŲ;1945164524;Taip;5;1;0;6
11896;Vandenis;GANDRIUKŲ;38894447952;Ne;2;2;0;4
11897;Vandenis;GANDRIUKŲ;61110317694;Taip;0;5;0;5
11898;Vandenis;GANDRIUKŲ;5716325525;Taip;5;2;0;7
11899;Vandenis;GANDRIUKŲ;1650529956;Taip;0;1;0;1
11900;Vandenis;GANDRIUKŲ;2447879418;Taip;2;0;0;2
11901;Vandenis;GANDRIUKŲ;8144064189;Taip;9;0;1;10
11902;Vandenis;GANDRIUKŲ;94273730058;Ne;7;1;1;9
11903;Vandenis;GANDRIUKŲ;44800276421;Taip;7;0;4;11
11904;Vandenis;GANDRIUKŲ;1713624934;Taip;13;0;0;13
11905;Vandenis;PURIENŲ;2114436962;Taip;0;1;0;1
11906;Vandenis;PURIENŲ;877974909;Taip;6;3;0;9
11907;Vandenis;PURIENŲ;3823382249;Taip;0;2;0;2
11908;Vandenis;PURIENŲ;43295720034;Ne;0;1;1;2
11909;Vandenis;PURIENŲ;84636435681;Taip;10;0;1;11
11910;Vandenis;PURIENŲ;1958929302;Taip;11;0;0;11
11911;Vandenis;PURIENŲ;39973189502;Taip;3;0;2;5
11912;Vandenis;PURIENŲ;1633589144;Taip;11;0;0;11
11913;Vandenis;PURIENŲ;1854498462;Taip;5;1;0;6
11914;Vandenis;PURIENŲ;6673346389;Ne;0;0;3;3
11915;Vandenis;PURIENŲ;7168910452;Taip;1;2;0;3
11916;Vandenis;PURIENŲ;58997790744;Taip;5;1;0;6
11917;Vandenis;PURIENŲ;2073785910;Taip;0;1;0;1
11918;Vandenis;PURIENŲ;1245031666;Taip;0;1;0;1
11919;Vandenis;PURIENŲ;38137368394;Taip;4;0;0;4
11920;Vandenis;PURIENŲ;81817138188;Taip;0;2;0;2
11921;Vandenis;PURIENŲ;1395272045;Taip;0;3;0;3
11922;Vandenis;PURIENŲ;3740778932;Taip;16;1;0;17
11923;Vandenis;VARLIUKAI;2960005490;Taip;0;7;4;11
11924;Vandenis;VARLIUKAI;1180322026;Taip;0;7;4;11
11925;Vandenis;VARLIUKAI;3633805607;Taip;8;2;0;10
11926;Vandenis;VARLIUKAI;7959438279;Taip;0;2;0;2
11927;Vandenis;VARLIUKAI;1788652447;Taip;0;1;0;1
11928;Vandenis;VARLIUKAI;5540306590;Taip;0;2;1;3
11929;Vandenis;VARLIUKAI;2719678617;Taip;2;1;0;3
11930;Vandenis;VARLIUKAI;7171302906;Taip;0;0;20;20
11931;Vandenis;VARLIUKAI;8085633453;Taip;0;0;20;20
11932;Vandenis;VARLIUKAI;5764809162;Taip;0;1;0;1
11933;Vandenis;VARLIUKAI;2614561762;Taip;0;2;1;3
11934;Vandenis;VARLIUKAI;1244502945;Taip;0;4;0;4
11935;Vandenis;VARLIUKAI;2315167746;Ne;10;2;0;12
11936;Vandenis;VARLIUKAI;6332179750;Taip;0;2;2;4
11937;Vandenis;VARLIUKAI;6027680514;Taip;0;1;0;1
11938;Vandenis;PINGVINAI;9994373029;Taip;11;1;0;12
11939;Vandenis;PINGVINAI;3544717790;Taip;5;2;0;7
11940;Vandenis;PINGVINAI;4085256182;Taip;5;5;0;10
11941;Vandenis;PINGVINAI;1568158992;Taip;3;0;0;3
11942;Vandenis;PINGVINAI;18336904438;Taip;0;1;0;1
11943;Vandenis;PINGVINAI;8689134931;Taip;4;1;0;5
11944;Vandenis;PINGVINAI;9608871155;Taip;0;2;1;3
11945;Vandenis;PINGVINAI;64711327503;Taip;15;3;0;18
11946;Vandenis;PINGVINAI;7381695975;Taip;0;3;1;4
11947;Vandenis;PINGVINAI;43933878402;Taip;0;2;1;3
11948;Vandenis;PINGVINAI;71513217054;Taip;1;3;0;4
11949;Vandenis;PINGVINAI;55421695186;Taip;1;1;0;2
11950;Vandenis;PINGVINAI;24217366528;Taip;7;3;0;10
11951;Vandenis;PINGVINAI;5549292096;Taip;12;2;0;14
11952;Vandenis;PINGVINAI;7408758565;Taip;1;0;0;1
11953;Vandenis;PINGVINAI;4643267945;Taip;6;3;0;9
11954;Vandenis;PINGVINAI;1535450614;Taip;0;1;0;1
11955;Vandenis;PINGVINAI;35673258175;Taip;0;0;11;11
11956;Vandenis;PINGVINAI;27409922803;Taip;15;0;0;15
11957;Vandenis;PINGVINAI;1598122777;Ne;6;0;0;6
11958;Vandenis;PINGVINAI;1815765498;Taip;14;0;0;14
11959;Vėjelis;Pumpurėliai;89672883586;Taip;0;1;0;1
11960;Vėjelis;Pumpurėliai;2647629246;Taip;6;0;0;6
11961;Vėjelis;Pumpurėliai;49983865253;Taip;7;2;2;11
11962;Vėjelis;Pumpurėliai;90185075321;Taip;0;2;0;2
11963;Vėjelis;Pumpurėliai;1640356242;Taip;8;1;0;9
11964;Vėjelis;Pumpurėliai;86128256406;Taip;6;4;1;11
11965;Vėjelis;Pumpurėliai;77205958956;Taip;0;1;2;3
11966;Vėjelis;Pumpurėliai;2718251356;Taip;0;1;1;2
11967;Vėjelis;Pumpurėliai;1988459596;Taip;0;1;0;1
11968;Vėjelis;Pumpurėliai;64339770365;Taip;8;0;4;12
11969;Vėjelis;Pumpurėliai;75596757609;Taip;5;0;3;8
11970;Vėjelis;Pumpurėliai;1934426525;Taip;12;3;0;15
11971;Vėjelis;Pumpurėliai;44153389025;Taip;7;1;1;9
11972;Vėjelis;Pumpurėliai;1921039937;Taip;7;1;0;8
11973;Vėjelis;Pumpurėliai;57285479257;Taip;0;1;0;1
11974;Vėjelis;Pumpurėliai;93219773975;Taip;0;0;2;2
11975;Vėjelis;Drugeliai;4746932126;Taip;9;5;0;14
11976;Vėjelis;Drugeliai;1978952781;Taip;3;1;0;4
11977;Vėjelis;Drugeliai;8353084814;Taip;7;0;0;7
11978;Vėjelis;Drugeliai;1115802837;Ne;17;0;0;17
11979;Vėjelis;Drugeliai;2416832899;Taip;0;2;0;2
11980;Vėjelis;Drugeliai;1494531065;Taip;0;0;3;3
11981;Vėjelis;Drugeliai;9298789434;Taip;14;0;0;14
11982;Vėjelis;Drugeliai;2734024890;Taip;15;4;0;19
11983;Vėjelis;Drugeliai;7981032872;Taip;20;1;0;21
11984;Vėjelis;Drugeliai;2000277444;Taip;10;0;0;10
11985;Vėjelis;Drugeliai;7752923796;Taip;14;0;0;14
11986;Vėjelis;Drugeliai;7594586198;Taip;0;11;0;11
11987;Vėjelis;Drugeliai;7697394469;Taip;5;1;0;6
11988;Vėjelis;Drugeliai;4066956765;Taip;3;14;0;17
11989;Vėjelis;Drugeliai;1571064934;Taip;0;0;8;8
11990;Vėjelis;Drugeliai;2788205363;Taip;0;2;2;4
11991;Vėjelis;Drugeliai;1331334220;Taip;11;1;3;15
11992;Vėjelis;Drugeliai;2151737048;Taip;9;4;0;13
11993;Vėjelis;Drugeliai;3276062426;Taip;16;0;0;16
11994;Vėjelis;Malūnėlis;74207410750;Taip;3;0;0;3
11995;Vėjelis;Malūnėlis;20148908290;Taip;1;0;0;1
11996;Vėjelis;Malūnėlis;90926729186;Taip;5;3;0;8
11997;Vėjelis;Malūnėlis;39671245978;Taip;3;0;0;3
11998;Vėjelis;Malūnėlis;1209526192;Taip;5;0;0;5
11999;Vėjelis;Malūnėlis;68958036563;Taip;6;2;0;8
12000;Vėjelis;Malūnėlis;20593684676;Taip;2;0;0;2
12001;Vėjelis;Malūnėlis;14502736200;Taip;0;1;2;3
12002;Vėjelis;Malūnėlis;98024305748;Taip;0;3;0;3
12003;Vėjelis;Malūnėlis;5468993286;Taip;0;3;0;3
12004;Vėjelis;Malūnėlis;46167493039;Taip;0;2;0;2
12005;Vėjelis;Malūnėlis;1267672356;Taip;4;0;0;4
12006;Vėjelis;Malūnėlis;2021887954;Taip;0;1;0;1
12007;Vėjelis;Malūnėlis;1284286578;Ne;10;10;0;20
12008;Vėjelis;Malūnėlis;1789982154;Taip;0;8;0;8
12009;Vėjelis;Malūnėlis;54924516732;Taip;0;2;0;2
12010;Vėjelis;Malūnėlis;1242928700;Taip;11;0;1;12
12011;Vėjelis;Malūnėlis;9826410933;Taip;0;0;1;1
12012;Vėjelis;Malūnėlis;4110537888;Taip;7;1;0;8
12013;Vėjelis;Malūnėlis;44482585723;Taip;0;1;0;1
12014;Vėjelis;Žvaigždutės;3485366651;Taip;0;4;0;4
12015;Vėjelis;Žvaigždutės;5139323880;Taip;4;1;1;6
12016;Vėjelis;Žvaigždutės;2363974247;Taip;21;0;0;21
12017;Vėjelis;Žvaigždutės;86337749074;Taip;0;0;1;1
12018;Vėjelis;Žvaigždutės;8379298947;Taip;21;0;0;21
12019;Vėjelis;Žvaigždutės;8973530484;Ne;0;5;0;5
12020;Vėjelis;Žvaigždutės;69341469387;Taip;0;6;0;6
12021;Vėjelis;Žvaigždutės;9190085358;Taip;0;14;0;14
12022;Vėjelis;Žvaigždutės;8949760376;Taip;9;0;0;9
12023;Vėjelis;Žvaigždutės;6002719498;Taip;0;10;0;10
12024;Vėjelis;Žvaigždutės;9000966115;Ne;0;10;0;10
12025;Vėjelis;Žvaigždutės;4230144743;Taip;18;0;0;18
12026;Vėjelis;Žvaigždutės;3255066035;Taip;3;0;1;4
12027;Vėjelis;Žvaigždutės;76305473353;Taip;5;1;0;6
12028;Vėjelis;Žvaigždutės;73287916371;Taip;0;14;0;14
12029;Vėjelis;Žvaigždutės;50124109589;Ne;0;11;0;11
12030;Vėjelis;Varpeliai;28696711850;Taip;0;11;0;11
12031;Vėjelis;Varpeliai;8787363287;Taip;0;2;0;2
12032;Vėjelis;Varpeliai;83608030842;Ne;0;1;0;1
12033;Vėjelis;Varpeliai;71456994638;Taip;0;8;0;8
12034;Vėjelis;Varpeliai;14157070764;Taip;0;1;10;11
12035;Vėjelis;Varpeliai;1944266562;Taip;0;1;1;2
12036;Vėjelis;Varpeliai;80942260332;Taip;0;2;0;2
12037;Vėjelis;Varpeliai;8389094301;Taip;10;0;1;11
12038;Vėjelis;Varpeliai;6745229012;Taip;0;1;7;8
12039;Vėjelis;Varpeliai;9538710614;Ne;0;5;0;5
12040;Vėjelis;Varpeliai;90647333398;Taip;0;7;0;7
12041;Vėjelis;Varpeliai;40744700561;Taip;0;10;0;10
12042;Vėjelis;Varpeliai;47143492836;Taip;0;4;1;5
12043;Vėjelis;Varpeliai;1295818672;Ne;16;0;0;16
12044;Vėjelis;Varpeliai;1930159743;Taip;0;1;1;2
12045;Vėjelis;Varpeliai;56520156825;Taip;2;2;0;4
12046;Vėjelis;Varpeliai;47986392996;Taip;0;3;0;3
12047;Vėjelis;Pelėdžiukų;1454662113;Taip;0;0;1;1
12048;Vėjelis;Pelėdžiukų;1238171728;Taip;6;0;0;6
12049;Vėjelis;Pelėdžiukų;4024898537;Taip;0;7;0;7
12050;Vėjelis;Pelėdžiukų;24011371444;Taip;16;0;0;16
12051;Vėjelis;Pelėdžiukų;1783878104;Taip;0;2;0;2
12052;Vėjelis;Pelėdžiukų;1510415602;Taip;5;0;1;6
12053;Vėjelis;Pelėdžiukų;2042863944;Taip;0;3;0;3
12054;Vėjelis;Pelėdžiukų;5992665537;Taip;0;4;0;4
12055;Vėjelis;Pelėdžiukų;1347855869;Taip;7;1;0;8
12056;Vėjelis;Pelėdžiukų;1990674632;Taip;0;0;1;1
12057;Vėjelis;Pelėdžiukų;6618114389;Taip;7;3;0;10
12058;Vėjelis;Pelėdžiukų;1467023330;Taip;6;0;0;6
12059;Vėjelis;Pelėdžiukų;1518855620;Taip;6;7;0;13
12060;Vėjelis;Pelėdžiukų;4930807661;Taip;0;6;1;7
12061;Vėjelis;Pelėdžiukų;2128818222;Ne;0;0;6;6
12062;Vėjelis;Pelėdžiukų;1603377234;Ne;5;1;0;6
12063;Vėjelis;Skruzdeliukų;3910688753;Ne;0;0;2;2
12064;Vėjelis;Skruzdeliukų;2167025998;Taip;2;0;0;2
12065;Vėjelis;Skruzdeliukų;7400967836;Taip;0;0;1;1
12066;Vėjelis;Skruzdeliukų;8470977526;Taip;6;3;0;9
12067;Vėjelis;Skruzdeliukų;9434737088;Taip;1;0;1;2
12068;Vėjelis;Skruzdeliukų;1952141664;Taip;10;0;1;11
12069;Vėjelis;Skruzdeliukų;3264153232;Taip;7;0;1;8
12070;Vėjelis;Skruzdeliukų;12087873516;Taip;0;5;0;5
12071;Vėjelis;Skruzdeliukų;7610485310;Taip;0;10;0;10
12072;Vėjelis;Skruzdeliukų;2282796452;Taip;0;3;0;3
12073;Vėjelis;Skruzdeliukų;1551143643;Taip;12;0;0;12
12074;Vėjelis;Skruzdeliukų;7794899167;Taip;0;1;0;1
12075;Vėjelis;Skruzdeliukų;8941647789;Taip;0;1;4;5
12076;Vėjelis;Skruzdeliukų;41268510292;Taip;0;2;0;2
12077;Vėjelis;Skruzdeliukų;1534169381;Taip;0;8;0;8
12078;Vėjelis;Skruzdeliukų;4508775250;Taip;8;0;0;8
12079;Vėjelis;Skruzdeliukų;4992783345;Taip;5;6;0;11
12080;Vėjelis;Pieštukų;4853650350;Taip;8;0;0;8
12081;Vėjelis;Pieštukų;60890519853;Taip;6;4;0;10
12082;Vėjelis;Pieštukų;8386409466;Ne;14;5;0;19
12083;Vėjelis;Pieštukų;9492690970;Ne;10;0;0;10
12084;Vėjelis;Pieštukų;6386092350;Taip;11;3;0;14
12085;Vėjelis;Pieštukų;8684461171;Taip;0;13;0;13
12086;Vėjelis;Pieštukų;9395929106;Ne;14;7;0;21
12087;Vėjelis;Pieštukų;1205392813;Ne;11;8;0;19
12088;Vėjelis;Pieštukų;2117924725;Taip;14;0;1;15
12089;Vėjelis;Pieštukų;1436893015;Ne;12;0;0;12
12090;Vėjelis;Pieštukų;1549518622;Taip;0;0;3;3
12091;Vėjelis;Pieštukų;6844704326;Taip;0;0;1;1
12092;Vėjelis;Pieštukų;8300497094;Taip;11;0;0;11
12093;Vėjelis;Pieštukų;4219672982;Taip;8;0;0;8
12094;Vėjelis;Pieštukų;7255617408;Taip;7;6;0;13
12095;Vėjelis;Pieštukų;4829314007;Ne;15;0;0;15
12096;Vėjelis;Pieštukų;2132551615;Ne;0;0;15;15
12097;Vėjelis;Ramunėlių;5987294293;Taip;8;3;0;11
12098;Vėjelis;Ramunėlių;8047799576;Taip;6;4;0;10
12099;Vėjelis;Ramunėlių;4745262277;Ne;8;1;0;9
12100;Vėjelis;Ramunėlių;4353239658;Ne;5;0;0;5
12101;Vėjelis;Ramunėlių;7178844364;Taip;11;1;0;12
12102;Vėjelis;Ramunėlių;2386927970;Taip;13;4;0;17
12103;Vėjelis;Ramunėlių;2124857941;Taip;11;1;0;12
12104;Vėjelis;Ramunėlių;6455798848;Taip;7;0;0;7
12105;Vėjelis;Ramunėlių;2999425729;Taip;21;0;0;21
12106;Vėjelis;Ramunėlių;6996900411;Taip;9;4;0;13
12107;Vėjelis;Ramunėlių;2289954824;Taip;4;6;0;10
12108;Vėjelis;Ramunėlių;6891260701;Taip;0;2;0;2
12109;Vėjelis;Ramunėlių;7836199284;Taip;19;0;0;19
12110;Vėjelis;Ramunėlių;4733227215;Taip;0;1;0;1
12111;Vėjelis;Ramunėlių;5909697341;Taip;0;3;0;3
12112;Vėjelis;Ramunėlių;6451722893;Taip;6;1;0;7
12113;Vėjelis;Ramunėlių;8721116918;Ne;1;1;0;2
12114;Vėjelis;Ramunėlių;3584347608;Taip;0;3;0;3
12115;Vėjelis;Ramunėlių;1381191703;Taip;0;1;7;8
12116;Vėjelis;Nykštukai;6660799519;Taip;6;6;1;13
12117;Vėjelis;Nykštukai;2522750651;Taip;0;0;5;5
12118;Vėjelis;Nykštukai;4433799070;Taip;9;0;0;9
12119;Vėjelis;Nykštukai;1235788079;Ne;7;0;1;8
12120;Vėjelis;Nykštukai;2371667380;Taip;5;1;0;6
12121;Vėjelis;Nykštukai;3524350131;Taip;11;0;1;12
12122;Vėjelis;Nykštukai;9116153981;Taip;17;0;0;17
12123;Vėjelis;Nykštukai;5516672613;Taip;10;0;0;10
12124;Vėjelis;Nykštukai;7790713917;Taip;12;0;3;15
12125;Vėjelis;Nykštukai;6772736175;Taip;19;0;0;19
12126;Vėjelis;BITUTĖS;5902455219;Taip;0;1;0;1
12127;Vėjelis;BITUTĖS;48694326383;Taip;0;1;0;1
12128;Vėjelis;BITUTĖS;4831426440;Taip;6;0;0;6
12129;Vėjelis;BITUTĖS;74475070018;Taip;0;5;0;5
12130;Vėjelis;BITUTĖS;6724813553;Taip;17;0;0;17
12131;Vėjelis;BITUTĖS;5508269515;Taip;7;3;0;10
12132;Vėjelis;BITUTĖS;8998452731;Taip;0;0;4;4
12133;Vėjelis;BITUTĖS;9672929606;Taip;6;0;4;10
12134;Vėjelis;BITUTĖS;9754373141;Taip;10;0;2;12
12135;Vėjelis;BITUTĖS;4906958328;Taip;0;1;1;2
12136;Vėjelis;BITUTĖS;43342043904;Ne;0;2;0;2
12137;Vėjelis;BITUTĖS;89943712210;Taip;0;3;0;3
12138;Vėjelis;BITUTĖS;64628040227;Taip;0;1;0;1
12139;Vėjelis;BITUTĖS;22865699640;Taip;13;1;0;14
12140;Vėjelis;BITUTĖS;1008705526;Ne;7;1;1;9
12141;Vėjelis;BITUTĖS;1251348150;Taip;0;6;0;6
12142;Vėjelis;BITUTĖS;5207473829;Ne;0;1;0;1
12143;Vėjelis;BITUTĖS;8226906949;Taip;14;0;0;14
12144;Vėjelis;BITUTĖS;4938939921;Taip;11;3;0;14
12145;Vėjelis;BITUTĖS;20492762368;Ne;0;2;0;2
12146;Vėjelis;Boruželės;2199680661;Taip;0;0;2;2
12147;Vėjelis;Boruželės;5325081841;Taip;6;6;0;12
12148;Vėjelis;Boruželės;5381588565;Taip;0;7;0;7
12149;Vėjelis;Boruželės;1863210064;Taip;0;4;0;4
12150;Vėjelis;Boruželės;9037622738;Taip;5;0;0;5
12151;Vėjelis;Boruželės;8553966497;Taip;0;6;0;6
12152;Vėjelis;Boruželės;1588345134;Taip;0;2;0;2
12153;Vėjelis;Boruželės;1751533938;Ne;5;1;0;6
12154;Vėjelis;Boruželės;1429496839;Taip;0;0;1;1
12155;Vėjelis;Boruželės;1931659200;Taip;11;3;0;14
12156;Vėjelis;Boruželės;1076538028;Ne;12;0;0;12
12157;Vėjelis;Boruželės;6221257045;Taip;11;0;0;11
12158;Vėjelis;Boruželės;8666759391;Ne;0;1;1;2
12159;Vėjelis;Boruželės;3844131154;Taip;0;1;0;1
12160;Vėjelis;Boruželės;4747466651;Taip;12;4;0;16
12161;Vėjelis;Boruželės;3473416323;Taip;0;1;0;1
12162;Vėjelis;Boruželės;8141198449;Taip;11;0;8;19
12163;Vėjelis;Boruželės;8121537795;Ne;12;5;0;17
12164;Vėjelis;Boruželės;7133454882;Taip;4;4;4;12
12165;Vėjelis;Boruželės;5517128872;Ne;0;1;0;1
12166;Vėjelis;Boruželės;8938491367;Taip;15;1;0;16
12167;Vėtrungė;Debesėlių;2825732654;Taip;5;1;1;7
12168;Vėtrungė;Debesėlių;5251308945;Taip;24;0;0;24
12169;Vėtrungė;Debesėlių;5446546214;Taip;0;1;0;1
12170;Vėtrungė;Debesėlių;8956375453;Taip;0;0;1;1
12171;Vėtrungė;Debesėlių;4339450816;Taip;3;2;4;9
12172;Vėtrungė;Debesėlių;7863176604;Taip;0;4;0;4
12173;Vėtrungė;Debesėlių;3179715496;Taip;0;4;0;4
12174;Vėtrungė;Debesėlių;8441629302;Ne;14;0;0;14
12175;Vėtrungė;Debesėlių;9423361592;Taip;18;1;0;19
12176;Vėtrungė;Debesėlių;1191007983;Taip;7;0;1;8
12177;Vėtrungė;Debesėlių;3745680607;Taip;3;2;5;10
12178;Vėtrungė;Debesėlių;9359012317;Taip;0;0;2;2
12179;Vėtrungė;Zuikių;8493950205;Taip;11;0;0;11
12180;Vėtrungė;Zuikių;7585075881;Taip;13;0;0;13
12181;Vėtrungė;Zuikių;4874628984;Taip;16;0;1;17
12182;Vėtrungė;Zuikių;9332362038;Taip;5;0;1;6
12183;Vėtrungė;Zuikių;9407558097;Taip;5;5;0;10
12184;Vėtrungė;Zuikių;2985829593;Taip;0;3;0;3
12185;Vėtrungė;Zuikių;4121886031;Ne;21;0;0;21
12186;Vėtrungė;Zuikių;7573021445;Taip;0;0;2;2
12187;Vėtrungė;Zuikių;3335047815;Taip;2;2;0;4
12188;Vėtrungė;Zuikių;8157356569;Taip;2;3;0;5
12189;Vėtrungė;Zuikių;9742099165;Taip;9;1;0;10
12190;Vėtrungė;Zuikių;1215953192;Taip;14;0;0;14
12191;Vėtrungė;Zuikių;5017020616;Ne;0;5;1;6
12192;Vėtrungė;Zuikių;3908259010;Ne;20;0;0;20
12193;Vėtrungė;Zuikių;8421138967;Taip;13;0;2;15
12194;Vėtrungė;Drugelių;5622109033;Taip;0;1;0;1
12195;Vėtrungė;Drugelių;7936785905;Taip;5;3;1;9
12196;Vėtrungė;Drugelių;5539872851;Taip;12;0;0;12
12197;Vėtrungė;Drugelių;6457369177;Taip;0;0;1;1
12198;Vėtrungė;Drugelių;8744050633;Taip;0;0;1;1
12199;Vėtrungė;Drugelių;9444188699;Taip;16;0;3;19
12200;Vėtrungė;Drugelių;1462620951;Taip;1;0;0;1
12201;Vėtrungė;Drugelių;4408537397;Taip;5;0;0;5
12202;Vėtrungė;Drugelių;7476984763;Taip;19;0;0;19
12203;Vėtrungė;Do-re-mi;6978977383;Taip;5;0;1;6
12204;Vėtrungė;Do-re-mi;6449124019;Taip;5;0;2;7
12205;Vėtrungė;Do-re-mi;3278452234;Taip;0;3;6;9
12206;Vėtrungė;Do-re-mi;9324733839;Taip;4;1;0;5
12207;Vėtrungė;Do-re-mi;2287044278;Taip;2;1;1;4
12208;Vėtrungė;Do-re-mi;2928868412;Taip;0;5;2;7
12209;Vėtrungė;Do-re-mi;9518734260;Taip;7;0;2;9
12210;Vėtrungė;Do-re-mi;7496582551;Taip;6;0;0;6
12211;Vėtrungė;Do-re-mi;5430818470;Taip;3;1;0;4
12212;Vėtrungė;Do-re-mi;5832298824;Ne;2;0;0;2
12213;Vėtrungė;Do-re-mi;7895027909;Taip;0;0;5;5
12214;Vėtrungė;Do-re-mi;8538678373;Taip;0;1;0;1
12215;Vėtrungė;Do-re-mi;7749675589;Taip;0;1;0;1
12216;Vėtrungė;Do-re-mi;7483624989;Taip;10;0;1;11
12217;Vėtrungė;Do-re-mi;7807708310;Taip;0;7;0;7
12218;Vėtrungė;Do-re-mi;3200251047;Taip;7;0;1;8
12219;Vėtrungė;Do-re-mi;3369970611;Taip;0;2;0;2
12220;Vėtrungė;Do-re-mi;1808699695;Taip;1;1;0;2
12221;Vėtrungė;Do-re-mi;5217297849;Ne;16;0;0;16
12222;Vėtrungė;Smalsučių;5338119067;Taip;0;1;0;1
12223;Vėtrungė;Smalsučių;18747550179;Taip;2;1;0;3
12224;Vėtrungė;Smalsučių;8948342560;Taip;7;0;0;7
12225;Vėtrungė;Smalsučių;31644585040;Ne;5;1;0;6
12226;Vėtrungė;Smalsučių;9844783953;Taip;0;1;0;1
12227;Vėtrungė;Smalsučių;65861118217;Taip;0;2;0;2
12228;Vėtrungė;Smalsučių;96980344422;Taip;6;0;0;6
12229;Vėtrungė;Smalsučių;30792456956;Ne;4;0;0;4
12230;Vėtrungė;Smalsučių;684188851;Taip;8;0;0;8
12231;Vėtrungė;Smalsučių;22961558196;Taip;0;1;3;4
12232;Vėtrungė;Smalsučių;62501279379;Ne;5;0;0;5
12233;Vėtrungė;Smalsučių;11835082526;Taip;0;1;0;1
12234;Vėtrungė;Smalsučių;92977432447;Ne;0;1;0;1
12235;Vėtrungė;Smalsučių;4547247726;Taip;4;1;4;9
12236;Vėtrungė;Smalsučių;63472451321;Taip;2;2;0;4
12237;Vėtrungė;Smalsučių;92266460791;Taip;0;0;2;2
12238;Vėtrungė;Smalsučių;68262180072;Taip;0;1;0;1
12239;Vėtrungė;Smalsučių;1452467682;Taip;5;10;0;15
12240;Vėtrungė;Gudručių;1128961321;Taip;0;2;0;2
12241;Vėtrungė;Gudručių;99423172685;Ne;0;1;0;1
12242;Vėtrungė;Gudručių;98795465390;Taip;0;0;1;1
12243;Vėtrungė;Gudručių;40200404538;Ne;0;5;0;5
12244;Vėtrungė;Gudručių;42353807206;Taip;0;3;0;3
12245;Vėtrungė;Gudručių;1019550327;Taip;0;0;3;3
12246;Vėtrungė;Gudručių;76967115688;Taip;0;4;0;4
12247;Vėtrungė;Gudručių;1111688152;Taip;0;1;0;1
12248;Vėtrungė;Gudručių;1533796435;Taip;4;0;0;4
12249;Vėtrungė;Gudručių;1752676956;Taip;0;3;0;3
12250;Vėtrungė;Gudručių;72462689908;Taip;5;3;0;8
12251;Vėtrungė;Gudručių;26126038013;Taip;0;1;0;1
12252;Vėtrungė;Gudručių;58224525427;Taip;7;3;0;10
12253;Vėtrungė;Gudručių;88062307371;Taip;0;1;0;1
12254;Vėtrungė;Gudručių;96815788666;Taip;0;2;0;2
12255;Vėtrungė;Gudručių;68938242748;Taip;5;1;0;6
12256;Vėtrungė;Gudručių;6520234687;Ne;0;7;0;7
12257;Vėtrungė;Kodėlčių;1366458234;Taip;10;0;2;12
12258;Vėtrungė;Kodėlčių;1021458176;Taip;0;15;0;15
12259;Vėtrungė;Kodėlčių;1267104594;Taip;0;1;0;1
12260;Vėtrungė;Kodėlčių;1022530443;Taip;0;1;1;2
12261;Vėtrungė;Kodėlčių;1283685496;Taip;0;2;0;2
12262;Vėtrungė;Kodėlčių;20608668180;Taip;7;0;0;7
12263;Vėtrungė;Kodėlčių;3980104822;Taip;0;4;0;4
12264;Vėtrungė;Kodėlčių;49220186521;Taip;0;6;0;6
12265;Vėtrungė;Kodėlčių;41508942219;Taip;0;6;0;6
12266;Vėtrungė;Kodėlčių;1662123237;Taip;0;1;0;1
12267;Vėtrungė;Kodėlčių;1456877681;Taip;0;21;0;21
12268;Vėtrungė;Kodėlčių;1487142899;Taip;16;0;0;16
12269;Vėtrungė;Kodėlčių;19486911273;Taip;0;0;1;1
12270;Vėtrungė;Kodėlčių;56266349747;Taip;16;0;0;16
12271;Vėtrungė;Kodėlčių;9395706055;Taip;20;1;0;21
12272;Vėtrungė;Kodėlčių;4291687553;Taip;0;6;0;6
12273;Vėtrungė;Kodėlčių;18426639118;Taip;0;2;0;2
12274;Vėtrungė;Kodėlčių;1383686133;Taip;0;1;0;1
12275;Vėtrungė;Kodėlčių;6563805572;Taip;0;6;0;6
12276;Vėtrungė;Kodėlčių;1395153496;Taip;0;12;0;12
12277;Vėtrungė;Kodėlčių;8857763201;Taip;19;2;0;21
12278;Vėtrungė;Kodėlčių;8080668755;Taip;19;2;0;21
12279;Vėtrungė;Paukštelių;63512524250;Ne;5;0;6;11
12280;Vėtrungė;Paukštelių;1769926207;Taip;0;1;0;1
12281;Vėtrungė;Paukštelių;1322617786;Taip;17;0;0;17
12282;Vėtrungė;Paukštelių;2864217098;Taip;0;0;1;1
12283;Vėtrungė;Paukštelių;7921863675;Taip;0;6;0;6
12284;Vėtrungė;Paukštelių;4091719904;Taip;6;0;3;9
12285;Vėtrungė;Paukštelių;4347810256;Taip;7;0;0;7
12286;Vėtrungė;Paukštelių;8915159672;Taip;5;4;0;9
12287;Vėtrungė;Paukštelių;2482436192;Taip;7;1;1;9
12288;Vėtrungė;Paukštelių;6732632515;Taip;16;0;0;16
12289;Vėtrungė;Paukštelių;8897558066;Taip;0;0;2;2
12290;Vėtrungė;Paukštelių;3404120492;Taip;0;1;0;1
12291;Vėtrungė;Paukštelių;8154023892;Ne;18;0;0;18
12292;Vėtrungė;Paukštelių;3721504364;Taip;4;2;0;6
12293;Vėtrungė;Paukštelių;4115995882;Taip;0;6;0;6
12294;Vėtrungė;Paukštelių;1357603285;Taip;4;0;0;4
12295;Vėtrungė;Paukštelių;5994465833;Taip;0;3;1;4
12296;Vėtrungė;Paukštelių;8721035192;Ne;5;10;0;15
12297;Vėtrungė;Paukštelių;1970034012;Ne;11;7;0;18
12298;Vėtrungė;Paukštelių;40392900667;Ne;18;0;1;19
12299;Vėtrungė;Viščiukų;3744377479;Taip;2;0;1;3
12300;Vėtrungė;Viščiukų;4916692634;Taip;0;8;0;8
12301;Vėtrungė;Viščiukų;2447851565;Taip;8;0;0;8
12302;Vėtrungė;Viščiukų;2136966687;Taip;13;1;1;15
12303;Vėtrungė;Viščiukų;4197321604;Taip;17;0;0;17
12304;Vėtrungė;Viščiukų;8742161467;Taip;0;2;4;6
12305;Vėtrungė;Viščiukų;7558548846;Taip;15;0;0;15
12306;Vėtrungė;Viščiukų;1007578933;Taip;15;0;0;15
12307;Vėtrungė;Viščiukų;9893842192;Taip;8;0;0;8
12308;Vėtrungė;Viščiukų;3433811829;Taip;5;5;0;10
12309;Vėtrungė;Viščiukų;3634995652;Taip;2;1;0;3
12310;Vėtrungė;Viščiukų;5508759323;Taip;11;0;0;11
12311;Vėtrungė;Viščiukų;1255147376;Ne;0;1;0;1
12312;Vėtrungė;Viščiukų;5950287989;Taip;4;1;3;8
12313;Vėtrungė;Nykštukų;29699317546;Taip;4;0;8;12
12314;Vėtrungė;Nykštukų;1474010989;Ne;0;17;0;17
12315;Vėtrungė;Nykštukų;47141854213;Taip;5;9;0;14
12316;Vėtrungė;Nykštukų;1754493671;Ne;6;2;0;8
12317;Vėtrungė;Nykštukų;1843306606;Taip;6;4;0;10
12318;Vėtrungė;Nykštukų;1630866223;Taip;0;1;1;2
12319;Vėtrungė;Nykštukų;1529226569;Taip;0;1;0;1
12320;Vėtrungė;Nykštukų;1690268842;Taip;0;5;1;6
12321;Vėtrungė;Nykštukų;1279678980;Taip;0;1;0;1
12322;Vėtrungė;Nykštukų;1370336984;Taip;4;1;0;5
12323;Vėtrungė;Nykštukų;78016704795;Taip;0;5;0;5
12324;Vėtrungė;Nykštukų;68628872682;Taip;0;0;3;3
12325;Vėtrungė;Nykštukų;54494917364;Taip;0;1;0;1
12326;Vėtrungė;Nykštukų;87686013986;Taip;0;0;2;2
12327;Vėtrungė;Nykštukų;70610257897;Taip;0;2;0;2
12328;Vėtrungė;Nykštukų;2715736596;Taip;0;5;0;5
12329;Vėtrungė;Nykštukų;1744400765;Ne;11;7;0;18
12330;Vėtrungė;Nykštukų;1360031121;Taip;0;5;0;5
12331;Vėtrungė;Nykštukų;2145081325;Taip;2;0;10;12
12332;Vėtrungė;Nykštukų;2529102855;Taip;5;0;0;5
12333;Vėtrungė;Nykštukų;1611274573;Taip;0;12;0;12
12334;Vėtrungė;Nykštukų;9606769599;Ne;15;0;0;15
12335;Vėtrungė;Meškiukų;2510763357;Taip;16;0;0;16
12336;Vėtrungė;Meškiukų;4713420194;Taip;16;0;0;16
12337;Vėtrungė;Meškiukų;2226654309;Taip;16;1;0;17
12338;Vėtrungė;Meškiukų;7270370939;Taip;4;1;0;5
12339;Vėtrungė;Meškiukų;9543456295;Taip;9;0;0;9
12340;Vėtrungė;Meškiukų;9207846866;Taip;13;0;0;13
12341;Vėtrungė;Meškiukų;9065848425;Taip;0;9;0;9
12342;Vėtrungė;Meškiukų;3328447991;Taip;10;1;0;11
12343;Vėtrungė;Meškiukų;9685389270;Ne;0;15;0;15
12344;Vėtrungė;Meškiukų;9313438768;Taip;1;5;0;6
12345;Vėtrungė;Meškiukų;9070732925;Taip;0;4;0;4
12346;Vėtrungė;Meškiukų;3122948974;Taip;0;0;1;1
12347;Vėtrungė;Meškiukų;2414957010;Taip;0;12;0;12
12348;Vėtrungė;Meškiukų;2880342138;Taip;5;0;0;5
12349;Vėtrungė;Meškiukų;2520926439;Taip;0;1;2;3
12350;Vėtrungė;Meškiukų;7704497739;Taip;0;4;0;4
12351;Vėtrungė;Meškiukų;7143997258;Taip;16;0;0;16
12352;Vėtrungė;Meškiukų;5123894802;Taip;0;4;0;4
12353;Vėtrungė;Meškiukų;4394100006;Taip;0;0;12;12
12354;Vėtrungė;Meškiukų;8961791293;Taip;0;3;0;3
12355;Vėtrungė;Meškiukų;2809555356;Taip;17;0;0;17
12356;Vėtrungė;Ąžuoliukų;3249689008;Taip;0;4;0;4
12357;Vėtrungė;Ąžuoliukų;7295216791;Taip;0;1;1;2
12358;Vėtrungė;Ąžuoliukų;2440001662;Taip;9;0;1;10
12359;Vėtrungė;Ąžuoliukų;1636432189;Taip;6;0;0;6
12360;Vėtrungė;Ąžuoliukų;7803736567;Taip;7;3;0;10
12361;Vėtrungė;Ąžuoliukų;7129180154;Taip;3;0;0;3
12362;Vėtrungė;Ąžuoliukų;6356914122;Ne;0;18;0;18
12363;Vėtrungė;Ąžuoliukų;6479094819;Taip;15;1;0;16
12364;Vėtrungė;Ąžuoliukų;5367369908;Taip;6;0;0;6
12365;Vėtrungė;Ąžuoliukų;4000379945;Taip;0;5;0;5
12366;Vėtrungė;Ąžuoliukų;1789419548;Ne;0;9;0;9
12367;Vėtrungė;Ąžuoliukų;7363490503;Taip;0;4;0;4
12368;Vėtrungė;Ąžuoliukų;1082104060;Taip;0;13;0;13
12369;Vilnelė;Lakštutė;9657350714;Taip;0;6;0;6
12370;Vilnelė;Lakštutė;1720695615;Taip;0;1;0;1
12371;Vilnelė;Lakštutė;2121071276;Taip;8;0;0;8
12372;Vilnelė;Lakštutė;1065422209;Taip;8;1;4;13
12373;Vilnelė;Lakštutė;1607330769;Taip;0;5;0;5
12374;Vilnelė;Lakštutė;66992481918;Taip;6;1;0;7
12375;Vilnelė;Lakštutė;3316451889;Taip;0;1;0;1
12376;Vilnelė;Lakštutė;8820091584;Taip;5;0;0;5
12377;Vilnelė;Lakštutė;8270866998;Taip;0;14;0;14
12378;Vilnelė;Lakštutė;8593060923;Taip;0;0;4;4
12379;Vilnelė;Lakštutė;3454141069;Taip;16;0;0;16
12380;Vilnelė;Lakštutė;9618342480;Taip;0;2;0;2
12381;Vilnelė;Lakštutė;6155522893;Taip;0;4;0;4
12382;Vilnelė;Lakštutė;6318246517;Taip;1;10;1;12
12383;Vilnelė;Lakštutė;7387394504;Taip;14;0;0;14
12384;Vilnelė;Lakštutė;1882520335;Ne;0;1;0;1
12385;Vilnelė;Vyturėlis;5091272908;Taip;1;13;0;14
12386;Vilnelė;Vyturėlis;1133945467;Taip;13;1;0;14
12387;Vilnelė;Vyturėlis;6132739519;Ne;0;2;0;2
12388;Vilnelė;Vyturėlis;3009064105;Taip;5;0;0;5
12389;Vilnelė;Vyturėlis;1674551092;Taip;0;4;0;4
12390;Vilnelė;Vyturėlis;3743740372;Taip;5;0;0;5
12391;Vilnelė;Vyturėlis;2131599015;Taip;5;10;0;15
12392;Vilnelė;Vyturėlis;9460789751;Ne;11;0;0;11
12393;Vilnelė;Vyturėlis;18740103706;Taip;0;1;0;1
12394;Vilnelė;Vyturėlis;7057183482;Taip;18;0;0;18
12395;Vilnelė;Vyturėlis;8725191514;Taip;1;13;0;14
12396;Vilnelė;Vyturėlis;6308015852;Taip;0;4;0;4
12397;Vilnelė;Vyturėlis;7963783957;Taip;5;0;0;5
12398;Vilnelė;Vyturėlis;1545570307;Taip;0;3;0;3
12399;Vilnelė;Vyturėlis;5540359276;Taip;6;1;0;7
12400;Vilnelė;Vyturėlis;1966090625;Taip;0;1;0;1
12401;Vilnelė;Vyturėlis;8740717061;Taip;15;1;0;16
12402;Vilnelė;Vyturėlis;3772263873;Taip;0;5;1;6
12403;Vilnelė;Vyturėlis;9183391434;Taip;0;4;0;4
12404;Vilnelė;Vyturėlis;2159103903;Taip;0;1;0;1
12405;Vilnelė;Pagrandukas;59579013512;Taip;0;18;0;18
12406;Vilnelė;Pagrandukas;5480363267;Taip;0;2;1;3
12407;Vilnelė;Pagrandukas;2812680090;Taip;0;1;0;1
12408;Vilnelė;Pagrandukas;95852926101;Taip;4;0;0;4
12409;Vilnelė;Pagrandukas;1594154669;Ne;0;2;0;2
12410;Vilnelė;Pagrandukas;32662933313;Ne;0;0;4;4
12411;Vilnelė;Pagrandukas;1410511913;Taip;0;7;0;7
12412;Vilnelė;Pagrandukas;48926369907;Taip;0;0;1;1
12413;Vilnelė;Pagrandukas;13646307629;Taip;0;3;0;3
12414;Vilnelė;Pagrandukas;1680411448;Taip;8;1;4;13
12415;Vilnelė;Pagrandukas;1294194561;Taip;0;3;0;3
12416;Vilnelė;Pagrandukas;1111397062;Taip;0;2;0;2
12417;Vilnelė;Pagrandukas;54871985655;Taip;7;0;0;7
12418;Vilnelė;Pagrandukas;1733279710;Taip;0;0;2;2
12419;Vilnelė;Pagrandukas;91933747502;Taip;0;7;0;7
12420;Vilnelė;Pagrandukas;1346145809;Taip;0;0;2;2
12421;Vilnelė;Pagrandukas;1498777674;Taip;5;2;2;9
12422;Vilnelė;Pagrandukas;1932829642;Ne;8;0;0;8
12423;Vilnelė;Bitutė;77967081365;Taip;3;1;0;4
12424;Vilnelė;Bitutė;9643543101;Taip;8;2;0;10
12425;Vilnelė;Bitutė;78753442031;Taip;0;18;0;18
12426;Vilnelė;Bitutė;31701260922;Taip;7;5;0;12
12427;Vilnelė;Bitutė;95736417954;Taip;0;3;0;3
12428;Vilnelė;Bitutė;10333554439;Taip;0;4;0;4
12429;Vilnelė;Bitutė;2864763106;Taip;0;1;0;1
12430;Vilnelė;Bitutė;60707257606;Taip;0;1;0;1
12431;Vilnelė;Bitutė;96611892032;Taip;0;1;0;1
12432;Vilnelė;Bitutė;79700582010;Taip;5;1;0;6
12433;Vilnelė;Bitutė;985960052;Taip;0;3;0;3
12434;Vilnelė;Bitutė;624138880;Taip;0;1;0;1
12435;Vilnelė;Bitutė;87237045379;Taip;5;0;0;5
12436;Vilnelė;Bitutė;1051858780;Taip;11;0;2;13
12437;Vilnelė;Bitutė;2138907190;Taip;0;5;0;5
12438;Vilnelė;Bitutė;5936699300;Taip;5;4;0;9
12439;Vilnelė;Bitutė;77572611171;Taip;0;3;0;3
12440;Vilnelė;Bitutė;7442249956;Ne;18;0;0;18
12441;Vilnelė;Bitutė;1061139491;Taip;0;2;0;2
12442;Vilnelė;Šaltinėlis;1783854203;Taip;0;6;0;6
12443;Vilnelė;Šaltinėlis;5013418313;Taip;7;1;0;8
12444;Vilnelė;Šaltinėlis;42835212158;Taip;8;0;2;10
12445;Vilnelė;Šaltinėlis;98028664140;Taip;0;14;0;14
12446;Vilnelė;Šaltinėlis;11430703629;Taip;0;1;0;1
12447;Vilnelė;Šaltinėlis;7292043157;Taip;0;6;0;6
12448;Vilnelė;Šaltinėlis;6327531229;Taip;6;0;1;7
12449;Vilnelė;Šaltinėlis;10345875729;Taip;10;0;0;10
12450;Vilnelė;Šaltinėlis;1572818047;Taip;0;2;3;5
12451;Vilnelė;Šaltinėlis;2130482375;Taip;0;3;0;3
12452;Vilnelė;Šaltinėlis;4480175299;Taip;0;7;0;7
12453;Vilnelė;Šaltinėlis;9058632601;Taip;0;1;0;1
12454;Vilnelė;Šaltinėlis;1507865281;Taip;0;8;0;8
12455;Vilnelė;Šaltinėlis;39494954188;Taip;0;13;0;13
12456;Vilnelė;Šaltinėlis;8615257084;Taip;1;0;0;1
12457;Vilnelė;Šaltinėlis;6146514112;Taip;12;3;0;15
12458;Vilnelė;Šaltinėlis;1281521052;Taip;0;11;0;11
12459;Vilnelė;Šaltinėlis;5790420711;Taip;0;5;0;5
12460;Vilnelė;Riešutėllis;55974182996;Taip;11;0;0;11
12461;Vilnelė;Riešutėllis;85568332595;Taip;0;3;0;3
12462;Vilnelė;Riešutėllis;22516605873;Taip;0;5;0;5
12463;Vilnelė;Riešutėllis;64066480740;Taip;10;1;0;11
12464;Vilnelė;Riešutėllis;16272480270;Ne;0;2;0;2
12465;Vilnelė;Riešutėllis;1859757115;Taip;0;8;0;8
12466;Vilnelė;Riešutėllis;1450994872;Taip;0;0;1;1
12467;Vilnelė;Riešutėllis;9331404812;Taip;0;13;0;13
12468;Vilnelė;Riešutėllis;11702051319;Taip;15;1;0;16
12469;Vilnelė;Riešutėllis;41536662155;Taip;0;1;3;4
12470;Vilnelė;Riešutėllis;69413564937;Taip;0;4;0;4
12471;Vilnelė;Riešutėllis;71906228270;Taip;0;0;1;1
12472;Vilnelė;Riešutėllis;7916632244;Taip;0;4;0;4
12473;Vilnelė;Riešutėllis;20639648308;Taip;0;0;1;1
12474;Vilnelė;Riešutėllis;73658263243;Ne;11;4;0;15
12475;Vilnelė;Riešutėllis;8889469645;Taip;11;0;0;11
12476;Vilnelė;Riešutėllis;1522056886;Taip;6;0;0;6
12477;Vilnelė;Riešutėllis;1321202650;Taip;14;1;0;15
12478;Vilnelė;Riešutėllis;2696565855;Taip;5;1;1;7
12479;Vilnelė;Nykštukas;1336497125;Taip;4;2;0;6
12480;Vilnelė;Nykštukas;34859308729;Taip;14;0;0;14
12481;Vilnelė;Nykštukas;32988468324;Taip;0;11;0;11
12482;Vilnelė;Nykštukas;89748262997;Taip;1;16;0;17
12483;Vilnelė;Nykštukas;87406093438;Taip;1;16;0;17
12484;Vilnelė;Nykštukas;13583637193;Taip;0;7;0;7
12485;Vilnelė;Nykštukas;23442711820;Taip;0;1;0;1
12486;Vilnelė;Nykštukas;47863474499;Taip;0;2;0;2
12487;Vilnelė;Nykštukas;13231410969;Taip;0;1;0;1
12488;Vilnelė;Nykštukas;62208863766;Taip;0;6;0;6
12489;Vilnelė;Nykštukas;36905818484;Taip;0;6;0;6
12490;Vilnelė;Nykštukas;1845336128;Taip;0;1;0;1
12491;Vilnelė;Nykštukas;87094375121;Taip;0;4;0;4
12492;Vilnelė;Nykštukas;58422521907;Taip;0;1;0;1
12493;Vilnelė;Nykštukas;15265621906;Taip;0;4;0;4
12494;Vilnelė;Nykštukas;5198859945;Taip;0;10;0;10
12495;Vilnelė;Nykštukas;2097945353;Ne;0;1;0;1
12496;Vilnelė;Nykštukas;1957418704;Taip;7;1;0;8
12497;Vilnelė;Pieštukas;9879688569;Taip;0;11;0;11
12498;Vilnelė;Pieštukas;5473379559;Taip;6;1;0;7
12499;Vilnelė;Pieštukas;1462397783;Taip;6;1;2;9
12500;Vilnelė;Pieštukas;1792586468;Taip;0;1;0;1
12501;Vilnelė;Pieštukas;3781595939;Taip;0;9;0;9
12502;Vilnelė;Pieštukas;9884955712;Taip;0;1;0;1
12503;Vilnelė;Pieštukas;2479090686;Taip;0;1;0;1
12504;Vilnelė;Pieštukas;3945921490;Taip;0;19;0;19
12505;Vilnelė;Pieštukas;1975954784;Taip;4;0;0;4
12506;Vilnelė;Pieštukas;6798728562;Taip;5;8;0;13
12507;Vilnelė;Pieštukas;2859160609;Taip;4;3;0;7
12508;Vilnelė;Pieštukas;1730149127;Taip;0;8;0;8
12509;Vilnelė;Pieštukas;5778176840;Taip;10;0;1;11
12510;Vilnelė;Pieštukas;7976798775;Taip;0;1;0;1
12511;Vilnelė;Pieštukas;3811289758;Taip;0;16;0;16
12512;Vilnelė;Pieštukas;5261402753;Taip;10;9;0;19
12513;Vilnelė;Pieštukas;3529718234;Ne;6;1;0;7
12514;Vilnelė;Pieštukas;4129178478;Taip;0;1;0;1
12515;Vilnelė;Voverytė;4838684336;Ne;18;0;1;19
12516;Vilnelė;Voverytė;7536603663;Taip;0;10;0;10
12517;Vilnelė;Voverytė;3503461211;Ne;16;2;0;18
12518;Vilnelė;Voverytė;3993826389;Taip;0;0;1;1
12519;Vilnelė;Voverytė;7388336851;Taip;0;1;0;1
12520;Vilnelė;Voverytė;8667403338;Taip;0;4;0;4
12521;Vilnelė;Voverytė;7883724600;Taip;0;3;0;3
12522;Vilnelė;Voverytė;4166351390;Taip;10;0;1;11
12523;Vilnelė;Voverytė;1351798589;Taip;5;1;0;6
12524;Vilnelė;Voverytė;9162681538;Taip;0;2;0;2
12525;Vilnelė;Voverytė;3075681823;Taip;0;2;0;2
12526;Vilnelė;Voverytė;6342242777;Taip;0;1;0;1
12527;Vilnelė;Voverytė;3843064564;Taip;12;0;0;12
12528;Vilnelė;Voverytė;3558073399;Taip;13;0;0;13
12529;Vilnelė;Voverytė;2923012145;Taip;6;0;1;7
12530;Vilnelė;Voverytė;2841315531;Taip;0;0;3;3
12531;Vilnelė;Voverytė;9804772168;Taip;0;2;0;2
12532;Vilnelė;Voverytė;1596625263;Taip;3;0;0;3
12533;Vilnelė;Voverytė;7338573817;Taip;6;0;1;7
12534;Vilnelė;Voverytė;8121075430;Ne;8;2;0;10
12535;Vilnelė;Kodėlčiukas;85452254846;Taip;0;1;0;1
12536;Vilnelė;Kodėlčiukas;53049214510;Taip;0;3;0;3
12537;Vilnelė;Kodėlčiukas;6289991945;Taip;0;6;0;6
12538;Vilnelė;Kodėlčiukas;81657018187;Taip;0;13;0;13
12539;Vilnelė;Kodėlčiukas;1448257490;Taip;9;1;0;10
12540;Vilnelė;Kodėlčiukas;69532393507;Taip;0;3;0;3
12541;Vilnelė;Kodėlčiukas;1160794222;Taip;0;5;0;5
12542;Vilnelė;Kodėlčiukas;99580393765;Taip;0;6;0;6
12543;Vilnelė;Kodėlčiukas;36561742487;Taip;9;0;0;9
12544;Vilnelė;Kodėlčiukas;96900970284;Taip;0;8;0;8
12545;Vilnelė;Kodėlčiukas;85391221236;Taip;0;5;0;5
12546;Vilnelė;Kodėlčiukas;39412868538;Taip;0;4;0;4
12547;Vilnelė;Kodėlčiukas;67110179640;Ne;0;2;0;2
12548;Vilnelė;Kodėlčiukas;35546482171;Taip;5;2;0;7
12549;Vilnelė;Kodėlčiukas;90980722090;Taip;0;4;0;4
12550;Vilnelė;Kodėlčiukas;32819254615;Ne;11;0;0;11
12551;Vilnelė;Kodėlčiukas;24746064267;Taip;6;1;0;7
12552;Vilnelė;Žirniukas;6026600803;Taip;12;1;0;13
12553;Vilnelė;Žirniukas;1580287517;Taip;0;5;0;5
12554;Vilnelė;Žirniukas;8620789304;Taip;14;0;0;14
12555;Vilnelė;Žirniukas;8439505238;Taip;0;4;0;4
12556;Vilnelė;Žirniukas;6448119003;Taip;4;1;0;5
12557;Vilnelė;Žirniukas;1027463000;Ne;6;1;1;8
12558;Vilnelė;Žirniukas;5953205533;Taip;0;18;0;18
12559;Vilnelė;Žirniukas;4448413194;Taip;10;0;8;18
12560;Vilnelė;Žirniukas;6830433856;Ne;0;9;0;9
12561;Vilnelė;Žirniukas;7020707723;Taip;11;0;5;16
12562;Vilnelė;Žirniukas;5306723959;Taip;11;0;1;12
12563;Vilnelė;Žirniukas;5558378376;Taip;0;11;0;11
12564;Vilnelė;Žirniukas;4664946923;Taip;10;0;0;10
12565;Vilnelė;Žirniukas;1960860528;Taip;0;0;8;8
12566;Vilnelė;Žirniukas;3312254613;Taip;2;7;0;9
12567;Vilnelė;Pipiras;6659537454;Taip;0;2;0;2
12568;Vilnelė;Pipiras;9640330864;Taip;11;0;0;11
12569;Vilnelė;Pipiras;5961910077;Taip;15;0;0;15
12570;Vilnelė;Pipiras;4295816753;Taip;5;2;0;7
12571;Vilnelė;Pipiras;3848720970;Taip;0;2;0;2
12572;Vilnelė;Pipiras;9537740492;Taip;12;0;0;12
12573;Vilnelė;Pipiras;3670613082;Taip;17;0;0;17
12574;Vilnelė;Pipiras;3211657057;Taip;0;4;0;4
12575;Vilnelė;Pipiras;6417545510;Taip;6;0;0;6
12576;Vilnelė;Pipiras;7833531435;Taip;4;2;0;6
12577;Vilnelė;Pipiras;8717111488;Taip;0;2;0;2
12578;Vilnelė;Pipiras;5756690199;Taip;9;1;0;10
12579;Vilnelė;Pipiras;3056845279;Taip;0;18;0;18
12580;Vilnelė;Pipiras;7085972543;Taip;8;0;0;8
12581;Vilnelė;Pipiras;2144925171;Ne;5;0;0;5
12582;Vėrinėlis;GAIDELIAI;2529641529;Taip;8;5;0;13
12583;Vėrinėlis;GAIDELIAI;3729926575;Taip;21;0;0;21
12584;Vėrinėlis;GAIDELIAI;4390098560;Ne;6;0;0;6
12585;Vėrinėlis;GAIDELIAI;4666918175;Taip;0;0;1;1
12586;Vėrinėlis;GAIDELIAI;5429955166;Taip;10;1;0;11
12587;Vėrinėlis;GAIDELIAI;5209398043;Taip;0;1;0;1
12588;Vėrinėlis;GAIDELIAI;1060619471;Ne;19;0;0;19
12589;Vėrinėlis;GAIDELIAI;8885866108;Taip;5;0;1;6
12590;Vėrinėlis;GAIDELIAI;8213498951;Taip;0;6;0;6
12591;Vėrinėlis;GAIDELIAI;6136232912;Taip;11;2;0;13
12592;Vėrinėlis;GAIDELIAI;7092421890;Taip;5;0;0;5
12593;Vėrinėlis;GAIDELIAI;6058712578;Taip;5;0;0;5
12594;Vėrinėlis;GAIDELIAI;6496291933;Taip;2;10;0;12
12595;Vėrinėlis;GAIDELIAI;1164396960;Taip;0;0;5;5
12596;Vėrinėlis;GAIDELIAI;8091400240;Taip;0;1;1;2
12597;Vėrinėlis;GAIDELIAI;8728166391;Taip;13;0;0;13
12598;Vėrinėlis;GAIDELIAI;4415030161;Taip;2;8;0;10
12599;Vėrinėlis;GAIDELIAI;6413701823;Taip;5;0;0;5
12600;Vėrinėlis;SAULUTĖ;8755941866;Taip;13;0;3;16
12601;Vėrinėlis;SAULUTĖ;5434506594;Taip;0;11;0;11
12602;Vėrinėlis;SAULUTĖ;9751494612;Taip;0;0;4;4
12603;Vėrinėlis;SAULUTĖ;1897451825;Ne;0;5;0;5
12604;Vėrinėlis;SAULUTĖ;4727265555;Taip;0;12;0;12
12605;Vėrinėlis;SAULUTĖ;1047139776;Taip;0;1;0;1
12606;Vėrinėlis;SAULUTĖ;1493604303;Taip;21;0;0;21
12607;Vėrinėlis;SAULUTĖ;9500715949;Taip;2;0;1;3
12608;Vėrinėlis;SAULUTĖ;8922728881;Taip;0;0;2;2
12609;Vėrinėlis;SAULUTĖ;9391697537;Taip;3;0;0;3
12610;Vėrinėlis;SAULUTĖ;7071043164;Taip;2;5;0;7
12611;Vėrinėlis;SAULUTĖ;8620836106;Taip;16;0;0;16
12612;Vėrinėlis;SAULUTĖ;5003344894;Ne;0;0;3;3
12613;Vėrinėlis;SAULUTĖ;6866592245;Ne;8;0;0;8
12614;Vėrinėlis;SAULUTĖ;4183077476;Taip;0;12;0;12
12615;Vėrinėlis;SAULUTĖ;6906865967;Taip;8;8;0;16
12616;Vėrinėlis;SAULUTĖ;4925983616;Taip;4;0;2;6
12617;Vėrinėlis;SAULUTĖ;2732572235;Taip;4;1;1;6
12618;Vėrinėlis;SAULUTĖ;2633143128;Taip;5;0;0;5
12619;Vėrinėlis;NYKŠTUKAI;1518907235;Taip;0;1;1;2
12620;Vėrinėlis;NYKŠTUKAI;7978434812;Taip;5;0;6;11
12621;Vėrinėlis;NYKŠTUKAI;6065348004;Taip;0;3;0;3
12622;Vėrinėlis;NYKŠTUKAI;3563944204;Taip;11;0;1;12
12623;Vėrinėlis;NYKŠTUKAI;7436873997;Ne;1;8;0;9
12624;Vėrinėlis;NYKŠTUKAI;63333257753;Taip;0;1;0;1
12625;Vėrinėlis;NYKŠTUKAI;1592544116;Taip;0;0;4;4
12626;Vėrinėlis;NYKŠTUKAI;1261337457;Taip;5;0;8;13
12627;Vėrinėlis;NYKŠTUKAI;11459693163;Taip;21;0;0;21
12628;Vėrinėlis;NYKŠTUKAI;38428514086;Ne;8;0;0;8
12629;Vėrinėlis;NYKŠTUKAI;27431479888;Taip;5;1;1;7
12630;Vėrinėlis;NYKŠTUKAI;41029899086;Ne;0;0;2;2
12631;Vėrinėlis;NYKŠTUKAI;2001903188;Ne;1;0;2;3
12632;Vėrinėlis;NYKŠTUKAI;1251822610;Ne;0;1;0;1
12633;Vėrinėlis;NYKŠTUKAI;8755231814;Taip;0;0;1;1
12634;Vėrinėlis;NYKŠTUKAI;9604483237;Taip;0;0;1;1
12635;Vėrinėlis;NYKŠTUKAI;9719933940;Ne;0;0;7;7
12636;Vėrinėlis;BURATINAS;65408541019;Ne;16;3;0;19
12637;Vėrinėlis;BURATINAS;3703886468;Taip;9;1;0;10
12638;Vėrinėlis;BURATINAS;57498275265;Taip;0;8;0;8
12639;Vėrinėlis;BURATINAS;54666417396;Taip;0;5;0;5
12640;Vėrinėlis;BURATINAS;4067153819;Taip;0;1;0;1
12641;Vėrinėlis;BURATINAS;1103951120;Ne;8;0;0;8
12642;Vėrinėlis;BURATINAS;1170817811;Taip;9;1;0;10
12643;Vėrinėlis;BURATINAS;73256255966;Taip;9;0;0;9
12644;Vėrinėlis;BURATINAS;22726982138;Taip;0;0;2;2
12645;Vėrinėlis;BURATINAS;89785057363;Taip;0;15;0;15
12646;Vėrinėlis;BURATINAS;25071096491;Taip;0;3;0;3
12647;Vėrinėlis;BURATINAS;90264493281;Ne;0;9;0;9
12648;Vėrinėlis;BURATINAS;90979069296;Taip;5;0;1;6
12649;Vėrinėlis;BURATINAS;1028568095;Taip;0;1;1;2
12650;Vėrinėlis;BURATINAS;67282950717;Taip;0;0;6;6
12651;Vėrinėlis;BURATINAS;7431541945;Taip;0;2;0;2
12652;Vėrinėlis;BURATINAS;67987598880;Taip;0;1;2;3
12653;Vėrinėlis;BURATINAS;9266953028;Taip;0;6;0;6
12654;Vėrinėlis;BURATINAS;4789626884;Taip;10;1;0;11
12655;Vėrinėlis;GINTARĖLIAI;79005449877;Taip;0;2;0;2
12656;Vėrinėlis;GINTARĖLIAI;3183131197;Taip;0;1;0;1
12657;Vėrinėlis;GINTARĖLIAI;2023475725;Taip;0;6;0;6
12658;Vėrinėlis;GINTARĖLIAI;1028694005;Taip;0;1;1;2
12659;Vėrinėlis;GINTARĖLIAI;1465052758;Taip;21;0;0;21
12660;Vėrinėlis;GINTARĖLIAI;97559214584;Taip;0;1;3;4
12661;Vėrinėlis;GINTARĖLIAI;7819933209;Taip;6;0;0;6
12662;Vėrinėlis;GINTARĖLIAI;762270610;Taip;0;0;3;3
12663;Vėrinėlis;GINTARĖLIAI;78121632796;Taip;0;2;0;2
12664;Vėrinėlis;GINTARĖLIAI;99325931907;Taip;0;12;0;12
12665;Vėrinėlis;GINTARĖLIAI;5238619411;Taip;0;1;0;1
12666;Vėrinėlis;GINTARĖLIAI;668239862;Taip;0;1;0;1
12667;Vėrinėlis;GINTARĖLIAI;8197177876;Taip;0;3;0;3
12668;Vėrinėlis;GINTARĖLIAI;22535431362;Taip;0;1;0;1
12669;Vėrinėlis;GINTARĖLIAI;1804757495;Taip;2;0;0;2
12670;Vėrinėlis;GINTARĖLIAI;1029210296;Taip;6;5;0;11
12671;Vėrinėlis;GINTARĖLIAI;1791124205;Taip;0;1;0;1
12672;Vėrinėlis;GINTARĖLIAI;92480758419;Ne;0;2;2;4
12673;Vėrinėlis;GINTARĖLIAI;8955109359;Ne;0;1;1;2
12674;Vėrinėlis;RAMUNĖLĖS;6738189242;Taip;0;0;1;1
12675;Vėrinėlis;RAMUNĖLĖS;1292880457;Taip;0;1;1;2
12676;Vėrinėlis;RAMUNĖLĖS;1133491927;Taip;10;1;0;11
12677;Vėrinėlis;RAMUNĖLĖS;1268710930;Taip;0;2;0;2
12678;Vėrinėlis;RAMUNĖLĖS;1477336890;Taip;0;7;0;7
12679;Vėrinėlis;RAMUNĖLĖS;25415760747;Taip;0;3;0;3
12680;Vėrinėlis;RAMUNĖLĖS;6004379115;Taip;0;3;0;3
12681;Vėrinėlis;RAMUNĖLĖS;1803838403;Taip;5;1;0;6
12682;Vėrinėlis;RAMUNĖLĖS;71830611159;Taip;7;0;0;7
12683;Vėrinėlis;RAMUNĖLĖS;39153716711;Taip;0;4;0;4
12684;Vėrinėlis;RAMUNĖLĖS;11343969028;Taip;15;2;0;17
12685;Vėrinėlis;RAMUNĖLĖS;1086306523;Ne;6;0;2;8
12686;Vėrinėlis;RAMUNĖLĖS;1408704528;Taip;0;10;1;11
12687;Vėrinėlis;RAMUNĖLĖS;1239744245;Taip;0;10;1;11
12688;Vėrinėlis;RAMUNĖLĖS;6148700823;Taip;0;6;0;6
12689;Vėrinėlis;RAMUNĖLĖS;4680688747;Ne;11;0;1;12
12690;Vėrinėlis;KODELČIUKŲ;1410929889;Taip;0;6;0;6
12691;Vėrinėlis;KODELČIUKŲ;1001125426;Taip;6;0;2;8
12692;Vėrinėlis;KODELČIUKŲ;42875958735;Ne;0;2;0;2
12693;Vėrinėlis;KODELČIUKŲ;25734061057;Taip;2;0;0;2
12694;Vėrinėlis;KODELČIUKŲ;68027880109;Taip;3;0;0;3
12695;Vėrinėlis;KODELČIUKŲ;1876456237;Taip;0;6;0;6
12696;Vėrinėlis;KODELČIUKŲ;12363691267;Taip;4;1;0;5
12697;Vėrinėlis;KODELČIUKŲ;3044373634;Taip;5;0;0;5
12698;Vėrinėlis;KODELČIUKŲ;24888549934;Taip;0;8;0;8
12699;Vėrinėlis;KODELČIUKŲ;38831165210;Taip;0;11;0;11
12700;Vėrinėlis;KODELČIUKŲ;37600982027;Ne;0;2;0;2
12701;Vėrinėlis;KODELČIUKŲ;79317384797;Taip;0;4;0;4
12702;Vėrinėlis;KODELČIUKŲ;1953362884;Taip;5;0;0;5
12703;Vėrinėlis;KODELČIUKŲ;58909000723;Taip;0;1;1;2
12704;Vėrinėlis;KODELČIUKŲ;1907101316;Taip;0;6;0;6
12705;Vėrinėlis;KODELČIUKŲ;8978798314;Taip;13;1;0;14
12706;Vėrinėlis;ŽIRNIUKAI;3074835599;Ne;16;0;0;16
12707;Vėrinėlis;ŽIRNIUKAI;1769852084;Taip;9;0;1;10
12708;Vėrinėlis;ŽIRNIUKAI;4718732261;Taip;0;1;0;1
12709;Vėrinėlis;ŽIRNIUKAI;4981127515;Taip;5;0;0;5
12710;Vėrinėlis;ŽIRNIUKAI;7845985650;Ne;1;0;3;4
12711;Vėrinėlis;ŽIRNIUKAI;2815770695;Taip;19;2;0;21
12712;Vėrinėlis;ŽIRNIUKAI;9419245081;Taip;10;2;0;12
12713;Vėrinėlis;ŽIRNIUKAI;8329989952;Taip;10;0;1;11
12714;Vėrinėlis;ŽIRNIUKAI;3202518504;Taip;0;0;1;1
12715;Vėrinėlis;ŽIRNIUKAI;8824435889;Taip;2;0;0;2
12716;Vėrinėlis;ŽIRNIUKAI;4752902173;Taip;0;1;0;1
12717;Vėrinėlis;ŽIRNIUKAI;7237945125;Taip;0;0;1;1
12718;Vėrinėlis;ŽIRNIUKAI;5600815908;Taip;8;0;1;9
12719;Vėrinėlis;ŽIRNIUKAI;6779005350;Ne;1;0;2;3
12720;Vėrinėlis;ŽIRNIUKAI;7367485961;Taip;0;0;1;1
12721;Vėrinėlis;ŽIRNIUKAI;6576726481;Taip;1;0;1;2
12722;Vėrinėlis;ŽIRNIUKAI;8397025332;Taip;1;0;1;2
12723;Vėrinėlis;ŽIRNIUKAI;9340167973;Taip;5;7;0;12
12724;Vėrinėlis;ŽIRNIUKAI;1736733257;Ne;21;0;0;21
12725;Vėrinėlis;ŽIRNIUKAI;2687583764;Taip;0;0;3;3
12726;Vėrinėlis;VARPELIAI;3316897176;Taip;5;0;2;7
12727;Vėrinėlis;VARPELIAI;7471147288;Taip;6;0;2;8
12728;Vėrinėlis;VARPELIAI;9289003583;Taip;0;10;0;10
12729;Vėrinėlis;VARPELIAI;1684203955;Taip;0;10;0;10
12730;Vėrinėlis;VARPELIAI;3882915774;Taip;8;3;0;11
12731;Vėrinėlis;VARPELIAI;7273090217;Taip;4;0;0;4
12732;Vėrinėlis;VARPELIAI;7233139048;Taip;0;0;2;2
12733;Vėrinėlis;VARPELIAI;3130841241;Taip;20;0;0;20
12734;Vėrinėlis;VARPELIAI;6435612222;Taip;0;0;2;2
12735;Vėrinėlis;VARPELIAI;2337883071;Taip;7;0;4;11
12736;Vėrinėlis;VARPELIAI;6913001318;Ne;8;3;0;11
12737;Vėrinėlis;VARPELIAI;4728119881;Taip;0;0;1;1
12738;Vėrinėlis;VARPELIAI;7224418233;Taip;0;17;0;17
12739;Vėrinėlis;VARPELIAI;1894717954;Taip;0;0;3;3
12740;Vėrinėlis;VARPELIAI;3667953591;Taip;9;0;0;9
12741;Vėrinėlis;VARPELIAI;4191386053;Taip;0;4;0;4
12742;Vėrinėlis;VARPELIAI;2090334618;Taip;10;0;0;10
12743;Vėrinėlis;BORUŽĖLĖS;8759487574;Taip;6;7;0;13
12744;Vėrinėlis;BORUŽĖLĖS;4819016753;Ne;2;0;1;3
12745;Vėrinėlis;BORUŽĖLĖS;1910385020;Taip;12;0;0;12
12746;Vėrinėlis;BORUŽĖLĖS;2078857084;Taip;5;0;0;5
12747;Vėrinėlis;BORUŽĖLĖS;3934652683;Taip;11;0;1;12
12748;Vėrinėlis;BORUŽĖLĖS;6904733283;Taip;16;0;0;16
12749;Vėrinėlis;BORUŽĖLĖS;4446546335;Taip;0;0;1;1
12750;Vėrinėlis;BORUŽĖLĖS;3718510933;Taip;6;0;0;6
12751;Vėrinėlis;BORUŽĖLĖS;2501287529;Taip;5;2;0;7
12752;Vėrinėlis;BORUŽĖLĖS;8904833339;Taip;6;2;0;8
12753;Vėrinėlis;BORUŽĖLĖS;3312501759;Taip;6;2;0;8
12754;Vėrinėlis;BORUŽĖLĖS;9217188911;Taip;5;13;0;18
12755;Vėrinėlis;BORUŽĖLĖS;7414937335;Taip;0;10;0;10
12756;Vėrinėlis;BORUŽĖLĖS;2574507205;Taip;14;0;0;14
12757;Vėrinėlis;BORUŽĖLĖS;6671382987;Taip;0;0;7;7
12758;Vėrinėlis;SVEIKUOLIAI;87606501349;Taip;5;0;1;6
12759;Vėrinėlis;SVEIKUOLIAI;19865450007;Taip;6;0;0;6
12760;Vėrinėlis;SVEIKUOLIAI;6869951613;Taip;0;1;5;6
12761;Vėrinėlis;SVEIKUOLIAI;1395590011;Ne;21;0;0;21
12762;Vėrinėlis;SVEIKUOLIAI;3975934329;Taip;0;0;1;1
12763;Vėrinėlis;SVEIKUOLIAI;9751037428;Ne;0;9;0;9
12764;Vėrinėlis;SVEIKUOLIAI;1513856520;Taip;10;0;2;12
12765;Vėrinėlis;SVEIKUOLIAI;3562371502;Taip;1;0;5;6
12766;Vėrinėlis;SVEIKUOLIAI;4089567420;Ne;3;0;2;5
12767;Vėrinėlis;SVEIKUOLIAI;5960946826;Taip;11;0;2;13
12768;Vėrinėlis;SVEIKUOLIAI;5496928903;Ne;7;0;2;9
12769;Vėrinėlis;SVEIKUOLIAI;7865276052;Taip;12;0;2;14
12770;Vėrinėlis;SVEIKUOLIAI;7981261038;Taip;10;4;1;15
12771;Vėrinėlis;SVEIKUOLIAI;6278738058;Taip;4;0;2;6
12772;Vėrinėlis;SVEIKUOLIAI;5511584499;Taip;10;0;0;10
12773;Vėrinėlis;SVEIKUOLIAI;6644892686;Taip;7;7;1;15
12774;Vėrinėlis;SVEIKUOLIAI;4958359640;Taip;0;10;3;13
12775;Vėrinėlis;SVEIKUOLIAI;1338287524;Taip;6;4;0;10
12776;Vėrinėlis;SVEIKUOLIAI;8579819581;Taip;16;2;0;18
12777;Vėrinėlis;SVEIKUOLIAI;6220653152;Taip;6;3;0;9
12778;Vėrinėlis;ŠIRDELĖS;2944010445;Taip;0;14;0;14
12779;Vėrinėlis;ŠIRDELĖS;8195455092;Taip;0;1;0;1
12780;Vėrinėlis;ŠIRDELĖS;96779456411;Taip;0;2;0;2
12781;Vėrinėlis;ŠIRDELĖS;7167034587;Taip;0;2;0;2
12782;Vėrinėlis;ŠIRDELĖS;5712568063;Ne;11;0;0;11
12783;Vėrinėlis;ŠIRDELĖS;3049346950;Taip;0;0;21;21
12784;Vėrinėlis;ŠIRDELĖS;7070058961;Taip;5;2;0;7
12785;Vėrinėlis;ŠIRDELĖS;7130691686;Taip;14;0;0;14
12786;Vėrinėlis;ŠIRDELĖS;8709714647;Taip;3;11;0;14
12787;Vėrinėlis;ŠIRDELĖS;3308843618;Taip;0;0;4;4
12788;Vėrinėlis;ŠIRDELĖS;85262495209;Ne;0;8;0;8
12789;Vėrinėlis;ŠIRDELĖS;4039903678;Taip;10;0;4;14
12790;Vėrinėlis;ŠIRDELĖS;9119967823;Taip;5;0;0;5
12791;Vėrinėlis;ŠIRDELĖS;1467899937;Taip;0;0;5;5
12792;Vėrinėlis;ŠIRDELĖS;7634939364;Taip;10;0;1;11
12793;Vėrinėlis;ŠIRDELĖS;54361215161;Taip;3;0;1;4
12794;Vėrinėlis;ŠIRDELĖS;1535567719;Taip;6;4;0;10
12795;Vėrinėlis;ŠIRDELĖS;8652292752;Taip;6;4;0;10
12796;Vėrinėlis;ŠIRDELĖS;2231062782;Taip;3;0;0;3
12797;Viltenė;Drugeliai;79464006792;Taip;0;2;0;2
12798;Viltenė;Drugeliai;70813966825;Taip;0;6;0;6
12799;Viltenė;Drugeliai;50489733849;Ne;0;1;0;1
12800;Viltenė;Drugeliai;69838945768;Ne;6;0;0;6
12801;Viltenė;Drugeliai;54422258148;Taip;7;0;0;7
12802;Viltenė;Drugeliai;4322306031;Taip;0;8;0;8
12803;Viltenė;Drugeliai;82849073169;Taip;0;1;0;1
12804;Viltenė;Drugeliai;39676814294;Ne;5;4;0;9
12805;Viltenė;Drugeliai;47885567334;Taip;0;16;0;16
12806;Viltenė;Drugeliai;45275376273;Taip;0;2;0;2
12807;Viltenė;Drugeliai;1155378470;Taip;0;1;0;1
12808;Viltenė;Drugeliai;68110722913;Taip;0;1;0;1
12809;Viltenė;Drugeliai;16461652415;Taip;5;3;0;8
12810;Viltenė;Drugeliai;91847807834;Taip;0;1;0;1
12811;Viltenė;Drugeliai;34691221253;Ne;5;3;0;8
12812;Viltenė;Drugeliai;75637599543;Taip;0;1;0;1
12813;Viltenė;Drugeliai;33159619580;Taip;5;1;0;6
12814;Viltenė;Drugeliai;4586042895;Taip;0;1;0;1
12815;Viltenė;Drugeliai;7169597620;Taip;6;1;0;7
12816;Viltenė;Drugeliai;25504337581;Taip;0;1;0;1
12817;Viltenė;Drugeliai;1739353382;Taip;0;4;0;4
12818;Viltenė;Bitučių;21665885641;Taip;0;1;0;1
12819;Viltenė;Bitučių;1747442313;Taip;0;1;0;1
12820;Viltenė;Bitučių;61093082990;Ne;0;2;0;2
12821;Viltenė;Bitučių;13157765051;Taip;5;3;0;8
12822;Viltenė;Bitučių;46245753187;Taip;6;0;0;6
12823;Viltenė;Bitučių;2046122804;Taip;0;6;0;6
12824;Viltenė;Bitučių;74464437862;Taip;0;5;0;5
12825;Viltenė;Bitučių;66587678111;Taip;9;0;0;9
12826;Viltenė;Bitučių;65252989761;Taip;3;0;0;3
12827;Viltenė;Bitučių;84451732377;Taip;0;1;0;1
12828;Viltenė;Bitučių;1702925444;Taip;0;7;0;7
12829;Viltenė;Bitučių;1165480440;Taip;0;2;0;2
12830;Viltenė;Bitučių;6006470515;Taip;0;1;0;1
12831;Viltenė;Bitučių;1798739406;Taip;5;0;0;5
12832;Viltenė;Bitučių;1656026241;Taip;7;0;0;7
12833;Viltenė;Bitučių;4554162475;Taip;0;6;0;6
12834;Viltenė;Bitučių;1291605426;Taip;0;1;0;1
12835;Viltenė;Bitučių;6322746293;Taip;0;4;0;4
12836;Viltenė;Bitučių;4334881910;Taip;0;5;0;5
12837;Viltenė;Bitučių;9068349987;Ne;0;11;0;11
12838;Viltenė;Boružėlių;3777544301;Taip;0;3;0;3
12839;Viltenė;Boružėlių;6642790962;Taip;18;0;0;18
12840;Viltenė;Boružėlių;9572407405;Taip;0;3;0;3
12841;Viltenė;Boružėlių;3738838707;Taip;0;1;0;1
12842;Viltenė;Boružėlių;8473588098;Taip;2;8;0;10
12843;Viltenė;Boružėlių;3995418079;Taip;19;0;0;19
12844;Viltenė;Boružėlių;1399653129;Taip;0;6;0;6
12845;Viltenė;Boružėlių;7526555727;Taip;9;5;0;14
12846;Viltenė;Boružėlių;5379804362;Taip;0;5;0;5
12847;Viltenė;Boružėlių;1936628249;Taip;0;9;0;9
12848;Viltenė;Boružėlių;4003018966;Taip;11;0;0;11
12849;Viltenė;Boružėlių;7912396297;Taip;0;1;0;1
12850;Viltenė;Boružėlių;4036109404;Taip;0;8;0;8
12851;Viltenė;Boružėlių;4604298036;Taip;0;9;0;9
12852;Viltenė;Boružėlių;9197007374;Taip;0;7;0;7
12853;Viltenė;Boružėlių;9242034622;Taip;0;1;0;1
12854;Viltenė;Boružėlių;6621273812;Taip;0;3;0;3
12855;Viltenė;Boružėlių;2383607612;Taip;7;0;0;7
12856;Viltenė;Boružėlių;1496943250;Taip;0;5;0;5
12857;Viltenė;Gandriukų;6481491422;Taip;11;0;0;11
12858;Viltenė;Gandriukų;2452782594;Taip;7;0;0;7
12859;Viltenė;Gandriukų;9217178863;Ne;0;2;0;2
12860;Viltenė;Gandriukų;1126409020;Taip;0;5;0;5
12861;Viltenė;Gandriukų;2884698447;Taip;0;4;0;4
12862;Viltenė;Gandriukų;6060648988;Taip;7;3;0;10
12863;Viltenė;Gandriukų;1840626621;Taip;0;1;0;1
12864;Viltenė;Gandriukų;8549631247;Taip;5;1;0;6
12865;Viltenė;Gandriukų;7796422726;Taip;0;1;0;1
12866;Viltenė;Gandriukų;2815105107;Taip;5;3;0;8
12867;Viltenė;Gandriukų;6511850468;Taip;10;0;0;10
12868;Viltenė;Gandriukų;5850652322;Taip;3;3;0;6
12869;Viltenė;Gandriukų;8110413064;Taip;0;1;0;1
12870;Viltenė;Gandriukų;1243595112;Taip;5;0;0;5
12871;Viltenė;Gandriukų;4388770140;Taip;0;2;0;2
12872;Viltenė;Gandriukų;3073228245;Taip;18;0;0;18
12873;Viltenė;Gandriukų;4468743044;Taip;21;0;0;21
12874;Viltenė;Gandriukų;6355857716;Ne;0;7;0;7
12875;Viltenė;Gandriukų;7274368180;Taip;16;0;0;16
12876;Viltenė;Aitvariukai;51598096361;Taip;0;2;0;2
12877;Viltenė;Aitvariukai;15218988953;Taip;0;8;0;8
12878;Viltenė;Aitvariukai;9155192250;Taip;5;15;0;20
12879;Viltenė;Aitvariukai;9611851889;Ne;0;1;0;1
12880;Viltenė;Aitvariukai;5304966336;Taip;8;0;0;8
12881;Viltenė;Aitvariukai;3057761137;Ne;8;1;1;10
12882;Viltenė;Aitvariukai;6160715081;Taip;21;0;0;21
12883;Viltenė;Aitvariukai;5919786939;Taip;0;3;0;3
12884;Viltenė;Aitvariukai;17844870669;Taip;0;5;0;5
12885;Viltenė;Aitvariukai;56293220882;Taip;5;3;0;8
12886;Viltenė;Aitvariukai;96366849694;Ne;0;1;0;1
12887;Viltenė;Aitvariukai;8259812812;Taip;0;1;0;1
12888;Viltenė;Aitvariukai;23233966729;Taip;4;2;1;7
12889;Viltenė;Aitvariukai;44367763042;Taip;0;1;3;4
12890;Viltenė;Aitvariukai;99398043638;Taip;6;6;0;12
12891;Viltenė;Aitvariukai;1712349973;Taip;0;1;0;1
12892;Viltenė;Aitvariukai;55514676697;Taip;6;6;0;12
12893;Viltenė;Aitvariukai;14831307307;Taip;0;1;0;1
12894;Viltenė;Aitvariukai;70963916697;Taip;0;1;0;1
12895;Viltenė;Aitvariukai;5297513672;Taip;0;1;2;3
12896;Viltenė;Geniukų;5604263567;Taip;11;0;0;11
12897;Viltenė;Geniukų;1822220265;Ne;3;2;0;5
12898;Viltenė;Geniukų;9613791189;Taip;3;4;0;7
12899;Viltenė;Geniukų;6349032936;Taip;0;1;0;1
12900;Viltenė;Geniukų;1423254631;Ne;3;1;0;4
12901;Viltenė;Geniukų;3002690526;Taip;5;3;0;8
12902;Viltenė;Geniukų;6276349499;Taip;0;2;0;2
12903;Viltenė;Geniukų;3711956659;Taip;0;2;0;2
12904;Viltenė;Geniukų;1054469254;Taip;9;1;0;10
12905;Viltenė;Geniukų;4295285885;Taip;0;9;0;9
12906;Viltenė;Geniukų;6063181025;Taip;9;1;0;10
12907;Viltenė;Geniukų;1672091332;Taip;4;0;0;4
12908;Viltenė;Geniukų;9396183748;Taip;5;0;0;5
12909;Viltenė;Geniukų;3018271511;Taip;4;2;0;6
12910;Viltenė;Geniukų;49998813869;Taip;5;1;0;6
12911;Viltenė;Geniukų;3389110405;Taip;6;1;0;7
12912;Viltenė;Geniukų;4319685140;Taip;0;5;0;5
12913;Viltenė;Geniukų;8329611036;Ne;0;5;0;5
12914;Viltenė;Geniukų;8125023386;Taip;10;2;0;12
12915;Viltenė;Geniukų;9035687504;Ne;3;1;0;4
12916;Viltenė;Geniukų;1629377078;Taip;0;13;0;13
12917;Viltenė;Geniukų;4104052524;Ne;0;1;0;1
12918;Viltenė;Saulutės;2044754943;Taip;0;2;0;2
12919;Viltenė;Saulutės;6848403057;Taip;0;15;0;15
12920;Viltenė;Saulutės;1615415742;Taip;0;7;0;7
12921;Viltenė;Saulutės;7994367286;Ne;4;0;0;4
12922;Viltenė;Saulutės;9935236068;Taip;6;0;0;6
12923;Viltenė;Saulutės;6664059418;Taip;0;2;0;2
12924;Viltenė;Saulutės;2141002432;Taip;0;6;0;6
12925;Viltenė;Saulutės;1362308882;Taip;0;1;0;1
12926;Viltenė;Saulutės;8920533673;Ne;10;0;0;10
12927;Viltenė;Saulutės;5024192785;Taip;0;9;0;9
12928;Viltenė;Saulutės;92968672028;Taip;0;1;0;1
12929;Viltenė;Saulutės;1918867591;Taip;0;6;0;6
12930;Viltenė;Saulutės;7559243300;Taip;0;1;0;1
12931;Viltenė;Saulutės;8512665706;Taip;0;1;0;1
12932;Viltenė;Saulutės;3560474943;Taip;0;5;0;5
12933;Viltenė;Saulutės;2840208662;Taip;5;1;0;6
12934;Viltenė;Saulutės;1252657362;Taip;4;0;0;4
12935;Viltenė;Saulutės;2559945034;Taip;2;1;0;3
12936;Viltenė;Saulutės;2546789906;Taip;15;0;0;15
12937;Viltenė;Saulutės;9858998005;Taip;7;0;0;7
12938;Viltenė;Saulutės;7726650894;Taip;0;4;0;4
12939;Viltenė;Saulutės;3709362712;Taip;10;1;0;11
12940;Viltenė;Saulutės;1841732416;Taip;0;3;0;3
12941;Viltenė;Saulutės;3008272979;Taip;0;10;0;10
12942;Viltenė;Lapiukų;2016636764;Taip;0;4;0;4
12943;Viltenė;Lapiukų;1650304982;Taip;0;1;2;3
12944;Viltenė;Lapiukų;89844531860;Taip;0;3;0;3
12945;Viltenė;Lapiukų;8261531943;Taip;0;2;0;2
12946;Viltenė;Lapiukų;60092202534;Taip;0;6;0;6
12947;Viltenė;Lapiukų;22318027000;Taip;0;2;0;2
12948;Viltenė;Lapiukų;1559623914;Taip;0;5;0;5
12949;Viltenė;Lapiukų;1503728117;Taip;0;13;0;13
12950;Viltenė;Lapiukų;1042196397;Taip;15;0;0;15
12951;Viltenė;Lapiukų;1210824560;Taip;0;8;0;8
12952;Viltenė;Lapiukų;2065651722;Taip;12;0;0;12
12953;Viltenė;Lapiukų;87698700338;Taip;0;1;0;1
12954;Viltenė;Lapiukų;3526237179;Taip;11;0;1;12
12955;Viltenė;Lapiukų;1662950901;Taip;0;3;0;3
12956;Viltenė;Lapiukų;1350487577;Taip;6;3;0;9
12957;Viltenė;Lapiukų;1592077335;Taip;6;0;1;7
12958;Viltenė;Lapiukų;1281808784;Ne;5;2;0;7
12959;Viltenė;Lapiukų;1726174128;Taip;10;1;0;11
12960;Viltenė;Lapiukų;4470172666;Taip;10;2;0;12
12961;Viltenė;Lapiukų;2527648089;Taip;0;3;0;3
12962;Viltenė;Lapiukų;93894985640;Ne;0;7;0;7
12963;Viltenė;Lapiukų;3259114583;Taip;0;1;1;2
12964;Viltenė;Voveriukai;8732323660;Taip;0;11;0;11
12965;Viltenė;Voveriukai;13795858727;Ne;7;3;0;10
12966;Viltenė;Voveriukai;1306624353;Taip;0;1;0;1
12967;Viltenė;Voveriukai;41763338811;Taip;7;1;0;8
12968;Viltenė;Voveriukai;46757944454;Ne;5;9;0;14
12969;Viltenė;Voveriukai;69918162258;Taip;0;2;0;2
12970;Viltenė;Voveriukai;76569470768;Taip;0;1;0;1
12971;Viltenė;Voveriukai;1262222404;Ne;6;2;0;8
12972;Viltenė;Voveriukai;7245395388;Ne;0;1;0;1
12973;Viltenė;Voveriukai;77847693433;Taip;0;2;0;2
12974;Viltenė;Voveriukai;46252876577;Taip;0;3;0;3
12975;Viltenė;Voveriukai;92175043385;Taip;0;8;0;8
12976;Viltenė;Voveriukai;35466181637;Ne;0;8;0;8
12977;Viltenė;Voveriukai;54346881662;Taip;5;0;0;5
12978;Viltenė;Voveriukai;68243828276;Taip;0;2;0;2
12979;Viltenė;Voveriukai;1615151982;Taip;0;1;0;1
12980;Viltenė;Voveriukai;87296434240;Taip;6;2;0;8
12981;Viltenė;Voveriukai;51997485918;Ne;0;9;0;9
12982;Viltenė;Voveriukai;1872042290;Taip;0;4;0;4
12983;Viltenė;Voveriukai;1926586646;Ne;0;1;0;1
12984;Viltenė;Voveriukai;2008408325;Ne;0;11;0;11
12985;Viltenė;Triušikai;9756519374;Taip;0;5;0;5
12986;Viltenė;Triušikai;7928894276;Taip;16;0;0;16
12987;Viltenė;Triušikai;8527270437;Taip;0;1;1;2
12988;Viltenė;Triušikai;2026654467;Taip;0;3;0;3
12989;Viltenė;Triušikai;5522245968;Taip;0;3;0;3
12990;Viltenė;Triušikai;8439859449;Taip;15;0;0;15
12991;Viltenė;Triušikai;2786572522;Taip;0;2;0;2
12992;Viltenė;Triušikai;7277455268;Taip;0;13;0;13
12993;Viltenė;Triušikai;2410868015;Taip;18;0;1;19
12994;Viltenė;Triušikai;2660622296;Taip;11;1;0;12
12995;Viltenė;Kiškučiai;6040634853;Taip;15;1;0;16
12996;Viltenė;Kiškučiai;9101795131;Taip;0;1;0;1
12997;Viltenė;Kiškučiai;6296509460;Taip;11;0;0;11
12998;Viltenė;Kiškučiai;2702489251;Taip;14;2;0;16
12999;Viltenė;Kiškučiai;6810811656;Taip;9;2;0;11
13000;Viltenė;Kiškučiai;1888167096;Taip;2;3;0;5
13001;Viltenė;Kiškučiai;8679787688;Taip;3;1;0;4
13002;Viltenė;Kiškučiai;3908574248;Taip;9;0;0;9
13003;Viltenė;Kiškučiai;9228677568;Taip;0;2;0;2
13004;Viltenė;Kiškučiai;8477241365;Taip;14;0;0;14
13005;Viltenė;Kiškučiai;8840885039;Taip;14;2;0;16
13006;Viltenė;Kiškučiai;4616047113;Taip;0;1;0;1
13007;Viltenė;Kiškučiai;2642080849;Taip;10;1;0;11
13008;Viltenė;Kiškučiai;3031790547;Taip;4;6;0;10
13009;Viltenė;Nykštukų;9476132305;Taip;10;0;1;11
13010;Viltenė;Nykštukų;5194925689;Ne;11;0;0;11
13011;Viltenė;Nykštukų;5818645490;Taip;5;1;0;6
13012;Viltenė;Nykštukų;3679704404;Taip;3;8;0;11
13013;Viltenė;Nykštukų;1507287948;Taip;17;0;0;17
13014;Viltenė;Nykštukų;4121448859;Taip;0;0;2;2
13015;Viltenė;Nykštukų;6721689684;Taip;9;2;0;11
13016;Viltenė;Nykštukų;5552217000;Taip;0;3;0;3
13017;Viltenė;Nykštukų;4243501722;Taip;0;10;0;10
13018;Viltenė;Nykštukų;3905014810;Ne;0;11;0;11
13019;Viltenė;Nykštukų;9157616307;Taip;0;0;1;1
13020;Viltenė;Nykštukų;3052677157;Taip;0;7;0;7
13021;Voveraitė;ŽVIRBLIUKŲ;6690309946;Taip;0;1;0;1
13022;Voveraitė;ŽVIRBLIUKŲ;9491132884;Taip;10;2;0;12
13023;Voveraitė;ŽVIRBLIUKŲ;6684234832;Taip;6;0;0;6
13024;Voveraitė;ŽVIRBLIUKŲ;8119493388;Taip;3;13;1;17
13025;Voveraitė;ŽVIRBLIUKŲ;9715405072;Taip;0;3;0;3
13026;Voveraitė;ŽVIRBLIUKŲ;5804351872;Taip;2;0;0;2
13027;Voveraitė;ŽVIRBLIUKŲ;8925151080;Taip;3;0;2;5
13028;Voveraitė;ŽVIRBLIUKŲ;5510544648;Taip;0;15;0;15
13029;Voveraitė;ŽVIRBLIUKŲ;3582805599;Taip;0;8;0;8
13030;Voveraitė;ŽVIRBLIUKŲ;1988082807;Taip;3;4;0;7
13031;Voveraitė;ŽVIRBLIUKŲ;5705303891;Ne;19;0;0;19
13032;Voveraitė;ŽVIRBLIUKŲ;6959751328;Taip;8;3;1;12
13033;Voveraitė;ŽVIRBLIUKŲ;8803052781;Taip;0;9;0;9
13034;Voveraitė;ŽVIRBLIUKŲ;8257748589;Taip;8;8;0;16
13035;Voveraitė;ŽVIRBLIUKŲ;1522307865;Taip;0;10;0;10
13036;Voveraitė;ŽVIRBLIUKŲ;3258155215;Taip;5;3;0;8
13037;Voveraitė;ŽVIRBLIUKŲ;6855501432;Taip;0;10;0;10
13038;Voveraitė;VOVERIUKŲ;1515087924;Taip;3;4;0;7
13039;Voveraitė;VOVERIUKŲ;9195700962;Taip;19;0;0;19
13040;Voveraitė;VOVERIUKŲ;4324619869;Taip;13;3;0;16
13041;Voveraitė;VOVERIUKŲ;5138855000;Taip;5;1;0;6
13042;Voveraitė;VOVERIUKŲ;1340379090;Taip;5;1;0;6
13043;Voveraitė;VOVERIUKŲ;9912862474;Taip;7;3;0;10
13044;Voveraitė;VOVERIUKŲ;1960385335;Ne;0;3;0;3
13045;Voveraitė;VOVERIUKŲ;2594535017;Taip;2;5;0;7
13046;Voveraitė;VOVERIUKŲ;7746424196;Taip;0;2;0;2
13047;Voveraitė;VOVERIUKŲ;4563198733;Taip;5;6;0;11
13048;Voveraitė;VOVERIUKŲ;8373093305;Ne;8;2;0;10
13049;Voveraitė;VOVERIUKŲ;2322594823;Taip;3;1;0;4
13050;Voveraitė;VOVERIUKŲ;2662384275;Taip;5;2;0;7
13051;Voveraitė;VOVERIUKŲ;9514425475;Taip;15;0;0;15
13052;Voveraitė;VOVERIUKŲ;6017698476;Taip;16;0;0;16
13053;Voveraitė;VOVERIUKŲ;8580034134;Taip;12;6;0;18
13054;Voveraitė;VOVERIUKŲ;6891841301;Taip;10;3;0;13
13055;Voveraitė;VOVERIUKŲ;2627555750;Taip;5;0;16;21
13056;Voveraitė;VOVERIUKŲ;5935777154;Taip;9;0;0;9
13057;Voveraitė;KIŠKUČIŲ;3615729576;Ne;6;1;0;7
13058;Voveraitė;KIŠKUČIŲ;9231751171;Taip;0;1;0;1
13059;Voveraitė;KIŠKUČIŲ;4338861332;Taip;0;1;0;1
13060;Voveraitė;KIŠKUČIŲ;9933037872;Taip;1;3;0;4
13061;Voveraitė;KIŠKUČIŲ;3113780055;Taip;0;1;0;1
13062;Voveraitė;KIŠKUČIŲ;65926130735;Taip;9;2;0;11
13063;Voveraitė;KIŠKUČIŲ;7069780513;Taip;6;0;0;6
13064;Voveraitė;KIŠKUČIŲ;9997346812;Taip;21;0;0;21
13065;Voveraitė;KIŠKUČIŲ;9703726869;Taip;6;3;0;9
13066;Voveraitė;KIŠKUČIŲ;7314148938;Taip;0;3;0;3
13067;Voveraitė;KIŠKUČIŲ;4511771924;Taip;0;3;0;3
13068;Voveraitė;KIŠKUČIŲ;9007031372;Taip;4;5;0;9
13069;Voveraitė;KIŠKUČIŲ;6369860178;Taip;6;3;0;9
13070;Voveraitė;KIŠKUČIŲ;6649068571;Taip;14;0;0;14
13071;Voveraitė;KIŠKUČIŲ;1775800865;Taip;0;9;0;9
13072;Voveraitė;KIŠKUČIŲ;6433760749;Ne;9;2;0;11
13073;Voveraitė;KIŠKUČIŲ;54408671673;Taip;21;0;0;21
13074;Voveraitė;KIŠKUČIŲ;72154318379;Taip;21;0;0;21
13075;Voveraitė;KIŠKUČIŲ;1959958256;Ne;6;0;0;6
13076;Voveraitė;KIŠKUČIŲ;2693544600;Taip;0;1;0;1
13077;Voveraitė;KIŠKUČIŲ;6460834118;Taip;3;0;0;3
13078;Voveraitė;KODĖLČIUKŲ;3469734853;Taip;10;0;1;11
13079;Voveraitė;KODĖLČIUKŲ;9117809080;Taip;9;0;0;9
13080;Voveraitė;KODĖLČIUKŲ;46205148458;Taip;0;1;0;1
13081;Voveraitė;KODĖLČIUKŲ;1772758517;Ne;18;0;0;18
13082;Voveraitė;KODĖLČIUKŲ;9431523085;Taip;0;2;0;2
13083;Voveraitė;KODĖLČIUKŲ;51213803814;Taip;0;2;2;4
13084;Voveraitė;KODĖLČIUKŲ;36749754999;Taip;0;1;2;3
13085;Voveraitė;KODĖLČIUKŲ;6653141009;Taip;0;1;3;4
13086;Voveraitė;KODĖLČIUKŲ;4045121781;Taip;0;3;0;3
13087;Voveraitė;KODĖLČIUKŲ;2304004487;Taip;0;0;5;5
13088;Voveraitė;KODĖLČIUKŲ;7744504020;Taip;6;0;0;6
13089;Voveraitė;KODĖLČIUKŲ;2208396431;Taip;11;0;0;11
13090;Voveraitė;KODĖLČIUKŲ;5296850349;Taip;0;6;0;6
13091;Voveraitė;KODĖLČIUKŲ;2763656717;Taip;6;8;5;19
13092;Voveraitė;KODĖLČIUKŲ;4468214107;Taip;6;9;0;15
13093;Voveraitė;KODĖLČIUKŲ;9921313716;Taip;0;2;0;2
13094;Voveraitė;KODĖLČIUKŲ;5449490074;Ne;5;2;4;11
13095;Voveraitė;KODĖLČIUKŲ;7786378018;Ne;7;1;0;8
13096;Voveraitė;MEŠKIUKŲ;4079618555;Taip;0;3;0;3
13097;Voveraitė;MEŠKIUKŲ;3987058753;Taip;0;2;0;2
13098;Voveraitė;MEŠKIUKŲ;3381417855;Taip;0;1;0;1
13099;Voveraitė;MEŠKIUKŲ;3703062195;Taip;1;5;0;6
13100;Voveraitė;MEŠKIUKŲ;8438876806;Taip;11;0;0;11
13101;Voveraitė;MEŠKIUKŲ;1058273156;Taip;5;2;0;7
13102;Voveraitė;MEŠKIUKŲ;9149748841;Taip;5;5;0;10
13103;Voveraitė;MEŠKIUKŲ;5576058454;Taip;17;1;0;18
13104;Voveraitė;MEŠKIUKŲ;1629942114;Taip;0;1;0;1
13105;Voveraitė;MEŠKIUKŲ;6359983706;Taip;6;2;0;8
13106;Voveraitė;MEŠKIUKŲ;17534618616;Taip;0;2;0;2
13107;Voveraitė;MEŠKIUKŲ;1592633500;Taip;2;5;0;7
13108;Voveraitė;MEŠKIUKŲ;5437283673;Taip;4;14;0;18
13109;Voveraitė;MEŠKIUKŲ;7797966139;Taip;6;10;0;16
13110;Voveraitė;MEŠKIUKŲ;3029983180;Taip;0;8;0;8
13111;Voveraitė;MEŠKIUKŲ;9900940313;Taip;8;2;0;10
13112;Voveraitė;MEŠKIUKŲ;4680264973;Ne;2;9;0;11
13113;Voveraitė;MEŠKIUKŲ;5095849577;Taip;7;2;0;9
13114;Voveraitė;MEŠKIUKŲ;6886337758;Taip;0;16;0;16
13115;Voveraitė;MEŠKIUKŲ;6994680282;Taip;0;3;0;3
13116;Voveraitė;MEŠKIUKŲ;7861722125;Taip;2;5;0;7
13117;Voveraitė;BORUŽĖLIŲ;6898251154;Taip;10;0;1;11
13118;Voveraitė;BORUŽĖLIŲ;49205285378;Taip;0;10;0;10
13119;Voveraitė;BORUŽĖLIŲ;1587569563;Taip;3;1;0;4
13120;Voveraitė;BORUŽĖLIŲ;89216481616;Taip;5;1;1;7
13121;Voveraitė;BORUŽĖLIŲ;46318035221;Taip;7;0;0;7
13122;Voveraitė;BORUŽĖLIŲ;26080915874;Taip;0;2;0;2
13123;Voveraitė;BORUŽĖLIŲ;3818120898;Taip;0;3;0;3
13124;Voveraitė;BORUŽĖLIŲ;64724933885;Taip;0;1;0;1
13125;Voveraitė;BORUŽĖLIŲ;69797506996;Ne;0;2;0;2
13126;Voveraitė;BORUŽĖLIŲ;26264960973;Taip;6;1;0;7
13127;Voveraitė;BORUŽĖLIŲ;57033218205;Taip;7;2;0;9
13128;Voveraitė;BORUŽĖLIŲ;89873985894;Taip;0;8;0;8
13129;Voveraitė;BORUŽĖLIŲ;76074825733;Taip;0;4;0;4
13130;Voveraitė;BORUŽĖLIŲ;47111956594;Taip;0;2;1;3
13131;Voveraitė;BORUŽĖLIŲ;53801893219;Ne;4;2;0;6
13132;Voveraitė;BORUŽĖLIŲ;59442802443;Taip;5;1;0;6
13133;Voveraitė;BORUŽĖLIŲ;22913200509;Taip;0;0;5;5
13134;Voveraitė;PELĖDŽIUKŲ;1689261748;Taip;0;2;0;2
13135;Voveraitė;PELĖDŽIUKŲ;5944299310;Taip;0;1;0;1
13136;Voveraitė;PELĖDŽIUKŲ;4266535840;Taip;3;1;0;4
13137;Voveraitė;PELĖDŽIUKŲ;76432985710;Taip;2;0;0;2
13138;Voveraitė;PELĖDŽIUKŲ;74161507529;Ne;0;1;1;2
13139;Voveraitė;PELĖDŽIUKŲ;30591405375;Taip;0;10;0;10
13140;Voveraitė;PELĖDŽIUKŲ;42683378356;Taip;10;0;0;10
13141;Voveraitė;PELĖDŽIUKŲ;46665609670;Taip;0;4;2;6
13142;Voveraitė;PELĖDŽIUKŲ;68005956631;Taip;0;2;0;2
13143;Voveraitė;PELĖDŽIUKŲ;32030461873;Taip;0;2;0;2
13144;Voveraitė;PELĖDŽIUKŲ;5354784149;Taip;0;1;1;2
13145;Voveraitė;PELĖDŽIUKŲ;3292830298;Taip;0;1;3;4
13146;Voveraitė;PELĖDŽIUKŲ;86045196465;Taip;1;0;0;1
13147;Voveraitė;PELĖDŽIUKŲ;3756080192;Taip;0;1;3;4
13148;Voveraitė;PELĖDŽIUKŲ;1018558040;Taip;3;0;0;3
13149;Voveraitė;PELĖDŽIUKŲ;5804909515;Taip;0;6;0;6
13150;Voveraitė;DRUGELIŲ;9623406874;Taip;5;2;0;7
13151;Voveraitė;DRUGELIŲ;1668695462;Taip;0;1;1;2
13152;Voveraitė;DRUGELIŲ;1753442884;Taip;0;4;0;4
13153;Voveraitė;DRUGELIŲ;63032690186;Taip;0;1;0;1
13154;Voveraitė;DRUGELIŲ;7974406524;Taip;6;7;0;13
13155;Voveraitė;DRUGELIŲ;1032086466;Taip;0;6;4;10
13156;Voveraitė;DRUGELIŲ;2711136945;Taip;0;1;6;7
13157;Voveraitė;DRUGELIŲ;8538259157;Taip;0;1;0;1
13158;Voveraitė;DRUGELIŲ;81628846458;Taip;0;1;0;1
13159;Voveraitė;DRUGELIŲ;2044914624;Taip;1;11;2;14
13160;Voveraitė;DRUGELIŲ;5037713667;Taip;0;0;1;1
13161;Voveraitė;DRUGELIŲ;2031078156;Taip;1;0;0;1
13162;Voveraitė;DRUGELIŲ;80330740714;Taip;0;2;0;2
13163;Voveraitė;DRUGELIŲ;6729475469;Taip;0;6;0;6
13164;Voveraitė;DRUGELIŲ;1397274691;Ne;0;21;0;21
13165;Voveraitė;DRUGELIŲ;1612322367;Taip;5;4;1;10
13166;Voveraitė;DRUGELIŲ;6847620019;Taip;0;2;0;2
13167;Voveraitė;DRUGELIŲ;53507758884;Taip;0;5;0;5
13168;Voveraitė;DRUGELIŲ;1780573926;Taip;5;1;0;6
13169;Voveraitė;DRUGELIŲ;8443005812;Taip;10;1;0;11
13170;Voveraitė;NYKŠTUKŲ;59346262217;Ne;0;3;1;4
13171;Voveraitė;NYKŠTUKŲ;44115826781;Taip;2;0;0;2
13172;Voveraitė;NYKŠTUKŲ;67851579200;Taip;0;2;0;2
13173;Voveraitė;NYKŠTUKŲ;2902148527;Taip;0;2;0;2
13174;Voveraitė;NYKŠTUKŲ;28656009009;Taip;0;5;0;5
13175;Voveraitė;NYKŠTUKŲ;1704834744;Taip;3;2;0;5
13176;Voveraitė;NYKŠTUKŲ;35549553867;Taip;0;3;1;4
13177;Voveraitė;NYKŠTUKŲ;49924157014;Taip;5;4;1;10
13178;Voveraitė;NYKŠTUKŲ;41182124889;Taip;0;3;0;3
13179;Voveraitė;NYKŠTUKŲ;13173711840;Taip;5;4;0;9
13180;Voveraitė;NYKŠTUKŲ;602726070;Taip;10;1;5;16
13181;Voveraitė;NYKŠTUKŲ;27132982320;Taip;0;2;0;2
13182;Voveraitė;NYKŠTUKŲ;107968318;Taip;0;2;0;2
13183;Voveraitė;NYKŠTUKŲ;2762066479;Taip;0;1;0;1
13184;Voveraitė;NYKŠTUKŲ;66612277823;Taip;1;2;0;3
13185;Voveraitė;NYKŠTUKŲ;82642244788;Taip;3;2;0;5
13186;Voveraitė;NYKŠTUKŲ;2051732666;Taip;8;2;0;10
13187;Voveraitė;NYKŠTUKŲ;4163635632;Taip;4;4;0;8
13188;Voveraitė;GENIUKŲ;6903776113;Taip;0;1;1;2
13189;Voveraitė;GENIUKŲ;63276868064;Taip;0;4;1;5
13190;Voveraitė;GENIUKŲ;3137529068;Taip;0;4;0;4
13191;Voveraitė;GENIUKŲ;34170702690;Taip;0;2;0;2
13192;Voveraitė;GENIUKŲ;12366200545;Taip;0;1;2;3
13193;Voveraitė;GENIUKŲ;90970378921;Taip;0;1;0;1
13194;Voveraitė;GENIUKŲ;15716865051;Ne;0;2;0;2
13195;Voveraitė;GENIUKŲ;30515775412;Taip;3;1;0;4
13196;Voveraitė;GENIUKŲ;14865004407;Taip;0;1;1;2
13197;Voveraitė;GENIUKŲ;37044398892;Taip;0;2;0;2
13198;Voveraitė;GENIUKŲ;35850480678;Taip;0;1;0;1
13199;Voveraitė;GENIUKŲ;65838266846;Taip;0;2;2;4
13200;Voveraitė;GENIUKŲ;39956224681;Taip;11;1;0;12
13201;Voveraitė;GENIUKŲ;1055423524;Taip;0;4;0;4
13202;Voveraitė;GENIUKŲ;1261834247;Taip;10;1;0;11
13203;Voveraitė;LAPIUKŲ;1141304286;Ne;0;4;1;5
13204;Voveraitė;LAPIUKŲ;1550830434;Taip;2;6;6;14
13205;Voveraitė;LAPIUKŲ;1510853268;Taip;0;0;7;7
13206;Voveraitė;LAPIUKŲ;3388547792;Taip;3;7;0;10
13207;Voveraitė;LAPIUKŲ;8344323109;Taip;0;2;6;8
13208;Voveraitė;LAPIUKŲ;7099272964;Taip;0;0;5;5
13209;Voveraitė;LAPIUKŲ;2716400502;Taip;0;0;3;3
13210;Voveraitė;LAPIUKŲ;7008576999;Taip;0;0;3;3
13211;Voveraitė;LAPIUKŲ;4300235743;Taip;4;1;3;8
13212;Voveraitė;LAPIUKŲ;1441921029;Taip;0;0;6;6
13213;Voveraitė;LAPIUKŲ;2450726148;Taip;4;0;0;4
13214;Voveraitė;LAPIUKŲ;7531020548;Taip;4;5;2;11
13215;Voveraitė;LAPIUKŲ;8421104790;Taip;6;0;2;8
13216;Voveraitė;LAPIUKŲ;6073270223;Taip;9;0;2;11
13217;Voveraitė;EŽIUKŲ;1614180834;Taip;21;0;0;21
13218;Voveraitė;EŽIUKŲ;6572172779;Taip;9;0;1;10
13219;Voveraitė;EŽIUKŲ;8746008166;Taip;6;0;0;6
13220;Voveraitė;EŽIUKŲ;8507818993;Taip;11;1;0;12
13221;Voveraitė;EŽIUKŲ;3736638759;Taip;3;6;0;9
13222;Voveraitė;EŽIUKŲ;4060906360;Taip;0;2;0;2
13223;Voveraitė;EŽIUKŲ;9537862791;Taip;9;0;4;13
13224;Voveraitė;EŽIUKŲ;9011096222;Taip;8;0;1;9
13225;Voveraitė;EŽIUKŲ;4478984171;Taip;6;4;0;10
13226;Voveraitė;EŽIUKŲ;3058377539;Taip;11;4;0;15
13227;Voveraitė;EŽIUKŲ;6007396459;Taip;2;0;1;3
13228;Voveraitė;EŽIUKŲ;5114768009;Taip;10;1;1;12
13229;"Trakų Vokė";Voveriukų;2906508821;Ne;5;0;2;7
13230;"Trakų Vokė";Voveriukų;2389794233;Taip;20;0;0;20
13231;"Trakų Vokė";Voveriukų;9233090228;Taip;11;0;2;13
13232;"Trakų Vokė";Voveriukų;2880299812;Taip;9;0;1;10
13233;"Trakų Vokė";Voveriukų;4854440884;Taip;16;0;1;17
13234;"Trakų Vokė";Voveriukų;2761614687;Taip;16;0;1;17
13235;"Trakų Vokė";Voveriukų;2539647111;Taip;9;0;1;10
13236;"Trakų Vokė";Voveriukų;1360046096;Taip;12;0;0;12
13237;"Trakų Vokė";Voveriukų;3328527700;Taip;1;0;1;2
13238;"Trakų Vokė";Voveriukų;3278842582;Taip;0;4;0;4
13239;"Trakų Vokė";Voveriukų;1324720234;Taip;6;0;0;6
13240;"Trakų Vokė";Voveriukų;2869217654;Taip;16;0;0;16
13241;"Trakų Vokė";Voveriukų;6277305384;Taip;0;0;4;4
13242;"Trakų Vokė";Voveriukų;6369848950;Taip;5;0;1;6
13243;"Trakų Vokė";Voveriukų;6326568445;Taip;2;0;0;2
13244;"Trakų Vokė";Voveriukų;4040038648;Taip;3;0;2;5
13245;"Trakų Vokė";Voveriukų;7727246187;Taip;5;3;1;9
13246;"Trakų Vokė";Voveriukų;3611639112;Taip;0;0;6;6
13247;"Trakų Vokė";Voveriukų;5206616285;Taip;11;0;0;11
13248;"Trakų Vokė";Voveriukų;4535167417;Taip;0;6;0;6
13249;"Trakų Vokė";Boružėlių;3209594216;Taip;4;0;1;5
13250;"Trakų Vokė";Boružėlių;6732422645;Taip;0;0;3;3
13251;"Trakų Vokė";Boružėlių;5338798362;Taip;5;0;3;8
13252;"Trakų Vokė";Boružėlių;3319243283;Taip;2;0;2;4
13253;"Trakų Vokė";Boružėlių;1039690987;Taip;14;2;0;16
13254;"Trakų Vokė";Boružėlių;2516219363;Taip;4;0;1;5
13255;"Trakų Vokė";Boružėlių;7858812338;Ne;7;0;0;7
13256;"Trakų Vokė";Boružėlių;3913623741;Taip;0;0;3;3
13257;"Trakų Vokė";Boružėlių;2730385281;Taip;4;2;0;6
13258;"Trakų Vokė";Boružėlių;1088928094;Taip;9;0;2;11
13259;"Trakų Vokė";Boružėlių;7318458282;Taip;6;1;0;7
13260;"Trakų Vokė";Boružėlių;6908913934;Ne;8;0;0;8
13261;"Trakų Vokė";Boružėlių;7909596435;Taip;10;0;0;10
13262;"Trakų Vokė";Boružėlių;5251929660;Taip;0;1;0;1
13263;"Trakų Vokė";Boružėlių;6751625456;Taip;14;0;1;15
13264;"Trakų Vokė";Boružėlių;7752786907;Taip;20;1;0;21
13265;"Trakų Vokė";Boružėlių;2475068032;Taip;0;0;3;3
13266;"Trakų Vokė";Boružėlių;4601374629;Ne;9;0;1;10
13267;"Trakų Vokė";Boružėlių;4014027030;Taip;3;5;5;13
13268;"Trakų Vokė";Boružėlių;7660240598;Taip;11;7;0;18
13269;"Trakų Vokė";Boružėlių;4438127190;Ne;5;0;6;11
13270;"Trakų Vokė";Boružėlių;2388817616;Taip;5;0;4;9
13271;"Trakų Vokė";Boružėlių;9453317084;Taip;0;8;0;8
13272;"Trakų Vokė";KIŠKUČIŲ;15897808544;Taip;0;1;0;1
13273;"Trakų Vokė";KIŠKUČIŲ;88989814775;Taip;5;0;0;5
13274;"Trakų Vokė";KIŠKUČIŲ;6675993703;Taip;7;1;1;9
13275;"Trakų Vokė";KIŠKUČIŲ;87781186373;Taip;8;0;0;8
13276;"Trakų Vokė";KIŠKUČIŲ;69866048102;Taip;0;0;8;8
13277;"Trakų Vokė";KIŠKUČIŲ;64083541565;Taip;0;1;0;1
13278;"Trakų Vokė";KIŠKUČIŲ;67434532111;Taip;0;7;0;7
13279;"Trakų Vokė";KIŠKUČIŲ;26598573711;Taip;5;2;0;7
13280;"Trakų Vokė";KIŠKUČIŲ;69311478204;Taip;10;0;0;10
13281;"Trakų Vokė";KIŠKUČIŲ;71417288063;Taip;0;0;5;5
13282;"Trakų Vokė";KIŠKUČIŲ;44023296535;Taip;6;3;0;9
13283;"Trakų Vokė";KIŠKUČIŲ;6418198934;Taip;8;0;1;9
13284;"Trakų Vokė";KIŠKUČIŲ;50697040061;Taip;0;0;13;13
13285;"Trakų Vokė";KIŠKUČIŲ;9135918587;Taip;0;1;0;1
13286;"Trakų Vokė";KIŠKUČIŲ;64019248229;Taip;5;0;0;5
13287;"Trakų Vokė";KIŠKUČIŲ;18796898215;Taip;4;0;5;9
13288;"Trakų Vokė";KIŠKUČIŲ;86504089176;Taip;5;1;0;6
13289;"Trakų Vokė";KIŠKUČIŲ;3210453801;Taip;5;1;0;6
13290;"Trakų Vokė";KIŠKUČIŲ;21329819892;Taip;0;0;1;1
13291;"Trakų Vokė";KIŠKUČIŲ;9705561511;Taip;0;0;4;4
13292;"Trakų Vokė";KIŠKUČIŲ;5109850366;Taip;0;5;0;5
13293;"Trakų Vokė";KIŠKUČIŲ;33984949164;Taip;0;8;0;8
13294;"Trakų Vokė";KIŠKUČIŲ;85293469079;Taip;13;0;0;13
13295;Zylutė;Katerok;8749296671;Taip;17;0;0;17
13296;Zylutė;Katerok;1621772702;Taip;16;0;0;16
13297;Zylutė;Katerok;4592825972;Taip;0;9;0;9
13298;Zylutė;Katerok;8747721198;Taip;18;0;0;18
13299;Zylutė;Katerok;8212030518;Taip;0;10;0;10
13300;Zylutė;Katerok;7706833089;Taip;12;4;0;16
13301;Zylutė;Katerok;1353114929;Ne;0;1;5;6
13302;Zylutė;Katerok;2968625045;Taip;6;3;0;9
13303;Zylutė;Katerok;8618778936;Taip;16;0;0;16
13304;Zylutė;Katerok;1897871944;Taip;12;4;0;16
13305;Zylutė;Katerok;5687201052;Taip;10;0;0;10
13306;Zylutė;Katerok;3055559237;Taip;8;2;0;10
13307;Zylutė;Katerok;2792217953;Taip;6;1;0;7
13308;Zylutė;Katerok;5948147748;Taip;0;0;2;2
13309;Zylutė;Katerok;5264930854;Taip;11;1;0;12
13310;Zylutė;Katerok;7851423851;Taip;0;0;1;1
13311;Zylutė;"Vesole misiaki";86301183281;Taip;0;2;0;2
13312;Zylutė;"Vesole misiaki";9262869284;Taip;0;3;0;3
13313;Zylutė;"Vesole misiaki";1256879956;Ne;0;4;0;4
13314;Zylutė;"Vesole misiaki";3126726854;Ne;0;5;0;5
13315;Zylutė;"Vesole misiaki";9484752315;Taip;0;8;0;8
13316;Zylutė;"Vesole misiaki";7140223126;Taip;6;0;0;6
13317;Zylutė;"Vesole misiaki";81796510706;Taip;0;6;0;6
13318;Zylutė;"Vesole misiaki";7606434084;Taip;0;4;0;4
13319;Zylutė;"Vesole misiaki";6299191475;Ne;0;9;0;9
13320;Zylutė;"Vesole misiaki";9953834483;Taip;0;1;0;1
13321;Zylutė;"Vesole misiaki";9664467134;Ne;0;2;0;2
13322;Zylutė;"Vesole misiaki";8336138549;Taip;0;7;0;7
13323;Zylutė;"Vesole misiaki";9457189905;Taip;11;0;0;11
13324;Zylutė;"Vesole misiaki";2445444641;Taip;0;4;0;4
13325;Zylutė;"Vesole misiaki";8638652914;Ne;0;1;0;1
13326;Zylutė;"Vesole misiaki";9908198854;Taip;0;4;0;4
13327;Zylutė;NYKŠTUKAI;19429820228;Taip;0;3;0;3
13328;Zylutė;NYKŠTUKAI;46013925783;Taip;0;2;0;2
13329;Zylutė;NYKŠTUKAI;53165044678;Taip;0;1;0;1
13330;Zylutė;NYKŠTUKAI;40369749025;Taip;0;7;0;7
13331;Zylutė;NYKŠTUKAI;42712894954;Taip;0;4;0;4
13332;Zylutė;NYKŠTUKAI;87231809477;Taip;11;0;0;11
13333;Zylutė;NYKŠTUKAI;1584743051;Ne;5;5;0;10
13334;Zylutė;NYKŠTUKAI;1187261223;Taip;9;0;0;9
13335;Zylutė;NYKŠTUKAI;2276463136;Taip;0;4;2;6
13336;Zylutė;NYKŠTUKAI;7042731356;Taip;5;0;1;6
13337;Zylutė;NYKŠTUKAI;27488840113;Taip;5;0;0;5
13338;Zylutė;NYKŠTUKAI;35300054087;Taip;0;2;0;2
13339;Zylutė;NYKŠTUKAI;1699222615;Taip;0;0;1;1
13340;Zylutė;NYKŠTUKAI;3246229837;Taip;10;0;0;10
13341;Zylutė;NYKŠTUKAI;6324036463;Taip;17;0;0;17
13342;Zylutė;NYKŠTUKAI;4394023057;Taip;0;6;0;6
13343;Zylutė;NYKŠTUKAI;2153133102;Taip;0;0;1;1
13344;Zylutė;NYKŠTUKAI;2910542367;Taip;0;9;0;9
13345;Zylutė;NYKŠTUKAI;8141884164;Taip;0;1;13;14
13346;Zylutė;NYKŠTUKAI;49606187547;Taip;0;0;11;11
13347;Zylutė;Ručijok;6112586092;Taip;0;7;0;7
13348;Zylutė;Ručijok;5045652581;Taip;5;6;0;11
13349;Zylutė;Ručijok;3547185618;Taip;3;0;0;3
13350;Zylutė;Ručijok;9913001904;Taip;0;3;0;3
13351;Zylutė;Ručijok;7241045507;Taip;8;0;0;8
13352;Zylutė;Ručijok;9381656201;Taip;7;0;0;7
13353;Zylutė;Ručijok;2654373943;Taip;9;0;0;9
13354;Zylutė;Ručijok;4497904128;Taip;13;3;0;16
13355;Zylutė;Ručijok;1452384017;Taip;10;0;0;10
13356;Zylutė;Ručijok;9586800176;Taip;10;5;0;15
13357;Zylutė;Ručijok;3355159275;Taip;0;2;0;2
13358;Zylutė;Ručijok;9995791665;Taip;7;3;0;10
13359;Zylutė;Ručijok;4916625058;Taip;10;0;3;13
13360;Zylutė;Ručijok;8178488164;Taip;1;0;5;6
13361;Zylutė;Ručijok;6848387941;Ne;14;0;0;14
13362;Zylutė;Raduga;9325387975;Taip;5;6;0;11
13363;Zylutė;Raduga;3363212754;Taip;16;1;0;17
13364;Zylutė;Raduga;6569135467;Taip;0;0;5;5
13365;Zylutė;Raduga;3117948118;Taip;0;5;0;5
13366;Zylutė;Raduga;2654794460;Taip;0;0;3;3
13367;Zylutė;Raduga;1423890598;Taip;10;0;3;13
13368;Zylutė;Raduga;3826815202;Taip;0;0;2;2
13369;Zylutė;Raduga;3943002728;Taip;17;0;0;17
13370;Zylutė;Raduga;4043810535;Taip;7;0;0;7
13371;Zylutė;Raduga;2107123106;Ne;15;0;1;16
13372;Zylutė;Raduga;7482740111;Taip;4;0;3;7
13373;Zylutė;Raduga;6995285377;Ne;10;5;0;15
13374;Zylutė;Raduga;2559643556;Taip;13;0;1;14
13375;Zylutė;Raduga;7824348276;Ne;5;3;0;8
13376;Zylutė;Raduga;4811667497;Ne;17;1;0;18
13377;Zylutė;Raduga;5683151005;Taip;9;4;0;13
13378;Zylutė;Raduga;2681013154;Taip;0;0;2;2
13379;Zylutė;Raduga;6391999153;Taip;13;0;0;13
13380;Zylutė;Raduga;6833030749;Taip;14;2;0;16
13381;Zylutė;"Miki Maus";5670953383;Taip;12;0;0;12
13382;Zylutė;"Miki Maus";5027134228;Taip;10;9;0;19
13383;Zylutė;"Miki Maus";4543822765;Taip;21;0;0;21
13384;Zylutė;"Miki Maus";4566817285;Ne;3;0;1;4
13385;Zylutė;"Miki Maus";2092319455;Taip;4;0;0;4
13386;Zylutė;"Miki Maus";9457457032;Taip;6;0;3;9
13387;Zylutė;"Miki Maus";1290248125;Ne;1;0;1;2
13388;Zylutė;"Miki Maus";3633983359;Taip;12;0;0;12
13389;Zylutė;"Miki Maus";6833822248;Taip;16;0;0;16
13390;Zylutė;"Miki Maus";5589330186;Taip;10;0;3;13
13391;Zylutė;"Miki Maus";9737308076;Taip;0;0;2;2
13392;Zylutė;"Miki Maus";9162232979;Taip;16;0;0;16
13393;Zylutė;"Miki Maus";3848401615;Taip;6;0;1;7
13394;Zylutė;"Miki Maus";5577339739;Taip;3;0;3;6
13395;Zylutė;"Miki Maus";1455822427;Taip;0;0;2;2
13396;Zylutė;"Miki Maus";3332865242;Taip;15;0;0;15
13397;Zylutė;Solnyško;52293061924;Taip;0;13;0;13
13398;Zylutė;Solnyško;50784859977;Taip;0;6;0;6
13399;Zylutė;Solnyško;1212526573;Taip;6;0;0;6
13400;Zylutė;Solnyško;2020113161;Taip;6;2;0;8
13401;Zylutė;Solnyško;2058827699;Taip;0;1;0;1
13402;Zylutė;Solnyško;16723015849;Ne;8;0;0;8
13403;Zylutė;Solnyško;53283282669;Taip;17;0;0;17
13404;Zylutė;Solnyško;98295398362;Taip;5;1;0;6
13405;Zylutė;Solnyško;63287117036;Ne;0;9;0;9
13406;Zylutė;Solnyško;1004049147;Taip;0;2;0;2
13407;Zylutė;Solnyško;8582483538;Taip;0;2;0;2
13408;Zylutė;Solnyško;1979823314;Taip;0;15;0;15
13409;Zylutė;Solnyško;9728065395;Taip;0;1;0;1
13410;Zylutė;Solnyško;91938227358;Ne;0;9;0;9
13411;Zylutė;Solnyško;55672880453;Ne;1;1;0;2
13412;Zylutė;Solnyško;63798640792;Taip;0;8;0;8
13413;Zylutė;Solnyško;1059365398;Taip;0;7;0;7
13414;Zylutė;Solnyško;91534371407;Taip;0;2;0;2
13415;Zylutė;Motyliok;45252076215;Ne;21;0;0;21
13416;Zylutė;Motyliok;45779928616;Taip;0;2;0;2
13417;Zylutė;Motyliok;31724596372;Taip;6;0;0;6
13418;Zylutė;Motyliok;1598044320;Taip;6;1;0;7
13419;Zylutė;Motyliok;20333534526;Taip;0;3;0;3
13420;Zylutė;Motyliok;1756267879;Taip;0;1;0;1
13421;Zylutė;Motyliok;1801436436;Taip;7;0;0;7
13422;Zylutė;Motyliok;1445891751;Taip;5;0;1;6
13423;Zylutė;Motyliok;1284845681;Taip;0;4;0;4
13424;Zylutė;Motyliok;1873200936;Taip;2;0;0;2
13425;Zylutė;Motyliok;8546942240;Taip;21;0;0;21
13426;Zylutė;Motyliok;2306517891;Taip;5;2;0;7
13427;Zylutė;Motyliok;23826981323;Taip;10;1;1;12
13428;Zylutė;Motyliok;1145364380;Taip;10;1;1;12
13429;Zylutė;Motyliok;7712651566;Ne;0;4;0;4
13430;Zylutė;Motyliok;42101273435;Taip;6;1;0;7
13431;Zylutė;Motyliok;35364823312;Taip;2;4;0;6
13432;Zylutė;ŽVIRBLIUKAI;20569748356;Ne;11;1;4;16
13433;Zylutė;ŽVIRBLIUKAI;8783866036;Taip;7;5;0;12
13434;Zylutė;ŽVIRBLIUKAI;2274290871;Taip;0;13;0;13
13435;Zylutė;ŽVIRBLIUKAI;9902286013;Taip;3;0;0;3
13436;Zylutė;ŽVIRBLIUKAI;4154010905;Taip;11;0;0;11
13437;Zylutė;ŽVIRBLIUKAI;1972826928;Taip;0;5;0;5
13438;Zylutė;ŽVIRBLIUKAI;3919565034;Taip;12;0;0;12
13439;Zylutė;ŽVIRBLIUKAI;6865973084;Ne;3;1;0;4
13440;Zylutė;ŽVIRBLIUKAI;2744516236;Taip;0;4;0;4
13441;Zylutė;ŽVIRBLIUKAI;5174329244;Taip;6;0;0;6
13442;Zylutė;ŽVIRBLIUKAI;1939618217;Taip;10;1;0;11
13443;Zylutė;ŽVIRBLIUKAI;8627523283;Taip;4;1;0;5
13444;Zylutė;ŽVIRBLIUKAI;3606566852;Taip;8;3;0;11
13445;Zylutė;ŽVIRBLIUKAI;8874692591;Taip;15;1;0;16
13446;Zylutė;ŽVIRBLIUKAI;5431521522;Taip;0;10;0;10
13447;Zylutė;ŽVIRBLIUKAI;6548786007;Ne;5;1;0;6
13448;Zylutė;ŽVIRBLIUKAI;3074954453;Taip;2;0;0;2
13449;Zylutė;"DRUŽNYJE REBIATA";12377363480;Taip;13;1;0;14
13450;Zylutė;"DRUŽNYJE REBIATA";1428614163;Taip;0;1;0;1
13451;Zylutė;"DRUŽNYJE REBIATA";1674095701;Taip;0;10;0;10
13452;Zylutė;"DRUŽNYJE REBIATA";67435726524;Taip;5;1;0;6
13453;Zylutė;"DRUŽNYJE REBIATA";3843999609;Taip;16;0;0;16
13454;Zylutė;"DRUŽNYJE REBIATA";3036582121;Ne;0;3;0;3
13455;Zylutė;"DRUŽNYJE REBIATA";9163527400;Ne;0;2;1;3
13456;Zylutė;"DRUŽNYJE REBIATA";4302751308;Taip;7;0;0;7
13457;Zylutė;"DRUŽNYJE REBIATA";8293541980;Taip;21;0;0;21
13458;Zylutė;"DRUŽNYJE REBIATA";5452659798;Taip;0;4;0;4
13459;Zylutė;"DRUŽNYJE REBIATA";9589810356;Taip;0;3;0;3
13460;Zylutė;"DRUŽNYJE REBIATA";5224781417;Ne;5;1;0;6
13461;Zylutė;"DRUŽNYJE REBIATA";5162635301;Taip;2;9;0;11
13462;Zylutė;"DRUŽNYJE REBIATA";7023565057;Taip;15;0;0;15
13463;Zylutė;"DRUŽNYJE REBIATA";7804533930;Taip;8;0;0;8
13464;Zylutė;"DRUŽNYJE REBIATA";3254847545;Ne;0;1;0;1
13465;Zylutė;"DRUŽNYJE REBIATA";5803032683;Taip;21;0;0;21
13466;Zylutė;"DRUŽNYJE REBIATA";3089235413;Taip;18;0;0;18
13467;Zylutė;"DRUŽNYJE REBIATA";8180889070;Taip;2;1;0;3
13468;Zylutė;VIEVERSĖLIAI;2125519672;Taip;0;1;0;1
13469;Zylutė;VIEVERSĖLIAI;72716975865;Taip;6;0;0;6
13470;Zylutė;VIEVERSĖLIAI;6275164528;Taip;0;1;0;1
13471;Zylutė;VIEVERSĖLIAI;5172154642;Taip;4;6;0;10
13472;Zylutė;VIEVERSĖLIAI;2943888466;Taip;0;15;0;15
13473;Zylutė;VIEVERSĖLIAI;6907378757;Taip;0;4;0;4
13474;Zylutė;VIEVERSĖLIAI;6723650872;Taip;0;1;0;1
13475;Zylutė;VIEVERSĖLIAI;3810636967;Taip;21;0;0;21
13476;Zylutė;VIEVERSĖLIAI;6154352500;Taip;0;7;0;7
13477;Zylutė;VIEVERSĖLIAI;9660898505;Taip;0;6;0;6
13478;Zylutė;VIEVERSĖLIAI;57138305703;Ne;0;6;0;6
13479;Zylutė;VIEVERSĖLIAI;5544338521;Taip;10;0;0;10
13480;Zylutė;VIEVERSĖLIAI;4764295850;Taip;0;10;0;10
13481;Zylutė;VIEVERSĖLIAI;4966816780;Taip;0;0;11;11
13482;Želmenėliai;Bitučių;4681686872;Taip;0;1;0;1
13483;Želmenėliai;Bitučių;3268310531;Taip;13;0;0;13
13484;Želmenėliai;Bitučių;5211426226;Taip;9;3;0;12
13485;Želmenėliai;Bitučių;2122665619;Taip;6;0;0;6
13486;Želmenėliai;Bitučių;2563117992;Taip;11;0;0;11
13487;Želmenėliai;Bitučių;6799702725;Ne;0;2;2;4
13488;Želmenėliai;Bitučių;9006406225;Taip;8;4;0;12
13489;Želmenėliai;Bitučių;7423900312;Taip;20;0;0;20
13490;Želmenėliai;Bitučių;2102401372;Taip;5;2;0;7
13491;Želmenėliai;Bitučių;4931835807;Taip;0;2;0;2
13492;Želmenėliai;Bitučių;5147895081;Taip;0;1;0;1
13493;Želmenėliai;Bitučių;6481952132;Taip;11;1;0;12
13494;Želmenėliai;Bitučių;9611741258;Taip;11;0;1;12
13495;Želmenėliai;Bitučių;1619143702;Taip;11;0;0;11
13496;Želmenėliai;Bitučių;2794274146;Taip;6;0;0;6
13497;Želmenėliai;Bitučių;9825545754;Ne;4;5;0;9
13498;Želmenėliai;Bitučių;5314438217;Taip;0;3;0;3
13499;Želmenėliai;Bitučių;4927030144;Taip;17;0;0;17
13500;Želmenėliai;Bitučių;1751328192;Ne;16;0;0;16
13501;Želmenėliai;Kačiukų;53611793303;Taip;5;3;0;8
13502;Želmenėliai;Kačiukų;25991128602;Ne;9;1;0;10
13503;Želmenėliai;Kačiukų;50204719384;Taip;0;5;0;5
13504;Želmenėliai;Kačiukų;84671486637;Taip;0;0;1;1
13505;Želmenėliai;Kačiukų;75215159489;Taip;0;9;0;9
13506;Želmenėliai;Kačiukų;68168210430;Ne;0;1;0;1
13507;Želmenėliai;Kačiukų;52474082386;Taip;16;5;0;21
13508;Želmenėliai;Kačiukų;32945118976;Taip;0;2;5;7
13509;Želmenėliai;Kačiukų;72091418618;Taip;0;2;0;2
13510;Želmenėliai;Kačiukų;72029098066;Taip;1;10;0;11
13511;Želmenėliai;Kačiukų;80129197524;Ne;0;2;0;2
13512;Želmenėliai;Kačiukų;93374623931;Ne;0;0;2;2
13513;Želmenėliai;Kačiukų;25744693727;Taip;0;2;0;2
13514;Želmenėliai;Kačiukų;41941728755;Taip;0;0;2;2
13515;Želmenėliai;Kačiukų;98487229210;Taip;8;2;0;10
13516;Želmenėliai;Kačiukų;11316462529;Taip;0;0;5;5
13517;Želmenėliai;Kačiukų;1064518850;Taip;0;4;0;4
13518;Želmenėliai;Voveriukų;38426234048;Taip;0;1;0;1
13519;Želmenėliai;Voveriukų;2066711124;Taip;5;1;0;6
13520;Želmenėliai;Voveriukų;5696221669;Taip;5;0;3;8
13521;Želmenėliai;Voveriukų;1799477959;Taip;14;1;0;15
13522;Želmenėliai;Voveriukų;1868937175;Taip;9;1;1;11
13523;Želmenėliai;Voveriukų;3258904017;Taip;0;1;0;1
13524;Želmenėliai;Voveriukų;6783113916;Taip;0;1;0;1
13525;Želmenėliai;Voveriukų;2044063398;Taip;8;0;0;8
13526;Želmenėliai;Voveriukų;2005437403;Taip;0;5;0;5
13527;Želmenėliai;Voveriukų;1744939559;Taip;6;0;0;6
13528;Želmenėliai;Voveriukų;27187464726;Taip;0;2;1;3
13529;Želmenėliai;Voveriukų;1952686295;Taip;9;2;0;11
13530;Želmenėliai;Voveriukų;2836206893;Ne;0;2;0;2
13531;Želmenėliai;Voveriukų;1342094235;Ne;0;1;2;3
13532;Želmenėliai;Voveriukų;5214021520;Ne;0;1;2;3
13533;Želmenėliai;Voveriukų;3490705425;Ne;5;2;0;7
13534;Želmenėliai;Voveriukų;6478525575;Taip;7;3;0;10
13535;Želmenėliai;Voveriukų;2231634495;Taip;7;3;0;10
13536;Želmenėliai;Ežiukų;34055134038;Taip;14;2;0;16
13537;Želmenėliai;Ežiukų;63879513374;Ne;6;3;0;9
13538;Želmenėliai;Ežiukų;12336777368;Ne;0;3;1;4
13539;Želmenėliai;Ežiukų;65633625929;Taip;0;2;0;2
13540;Želmenėliai;Ežiukų;16400566719;Taip;0;1;0;1
13541;Želmenėliai;Ežiukų;22209426414;Taip;0;1;0;1
13542;Želmenėliai;Ežiukų;21636460884;Taip;0;5;0;5
13543;Želmenėliai;Ežiukų;8394779853;Taip;0;1;0;1
13544;Želmenėliai;Ežiukų;1425695010;Taip;0;1;0;1
13545;Želmenėliai;Ežiukų;10686783804;Ne;8;3;0;11
13546;Želmenėliai;Ežiukų;21263242044;Taip;0;1;0;1
13547;Želmenėliai;Ežiukų;77946540922;Taip;0;4;1;5
13548;Želmenėliai;Ežiukų;8218755050;Taip;0;3;1;4
13549;Želmenėliai;Ežiukų;68226657214;Taip;5;1;0;6
13550;Želmenėliai;Ežiukų;10990624964;Ne;10;4;0;14
13551;Želmenėliai;Peledžiukų;4206128805;Taip;0;2;0;2
13552;Želmenėliai;Peledžiukų;6816346946;Taip;0;1;0;1
13553;Želmenėliai;Peledžiukų;9359070885;Ne;6;0;0;6
13554;Želmenėliai;Peledžiukų;2727113833;Taip;8;0;0;8
13555;Želmenėliai;Peledžiukų;2428447892;Taip;6;1;0;7
13556;Želmenėliai;Peledžiukų;5787772212;Taip;0;1;0;1
13557;Želmenėliai;Peledžiukų;1239398642;Taip;0;2;0;2
13558;Želmenėliai;Peledžiukų;29112205705;Taip;3;0;0;3
13559;Želmenėliai;Peledžiukų;1248541555;Taip;0;3;0;3
13560;Želmenėliai;Peledžiukų;8995804360;Taip;0;2;0;2
13561;Želmenėliai;Peledžiukų;1522141057;Taip;8;0;5;13
13562;Želmenėliai;Peledžiukų;5616709457;Ne;10;2;0;12
13563;Želmenėliai;Peledžiukų;8300887366;Taip;0;6;0;6
13564;Želmenėliai;Peledžiukų;96660519820;Taip;12;0;0;12
13565;Želmenėliai;Peledžiukų;5842563754;Taip;0;3;0;3
13566;Želmenėliai;Peledžiukų;9375550172;Ne;5;3;0;8
13567;Želmenėliai;Peledžiukų;8478564831;Taip;0;7;0;7
13568;Želmenėliai;Peledžiukų;1941723687;Taip;0;3;0;3
13569;Želmenėliai;Peledžiukų;8590746750;Taip;3;5;0;8
13570;Želmenėliai;Peledžiukų;1343084840;Ne;15;1;0;16
13571;Želmenėliai;Drugelių;7664430346;Ne;10;0;0;10
13572;Želmenėliai;Drugelių;3417538909;Taip;0;1;0;1
13573;Želmenėliai;Drugelių;3295852546;Ne;0;7;0;7
13574;Želmenėliai;Drugelių;4739083871;Taip;0;6;1;7
13575;Želmenėliai;Drugelių;3379266015;Taip;0;9;0;9
13576;Želmenėliai;Drugelių;3737786832;Taip;0;2;1;3
13577;Želmenėliai;Drugelių;5633127620;Taip;12;1;0;13
13578;Želmenėliai;Drugelių;1984105453;Taip;10;1;0;11
13579;Želmenėliai;Drugelių;1920917916;Taip;17;1;0;18
13580;Želmenėliai;Drugelių;4652412483;Taip;0;12;0;12
13581;Želmenėliai;Drugelių;1652949383;Taip;0;1;0;1
13582;Želmenėliai;Drugelių;5046836398;Taip;0;1;0;1
13583;Želmenėliai;Drugelių;13558387807;Taip;0;1;0;1
13584;Želmenėliai;Drugelių;5143554665;Taip;0;7;0;7
13585;Želmenėliai;Drugelių;7585159351;Taip;0;9;0;9
13586;Želmenėliai;Drugelių;9207984505;Taip;5;10;0;15
13587;Želmenėliai;Drugelių;4634346755;Taip;9;1;1;11
13588;Želmenėliai;Drugelių;4916436238;Taip;0;10;0;10
13589;Želmenėliai;Drugelių;5558795651;Taip;15;1;0;16
13590;Želmenėliai;Voriukų;4264751761;Taip;10;0;0;10
13591;Želmenėliai;Voriukų;3184074698;Taip;5;0;0;5
13592;Želmenėliai;Voriukų;1614791794;Taip;0;3;0;3
13593;Želmenėliai;Voriukų;1203343580;Taip;15;1;0;16
13594;Želmenėliai;Voriukų;9351650342;Ne;0;7;0;7
13595;Želmenėliai;Voriukų;3014568232;Taip;0;4;0;4
13596;Želmenėliai;Voriukų;6916426436;Taip;0;4;0;4
13597;Želmenėliai;Voriukų;7563461821;Taip;21;0;0;21
13598;Želmenėliai;Voriukų;4534946646;Taip;8;0;0;8
13599;Želmenėliai;Voriukų;4075533071;Taip;0;4;0;4
13600;Želmenėliai;Voriukų;4545012342;Taip;5;2;0;7
13601;Želmenėliai;Voriukų;8504963337;Taip;0;2;0;2
13602;Želmenėliai;Voriukų;7505996978;Taip;8;3;0;11
13603;Želmenėliai;Voriukų;2846903449;Taip;12;1;0;13
13604;Želmenėliai;Voriukų;4473677352;Taip;0;5;0;5
13605;Želmenėliai;Voriukų;8973215240;Taip;3;4;0;7
13606;Želmenėliai;Voriukų;2722619508;Taip;0;12;0;12
13607;Želmenėliai;Voriukų;5025345647;Taip;0;10;0;10
13608;Želmenėliai;Voriukų;3043560150;Ne;2;3;0;5
13609;Želmenėliai;Voriukų;8892137326;Taip;0;14;0;14
13610;Želmenėliai;Boružėlių;51756630728;Taip;11;7;0;18
13611;Želmenėliai;Boružėlių;22539846993;Taip;8;1;0;9
13612;Želmenėliai;Boružėlių;5223588064;Ne;0;1;0;1
13613;Želmenėliai;Boružėlių;91372955120;Taip;0;1;0;1
13614;Želmenėliai;Boružėlių;2898358705;Taip;0;14;0;14
13615;Želmenėliai;Boružėlių;63043069680;Taip;12;0;0;12
13616;Želmenėliai;Boružėlių;10462964817;Taip;0;1;0;1
13617;Želmenėliai;Boružėlių;2103938312;Taip;0;3;0;3
13618;Želmenėliai;Boružėlių;35901929384;Taip;0;11;0;11
13619;Želmenėliai;Boružėlių;39675390598;Taip;0;1;0;1
13620;Želmenėliai;Boružėlių;1290780920;Taip;10;4;0;14
13621;Želmenėliai;Boružėlių;1699958696;Taip;0;13;0;13
13622;Želmenėliai;Boružėlių;98852944217;Ne;0;6;0;6
13623;Želmenėliai;Boružėlių;7502363323;Ne;9;8;0;17
13624;Želmenėliai;Boružėlių;1009164107;Taip;10;2;0;12
13625;Želmenėliai;Boružėlių;92486344928;Taip;0;9;0;9
13626;Želmenėliai;Boružėlių;1802714172;Taip;8;1;0;9
13627;Želmenėliai;Boružėlių;1933769076;Taip;0;1;0;1
13628;Želmenėliai;Boružėlių;1134743316;Taip;13;0;0;13
13629;Želmenėliai;Boružėlių;9414488405;Taip;21;0;0;21
13630;Želmenėliai;Pūkuotukų;73813829491;Taip;0;17;0;17
13631;Želmenėliai;Pūkuotukų;79879695958;Taip;8;1;0;9
13632;Želmenėliai;Pūkuotukų;54536849345;Taip;0;6;0;6
13633;Želmenėliai;Pūkuotukų;8936734213;Taip;18;0;0;18
13634;Želmenėliai;Pūkuotukų;1213403598;Taip;0;3;0;3
13635;Želmenėliai;Pūkuotukų;1803684569;Ne;0;3;0;3
13636;Želmenėliai;Pūkuotukų;1716801722;Taip;7;6;0;13
13637;Želmenėliai;Pūkuotukų;45440599686;Taip;6;6;0;12
13638;Želmenėliai;Pūkuotukų;50805473649;Taip;11;6;0;17
13639;Želmenėliai;Pūkuotukų;1405460015;Ne;0;2;0;2
13640;Želmenėliai;Pūkuotukų;85619767784;Taip;0;10;0;10
13641;Želmenėliai;Pūkuotukų;1800724034;Taip;0;1;1;2
13642;Želmenėliai;Pūkuotukų;8706951420;Taip;3;6;0;9
13643;Želmenėliai;Pūkuotukų;1426827854;Taip;0;1;0;1
13644;Želmenėliai;Pūkuotukų;1619412305;Taip;0;1;0;1
13645;Želmenėliai;Pūkuotukų;75198661944;Taip;0;2;0;2
13646;Želmenėliai;Pūkuotukų;2036184590;Taip;0;1;0;1
13647;Želmenėliai;Pūkuotukų;37152467004;Taip;0;2;0;2
13648;Želmenėliai;Ančiukų;9493581034;Taip;11;1;0;12
13649;Želmenėliai;Ančiukų;6509783586;Taip;10;1;0;11
13650;Želmenėliai;Ančiukų;8987377791;Taip;0;6;0;6
13651;Želmenėliai;Ančiukų;4126499046;Taip;0;0;1;1
13652;Želmenėliai;Ančiukų;4758240577;Taip;8;0;0;8
13653;Želmenėliai;Ančiukų;2570248893;Taip;0;9;0;9
13654;Želmenėliai;Ančiukų;2577850672;Taip;0;1;0;1
13655;Želmenėliai;Ančiukų;2111008869;Taip;10;0;0;10
13656;Želmenėliai;Ančiukų;4198085732;Taip;9;0;0;9
13657;Želmenėliai;Ančiukų;7849682820;Taip;13;1;0;14
13658;Želmenėliai;Ančiukų;4589396143;Taip;11;1;0;12
13659;Želmenėliai;Ančiukų;7094853897;Taip;21;0;0;21
13660;Želmenėliai;Ančiukų;5281861477;Taip;14;0;0;14
13661;Želmenėliai;Nykštukų;3572462731;Taip;0;1;0;1
13662;Želmenėliai;Nykštukų;1652131150;Ne;0;2;0;2
13663;Želmenėliai;Nykštukų;2350936740;Taip;18;0;0;18
13664;Želmenėliai;Nykštukų;4931664953;Taip;12;0;0;12
13665;Želmenėliai;Nykštukų;3063417708;Taip;0;7;0;7
13666;Želmenėliai;Nykštukų;2311169187;Taip;4;0;1;5
13667;Želmenėliai;Nykštukų;6635909614;Taip;0;5;0;5
13668;Želmenėliai;Nykštukų;8954705816;Taip;13;0;0;13
13669;Želmenėliai;Nykštukų;5795735579;Taip;9;0;0;9
13670;Želmenėliai;Nykštukų;1292462938;Taip;11;0;0;11
13671;Želmenėliai;Nykštukų;3353793939;Taip;7;0;0;7
13672;Želmenėliai;Nykštukų;8519608506;Taip;8;0;0;8
13673;Želmenėliai;Nykštukų;1877749103;Taip;0;4;0;4
13674;Želmenėliai;Lašelių;8154713582;Taip;6;0;1;7
13675;Želmenėliai;Lašelių;5171736943;Taip;0;3;0;3
13676;Želmenėliai;Lašelių;6876147546;Taip;0;2;0;2
13677;Želmenėliai;Lašelių;9126715074;Taip;0;12;0;12
13678;Želmenėliai;Lašelių;6180553648;Taip;0;10;0;10
13679;Želmenėliai;Lašelių;1260607572;Taip;0;1;0;1
13680;Želmenėliai;Lašelių;4120125150;Taip;3;0;4;7
13681;Želmenėliai;Lašelių;3972980949;Taip;0;8;0;8
13682;Želmenėliai;Lašelių;2296870749;Taip;11;0;0;11
13683;Želmenėliai;Lašelių;2262009049;Taip;20;0;0;20
13684;Želmenėliai;Lašelių;6819466901;Taip;5;0;0;5
13685;Želmenėliai;Lašelių;6779746783;Taip;7;0;0;7
13686;Želmenėliai;Lašelių;5750337167;Taip;11;0;0;11
13687;Žemyna;Čiauškučiai;2003368811;Taip;6;0;0;6
13688;Žemyna;Čiauškučiai;9130965949;Taip;0;1;0;1
13689;Žemyna;Čiauškučiai;58578414067;Taip;0;1;0;1
13690;Žemyna;Čiauškučiai;88775150201;Taip;0;0;1;1
13691;Žemyna;Čiauškučiai;1683299408;Taip;0;1;0;1
13692;Žemyna;Čiauškučiai;39175264243;Taip;0;2;0;2
13693;Žemyna;Čiauškučiai;35462796459;Taip;0;0;1;1
13694;Žemyna;Čiauškučiai;50543973728;Taip;17;0;1;18
13695;Žemyna;Čiauškučiai;1595030102;Ne;0;0;1;1
13696;Žemyna;Čiauškučiai;6448628301;Taip;14;1;0;15
13697;Žemyna;Čiauškučiai;1421842247;Taip;0;1;0;1
13698;Žemyna;Čiauškučiai;47562685723;Taip;5;1;1;7
13699;Žemyna;Čiauškučiai;32755929074;Taip;11;2;0;13
13700;Žemyna;Čiauškučiai;54253890981;Taip;0;1;3;4
13701;Žemyna;Čiauškučiai;54823974018;Taip;3;0;0;3
13702;Žemyna;Čiauškučiai;1049546597;Taip;0;0;6;6
13703;Žemyna;Čiauškučiai;99015221693;Taip;0;1;0;1
13704;Žemyna;Čiauškučiai;38604851102;Taip;13;0;4;17
13705;Žemyna;Čiauškučiai;1305667359;Taip;0;0;3;3
13706;Žemyna;Čiauškučiai;6089122225;Taip;0;2;0;2
13707;Žemyna;Čiauškučiai;7343337032;Taip;3;1;4;8
13708;Žemyna;Nykštukai;5114094924;Taip;15;1;0;16
13709;Žemyna;Nykštukai;3874855308;Taip;0;5;1;6
13710;Žemyna;Nykštukai;2461700030;Taip;11;0;0;11
13711;Žemyna;Nykštukai;1725771976;Taip;0;0;3;3
13712;Žemyna;Nykštukai;8622780639;Taip;5;1;0;6
13713;Žemyna;Nykštukai;3643594001;Taip;0;0;3;3
13714;Žemyna;Nykštukai;9182709647;Taip;4;3;0;7
13715;Žemyna;Nykštukai;7121742098;Taip;11;5;0;16
13716;Žemyna;Nykštukai;1468040559;Taip;10;0;0;10
13717;Žemyna;Nykštukai;4322192775;Taip;5;1;0;6
13718;Žemyna;Nykštukai;4444870782;Taip;0;2;1;3
13719;Žemyna;Nykštukai;7781924111;Taip;4;6;1;11
13720;Žemyna;Nykštukai;4257096808;Ne;5;0;1;6
13721;Žemyna;Nykštukai;1575505075;Taip;4;10;1;15
13722;Žemyna;Nykštukai;2860210906;Taip;8;1;0;9
13723;Žemyna;Nykštukai;7832066079;Ne;11;0;0;11
13724;Žemyna;Nykštukai;4759403487;Taip;15;1;0;16
13725;Žemyna;Nykštukai;9653530823;Taip;0;0;5;5
13726;Žemyna;Nykštukai;7508491119;Taip;5;1;0;6
13727;Žemyna;Nykštukai;2928125522;Ne;12;1;0;13
13728;Žemyna;Voveriukai;3135562485;Taip;10;0;0;10
13729;Žemyna;Voveriukai;2976467316;Taip;0;1;3;4
13730;Žemyna;Voveriukai;6812823390;Taip;0;1;2;3
13731;Žemyna;Voveriukai;8500642069;Taip;0;16;0;16
13732;Žemyna;Voveriukai;6430348135;Taip;3;3;0;6
13733;Žemyna;Voveriukai;7925774308;Taip;5;0;0;5
13734;Žemyna;Voveriukai;3938938667;Taip;0;0;3;3
13735;Žemyna;Voveriukai;9958040413;Ne;18;0;0;18
13736;Žemyna;Voveriukai;1531980297;Taip;1;0;0;1
13737;Žemyna;Voveriukai;1114714466;Taip;6;0;1;7
13738;Žemyna;Voveriukai;1807466584;Taip;17;0;0;17
13739;Žemyna;Voveriukai;1543415914;Taip;6;0;1;7
13740;Žemyna;Voveriukai;7125026803;Taip;0;1;0;1
13741;Žemyna;Voveriukai;9148594407;Taip;0;9;0;9
13742;Žemyna;Voveriukai;6701717634;Taip;0;2;0;2
13743;Žemyna;Voveriukai;9866110744;Taip;0;0;3;3
13744;Žemyna;Voveriukai;7693278353;Taip;5;1;1;7
13745;Žemyna;Voveriukai;1118997229;Taip;7;1;0;8
13746;Žemyna;Voveriukai;3357339710;Taip;11;0;3;14
13747;Žemyna;Kiškučiai;26124703883;Taip;0;0;1;1
13748;Žemyna;Kiškučiai;1688122673;Taip;0;1;0;1
13749;Žemyna;Kiškučiai;5635456615;Taip;5;4;0;9
13750;Žemyna;Kiškučiai;1947185865;Taip;0;1;4;5
13751;Žemyna;Kiškučiai;6647400698;Ne;0;1;2;3
13752;Žemyna;Kiškučiai;23371576969;Ne;0;3;0;3
13753;Žemyna;Kiškučiai;5830320758;Taip;0;10;0;10
13754;Žemyna;Kiškučiai;6148416514;Taip;0;21;0;21
13755;Žemyna;Kiškučiai;1380225362;Taip;5;0;0;5
13756;Žemyna;Kiškučiai;88687293547;Ne;0;3;0;3
13757;Žemyna;Kiškučiai;43607772302;Taip;8;1;0;9
13758;Žemyna;Kiškučiai;1265326169;Taip;0;0;6;6
13759;Žemyna;Kiškučiai;2032992299;Taip;6;0;0;6
13760;Žemyna;Kiškučiai;1210307182;Taip;6;0;0;6
13761;Žemyna;Kiškučiai;4570281722;Ne;0;1;4;5
13762;Žemyna;Kiškučiai;92534877861;Taip;0;1;0;1
13763;Žemyna;Kiškučiai;1716821186;Taip;2;0;0;2
13764;Žemyna;Kiškučiai;75681135185;Taip;0;1;0;1
13765;Žemyna;Kiškučiai;15573695823;Taip;0;2;0;2
13766;Žemyna;Kiškučiai;2072914123;Taip;4;1;0;5
13767;Žemyna;Kiškučiai;8292265369;Taip;0;1;2;3
13768;Žemyna;Vyturiukai;9232638767;Taip;3;0;2;5
13769;Žemyna;Vyturiukai;38769607968;Taip;0;1;0;1
13770;Žemyna;Vyturiukai;47470155594;Taip;8;0;0;8
13771;Žemyna;Vyturiukai;17098859260;Taip;9;0;0;9
13772;Žemyna;Vyturiukai;1687206394;Taip;11;0;1;12
13773;Žemyna;Vyturiukai;5508251792;Taip;6;0;0;6
13774;Žemyna;Vyturiukai;85135645557;Taip;5;1;0;6
13775;Žemyna;Vyturiukai;59506345859;Taip;2;2;0;4
13776;Žemyna;Vyturiukai;89787441782;Taip;0;1;0;1
13777;Žemyna;Vyturiukai;5306392307;Taip;7;4;4;15
13778;Žemyna;Vyturiukai;9018138289;Taip;0;7;1;8
13779;Žemyna;Vyturiukai;37570629861;Taip;16;2;0;18
13780;Žemyna;Vyturiukai;13242930752;Taip;0;1;0;1
13781;Žemyna;Vyturiukai;96473502730;Taip;5;0;3;8
13782;Žemyna;Vyturiukai;93423088394;Taip;0;4;0;4
13783;Žemyna;Vyturiukai;8040359407;Taip;0;1;0;1
13784;Žemyna;Vyturiukai;3622634119;Ne;7;0;1;8
13785;Žemyna;Vyturiukai;4235160760;Taip;0;0;1;1
13786;Žemyna;Pelėdžiukai;68982161758;Taip;0;1;2;3
13787;Žemyna;Pelėdžiukai;2972633401;Ne;0;1;0;1
13788;Žemyna;Pelėdžiukai;65677663175;Taip;5;6;0;11
13789;Žemyna;Pelėdžiukai;74969696164;Taip;0;2;0;2
13790;Žemyna;Pelėdžiukai;47974278492;Taip;0;2;0;2
13791;Žemyna;Pelėdžiukai;92159859248;Taip;6;0;0;6
13792;Žemyna;Pelėdžiukai;10344263960;Taip;0;1;3;4
13793;Žemyna;Pelėdžiukai;54029612806;Taip;0;6;0;6
13794;Žemyna;Pelėdžiukai;93378737171;Taip;0;2;0;2
13795;Žemyna;Pelėdžiukai;5204796908;Taip;0;0;1;1
13796;Žemyna;Pelėdžiukai;9556275322;Taip;11;1;0;12
13797;Žemyna;Pelėdžiukai;78280621543;Taip;0;5;0;5
13798;Žemyna;Pelėdžiukai;81683768388;Taip;0;0;2;2
13799;Žemyna;Pelėdžiukai;65117735882;Taip;7;1;1;9
13800;Žemyna;Pelėdžiukai;59441904717;Taip;13;0;0;13
13801;Žemyna;Pelėdžiukai;97712802830;Taip;0;2;0;2
13802;Žemyna;Pelėdžiukai;70694756261;Taip;0;1;3;4
13803;Žemyna;Pelėdžiukai;45269313606;Taip;0;1;0;1
13804;Žemyna;Pelėdžiukai;30518889603;Taip;0;1;0;1
13805;Žemyna;Pelėdžiukai;1674165765;Taip;4;3;0;7
13806;Žemyna;Pelėdžiukai;2033947862;Taip;0;1;2;3
13807;Žemyna;Pelėdžiukai;1337500221;Taip;0;1;0;1
13808;Žemyna;Vijurkai;96099047169;Taip;0;1;0;1
13809;Žemyna;Vijurkai;85617781303;Taip;4;0;0;4
13810;Žemyna;Vijurkai;62565967575;Taip;0;1;0;1
13811;Žemyna;Vijurkai;1535497308;Taip;5;1;0;6
13812;Žemyna;Vijurkai;1158352472;Taip;4;1;0;5
13813;Žemyna;Vijurkai;10288969939;Taip;0;1;0;1
13814;Žemyna;Vijurkai;40843229500;Ne;0;1;0;1
13815;Žemyna;Vijurkai;69690099920;Taip;0;1;2;3
13816;Žemyna;Vijurkai;98477626952;Taip;0;1;0;1
13817;Žemyna;Vijurkai;71013970407;Taip;0;1;0;1
13818;Žemyna;Vijurkai;87939385151;Taip;0;1;0;1
13819;Žemyna;Vijurkai;56418377668;Taip;0;1;0;1
13820;Žemyna;Vijurkai;46550223916;Taip;2;0;0;2
13821;Žemyna;Vijurkai;98919412716;Taip;0;1;0;1
13822;Žemyna;Vijurkai;1866645242;Taip;4;1;0;5
13823;Žemyna;Vijurkai;83056273504;Taip;0;1;1;2
13824;Žemyna;Vijurkai;1609941314;Ne;6;1;0;7
13825;Žemyna;Vijurkai;1790109762;Taip;0;1;1;2
13826;Žemyna;Vijurkai;89754744294;Taip;0;1;0;1
13827;Žemyna;Vijurkai;1393006122;Taip;0;1;1;2
13828;Žemyna;Vijurkai;9409512255;Taip;0;0;8;8
13829;Žemyna;Vijurkai;55748223762;Taip;0;0;2;2
13830;Žemyna;Šnekučiai;9501126807;Taip;5;1;2;8
13831;Žemyna;Šnekučiai;6735720135;Taip;10;0;3;13
13832;Žemyna;Šnekučiai;9912869400;Taip;5;0;1;6
13833;Žemyna;Šnekučiai;2006173745;Taip;5;10;1;16
13834;Žemyna;Šnekučiai;6116581655;Taip;0;0;1;1
13835;Žemyna;Šnekučiai;5727308039;Taip;0;2;0;2
13836;Žemyna;Šnekučiai;7367602247;Taip;0;2;0;2
13837;Žemyna;Šnekučiai;7280740926;Taip;5;0;0;5
13838;Žemyna;Šnekučiai;6419974691;Taip;5;1;0;6
13839;Žemyna;Šnekučiai;9818711030;Taip;6;5;0;11
13840;Žemyna;Šnekučiai;9219519029;Ne;0;12;2;14
13841;Žemyna;Šnekučiai;6293560729;Taip;12;0;0;12
13842;Žemyna;Šnekučiai;7764615445;Taip;0;0;1;1
13843;Žemyna;Šnekučiai;3992383447;Taip;17;0;0;17
13844;Žemyna;Šnekučiai;9668975591;Taip;16;0;0;16
13845;Žemyna;Šnekučiai;6856737270;Ne;0;0;2;2
13846;Žemyna;Šnekučiai;5188496664;Taip;19;0;1;20
13847;Žemyna;Šnekučiai;4872348199;Taip;6;0;2;8
13848;Žemyna;Šnekučiai;6878669773;Taip;5;0;1;6
13849;Žemyna;Šnekučiai;4502958166;Ne;0;1;1;2
13850;Žemyna;Šnekučiai;5688714928;Taip;7;0;1;8
13851;Žemyna;Pabiručiai;3596822649;Taip;1;0;1;2
13852;Žemyna;Pabiručiai;86746604640;Taip;10;0;0;10
13853;Žemyna;Pabiručiai;82507236376;Taip;0;1;4;5
13854;Žemyna;Pabiručiai;84955588471;Taip;1;0;1;2
13855;Žemyna;Pabiručiai;80737839511;Taip;0;2;0;2
13856;Žemyna;Pabiručiai;82479499709;Ne;0;0;2;2
13857;Žemyna;Pabiručiai;14902924855;Taip;0;2;0;2
13858;Žemyna;Pabiručiai;50687988382;Ne;0;11;0;11
13859;Žemyna;Pabiručiai;1278096396;Taip;7;0;5;12
13860;Žemyna;Pabiručiai;8726346349;Taip;11;0;0;11
13861;Žemyna;Pabiručiai;2841526614;Taip;8;0;1;9
13862;Žemyna;Pabiručiai;8496195396;Taip;5;0;4;9
13863;Žemyna;Pabiručiai;4796265997;Taip;0;0;4;4
13864;Žemyna;Pabiručiai;8139714064;Taip;0;1;2;3
13865;Žemyna;Pabiručiai;3895238312;Taip;9;0;0;9
13866;Žemyna;Pabiručiai;1058705875;Taip;1;10;0;11
13867;Žemyna;Pabiručiai;7785889259;Taip;0;0;1;1
13868;Žemyna;Pabiručiai;7676796264;Taip;0;3;0;3
13869;Žemyna;Pabiručiai;2090395417;Taip;9;1;0;10
13870;Žemyna;Pabiručiai;15110117571;Taip;1;0;0;1
13871;Žemyna;Drugeliai;72801825176;Taip;4;2;0;6
13872;Žemyna;Drugeliai;32383247850;Taip;13;0;0;13
13873;Žemyna;Drugeliai;2100326039;Taip;5;0;1;6
13874;Žemyna;Drugeliai;84680481889;Taip;0;1;2;3
13875;Žemyna;Drugeliai;1471204471;Taip;0;3;0;3
13876;Žemyna;Drugeliai;1882507954;Taip;1;1;0;2
13877;Žemyna;Drugeliai;1607110213;Taip;0;5;2;7
13878;Žemyna;Drugeliai;1623854426;Taip;0;1;0;1
13879;Žemyna;Drugeliai;50369667193;Taip;5;1;0;6
13880;Žemyna;Drugeliai;1705971732;Taip;10;10;0;20
13881;Žemyna;Drugeliai;17784132877;Taip;0;0;1;1
13882;Žemyna;Drugeliai;45222048620;Taip;0;6;1;7
13883;Žemyna;Drugeliai;1654912072;Taip;0;0;2;2
13884;Žemyna;Drugeliai;1968337404;Taip;9;0;0;9
13885;Žemyna;Drugeliai;27867030470;Taip;0;1;0;1
13886;Žemyna;Drugeliai;51870099224;Taip;2;0;4;6
13887;Žemyna;Drugeliai;1941650167;Taip;0;1;0;1
13888;Žemyna;Drugeliai;1867198805;Taip;0;1;0;1
13889;Žemyna;Drugeliai;4519502372;Taip;0;1;1;2
13890;Žemyna;Drugeliai;1481869723;Ne;0;0;9;9
13891;Žemyna;Drugeliai;8018865138;Ne;0;2;0;2
13892;Žemyna;Drugeliai;5233574060;Ne;11;0;0;11
13893;Žemyna;"ŽIRNIUKAI ";7620179886;Taip;12;0;1;13
13894;Žemyna;"ŽIRNIUKAI ";5069437469;Taip;6;1;0;7
13895;Žemyna;"ŽIRNIUKAI ";7277970673;Taip;5;2;0;7
13896;Žemyna;"ŽIRNIUKAI ";3074391266;Taip;15;0;1;16
13897;Žemyna;"ŽIRNIUKAI ";2547436771;Taip;17;0;1;18
13898;Žemyna;"ŽIRNIUKAI ";6346173832;Taip;5;0;0;5
13899;Žemyna;"ŽIRNIUKAI ";1365045512;Taip;4;0;0;4
13900;Žemyna;"ŽIRNIUKAI ";4642600915;Taip;0;1;0;1
13901;Žemyna;"ŽIRNIUKAI ";5416338054;Taip;0;21;0;21
13902;Žemyna;"ŽIRNIUKAI ";5133115712;Taip;0;21;0;21
13903;Žemyna;"ŽIRNIUKAI ";2792702536;Taip;5;1;0;6
13904;Žemyna;"ŽIRNIUKAI ";6051208732;Taip;5;1;0;6
13905;Žemyna;"ŽIRNIUKAI ";7427119736;Taip;3;0;0;3
13906;Žemyna;"ŽIRNIUKAI ";2354265632;Taip;21;0;0;21
13907;Žemyna;"ŽIOGELIAI ";9094718595;Taip;6;0;1;7
13908;Žemyna;"ŽIOGELIAI ";6208953341;Taip;6;1;0;7
13909;Žemyna;"ŽIOGELIAI ";9827401825;Taip;0;10;0;10
13910;Žemyna;"ŽIOGELIAI ";8559870965;Taip;10;0;0;10
13911;Žemyna;"ŽIOGELIAI ";4176386795;Taip;0;4;0;4
13912;Žemyna;"ŽIOGELIAI ";6958537154;Taip;0;2;0;2
13913;Žemyna;"ŽIOGELIAI ";2034162734;Taip;0;3;0;3
13914;Žemyna;"ŽIOGELIAI ";7122276019;Taip;5;0;0;5
13915;Žemyna;"ŽIOGELIAI ";1745197274;Taip;10;0;0;10
13916;Žemyna;"ŽIOGELIAI ";6041223291;Taip;14;2;0;16
13917;Žemyna;"ŽIOGELIAI ";8248443265;Taip;4;0;3;7
13918;Žemyna;"ŽIOGELIAI ";1850100203;Taip;13;0;0;13
13919;Žemyna;"ŽIOGELIAI ";9628651723;Ne;17;0;0;17
13920;Žemyna;"ŽIOGELIAI ";5743535463;Taip;13;0;0;13
13921;Žemyna;"ŽIOGELIAI ";4613946229;Taip;0;4;0;4
13922;Žemyna;"ŽIOGELIAI ";1656335765;Taip;4;1;0;5
13923;Žemuogėlė;Boružiukai;54663750186;Taip;0;1;0;1
13924;Žemuogėlė;Boružiukai;4231767115;Taip;0;7;0;7
13925;Žemuogėlė;Boružiukai;3977351017;Taip;0;7;0;7
13926;Žemuogėlė;Boružiukai;3854265246;Taip;5;2;0;7
13927;Žemuogėlė;Boružiukai;5147617128;Taip;3;13;0;16
13928;Žemuogėlė;Boružiukai;1058207935;Taip;0;1;0;1
13929;Žemuogėlė;Boružiukai;1628749648;Taip;0;0;1;1
13930;Žemuogėlė;Boružiukai;711908013;Taip;0;2;0;2
13931;Žemuogėlė;Boružiukai;6962103028;Taip;0;2;0;2
13932;Žemuogėlė;Boružiukai;7714826773;Taip;3;6;0;9
13933;Žemuogėlė;Boružiukai;3134493860;Taip;0;1;0;1
13934;Žemuogėlė;Boružiukai;8023936861;Taip;3;0;1;4
13935;Žemuogėlė;Boružiukai;1907004376;Taip;0;1;0;1
13936;Žemuogėlė;Boružiukai;38870047353;Taip;12;0;0;12
13937;Žemuogėlė;Boružiukai;7403172794;Taip;5;1;0;6
13938;Žemuogėlė;Boružiukai;9315711142;Taip;0;2;0;2
13939;Žemuogėlė;Boružiukai;94792383091;Taip;9;0;0;9
13940;Žemuogėlė;Boružiukai;4421397490;Taip;0;7;0;7
13941;Žemuogėlė;Šviesuliukai;4810459063;Taip;0;1;0;1
13942;Žemuogėlė;Šviesuliukai;1745679183;Taip;0;1;0;1
13943;Žemuogėlė;Šviesuliukai;9255723192;Taip;5;0;0;5
13944;Žemuogėlė;Šviesuliukai;2740942924;Taip;8;0;1;9
13945;Žemuogėlė;Šviesuliukai;5972567526;Taip;0;1;0;1
13946;Žemuogėlė;Šviesuliukai;1910570858;Taip;0;6;0;6
13947;Žemuogėlė;Šviesuliukai;8409711622;Taip;0;2;0;2
13948;Žemuogėlė;Šviesuliukai;6726124641;Taip;0;2;0;2
13949;Žemuogėlė;Šviesuliukai;5127370193;Taip;0;0;1;1
13950;Žemuogėlė;Šviesuliukai;5126348190;Taip;12;1;0;13
13951;Žemuogėlė;Šviesuliukai;9534937419;Taip;8;0;1;9
13952;Žemuogėlė;Šviesuliukai;3612833383;Taip;13;0;0;13
13953;Žemuogėlė;Šviesuliukai;3000676765;Taip;17;0;0;17
13954;Žemuogėlė;Šviesuliukai;9689082202;Taip;11;2;0;13
13955;Žemuogėlė;Šviesuliukai;1275552038;Taip;7;1;0;8
13956;Žemuogėlė;Šviesuliukai;1377813636;Taip;1;0;0;1
13957;Žemuogėlė;Šviesuliukai;2731544174;Taip;0;1;0;1
13958;Žemuogėlė;Šviesuliukai;4660479216;Taip;10;0;0;10
13959;Žemuogėlė;Lašiukai;1248683052;Taip;0;1;0;1
13960;Žemuogėlė;Lašiukai;2099256322;Taip;0;1;0;1
13961;Žemuogėlė;Lašiukai;2320908623;Taip;5;2;0;7
13962;Žemuogėlė;Lašiukai;3208009994;Taip;0;2;0;2
13963;Žemuogėlė;Lašiukai;60841198741;Taip;0;6;0;6
13964;Žemuogėlė;Lašiukai;2146044539;Taip;0;3;0;3
13965;Žemuogėlė;Lašiukai;97014601220;Ne;0;3;0;3
13966;Žemuogėlė;Lašiukai;31450036105;Taip;6;3;0;9
13967;Žemuogėlė;Lašiukai;93523683833;Taip;0;3;2;5
13968;Žemuogėlė;Lašiukai;1223819270;Ne;0;1;0;1
13969;Žemuogėlė;Lašiukai;1608506638;Taip;3;1;0;4
13970;Žemuogėlė;Lašiukai;1448477562;Taip;3;1;0;4
13971;Žemuogėlė;Lašiukai;4900328025;Taip;0;1;0;1
13972;Žemuogėlė;Lašiukai;8295541141;Ne;5;3;0;8
13973;Žemuogėlė;Lašiukai;1223648771;Taip;0;1;0;1
13974;Žemuogėlė;Skambaliukai;34462365948;Taip;0;2;0;2
13975;Žemuogėlė;Skambaliukai;13768771915;Taip;0;1;0;1
13976;Žemuogėlė;Skambaliukai;96539338587;Taip;4;5;0;9
13977;Žemuogėlė;Skambaliukai;1844596636;Taip;0;1;0;1
13978;Žemuogėlė;Skambaliukai;10356039859;Taip;0;1;0;1
13979;Žemuogėlė;Skambaliukai;8952696734;Taip;0;6;0;6
13980;Žemuogėlė;Skambaliukai;77880141132;Taip;0;1;0;1
13981;Žemuogėlė;Skambaliukai;53763899224;Taip;0;1;0;1
13982;Žemuogėlė;Skambaliukai;29973978107;Taip;0;1;0;1
13983;Žemuogėlė;Skambaliukai;1366286798;Taip;0;1;0;1
13984;Žemuogėlė;Skambaliukai;58604834495;Taip;4;2;0;6
13985;Žemuogėlė;Skambaliukai;87719167969;Taip;0;3;0;3
13986;Žemuogėlė;Skambaliukai;97664138036;Taip;0;3;0;3
13987;Žemuogėlė;Skambaliukai;66464155865;Taip;0;2;1;3
13988;Žemuogėlė;Skambaliukai;3354347837;Taip;0;1;0;1
13989;Žemuogėlė;Skambaliukai;98006600854;Taip;0;3;0;3
13990;Žemuogėlė;Skambaliukai;28795421460;Taip;0;1;0;1
13991;Žemuogėlė;Skambaliukai;33112231008;Taip;0;12;0;12
13992;Žemuogėlė;Skambaliukai;37726841145;Taip;0;1;0;1
13993;Žemuogėlė;Skambaliukai;24111477729;Taip;7;1;0;8
13994;Žemuogėlė;Spinduliukai;62210251654;Taip;0;5;0;5
13995;Žemuogėlė;Spinduliukai;22761916112;Ne;0;5;0;5
13996;Žemuogėlė;Spinduliukai;5888483930;Ne;0;7;0;7
13997;Žemuogėlė;Spinduliukai;97511628790;Taip;0;4;0;4
13998;Žemuogėlė;Spinduliukai;89316574266;Taip;1;0;0;1
13999;Žemuogėlė;Spinduliukai;64042870424;Taip;3;2;0;5
14000;Žemuogėlė;Spinduliukai;1296464444;Taip;4;2;0;6
14001;Žemuogėlė;Spinduliukai;29436958034;Taip;3;2;0;5
14002;Žemuogėlė;Spinduliukai;9864664937;Taip;0;3;0;3
14003;Žemuogėlė;Spinduliukai;75012082294;Taip;0;2;0;2
14004;Žemuogėlė;Spinduliukai;9042246873;Taip;7;6;0;13
14005;Žemuogėlė;Spinduliukai;57783467185;Taip;10;1;0;11
14006;Žemuogėlė;Spinduliukai;24863928147;Taip;0;1;0;1
14007;Žemuogėlė;Spinduliukai;1859848343;Taip;0;7;0;7
14008;Žemuogėlė;Spinduliukai;96167322031;Taip;9;2;0;11
14009;Žemuogėlė;Spinduliukai;4766971363;Taip;0;4;0;4
14010;Žemuogėlė;Spinduliukai;1608544032;Taip;0;6;0;6
14011;Žemuogėlė;Spinduliukai;3868254757;Taip;0;1;0;1
14012;Žemuogėlė;Spinduliukai;8187939143;Taip;0;3;0;3
14013;Žemuogėlė;Spinduliukai;3062268362;Taip;2;1;0;3
14014;Žemuogėlė;Spinduliukai;5395954931;Taip;0;3;0;3
14015;Žemuogėlė;Spinduliukai;73679997517;Taip;0;3;0;3
14016;Žemuogėlė;Perliukai;64182347253;Taip;0;2;0;2
14017;Žemuogėlė;Perliukai;23841110826;Taip;0;1;0;1
14018;Žemuogėlė;Perliukai;89682626079;Taip;1;3;0;4
14019;Žemuogėlė;Perliukai;21886029194;Taip;0;2;0;2
14020;Žemuogėlė;Perliukai;7503799036;Taip;9;0;1;10
14021;Žemuogėlė;Perliukai;95392130582;Taip;0;2;0;2
14022;Žemuogėlė;Perliukai;1099252682;Taip;7;2;0;9
14023;Žemuogėlė;Perliukai;1550066922;Taip;0;2;0;2
14024;Žemuogėlė;Perliukai;1354590098;Taip;0;1;0;1
14025;Žemuogėlė;Perliukai;1543283524;Taip;0;2;0;2
14026;Žemuogėlė;Perliukai;1085793430;Taip;0;2;0;2
14027;Žemuogėlė;Perliukai;1970687025;Taip;4;2;0;6
14028;Žemuogėlė;Perliukai;52842591023;Taip;0;0;2;2
14029;Žemuogėlė;Perliukai;5911529759;Taip;0;4;0;4
14030;Žemuogėlė;Perliukai;1093128368;Taip;0;2;0;2
14031;Žemuogėlė;Perliukai;70054283264;Taip;10;1;0;11
14032;Žemuogėlė;Perliukai;40590616715;Taip;3;2;0;5
14033;Žemuogėlė;Drugeliai;9592456683;Taip;3;2;0;5
14034;Žemuogėlė;Drugeliai;3765022476;Taip;1;3;0;4
14035;Žemuogėlė;Drugeliai;9519563708;Taip;0;2;0;2
14036;Žemuogėlė;Drugeliai;5266493632;Taip;10;0;0;10
14037;Žemuogėlė;Drugeliai;3237083654;Taip;11;10;0;21
14038;Žemuogėlė;Drugeliai;2259779058;Taip;3;0;0;3
14039;Žemuogėlė;Drugeliai;9693894254;Taip;11;0;0;11
14040;Žemuogėlė;Drugeliai;5418395023;Taip;3;2;0;5
14041;Žemuogėlė;Drugeliai;6581889641;Taip;11;0;0;11
14042;Žemuogėlė;Drugeliai;2555902309;Taip;12;1;0;13
14043;Žemuogėlė;Drugeliai;4536398519;Taip;0;4;0;4
14044;Žemuogėlė;Drugeliai;3458374439;Taip;0;1;0;1
14045;Žemuogėlė;Drugeliai;8757701456;Taip;0;6;0;6
14046;Žemuogėlė;Drugeliai;1713927628;Taip;5;3;0;8
14047;Žemuogėlė;Drugeliai;1844299594;Taip;10;2;0;12
14048;Žemuogėlė;Drugeliai;2132549536;Taip;4;2;0;6
14049;Žemuogėlė;Drugeliai;8496353410;Taip;0;2;0;2
14050;Žemuogėlė;Drugeliai;7804015060;Taip;0;1;0;1
14051;Žemuogėlė;Drugeliai;3714945248;Taip;21;0;0;21
14052;Žemuogėlė;Drugeliai;2001471529;Taip;0;6;0;6
14053;Žemuogėlė;Drugeliai;9378432383;Taip;0;3;0;3
14054;Žemuogėlė;Drugeliai;6913038845;Taip;9;3;0;12
14055;Žemuogėlė;Drugeliai;5532053268;Taip;10;1;0;11
14056;Žemuogėlė;"VIEVERSIUKAI ";7592566602;Taip;2;0;1;3
14057;Žemuogėlė;"VIEVERSIUKAI ";2664267604;Taip;11;0;0;11
14058;Žemuogėlė;"VIEVERSIUKAI ";9693814425;Taip;0;0;2;2
14059;Žemuogėlė;"VIEVERSIUKAI ";3288369628;Taip;5;2;0;7
14060;Žemuogėlė;"VIEVERSIUKAI ";3825509486;Taip;5;0;0;5
14061;Žemuogėlė;"VIEVERSIUKAI ";1060986850;Taip;9;1;0;10
14062;Žemuogėlė;"VIEVERSIUKAI ";1306065826;Taip;21;0;0;21
14063;Žemuogėlė;"VIEVERSIUKAI ";5992802843;Taip;5;1;0;6
14064;Žemuogėlė;"VIEVERSIUKAI ";5505719625;Taip;0;1;0;1
14065;Žemuogėlė;"VIEVERSIUKAI ";1555899448;Taip;21;0;0;21
14066;Žemuogėlė;"VIEVERSIUKAI ";7137182934;Taip;4;0;0;4
14067;Žemuogėlė;"VIEVERSIUKAI ";1796489729;Taip;19;0;0;19
14068;Žemuogėlė;"VIEVERSIUKAI ";3059525247;Taip;0;1;0;1
14069;Žemuogėlė;"NYKŠTUKAI ";3546429231;Taip;13;2;0;15
14070;Žemuogėlė;"NYKŠTUKAI ";1251497003;Taip;2;1;0;3
14071;Žemuogėlė;"NYKŠTUKAI ";3706531223;Taip;9;0;0;9
14072;Žemuogėlė;"NYKŠTUKAI ";2841634296;Taip;8;0;0;8
14073;Žemuogėlė;"NYKŠTUKAI ";4565097904;Ne;6;0;0;6
14074;Žemuogėlė;"NYKŠTUKAI ";8644564820;Taip;9;0;0;9
14075;Žemuogėlė;"NYKŠTUKAI ";9579921777;Taip;12;0;0;12
14076;Žemuogėlė;"NYKŠTUKAI ";6169845677;Taip;5;0;0;5
14077;Žemuogėlė;"NYKŠTUKAI ";1356340471;Taip;13;1;0;14
14078;Žemuogėlė;"NYKŠTUKAI ";6747566307;Taip;2;1;0;3
14079;Žemuogėlė;"NYKŠTUKAI ";3753156044;Ne;21;0;0;21
14080;Žemuogėlė;"NYKŠTUKAI ";3073956225;Taip;6;0;0;6
14081;Žemuogėlė;"NYKŠTUKAI ";1469759840;Taip;5;1;0;6
14082;Žemuogėlė;KIŠKUČIAI;3041461125;Taip;14;0;0;14
14083;Žemuogėlė;KIŠKUČIAI;1953538445;Taip;16;0;1;17
14084;Žemuogėlė;KIŠKUČIAI;6707522989;Taip;14;0;0;14
14085;Žemuogėlė;KIŠKUČIAI;9981446556;Taip;8;0;0;8
14086;Žemuogėlė;KIŠKUČIAI;3837424301;Taip;9;0;0;9
14087;Žemuogėlė;KIŠKUČIAI;9545690301;Ne;16;0;0;16
14088;Žemuogėlė;KIŠKUČIAI;8827421660;Ne;19;0;0;19
14089;Žemuogėlė;KIŠKUČIAI;7669457695;Taip;7;0;0;7
14090;Žemuogėlė;KIŠKUČIAI;8675089149;Taip;5;0;1;6
14091;Žemuogėlė;KIŠKUČIAI;4165354124;Taip;1;0;0;1
14092;Žemuogėlė;KIŠKUČIAI;6059069293;Taip;6;2;0;8
14093;Žemuogėlė;KIŠKUČIAI;5971652934;Taip;13;2;0;15
14094;Žemuogėlė;KIŠKUČIAI;9955429241;Taip;8;0;0;8
14095;Žemuogėlė;KIŠKUČIAI;5770044886;Taip;3;0;2;5
14096;Žibutė;PELĖDŽIUKAI;54535455969;Taip;11;0;3;14
14097;Žibutė;PELĖDŽIUKAI;62146271609;Taip;0;5;0;5
14098;Žibutė;PELĖDŽIUKAI;85042822872;Taip;0;0;2;2
14099;Žibutė;PELĖDŽIUKAI;59824395612;Taip;0;1;3;4
14100;Žibutė;PELĖDŽIUKAI;2361682400;Taip;0;6;0;6
14101;Žibutė;PELĖDŽIUKAI;1826763192;Taip;0;3;0;3
14102;Žibutė;PELĖDŽIUKAI;1259481487;Taip;1;0;0;1
14103;Žibutė;PELĖDŽIUKAI;3826875107;Taip;0;11;0;11
14104;Žibutė;PELĖDŽIUKAI;3186792146;Taip;0;0;5;5
14105;Žibutė;PELĖDŽIUKAI;1226458088;Taip;0;2;0;2
14106;Žibutė;PELĖDŽIUKAI;7344095020;Taip;1;0;3;4
14107;Žibutė;PELĖDŽIUKAI;1078105287;Taip;0;1;0;1
14108;Žibutė;PELĖDŽIUKAI;2152452830;Ne;10;0;0;10
14109;Žibutė;PELĖDŽIUKAI;1394895695;Ne;0;1;0;1
14110;Žibutė;PELĖDŽIUKAI;2236930916;Taip;6;0;0;6
14111;Žibutė;PELĖDŽIUKAI;7095870173;Taip;11;3;0;14
14112;Žibutė;PELĖDŽIUKAI;2840754631;Taip;5;1;2;8
14113;Žibutė;PELĖDŽIUKAI;6089325755;Taip;0;0;1;1
14114;Žibutė;PELĖDŽIUKAI;1274409680;Taip;6;0;5;11
14115;Žibutė;KREGŽDUTĖS;8587562864;Ne;13;1;2;16
14116;Žibutė;KREGŽDUTĖS;29414890756;Ne;0;2;0;2
14117;Žibutė;KREGŽDUTĖS;2951520056;Taip;0;2;0;2
14118;Žibutė;KREGŽDUTĖS;3035056391;Taip;0;4;0;4
14119;Žibutė;KREGŽDUTĖS;4480906648;Ne;9;1;0;10
14120;Žibutė;KREGŽDUTĖS;90082848356;Taip;0;1;0;1
14121;Žibutė;KREGŽDUTĖS;81886125258;Ne;5;0;0;5
14122;Žibutė;KREGŽDUTĖS;22415995120;Taip;5;1;0;6
14123;Žibutė;KREGŽDUTĖS;1478348672;Taip;0;0;8;8
14124;Žibutė;KREGŽDUTĖS;24118925398;Taip;0;1;2;3
14125;Žibutė;KREGŽDUTĖS;37321817270;Taip;4;0;3;7
14126;Žibutė;KREGŽDUTĖS;4241572158;Taip;5;1;10;16
14127;Žibutė;KREGŽDUTĖS;2776197727;Ne;0;0;1;1
14128;Žibutė;KREGŽDUTĖS;6471216018;Taip;5;2;6;13
14129;Žibutė;KREGŽDUTĖS;8830047872;Taip;16;1;0;17
14130;Žibutė;BORUŽĖLĖS;8792292819;Taip;18;0;0;18
14131;Žibutė;BORUŽĖLĖS;2438980348;Taip;0;0;3;3
14132;Žibutė;BORUŽĖLĖS;7668484415;Taip;3;0;1;4
14133;Žibutė;BORUŽĖLĖS;5126232169;Taip;10;0;2;12
14134;Žibutė;BORUŽĖLĖS;9918283923;Taip;1;0;4;5
14135;Žibutė;BORUŽĖLĖS;9700866512;Taip;5;0;2;7
14136;Žibutė;BORUŽĖLĖS;3268141759;Ne;0;0;5;5
14137;Žibutė;BORUŽĖLĖS;7774532200;Taip;6;4;0;10
14138;Žibutė;BORUŽĖLĖS;1366469428;Taip;10;0;0;10
14139;Žibutė;BORUŽĖLĖS;2607509585;Taip;0;7;0;7
14140;Žibutė;BORUŽĖLĖS;4825064521;Taip;10;7;2;19
14141;Žibutė;BORUŽĖLĖS;5826523148;Taip;5;3;0;8
14142;Žibutė;BORUŽĖLĖS;5806696915;Taip;0;2;0;2
14143;Žibutė;BORUŽĖLĖS;3957898269;Taip;0;2;0;2
14144;Žibutė;BORUŽĖLĖS;4814936645;Taip;0;0;7;7
14145;Žibutė;BORUŽĖLĖS;4382812297;Taip;2;0;0;2
14146;Žibutė;BORUŽĖLĖS;5591698130;Taip;0;5;0;5
14147;Žibutė;BORUŽĖLĖS;1004098038;Taip;8;0;0;8
14148;Žibutė;BORUŽĖLĖS;2880593326;Taip;2;0;0;2
14149;Žibutė;BORUŽĖLĖS;7479437931;Ne;10;0;0;10
14150;Žibutė;BITUTĖS;14091973543;Taip;9;1;0;10
14151;Žibutė;BITUTĖS;27182644850;Taip;0;1;0;1
14152;Žibutė;BITUTĖS;9591439732;Taip;0;2;0;2
14153;Žibutė;BITUTĖS;90040902859;Taip;0;10;0;10
14154;Žibutė;BITUTĖS;39367516353;Taip;0;1;2;3
14155;Žibutė;BITUTĖS;72357016152;Taip;0;6;0;6
14156;Žibutė;BITUTĖS;1054908586;Taip;2;1;0;3
14157;Žibutė;BITUTĖS;1215072172;Taip;0;6;0;6
14158;Žibutė;BITUTĖS;1317512329;Taip;0;2;0;2
14159;Žibutė;BITUTĖS;2144866874;Ne;0;2;0;2
14160;Žibutė;BITUTĖS;1749323904;Taip;3;2;0;5
14161;Žibutė;BITUTĖS;19558564943;Taip;11;0;0;11
14162;Žibutė;BITUTĖS;6958822972;Ne;2;0;0;2
14163;Žibutė;BITUTĖS;62187632470;Ne;7;1;1;9
14164;Žibutė;KAČIUKAI;65433129636;Taip;0;1;0;1
14165;Žibutė;KAČIUKAI;25658034484;Taip;0;1;4;5
14166;Žibutė;KAČIUKAI;6736950445;Taip;0;2;0;2
14167;Žibutė;KAČIUKAI;2089960385;Taip;0;13;3;16
14168;Žibutė;KAČIUKAI;30838051846;Taip;0;1;0;1
14169;Žibutė;KAČIUKAI;29408732286;Taip;0;1;0;1
14170;Žibutė;KAČIUKAI;35959201106;Taip;0;1;0;1
14171;Žibutė;KAČIUKAI;67702702073;Taip;0;1;0;1
14172;Žibutė;KAČIUKAI;60756444655;Ne;0;0;4;4
14173;Žibutė;KAČIUKAI;33367530216;Taip;1;1;0;2
14174;Žibutė;KAČIUKAI;97730387781;Taip;0;1;0;1
14175;Žibutė;KAČIUKAI;51435935201;Taip;5;1;5;11
14176;Žibutė;KAČIUKAI;14243834326;Taip;0;5;1;6
14177;Žibutė;KAČIUKAI;1683770314;Taip;0;3;0;3
14178;Žibutė;KAČIUKAI;10269347801;Taip;0;1;1;2
14179;Žibutė;KAČIUKAI;76137370554;Taip;9;1;0;10
14180;Žibutė;KAČIUKAI;4475507372;Taip;0;0;1;1
14181;Žibutė;KAČIUKAI;9655499291;Ne;0;1;2;3
14182;Žibutė;ZUIKIAI;6495108202;Taip;10;0;1;11
14183;Žibutė;ZUIKIAI;5677389434;Taip;4;1;0;5
14184;Žibutė;ZUIKIAI;5187777741;Taip;2;0;0;2
14185;Žibutė;ZUIKIAI;6013340521;Taip;21;0;0;21
14186;Žibutė;ZUIKIAI;7036454359;Ne;16;0;0;16
14187;Žibutė;ZUIKIAI;5412917352;Taip;3;0;1;4
14188;Žibutė;ZUIKIAI;8715912139;Taip;15;1;0;16
14189;Žibutė;ZUIKIAI;5416015554;Taip;6;0;2;8
14190;Žibutė;ZUIKIAI;2406005105;Taip;5;0;1;6
14191;Žibutė;ZUIKIAI;3555071718;Taip;21;0;0;21
14192;Žibutė;ZUIKIAI;7531027545;Taip;3;0;2;5
14193;Žibutė;ZUIKIAI;3645481894;Taip;11;1;0;12
14194;Žibutė;ZUIKIAI;6074488747;Taip;6;0;2;8
14195;Žibutė;ZUIKIAI;8880329060;Taip;10;0;1;11
14196;Žibutė;ZUIKIAI;2957525481;Taip;11;1;0;12
14197;Žibutė;ZUIKIAI;5009495840;Ne;20;0;0;20
14198;Žibutė;ZUIKIAI;7136145033;Taip;6;0;3;9
14199;Žibutė;ZUIKIAI;5575614158;Taip;7;0;5;12
14200;Žibutė;ZUIKIAI;5190377896;Taip;17;0;0;17
14201;Žibutė;ZUIKIAI;3191351976;Taip;10;7;0;17
14202;Žibutė;ZUIKIAI;9498011134;Taip;5;4;1;10
14203;Žiedas;Bitutės;7123756950;Taip;0;1;0;1
14204;Žiedas;Bitutės;1818701657;Ne;0;1;3;4
14205;Žiedas;Bitutės;2063680054;Taip;0;1;0;1
14206;Žiedas;Bitutės;1817676038;Taip;3;1;0;4
14207;Žiedas;Bitutės;38427730823;Ne;0;1;0;1
14208;Žiedas;Bitutės;1631546874;Ne;0;6;0;6
14209;Žiedas;Bitutės;33966765931;Taip;4;0;0;4
14210;Žiedas;Bitutės;29665685563;Taip;6;0;0;6
14211;Žiedas;Bitutės;23936058075;Taip;0;1;0;1
14212;Žiedas;Bitutės;42777955874;Ne;0;1;0;1
14213;Žiedas;Bitutės;31369021056;Taip;0;6;0;6
14214;Žiedas;Bitutės;83630991208;Taip;0;2;0;2
14215;Žiedas;Bitutės;80003937908;Taip;0;1;0;1
14216;Žiedas;Bitutės;81304970766;Taip;0;1;0;1
14217;Žiedas;Bitutės;1288374706;Taip;0;4;0;4
14218;Žiedas;Bitutės;34178608904;Taip;13;2;0;15
14219;Žiedas;Bitutės;58252361010;Taip;0;5;0;5
14220;Žiedas;Varpeliai;32671505578;Taip;0;5;1;6
14221;Žiedas;Varpeliai;5835879070;Taip;0;1;0;1
14222;Žiedas;Varpeliai;1733596148;Taip;0;3;2;5
14223;Žiedas;Varpeliai;55459877940;Ne;0;4;0;4
14224;Žiedas;Varpeliai;50069962197;Taip;0;11;1;12
14225;Žiedas;Varpeliai;59092030605;Taip;0;1;0;1
14226;Žiedas;Varpeliai;1748932818;Taip;0;1;0;1
14227;Žiedas;Varpeliai;17275054601;Taip;0;4;0;4
14228;Žiedas;Varpeliai;1897597456;Taip;0;4;0;4
14229;Žiedas;Varpeliai;1443451076;Taip;0;3;0;3
14230;Žiedas;Varpeliai;1491929025;Taip;0;2;0;2
14231;Žiedas;Varpeliai;2075892389;Taip;11;0;0;11
14232;Žiedas;Varpeliai;9044903345;Taip;0;1;0;1
14233;Žiedas;Varpeliai;85152640431;Ne;0;2;0;2
14234;Žiedas;Varpeliai;2147350804;Taip;12;2;0;14
14235;Žiedas;Varpeliai;1366570116;Taip;0;1;0;1
14236;Žiedas;Varpeliai;37314210812;Taip;5;0;0;5
14237;Žiedas;Varpeliai;52683198809;Taip;3;1;0;4
14238;Žiedas;Varpeliai;99985645406;Taip;0;6;0;6
14239;Žiedas;Varpeliai;39022317368;Ne;11;1;0;12
14240;Žiedas;Varpeliai;1618815502;Taip;0;1;0;1
14241;Žiedas;Varpeliai;1332249885;Ne;0;2;0;2
14242;Žiedas;Varpeliai;12622490543;Ne;12;3;0;15
14243;Žiedas;Varpeliai;1120478375;Taip;8;2;1;11
14244;Žiedas;Varpeliai;2081656643;Taip;0;0;1;1
14245;Žiedas;Ramunėlės;9648580306;Taip;0;2;0;2
14246;Žiedas;Ramunėlės;9736967156;Taip;0;3;0;3
14247;Žiedas;Ramunėlės;4922560649;Taip;5;3;0;8
14248;Žiedas;Ramunėlės;2511423525;Taip;16;0;0;16
14249;Žiedas;Ramunėlės;2095655987;Ne;0;2;0;2
14250;Žiedas;Ramunėlės;6703889237;Taip;0;0;2;2
14251;Žiedas;Ramunėlės;7954517383;Taip;9;6;0;15
14252;Žiedas;Ramunėlės;7016509405;Taip;6;0;0;6
14253;Žiedas;Ramunėlės;9247088735;Taip;11;0;0;11
14254;Žiedas;Ramunėlės;9699668892;Taip;3;2;0;5
14255;Žiedas;Ramunėlės;6432090199;Taip;21;0;0;21
14256;Žiedas;Ramunėlės;1139186052;Taip;3;3;0;6
14257;Žiedas;Ramunėlės;5653785844;Taip;4;2;0;6
14258;Žiedas;Ramunėlės;5588136738;Taip;4;5;0;9
14259;Žiedas;Ramunėlės;5626494892;Taip;20;0;0;20
14260;Žiedas;Ramunėlės;1794393042;Taip;9;2;0;11
14261;Žiedas;Ramunėlės;2083493509;Taip;3;8;5;16
14262;Žiedas;Ramunėlės;7708360056;Taip;11;1;0;12
14263;Žiedas;Ramunėlės;7396006218;Taip;11;0;0;11
14264;Žiedas;Ramunėlės;3586376571;Taip;11;0;1;12
14265;Žiedas;Ramunėlės;6786526552;Taip;17;0;2;19
14266;Žiedas;Ramunėlės;3702078720;Taip;10;2;0;12
14267;Žiedas;Ramunėlės;2849254119;Taip;11;4;0;15
14268;Žiedas;Pakalnutės;1063755068;Taip;0;1;0;1
14269;Žiedas;Pakalnutės;42049755986;Taip;0;1;0;1
14270;Žiedas;Pakalnutės;52721173922;Taip;0;1;0;1
14271;Žiedas;Pakalnutės;2060067625;Taip;5;7;0;12
14272;Žiedas;Pakalnutės;2434909184;Taip;0;3;0;3
14273;Žiedas;Pakalnutės;3616767119;Taip;5;1;0;6
14274;Žiedas;Pakalnutės;1835889494;Taip;12;3;0;15
14275;Žiedas;Pakalnutės;1600420971;Taip;0;10;0;10
14276;Žiedas;Pakalnutės;3930283171;Taip;0;7;0;7
14277;Žiedas;Pakalnutės;1708363648;Taip;2;1;0;3
14278;Žiedas;Pakalnutės;9940683245;Taip;0;3;0;3
14279;Žiedas;Pakalnutės;1200692015;Taip;3;0;0;3
14280;Žiedas;Pakalnutės;1013773415;Taip;0;1;0;1
14281;Žiedas;Pakalnutės;27339844730;Taip;10;5;0;15
14282;Žiedas;Pakalnutės;5812737969;Ne;0;2;0;2
14283;Žiedas;Pakalnutės;1127645903;Ne;5;1;0;6
14284;Žiedas;Pakalnutės;1219022794;Taip;0;14;0;14
14285;Žiedas;Pakalnutės;7647496475;Taip;7;6;0;13
14286;Žiedas;Pakalnutės;1785446716;Ne;4;3;0;7
14287;Žiedas;Pakalnutės;2094277643;Ne;0;3;3;6
14288;Žiedas;Pakalnutės;12960180114;Taip;0;4;0;4
14289;Žiedas;Pakalnutės;3346603228;Taip;0;4;0;4
14290;Žiedas;Rožytės;2718046390;Taip;0;0;7;7
14291;Žiedas;Rožytės;1136010138;Taip;6;7;0;13
14292;Žiedas;Rožytės;1618505155;Taip;9;1;0;10
14293;Žiedas;Rožytės;47457128214;Taip;7;0;0;7
14294;Žiedas;Rožytės;40744263923;Taip;0;3;0;3
14295;Žiedas;Rožytės;33135652351;Ne;10;0;0;10
14296;Žiedas;Rožytės;87240375524;Taip;17;0;0;17
14297;Žiedas;Rožytės;1893226570;Taip;0;8;0;8
14298;Žiedas;Rožytės;7283725455;Taip;21;0;0;21
14299;Žiedas;Rožytės;56707734658;Taip;0;0;1;1
14300;Žiedas;Rožytės;2157262849;Taip;0;15;0;15
14301;Žiedas;Rožytės;9757771445;Taip;0;14;0;14
14302;Žiedas;Rožytės;73923918829;Taip;9;1;0;10
14303;Žiedas;Rožytės;4749655084;Taip;11;3;0;14
14304;Žiedas;Rožytės;1772492727;Taip;7;0;1;8
14305;Žiedas;Rožytės;8372385066;Taip;9;0;2;11
14306;Žiedas;Rožytės;3613860509;Taip;0;9;0;9
14307;Žiedas;Rožytės;5537717174;Taip;0;7;0;7
14308;Žiedas;Rožytės;6925923143;Ne;19;0;0;19
14309;Žiedas;Rožytės;1453937876;Taip;10;0;0;10
14310;Žiedas;Rožytės;1781950568;Taip;0;0;1;1
14311;Žiedas;Rožytės;9573180529;Taip;0;16;0;16
14312;Žiedas;Rožytės;2026462074;Taip;0;0;1;1
14313;Žiedas;Pumpurėliai;7097790025;Taip;0;3;0;3
14314;Žiedas;Pumpurėliai;3178778438;Taip;6;1;5;12
14315;Žiedas;Pumpurėliai;6444377924;Taip;0;11;1;12
14316;Žiedas;Pumpurėliai;9587581470;Taip;0;3;0;3
14317;Žiedas;Pumpurėliai;5578227349;Taip;0;3;3;6
14318;Žiedas;Pumpurėliai;5652936425;Taip;4;1;0;5
14319;Žiedas;Pumpurėliai;8812316692;Taip;12;0;1;13
14320;Žiedas;Pumpurėliai;3387263016;Taip;17;0;0;17
14321;Žiedas;Pumpurėliai;3230107921;Taip;0;2;0;2
14322;Žiedas;Pumpurėliai;9602083568;Taip;15;2;0;17
14323;Žiedas;Pumpurėliai;5628720422;Ne;12;1;0;13
14324;Žiedas;Pumpurėliai;1582961378;Ne;0;3;2;5
14325;Žiedas;Pumpurėliai;9020540780;Taip;3;0;2;5
14326;Žiedas;Pumpurėliai;3704491209;Taip;0;2;0;2
14327;Žiedas;Pumpurėliai;6882614465;Taip;5;0;0;5
14328;Žiedas;Pumpurėliai;6914059680;Taip;15;0;0;15
14329;Žiedas;Pumpurėliai;7771247056;Ne;12;0;0;12
14330;Žiedas;Pumpurėliai;6515510381;Taip;10;0;0;10
14331;Žiedas;Pumpurėliai;3842589827;Taip;13;0;0;13
14332;Žiedas;Pumpurėliai;5835309107;Taip;0;0;2;2
14333;Žiedas;Pumpurėliai;3178580610;Ne;4;2;0;6
14334;Žiedas;Pumpurėliai;1878050384;Taip;9;0;1;10
14335;Žiedas;"Dobiliukai ";88471315730;Taip;4;0;0;4
14336;Žiedas;"Dobiliukai ";1484464986;Taip;0;2;0;2
14337;Žiedas;"Dobiliukai ";34193530;Taip;10;0;0;10
14338;Žiedas;"Dobiliukai ";1529988412;Taip;8;1;0;9
14339;Žiedas;"Dobiliukai ";78720591915;Taip;0;2;0;2
14340;Žiedas;"Dobiliukai ";1550350520;Taip;9;0;0;9
14341;Žiedas;"Dobiliukai ";2763469583;Taip;0;1;0;1
14342;Žiedas;"Dobiliukai ";86877563124;Taip;8;3;0;11
14343;Žiedas;"Dobiliukai ";1458152054;Ne;3;6;0;9
14344;Žiedas;"Dobiliukai ";3414702993;Taip;6;0;0;6
14345;Žiedas;"Dobiliukai ";69485023219;Taip;4;1;0;5
14346;Žiedas;"Dobiliukai ";1007894628;Ne;11;2;0;13
14347;Žiedas;"Dobiliukai ";1625009666;Taip;11;1;0;12
14348;Žiedas;"Dobiliukai ";1868951268;Taip;6;0;0;6
14349;Žiedas;"Dobiliukai ";1824692620;Taip;13;0;0;13
14350;Žiedas;"Dobiliukai ";9058688663;Ne;9;4;0;13
14351;Žiedas;"Dobiliukai ";2026728639;Taip;0;3;0;3
14352;Žiedas;"Dobiliukai ";7150433256;Taip;7;2;0;9
14353;Žiedas;"Dobiliukai ";6145720452;Taip;0;2;0;2
14354;Žiedas;"Dobiliukai ";1030089009;Ne;0;1;0;1
14355;Žiedas;"Dobiliukai ";4807479784;Taip;0;3;0;3
14356;Žiedas;"Dobiliukai ";2507543124;Taip;16;1;0;17
14357;Žiedas;"Dobiliukai ";6945326867;Taip;0;2;0;2
14358;Žiedas;"Dobiliukai ";9337128671;Taip;0;2;0;2
14359;Žiedas;RŪTELĖS;5885209631;Taip;10;3;1;14
14360;Žiedas;RŪTELĖS;2134466899;Taip;10;3;1;14
14361;Žiedas;RŪTELĖS;5420327672;Taip;3;13;0;16
14362;Žiedas;RŪTELĖS;5108263139;Taip;17;0;0;17
14363;Žiedas;RŪTELĖS;6822887260;Taip;0;1;0;1
14364;Žiedas;RŪTELĖS;9352485926;Taip;7;2;0;9
14365;Žiedas;RŪTELĖS;5914428064;Taip;6;1;0;7
14366;Žiedas;RŪTELĖS;3857121753;Taip;15;1;0;16
14367;Žiedas;RŪTELĖS;6443633568;Taip;0;21;0;21
14368;Žiedas;RŪTELĖS;7491134119;Taip;8;1;0;9
14369;Žiedas;RŪTELĖS;5959899914;Taip;13;0;0;13
14370;Žiedas;RŪTELĖS;1737296046;Taip;0;3;3;6
14371;Žiedas;RŪTELĖS;7333813704;Ne;0;4;1;5
14372;Žiedas;RŪTELĖS;1048272199;Taip;10;0;0;10
14373;Žiedas;RŪTELĖS;1645402434;Taip;0;1;0;1
14374;Žiedas;RŪTELĖS;3715928992;Taip;0;1;1;2
14375;Žiedas;RŪTELĖS;6658762922;Taip;0;2;0;2
14376;Žiedas;RŪTELĖS;5703750436;Taip;2;0;0;2
14377;Žiedas;RŪTELĖS;1253833615;Taip;6;6;0;12
14378;Žiedas;RŪTELĖS;7578964555;Ne;0;1;0;1
14379;Žiedas;RŪTELĖS;5126173608;Taip;0;5;0;5
14380;Žiedas;RŪTELĖS;5647232875;Ne;10;3;0;13
14381;Žiedas;RŪTELĖS;7172793351;Ne;10;0;0;10
14382;Žiedas;RŪTELĖS;4497634040;Taip;0;0;1;1
14383;Žiedas;RŪTELĖS;7057747531;Taip;19;0;0;19
14384;Žiedas;RŪTELĖS;1738121071;Taip;0;6;0;6
14385;Žiedas;SAULĖGRĄŽOS;36350993825;Taip;0;8;0;8
14386;Žiedas;SAULĖGRĄŽOS;69245659818;Taip;5;12;0;17
14387;Žiedas;SAULĖGRĄŽOS;2391924358;Taip;0;1;0;1
14388;Žiedas;SAULĖGRĄŽOS;8172222365;Taip;0;1;0;1
14389;Žiedas;SAULĖGRĄŽOS;8753972322;Taip;0;18;0;18
14390;Žiedas;SAULĖGRĄŽOS;3900091129;Taip;3;3;0;6
14391;Žiedas;SAULĖGRĄŽOS;9363714015;Taip;0;4;0;4
14392;Žiedas;SAULĖGRĄŽOS;6964047214;Taip;4;0;0;4
14393;Žiedas;SAULĖGRĄŽOS;3067962647;Ne;0;2;0;2
14394;Žiedas;SAULĖGRĄŽOS;2037477873;Ne;5;1;2;8
14395;Žiedas;SAULĖGRĄŽOS;2843328732;Taip;0;1;0;1
14396;Žiedas;SAULĖGRĄŽOS;2515028280;Taip;5;4;0;9
14397;Žiedas;SAULĖGRĄŽOS;1215443920;Taip;0;1;0;1
14398;Žiedas;SAULĖGRĄŽOS;5282211767;Taip;0;8;0;8
14399;Žiedas;SAULĖGRĄŽOS;1583038469;Taip;5;5;0;10
14400;Žiedas;SAULĖGRĄŽOS;8208331527;Taip;10;1;0;11
14401;Žiedas;SAULĖGRĄŽOS;8517250094;Taip;5;0;3;8
14402;Žiedas;SAULĖGRĄŽOS;1318132922;Taip;0;2;0;2
14403;Žiedas;SAULĖGRĄŽOS;6815408748;Taip;0;2;0;2
14404;Žiedas;SAULĖGRĄŽOS;5451923881;Taip;21;0;0;21
14405;Žiedas;SAULĖGRĄŽOS;5079107907;Taip;0;4;0;4
14406;Žiedas;SAULĖGRĄŽOS;7136135394;Taip;0;1;0;1
14407;Žiedas;SAULĖGRĄŽOS;1450251779;Taip;0;6;0;6
14408;Žiedas;SAULĖGRĄŽOS;9037835899;Ne;15;0;0;15
14409;Žiedas;RUGIAGĖLĖS;8148831014;Taip;5;5;0;10
14410;Žiedas;RUGIAGĖLĖS;8645771800;Taip;13;0;0;13
14411;Žiedas;RUGIAGĖLĖS;9702211410;Taip;12;2;0;14
14412;Žiedas;RUGIAGĖLĖS;5570910138;Ne;0;7;0;7
14413;Žiedas;RUGIAGĖLĖS;7187176169;Taip;21;0;0;21
14414;Žiedas;RUGIAGĖLĖS;8163645535;Taip;17;0;0;17
14415;Žiedas;RUGIAGĖLĖS;9750690920;Taip;0;8;0;8
14416;Žiedas;RUGIAGĖLĖS;4222689492;Taip;0;2;0;2
14417;Žiedas;RUGIAGĖLĖS;2763996098;Ne;21;0;0;21
14418;Žiedas;RUGIAGĖLĖS;4983852075;Taip;10;0;1;11
14419;Žiedas;RUGIAGĖLĖS;4521161684;Ne;13;1;0;14
14420;Žiedas;RUGIAGĖLĖS;3641595127;Taip;0;1;0;1
14421;Žiedas;RUGIAGĖLĖS;1333233100;Taip;11;0;0;11
14422;Žiedas;RUGIAGĖLĖS;9129315784;Taip;17;0;0;17
14423;Žiedas;RUGIAGĖLĖS;4284627073;Taip;13;0;0;13
14424;Žiedas;RUGIAGĖLĖS;9094287056;Taip;2;0;0;2
14425;Žiedas;RUGIAGĖLĖS;3370495317;Taip;0;8;0;8
14426;Žiedas;RUGIAGĖLĖS;7952899220;Taip;1;0;0;1
14427;Žiedas;RUGIAGĖLĖS;6261847845;Ne;12;0;0;12
14428;Žiedas;RUGIAGĖLĖS;3984607857;Taip;5;1;0;6
14429;Žiedas;RUGIAGĖLĖS;5020148822;Taip;12;0;0;12
14430;Žiedas;RUGIAGĖLĖS;9415269410;Taip;1;0;0;1
14431;Žiedas;RUGIAGĖLĖS;7672879525;Taip;11;0;0;11
14432;Žiedas;Boružėlės;1079445123;Taip;0;2;1;3
14433;Žiedas;Boružėlės;50534384762;Taip;0;1;0;1
14434;Žiedas;Boružėlės;1985949180;Taip;3;1;0;4
14435;Žiedas;Boružėlės;1782429057;Taip;5;1;0;6
14436;Žiedas;Boružėlės;75047415039;Ne;0;2;0;2
14437;Žiedas;Boružėlės;85519253910;Taip;0;2;0;2
14438;Žiedas;Boružėlės;43123840066;Taip;0;2;2;4
14439;Žiedas;Boružėlės;50295529511;Taip;0;1;0;1
14440;Žiedas;Boružėlės;226707253;Taip;7;1;1;9
14441;Žiedas;Boružėlės;4665596321;Taip;0;1;2;3
14442;Žiedas;Boružėlės;22305887643;Taip;0;1;0;1
14443;Žiedas;Boružėlės;39792014616;Ne;0;2;2;4
14444;Žiedas;Boružėlės;65264733887;Ne;0;2;0;2
14445;Žiedas;Boružėlės;56303923223;Taip;5;0;0;5
14446;Žiedas;Boružėlės;29411390190;Ne;1;1;0;2
14447;Žiedas;Boružėlės;55136247841;Taip;0;1;0;1
14448;Žiedas;AGUONĖLĖS;3055218791;Taip;0;2;0;2
14449;Žiedas;AGUONĖLĖS;9218388800;Taip;12;3;0;15
14450;Žiedas;AGUONĖLĖS;1243169901;Taip;13;3;0;16
14451;Žiedas;AGUONĖLĖS;1333555044;Taip;11;0;0;11
14452;Žiedas;AGUONĖLĖS;2682112101;Taip;6;0;0;6
14453;Žiedas;AGUONĖLĖS;5789261620;Taip;11;0;0;11
14454;Žiedas;AGUONĖLĖS;5920211041;Taip;5;3;0;8
14455;Žiedas;AGUONĖLĖS;3168061557;Taip;7;0;0;7
14456;Žiedas;AGUONĖLĖS;4044156905;Taip;16;0;0;16
14457;Žiedas;AGUONĖLĖS;4844442247;Taip;13;1;0;14
14458;Žiedas;AGUONĖLĖS;6884933845;Taip;11;6;2;19
14459;Žiedas;AGUONĖLĖS;7294671324;Taip;4;0;5;9
14460;Žiedas;AGUONĖLĖS;2938302462;Taip;2;5;0;7
14461;Žiedas;AGUONĖLĖS;7869675895;Taip;14;0;0;14
14462;Žiedas;ŽIBUTĖS;8857150598;Taip;16;1;0;17
14463;Žiedas;ŽIBUTĖS;7942276632;Taip;5;0;0;5
14464;Žiedas;ŽIBUTĖS;1011602827;Taip;10;1;0;11
14465;Žiedas;ŽIBUTĖS;6041919197;Taip;16;0;0;16
14466;Žiedas;ŽIBUTĖS;7799489700;Taip;16;3;0;19
14467;Žiedas;ŽIBUTĖS;2932857132;Taip;5;0;1;6
14468;Žiedas;ŽIBUTĖS;2642760082;Taip;0;5;16;21
14469;Žiedas;ŽIBUTĖS;8927034492;Taip;0;0;21;21
14470;Žiedas;ŽIBUTĖS;2182381160;Taip;10;0;0;10
14471;Žiedas;ŽIBUTĖS;9057761408;Taip;21;0;0;21
14472;Žiedas;ŽIBUTĖS;9562512849;Taip;0;2;19;21
14473;Žiedas;ŽIBUTĖS;6175213274;Ne;0;1;0;1
14474;Žiedas;ŽIBUTĖS;8822472312;Taip;12;5;0;17
14475;Žiedas;ŽIBUTĖS;9021286246;Taip;0;6;0;6
14476;Žiedas;ŽIBUTĖS;4556559021;Taip;16;0;0;16
14477;Žiedas;ŽIBUTĖS;1777501190;Taip;0;2;0;2
14478;Žiedas;ŽIBUTĖS;1043230748;Taip;0;4;0;4
14479;Žiedas;ŽIBUTĖS;1844621525;Taip;3;1;0;4
14480;Žiedas;ŽIBUTĖS;1219634640;Taip;3;2;3;8
14481;Žiogelis;SKRUZDELYTĖS;8819549855;Ne;14;0;1;15
14482;Žiogelis;SKRUZDELYTĖS;4508141956;Taip;7;0;7;14
14483;Žiogelis;SKRUZDELYTĖS;4343510173;Taip;0;5;0;5
14484;Žiogelis;SKRUZDELYTĖS;6346503991;Taip;5;1;1;7
14485;Žiogelis;SKRUZDELYTĖS;18018505301;Taip;9;0;0;9
14486;Žiogelis;SKRUZDELYTĖS;3503872654;Taip;3;1;2;6
14487;Žiogelis;SKRUZDELYTĖS;6067622823;Taip;8;1;0;9
14488;Žiogelis;SKRUZDELYTĖS;8702710674;Taip;0;7;0;7
14489;Žiogelis;SKRUZDELYTĖS;4671356872;Taip;0;7;0;7
14490;Žiogelis;SKRUZDELYTĖS;7881358741;Taip;5;1;0;6
14491;Žiogelis;SKRUZDELYTĖS;3750023611;Taip;4;0;0;4
14492;Žiogelis;SKRUZDELYTĖS;3609961581;Taip;4;0;1;5
14493;Žiogelis;SKRUZDELYTĖS;64865699245;Taip;0;1;0;1
14494;Žiogelis;SKRUZDELYTĖS;60959051938;Taip;8;1;0;9
14495;Žiogelis;SKRUZDELYTĖS;95713316600;Taip;0;6;2;8
14496;Žiogelis;SKRUZDELYTĖS;4445888917;Taip;0;1;0;1
14497;Žiogelis;SKRUZDELYTĖS;24941867247;Ne;6;1;0;7
14498;Žiogelis;SKRUZDELYTĖS;6659086172;Ne;13;1;0;14
14499;Žiogelis;SKRUZDELYTĖS;2883732914;Taip;8;1;0;9
14500;Žiogelis;SKRUZDELYTĖS;3189872952;Taip;9;1;0;10
14501;Žiogelis;SKRUZDELYTĖS;9295720241;Taip;12;2;0;14
14502;Žiogelis;SKRUZDELYTĖS;1568915914;Taip;0;2;0;2
14503;Žiogelis;SKRUZDELYTĖS;3203359908;Taip;3;1;1;5
14504;Žiogelis;SKRUZDELYTĖS;3320077143;Ne;0;1;3;4
14505;Žiogelis;ŽIRNIUKAI;7704256764;Taip;0;4;0;4
14506;Žiogelis;ŽIRNIUKAI;6701809272;Taip;7;1;0;8
14507;Žiogelis;ŽIRNIUKAI;2233244282;Taip;0;3;0;3
14508;Žiogelis;ŽIRNIUKAI;8675451323;Taip;14;0;0;14
14509;Žiogelis;ŽIRNIUKAI;85437321236;Taip;10;0;0;10
14510;Žiogelis;ŽIRNIUKAI;1660784232;Taip;5;0;3;8
14511;Žiogelis;ŽIRNIUKAI;1235203700;Taip;0;0;2;2
14512;Žiogelis;ŽIRNIUKAI;1551989977;Taip;0;6;0;6
14513;Žiogelis;ŽIRNIUKAI;3310492752;Taip;6;0;0;6
14514;Žiogelis;ŽIRNIUKAI;5557800297;Taip;0;2;0;2
14515;Žiogelis;ŽIRNIUKAI;3392582853;Taip;0;2;0;2
14516;Žiogelis;ŽIRNIUKAI;2366095661;Taip;6;0;2;8
14517;Žiogelis;ŽIRNIUKAI;1320126836;Taip;0;1;0;1
14518;Žiogelis;ŽIRNIUKAI;1442866468;Taip;5;0;1;6
14519;Žiogelis;ŽIRNIUKAI;6697117406;Taip;12;0;0;12
14520;Žiogelis;ŽIRNIUKAI;9862582346;Taip;8;0;1;9
14521;Žiogelis;ŽIRNIUKAI;7087781379;Ne;11;0;0;11
14522;Žiogelis;ŽIRNIUKAI;4015109974;Ne;11;0;0;11
14523;Žiogelis;ŽIRNIUKAI;9406830518;Taip;0;1;0;1
14524;Žiogelis;ŽIRNIUKAI;3910954904;Taip;4;0;0;4
14525;Žiogelis;ŽIRNIUKAI;4713696984;Ne;10;1;0;11
14526;Žiogelis;ŽIRNIUKAI;2028383677;Taip;7;0;1;8
14527;Žiogelis;ŽIRNIUKAI;2704243085;Taip;10;1;0;11
14528;Žiogelis;DOBILĖLIAI;8683148826;Taip;0;8;0;8
14529;Žiogelis;DOBILĖLIAI;3502278745;Taip;5;0;0;5
14530;Žiogelis;DOBILĖLIAI;3308563362;Taip;3;0;0;3
14531;Žiogelis;DOBILĖLIAI;3928697936;Taip;17;0;0;17
14532;Žiogelis;DOBILĖLIAI;1190395481;Taip;14;0;0;14
14533;Žiogelis;DOBILĖLIAI;1465027680;Taip;10;0;0;10
14534;Žiogelis;DOBILĖLIAI;6495456608;Taip;4;0;0;4
14535;Žiogelis;DOBILĖLIAI;5364996984;Taip;13;0;0;13
14536;Žiogelis;DOBILĖLIAI;9568208184;Taip;13;0;0;13
14537;Žiogelis;DOBILĖLIAI;6340620973;Taip;0;2;0;2
14538;Žiogelis;DOBILĖLIAI;5961630249;Taip;7;0;0;7
14539;Žiogelis;DOBILĖLIAI;7630342576;Ne;6;0;6;12
14540;Žiogelis;DOBILĖLIAI;6532218580;Taip;5;0;0;5
14541;Žiogelis;DOBILĖLIAI;1763070523;Ne;8;2;0;10
14542;Žiogelis;DOBILĖLIAI;5911231906;Taip;13;0;0;13
14543;Žiogelis;DOBILĖLIAI;9610249055;Taip;7;2;0;9
14544;Žiogelis;DOBILĖLIAI;6115834138;Ne;8;0;0;8
14545;Žiogelis;DOBILĖLIAI;3887222613;Ne;15;0;0;15
14546;Žiogelis;DOBILĖLIAI;8485067381;Taip;0;1;0;1
14547;Žiogelis;DOBILĖLIAI;7065052244;Taip;6;0;1;7
14548;Žiogelis;BORUŽĖLĖS;54446173105;Taip;6;0;1;7
14549;Žiogelis;BORUŽĖLĖS;4776403513;Taip;2;0;0;2
14550;Žiogelis;BORUŽĖLĖS;1617516552;Taip;0;2;0;2
14551;Žiogelis;BORUŽĖLĖS;81608736626;Taip;3;1;0;4
14552;Žiogelis;BORUŽĖLĖS;4465151986;Taip;0;2;0;2
14553;Žiogelis;BORUŽĖLĖS;6963163354;Taip;3;0;3;6
14554;Žiogelis;BORUŽĖLĖS;98660118094;Taip;0;10;0;10
14555;Žiogelis;BORUŽĖLĖS;67475530006;Taip;0;3;0;3
14556;Žiogelis;BORUŽĖLĖS;8169022043;Taip;8;0;0;8
14557;Žiogelis;BORUŽĖLĖS;5639046412;Ne;0;6;0;6
14558;Žiogelis;BORUŽĖLĖS;65387706999;Ne;0;4;0;4
14559;Žiogelis;BORUŽĖLĖS;45051106222;Taip;20;0;0;20
14560;Žiogelis;BORUŽĖLĖS;49836275638;Taip;0;1;0;1
14561;Žiogelis;BORUŽĖLĖS;14932261911;Taip;0;4;0;4
14562;Žiogelis;BORUŽĖLĖS;29876596658;Taip;9;1;0;10
14563;Žiogelis;BORUŽĖLĖS;63956907259;Taip;6;0;0;6
14564;Žiogelis;BORUŽĖLĖS;84919810287;Taip;0;7;0;7
14565;Žiogelis;BORUŽĖLĖS;87755643169;Taip;0;3;0;3
14566;Žiogelis;BORUŽĖLĖS;5072204356;Taip;6;1;1;8
14567;Žiogelis;DRUGELIAI;40049935108;Taip;9;4;0;13
14568;Žiogelis;DRUGELIAI;37505015919;Taip;0;1;3;4
14569;Žiogelis;DRUGELIAI;25631779076;Taip;0;7;0;7
14570;Žiogelis;DRUGELIAI;91499233609;Taip;3;1;0;4
14571;Žiogelis;DRUGELIAI;40186714037;Taip;2;5;0;7
14572;Žiogelis;DRUGELIAI;52847485981;Taip;2;2;1;5
14573;Žiogelis;DRUGELIAI;96369154198;Taip;0;6;0;6
14574;Žiogelis;DRUGELIAI;56579227266;Ne;3;1;2;6
14575;Žiogelis;DRUGELIAI;66037746045;Taip;0;4;0;4
14576;Žiogelis;DRUGELIAI;68621438109;Taip;0;2;2;4
14577;Žiogelis;DRUGELIAI;18225364866;Taip;0;0;2;2
14578;Žiogelis;DRUGELIAI;18957711548;Taip;0;2;0;2
14579;Žiogelis;DRUGELIAI;52855728176;Ne;0;3;0;3
14580;Žiogelis;DRUGELIAI;35609682774;Taip;14;1;0;15
14581;Žiogelis;DRUGELIAI;1096666450;Taip;0;1;0;1
14582;Žiogelis;DRUGELIAI;1237788562;Taip;5;8;0;13
14583;Žiogelis;DRUGELIAI;1867019234;Taip;0;5;0;5
14584;Žiogelis;DRUGELIAI;1082983134;Taip;5;2;0;7
14585;Žiogelis;DRUGELIAI;97696839366;Taip;3;0;0;3
14586;Žiogelis;DRUGELIAI;9326053563;Taip;2;0;2;4
14587;Žiogelis;DRUGELIAI;2853980993;Taip;9;2;0;11
14588;Žiogelis;DRUGELIAI;6980862023;Taip;3;1;0;4
14589;Žiogelis;DRUGELIAI;52901528922;Taip;2;1;0;3
14590;Žiogelis;DRUGELIAI;63719135594;Ne;1;1;0;2
14591;Žiogelis;DRUGELIAI;5975060180;Taip;6;0;0;6
14592;Žiogelis;PELĖDŽIUKAI;25765405268;Taip;0;3;0;3
14593;Žiogelis;PELĖDŽIUKAI;40656416455;Taip;0;5;0;5
14594;Žiogelis;PELĖDŽIUKAI;58435832422;Taip;0;2;0;2
14595;Žiogelis;PELĖDŽIUKAI;65431295185;Taip;0;3;0;3
14596;Žiogelis;PELĖDŽIUKAI;90856268042;Taip;0;2;0;2
14597;Žiogelis;PELĖDŽIUKAI;4546122149;Taip;0;1;0;1
14598;Žiogelis;PELĖDŽIUKAI;677032532;Taip;0;1;0;1
14599;Žiogelis;PELĖDŽIUKAI;75990939732;Taip;0;4;0;4
14600;Žiogelis;PELĖDŽIUKAI;99706324340;Taip;0;10;0;10
14601;Žiogelis;PELĖDŽIUKAI;46206606894;Taip;0;1;0;1
14602;Žiogelis;PELĖDŽIUKAI;87136010729;Taip;0;1;0;1
14603;Žiogelis;PELĖDŽIUKAI;83065651470;Ne;0;4;0;4
14604;Žiogelis;PELĖDŽIUKAI;88467192459;Taip;19;0;0;19
14605;Žiogelis;PELĖDŽIUKAI;30153333482;Ne;0;1;0;1
14606;Žiogelis;PELĖDŽIUKAI;9520854450;Taip;8;2;0;10
14607;Žiogelis;PELĖDŽIUKAI;46938187629;Taip;0;2;0;2
14608;Žiogelis;PELĖDŽIUKAI;65284631135;Taip;0;3;0;3
14609;Žiogelis;PELĖDŽIUKAI;1303123383;Taip;0;2;0;2
14610;Žiogelis;PELĖDŽIUKAI;62633906174;Taip;0;2;0;2
14611;Žiogelis;PELĖDŽIUKAI;2100993889;Ne;0;12;0;12
14612;Žiogelis;PELĖDŽIUKAI;82738581846;Taip;0;1;0;1
14613;Žiogelis;PELĖDŽIUKAI;80050087040;Taip;21;0;0;21
14614;Žiogelis;VARPELIAI;63443494015;Taip;0;3;0;3
14615;Žiogelis;VARPELIAI;1069475442;Ne;0;9;0;9
14616;Žiogelis;VARPELIAI;72043183625;Taip;0;1;0;1
14617;Žiogelis;VARPELIAI;1198917418;Taip;0;8;0;8
14618;Žiogelis;VARPELIAI;44118139818;Taip;3;1;0;4
14619;Žiogelis;VARPELIAI;7708273984;Taip;14;4;0;18
14620;Žiogelis;VARPELIAI;1060830668;Taip;20;0;0;20
14621;Žiogelis;VARPELIAI;9871477318;Taip;5;2;0;7
14622;Žiogelis;VARPELIAI;6225523016;Taip;5;7;0;12
14623;Žiogelis;VARPELIAI;2575280329;Taip;6;0;0;6
14624;Žiogelis;VARPELIAI;4402777236;Taip;18;0;0;18
14625;Žiogelis;VARPELIAI;1370071592;Taip;16;1;0;17
14626;Žiogelis;VARPELIAI;9416538794;Taip;10;2;0;12
14627;Žiogelis;VARPELIAI;7888873296;Taip;8;2;0;10
14628;Žiogelis;VARPELIAI;9032003195;Ne;12;1;0;13
14629;Žiogelis;VARPELIAI;8262619320;Taip;12;3;0;15
14630;Žiogelis;VARPELIAI;1837140329;Ne;3;0;0;3
14631;Žiogelis;VARPELIAI;8983731310;Taip;3;6;0;9
14632;Žiogelis;VARPELIAI;7493919076;Taip;21;0;0;21
14633;Žiogelis;KREGŽDUTĖS;1195431423;Taip;0;1;0;1
14634;Žiogelis;KREGŽDUTĖS;20399291813;Taip;13;0;0;13
14635;Žiogelis;KREGŽDUTĖS;1521276302;Taip;0;8;0;8
14636;Žiogelis;KREGŽDUTĖS;52932005977;Taip;0;5;0;5
14637;Žiogelis;KREGŽDUTĖS;28585504631;Taip;3;0;1;4
14638;Žiogelis;KREGŽDUTĖS;71387182665;Ne;9;0;0;9
14639;Žiogelis;KREGŽDUTĖS;94690046398;Taip;0;2;1;3
14640;Žiogelis;KREGŽDUTĖS;94313785346;Taip;0;1;0;1
14641;Žiogelis;KREGŽDUTĖS;22969768169;Taip;0;2;0;2
14642;Žiogelis;KREGŽDUTĖS;18304908981;Taip;0;6;0;6
14643;Žiogelis;KREGŽDUTĖS;1042591705;Taip;6;10;0;16
14644;Žiogelis;KREGŽDUTĖS;1160064257;Taip;0;1;0;1
14645;Žiogelis;KREGŽDUTĖS;1162630845;Taip;0;1;0;1
14646;Žiogelis;KREGŽDUTĖS;2072071751;Taip;0;1;2;3
14647;Žiogelis;KREGŽDUTĖS;1200247527;Taip;0;6;0;6
14648;Žiogelis;KREGŽDUTĖS;41448152472;Taip;0;1;0;1
14649;Žiogelis;KREGŽDUTĖS;44023584723;Taip;0;2;3;5
14650;Žiogelis;KREGŽDUTĖS;1915370991;Taip;0;3;0;3
14651;Žiogelis;KREGŽDUTĖS;1821759690;Ne;0;9;0;9
14652;Žiogelis;KREGŽDUTĖS;24010106626;Taip;0;7;0;7
14653;Žiogelis;KREGŽDUTĖS;2062794337;Ne;7;1;0;8
14654;Žiogelis;KREGŽDUTĖS;3802615302;Taip;0;1;0;1
14655;Žiogelis;KREGŽDUTĖS;84803452318;Taip;0;5;0;5
14656;Žiogelis;KREGŽDUTĖS;10001742134;Taip;0;1;2;3
14657;Žiogelis;KREGŽDUTĖS;4675275745;Taip;8;0;1;9
14658;Žiogelis;ŽVIRBLIUKAI;4156736676;Taip;11;0;0;11
14659;Žiogelis;ŽVIRBLIUKAI;4565342104;Taip;16;0;0;16
14660;Žiogelis;ŽVIRBLIUKAI;8894068297;Taip;17;2;0;19
14661;Žiogelis;ŽVIRBLIUKAI;4609861306;Taip;4;0;0;4
14662;Žiogelis;ŽVIRBLIUKAI;9387048672;Taip;2;13;0;15
14663;Žiogelis;ŽVIRBLIUKAI;7502572217;Taip;9;3;5;17
14664;Žiogelis;ŽVIRBLIUKAI;4378941619;Taip;0;1;0;1
14665;Žiogelis;ŽVIRBLIUKAI;1939672072;Taip;14;0;0;14
14666;Žiogelis;ŽVIRBLIUKAI;2759766559;Taip;18;0;0;18
14667;Žiogelis;ŽVIRBLIUKAI;1134384178;Taip;6;0;1;7
14668;Žiogelis;ŽVIRBLIUKAI;8689074067;Taip;0;1;0;1
14669;Žiogelis;ŽVIRBLIUKAI;7128248940;Taip;5;1;1;7
14670;Žiogelis;ŽVIRBLIUKAI;3963308094;Taip;0;8;0;8
14671;Žiogelis;ŽVIRBLIUKAI;9250789113;Taip;0;6;0;6
14672;Žiogelis;ŽVIRBLIUKAI;8217782981;Taip;10;6;0;16
14673;Žiogelis;ŽVIRBLIUKAI;5876904663;Taip;12;0;0;12
14674;Žiogelis;ŽVIRBLIUKAI;7120126547;Taip;7;8;0;15
14675;Žiogelis;ŽVIRBLIUKAI;7098548563;Taip;0;2;2;4
14676;Žiogelis;ŽVIRBLIUKAI;3937261260;Taip;0;4;0;4
14677;Žiogelis;BITUTĖS;3752355139;Taip;17;0;0;17
14678;Žiogelis;BITUTĖS;4605250897;Taip;13;0;0;13
14679;Žiogelis;BITUTĖS;6942029629;Ne;0;1;0;1
14680;Žiogelis;BITUTĖS;2173494736;Taip;18;0;1;19
14681;Žiogelis;BITUTĖS;3420228264;Taip;8;0;0;8
14682;Žiogelis;BITUTĖS;5042341085;Taip;13;0;0;13
14683;Žiogelis;BITUTĖS;9627583831;Taip;11;0;0;11
14684;Žiogelis;BITUTĖS;3296450902;Taip;8;0;0;8
14685;Žiogelis;BITUTĖS;2455244286;Taip;12;0;0;12
14686;Žiogelis;BITUTĖS;3792114246;Taip;10;1;0;11
14687;Žiogelis;BITUTĖS;9981130790;Taip;15;3;0;18
14688;Žiogelis;BITUTĖS;8293687695;Taip;15;1;0;16
14689;Žiogelis;BITUTĖS;3820534331;Taip;5;3;0;8
14690;Žiogelis;BITUTĖS;1996517542;Ne;6;2;0;8
14691;Žiogelis;BITUTĖS;5545581078;Taip;0;3;0;3
14692;Žiogelis;BITUTĖS;4630381709;Taip;9;1;0;10
14693;Žiogelis;BITUTĖS;9790463889;Taip;14;5;0;19
14694;Žiogelis;BITUTĖS;6024752960;Taip;0;2;1;3
14695;Žiogelis;BITUTĖS;8853905367;Taip;0;2;1;3
14696;Žiogelis;BITUTĖS;1397686161;Taip;5;1;0;6
14697;Žiogelis;BITUTĖS;2171351454;Taip;0;0;1;1
14698;Žiogelis;BITUTĖS;6760074113;Taip;10;0;0;10
14699;Žiogelis;RIEŠUTĖLIAI;6378295945;Taip;15;0;0;15
14700;Žiogelis;RIEŠUTĖLIAI;6308141378;Taip;11;0;0;11
14701;Žiogelis;RIEŠUTĖLIAI;1268908081;Taip;7;1;0;8
14702;Žiogelis;RIEŠUTĖLIAI;1828843135;Taip;5;0;0;5
14703;Žiogelis;RIEŠUTĖLIAI;5487213418;Taip;19;0;0;19
14704;Žiogelis;RIEŠUTĖLIAI;1618384759;Taip;0;2;1;3
14705;Žiogelis;RIEŠUTĖLIAI;3856321373;Taip;13;3;0;16
14706;Žiogelis;RIEŠUTĖLIAI;7340918175;Taip;5;0;0;5
14707;Žiogelis;RIEŠUTĖLIAI;7310459638;Taip;5;0;0;5
14708;Žiogelis;RIEŠUTĖLIAI;4513613915;Taip;0;7;0;7
14709;Žiogelis;RIEŠUTĖLIAI;8712788346;Taip;11;2;0;13
14710;Žiogelis;RIEŠUTĖLIAI;5054228916;Taip;2;0;0;2
14711;Žiogelis;RIEŠUTĖLIAI;6866685213;Taip;11;6;0;17
14712;Žiogelis;RIEŠUTĖLIAI;9813150014;Taip;3;0;0;3
14713;Žiogelis;RIEŠUTĖLIAI;9874412804;Taip;19;0;0;19
14714;Žiogelis;RIEŠUTĖLIAI;3361421852;Taip;9;1;0;10
14715;Žolynėlis;Spanguolėlė;92615552899;Taip;0;5;0;5
14716;Žolynėlis;Spanguolėlė;5717038791;Taip;16;2;0;18
14717;Žolynėlis;Spanguolėlė;15306882704;Taip;5;12;3;20
14718;Žolynėlis;Spanguolėlė;9128728457;Taip;0;8;0;8
14719;Žolynėlis;Spanguolėlė;1216568014;Taip;0;8;0;8
14720;Žolynėlis;Spanguolėlė;7438853916;Taip;0;2;12;14
14721;Žolynėlis;Spanguolėlė;44063150309;Taip;0;2;4;6
14722;Žolynėlis;Spanguolėlė;8700231970;Taip;1;0;0;1
14723;Žolynėlis;Spanguolėlė;7831076713;Ne;21;0;0;21
14724;Žolynėlis;"RŪTELĖ (spec)";48837362422;Taip;3;6;0;9
14725;Žolynėlis;"RŪTELĖ (spec)";88879292846;Taip;6;2;0;8
14726;Žolynėlis;"RŪTELĖ (spec)";1954888655;Taip;10;4;0;14
14727;Žolynėlis;"RŪTELĖ (spec)";6619551947;Taip;15;2;0;17
14728;Žolynėlis;"RŪTELĖ (spec)";6678697536;Taip;4;1;0;5
14729;Žolynėlis;"RŪTELĖ (spec)";6510930436;Taip;11;2;0;13
14730;Žolynėlis;"SAULUTĖ (spec)";89488434450;Ne;20;0;0;20
14731;Žolynėlis;"SAULUTĖ (spec)";1153167430;Taip;5;2;0;7
14732;Žolynėlis;"SAULUTĖ (spec)";9675783636;Taip;4;0;0;4
14733;Žolynėlis;"LINELIS (spec)";93519259505;Taip;3;8;0;11
14734;Žolynėlis;"LINELIS (spec)";23605662146;Ne;0;1;0;1
14735;Žolynėlis;"LINELIS (spec)";7717415005;Taip;0;2;0;2
14736;Žolynėlis;"LINELIS (spec)";2665355759;Taip;0;2;0;2
14737;Žolynėlis;"LINELIS (spec)";6080154964;Taip;0;3;3;6
14738;Žolynėlis;"RASAKILA (spec)";3337602618;Ne;6;1;0;7
14739;Žolynėlis;"RASAKILA (spec)";2913607286;Taip;19;0;0;19
14740;Žolynėlis;"RASAKILA (spec)";7962304738;Ne;5;1;0;6
14741;Žolynėlis;"RASAKILA (spec)";1196172221;Ne;0;12;0;12
14742;Žolynėlis;"RAMUNĖLĖS (spec)";1916465295;Taip;10;0;1;11
14743;Žolynėlis;"RAMUNĖLĖS (spec)";9262350279;Taip;5;1;1;7
14744;Žolynėlis;"RAMUNĖLĖS (spec)";2511678193;Taip;10;1;1;12
14745;Žolynėlis;"RAMUNĖLĖS (spec)";9926551617;Taip;0;0;3;3
14746;Žolynėlis;"RAMUNĖLĖS (spec)";2285501450;Taip;3;2;0;5
14747;Žolynėlis;Dobiliukai;59125596894;Taip;0;4;0;4
14748;Žolynėlis;Dobiliukai;1655571687;Taip;21;0;0;21
14749;Žolynėlis;Dobiliukai;1331253673;Taip;0;3;0;3
14750;Žolynėlis;Dobiliukai;89750778560;Taip;0;3;2;5
14751;Žolynėlis;Dobiliukai;76688557717;Taip;0;1;0;1
14752;Žolynėlis;Dobiliukai;47442048515;Taip;0;1;0;1
14753;Žolynėlis;Dobiliukai;75335374706;Taip;0;1;0;1
14754;Žolynėlis;Dobiliukai;71887799705;Taip;0;2;2;4
14755;Žolynėlis;Dobiliukai;1933377698;Taip;0;3;0;3
14756;Žolynėlis;Aguonėlė;7313345140;Taip;0;2;0;2
14757;Žolynėlis;Aguonėlė;1620578562;Taip;0;14;0;14
14758;Žolynėlis;Aguonėlė;77707724932;Taip;0;4;0;4
14759;Žolynėlis;Aguonėlė;4545601535;Taip;0;3;0;3
14760;Žolynėlis;Aguonėlė;95007685205;Taip;0;3;0;3
14761;Žolynėlis;Aguonėlė;61475380296;Taip;0;3;0;3
14762;Žolynėlis;Aguonėlė;8027151284;Taip;0;3;13;16
14763;Žolynėlis;Aguonėlė;28730145668;Taip;6;0;3;9
14764;Žolynėlis;Aguonėlė;14877714964;Taip;0;9;0;9
14765;Žolynėlis;Aguonėlė;84849092452;Taip;4;2;0;6
14766;Žolynėlis;Aguonėlė;3263848791;Taip;0;5;3;8
14767;Žolynėlis;Aguonėlė;5827146071;Taip;0;3;3;6
14768;Žolynėlis;Aguonėlė;7256502393;Taip;0;2;0;2
14769;Žolynėlis;Aguonėlė;79704789499;Taip;0;2;0;2
14770;Žolynėlis;Aguonėlė;5173171444;Taip;0;1;0;1
14771;Žolynėlis;Aguonėlė;2881461471;Taip;0;4;0;4
14772;Žolynėlis;Aguonėlė;8547773739;Taip;0;5;0;5
14773;Žolynėlis;Aguonėlė;2565770471;Taip;15;2;0;17
14774;Žolynėlis;Aguonėlė;5650427433;Taip;0;8;0;8
14775;Žolynėlis;Pienė;3520272555;Taip;0;12;0;12
14776;Žolynėlis;Pienė;3088932720;Taip;0;5;0;5
14777;Žolynėlis;Pienė;2108221942;Taip;11;2;0;13
14778;Žolynėlis;Pienė;2934361190;Taip;21;0;0;21
14779;Žolynėlis;Pienė;2460982987;Taip;7;1;0;8
14780;Žolynėlis;Pienė;7339110559;Taip;10;0;2;12
14781;Žolynėlis;Pienė;6763515483;Taip;0;0;1;1
14782;Žolynėlis;Pienė;8215427354;Ne;5;8;0;13
14783;Žolynėlis;Pienė;1485195267;Taip;0;2;4;6
14784;Žolynėlis;Pienė;1163753820;Ne;6;1;0;7
14785;Žolynėlis;Pienė;9106152447;Taip;0;1;0;1
14786;Žolynėlis;Pienė;7827343027;Taip;0;0;5;5
14787;Žolynėlis;Čiobreliai;4379062413;Taip;0;10;0;10
14788;Žolynėlis;Čiobreliai;96960531652;Taip;0;3;0;3
14789;Žolynėlis;Čiobreliai;32852326605;Taip;0;1;0;1
14790;Žolynėlis;Čiobreliai;67610580721;Taip;0;13;0;13
14791;Žolynėlis;Čiobreliai;91866724044;Taip;10;5;0;15
14792;Žolynėlis;Čiobreliai;58271736414;Taip;0;5;0;5
14793;Žolynėlis;Čiobreliai;1123243743;Taip;0;3;0;3
14794;Žolynėlis;Čiobreliai;79759781705;Taip;0;3;0;3
14795;Žolynėlis;Čiobreliai;1833898567;Taip;1;6;0;7
14796;Žolynėlis;Čiobreliai;29420971822;Ne;9;2;0;11
14797;Žolynėlis;Čiobreliai;1080834237;Taip;0;6;0;6
14798;Žolynėlis;Čiobreliai;1619061427;Ne;0;8;0;8
14799;Žolynėlis;Čiobreliai;8104525380;Taip;0;6;0;6
14800;Žolynėlis;Čiobreliai;24353356454;Taip;0;5;0;5
14801;Žolynėlis;Čiobreliai;82641799101;Taip;10;6;0;16
14802;Žolynėlis;Čiobreliai;95943166746;Taip;4;9;0;13
14803;Žolynėlis;Čiobreliai;4109395683;Taip;17;1;0;18
14804;Žolynėlis;Čiobreliai;2984354887;Taip;9;5;0;14
14805;Žolynėlis;Čiobreliai;66167062016;Taip;0;6;0;6
14806;Žolynėlis;Čiobreliai;2051626484;Taip;0;7;0;7
14807;Žolynėlis;Čiobreliai;1348748628;Taip;0;2;0;2
14808;Žolynėlis;Avietėlė;4618251201;Ne;0;17;1;18
14809;Žolynėlis;Avietėlė;5432464074;Taip;6;1;0;7
14810;Žolynėlis;Avietėlė;3149718901;Taip;0;21;0;21
14811;Žolynėlis;Avietėlė;6416217971;Taip;12;4;0;16
14812;Žolynėlis;Avietėlė;3877168024;Taip;21;0;0;21
14813;Žolynėlis;Avietėlė;9238832484;Taip;19;0;0;19
14814;Žolynėlis;Rugiagėlė;4758738231;Taip;7;0;7;14
14815;Žuvėdra;"JŪROS ŽVAIGŽDUTĖS";3516571980;Taip;11;0;0;11
14816;Žuvėdra;"JŪROS ŽVAIGŽDUTĖS";8096854841;Taip;0;1;13;14
14817;Žuvėdra;"JŪROS ŽVAIGŽDUTĖS";3148638780;Taip;10;4;0;14
14818;Žuvėdra;"JŪROS ŽVAIGŽDUTĖS";6148764075;Taip;0;1;0;1
14819;Žuvėdra;"JŪROS ŽVAIGŽDUTĖS";97427805302;Taip;1;0;0;1
14820;Žuvėdra;"JŪROS ŽVAIGŽDUTĖS";8349985186;Taip;10;0;1;11
14821;Žuvėdra;"JŪROS ŽVAIGŽDUTĖS";29500668582;Taip;14;0;1;15
14822;Žuvėdra;"JŪROS ŽVAIGŽDUTĖS";4828788876;Taip;11;7;0;18
14823;Žuvėdra;"JŪROS ŽVAIGŽDUTĖS";6068515077;Taip;0;7;0;7
14824;Žuvėdra;"JŪROS ŽVAIGŽDUTĖS";8104921853;Taip;11;1;0;12
14825;Žuvėdra;"JŪROS ŽVAIGŽDUTĖS";87882215162;Taip;0;3;0;3
14826;Žuvėdra;"JŪROS ŽVAIGŽDUTĖS";11300891895;Taip;0;9;0;9
14827;Žuvėdra;"JŪROS ŽVAIGŽDUTĖS";23851864127;Taip;0;1;0;1
14828;Žuvėdra;"JŪROS ŽVAIGŽDUTĖS";8843700949;Ne;0;8;0;8
14829;Žuvėdra;"JŪROS ŽVAIGŽDUTĖS";5472830961;Ne;0;3;0;3
14830;Žuvėdra;"JŪROS ŽVAIGŽDUTĖS";8589283055;Taip;16;0;0;16
14831;Žuvėdra;DELFINUKAI;1938808693;Taip;0;5;0;5
14832;Žuvėdra;DELFINUKAI;2334342995;Taip;0;2;0;2
14833;Žuvėdra;DELFINUKAI;5558584030;Taip;4;0;2;6
14834;Žuvėdra;DELFINUKAI;5049101816;Ne;12;4;0;16
14835;Žuvėdra;DELFINUKAI;9230342970;Taip;11;0;1;12
14836;Žuvėdra;DELFINUKAI;3620753237;Taip;11;4;0;15
14837;Žuvėdra;DELFINUKAI;2462839180;Ne;5;0;0;5
14838;Žuvėdra;DELFINUKAI;2660909247;Taip;4;0;0;4
14839;Žuvėdra;DELFINUKAI;8822952385;Ne;18;1;0;19
14840;Žuvėdra;DELFINUKAI;2092890028;Taip;5;1;3;9
14841;Žuvėdra;DELFINUKAI;7916717208;Taip;6;0;7;13
14842;Žuvėdra;DELFINUKAI;1311162040;Taip;10;3;0;13
14843;Žuvėdra;DELFINUKAI;9870595577;Taip;4;0;3;7
14844;Žuvėdra;DELFINUKAI;6294045755;Taip;0;9;0;9
14845;Žuvėdra;DELFINUKAI;3068069755;Taip;11;0;0;11
14846;Žuvėdra;DELFINUKAI;1200084485;Taip;0;8;0;8
14847;Žuvėdra;DELFINUKAI;2694424532;Taip;5;0;1;6
14848;Žuvėdra;DELFINUKAI;4177319374;Taip;0;5;2;7
14849;Žuvėdra;DELFINUKAI;1957926887;Taip;12;1;0;13
14850;Žuvėdra;OSMINOŽKI;1762760384;Taip;6;2;0;8
14851;Žuvėdra;OSMINOŽKI;1963584073;Taip;8;2;0;10
14852;Žuvėdra;OSMINOŽKI;2136463079;Taip;0;2;2;4
14853;Žuvėdra;OSMINOŽKI;74446494235;Taip;0;10;0;10
14854;Žuvėdra;OSMINOŽKI;41564122720;Taip;0;1;0;1
14855;Žuvėdra;OSMINOŽKI;1639340750;Taip;0;1;0;1
14856;Žuvėdra;OSMINOŽKI;3487938908;Ne;12;0;0;12
14857;Žuvėdra;OSMINOŽKI;66236924555;Taip;0;1;0;1
14858;Žuvėdra;OSMINOŽKI;66973380124;Ne;16;0;0;16
14859;Žuvėdra;OSMINOŽKI;8134671188;Taip;0;4;2;6
14860;Žuvėdra;OSMINOŽKI;4588593273;Taip;0;0;6;6
14861;Žuvėdra;OSMINOŽKI;55687216943;Ne;11;6;0;17
14862;Žuvėdra;OSMINOŽKI;1203660127;Taip;0;6;0;6
14863;Žuvėdra;OSMINOŽKI;9911525172;Taip;8;7;0;15
14864;Žuvėdra;OSMINOŽKI;24915726868;Taip;0;1;0;1
14865;Žuvėdra;OSMINOŽKI;1116645502;Taip;8;2;0;10
14866;Žuvėdra;OSMINOŽKI;1195732987;Ne;4;2;0;6
14867;Žuvėdra;OSMINOŽKI;1312918359;Taip;3;3;0;6
14868;Žuvėdra;OSMINOŽKI;6468506668;Ne;12;2;0;14
14869;Žuvėdra;OSMINOŽKI;83890207087;Taip;0;5;0;5
14870;Žuvėdra;RUSALAČKA;8408371550;Taip;5;1;0;6
14871;Žuvėdra;RUSALAČKA;2731016281;Taip;16;2;0;18
14872;Žuvėdra;RUSALAČKA;1164464390;Taip;4;4;0;8
14873;Žuvėdra;RUSALAČKA;1340241206;Taip;2;3;0;5
14874;Žuvėdra;RUSALAČKA;5021263583;Taip;0;1;0;1
14875;Žuvėdra;RUSALAČKA;5489757084;Taip;0;1;0;1
14876;Žuvėdra;RUSALAČKA;14760907606;Taip;0;0;4;4
14877;Žuvėdra;RUSALAČKA;1632308084;Taip;0;1;0;1
14878;Žuvėdra;RUSALAČKA;4011849839;Taip;4;9;0;13
14879;Žuvėdra;RUSALAČKA;75901332720;Taip;0;5;0;5
14880;Žuvėdra;RUSALAČKA;5684848140;Taip;5;8;0;13
14881;Žuvėdra;RUSALAČKA;5496071972;Taip;6;0;1;7
14882;Žuvėdra;RUSALAČKA;6612880861;Taip;10;7;0;17
14883;Žuvėdra;RUSALAČKA;1941428466;Taip;16;1;0;17
14884;Žuvėdra;RUSALAČKA;6007871092;Taip;17;0;0;17
14885;Žuvėdra;RUSALAČKA;63053155507;Taip;0;9;0;9
14886;Žuvėdra;RUSALAČKA;3853045274;Taip;0;1;0;1
14887;Žuvėdra;RUSALAČKA;6537464526;Taip;12;4;0;16
14888;Žuvėdra;RUSALAČKA;5674529681;Taip;5;9;0;14
14889;Žuvėdra;RUSALAČKA;7368183516;Taip;10;0;0;10
14890;Žuvėdra;RUSALAČKA;3185158741;Taip;4;1;0;5
14891;Žuvėdra;RUSALAČKA;5198825127;Taip;21;0;0;21
14892;Žuvėdra;RUSALAČKA;5561903903;Taip;0;0;1;1
14893;Žuvėdra;JANTARIKI;1960306957;Taip;10;4;0;14
14894;Žuvėdra;JANTARIKI;7467154866;Taip;7;0;0;7
14895;Žuvėdra;JANTARIKI;4715123063;Taip;7;4;0;11
14896;Žuvėdra;JANTARIKI;8308610070;Taip;14;0;0;14
14897;Žuvėdra;JANTARIKI;2582404760;Taip;7;3;0;10
14898;Žuvėdra;JANTARIKI;3613045982;Taip;14;7;0;21
14899;Žuvėdra;JANTARIKI;1509519996;Taip;11;5;0;16
14900;Žuvėdra;JANTARIKI;7710853637;Taip;0;5;0;5
14901;Žuvėdra;JANTARIKI;5151984122;Taip;10;3;0;13
14902;Žuvėdra;JANTARIKI;8942228415;Taip;6;0;2;8
14903;Žuvėdra;JANTARIKI;5679153359;Ne;13;0;0;13
14904;Žuvėdra;JANTARIKI;4373886054;Taip;15;2;0;17
14905;Žuvėdra;JANTARIKI;2987217910;Taip;16;0;0;16
14906;Žuvėdra;JANTARIKI;6672289932;Taip;9;0;0;9
14907;Žuvėdra;JANTARIKI;3349158713;Taip;19;0;0;19
14908;Žuvėdra;JANTARIKI;4702627979;Taip;13;2;0;15
14909;Žuvėdra;JANTARIKI;5398303580;Taip;4;0;0;4
14910;Žuvėdra;"AUKSINĖ ŽUVELĖ";1343293430;Taip;0;0;5;5
14911;Žuvėdra;"AUKSINĖ ŽUVELĖ";6324315523;Taip;15;2;1;18
14912;Žuvėdra;"AUKSINĖ ŽUVELĖ";7121154799;Taip;18;0;0;18
14913;Žuvėdra;"AUKSINĖ ŽUVELĖ";5744370516;Taip;4;0;0;4
14914;Žuvėdra;"AUKSINĖ ŽUVELĖ";5571732399;Taip;5;0;2;7
14915;Žuvėdra;"AUKSINĖ ŽUVELĖ";8472945857;Taip;0;1;0;1
14916;Žuvėdra;"AUKSINĖ ŽUVELĖ";7958768355;Ne;5;0;0;5
14917;Žuvėdra;"AUKSINĖ ŽUVELĖ";8185190219;Taip;18;0;2;20
14918;Žuvėdra;"AUKSINĖ ŽUVELĖ";8700802853;Taip;0;12;0;12
14919;Žuvėdra;"AUKSINĖ ŽUVELĖ";9485995178;Taip;10;5;0;15
14920;Žuvėdra;"AUKSINĖ ŽUVELĖ";5436158437;Taip;15;0;1;16
14921;Žuvėdra;"AUKSINĖ ŽUVELĖ";9521104462;Taip;20;0;0;20
14922;Žuvėdra;"AUKSINĖ ŽUVELĖ";2849503557;Taip;9;0;0;9
14923;Žuvėdra;"AUKSINĖ ŽUVELĖ";8162649794;Taip;11;2;1;14
14924;Žuvėdra;"AUKSINĖ ŽUVELĖ";6952843736;Taip;0;0;3;3
14925;Žvangutis;PELIUKŲ;6701947168;Taip;0;2;0;2
14926;Žvangutis;PELIUKŲ;1165172787;Taip;5;0;0;5
14927;Žvangutis;PELIUKŲ;1339151674;Ne;1;0;0;1
14928;Žvangutis;PELIUKŲ;1310113034;Taip;0;0;2;2
14929;Žvangutis;PELIUKŲ;7202747419;Taip;2;0;0;2
14930;Žvangutis;PELIUKŲ;7320625500;Taip;0;5;0;5
14931;Žvangutis;PELIUKŲ;3513746926;Taip;0;0;8;8
14932;Žvangutis;PELIUKŲ;9408369641;Ne;0;0;4;4
14933;Žvangutis;PELIUKŲ;6110958520;Taip;15;0;2;17
14934;Žvangutis;PELIUKŲ;8288997508;Ne;0;2;0;2
14935;Žvangutis;PELIUKŲ;3817258555;Taip;0;2;0;2
14936;Žvangutis;PELIUKŲ;6844824726;Ne;0;8;0;8
14937;Žvangutis;PELIUKŲ;3315858185;Taip;14;0;1;15
14938;Žvangutis;PELIUKŲ;92356998180;Taip;10;0;0;10
14939;Žvangutis;PELIUKŲ;5683601025;Taip;0;10;0;10
14940;Žvangutis;PELIUKŲ;8617941954;Taip;0;8;0;8
14941;Žvangutis;PELIUKŲ;3775960571;Taip;0;10;0;10
14942;Žvangutis;PELIUKŲ;11567978993;Taip;3;0;0;3
14943;Žvangutis;PELIUKŲ;9134683276;Taip;9;0;0;9
14944;Žvangutis;PELIUKŲ;8511103595;Taip;9;0;0;9
14945;Žvangutis;PELIUKŲ;7267340112;Taip;0;1;0;1
14946;Žvangutis;PELIUKŲ;9145365865;Taip;10;1;0;11
14947;Žvangutis;ANČIUKŲ;46159057420;Taip;0;2;0;2
14948;Žvangutis;ANČIUKŲ;93175189832;Taip;3;0;0;3
14949;Žvangutis;ANČIUKŲ;18751626988;Taip;0;5;0;5
14950;Žvangutis;ANČIUKŲ;98607926663;Taip;0;0;3;3
14951;Žvangutis;ANČIUKŲ;12457255518;Taip;0;6;0;6
14952;Žvangutis;ANČIUKŲ;9618217868;Taip;0;2;0;2
14953;Žvangutis;ANČIUKŲ;91140904183;Ne;0;1;0;1
14954;Žvangutis;ANČIUKŲ;30697407645;Ne;0;2;1;3
14955;Žvangutis;ANČIUKŲ;86145834840;Taip;0;1;0;1
14956;Žvangutis;ANČIUKŲ;93894162596;Taip;0;6;1;7
14957;Žvangutis;ANČIUKŲ;38451136109;Ne;0;2;0;2
14958;Žvangutis;ANČIUKŲ;39364323060;Taip;0;16;0;16
14959;Žvangutis;ANČIUKŲ;57033172828;Taip;10;2;1;13
14960;Žvangutis;ANČIUKŲ;80054829676;Taip;0;2;4;6
14961;Žvangutis;ANČIUKŲ;11053503331;Taip;0;1;0;1
14962;Žvangutis;ANČIUKŲ;41703990445;Ne;0;7;0;7
14963;Žvangutis;ANČIUKŲ;5929099485;Ne;0;4;0;4
14964;Žvangutis;ANČIUKŲ;95130491335;Taip;0;1;0;1
14965;Žvangutis;ANČIUKŲ;77459956838;Taip;0;6;0;6
14966;Žvangutis;ANČIUKŲ;77044982999;Taip;0;1;0;1
14967;Žvangutis;ANČIUKŲ;5616640228;Taip;0;2;0;2
14968;Žvangutis;ANČIUKŲ;1898484868;Taip;0;6;0;6
14969;Žvangutis;PELĖDŽIUKŲ;2755838558;Taip;0;11;0;11
14970;Žvangutis;PELĖDŽIUKŲ;1322688456;Taip;10;1;0;11
14971;Žvangutis;PELĖDŽIUKŲ;9036869235;Taip;0;2;0;2
14972;Žvangutis;PELĖDŽIUKŲ;2570379643;Taip;0;6;0;6
14973;Žvangutis;PELĖDŽIUKŲ;2600596320;Taip;0;11;0;11
14974;Žvangutis;PELĖDŽIUKŲ;2623107843;Taip;2;1;0;3
14975;Žvangutis;PELĖDŽIUKŲ;1185135525;Taip;0;15;0;15
14976;Žvangutis;PELĖDŽIUKŲ;2411307963;Ne;6;0;0;6
14977;Žvangutis;PELĖDŽIUKŲ;9468660351;Taip;4;7;0;11
14978;Žvangutis;PELĖDŽIUKŲ;1324948757;Taip;13;0;0;13
14979;Žvangutis;PELĖDŽIUKŲ;2922083476;Taip;10;1;0;11
14980;Žvangutis;PELĖDŽIUKŲ;1282567366;Taip;5;1;0;6
14981;Žvangutis;PELĖDŽIUKŲ;6068428687;Taip;9;0;0;9
14982;Žvangutis;PELĖDŽIUKŲ;9149037184;Taip;9;0;0;9
14983;Žvangutis;PELĖDŽIUKŲ;3665275100;Taip;7;0;0;7
14984;Žvangutis;PELĖDŽIUKŲ;5012996199;Taip;5;1;0;6
14985;Žvangutis;PELĖDŽIUKŲ;8295525284;Taip;5;0;0;5
14986;Žvangutis;PELĖDŽIUKŲ;3276065009;Taip;9;0;0;9
14987;Žvangutis;PELĖDŽIUKŲ;6040986672;Taip;5;4;0;9
14988;Žvangutis;PELĖDŽIUKŲ;2716216474;Ne;0;2;0;2
14989;Žvangutis;KAČIUKŲ;2291142377;Taip;0;1;0;1
14990;Žvangutis;KAČIUKŲ;1882797491;Taip;0;4;0;4
14991;Žvangutis;KAČIUKŲ;65598561926;Taip;0;1;0;1
14992;Žvangutis;KAČIUKŲ;52676408047;Taip;13;0;0;13
14993;Žvangutis;KAČIUKŲ;52544167449;Taip;0;1;0;1
14994;Žvangutis;KAČIUKŲ;8697156717;Taip;16;1;0;17
14995;Žvangutis;KAČIUKŲ;23369081648;Taip;0;2;0;2
14996;Žvangutis;KAČIUKŲ;6989839997;Taip;10;0;0;10
14997;Žvangutis;KAČIUKŲ;1065463278;Ne;0;3;0;3
14998;Žvangutis;KAČIUKŲ;1369424754;Taip;0;15;0;15
14999;Žvangutis;KAČIUKŲ;1823402065;Taip;0;12;0;12
15000;Žvangutis;KAČIUKŲ;6343552093;Taip;0;12;0;12
15001;Žvangutis;KAČIUKŲ;2145325174;Taip;2;2;0;4
15002;Žvangutis;KAČIUKŲ;2251482949;Taip;5;0;0;5
15003;Žvangutis;KAČIUKŲ;45857502483;Taip;0;3;0;3
15004;Žvangutis;KAČIUKŲ;4699447138;Taip;0;2;0;2
15005;Žvangutis;KAČIUKŲ;1862121693;Taip;5;2;0;7
15006;Žvangutis;KAČIUKŲ;1096499939;Taip;0;1;0;1
15007;Žvangutis;KAČIUKŲ;1847928083;Taip;0;12;0;12
15008;Žvangutis;KAČIUKŲ;1665136168;Taip;0;8;0;8
15009;Žvangutis;MEŠKUČIŲ;2296360416;Taip;0;8;0;8
15010;Žvangutis;MEŠKUČIŲ;9958554027;Taip;0;0;5;5
15011;Žvangutis;MEŠKUČIŲ;9239279639;Taip;0;7;0;7
15012;Žvangutis;MEŠKUČIŲ;1142315595;Taip;20;1;0;21
15013;Žvangutis;MEŠKUČIŲ;2351386211;Taip;0;0;2;2
15014;Žvangutis;MEŠKUČIŲ;6041698323;Taip;0;2;0;2
15015;Žvangutis;MEŠKUČIŲ;8492637734;Taip;15;0;0;15
15016;Žvangutis;MEŠKUČIŲ;7581320158;Taip;5;1;0;6
15017;Žvangutis;MEŠKUČIŲ;7721746116;Taip;5;4;2;11
15018;Žvangutis;MEŠKUČIŲ;2598842770;Taip;0;1;0;1
15019;Žvangutis;MEŠKUČIŲ;6723079944;Taip;5;0;0;5
15020;Žvangutis;MEŠKUČIŲ;4696437804;Taip;7;0;2;9
15021;Žvangutis;MEŠKUČIŲ;7213349517;Taip;0;1;0;1
15022;Žvangutis;KIŠKUČIŲ;1687362077;Taip;0;13;0;13
15023;Žvangutis;KIŠKUČIŲ;1886637245;Taip;0;4;0;4
15024;Žvangutis;KIŠKUČIŲ;96443240617;Taip;0;5;1;6
15025;Žvangutis;KIŠKUČIŲ;4249416168;Taip;0;2;0;2
15026;Žvangutis;KIŠKUČIŲ;1615111824;Taip;0;1;0;1
15027;Žvangutis;KIŠKUČIŲ;1481786579;Taip;7;1;0;8
15028;Žvangutis;KIŠKUČIŲ;1334567751;Taip;0;5;0;5
15029;Žvangutis;KIŠKUČIŲ;2138652487;Taip;10;1;1;12
15030;Žvangutis;KIŠKUČIŲ;1693249341;Taip;0;6;0;6
15031;Žvangutis;KIŠKUČIŲ;4798540560;Taip;0;4;0;4
15032;Žvangutis;KIŠKUČIŲ;5563516622;Taip;6;4;0;10
15033;Žvangutis;KIŠKUČIŲ;74528704135;Taip;5;2;0;7
15034;Žvangutis;KIŠKUČIŲ;57385778197;Taip;5;1;2;8
15035;Žvangutis;KIŠKUČIŲ;79808715852;Ne;0;4;0;4
15036;Žvangutis;KIŠKUČIŲ;5643005222;Taip;5;1;0;6
15037;Žvangutis;KIŠKUČIŲ;25954145882;Taip;0;1;0;1
15038;Žvangutis;KIŠKUČIŲ;1702224809;Ne;0;1;2;3
15039;Žvangutis;KIŠKUČIŲ;2111430405;Taip;0;6;0;6
15040;Žvangutis;KIŠKUČIŲ;46410307693;Taip;0;2;0;2
15041;Žvangutis;KIŠKUČIŲ;3049348955;Taip;0;4;0;4
15042;Žvangutis;KIŠKUČIŲ;1845521463;Taip;10;1;0;11
15043;Žirniukas;Boružiukų;5311746004;Taip;15;0;1;16
15044;Žirniukas;Boružiukų;6466220057;Ne;5;1;0;6
15045;Žirniukas;Boružiukų;3107511189;Ne;0;1;0;1
15046;Žirniukas;Boružiukų;2476906136;Taip;0;0;8;8
15047;Žirniukas;Boružiukų;2785102131;Taip;0;2;0;2
15048;Žirniukas;Boružiukų;8213507698;Taip;5;1;4;10
15049;Žirniukas;Boružiukų;2528905738;Ne;11;0;0;11
15050;Žirniukas;Boružiukų;2348752207;Taip;10;0;11;21
15051;Žirniukas;Boružiukų;6268788036;Taip;0;1;0;1
15052;Žirniukas;Boružiukų;6363169823;Taip;7;0;0;7
15053;Žirniukas;Boružiukų;2636634198;Taip;4;1;2;7
15054;Žirniukas;Boružiukų;8148254025;Taip;5;3;1;9
15055;Žirniukas;Boružiukų;1867254291;Taip;5;3;1;9
15056;Žirniukas;Boružiukų;5058103759;Taip;9;1;0;10
15057;Žirniukas;Boružiukų;6531175340;Taip;13;1;0;14
15058;Žirniukas;Boružiukų;6641200341;Taip;0;1;1;2
15059;Žirniukas;Boružiukų;3022672028;Taip;9;2;0;11
15060;Žirniukas;Smalsučiai;1701389895;Taip;0;1;0;1
15061;Žirniukas;Smalsučiai;65471257240;Ne;0;1;0;1
15062;Žirniukas;Smalsučiai;99019576563;Taip;4;1;0;5
15063;Žirniukas;Smalsučiai;56948775759;Taip;0;2;0;2
15064;Žirniukas;Smalsučiai;23221186484;Taip;0;1;0;1
15065;Žirniukas;Smalsučiai;54285529186;Taip;3;1;0;4
15066;Žirniukas;Smalsučiai;1382313386;Taip;3;0;0;3
15067;Žirniukas;Smalsučiai;49058747304;Taip;0;1;2;3
15068;Žirniukas;Smalsučiai;59972903968;Taip;0;2;0;2
15069;Žirniukas;Smalsučiai;37416946100;Taip;0;1;0;1
15070;Žirniukas;Smalsučiai;3723155762;Taip;1;1;0;2
15071;Žirniukas;Smalsučiai;15527206706;Taip;1;0;0;1
15072;Žirniukas;Smalsučiai;83997736517;Taip;0;1;0;1
15073;Žirniukas;Smalsučiai;7739943293;Ne;0;2;0;2
15074;Žirniukas;Smalsučiai;89146903524;Taip;1;1;1;3
15075;Žirniukas;Smalsučiai;65003409430;Taip;0;1;0;1
15076;Žirniukas;Smalsučiai;1150580143;Taip;2;1;5;8
15077;Žirniukas;Gėlyčių;74425301830;Ne;4;8;0;12
15078;Žirniukas;Gėlyčių;3763537106;Ne;0;0;1;1
15079;Žirniukas;Gėlyčių;6649555415;Taip;15;0;2;17
15080;Žirniukas;Gėlyčių;32583177093;Taip;0;1;0;1
15081;Žirniukas;Gėlyčių;91259031678;Taip;0;0;2;2
15082;Žirniukas;Gėlyčių;1804181833;Taip;0;1;0;1
15083;Žirniukas;Gėlyčių;47573534391;Taip;0;6;0;6
15084;Žirniukas;Gėlyčių;1878369945;Taip;11;2;0;13
15085;Žirniukas;Gėlyčių;2072018782;Taip;0;3;0;3
15086;Žirniukas;Gėlyčių;1378845384;Taip;0;10;0;10
15087;Žirniukas;Gėlyčių;8190751348;Taip;11;0;5;16
15088;Žirniukas;Gėlyčių;7872611724;Taip;11;0;5;16
15089;Žirniukas;Gėlyčių;4992122911;Taip;10;0;0;10
15090;Žirniukas;Gėlyčių;8180092480;Ne;0;0;1;1
15091;Žirniukas;Gėlyčių;7397202752;Taip;14;0;2;16
15092;Žirniukas;Gėlyčių;9938936765;Ne;9;0;1;10
15093;Žirniukas;Nykštukų;2309995947;Taip;5;0;0;5
15094;Žirniukas;Nykštukų;1514504241;Taip;0;2;2;4
15095;Žirniukas;Nykštukų;1064894307;Taip;0;2;1;3
15096;Žirniukas;Nykštukų;1162904969;Taip;5;2;0;7
15097;Žirniukas;Nykštukų;2049123663;Taip;0;0;10;10
15098;Žirniukas;Nykštukų;1017483419;Taip;8;0;0;8
15099;Žirniukas;Nykštukų;6957047759;Taip;8;0;0;8
15100;Žirniukas;Nykštukų;2151329751;Taip;0;2;0;2
15101;Žirniukas;Nykštukų;5939918015;Taip;8;2;1;11
15102;Žirniukas;Nykštukų;3010062747;Ne;0;1;2;3
15103;Žirniukas;Nykštukų;2162238771;Taip;0;2;0;2
15104;Žirniukas;Nykštukų;2029018108;Taip;0;2;0;2
15105;Žirniukas;Nykštukų;5987510202;Taip;0;0;4;4
15106;Žirniukas;Nykštukų;5104110821;Taip;0;0;2;2
15107;Žirniukas;Nykštukų;5471647472;Ne;2;2;1;5
15108;Žirniukas;Nykštukų;7644911127;Taip;0;0;1;1
15109;Žirniukas;Nykštukų;6180439078;Taip;0;0;1;1
15110;Žirniukas;Nykštukų;3808838764;Ne;0;2;5;7
15111;Žirniukas;Nykštukų;7975957714;Ne;0;1;0;1
15112;Žirniukas;Saulytės;37852143615;Taip;0;2;0;2
15113;Žirniukas;Saulytės;1409567693;Taip;5;5;0;10
15114;Žirniukas;Saulytės;2022475049;Taip;0;3;1;4
15115;Žirniukas;Saulytės;32419042337;Taip;1;1;0;2
15116;Žirniukas;Saulytės;71263500233;Taip;2;1;2;5
15117;Žirniukas;Saulytės;65898776759;Taip;7;0;0;7
15118;Žirniukas;Saulytės;51172128673;Taip;3;3;0;6
15119;Žirniukas;Saulytės;5189034384;Ne;14;2;0;16
15120;Žirniukas;Saulytės;68565861419;Ne;5;0;0;5
15121;Žirniukas;Saulytės;2294854901;Taip;0;1;0;1
15122;Žirniukas;Saulytės;5188013194;Taip;9;0;1;10
15123;Žirniukas;Saulytės;69810421328;Taip;0;1;1;2
15124;Žirniukas;Saulytės;66153778144;Taip;0;0;10;10
15125;Žirniukas;Saulytės;47491327916;Taip;0;3;4;7
15126;Žirniukas;Saulytės;98028824068;Taip;0;0;1;1
15127;Žirniukas;Saulytės;28992463324;Taip;4;8;1;13
15128;Žirniukas;Saulytės;71922426195;Taip;0;0;9;9
15129;Žirniukas;Drugelių;2141162140;Taip;6;2;0;8
15130;Žirniukas;Drugelių;1294183547;Taip;4;5;0;9
15131;Žirniukas;Drugelių;9192660067;Taip;0;7;0;7
15132;Žirniukas;Drugelių;2557138057;Taip;6;0;0;6
15133;Žirniukas;Drugelių;3068684150;Taip;21;0;0;21
15134;Žirniukas;Drugelių;8644938346;Ne;0;3;0;3
15135;Žirniukas;Drugelių;1991599271;Ne;0;1;0;1
15136;Žirniukas;Drugelių;2282495237;Taip;0;0;2;2
15137;Žirniukas;Drugelių;1961708150;Taip;0;9;1;10
15138;Žirniukas;Drugelių;9896415564;Taip;8;1;2;11
15139;Žirniukas;Drugelių;98962928727;Taip;5;0;0;5
15140;Žirniukas;Drugelių;6409900451;Taip;13;0;0;13
15141;Žirniukas;Drugelių;46265018782;Taip;0;1;0;1
15142;Žirniukas;Drugelių;7190628011;Taip;0;9;0;9
15143;Žirniukas;Drugelių;3248779733;Taip;5;1;1;7
15144;Žirniukas;Drugelių;9374080010;Taip;10;0;0;10
15145;Žirniukas;Drugelių;1095501791;Taip;0;0;4;4
15146;Žirniukas;Drugelių;1678041002;Taip;10;1;0;11
15147;Žirniukas;Drugelių;9649896460;Taip;8;0;0;8
15148;Žirniukas;Pelėdžiukai;1685677297;Taip;3;0;3;6
15149;Žirniukas;Pelėdžiukai;9424009308;Taip;5;0;0;5
15150;Žirniukas;Pelėdžiukai;1542257475;Taip;0;2;0;2
15151;Žirniukas;Pelėdžiukai;98781117814;Taip;0;1;4;5
15152;Žirniukas;Pelėdžiukai;1158530590;Taip;0;1;1;2
15153;Žirniukas;Pelėdžiukai;1352159915;Taip;0;0;4;4
15154;Žirniukas;Pelėdžiukai;1096649614;Taip;0;2;0;2
15155;Žirniukas;Pelėdžiukai;1699821845;Taip;0;1;0;1
15156;Žirniukas;Pelėdžiukai;52845409413;Taip;6;0;1;7
15157;Žirniukas;Pelėdžiukai;1609778506;Taip;0;1;1;2
15158;Žirniukas;Pelėdžiukai;1506642709;Taip;0;0;6;6
15159;Žirniukas;Pelėdžiukai;2118772211;Taip;9;1;2;12
15160;Žirniukas;Pelėdžiukai;1907669506;Taip;0;0;1;1
15161;Žirniukas;Pelėdžiukai;1607867151;Ne;12;0;1;13
15162;Žirniukas;Pelėdžiukai;1586083174;Taip;0;6;0;6
15163;Žirniukas;Pelėdžiukai;52181077421;Taip;4;2;1;7
15164;Žirniukas;Pelėdžiukai;5479153220;Taip;16;0;0;16
15165;Žirniukas;Pelėdžiukai;3236175335;Taip;9;1;1;11
15166;Žirniukas;ZUIKUČIAI;2733313392;Taip;13;1;0;14
15167;Žirniukas;ZUIKUČIAI;9961947583;Taip;5;2;2;9
15168;Žirniukas;ZUIKUČIAI;3610402086;Ne;13;0;0;13
15169;Žirniukas;ZUIKUČIAI;4827797140;Taip;2;1;2;5
15170;Žirniukas;ZUIKUČIAI;5819443551;Ne;10;1;0;11
15171;Žirniukas;ZUIKUČIAI;4045432303;Taip;4;3;0;7
15172;Žirniukas;ZUIKUČIAI;9707776533;Taip;19;2;0;21
15173;Žirniukas;ZUIKUČIAI;7278153529;Taip;19;2;0;21
15174;Žirniukas;ZUIKUČIAI;2325139043;Taip;0;5;0;5
15175;Žirniukas;ZUIKUČIAI;6254250706;Taip;6;0;0;6
15176;Žirniukas;ZUIKUČIAI;1262404954;Taip;6;0;0;6
15177;Žirniukas;ZUIKUČIAI;7926160083;Taip;12;0;1;13
15178;Žirniukas;ZUIKUČIAI;2982628594;Taip;0;1;0;1
15179;Žirniukas;ZUIKUČIAI;5422282267;Taip;11;1;3;15
15180;Aušra;Kodėlčiukai;3420851059;Taip;2;2;0;4
15181;Aušra;Kodėlčiukai;2199083085;Taip;0;1;0;1
15182;Aušra;Kodėlčiukai;4720749995;Taip;0;10;1;11
15183;Aušra;Kodėlčiukai;6139706771;Taip;10;7;0;17
15184;Aušra;Kodėlčiukai;7314273812;Ne;5;0;6;11
15185;Aušra;Kodėlčiukai;1526296386;Taip;21;0;0;21
15186;Aušra;Kodėlčiukai;5046439805;Taip;0;2;1;3
15187;Aušra;Kodėlčiukai;4540040693;Taip;11;1;0;12
15188;Aušra;Kodėlčiukai;1423840991;Taip;0;0;1;1
15189;Aušra;Kodėlčiukai;5013135853;Taip;5;0;0;5
15190;Aušra;Kodėlčiukai;9728140172;Taip;0;8;0;8
15191;Aušra;Kodėlčiukai;7765504789;Taip;0;5;0;5
15192;Aušra;Kodėlčiukai;8108663467;Taip;11;2;2;15
15193;Aušra;Kodėlčiukai;4824773027;Ne;4;0;0;4
15194;Aušra;Kodėlčiukai;1897365632;Taip;3;2;2;7
15195;Aušra;Kodėlčiukai;7469266085;Taip;2;13;0;15
15196;Aušra;Kodėlčiukai;1010721404;Taip;0;7;0;7
15197;Aušra;Pelėdžiukai;8686777160;Ne;0;1;0;1
15198;Aušra;Pelėdžiukai;15657824495;Taip;6;8;0;14
15199;Aušra;Pelėdžiukai;1385844067;Taip;0;1;0;1
15200;Aušra;Pelėdžiukai;35429495907;Taip;0;3;0;3
15201;Aušra;Pelėdžiukai;79051821501;Taip;3;2;0;5
15202;Aušra;Pelėdžiukai;3001784066;Taip;5;2;0;7
15203;Aušra;Pelėdžiukai;21234588466;Taip;0;0;1;1
15204;Aušra;Pelėdžiukai;5815377310;Ne;0;4;0;4
15205;Aušra;Pelėdžiukai;23609052737;Taip;10;1;0;11
15206;Aušra;Pelėdžiukai;3823619675;Taip;3;2;0;5
15207;Aušra;Pelėdžiukai;13825730049;Taip;0;2;0;2
15208;Aušra;Pelėdžiukai;58254707316;Ne;0;2;2;4
15209;Aušra;Pelėdžiukai;18943927144;Taip;17;1;0;18
15210;Aušra;Pelėdžiukai;1623803107;Taip;0;8;0;8
15211;Aušra;Pelėdžiukai;57469542504;Taip;5;0;0;5
15212;Aušra;Pelėdžiukai;2121418946;Taip;1;0;0;1
15213;Aušra;Pelėdžiukai;5409157554;Taip;0;0;5;5
15214;Aušra;Pelėdžiukai;2227238810;Ne;13;3;3;19
15215;Aušra;Pelėdžiukai;2000206874;Ne;16;0;0;16
15216;Aušra;Pelėdžiukai;4325224130;Taip;0;2;0;2
15217;Aušra;Pelėdžiukai;59267104215;Taip;0;1;0;1
15218;Aušra;Pelėdžiukai;5988529284;Taip;0;1;0;1
15219;Aušra;Smalsučiai;1049364899;Taip;0;5;0;5
15220;Aušra;Smalsučiai;1154675251;Taip;0;1;0;1
15221;Aušra;Smalsučiai;1473962346;Taip;0;5;0;5
15222;Aušra;Smalsučiai;1427235223;Taip;0;2;0;2
15223;Aušra;Smalsučiai;2128822237;Taip;0;3;0;3
15224;Aušra;Smalsučiai;81510885976;Ne;0;1;0;1
15225;Aušra;Smalsučiai;1767520195;Taip;0;1;1;2
15226;Aušra;Smalsučiai;76979979920;Taip;0;1;1;2
15227;Aušra;Smalsučiai;97571593143;Taip;0;4;0;4
15228;Aušra;Smalsučiai;59235411329;Taip;5;1;3;9
15229;Aušra;Smalsučiai;42344686036;Taip;0;4;0;4
15230;Aušra;Smalsučiai;62209740677;Taip;2;2;2;6
15231;Aušra;Smalsučiai;2019580127;Taip;0;9;0;9
15232;Aušra;Smalsučiai;95586246863;Taip;0;6;0;6
15233;Aušra;Smalsučiai;1095212350;Taip;0;1;3;4
15234;Aušra;Smalsučiai;66203768924;Taip;0;0;1;1
15235;Aušra;Smalsučiai;7962184651;Taip;0;1;0;1
15236;Aušra;Smalsučiai;12689030409;Taip;2;1;0;3
15237;Aušra;Smalsučiai;98150444770;Taip;0;1;0;1
15238;Aušra;Smalsučiai;1167565535;Taip;0;12;0;12
15239;Aušra;Smalsučiai;52044254281;Taip;7;0;4;11
15240;Aušra;Smalsučiai;1831747749;Taip;0;5;0;5
15241;Aušra;Smalsučiai;7222605763;Taip;9;2;0;11
15242;Aušra;Smalsučiai;4645855409;Taip;8;3;0;11
15243;Aušra;Smalsučiai;14343589644;Taip;0;1;0;1
15244;Aušra;Pagrandukai;7043021721;Taip;8;8;0;16
15245;Aušra;Pagrandukai;2023718424;Taip;0;0;3;3
15246;Aušra;Pagrandukai;8709340592;Taip;10;0;0;10
15247;Aušra;Pagrandukai;5524681006;Ne;8;1;0;9
15248;Aušra;Pagrandukai;4404047456;Taip;10;0;3;13
15249;Aušra;Pagrandukai;3680329197;Taip;16;0;0;16
15250;Aušra;Pagrandukai;2288159223;Taip;16;2;0;18
15251;Aušra;Pagrandukai;4805298824;Taip;5;0;0;5
15252;Aušra;Pagrandukai;29499576216;Taip;5;1;0;6
15253;Aušra;Pagrandukai;1940882109;Taip;0;3;0;3
15254;Aušra;Pagrandukai;7814902928;Taip;6;0;0;6
15255;Aušra;Pagrandukai;6384243597;Taip;5;4;0;9
15256;Aušra;Pagrandukai;3898178166;Ne;0;1;0;1
15257;Aušra;Pagrandukai;4352174590;Taip;16;0;0;16
15258;Aušra;Pagrandukai;1575761029;Taip;0;13;0;13
15259;Aušra;Pagrandukai;5673568541;Taip;0;0;5;5
15260;Aušra;Pagrandukai;97102749430;Taip;0;8;0;8
15261;Aušra;Pagrandukai;5777939563;Ne;0;11;0;11
15262;Aušra;Pagrandukai;8740755922;Taip;6;0;2;8
15263;Aušra;Pagrandukai;9831054554;Taip;0;0;4;4
15264;Aušra;"1A klasė";8510995681;Taip;0;1;0;1
15265;Aušra;"1A klasė";9605206310;Taip;10;1;0;11
15266;Aušra;"1A klasė";3284383302;Taip;0;1;0;1
15267;Aušra;"1A klasė";13157844661;Taip;0;1;0;1
15268;Aušra;"1A klasė";68160889669;Taip;4;1;0;5
15269;Aušra;"1A klasė";88655846176;Taip;1;1;0;2
15270;Aušra;"1A klasė";73509864636;Ne;0;1;0;1
15271;Aušra;"1A klasė";40499781883;Taip;0;1;0;1
15272;Aušra;"1A klasė";70233681803;Taip;0;1;0;1
15273;Aušra;"1A klasė";40714551025;Taip;0;1;0;1
15274;Aušra;"1A klasė";97781409787;Ne;0;1;0;1
15275;Aušra;"1A klasė";1396233353;Taip;7;1;0;8
15276;Aušra;"1A klasė";1437126272;Taip;0;1;0;1
15277;Aušra;"1A klasė";39537089288;Taip;0;1;0;1
15278;Aušra;"1A klasė";3965445196;Taip;0;1;0;1
15279;Aušra;"1A klasė";85578471272;Taip;0;1;0;1
15280;Aušra;"1A klasė";27958163601;Taip;0;1;0;1
15281;Aušra;"1A klasė";68031503463;Taip;1;1;0;2
15282;Aušra;"1A klasė";81633973264;Taip;0;1;0;1
15283;Aušra;"1A klasė";52985512945;Taip;0;1;0;1
15284;Aušra;"1A klasė";51185323645;Ne;0;1;0;1
15285;Aušra;"1A klasė";1437385365;Taip;6;1;0;7
15286;Aušra;"1A klasė";80929303402;Taip;8;1;0;9
15287;Aušra;"1A klasė";15330844181;Taip;0;1;0;1
15288;Aušra;"1A klasė";92468615840;Taip;0;1;0;1
15289;Aušra;"1A klasė";2062775070;Taip;0;1;0;1
15290;Aušra;"2A klasė";94704151051;Taip;0;1;0;1
15291;Aušra;"2A klasė";99886964420;Taip;0;21;0;21
15292;Aušra;"2A klasė";19920237804;Taip;8;1;0;9
15293;Aušra;"2A klasė";13361663464;Taip;7;1;0;8
15294;Aušra;"2A klasė";95948867937;Taip;0;21;0;21
15295;Aušra;"2A klasė";78030425432;Taip;0;1;0;1
15296;Aušra;"2A klasė";34795588283;Ne;0;21;0;21
15297;Aušra;"2A klasė";29636399665;Taip;0;1;0;1
15298;Aušra;"2A klasė";81428848455;Taip;1;1;0;2
15299;Aušra;"2A klasė";47725613978;Taip;0;21;0;21
15300;Aušra;"2A klasė";93365393803;Taip;6;1;0;7
15301;Aušra;"2A klasė";70687041413;Taip;0;1;0;1
15302;Aušra;"2A klasė";52864653926;Taip;0;21;0;21
15303;Aušra;"2A klasė";10272136932;Taip;0;1;0;1
15304;Aušra;"2A klasė";77425098448;Taip;0;1;0;1
15305;Aušra;"2A klasė";20550256232;Taip;1;1;0;2
15306;Aušra;"2A klasė";42015974556;Taip;0;1;0;1
15307;Aušra;"2A klasė";2113586354;Taip;2;1;0;3
15308;Aušra;"2A klasė";19718806057;Taip;0;1;0;1
15309;Aušra;"2A klasė";21856009403;Taip;4;1;0;5
15310;Aušra;"2A klasė";5166358753;Taip;0;1;0;1
15311;Aušra;"2A klasė";44870195034;Taip;1;1;0;2
15312;Aušra;"2A klasė";68481706412;Taip;0;21;0;21
15313;Aušra;"3A klasė";2908360090;Ne;0;1;0;1
15314;Aušra;"3A klasė";1585279799;Ne;0;1;0;1
15315;Aušra;"3A klasė";8497743711;Ne;2;1;0;3
15316;Aušra;"3A klasė";7439801986;Ne;0;1;0;1
15317;Aušra;"3A klasė";4952796453;Ne;0;1;0;1
15318;Aušra;"3A klasė";1404310604;Ne;1;1;0;2
15319;Aušra;"3A klasė";5770340819;Ne;0;1;0;1
15320;Aušra;"3A klasė";9510786725;Ne;0;1;0;1
15321;Aušra;"3A klasė";2280410145;Ne;0;21;0;21
15322;Aušra;"3A klasė";29945175192;Taip;0;21;0;21
15323;Aušra;"3A klasė";8367064629;Taip;1;1;0;2
15324;Aušra;"3A klasė";7931858964;Ne;2;1;0;3
15325;Aušra;"3A klasė";5792862565;Ne;0;1;0;1
15326;Aušra;"3A klasė";6942076490;Ne;0;1;0;1
15327;Aušra;"3A klasė";4399210916;Ne;0;1;0;1
15328;Aušra;"3A klasė";8892613555;Ne;0;1;0;1
15329;Aušra;"3A klasė";6534693192;Ne;1;1;0;2
15330;Aušra;"3A klasė";2797588970;Ne;0;1;0;1
15331;Aušra;"3A klasė";5657162092;Ne;0;21;0;21
15332;Aušra;"3A klasė";3435983733;Ne;0;1;0;1
15333;Aušra;"3A klasė";5825720308;Ne;5;1;0;6
15334;Aušra;"3A klasė";7313001921;Ne;4;1;0;5
15335;Aušra;"3A klasė";2796012982;Ne;0;1;0;1
15336;Aušra;"3A klasė";8632721907;Ne;0;1;0;1
15337;Aušra;"3A klasė";7113793626;Ne;0;1;0;1
15338;Aušra;"3A klasė";75839555732;Taip;1;1;0;2
15339;Aušra;"3A klasė";96979357769;Taip;0;21;0;21
15340;Aušra;"3A klasė";9584232864;Ne;3;1;0;4
15341;Aušra;"4A klasė";4190936993;Ne;6;1;0;7
15342;Aušra;"4A klasė";1685764132;Ne;0;21;0;21
15343;Aušra;"4A klasė";5340257141;Ne;0;1;0;1
15344;Aušra;"4A klasė";8328298376;Ne;0;21;0;21
15345;Aušra;"4A klasė";8543429220;Ne;3;1;0;4
15346;Aušra;"4A klasė";4341245904;Ne;0;1;0;1
15347;Aušra;"4A klasė";7499852390;Ne;4;1;0;5
15348;Aušra;"4A klasė";3749854924;Ne;1;1;0;2
15349;Aušra;"4A klasė";2072790876;Ne;5;1;0;6
15350;Aušra;"4A klasė";2863356239;Ne;0;1;0;1
15351;Aušra;"4A klasė";1448718807;Ne;0;21;0;21
15352;Aušra;"4A klasė";8550981774;Ne;4;1;0;5
15353;Aušra;"4A klasė";2951199272;Ne;6;1;0;7
15354;Aušra;"4A klasė";9332506542;Ne;0;1;0;1
15355;Aušra;"4A klasė";3115696927;Ne;0;1;0;1
15356;Aušra;"4A klasė";62035537641;Taip;0;21;0;21
15357;Aušra;"4A klasė";4073898542;Ne;0;21;0;21
15358;Aušra;"4A klasė";1414034080;Ne;0;21;0;21
15359;Aušra;"4A klasė";7435902333;Ne;0;1;0;1
15360;Aušra;"4A klasė";6232778631;Ne;0;1;0;1
15361;Aušra;"4A klasė";54244461148;Ne;0;1;0;1
15362;Aušra;"4A klasė";6540515450;Ne;0;21;0;21
15363;Aušra;"4A klasė";4257487788;Ne;0;1;0;1
15364;Aušra;"4A klasė";2942755846;Ne;0;1;0;1
15365;Aušra;"2B klasė";92119607174;Taip;0;1;0;1
15366;Aušra;"2B klasė";22923377435;Ne;5;1;0;6
15367;Aušra;"2B klasė";41852924528;Taip;0;1;0;1
15368;Aušra;"2B klasė";58526614808;Taip;0;1;0;1
15369;Aušra;"2B klasė";41039525379;Ne;0;1;0;1
15370;Aušra;"2B klasė";37339481276;Taip;0;1;0;1
15371;Aušra;"2B klasė";45165946624;Taip;0;1;0;1
15372;Aušra;"2B klasė";59107169775;Ne;0;1;0;1
15373;Aušra;"2B klasė";48349819906;Ne;0;1;0;1
15374;Aušra;"2B klasė";71596384638;Taip;0;1;0;1
15375;Aušra;"2B klasė";52332096506;Taip;0;1;0;1
15376;Aušra;"2B klasė";35703433862;Taip;0;1;0;1
15377;Aušra;"2B klasė";6201728036;Taip;0;21;0;21
15378;Aušra;"2B klasė";36889923728;Taip;0;1;0;1
15379;Aušra;"2B klasė";39957179831;Taip;0;21;0;21
15380;Aušra;"2B klasė";52909474598;Ne;0;1;0;1
15381;Aušra;"2B klasė";8901585006;Taip;0;1;0;1
15382;Aušra;"2B klasė";64562667133;Taip;0;1;0;1
15383;Aušra;"2B klasė";95076478544;Ne;0;1;0;1
15384;Aušra;"2B klasė";36899257479;Ne;2;1;0;3
15385;Aušra;"2B klasė";57520886724;Taip;0;21;0;21
15386;Aušra;"2B klasė";1815771421;Ne;0;1;0;1
15387;Aušra;"2B klasė";75433637766;Taip;3;1;0;4
15388;Aušra;"2B klasė";83119050626;Taip;0;1;0;1
15389;Aušra;"3B klasė";5687605664;Ne;0;21;0;21
15390;Aušra;"3B klasė";7713995959;Ne;1;1;0;2
15391;Aušra;"3B klasė";2610054474;Ne;1;1;0;2
15392;Aušra;"3B klasė";95798840861;Taip;0;21;0;21
15393;Aušra;"3B klasė";7553225340;Ne;0;1;0;1
15394;Aušra;"3B klasė";9736905104;Ne;0;1;0;1
15395;Aušra;"3B klasė";70054065156;Taip;7;1;0;8
15396;Aušra;"3B klasė";9695887585;Ne;2;1;0;3
15397;Aušra;"3B klasė";3225989797;Ne;0;1;0;1
15398;Aušra;"3B klasė";7405776766;Ne;0;21;0;21
15399;Aušra;"3B klasė";5005513948;Ne;0;1;0;1
15400;Aušra;"3B klasė";7697924792;Ne;0;1;0;1
15401;Aušra;"3B klasė";2412235474;Ne;1;1;0;2
15402;Aušra;"3B klasė";2075587354;Ne;0;1;0;1
15403;Aušra;"3B klasė";65535488153;Taip;1;1;0;2
15404;Aušra;"3B klasė";9600565378;Ne;0;1;0;1
15405;Aušra;"3B klasė";3114317363;Ne;8;1;0;9
15406;Aušra;"3B klasė";7075053685;Ne;0;21;0;21
15407;Aušra;"3B klasė";98154599269;Taip;0;21;0;21
15408;Aušra;"3B klasė";7321317333;Ne;3;1;0;4
15409;Aušra;"3B klasė";2893668707;Ne;0;1;0;1
15410;Aušra;"3B klasė";7886658451;Ne;0;21;0;21
15411;Berželis;PČIOLKI;1612263252;Taip;0;1;0;1
15412;Berželis;PČIOLKI;58375151019;Taip;13;1;0;14
15413;Berželis;PČIOLKI;88322206113;Taip;2;1;0;3
15414;Berželis;PČIOLKI;75750848557;Ne;0;1;4;5
15415;Berželis;PČIOLKI;77431203813;Taip;0;1;0;1
15416;Berželis;PČIOLKI;69799827219;Taip;0;1;2;3
15417;Berželis;PČIOLKI;19460486970;Taip;0;1;3;4
15418;Berželis;PČIOLKI;8942344021;Taip;6;1;1;8
15419;Berželis;PČIOLKI;59374659821;Taip;0;1;0;1
15420;Berželis;PČIOLKI;56482980062;Ne;0;1;0;1
15421;Berželis;PČIOLKI;1740077377;Taip;0;2;0;2
15422;Berželis;PČIOLKI;91676607875;Taip;0;1;2;3
15423;Berželis;PČIOLKI;1729593575;Taip;13;1;0;14
15424;Berželis;PČIOLKI;33843845240;Taip;0;1;0;1
15425;Berželis;PČIOLKI;4605587503;Taip;3;1;0;4
15426;Berželis;PČIOLKI;5747645162;Taip;0;1;4;5
15427;Berželis;PČIOLKI;9901922166;Taip;3;1;0;4
15428;Berželis;PČIOLKI;68853290649;Ne;4;1;2;7
15429;Berželis;PČIOLKI;1929783185;Taip;0;3;0;3
15430;Berželis;PČIOLKI;50400542457;Taip;0;1;1;2
15431;Berželis;PČIOLKI;68192824475;Taip;0;0;1;1
15432;Berželis;"BOŽJI KOROVKI";3162044236;Taip;4;5;0;9
15433;Berželis;"BOŽJI KOROVKI";9132058594;Taip;0;10;0;10
15434;Berželis;"BOŽJI KOROVKI";7421059780;Taip;1;10;0;11
15435;Berželis;"BOŽJI KOROVKI";5739847580;Taip;0;21;0;21
15436;Berželis;"BOŽJI KOROVKI";4100740863;Taip;4;9;0;13
15437;Berželis;"BOŽJI KOROVKI";1750209600;Taip;1;6;0;7
15438;Berželis;"BOŽJI KOROVKI";5953387226;Taip;0;21;0;21
15439;Berželis;"BOŽJI KOROVKI";9466461910;Taip;0;7;0;7
15440;Berželis;"BOŽJI KOROVKI";3070917065;Taip;0;11;0;11
15441;Berželis;"BOŽJI KOROVKI";5408368340;Taip;0;21;0;21
15442;Berželis;"BOŽJI KOROVKI";8118040960;Taip;15;0;0;15
15443;Berželis;"BOŽJI KOROVKI";2005082089;Taip;0;5;0;5
15444;Berželis;"BOŽJI KOROVKI";5692603837;Taip;14;0;0;14
15445;Berželis;"BOŽJI KOROVKI";5194480946;Taip;14;0;0;14
15446;Berželis;"BOŽJI KOROVKI";9848723402;Taip;5;0;0;5
15447;Berželis;"BOŽJI KOROVKI";5551459997;Taip;5;1;0;6
15448;Berželis;"BOŽJI KOROVKI";6651007152;Taip;0;21;0;21
15449;Berželis;SOLNYŠKO;8871199713;Taip;0;21;0;21
15450;Berželis;SOLNYŠKO;2182268389;Taip;8;0;0;8
15451;Berželis;SOLNYŠKO;1498165322;Taip;10;0;0;10
15452;Berželis;SOLNYŠKO;4163605313;Taip;11;0;0;11
15453;Berželis;SOLNYŠKO;2882693941;Taip;0;21;0;21
15454;Berželis;SOLNYŠKO;9438498834;Taip;8;0;0;8
15455;Berželis;SOLNYŠKO;7852089381;Taip;7;1;0;8
15456;Berželis;SOLNYŠKO;6189116357;Taip;18;0;0;18
15457;Berželis;SOLNYŠKO;8737788279;Taip;14;0;0;14
15458;Berželis;SOLNYŠKO;8875116641;Taip;10;11;0;21
15459;Berželis;SOLNYŠKO;8771171576;Taip;6;1;0;7
15460;Berželis;SOLNYŠKO;2901168499;Taip;6;1;0;7
15461;Berželis;SOLNYŠKO;8297975308;Taip;17;0;0;17
15462;Berželis;SOLNYŠKO;2693961315;Taip;9;0;0;9
15463;Berželis;SOLNYŠKO;7411282628;Taip;0;21;0;21
15464;Berželis;SOLNYŠKO;7080168105;Taip;10;2;0;12
15465;Berželis;SOLNYŠKO;1316018865;Taip;10;1;0;11
15466;Berželis;BABOČKI;4923631429;Ne;12;0;0;12
15467;Berželis;BABOČKI;5371508044;Taip;18;0;0;18
15468;Berželis;BABOČKI;1076719080;Taip;5;0;0;5
15469;Berželis;BABOČKI;2016194182;Taip;11;0;1;12
15470;Berželis;BABOČKI;2030770943;Taip;9;3;0;12
15471;Berželis;BABOČKI;9839929976;Taip;11;1;0;12
15472;Berželis;BABOČKI;2667957070;Taip;8;0;2;10
15473;Berželis;BABOČKI;7781031211;Taip;15;0;0;15
15474;Berželis;BABOČKI;2493612905;Taip;11;0;1;12
15475;Berželis;BABOČKI;5688897783;Taip;0;13;0;13
15476;Berželis;BABOČKI;6942559693;Ne;0;1;6;7
15477;Berželis;BABOČKI;9245706377;Taip;0;3;0;3
15478;Berželis;BABOČKI;6352635742;Ne;0;5;0;5
15479;Berželis;BABOČKI;3097809074;Taip;0;0;3;3
15480;Berželis;BABOČKI;3613459846;Taip;3;0;2;5
15481;Berželis;BABOČKI;8448872491;Taip;16;0;0;16
15482;Berželis;BABOČKI;5069322062;Taip;7;0;1;8
15483;Berželis;BABOČKI;2954451168;Taip;11;0;0;11
15484;Berželis;BABOČKI;4312062240;Taip;11;0;0;11
15485;Berželis;BABOČKI;9091691636;Taip;20;0;0;20
15486;Berželis;SOVUŠKI;8939353460;Taip;21;0;0;21
15487;Berželis;SOVUŠKI;5879965735;Taip;10;0;1;11
15488;Berželis;SOVUŠKI;1183377037;Ne;0;1;3;4
15489;Berželis;SOVUŠKI;61614684164;Taip;3;0;1;4
15490;Berželis;SOVUŠKI;1573177287;Taip;5;3;0;8
15491;Berželis;SOVUŠKI;48932211843;Ne;6;0;2;8
15492;Berželis;SOVUŠKI;11671380984;Taip;0;0;4;4
15493;Berželis;SOVUŠKI;1927042277;Taip;0;10;0;10
15494;Berželis;SOVUŠKI;1566912722;Taip;0;1;0;1
15495;Berželis;SOVUŠKI;1865658456;Taip;8;0;4;12
15496;Berželis;SOVUŠKI;1061894314;Taip;8;0;0;8
15497;Berželis;SOVUŠKI;5739686368;Taip;0;1;0;1
15498;Berželis;SOVUŠKI;25985469678;Taip;20;0;0;20
15499;Berželis;SOVUŠKI;2028316867;Ne;6;7;0;13
15500;Berželis;SOVUŠKI;83253240251;Taip;11;0;0;11
15501;Berželis;SOVUŠKI;1470907829;Taip;0;0;3;3
15502;Berželis;SOVUŠKI;9134420285;Ne;4;1;0;5
15503;Berželis;SOVUŠKI;9894036261;Taip;0;0;1;1
15504;Berželis;SOVUŠKI;5337604370;Ne;0;0;3;3
15505;Berželis;SOVUŠKI;1492203156;Taip;21;0;0;21
15506;Berželis;SOVUŠKI;1511044883;Taip;0;5;0;5
15507;Berželis;SOVUŠKI;7713921014;Taip;0;0;9;9
15508;Berželis;PODSOLNUŠKI;4521372127;Taip;0;1;0;1
15509;Berželis;PODSOLNUŠKI;2214171136;Taip;0;1;1;2
15510;Berželis;PODSOLNUŠKI;97218091736;Taip;11;0;4;15
15511;Berželis;PODSOLNUŠKI;1521982237;Taip;3;1;4;8
15512;Berželis;PODSOLNUŠKI;4013215941;Taip;0;1;0;1
15513;Berželis;PODSOLNUŠKI;64214150955;Ne;10;2;0;12
15514;Berželis;PODSOLNUŠKI;9024992452;Taip;0;4;0;4
15515;Berželis;PODSOLNUŠKI;9644196870;Taip;3;0;1;4
15516;Berželis;PODSOLNUŠKI;5084171353;Taip;5;1;1;7
15517;Berželis;PODSOLNUŠKI;1225018351;Taip;0;10;0;10
15518;Berželis;PODSOLNUŠKI;6473498471;Taip;5;0;0;5
15519;Berželis;PODSOLNUŠKI;1067618571;Taip;21;0;0;21
15520;Berželis;PODSOLNUŠKI;3772780161;Taip;15;0;0;15
15521;Berželis;PODSOLNUŠKI;4563582416;Taip;15;0;0;15
15522;Berželis;PODSOLNUŠKI;6113571093;Ne;12;0;1;13
15523;Berželis;PODSOLNUŠKI;1036370516;Taip;9;0;0;9
15524;Berželis;PODSOLNUŠKI;4284157599;Taip;15;1;0;16
15525;Berželis;PODSOLNUŠKI;9894751274;Taip;13;1;0;14
15526;Berželis;PODSOLNUŠKI;3298044639;Taip;0;1;0;1
15527;Berželis;PODSOLNUŠKI;3437712794;Taip;0;5;0;5
15528;Berželis;"1 klasė";7375940325;Taip;0;1;0;1
15529;Berželis;"1 klasė";39511689145;Taip;15;1;0;16
15530;Berželis;"1 klasė";62426432001;Taip;9;1;0;10
15531;Berželis;"1 klasė";29561378525;Taip;12;1;0;13
15532;Berželis;"1 klasė";51807139150;Ne;0;1;0;1
15533;Berželis;"1 klasė";95780247776;Taip;0;1;0;1
15534;Berželis;"1 klasė";83552840429;Taip;0;1;0;1
15535;Berželis;"1 klasė";84379482983;Taip;0;1;0;1
15536;Berželis;"1 klasė";17710158252;Taip;0;1;0;1
15537;Berželis;"1 klasė";86666390300;Taip;3;1;0;4
15538;Berželis;"1 klasė";37637382978;Taip;0;1;0;1
15539;Berželis;"1 klasė";95587380846;Taip;0;1;0;1
15540;Berželis;"1 klasė";48161697699;Taip;0;1;0;1
15541;Berželis;"1 klasė";44215014337;Taip;1;1;0;2
15542;Berželis;"1 klasė";2066819593;Taip;0;1;0;1
15543;Berželis;"2 klasė";3554738276;Taip;14;1;0;15
15544;Berželis;"2 klasė";68739754511;Taip;5;1;0;6
15545;Berželis;"2 klasė";9168601277;Taip;1;1;0;2
15546;Berželis;"2 klasė";93543942806;Taip;10;1;0;11
15547;Berželis;"2 klasė";5442568208;Taip;0;1;0;1
15548;Berželis;"2 klasė";84043380820;Taip;0;1;0;1
15549;Berželis;"2 klasė";945754955;Taip;0;1;0;1
15550;Berželis;"2 klasė";3658542055;Ne;0;21;0;21
15551;Berželis;"2 klasė";12564193771;Taip;4;1;0;5
15552;Berželis;"2 klasė";2412399682;Taip;5;1;0;6
15553;Berželis;"2 klasė";40956353978;Taip;0;1;0;1
15554;Berželis;"2 klasė";34721593327;Taip;0;1;0;1
15555;Berželis;"3 klasė";66532479024;Ne;5;1;0;6
15556;Berželis;"3 klasė";4381565277;Ne;0;1;0;1
15557;Berželis;"3 klasė";47358747103;Taip;0;1;0;1
15558;Berželis;"3 klasė";4263364972;Taip;13;1;0;14
15559;Berželis;"3 klasė";4750570367;Ne;0;21;0;21
15560;Berželis;"3 klasė";67358830655;Taip;2;1;0;3
15561;Berželis;"3 klasė";12252622276;Taip;3;1;0;4
15562;Berželis;"3 klasė";68547063004;Taip;9;1;0;10
15563;Berželis;"3 klasė";12819628369;Taip;4;1;0;5
15564;Berželis;"3 klasė";13521812215;Taip;0;21;0;21
15565;Berželis;"3 klasė";32336500026;Taip;0;1;0;1
15566;Berželis;"3 klasė";17898339325;Taip;10;1;0;11
15567;Berželis;"3 klasė";9395016208;Taip;1;1;0;2
15568;Berželis;"3 klasė";55709962549;Taip;0;1;0;1
15569;Berželis;"3 klasė";62300805754;Taip;0;1;0;1
15570;Berželis;"3 klasė";1162529591;Taip;0;1;0;1
15571;Berželis;"4 klasė";2691853015;Ne;0;1;0;1
15572;Berželis;"4 klasė";5856177876;Ne;0;1;0;1
15573;Berželis;"4 klasė";8143634742;Ne;0;1;0;1
15574;Berželis;"4 klasė";5616257764;Taip;0;1;0;1
15575;Berželis;"4 klasė";9486991928;Ne;0;1;0;1
15576;Berželis;"4 klasė";62987603892;Taip;0;1;0;1
15577;Berželis;"4 klasė";9998560354;Ne;12;1;0;13
15578;Berželis;"4 klasė";6702857359;Ne;0;1;0;1
15579;Berželis;"4 klasė";2955045450;Ne;0;1;0;1
15580;Berželis;"4 klasė";3149377224;Ne;0;1;0;1
15581;Berželis;"4 klasė";50930845005;Taip;0;1;0;1
15582;Berželis;"4 klasė";1161378829;Ne;0;1;0;1
15583;Berželis;"4 klasė";8322372921;Ne;0;1;0;1
15584;Berželis;"4 klasė";2501433917;Ne;2;1;0;3
15585;Berželis;"4 klasė";7728620622;Ne;0;1;0;1
15586;Berželis;"4 klasė";8921842915;Ne;2;1;0;3
15587;Berželis;"4 klasė";3064700283;Ne;4;1;0;5
15588;Saulutė;Drugeliai;66108847230;Taip;6;2;3;11
15589;Saulutė;Drugeliai;1556270046;Taip;0;5;0;5
15590;Saulutė;Drugeliai;3064199909;Taip;0;0;3;3
15591;Saulutė;Drugeliai;2097055107;Taip;0;11;0;11
15592;Saulutė;Drugeliai;1717909005;Taip;5;2;0;7
15593;Saulutė;Drugeliai;8599199376;Taip;14;1;2;17
15594;Saulutė;Drugeliai;1750571258;Taip;7;0;1;8
15595;Saulutė;Drugeliai;87814849917;Taip;6;2;2;10
15596;Saulutė;Drugeliai;1609952589;Taip;0;1;1;2
15597;Saulutė;Drugeliai;1386800520;Taip;0;2;2;4
15598;Saulutė;Drugeliai;1261384337;Taip;6;10;0;16
15599;Saulutė;Drugeliai;1320018338;Ne;6;1;7;14
15600;Saulutė;Drugeliai;1291318940;Taip;21;0;0;21
15601;Saulutė;Drugeliai;2162114750;Ne;0;0;20;20
15602;Saulutė;Drugeliai;9550046358;Taip;0;1;2;3
15603;Saulutė;Drugeliai;1391904744;Taip;0;1;8;9
15604;Saulutė;Drugeliai;8944601874;Taip;0;12;0;12
15605;Saulutė;Drugeliai;4272320685;Taip;0;12;0;12
15606;Saulutė;Drugeliai;1020606591;Taip;0;1;0;1
15607;Saulutė;Drugeliai;7539721995;Taip;0;3;0;3
15608;Saulutė;"Saulės zuikučiai";8946107286;Taip;1;2;0;3
15609;Saulutė;"Saulės zuikučiai";2397257894;Taip;0;0;2;2
15610;Saulutė;"Saulės zuikučiai";2010774109;Taip;4;14;0;18
15611;Saulutė;"Saulės zuikučiai";3089541630;Taip;0;1;0;1
15612;Saulutė;"Saulės zuikučiai";5148542811;Taip;18;0;0;18
15613;Saulutė;"Saulės zuikučiai";2259917151;Taip;0;3;1;4
15614;Saulutė;"Saulės zuikučiai";3691381351;Taip;0;2;0;2
15615;Saulutė;"Saulės zuikučiai";3749374270;Taip;0;10;1;11
15616;Saulutė;"Saulės zuikučiai";8242602551;Taip;15;0;0;15
15617;Saulutė;"Saulės zuikučiai";1324799653;Taip;19;0;0;19
15618;Saulutė;"Saulės zuikučiai";5247769309;Taip;0;0;1;1
15619;Saulutė;"Saulės zuikučiai";2816806902;Taip;0;3;0;3
15620;Saulutė;"Saulės zuikučiai";7844396402;Taip;0;9;1;10
15621;Saulutė;"Saulės zuikučiai";2781003892;Taip;1;0;0;1
15622;Saulutė;"Saulės zuikučiai";9892855816;Taip;0;10;0;10
15623;Saulutė;"Saulės zuikučiai";5326279083;Taip;7;0;0;7
15624;Saulutė;"Saulės zuikučiai";3675783868;Taip;0;8;0;8
15625;Saulutė;"Saulės zuikučiai";5839981073;Ne;0;6;0;6
15626;Saulutė;"Saulės zuikučiai";7888435573;Taip;0;0;1;1
15627;Saulutė;Boružėlės;3272296969;Taip;2;8;0;10
15628;Saulutė;Boružėlės;6044672321;Ne;5;0;5;10
15629;Saulutė;Boružėlės;3295289082;Taip;2;7;0;9
15630;Saulutė;Boružėlės;1587328722;Taip;10;1;0;11
15631;Saulutė;Boružėlės;8390767549;Taip;0;10;1;11
15632;Saulutė;Boružėlės;7576532632;Taip;0;0;17;17
15633;Saulutė;Boružėlės;2725491887;Taip;11;0;1;12
15634;Saulutė;Boružėlės;9314889468;Taip;14;1;2;17
15635;Saulutė;Boružėlės;7764493159;Ne;9;0;2;11
15636;Saulutė;Boružėlės;5565832676;Ne;0;0;5;5
15637;Saulutė;Boružėlės;9173336078;Taip;0;1;0;1
15638;Saulutė;Boružėlės;3408369823;Taip;0;0;11;11
15639;Saulutė;Boružėlės;5329894543;Taip;9;0;1;10
15640;Saulutė;Boružėlės;6803541200;Taip;21;0;0;21
15641;Saulutė;Boružėlės;4818911910;Ne;15;0;3;18
15642;Saulutė;Boružėlės;7081700501;Taip;5;0;0;5
15643;Saulutė;Boružėlės;9098663596;Taip;9;0;0;9
15644;Saulutė;Boružėlės;1803710557;Taip;6;0;0;6
15645;Saulutė;Boružėlės;7425789805;Taip;0;0;5;5
15646;Saulutė;Boružėlės;7474989619;Ne;0;0;3;3
15647;Saulutė;Boružėlės;8619163154;Ne;0;0;5;5
15648;Saulutė;Nykštukai;6099238784;Taip;0;4;0;4
15649;Saulutė;Nykštukai;7318452189;Taip;5;11;0;16
15650;Saulutė;Nykštukai;1855999738;Ne;0;3;0;3
15651;Saulutė;Nykštukai;78558743548;Taip;3;6;0;9
15652;Saulutė;Nykštukai;91371507376;Ne;0;2;0;2
15653;Saulutė;Nykštukai;55160240384;Taip;0;11;0;11
15654;Saulutė;Nykštukai;19852146326;Taip;0;2;0;2
15655;Saulutė;Nykštukai;1861612651;Taip;1;0;0;1
15656;Saulutė;Nykštukai;1745560688;Taip;0;1;0;1
15657;Saulutė;Nykštukai;63481737955;Taip;0;0;1;1
15658;Saulutė;Nykštukai;12674831673;Taip;0;1;0;1
15659;Saulutė;Nykštukai;32539394191;Taip;2;5;0;7
15660;Saulutė;Nykštukai;1913500127;Taip;0;2;0;2
15661;Saulutė;Nykštukai;23640604487;Taip;0;0;1;1
15662;Saulutė;Nykštukai;54373231773;Taip;0;5;0;5
15663;Saulutė;Nykštukai;88168936754;Taip;0;5;0;5
15664;Saulutė;Nykštukai;98979263108;Taip;0;7;0;7
15665;Saulutė;Nykštukai;1217446865;Taip;0;7;2;9
15666;Saulutė;Nykštukai;1077526046;Ne;0;1;1;2
15667;Saulutė;Meškiukai;1776164273;Taip;0;0;8;8
15668;Saulutė;Meškiukai;5264813819;Taip;1;0;2;3
15669;Saulutė;Meškiukai;5850783789;Taip;14;0;1;15
15670;Saulutė;Meškiukai;7243072252;Taip;0;4;0;4
15671;Saulutė;Meškiukai;5607937410;Taip;5;0;1;6
15672;Saulutė;Meškiukai;4800144085;Taip;3;0;1;4
15673;Saulutė;Meškiukai;3571751974;Taip;18;0;1;19
15674;Saulutė;Meškiukai;5928628498;Taip;8;0;1;9
15675;Saulutė;Meškiukai;2527027536;Taip;9;2;2;13
15676;Saulutė;Meškiukai;7620841597;Taip;17;0;0;17
15677;Saulutė;Meškiukai;7640441297;Taip;0;0;2;2
15678;Saulutė;Meškiukai;6046611248;Taip;0;7;0;7
15679;Saulutė;Meškiukai;4301516165;Taip;1;0;5;6
15680;Saulutė;Meškiukai;3221612665;Taip;2;0;2;4
15681;Saulutė;Meškiukai;9903380188;Taip;13;0;0;13
15682;Saulutė;Ežiukai;1686338325;Taip;0;0;1;1
15683;Saulutė;Ežiukai;1888990522;Taip;0;1;0;1
15684;Saulutė;Ežiukai;2140277182;Taip;4;0;1;5
15685;Saulutė;Ežiukai;1546200973;Ne;17;0;0;17
15686;Saulutė;Ežiukai;1917058710;Taip;0;0;4;4
15687;Saulutė;Ežiukai;2813274509;Taip;11;0;4;15
15688;Saulutė;Ežiukai;4510990261;Taip;0;0;4;4
15689;Saulutė;Ežiukai;8433646525;Taip;0;2;0;2
15690;Saulutė;Ežiukai;3410606033;Taip;5;4;0;9
15691;Saulutė;Ežiukai;6057668143;Taip;11;0;2;13
15692;Saulutė;Ežiukai;7413098580;Taip;3;0;3;6
15693;Saulutė;Ežiukai;9269501176;Taip;9;0;0;9
15694;Saulutė;Ežiukai;2059342403;Ne;5;0;0;5
15695;Saulutė;Ežiukai;8257363228;Taip;16;0;0;16
15696;Saulutė;Ežiukai;2074473832;Taip;0;0;1;1
15697;Saulutė;Ežiukai;8040751073;Taip;0;10;1;11
15698;Saulutė;Ežiukai;7297886198;Taip;0;0;3;3
15699;Saulutė;Bitutės;8984040932;Taip;5;2;0;7
15700;Saulutė;Bitutės;2373409300;Taip;21;0;0;21
15701;Saulutė;Bitutės;2545930114;Ne;10;0;0;10
15702;Saulutė;Bitutės;1056158093;Taip;12;0;0;12
15703;Saulutė;Bitutės;8512137633;Taip;10;0;1;11
15704;Saulutė;Bitutės;4123500930;Ne;0;2;0;2
15705;Saulutė;Bitutės;1745754752;Taip;8;0;0;8
15706;Saulutė;Bitutės;9497439410;Taip;7;5;0;12
15707;Saulutė;Bitutės;8405262902;Taip;7;0;1;8
15708;Saulutė;Bitutės;4363210987;Taip;0;4;2;6
15709;Saulutė;Bitutės;6842585310;Taip;6;0;3;9
15710;Saulutė;Bitutės;2601822200;Taip;13;0;1;14
15711;Saulutė;Bitutės;4211866191;Taip;10;0;0;10
15712;Saulutė;Bitutės;8371366346;Taip;11;10;0;21
15713;Saulutė;Bitutės;7139492238;Taip;0;0;3;3
15714;Saulutė;Bitutės;1323161584;Taip;2;1;0;3
15715;Saulutė;Bitutės;5165268747;Taip;11;0;0;11
15716;Saulutė;Bitutės;6608003946;Taip;0;8;0;8
15717;Saulutė;Bitutės;3244850673;Taip;0;15;0;15
15718;Saulutė;Bitutės;2450554594;Taip;0;9;0;9
15719;Saulutė;Pelėdžiukai;3445723020;Ne;0;7;1;8
15720;Saulutė;Pelėdžiukai;1534183935;Taip;0;2;0;2
15721;Saulutė;Pelėdžiukai;27386434894;Taip;0;3;2;5
15722;Saulutė;Pelėdžiukai;65492344097;Taip;0;10;0;10
15723;Saulutė;Pelėdžiukai;77923802656;Taip;3;3;0;6
15724;Saulutė;Pelėdžiukai;79919438191;Taip;0;4;0;4
15725;Saulutė;Pelėdžiukai;31705050946;Taip;2;6;2;10
15726;Saulutė;Pelėdžiukai;45306237230;Taip;0;10;1;11
15727;Saulutė;Pelėdžiukai;14195215027;Taip;0;10;0;10
15728;Saulutė;Pelėdžiukai;50944263059;Taip;0;1;2;3
15729;Saulutė;Pelėdžiukai;1510434265;Taip;0;0;1;1
15730;Saulutė;Pelėdžiukai;5574049005;Taip;0;8;3;11
15731;Saulutė;Pelėdžiukai;4312318284;Taip;11;10;0;21
15732;Saulutė;Pelėdžiukai;27752316336;Taip;1;8;0;9
15733;Saulutė;Pelėdžiukai;77170708225;Taip;1;0;0;1
15734;Saulutė;Pelėdžiukai;5745065672;Taip;7;0;0;7
15735;Saulutė;Pelėdžiukai;9612975694;Taip;0;10;4;14
15736;Saulutė;Pelėdžiukai;4287223197;Taip;0;4;0;4
15737;Saulutė;Pelėdžiukai;5511093996;Taip;0;10;5;15
15738;Saulutė;Pelėdžiukai;7471061365;Ne;0;10;0;10
15739;Saulutė;Zylutės;1277263391;Taip;0;6;4;10
15740;Saulutė;Zylutės;46280382280;Ne;0;6;1;7
15741;Saulutė;Zylutės;37315117916;Taip;5;1;0;6
15742;Saulutė;Zylutės;75405796772;Taip;0;10;0;10
15743;Saulutė;Zylutės;35570367633;Taip;5;2;3;10
15744;Saulutė;Zylutės;2098990667;Taip;1;0;0;1
15745;Saulutė;Zylutės;1786491396;Taip;0;9;0;9
15746;Saulutė;Zylutės;10893091651;Taip;3;8;0;11
15747;Saulutė;Zylutės;85182498024;Taip;0;2;0;2
15748;Saulutė;Zylutės;16622528829;Taip;4;14;0;18
15749;Saulutė;Zylutės;1911318708;Taip;5;0;1;6
15750;Saulutė;Zylutės;9565528566;Taip;0;19;2;21
15751;Saulutė;Zylutės;1332002470;Taip;0;11;0;11
15752;Saulutė;Zylutės;9081236999;Ne;0;5;2;7
15753;Saulutė;Zylutės;67332285574;Taip;3;0;3;6
15754;Saulutė;Zylutės;1513449225;Taip;5;6;2;13
15755;Saulutė;Zylutės;28772515317;Ne;0;2;1;3
15756;Saulutė;Zylutės;7564649742;Taip;1;10;4;15
15757;Saulutė;Zylutės;97145959022;Taip;11;10;0;21
15758;Saulutė;Zylutės;8372468555;Taip;11;10;0;21
15759;Saulutė;"1 klasė";3183309722;Ne;1;10;0;11
15760;Saulutė;"1 klasė";1475031090;Taip;3;10;0;13
15761;Saulutė;"1 klasė";3246485288;Taip;1;10;0;11
15762;Saulutė;"1 klasė";78967475616;Ne;1;10;0;11
15763;Saulutė;"1 klasė";3450668814;Taip;7;10;0;17
15764;Saulutė;"1 klasė";57283533169;Taip;0;10;0;10
15765;Saulutė;"1 klasė";21703177024;Taip;6;10;0;16
15766;Saulutė;"1 klasė";13147367113;Taip;0;10;0;10
15767;Saulutė;"1 klasė";6557918941;Taip;0;10;0;10
15768;Saulutė;"1 klasė";1005459768;Taip;1;10;0;11
15769;Saulutė;"1 klasė";1804521229;Taip;1;10;0;11
15770;Saulutė;"1 klasė";44452051978;Ne;2;10;0;12
15771;Saulutė;"1 klasė";89710141573;Taip;0;10;0;10
15772;Saulutė;"1 klasė";25124975646;Taip;0;10;0;10
15773;Saulutė;"1 klasė";8168961080;Ne;0;10;0;10
15774;Saulutė;"1 klasė";76744652185;Taip;2;10;0;12
15775;Saulutė;"1 klasė";97296161595;Taip;0;10;0;10
15776;Saulutė;"1 klasė";87409240076;Taip;0;10;0;10
15777;Saulutė;"1 klasė";1205642335;Taip;1;10;0;11
15778;Saulutė;"1 klasė";36414547943;Taip;0;10;0;10
15779;Saulutė;"1 klasė";1337654926;Taip;1;10;0;11
15780;Saulutė;"1 klasė";54950572289;Taip;3;10;0;13
15781;Saulutė;"1 klasė";1644704074;Taip;4;10;0;14
15782;Saulutė;"1 klasė";2426509692;Taip;5;10;0;15
15783;Saulutė;"1 klasė";96497471950;Taip;3;10;0;13
15784;Saulutė;"1 klasė";76108591835;Taip;1;10;0;11
15785;Saulutė;"1 klasė";5741276602;Taip;0;10;0;10
15786;Saulutė;"1 klasė";99841176399;Taip;0;10;0;10
15787;Saulutė;"1 klasė";2216383015;Taip;2;10;0;12
15788;Saulutė;"1 klasė";3156830821;Taip;0;10;0;10
15789;Saulutė;"2 klasė";58163470119;Taip;1;10;0;11
15790;Saulutė;"2 klasė";5822529731;Taip;3;10;0;13
15791;Saulutė;"2 klasė";67739063665;Taip;11;10;0;21
15792;Saulutė;"2 klasė";13916981850;Taip;1;10;0;11
15793;Saulutė;"2 klasė";1418237274;Taip;11;10;0;21
15794;Saulutė;"2 klasė";39606108938;Ne;0;10;0;10
15795;Saulutė;"2 klasė";81191097069;Taip;0;10;0;10
15796;Saulutė;"2 klasė";92198716772;Taip;4;10;0;14
15797;Saulutė;"2 klasė";16523279366;Taip;7;10;0;17
15798;Saulutė;"2 klasė";2095347468;Taip;0;10;0;10
15799;Saulutė;"2 klasė";37839378248;Taip;0;10;0;10
15800;Saulutė;"2 klasė";5997216605;Taip;11;10;0;21
15801;Saulutė;"2 klasė";8308288099;Ne;1;10;0;11
15802;Saulutė;"2 klasė";30863736694;Taip;0;10;0;10
15803;Saulutė;"2 klasė";18122758338;Taip;0;10;0;10
15804;Saulutė;"2 klasė";12964000357;Taip;2;10;0;12
15805;Saulutė;"2 klasė";54726632101;Taip;6;10;0;16
15806;Saulutė;"2 klasė";25720655179;Ne;5;10;0;15
15807;Saulutė;"2 klasė";6469772450;Taip;11;10;0;21
15808;Saulutė;"2 klasė";4302511346;Ne;11;10;0;21
15809;Saulutė;"2 klasė";8632066475;Ne;11;10;0;21
15810;Saulutė;"2 klasė";45877127245;Taip;0;10;0;10
15811;Saulutė;"2 klasė";82106514982;Taip;0;10;0;10
15812;Saulutė;"2 klasė";61113930769;Taip;1;10;0;11
15813;Saulutė;"2 klasė";8962761979;Taip;11;10;0;21
15814;Saulutė;"2 klasė";7785909571;Ne;1;10;0;11
15815;Saulutė;"2 klasė";90078805222;Taip;4;10;0;14
15816;Saulutė;"2 klasė";50110262859;Ne;10;10;0;20
15817;Saulutė;"2 klasė";42204884890;Ne;1;10;0;11
15818;Saulutė;"3 klasė";8531372660;Taip;0;10;0;10
15819;Saulutė;"3 klasė";3614749034;Taip;2;10;0;12
15820;Saulutė;"3 klasė";1153099638;Taip;0;10;0;10
15821;Saulutė;"3 klasė";5786453424;Taip;0;10;0;10
15822;Saulutė;"3 klasė";4342595483;Taip;1;10;0;11
15823;Saulutė;"3 klasė";1081812391;Taip;1;10;0;11
15824;Saulutė;"3 klasė";1436690766;Taip;0;10;0;10
15825;Saulutė;"3 klasė";4252242862;Taip;0;10;0;10
15826;Saulutė;"3 klasė";2517511237;Taip;4;10;0;14
15827;Saulutė;"3 klasė";8953313952;Ne;0;10;0;10
15828;Saulutė;"3 klasė";2957436888;Taip;2;10;0;12
15829;Saulutė;"3 klasė";7696948081;Taip;1;10;0;11
15830;Saulutė;"3 klasė";8192525690;Taip;0;10;0;10
15831;Saulutė;"3 klasė";3937034221;Ne;1;10;0;11
15832;Saulutė;"3 klasė";1312993030;Taip;1;10;0;11
15833;Saulutė;"3 klasė";3450860412;Ne;4;10;0;14
15834;Saulutė;"3 klasė";7543978588;Taip;2;10;0;12
15835;Saulutė;"3 klasė";6924270821;Ne;0;10;0;10
15836;Saulutė;"3 klasė";1701868565;Taip;0;10;0;10
15837;Saulutė;"3 klasė";3755300838;Taip;0;10;0;10
15838;Saulutė;"3 klasė";1117229507;Taip;11;10;0;21
15839;Saulutė;"3 klasė";6025668467;Ne;0;10;0;10
15840;Saulutė;"4 klasė";9113434597;Ne;0;10;0;10
15841;Saulutė;"4 klasė";9833653313;Ne;11;10;0;21
15842;Saulutė;"4 klasė";1659579883;Ne;1;10;0;11
15843;Saulutė;"4 klasė";9155511473;Ne;1;10;0;11
15844;Saulutė;"4 klasė";6957680310;Ne;2;10;0;12
15845;Saulutė;"4 klasė";7700196440;Ne;0;10;0;10
15846;Saulutė;"4 klasė";8601544457;Taip;1;10;0;11
15847;Saulutė;"4 klasė";8506064421;Ne;0;10;0;10
15848;Saulutė;"4 klasė";3302267009;Ne;1;10;0;11
15849;Saulutė;"4 klasė";7343265118;Ne;11;10;0;21
15850;Saulutė;"4 klasė";5193599921;Ne;0;10;0;10
15851;Saulutė;"4 klasė";2638495931;Ne;11;10;0;21
15852;Saulutė;"4 klasė";4189732482;Ne;11;10;0;21
15853;Saulutė;"4 klasė";2374587130;Ne;0;10;0;10
15854;Saulutė;"4 klasė";6797161399;Ne;1;10;0;11
15855;Saulutė;"4 klasė";6128992723;Ne;1;10;0;11
15856;Saulutė;"4 klasė";9621988308;Ne;11;10;0;21
15857;Saulutė;"4 klasė";1787634725;Ne;1;10;0;11
15858;Saulutė;"4 klasė";1604607524;Ne;11;10;0;21
15859;Saulutė;"4 klasė";9885756874;Ne;3;10;0;13
15860;Saulutė;"4 klasė";3495588866;Taip;1;10;0;11
15861;Svaja;"STEBUKLINGAS ŽIBINTAS";83624935456;Taip;0;1;2;3
15862;Svaja;"STEBUKLINGAS ŽIBINTAS";9847061480;Taip;0;1;4;5
15863;Svaja;"STEBUKLINGAS ŽIBINTAS";1660742385;Taip;0;1;0;1
15864;Svaja;"STEBUKLINGAS ŽIBINTAS";9628146488;Taip;5;1;0;6
15865;Svaja;"STEBUKLINGAS ŽIBINTAS";69028070656;Taip;6;0;1;7
15866;Svaja;"STEBUKLINGAS ŽIBINTAS";1017471747;Taip;0;1;0;1
15867;Svaja;"STEBUKLINGAS ŽIBINTAS";1304775332;Taip;5;1;2;8
15868;Svaja;"STEBUKLINGAS ŽIBINTAS";26902749194;Taip;6;1;0;7
15869;Svaja;"STEBUKLINGAS ŽIBINTAS";1903424547;Taip;0;1;0;1
15870;Svaja;"STEBUKLINGAS ŽIBINTAS";30360097999;Taip;4;1;2;7
15871;Svaja;"STEBUKLINGAS ŽIBINTAS";19887874988;Taip;0;1;5;6
15872;Svaja;"STEBUKLINGAS ŽIBINTAS";1967394949;Taip;1;1;1;3
15873;Svaja;"STEBUKLINGAS ŽIBINTAS";7719185632;Taip;13;0;3;16
15874;Svaja;"STEBUKLINGAS ŽIBINTAS";1297727288;Ne;6;0;0;6
15875;Svaja;"STEBUKLINGAS ŽIBINTAS";30027404222;Ne;0;0;1;1
15876;Svaja;"STEBUKLINGAS ŽIBINTAS";57216954289;Taip;0;0;2;2
15877;Svaja;"STEBUKLINGAS ŽIBINTAS";1352488176;Taip;5;0;2;7
15878;Svaja;"STEBUKLINGAS ŽIBINTAS";44989143252;Taip;0;0;6;6
15879;Svaja;"STEBUKLINGAS ŽIBINTAS";1943166503;Ne;12;0;0;12
15880;Svaja;"STEBUKLINGAS ŽIBINTAS";6056157113;Taip;0;3;3;6
15881;Svaja;"STEBUKLINGAS ŽIBINTAS";97298858365;Taip;0;0;2;2
15882;Svaja;"STEBUKLINGAS ŽIBINTAS";3077814152;Taip;12;0;1;13
15883;Svaja;"STEBUKLINGAS ŽIBINTAS";3499148291;Taip;0;10;0;10
15884;Svaja;"STEBUKLINGAS ŽIBINTAS";99005386537;Taip;12;1;0;13
15885;Svaja;SAULUTĖ;50207734108;Taip;5;1;0;6
15886;Svaja;SAULUTĖ;20473739993;Taip;0;2;0;2
15887;Svaja;SAULUTĖ;30719991872;Taip;13;0;0;13
15888;Svaja;SAULUTĖ;6665752307;Taip;10;1;1;12
15889;Svaja;SAULUTĖ;80459437057;Ne;10;0;1;11
15890;Svaja;SAULUTĖ;4968201186;Taip;8;2;0;10
15891;Svaja;SAULUTĖ;8689706130;Taip;0;3;0;3
15892;Svaja;SAULUTĖ;6807834176;Ne;0;0;1;1
15893;Svaja;SAULUTĖ;7020342969;Taip;4;1;0;5
15894;Svaja;SAULUTĖ;3633996231;Taip;14;0;2;16
15895;Svaja;SAULUTĖ;2750615517;Taip;6;4;0;10
15896;Svaja;SAULUTĖ;1045300185;Taip;0;0;1;1
15897;Svaja;SAULUTĖ;4341042027;Taip;5;1;0;6
15898;Svaja;SAULUTĖ;3802996573;Taip;15;0;0;15
15899;Svaja;SAULUTĖ;7936765752;Taip;0;1;1;2
15900;Svaja;SAULUTĖ;4293339784;Taip;21;0;0;21
15901;Svaja;SAULUTĖ;9475971731;Taip;2;0;1;3
15902;Svaja;SAULUTĖ;5479482244;Ne;2;0;4;6
15903;Svaja;SAULUTĖ;7473493846;Taip;9;5;0;14
15904;Svaja;SAULUTĖ;5443682744;Ne;6;5;0;11
15905;Svaja;SAULUTĖ;9112198914;Taip;0;1;3;4
15906;Svaja;SAULUTĖ;2166382346;Taip;0;0;1;1
15907;Svaja;"AUKSINĖ ŽUVELĖ";43307670660;Taip;0;3;0;3
15908;Svaja;"AUKSINĖ ŽUVELĖ";25194696146;Taip;10;1;0;11
15909;Svaja;"AUKSINĖ ŽUVELĖ";55925058866;Taip;0;0;1;1
15910;Svaja;"AUKSINĖ ŽUVELĖ";1704075006;Ne;0;0;1;1
15911;Svaja;"AUKSINĖ ŽUVELĖ";70641067006;Taip;9;0;1;10
15912;Svaja;"AUKSINĖ ŽUVELĖ";8279605005;Taip;5;6;0;11
15913;Svaja;"AUKSINĖ ŽUVELĖ";1437557657;Taip;21;0;0;21
15914;Svaja;"AUKSINĖ ŽUVELĖ";87432529423;Taip;5;1;0;6
15915;Svaja;"AUKSINĖ ŽUVELĖ";36505115395;Taip;10;1;0;11
15916;Svaja;"AUKSINĖ ŽUVELĖ";58102699652;Ne;10;0;0;10
15917;Svaja;"AUKSINĖ ŽUVELĖ";6593047776;Taip;5;0;0;5
15918;Svaja;"AUKSINĖ ŽUVELĖ";5335776957;Ne;0;8;2;10
15919;Svaja;"AUKSINĖ ŽUVELĖ";7911488445;Ne;0;3;0;3
15920;Svaja;"AUKSINĖ ŽUVELĖ";1295012978;Taip;12;0;0;12
15921;Svaja;"AUKSINĖ ŽUVELĖ";64196174690;Taip;5;0;0;5
15922;Svaja;"AUKSINĖ ŽUVELĖ";22702341083;Taip;13;0;1;14
15923;Svaja;"AUKSINĖ ŽUVELĖ";2076060840;Taip;4;2;0;6
15924;Svaja;"AUKSINĖ ŽUVELĖ";27445299450;Taip;6;0;4;10
15925;Svaja;"AUKSINĖ ŽUVELĖ";1576498450;Taip;0;0;1;1
15926;Svaja;"AUKSINĖ ŽUVELĖ";5198153485;Taip;0;1;0;1
15927;Svaja;"PRIE ĮLANKOS";5522433229;Taip;8;0;3;11
15928;Svaja;"PRIE ĮLANKOS";40856210635;Taip;0;1;6;7
15929;Svaja;"PRIE ĮLANKOS";67462299886;Taip;10;1;0;11
15930;Svaja;"PRIE ĮLANKOS";21608020858;Ne;0;0;3;3
15931;Svaja;"PRIE ĮLANKOS";1655551042;Taip;0;0;2;2
15932;Svaja;"PRIE ĮLANKOS";18733824395;Taip;0;1;1;2
15933;Svaja;"PRIE ĮLANKOS";26500981786;Taip;4;0;3;7
15934;Svaja;"PRIE ĮLANKOS";89042677798;Taip;12;0;0;12
15935;Svaja;"PRIE ĮLANKOS";1601648171;Taip;3;0;0;3
15936;Svaja;"PRIE ĮLANKOS";1509272327;Taip;0;0;3;3
15937;Svaja;"PRIE ĮLANKOS";4804779327;Taip;0;0;4;4
15938;Svaja;"PRIE ĮLANKOS";40814723278;Ne;0;0;4;4
15939;Svaja;"PRIE ĮLANKOS";23112873505;Taip;11;0;1;12
15940;Svaja;"PRIE ĮLANKOS";1400892707;Taip;0;0;1;1
15941;Svaja;"PRIE ĮLANKOS";3022690832;Taip;8;0;0;8
15942;Svaja;"PRIE ĮLANKOS";69413101571;Taip;0;0;1;1
15943;Svaja;"PRIE ĮLANKOS";3035781587;Taip;5;0;0;5
15944;Svaja;"PRIE ĮLANKOS";4881476441;Taip;0;5;1;6
15945;Svaja;"1 B klasė";6905550313;Taip;0;4;0;4
15946;Svaja;"1 B klasė";1367687415;Taip;0;6;0;6
15947;Svaja;"1 B klasė";1847775266;Taip;0;5;0;5
15948;Svaja;"1 B klasė";44418402260;Taip;0;1;0;1
15949;Svaja;"1 B klasė";54328462992;Taip;0;1;0;1
15950;Svaja;"1 B klasė";92044111261;Ne;0;1;0;1
15951;Svaja;"1 B klasė";6020060540;Taip;0;1;0;1
15952;Svaja;"1 B klasė";71708072632;Taip;0;5;0;5
15953;Svaja;"1 B klasė";56506642672;Taip;0;3;0;3
15954;Svaja;"1 B klasė";34141773112;Ne;0;2;0;2
15955;Svaja;"1 B klasė";4416877973;Taip;0;1;0;1
15956;Svaja;"1 B klasė";73391331150;Ne;0;1;0;1
15957;Svaja;"1 B klasė";70507326327;Taip;0;1;0;1
15958;Svaja;"1 B klasė";1470843400;Taip;0;1;0;1
15959;Svaja;"1 B klasė";8011137572;Taip;0;1;0;1
15960;Svaja;"1 B klasė";70506691027;Taip;0;1;0;1
15961;Svaja;"1 B klasė";62971657427;Ne;0;1;0;1
15962;Svaja;"1 B klasė";17947580061;Taip;0;1;0;1
15963;Svaja;"1 B klasė";50649509868;Taip;0;1;0;1
15964;Svaja;"1 B klasė";80772711351;Taip;0;6;0;6
15965;Svaja;"1 B klasė";11937575740;Taip;0;1;0;1
15966;Svaja;"1 B klasė";3526873547;Ne;0;1;0;1
15967;Svaja;"1 B klasė";6969692916;Taip;0;6;0;6
15968;Svaja;"1 A klasė";3474439050;Ne;0;5;0;5
15969;Svaja;"1 A klasė";8828911320;Ne;0;1;0;1
15970;Svaja;"1 A klasė";75104768118;Taip;0;21;0;21
15971;Svaja;"1 A klasė";18238622848;Taip;0;4;0;4
15972;Svaja;"1 A klasė";4617061890;Taip;0;1;0;1
15973;Svaja;"1 A klasė";3604946305;Taip;0;1;0;1
15974;Svaja;"1 A klasė";1649920341;Taip;0;6;0;6
15975;Svaja;"1 A klasė";64487515384;Taip;0;1;0;1
15976;Svaja;"1 A klasė";63346231562;Taip;0;2;0;2
15977;Svaja;"1 A klasė";6057524892;Taip;0;1;0;1
15978;Svaja;"1 A klasė";1181877436;Taip;0;1;0;1
15979;Svaja;"1 A klasė";25578518444;Taip;0;5;0;5
15980;Svaja;"1 A klasė";7348182434;Taip;0;2;0;2
15981;Svaja;"1 A klasė";89695643588;Taip;0;1;0;1
15982;Svaja;"1 A klasė";15252353189;Taip;0;1;0;1
15983;Svaja;"1 A klasė";72752022712;Taip;0;7;0;7
15984;Svaja;"1 A klasė";36386223863;Taip;0;3;0;3
15985;Svaja;"1 A klasė";30754812113;Taip;0;1;0;1
15986;Svaja;"1 A klasė";75296600945;Ne;0;1;0;1
15987;Svaja;"1 A klasė";2321739150;Ne;0;3;0;3
15988;Svaja;"1 A klasė";1168637823;Taip;0;8;0;8
15989;Svaja;"1 A klasė";4906784415;Taip;0;2;0;2
15990;Svaja;"1 A klasė";6810463192;Taip;0;1;0;1
15991;Svaja;"1 C klasė";25934507261;Taip;0;1;0;1
15992;Svaja;"1 C klasė";89047123808;Taip;0;2;0;2
15993;Svaja;"1 C klasė";50510924690;Taip;0;1;0;1
15994;Svaja;"1 C klasė";41183537732;Taip;0;7;0;7
15995;Svaja;"1 C klasė";57216299421;Ne;0;21;0;21
15996;Svaja;"1 C klasė";1795682827;Taip;0;1;0;1
15997;Svaja;"1 C klasė";93651139102;Taip;0;1;0;1
15998;Svaja;"1 C klasė";54462393937;Taip;0;1;0;1
15999;Svaja;"1 C klasė";74904581010;Taip;0;3;0;3
16000;Svaja;"1 C klasė";2165716699;Taip;0;1;0;1
16001;Svaja;"1 C klasė";36001411632;Taip;0;1;0;1
16002;Svaja;"1 C klasė";94449039022;Taip;0;2;0;2
16003;Svaja;"1 C klasė";85150525696;Ne;0;9;0;9
16004;Svaja;"1 C klasė";1848422504;Taip;0;1;0;1
16005;Svaja;"1 C klasė";3743948734;Taip;0;1;0;1
16006;Svaja;"1 C klasė";70714898590;Taip;0;3;0;3
16007;Svaja;"1 C klasė";54852358913;Taip;0;1;0;1
16008;Svaja;"1 C klasė";57253216255;Taip;0;11;0;11
16009;Svaja;"1 C klasė";34995551069;Taip;0;2;0;2
16010;Svaja;"1 C klasė";1742951527;Taip;0;4;0;4
16011;Svaja;"1 C klasė";91855230473;Taip;0;8;0;8
16012;Svaja;"1 C klasė";1855559693;Taip;0;3;0;3
16013;Svaja;"1 C klasė";31216445971;Ne;0;1;0;1
16014;Svaja;"1 C klasė";20342193231;Taip;0;1;0;1
16015;Svaja;"1 C klasė";91088224294;Taip;0;21;0;21
16016;Svaja;"2 A klasė";8876971658;Taip;0;6;0;6
16017;Svaja;"2 A klasė";96680395594;Taip;0;4;0;4
16018;Svaja;"2 A klasė";31604152893;Ne;0;3;0;3
16019;Svaja;"2 A klasė";56095979514;Taip;0;1;0;1
16020;Svaja;"2 A klasė";70513111186;Ne;0;3;0;3
16021;Svaja;"2 A klasė";72655912805;Taip;0;3;0;3
16022;Svaja;"2 A klasė";20363553383;Taip;0;3;0;3
16023;Svaja;"2 A klasė";69928474471;Taip;0;3;0;3
16024;Svaja;"2 A klasė";49184638535;Taip;0;21;0;21
16025;Svaja;"2 A klasė";58497063533;Taip;0;5;0;5
16026;Svaja;"2 A klasė";89075087937;Taip;0;21;0;21
16027;Svaja;"2 A klasė";99157757025;Ne;0;3;0;3
16028;Svaja;"2 A klasė";16955510836;Taip;0;6;0;6
16029;Svaja;"2 A klasė";24812635291;Taip;0;3;0;3
16030;Svaja;"2 A klasė";21534170175;Taip;0;4;0;4
16031;Svaja;"2 A klasė";28311552445;Taip;0;9;0;9
16032;Svaja;"2 A klasė";38781141060;Taip;0;3;0;3
16033;Svaja;"2 A klasė";88447528808;Taip;0;4;0;4
16034;Svaja;"2 A klasė";66507774550;Taip;0;4;0;4
16035;Svaja;"2 A klasė";48859926231;Taip;0;15;0;15
16036;Svaja;"2 A klasė";76101749947;Taip;0;21;0;21
16037;Svaja;"2 A klasė";3775578708;Ne;0;3;0;3
16038;Svaja;"2 B klasė";61996055386;Taip;0;3;0;3
16039;Svaja;"2 B klasė";57983452414;Taip;0;21;0;21
16040;Svaja;"2 B klasė";30200636424;Ne;0;4;0;4
16041;Svaja;"2 B klasė";8802243719;Taip;0;4;0;4
16042;Svaja;"2 B klasė";7747921362;Ne;0;3;0;3
16043;Svaja;"2 B klasė";38464012322;Taip;0;3;0;3
16044;Svaja;"2 B klasė";5712106350;Taip;0;8;0;8
16045;Svaja;"2 B klasė";9401605132;Taip;0;21;0;21
16046;Svaja;"2 B klasė";27313057222;Taip;0;21;0;21
16047;Svaja;"2 B klasė";68894832324;Taip;0;3;0;3
16048;Svaja;"2 B klasė";29972474690;Taip;0;6;0;6
16049;Svaja;"2 B klasė";47441661801;Ne;0;3;0;3
16050;Svaja;"2 B klasė";62579722313;Taip;0;3;0;3
16051;Svaja;"2 B klasė";21035820496;Taip;0;3;0;3
16052;Svaja;"2 B klasė";71840791098;Taip;0;11;0;11
16053;Svaja;"2 B klasė";59707838958;Taip;0;3;0;3
16054;Svaja;"2 B klasė";71086654007;Taip;0;7;0;7
16055;Svaja;"2 B klasė";15871540340;Taip;0;3;0;3
16056;Svaja;"2 B klasė";97651620085;Taip;0;21;0;21
16057;Svaja;"2 B klasė";77796846388;Taip;0;21;0;21
16058;Svaja;"3 A klasė";6331528628;Taip;0;1;0;1
16059;Svaja;"3 A klasė";3545160978;Taip;0;7;0;7
16060;Svaja;"3 A klasė";3812365439;Taip;0;1;0;1
16061;Svaja;"3 A klasė";4732976577;Taip;0;1;0;1
16062;Svaja;"3 A klasė";4819506647;Taip;0;1;0;1
16063;Svaja;"3 A klasė";7374204735;Taip;0;1;0;1
16064;Svaja;"3 A klasė";4147975771;Taip;0;3;0;3
16065;Svaja;"3 A klasė";5355661673;Taip;0;10;0;10
16066;Svaja;"3 A klasė";8907191675;Taip;0;11;0;11
16067;Svaja;"3 A klasė";6301200166;Ne;0;1;0;1
16068;Svaja;"3 A klasė";7406969545;Ne;0;2;0;2
16069;Svaja;"3 A klasė";6182584108;Taip;0;6;0;6
16070;Svaja;"3 A klasė";6561055995;Taip;0;1;0;1
16071;Svaja;"3 A klasė";7745440861;Taip;0;1;0;1
16072;Svaja;"3 A klasė";3100769948;Ne;0;1;0;1
16073;Svaja;"3 A klasė";1932041952;Taip;0;1;0;1
16074;Svaja;"3 A klasė";2963665708;Taip;0;1;0;1
16075;Svaja;"3 A klasė";6166818062;Taip;0;1;0;1
16076;Svaja;"3 A klasė";5400447747;Taip;0;5;0;5
16077;Svaja;"3 A klasė";4677183471;Taip;0;2;0;2
16078;Svaja;"3 A klasė";3876795349;Taip;0;1;0;1
16079;Svaja;"3 A klasė";4570702330;Taip;0;3;0;3
16080;Svaja;"3 A klasė";4559408388;Taip;0;2;0;2
16081;Svaja;"3 A klasė";1851430613;Taip;0;3;0;3
16082;Svaja;"3 B klasė";6685023540;Taip;0;1;0;1
16083;Svaja;"3 B klasė";3917545035;Taip;0;21;0;21
16084;Svaja;"3 B klasė";3154268090;Taip;0;2;0;2
16085;Svaja;"3 B klasė";7137011094;Taip;0;1;0;1
16086;Svaja;"3 B klasė";8497722175;Taip;0;2;0;2
16087;Svaja;"3 B klasė";1949789571;Taip;0;3;0;3
16088;Svaja;"3 B klasė";986820082;Taip;0;1;0;1
16089;Svaja;"3 B klasė";5316972581;Taip;0;21;0;21
16090;Svaja;"3 B klasė";5304302886;Taip;0;1;0;1
16091;Svaja;"3 B klasė";9390649669;Ne;0;21;0;21
16092;Svaja;"3 B klasė";2543801351;Taip;0;1;0;1
16093;Svaja;"3 B klasė";2768998567;Taip;0;2;0;2
16094;Svaja;"3 B klasė";5417233257;Taip;0;1;0;1
16095;Svaja;"3 B klasė";8934053695;Ne;0;21;0;21
16096;Svaja;"3 B klasė";6888324693;Ne;0;1;0;1
16097;Svaja;"3 B klasė";9741563523;Taip;0;21;0;21
16098;Svaja;"3 B klasė";9474581791;Taip;0;1;0;1
16099;Svaja;"3 B klasė";7185891478;Ne;0;21;0;21
16100;Svaja;"3 B klasė";6949932613;Taip;0;1;0;1
16101;Svaja;"3 B klasė";9227257148;Taip;0;1;0;1
16102;Svaja;"3 B klasė";7403841330;Taip;0;4;0;4
16103;Svaja;"3 B klasė";6387070757;Taip;0;21;0;21
16104;Svaja;"3 B klasė";4859522896;Taip;0;1;0;1
16105;Svaja;"3 B klasė";7165840275;Taip;0;1;0;1
16106;Svaja;"3 B klasė";4858401763;Taip;0;4;0;4
16107;Svaja;SAULĖGRĄŽA;1579441289;Taip;0;0;1;1
16108;Svaja;SAULĖGRĄŽA;9811110367;Taip;0;0;1;1
16109;Svaja;SAULĖGRĄŽA;7023534254;Taip;0;0;12;12
16110;Svaja;SAULĖGRĄŽA;3792660330;Taip;11;0;0;11
16111;Svaja;SAULĖGRĄŽA;9240037050;Taip;18;0;0;18
16112;Svaja;SAULĖGRĄŽA;7575922215;Taip;0;2;0;2
16113;Svaja;SAULĖGRĄŽA;4510147045;Taip;5;3;0;8
16114;Svaja;SAULĖGRĄŽA;9680766688;Taip;0;1;6;7
16115;Svaja;SAULĖGRĄŽA;3912426942;Taip;0;1;0;1
16116;Svaja;SAULĖGRĄŽA;3809817617;Taip;10;0;0;10
16117;Svaja;SAULĖGRĄŽA;3501620040;Taip;0;4;0;4
16118;Svaja;SAULĖGRĄŽA;4333001830;Taip;19;0;0;19
16119;Svaja;SAULĖGRĄŽA;6928763381;Taip;3;3;0;6
16120;Svaja;SAULĖGRĄŽA;7408966637;Taip;0;4;0;4
16121;Svaja;SAULĖGRĄŽA;2209697834;Taip;0;9;0;9
16122;Svaja;SAULĖGRĄŽA;3563842321;Taip;0;0;1;1
16123;Svaja;SAULĖGRĄŽA;7089640807;Taip;10;0;0;10
16124;Svaja;SAULĖGRĄŽA;3461282516;Taip;11;0;0;11
16125;Svaja;SAULĖGRĄŽA;4253831334;Taip;9;0;3;12
16126;Svaja;SAULĖGRĄŽA;9311520300;Taip;3;0;0;3
16127;Svaja;SAULĖGRĄŽA;6963684639;Taip;10;0;0;10
16128;Svaja;"4 A klasė";6890796785;Taip;0;2;0;2
16129;Svaja;"4 A klasė";3060720122;Taip;0;1;0;1
16130;Svaja;"4 A klasė";4191652201;Taip;0;1;0;1
16131;Svaja;"4 A klasė";2408787820;Ne;0;2;0;2
16132;Svaja;"4 A klasė";2143707618;Taip;0;1;0;1
16133;Svaja;"4 A klasė";9922327181;Taip;0;2;0;2
16134;Svaja;"4 A klasė";7360643147;Taip;0;1;0;1
16135;Svaja;"4 A klasė";9431617139;Taip;0;21;0;21
16136;Svaja;"4 A klasė";5072924063;Taip;0;3;0;3
16137;Svaja;"4 A klasė";1224863574;Ne;0;3;0;3
16138;Svaja;"4 A klasė";5866029763;Ne;0;21;0;21
16139;Svaja;"4 A klasė";5224191012;Taip;0;7;0;7
16140;Svaja;"4 A klasė";2396489897;Taip;0;1;0;1
16141;Svaja;"4 A klasė";3362976996;Taip;0;3;0;3
16142;Svaja;"4 A klasė";6924433006;Taip;0;2;0;2
16143;Svaja;"4 A klasė";6379522088;Taip;0;1;0;1
16144;Svaja;"4 A klasė";6859893256;Taip;0;21;0;21
16145;Svaja;"4 A klasė";7222472406;Taip;0;5;0;5
16146;Svaja;"4 A klasė";8566329547;Ne;0;21;0;21
16147;Svaja;"4 A klasė";8014577929;Taip;0;1;0;1
16148;Svaja;"4 A klasė";5916292577;Taip;0;21;0;21
16149;Svaja;"4 B klasė";5552969529;Taip;0;3;0;3
16150;Svaja;"4 B klasė";4730576902;Taip;0;2;0;2
16151;Svaja;"4 B klasė";1717017574;Taip;0;21;0;21
16152;Svaja;"4 B klasė";6738703814;Taip;0;1;0;1
16153;Svaja;"4 B klasė";9134285226;Taip;0;2;0;2
16154;Svaja;"4 B klasė";5936330139;Taip;0;1;0;1
16155;Svaja;"4 B klasė";2601042375;Taip;0;1;0;1
16156;Svaja;"4 B klasė";5872552939;Taip;0;21;0;21
16157;Svaja;"4 B klasė";9268837216;Taip;0;21;0;21
16158;Svaja;"4 B klasė";3914701993;Taip;0;10;0;10
16159;Svaja;"4 B klasė";6125002433;Taip;0;21;0;21
16160;Svaja;"4 B klasė";7318107259;Taip;0;21;0;21
16161;Svaja;"4 B klasė";3710090923;Taip;0;10;0;10
16162;Svaja;"4 B klasė";4798681160;Taip;0;17;0;17
16163;Svaja;"4 B klasė";8694436642;Taip;0;1;0;1
16164;Svaja;"4 B klasė";9634453365;Taip;0;2;0;2
16165;Svaja;"4 B klasė";5247586745;Taip;0;21;0;21
16166;Svaja;"4 B klasė";3794316760;Taip;0;6;0;6
16167;Svaja;"4 B klasė";2827984254;Taip;0;2;0;2
16168;Svaja;"4 B klasė";2414969796;Taip;0;1;0;1
16169;Svaja;"4 B klasė";6780795284;Taip;0;6;0;6
16170;Svaja;"4 B klasė";7211076381;Taip;0;1;0;1
16171;Svaja;"4 B klasė";7731424463;Taip;0;21;0;21
16172;Svaja;"4 B klasė";6933648513;Taip;0;1;0;1
16173;Svaja;"2 C klasė";77712240909;Taip;0;3;0;3
16174;Svaja;"2 C klasė";79260508923;Taip;0;3;0;3
16175;Svaja;"2 C klasė";94437606762;Taip;0;21;0;21
16176;Svaja;"2 C klasė";73440582394;Taip;0;3;0;3
16177;Svaja;"2 C klasė";60982723867;Taip;0;21;0;21
16178;Svaja;"2 C klasė";70157518595;Taip;0;3;0;3
16179;Svaja;"2 C klasė";50116820543;Taip;0;3;0;3
16180;Svaja;"2 C klasė";5975083034;Ne;0;21;0;21
16181;Svaja;"2 C klasė";5288858941;Ne;0;3;0;3
16182;Svaja;"2 C klasė";76871144487;Taip;0;21;0;21
16183;Svaja;"2 C klasė";6613028133;Taip;0;4;0;4
16184;Svaja;"2 C klasė";48888360976;Taip;0;3;0;3
16185;Svaja;"2 C klasė";12226488343;Taip;0;3;0;3
16186;Svaja;"2 C klasė";3909240894;Ne;0;4;0;4
16187;Svaja;"2 C klasė";53352329988;Taip;0;7;0;7
16188;Svaja;"2 C klasė";59917024948;Taip;0;3;0;3
16189;Svaja;"2 C klasė";73691352138;Taip;0;8;0;8
16190;Svaja;"2 C klasė";66967032561;Taip;0;7;0;7
16191;Svaja;"2 C klasė";82358174131;Taip;0;3;0;3
16192;Svaja;"2 C klasė";2018073862;Taip;0;3;0;3
16193;Svaja;"2 C klasė";25585032766;Taip;0;21;0;21
16194;Svaja;"2 C klasė";79572045341;Ne;0;21;0;21
16195;Svaja;"3 C klasė";4022762780;Taip;0;21;0;21
16196;Svaja;"3 C klasė";4196053724;Taip;0;1;0;1
16197;Svaja;"3 C klasė";6750156163;Taip;0;1;0;1
16198;Svaja;"3 C klasė";5749575112;Taip;0;21;0;21
16199;Svaja;"3 C klasė";8150945946;Taip;0;21;0;21
16200;Svaja;"3 C klasė";1915009909;Taip;0;1;0;1
16201;Svaja;"3 C klasė";4310597965;Taip;0;11;0;11
16202;Svaja;"3 C klasė";8274918664;Taip;0;3;0;3
16203;Svaja;"3 C klasė";4333896021;Taip;0;1;0;1
16204;Svaja;"3 C klasė";5467666579;Taip;0;4;0;4
16205;Svaja;"3 C klasė";5453168902;Ne;0;4;0;4
16206;Svaja;"3 C klasė";1750972673;Taip;0;1;0;1
16207;Svaja;"3 C klasė";5633989310;Taip;0;3;0;3
16208;Svaja;"3 C klasė";4807854408;Taip;0;21;0;21
16209;Svaja;"3 C klasė";9653780566;Taip;0;1;0;1
16210;Svaja;"3 C klasė";8556383911;Ne;0;1;0;1
16211;Svaja;"3 C klasė";5736016717;Taip;0;1;0;1
16212;Svaja;"3 C klasė";6956015602;Ne;0;21;0;21
16213;Svaja;"3 C klasė";6155277279;Ne;0;21;0;21
16214;Svaja;"3 C klasė";3466700144;Ne;0;1;0;1
16215;Svaja;"3 C klasė";9961965117;Taip;0;21;0;21
16216;Svaja;"3 C klasė";4809644609;Taip;0;1;0;1
16217;Svaja;"3 C klasė";1910435736;Taip;0;4;0;4
16218;Svaja;"3 C klasė";5205253544;Taip;0;3;0;3
16219;Svaja;"3 C klasė";6958729265;Ne;0;1;0;1
16220;Šilelis;PAUKŠTELIAI;1048576329;Taip;0;1;1;2
16221;Šilelis;PAUKŠTELIAI;15636728118;Taip;5;0;0;5
16222;Šilelis;PAUKŠTELIAI;79937811039;Taip;0;2;0;2
16223;Šilelis;PAUKŠTELIAI;2478018487;Taip;7;0;0;7
16224;Šilelis;PAUKŠTELIAI;43394471973;Taip;7;6;0;13
16225;Šilelis;PAUKŠTELIAI;78892676375;Ne;3;7;0;10
16226;Šilelis;PAUKŠTELIAI;2033871385;Taip;9;1;0;10
16227;Šilelis;PAUKŠTELIAI;5025537628;Taip;3;1;0;4
16228;Šilelis;PAUKŠTELIAI;1150836049;Ne;0;1;2;3
16229;Šilelis;PAUKŠTELIAI;33018110830;Taip;0;1;2;3
16230;Šilelis;PAUKŠTELIAI;8337759186;Taip;0;0;1;1
16231;Šilelis;PAUKŠTELIAI;79806281817;Taip;0;0;1;1
16232;Šilelis;PAUKŠTELIAI;1483339314;Taip;0;5;0;5
16233;Šilelis;PAUKŠTELIAI;19141613082;Taip;0;2;0;2
16234;Šilelis;SKRUZDELIUKAI;7502057552;Ne;9;0;0;9
16235;Šilelis;SKRUZDELIUKAI;6510813364;Taip;15;0;0;15
16236;Šilelis;SKRUZDELIUKAI;6099940488;Taip;16;0;0;16
16237;Šilelis;SKRUZDELIUKAI;6139976105;Taip;0;5;0;5
16238;Šilelis;SKRUZDELIUKAI;3940123543;Ne;10;0;1;11
16239;Šilelis;SKRUZDELIUKAI;3823958567;Taip;14;0;0;14
16240;Šilelis;SKRUZDELIUKAI;2289616655;Taip;16;0;0;16
16241;Šilelis;SKRUZDELIUKAI;1887013803;Taip;0;5;0;5
16242;Šilelis;SKRUZDELIUKAI;6359318134;Taip;0;0;1;1
16243;Šilelis;SKRUZDELIUKAI;5598152793;Taip;10;3;0;13
16244;Šilelis;SKRUZDELIUKAI;8090773379;Taip;7;0;0;7
16245;Šilelis;SKRUZDELIUKAI;1200024379;Taip;0;0;1;1
16246;Šilelis;SKRUZDELIUKAI;7299084520;Taip;10;0;0;10
16247;Šilelis;SKRUZDELIUKAI;4196893379;Taip;18;1;0;19
16248;Šilelis;SKRUZDELIUKAI;3373275644;Taip;5;0;2;7
16249;Šilelis;SKRUZDELIUKAI;8166061969;Taip;7;0;0;7
16250;Šilelis;SKRUZDELIUKAI;8578620603;Taip;6;0;2;8
16251;Šilelis;SMERFY;1246899777;Taip;6;0;0;6
16252;Šilelis;SMERFY;8980788109;Taip;0;1;0;1
16253;Šilelis;SMERFY;30180586342;Taip;0;1;1;2
16254;Šilelis;SMERFY;7936978436;Taip;0;8;0;8
16255;Šilelis;SMERFY;8100789958;Taip;6;0;0;6
16256;Šilelis;SMERFY;6572969153;Taip;5;3;0;8
16257;Šilelis;SMERFY;3015424614;Taip;8;0;0;8
16258;Šilelis;SMERFY;3247333567;Taip;0;5;0;5
16259;Šilelis;SMERFY;6999088222;Ne;15;0;1;16
16260;Šilelis;SMERFY;9886134621;Ne;11;0;0;11
16261;Šilelis;SMERFY;5036549574;Taip;13;0;1;14
16262;Šilelis;SMERFY;74190923349;Taip;20;0;0;20
16263;Šilelis;SMERFY;5665331529;Taip;5;2;0;7
16264;Šilelis;SMERFY;6773906184;Ne;11;0;0;11
16265;Šilelis;SMERFY;3089270468;Taip;9;6;0;15
16266;Šilelis;SMERFY;7824279279;Ne;15;1;0;16
16267;Šilelis;SMERFY;4504627601;Taip;10;0;4;14
16268;Šilelis;SMERFY;7534468539;Taip;5;7;0;12
16269;Šilelis;EŽIUKAI;9266061396;Ne;0;0;1;1
16270;Šilelis;EŽIUKAI;7074963804;Taip;0;5;0;5
16271;Šilelis;EŽIUKAI;1165219272;Taip;5;3;0;8
16272;Šilelis;EŽIUKAI;3234612149;Taip;16;0;0;16
16273;Šilelis;EŽIUKAI;4702068672;Taip;10;1;0;11
16274;Šilelis;EŽIUKAI;1724976098;Taip;10;6;0;16
16275;Šilelis;EŽIUKAI;1586414960;Taip;8;0;0;8
16276;Šilelis;EŽIUKAI;2397366916;Taip;13;0;0;13
16277;Šilelis;EŽIUKAI;2151250706;Taip;16;0;0;16
16278;Šilelis;EŽIUKAI;2295849333;Taip;0;4;0;4
16279;Šilelis;EŽIUKAI;5131051261;Taip;7;0;0;7
16280;Šilelis;EŽIUKAI;8339335908;Taip;10;0;0;10
16281;Šilelis;EŽIUKAI;4678970810;Taip;10;0;0;10
16282;Šilelis;EŽIUKAI;1883483049;Taip;5;0;0;5
16283;Šilelis;EŽIUKAI;6854997486;Taip;8;0;0;8
16284;Šilelis;EŽIUKAI;6386996498;Taip;2;0;17;19
16285;Šilelis;EŽIUKAI;5210301367;Taip;13;0;0;13
16286;Šilelis;EŽIUKAI;4285845345;Taip;6;0;0;6
16287;Šilelis;EŽIUKAI;9354491312;Taip;17;0;0;17
16288;Šilelis;NYKŠTUKAI;85457589779;Taip;0;1;0;1
16289;Šilelis;NYKŠTUKAI;53418739087;Taip;0;1;5;6
16290;Šilelis;NYKŠTUKAI;47822247496;Ne;0;1;4;5
16291;Šilelis;NYKŠTUKAI;51144587636;Taip;0;0;6;6
16292;Šilelis;NYKŠTUKAI;54390109952;Taip;2;2;0;4
16293;Šilelis;NYKŠTUKAI;27632618220;Taip;3;1;0;4
16294;Šilelis;NYKŠTUKAI;70854637761;Taip;0;1;2;3
16295;Šilelis;NYKŠTUKAI;46963038100;Taip;0;1;0;1
16296;Šilelis;NYKŠTUKAI;36489228256;Ne;0;1;0;1
16297;Šilelis;NYKŠTUKAI;88867863035;Taip;0;1;0;1
16298;Šilelis;NYKŠTUKAI;1062766090;Taip;5;1;0;6
16299;Šilelis;NYKŠTUKAI;1740251009;Taip;0;1;1;2
16300;Šilelis;NYKŠTUKAI;1525689616;Taip;0;8;0;8
16301;Šilelis;NYKŠTUKAI;90624206653;Taip;7;3;0;10
16302;Šilelis;NYKŠTUKAI;4263665228;Taip;0;1;0;1
16303;Šilelis;ANČIUKAI;6560491835;Taip;0;0;4;4
16304;Šilelis;ANČIUKAI;8969858170;Taip;0;1;1;2
16305;Šilelis;ANČIUKAI;2078673522;Taip;0;1;0;1
16306;Šilelis;ANČIUKAI;58760882565;Ne;0;1;0;1
16307;Šilelis;ANČIUKAI;56024407115;Taip;4;1;0;5
16308;Šilelis;ANČIUKAI;5489571459;Taip;15;0;0;15
16309;Šilelis;ANČIUKAI;34382940842;Taip;11;0;1;12
16310;Šilelis;ANČIUKAI;942416614;Ne;7;0;0;7
16311;Šilelis;ANČIUKAI;37050806780;Taip;0;1;0;1
16312;Šilelis;ANČIUKAI;1490838609;Taip;0;1;1;2
16313;Šilelis;ANČIUKAI;1621768113;Taip;0;4;0;4
16314;Šilelis;ANČIUKAI;3892886609;Taip;0;1;0;1
16315;Šilelis;ANČIUKAI;1257686463;Taip;17;0;0;17
16316;Šilelis;ANČIUKAI;1633933962;Ne;11;0;3;14
16317;Šilelis;ANČIUKAI;8127562502;Taip;0;7;0;7
16318;Šilelis;ANČIUKAI;7201199871;Taip;0;0;1;1
16319;Šilelis;ANČIUKAI;1766981537;Taip;21;0;0;21
16320;Šilelis;ANČIUKAI;4187993554;Taip;0;1;0;1
16321;Šilelis;KAČIUKAI;9899047136;Taip;14;0;0;14
16322;Šilelis;KAČIUKAI;3216168797;Taip;21;0;0;21
16323;Šilelis;KAČIUKAI;9848760151;Ne;13;0;0;13
16324;Šilelis;KAČIUKAI;4743459915;Ne;17;0;0;17
16325;Šilelis;KAČIUKAI;2420308954;Taip;3;0;0;3
16326;Šilelis;KAČIUKAI;8387022157;Taip;18;0;0;18
16327;Šilelis;KAČIUKAI;3393466953;Taip;0;0;3;3
16328;Šilelis;KAČIUKAI;2111979474;Ne;20;0;0;20
16329;Šilelis;KAČIUKAI;8064905796;Taip;5;0;7;12
16330;Šilelis;KAČIUKAI;5176259940;Taip;5;0;1;6
16331;Šilelis;KAČIUKAI;5589764935;Taip;15;0;3;18
16332;Šilelis;KAČIUKAI;7123048946;Taip;11;0;1;12
16333;Šilelis;KAČIUKAI;6479728064;Taip;1;0;2;3
16334;Šilelis;KAČIUKAI;1821827154;Taip;9;0;0;9
16335;Šilelis;KAČIUKAI;1142044361;Taip;0;0;1;1
16336;Šilelis;KIŠKUČIAI;62991250307;Ne;0;5;0;5
16337;Šilelis;KIŠKUČIAI;1392455608;Taip;0;0;1;1
16338;Šilelis;KIŠKUČIAI;65917456866;Ne;3;0;0;3
16339;Šilelis;KIŠKUČIAI;193181908;Taip;0;0;1;1
16340;Šilelis;KIŠKUČIAI;21871530266;Taip;0;1;1;2
16341;Šilelis;KIŠKUČIAI;1747920772;Taip;0;1;2;3
16342;Šilelis;KIŠKUČIAI;1904442630;Taip;0;0;2;2
16343;Šilelis;KIŠKUČIAI;1640789816;Taip;0;6;0;6
16344;Šilelis;KIŠKUČIAI;6061033736;Taip;0;4;0;4
16345;Šilelis;KIŠKUČIAI;1976745574;Taip;0;0;1;1
16346;Šilelis;KIŠKUČIAI;29368876227;Taip;5;0;0;5
16347;Šilelis;KIŠKUČIAI;20920553773;Taip;3;0;0;3
16348;Šilelis;KIŠKUČIAI;5478094866;Taip;14;0;1;15
16349;Šilelis;KIŠKUČIAI;6096639483;Taip;6;4;0;10
16350;Šilelis;KIŠKUČIAI;4332682721;Ne;3;6;1;10
16351;Šilelis;KIŠKUČIAI;2256130191;Taip;0;0;4;4
16352;Šilelis;KIŠKUČIAI;1610171462;Taip;0;0;4;4
16353;Šilelis;KIŠKUČIAI;8491275729;Taip;3;1;0;4
16354;Šilelis;KREGŽDUTĖS;1344825612;Taip;7;0;0;7
16355;Šilelis;KREGŽDUTĖS;3655800765;Taip;0;1;0;1
16356;Šilelis;KREGŽDUTĖS;50209412455;Taip;0;3;0;3
16357;Šilelis;KREGŽDUTĖS;1719681061;Taip;5;5;0;10
16358;Šilelis;KREGŽDUTĖS;2049105004;Taip;0;1;0;1
16359;Šilelis;KREGŽDUTĖS;35712878822;Taip;0;1;3;4
16360;Šilelis;KREGŽDUTĖS;36811772392;Taip;6;1;0;7
16361;Šilelis;KREGŽDUTĖS;1958785859;Taip;0;2;0;2
16362;Šilelis;KREGŽDUTĖS;89194687299;Taip;6;4;0;10
16363;Šilelis;KREGŽDUTĖS;1571063782;Taip;5;1;1;7
16364;Šilelis;KREGŽDUTĖS;1930906118;Taip;12;1;0;13
16365;Šilelis;KREGŽDUTĖS;82928837930;Taip;5;3;0;8
16366;Šilelis;KREGŽDUTĖS;5186367833;Taip;0;1;0;1
16367;Šilelis;KREGŽDUTĖS;1984731000;Ne;0;8;0;8
16368;Šilelis;KREGŽDUTĖS;1528581005;Taip;3;1;0;4
16369;Šilelis;KREGŽDUTĖS;40753518660;Taip;5;0;0;5
16370;Šilelis;KREGŽDUTĖS;75274553746;Taip;5;1;9;15
16371;Šilelis;KREGŽDUTĖS;7542121945;Taip;2;5;0;7
16372;Šilelis;KREGŽDUTĖS;20994727549;Taip;3;0;3;6
16373;Šilelis;KREGŽDUTĖS;8915228012;Taip;0;13;0;13
16374;Šilelis;KREGŽDUTĖS;8012626513;Taip;11;1;0;12
16375;Šilelis;PAGRANDUKAI;43259107285;Taip;0;2;0;2
16376;Šilelis;PAGRANDUKAI;4814863979;Ne;12;0;1;13
16377;Šilelis;PAGRANDUKAI;9670243727;Taip;0;2;0;2
16378;Šilelis;PAGRANDUKAI;8357287467;Taip;0;1;0;1
16379;Šilelis;PAGRANDUKAI;20525573092;Taip;0;6;0;6
16380;Šilelis;PAGRANDUKAI;2897196188;Ne;0;0;1;1
16381;Šilelis;PAGRANDUKAI;1288690113;Taip;0;6;0;6
16382;Šilelis;PAGRANDUKAI;3583955729;Ne;2;4;0;6
16383;Šilelis;PAGRANDUKAI;8199573104;Taip;18;0;0;18
16384;Šilelis;PAGRANDUKAI;9113098594;Taip;11;0;2;13
16385;Šilelis;PAGRANDUKAI;56885383122;Taip;3;0;1;4
16386;Šilelis;PAGRANDUKAI;8265212749;Taip;10;1;0;11
16387;Šilelis;PAGRANDUKAI;9081488972;Taip;6;0;0;6
16388;Šilelis;PAGRANDUKAI;55396452032;Taip;13;0;0;13
16389;Šilelis;PAGRANDUKAI;7623203279;Taip;21;0;0;21
16390;Šilelis;PAGRANDUKAI;2397630691;Taip;11;2;0;13
16391;Šilelis;PAGRANDUKAI;4340856490;Taip;5;0;0;5
16392;Šilelis;PAGRANDUKAI;3807787648;Taip;6;1;0;7
16393;Šilelis;PAGRANDUKAI;2354942164;Taip;0;6;0;6
16394;Šilelis;PAGRANDUKAI;8687864179;Taip;12;0;1;13
16395;Šilelis;PAGRANDUKAI;6276408187;Taip;13;0;0;13
16396;Šilelis;BITUTĖS;2948291866;Taip;0;7;0;7
16397;Šilelis;BITUTĖS;4682742121;Taip;6;0;0;6
16398;Šilelis;BITUTĖS;5835209357;Taip;0;1;0;1
16399;Šilelis;BITUTĖS;7512731255;Taip;0;6;0;6
16400;Šilelis;BITUTĖS;4781652156;Taip;15;1;0;16
16401;Šilelis;BITUTĖS;6104538160;Taip;5;0;0;5
16402;Šilelis;BITUTĖS;8271830626;Ne;10;1;2;13
16403;Šilelis;BITUTĖS;7814807923;Taip;16;3;0;19
16404;Šilelis;BITUTĖS;5305660046;Taip;0;0;2;2
16405;Šilelis;BITUTĖS;9071963194;Taip;11;0;4;15
16406;Šilelis;BITUTĖS;1306672095;Taip;8;0;1;9
16407;Šilelis;BITUTĖS;6297546907;Taip;12;1;2;15
16408;Šilelis;BITUTĖS;5843337891;Taip;4;1;0;5
16409;Šilelis;BITUTĖS;1960952604;Taip;4;0;0;4
16410;Šilelis;BITUTĖS;3954379433;Taip;0;2;0;2
16411;Šilelis;BITUTĖS;7350013139;Taip;6;2;0;8
16412;Šilelis;BITUTĖS;3879234745;Taip;4;0;1;5
16413;Šilelis;BITUTĖS;3062557053;Taip;0;1;0;1
16414;Šilelis;BITUTĖS;1390916076;Taip;21;0;0;21
16415;Šilelis;DRUGELIAI;1877467761;Taip;1;0;3;4
16416;Šilelis;DRUGELIAI;2079073174;Taip;5;0;0;5
16417;Šilelis;DRUGELIAI;3598370884;Taip;12;3;0;15
16418;Šilelis;DRUGELIAI;1618432877;Taip;6;0;0;6
16419;Šilelis;DRUGELIAI;1347150938;Ne;3;0;1;4
16420;Šilelis;DRUGELIAI;7636725161;Taip;8;1;0;9
16421;Šilelis;DRUGELIAI;9256656029;Taip;0;6;0;6
16422;Šilelis;DRUGELIAI;1891388542;Taip;0;1;4;5
16423;Šilelis;DRUGELIAI;5759824196;Ne;0;1;0;1
16424;Šilelis;DRUGELIAI;31906089315;Ne;7;0;4;11
16425;Šilelis;DRUGELIAI;4115738520;Taip;0;0;3;3
16426;Šilelis;DRUGELIAI;3824174896;Taip;0;0;3;3
16427;Šilelis;DRUGELIAI;8090765017;Taip;0;7;0;7
16428;Šilelis;DRUGELIAI;54633547799;Taip;15;0;0;15
16429;Šilelis;DRUGELIAI;9100047520;Taip;6;1;0;7
16430;Šilelis;DRUGELIAI;1019874215;Taip;0;0;2;2
16431;Šilelis;DRUGELIAI;5863425750;Taip;10;5;0;15
16432;Šilelis;DRUGELIAI;1448291886;Taip;0;8;0;8
16433;Šilelis;DRUGELIAI;1638362625;Taip;0;0;3;3
16434;Šilelis;DRUGELIAI;9482667810;Taip;5;0;2;7
16435;Šilelis;DRUGELIAI;5379171382;Ne;0;0;1;1
16436;Šilelis;DRUGELIAI;6230566495;Taip;11;0;0;11
16437;Šilelis;DRUGELIAI;6523676718;Ne;0;0;5;5
16438;Vaduvos;PAGRANDUKAI;1048630061;Taip;0;9;0;9
16439;Vaduvos;PAGRANDUKAI;8408017356;Taip;4;4;0;8
16440;Vaduvos;PAGRANDUKAI;72724196791;Taip;5;10;2;17
16441;Vaduvos;PAGRANDUKAI;9371067563;Taip;0;2;0;2
16442;Vaduvos;PAGRANDUKAI;9987311980;Taip;0;10;1;11
16443;Vaduvos;PAGRANDUKAI;6425640531;Taip;0;0;1;1
16444;Vaduvos;PAGRANDUKAI;4029586203;Taip;0;0;1;1
16445;Vaduvos;PAGRANDUKAI;73800920781;Taip;4;0;0;4
16446;Vaduvos;PAGRANDUKAI;18035723255;Ne;11;0;1;12
16447;Vaduvos;PAGRANDUKAI;5954492368;Taip;0;2;0;2
16448;Vaduvos;PAGRANDUKAI;7397068779;Ne;0;9;0;9
16449;Vaduvos;PAGRANDUKAI;8875709110;Taip;0;5;0;5
16450;Vaduvos;PAGRANDUKAI;4789480822;Taip;11;0;0;11
16451;Vaduvos;PAGRANDUKAI;7305111076;Taip;0;2;0;2
16452;Vaduvos;PAGRANDUKAI;68848152670;Taip;16;1;0;17
16453;Vaduvos;PAGRANDUKAI;4105978403;Taip;0;6;0;6
16454;Vaduvos;PAGRANDUKAI;5428067167;Taip;0;4;0;4
16455;Vaduvos;PAGRANDUKAI;3699578284;Taip;0;0;4;4
16456;Vaduvos;KODĖLČIUKAI;9429028460;Taip;0;3;0;3
16457;Vaduvos;KODĖLČIUKAI;6210729584;Taip;0;1;0;1
16458;Vaduvos;KODĖLČIUKAI;9540008495;Taip;5;0;1;6
16459;Vaduvos;KODĖLČIUKAI;9983148737;Taip;6;0;0;6
16460;Vaduvos;KODĖLČIUKAI;9072097216;Ne;3;0;0;3
16461;Vaduvos;KODĖLČIUKAI;9062135043;Taip;4;6;0;10
16462;Vaduvos;KODĖLČIUKAI;6810198013;Taip;6;6;2;14
16463;Vaduvos;KODĖLČIUKAI;9178907705;Taip;11;0;6;17
16464;Vaduvos;KODĖLČIUKAI;3641822841;Taip;17;4;0;21
16465;Vaduvos;KODĖLČIUKAI;4270137614;Taip;6;1;0;7
16466;Vaduvos;KODĖLČIUKAI;7181151562;Taip;6;0;0;6
16467;Vaduvos;KODĖLČIUKAI;5262165284;Taip;11;0;2;13
16468;Vaduvos;KODĖLČIUKAI;8603418399;Taip;7;0;0;7
16469;Vaduvos;KODĖLČIUKAI;3096104197;Taip;16;0;0;16
16470;Vaduvos;KODĖLČIUKAI;5761137540;Ne;0;10;2;12
16471;Vaduvos;KODĖLČIUKAI;9597857664;Taip;9;0;0;9
16472;Vaduvos;KODĖLČIUKAI;1054097622;Taip;11;5;0;16
16473;Vaduvos;SMALSUČIAI;5307128703;Taip;0;2;0;2
16474;Vaduvos;SMALSUČIAI;6121365922;Taip;0;1;1;2
16475;Vaduvos;SMALSUČIAI;62183976729;Taip;5;1;1;7
16476;Vaduvos;SMALSUČIAI;1825188497;Taip;0;2;1;3
16477;Vaduvos;SMALSUČIAI;1622695085;Taip;4;0;0;4
16478;Vaduvos;SMALSUČIAI;3555513755;Taip;0;0;1;1
16479;Vaduvos;SMALSUČIAI;2184711783;Taip;0;0;1;1
16480;Vaduvos;SMALSUČIAI;3010510262;Taip;8;4;0;12
16481;Vaduvos;SMALSUČIAI;7537754249;Taip;0;1;0;1
16482;Vaduvos;SMALSUČIAI;4565556635;Taip;0;0;3;3
16483;Vaduvos;SMALSUČIAI;4615315809;Taip;0;0;1;1
16484;Vaduvos;SMALSUČIAI;7337663549;Taip;16;0;0;16
16485;Vaduvos;SMALSUČIAI;5055972872;Taip;10;0;1;11
16486;Vaduvos;SMALSUČIAI;1423148023;Taip;0;3;0;3
16487;Vaduvos;SMALSUČIAI;6192828320;Taip;0;3;0;3
16488;Vaduvos;SMALSUČIAI;13888236429;Taip;0;0;2;2
16489;Vaduvos;SMALSUČIAI;3722349868;Taip;0;2;0;2
16490;Vaduvos;SMALSUČIAI;3174998523;Ne;12;0;0;12
16491;Vaduvos;SMALSUČIAI;3091707832;Taip;17;0;0;17
16492;Vaduvos;SMALSUČIAI;13178417729;Taip;0;10;0;10
16493;Vaduvos;GILIUKAI;11202010413;Taip;0;7;0;7
16494;Vaduvos;GILIUKAI;1046867513;Ne;0;4;0;4
16495;Vaduvos;GILIUKAI;4342471835;Taip;0;0;2;2
16496;Vaduvos;GILIUKAI;15757662594;Taip;0;1;0;1
16497;Vaduvos;GILIUKAI;97007740148;Taip;0;0;1;1
16498;Vaduvos;GILIUKAI;93702732546;Taip;0;0;1;1
16499;Vaduvos;GILIUKAI;1464016847;Taip;6;2;3;11
16500;Vaduvos;GILIUKAI;2006018986;Taip;0;3;0;3
16501;Vaduvos;GILIUKAI;59616893535;Taip;2;0;4;6
16502;Vaduvos;GILIUKAI;61046090149;Taip;0;1;0;1
16503;Vaduvos;GILIUKAI;87008942241;Taip;6;0;0;6
16504;Vaduvos;GILIUKAI;79437154441;Taip;4;0;1;5
16505;Vaduvos;GILIUKAI;68937983441;Taip;14;2;0;16
16506;Vaduvos;GILIUKAI;1703266825;Taip;0;1;0;1
16507;Vaduvos;GILIUKAI;65843855427;Taip;0;1;2;3
16508;Vaduvos;BORUŽĖLĖS;24887196729;Taip;0;3;0;3
16509;Vaduvos;BORUŽĖLĖS;16882774330;Taip;0;4;0;4
16510;Vaduvos;BORUŽĖLĖS;70693742936;Taip;0;4;0;4
16511;Vaduvos;BORUŽĖLĖS;4670249904;Taip;0;0;5;5
16512;Vaduvos;BORUŽĖLĖS;1385184350;Taip;3;0;2;5
16513;Vaduvos;BORUŽĖLĖS;65647119496;Taip;0;1;0;1
16514;Vaduvos;BORUŽĖLĖS;96803174459;Taip;0;8;0;8
16515;Vaduvos;BORUŽĖLĖS;19390879176;Taip;10;1;0;11
16516;Vaduvos;BORUŽĖLĖS;47465933557;Taip;0;1;0;1
16517;Vaduvos;BORUŽĖLĖS;16006064074;Taip;0;1;1;2
16518;Vaduvos;BORUŽĖLĖS;55138588393;Taip;0;1;0;1
16519;Vaduvos;BORUŽĖLĖS;3172047211;Taip;5;1;0;6
16520;Vaduvos;BORUŽĖLĖS;93924290247;Taip;0;7;3;10
16521;Vaduvos;BORUŽĖLĖS;61243200177;Taip;0;2;0;2
16522;Vaduvos;BORUŽĖLĖS;95104294893;Taip;0;1;3;4
16523;Vaduvos;BORUŽĖLĖS;6155494370;Ne;0;1;0;1
16524;Vaduvos;BORUŽĖLĖS;94906586734;Taip;6;1;2;9
16525;Vaduvos;BORUŽĖLĖS;7957072941;Taip;0;0;1;1
16526;Vaduvos;BORUŽĖLĖS;6386205227;Taip;0;0;8;8
16527;Vaduvos;DRUGELIAI;39687066893;Ne;5;1;4;10
16528;Vaduvos;DRUGELIAI;87671358423;Taip;0;1;0;1
16529;Vaduvos;DRUGELIAI;40872193458;Taip;1;0;0;1
16530;Vaduvos;DRUGELIAI;1241148402;Taip;0;3;0;3
16531;Vaduvos;DRUGELIAI;13203715320;Taip;8;0;0;8
16532;Vaduvos;DRUGELIAI;26736566969;Taip;0;0;3;3
16533;Vaduvos;DRUGELIAI;66359913774;Taip;0;9;0;9
16534;Vaduvos;DRUGELIAI;49738318631;Taip;0;3;2;5
16535;Vaduvos;DRUGELIAI;96892752634;Taip;0;0;1;1
16536;Vaduvos;DRUGELIAI;8802765960;Taip;0;1;4;5
16537;Vaduvos;DRUGELIAI;1107557891;Ne;10;5;0;15
16538;Vaduvos;DRUGELIAI;78931952732;Taip;0;5;0;5
16539;Vaduvos;DRUGELIAI;3632802933;Ne;0;1;0;1
16540;Vaduvos;DRUGELIAI;2605583220;Taip;5;1;1;7
16541;Vaduvos;DRUGELIAI;54193761898;Taip;0;0;1;1
16542;Vaduvos;DRUGELIAI;1010061503;Taip;7;0;3;10
16543;Vaduvos;DRUGELIAI;2348627375;Taip;6;0;0;6
16544;Vaduvos;DRUGELIAI;1139509471;Taip;6;0;0;6
16545;Vaduvos;RIEŠUTĖLIAI;1422507884;Taip;0;10;2;12
16546;Vaduvos;RIEŠUTĖLIAI;2417613291;Taip;16;0;0;16
16547;Vaduvos;RIEŠUTĖLIAI;6439773886;Taip;0;1;0;1
16548;Vaduvos;RIEŠUTĖLIAI;6593754016;Taip;0;8;0;8
16549;Vaduvos;RIEŠUTĖLIAI;8324927031;Taip;0;0;1;1
16550;Vaduvos;RIEŠUTĖLIAI;5717064754;Ne;0;0;1;1
16551;Vaduvos;RIEŠUTĖLIAI;5634252033;Taip;0;0;6;6
16552;Vaduvos;RIEŠUTĖLIAI;9705185906;Taip;10;0;0;10
16553;Vaduvos;RIEŠUTĖLIAI;7904713344;Taip;4;0;0;4
16554;Vaduvos;RIEŠUTĖLIAI;4465504676;Taip;13;0;0;13
16555;Vaduvos;RIEŠUTĖLIAI;6462126837;Taip;0;6;0;6
16556;Vaduvos;RIEŠUTĖLIAI;6991960029;Taip;0;2;1;3
16557;Vaduvos;RIEŠUTĖLIAI;7521846747;Ne;1;0;0;1
16558;Vaduvos;"1 klasė";42498568346;Taip;0;1;0;1
16559;Vaduvos;"1 klasė";38504924027;Taip;0;1;0;1
16560;Vaduvos;"1 klasė";96148085691;Taip;0;1;0;1
16561;Vaduvos;"1 klasė";33277362439;Ne;0;1;0;1
16562;Vaduvos;"1 klasė";32138087379;Taip;0;2;0;2
16563;Vaduvos;"1 klasė";67324784528;Taip;0;1;0;1
16564;Vaduvos;"1 klasė";2181614424;Taip;0;1;0;1
16565;Vaduvos;"1 klasė";2019573643;Taip;0;2;0;2
16566;Vaduvos;"1 klasė";27419094487;Taip;0;1;0;1
16567;Vaduvos;"1 klasė";41272273463;Taip;0;1;0;1
16568;Vaduvos;"1 klasė";89793734700;Taip;0;1;0;1
16569;Vaduvos;"1 klasė";17473821556;Taip;0;1;0;1
16570;Vaduvos;"1 klasė";53866301875;Ne;0;1;0;1
16571;Vaduvos;"1 klasė";1532675814;Taip;0;2;0;2
16572;Vaduvos;"1 klasė";36931517006;Taip;0;1;0;1
16573;Vaduvos;"1 klasė";61243424057;Taip;0;2;0;2
16574;Vaduvos;"1 klasė";30979103892;Taip;0;1;0;1
16575;Vaduvos;"1 klasė";78245732319;Taip;0;1;0;1
16576;Vaduvos;"1 klasė";97878811046;Taip;0;4;0;4
16577;Vaduvos;"1 klasė";48433447683;Taip;0;1;0;1
16578;Vaduvos;"1 klasė";12330772986;Taip;0;4;0;4
16579;Vaduvos;"1 klasė";4807104855;Taip;0;5;0;5
16580;Vaduvos;"1 klasė";7786986697;Taip;0;1;0;1
16581;Vaduvos;"1 klasė";98259624669;Taip;0;1;0;1
16582;Vaduvos;"1 klasė";85090873161;Taip;0;1;0;1
16583;Vaduvos;"1 klasė";97423576166;Taip;0;1;0;1
16584;Vaduvos;"1 klasė";9147332638;Taip;0;3;0;3
16585;Vaduvos;"2 klasė";96473212525;Taip;0;3;0;3
16586;Vaduvos;"2 klasė";75428164558;Taip;0;1;0;1
16587;Vaduvos;"2 klasė";8188624118;Ne;0;21;0;21
16588;Vaduvos;"2 klasė";63286903462;Taip;0;2;0;2
16589;Vaduvos;"2 klasė";20841176336;Taip;0;21;0;21
16590;Vaduvos;"2 klasė";13721939854;Taip;0;1;0;1
16591;Vaduvos;"2 klasė";7172286009;Taip;0;4;0;4
16592;Vaduvos;"2 klasė";6049882391;Ne;0;3;0;3
16593;Vaduvos;"2 klasė";38013859931;Taip;0;1;0;1
16594;Vaduvos;"2 klasė";61830127618;Taip;0;1;0;1
16595;Vaduvos;"2 klasė";4591744662;Taip;0;1;0;1
16596;Vaduvos;"2 klasė";9149523910;Taip;0;1;0;1
16597;Vaduvos;"2 klasė";76662161382;Taip;0;1;0;1
16598;Vaduvos;"2 klasė";26934740147;Taip;0;21;0;21
16599;Vaduvos;"2 klasė";18300713872;Taip;0;21;0;21
16600;Vaduvos;"2 klasė";768455288;Ne;0;21;0;21
16601;Vaduvos;"2 klasė";1768173501;Taip;0;2;0;2
16602;Vaduvos;"2 klasė";60531886576;Taip;0;1;0;1
16603;Vaduvos;"2 klasė";2004208381;Ne;0;1;0;1
16604;Vaduvos;"2 klasė";38462664426;Ne;0;10;0;10
16605;Vaduvos;"2 klasė";2029363844;Taip;0;21;0;21
16606;Vaduvos;"2 klasė";1821644443;Ne;0;3;0;3
16607;Vaduvos;"2 klasė";1171210935;Ne;0;7;0;7
16608;Vaduvos;"3 klasė";8009941823;Taip;0;2;0;2
16609;Vaduvos;"3 klasė";2423925079;Ne;0;21;0;21
16610;Vaduvos;"3 klasė";7410760461;Taip;0;21;0;21
16611;Vaduvos;"3 klasė";6487033699;Taip;0;4;0;4
16612;Vaduvos;"3 klasė";1671409152;Taip;0;2;0;2
16613;Vaduvos;"3 klasė";5072769647;Taip;0;2;0;2
16614;Vaduvos;"3 klasė";4637670260;Taip;0;2;0;2
16615;Vaduvos;"3 klasė";7236550835;Taip;0;2;0;2
16616;Vaduvos;"3 klasė";9372936408;Taip;0;2;0;2
16617;Vaduvos;"3 klasė";7243175751;Taip;0;3;0;3
16618;Vaduvos;"3 klasė";2482212122;Taip;0;4;0;4
16619;Vaduvos;"3 klasė";1982860223;Taip;0;2;0;2
16620;Vaduvos;"3 klasė";4447152355;Taip;0;2;0;2
16621;Vaduvos;"3 klasė";3325229112;Taip;0;9;0;9
16622;Vaduvos;"3 klasė";5531150399;Taip;0;21;0;21
16623;Vaduvos;"3 klasė";6980440631;Taip;0;2;0;2
16624;Vaduvos;"3 klasė";1091221509;Ne;0;4;0;4
16625;Vaduvos;"3 klasė";7614692200;Taip;0;2;0;2
16626;Vaduvos;"3 klasė";8216757208;Taip;0;2;0;2
16627;Vaduvos;"3 klasė";5459268700;Ne;0;21;0;21
16628;Vaduvos;"3 klasė";5593756016;Taip;0;2;0;2
16629;Vaduvos;"3 klasė";1642242442;Taip;0;5;0;5
16630;Vaduvos;"3 klasė";8928517238;Taip;0;2;0;2
16631;Vaduvos;"3 klasė";5099560123;Taip;0;2;0;2
16632;Vaduvos;"3 klasė";7899239147;Taip;0;2;0;2
16633;Vaduvos;"4 klasė";6896561963;Taip;0;5;0;5
16634;Vaduvos;"4 klasė";2149582337;Taip;0;7;0;7
16635;Vaduvos;"4 klasė";2520421584;Ne;0;3;0;3
16636;Vaduvos;"4 klasė";8241399720;Taip;0;2;0;2
16637;Vaduvos;"4 klasė";7719637673;Taip;0;3;0;3
16638;Vaduvos;"4 klasė";9644782309;Taip;0;4;0;4
16639;Vaduvos;"4 klasė";5523290081;Taip;0;3;0;3
16640;Vaduvos;"4 klasė";5786723345;Ne;0;4;0;4
16641;Vaduvos;"4 klasė";1461738157;Taip;0;4;0;4
16642;Vaduvos;"4 klasė";7786044620;Taip;0;21;0;21
16643;Vaduvos;"4 klasė";4347558872;Taip;0;3;0;3
16644;Vaduvos;"4 klasė";1954540001;Taip;0;9;0;9
16645;Vaduvos;"4 klasė";9271050464;Taip;0;2;0;2
16646;Vaduvos;"4 klasė";3755145838;Taip;0;21;0;21
16647;Vaduvos;"4 klasė";9494193819;Ne;0;21;0;21
16648;Vaduvos;"4 klasė";7838224919;Ne;0;2;0;2
16649;Vaduvos;"4 klasė";1086186628;Taip;0;6;0;6
16650;Vaduvos;"4 klasė";9441676636;Ne;0;2;0;2
16651;Vaduvos;"4 klasė";1841919654;Ne;0;4;0;4
16652;Vaduvos;"4 klasė";6964778383;Taip;0;3;0;3
16653;Vaduvos;"4 klasė";6748405557;Taip;0;9;0;9
16654;Vaduvos;"4 klasė";1730710569;Taip;0;4;0;4
16655;Vaduvos;"4 klasė";6744521293;Ne;0;4;0;4
16656;Vaduvos;"4 klasė";8801412437;Taip;0;2;0;2
16657;Vaduvos;"4 klasė";3583694770;Taip;0;7;0;7
16658;Vilkpėdės;BORUŽĖLĖS;8969001990;Taip;10;0;0;10
16659;Vilkpėdės;BORUŽĖLĖS;6744834487;Taip;14;0;0;14
16660;Vilkpėdės;BORUŽĖLĖS;7401886306;Taip;14;0;0;14
16661;Vilkpėdės;BORUŽĖLĖS;1528619779;Taip;5;2;0;7
16662;Vilkpėdės;BORUŽĖLĖS;6820236577;Taip;2;0;0;2
16663;Vilkpėdės;BORUŽĖLĖS;4255757333;Taip;8;0;2;10
16664;Vilkpėdės;BORUŽĖLĖS;5053032081;Taip;1;1;0;2
16665;Vilkpėdės;BORUŽĖLĖS;4166416292;Taip;9;0;0;9
16666;Vilkpėdės;BORUŽĖLĖS;3785308006;Taip;10;0;5;15
16667;Vilkpėdės;BORUŽĖLĖS;6473925760;Taip;11;0;0;11
16668;Vilkpėdės;BORUŽĖLĖS;9605430333;Taip;14;1;1;16
16669;Vilkpėdės;BORUŽĖLĖS;3888880306;Taip;0;0;2;2
16670;Vilkpėdės;BORUŽĖLĖS;9601934563;Taip;7;1;0;8
16671;Vilkpėdės;BORUŽĖLĖS;1571869318;Taip;6;6;0;12
16672;Vilkpėdės;SKRUZDĖLIUKAI;1838974989;Taip;0;0;1;1
16673;Vilkpėdės;SKRUZDĖLIUKAI;8820585407;Taip;0;6;0;6
16674;Vilkpėdės;SKRUZDĖLIUKAI;4018140154;Taip;13;1;0;14
16675;Vilkpėdės;SKRUZDĖLIUKAI;8385974099;Taip;7;1;1;9
16676;Vilkpėdės;SKRUZDĖLIUKAI;5719253028;Taip;11;1;0;12
16677;Vilkpėdės;SKRUZDĖLIUKAI;4031175523;Taip;8;0;2;10
16678;Vilkpėdės;SKRUZDĖLIUKAI;6778288398;Taip;0;1;0;1
16679;Vilkpėdės;SKRUZDĖLIUKAI;3948025914;Taip;14;0;0;14
16680;Vilkpėdės;SKRUZDĖLIUKAI;6514256499;Taip;5;1;1;7
16681;Vilkpėdės;DRUGELIAI;2420271759;Taip;0;3;0;3
16682;Vilkpėdės;DRUGELIAI;9294350205;Taip;0;5;0;5
16683;Vilkpėdės;DRUGELIAI;2377248778;Taip;13;0;0;13
16684;Vilkpėdės;DRUGELIAI;7698759895;Taip;0;2;0;2
16685;Vilkpėdės;DRUGELIAI;1019057127;Taip;9;0;0;9
16686;Vilkpėdės;DRUGELIAI;1807884737;Taip;13;1;0;14
16687;Vilkpėdės;DRUGELIAI;6816745585;Taip;16;0;0;16
16688;Vilkpėdės;DRUGELIAI;9460356725;Taip;9;0;1;10
16689;Vilkpėdės;DRUGELIAI;8015392054;Taip;2;3;0;5
16690;Vilkpėdės;DRUGELIAI;2320350937;Taip;8;1;0;9
16691;Vilkpėdės;DRUGELIAI;7894766629;Taip;0;21;0;21
16692;Vilkpėdės;DRUGELIAI;6762306583;Taip;21;0;0;21
16693;Vilkpėdės;DRUGELIAI;9795696242;Taip;9;0;0;9
16694;Vilkpėdės;DRUGELIAI;8581661608;Taip;1;6;0;7
16695;Vilkpėdės;DRUGELIAI;6261547304;Taip;4;0;0;4
16696;Vilkpėdės;DRUGELIAI;4095366279;Taip;7;0;0;7
16697;Vilkpėdės;DRUGELIAI;8128254701;Taip;0;1;5;6
16698;Vilkpėdės;DRUGELIAI;7908813288;Ne;10;0;0;10
16699;Vilkpėdės;DRUGELIAI;2251274741;Ne;14;0;0;14
16700;Vilkpėdės;ŽIOGELIAI;1267187553;Taip;13;0;0;13
16701;Vilkpėdės;ŽIOGELIAI;7508333714;Taip;11;1;0;12
16702;Vilkpėdės;ŽIOGELIAI;1396827668;Taip;5;0;0;5
16703;Vilkpėdės;ŽIOGELIAI;5551822633;Taip;17;0;0;17
16704;Vilkpėdės;ŽIOGELIAI;3666145718;Taip;12;0;0;12
16705;Vilkpėdės;ŽIOGELIAI;5633014328;Taip;16;0;0;16
16706;Vilkpėdės;ŽIOGELIAI;5422061533;Taip;0;2;0;2
16707;Vilkpėdės;ŽIOGELIAI;4311938034;Taip;0;2;0;2
16708;Vilkpėdės;ŽIOGELIAI;3833382641;Taip;10;0;0;10
16709;Vilkpėdės;ŽIOGELIAI;5346798201;Taip;1;3;1;5
16710;Vilkpėdės;ŽIOGELIAI;5340239466;Taip;13;0;0;13
16711;Vilkpėdės;ŽIOGELIAI;3720639726;Taip;5;0;0;5
16712;Vilkpėdės;BITUTĖS;9605399822;Taip;0;1;0;1
16713;Vilkpėdės;BITUTĖS;7875898177;Taip;11;2;0;13
16714;Vilkpėdės;BITUTĖS;9867411687;Taip;5;1;0;6
16715;Vilkpėdės;BITUTĖS;4735164204;Taip;11;0;0;11
16716;Vilkpėdės;BITUTĖS;46561435465;Ne;6;5;0;11
16717;Vilkpėdės;BITUTĖS;48059844727;Taip;0;1;0;1
16718;Vilkpėdės;BITUTĖS;7634355147;Taip;0;2;4;6
16719;Vilkpėdės;BITUTĖS;4392760215;Ne;1;1;0;2
16720;Vilkpėdės;BITUTĖS;2955411131;Taip;5;2;0;7
16721;Vilkpėdės;BITUTĖS;2736368118;Taip;0;10;0;10
16722;Vilkpėdės;BITUTĖS;4515945951;Taip;8;0;1;9
16723;Vilkpėdės;BITUTĖS;2900581406;Taip;8;0;0;8
16724;Vilkpėdės;BITUTĖS;7527929277;Taip;11;4;0;15
16725;Vilkpėdės;BITUTĖS;8865545376;Ne;0;5;0;5
16726;Vilkpėdės;BITUTĖS;4276158771;Taip;0;2;0;2
16727;Vilkpėdės;BITUTĖS;7889480219;Ne;6;0;0;6
16728;Vilkpėdės;BITUTĖS;2125569383;Taip;0;0;6;6
16729;Vilkpėdės;"2 klasė";14499651046;Ne;3;1;0;4
16730;Vilkpėdės;"2 klasė";90217345315;Taip;0;1;0;1
16731;Vilkpėdės;"2 klasė";51286525404;Taip;0;1;0;1
16732;Vilkpėdės;"2 klasė";49513181091;Taip;5;1;0;6
16733;Vilkpėdės;"2 klasė";1032216128;Taip;12;1;0;13
16734;Vilkpėdės;"2 klasė";37450374921;Taip;3;1;0;4
16735;Vilkpėdės;"2 klasė";36704555745;Taip;0;1;0;1
16736;Vilkpėdės;"2 klasė";66356984763;Taip;5;1;0;6
16737;Vilkpėdės;"2 klasė";88279045901;Taip;10;2;0;12
16738;Vilkpėdės;"2 klasė";66451097025;Taip;2;1;0;3
16739;Vilkpėdės;"2 klasė";2806307083;Taip;0;1;0;1
16740;Vilkpėdės;"2 klasė";51799865091;Taip;1;1;0;2
16741;Vilkpėdės;"2 klasė";79269485254;Taip;0;2;0;2
16742;Vilkpėdės;"2 klasė";61833757576;Taip;0;1;0;1
16743;Vilkpėdės;"2 klasė";64216245300;Taip;0;1;0;1
16744;Vilkpėdės;"3 klasė";6750171948;Ne;8;0;0;8
16745;Vilkpėdės;"3 klasė";3330174377;Ne;1;0;0;1
16746;Vilkpėdės;"3 klasė";5753361387;Ne;1;0;0;1
16747;Vilkpėdės;"3 klasė";7567054902;Ne;2;0;0;2
16748;Vilkpėdės;"3 klasė";4450490805;Ne;1;0;0;1
16749;Vilkpėdės;"3 klasė";9422266523;Ne;1;0;0;1
16750;Vilkpėdės;"3 klasė";4467711387;Ne;1;0;0;1
16751;Vilkpėdės;"3 klasė";4562930821;Ne;5;0;0;5
16752;Vilkpėdės;GUDRUČIAI;19719432462;Taip;0;2;0;2
16753;Vilkpėdės;GUDRUČIAI;63180329851;Ne;5;1;0;6
16754;Vilkpėdės;GUDRUČIAI;93775558547;Ne;0;6;0;6
16755;Vilkpėdės;GUDRUČIAI;5218466024;Taip;6;1;1;8
16756;Vilkpėdės;GUDRUČIAI;41394645789;Taip;2;2;0;4
16757;Vilkpėdės;GUDRUČIAI;4457851703;Taip;5;0;0;5
16758;Vilkpėdės;GUDRUČIAI;70184817311;Taip;0;7;0;7
16759;Vilkpėdės;GUDRUČIAI;61457409195;Ne;0;5;0;5
16760;Vilkpėdės;GUDRUČIAI;90816091771;Taip;0;2;0;2
16761;Vilkpėdės;GUDRUČIAI;60687258266;Taip;0;3;0;3
16762;Vilkpėdės;GUDRUČIAI;25846393751;Taip;0;4;0;4
16763;Vilkpėdės;GUDRUČIAI;95615604947;Taip;6;1;0;7
16764;Vilkpėdės;GUDRUČIAI;3001209213;Taip;5;1;0;6
16765;Vilkpėdės;GUDRUČIAI;90226911248;Taip;14;5;0;19
16766;Vilkpėdės;GUDRUČIAI;18860888473;Taip;0;3;0;3
16767;Vilkpėdės;GUDRUČIAI;73812058890;Taip;0;12;0;12
16768;Vilkpėdės;GUDRUČIAI;95408044297;Taip;0;3;0;3
16769;Vilkpėdės;GUDRUČIAI;64155507543;Taip;0;3;0;3
16770;Vilkpėdės;GUDRUČIAI;33842357499;Taip;2;4;0;6
16771;Vilkpėdės;GUDRUČIAI;21841574426;Taip;0;10;0;10
16772;Vilkpėdės;GUDRUČIAI;32683398503;Taip;4;2;0;6
16773;Vilkpėdės;GUDRUČIAI;58037049872;Taip;0;1;0;1
16774;Vilkpėdės;SMALSUČIAI;2065010940;Taip;5;3;0;8
16775;Vilkpėdės;SMALSUČIAI;1137529145;Taip;0;1;0;1
16776;Vilkpėdės;SMALSUČIAI;13241568469;Taip;4;2;0;6
16777;Vilkpėdės;SMALSUČIAI;1052719398;Taip;1;1;0;2
16778;Vilkpėdės;SMALSUČIAI;1145968615;Taip;2;1;0;3
16779;Vilkpėdės;SMALSUČIAI;1598018406;Taip;0;1;0;1
16780;Vilkpėdės;SMALSUČIAI;1136036746;Taip;7;0;2;9
16781;Vilkpėdės;SMALSUČIAI;51976067616;Taip;7;2;0;9
16782;Vilkpėdės;SMALSUČIAI;73470824566;Ne;0;1;5;6
16783;Vilkpėdės;SMALSUČIAI;5912919726;Taip;0;8;0;8
16784;Vilkpėdės;SMALSUČIAI;72227817278;Ne;6;1;0;7
16785;Vilkpėdės;SMALSUČIAI;1795879331;Taip;0;4;0;4
16786;Vilkpėdės;SMALSUČIAI;2000428715;Taip;0;0;1;1
16787;Vilkpėdės;SMALSUČIAI;1042000830;Taip;0;0;4;4
16788;Vilkpėdės;SMALSUČIAI;72899151328;Taip;0;1;0;1
16789;Vilkpėdės;SMALSUČIAI;1527272055;Ne;0;1;0;1
16790;Vilkpėdės;SMALSUČIAI;1384224802;Taip;0;1;0;1
16791;Vilkpėdės;SMALSUČIAI;25008201566;Taip;0;21;0;21
16792;Vilkpėdės;SMALSUČIAI;9393571483;Taip;10;0;0;10
16793;Žiburėlis;Nykštukai;6696156248;Taip;16;0;0;16
16794;Žiburėlis;Nykštukai;7163594513;Taip;0;2;0;2
16795;Žiburėlis;Nykštukai;5209976632;Taip;10;0;0;10
16796;Žiburėlis;Nykštukai;5408766721;Ne;5;0;0;5
16797;Žiburėlis;Nykštukai;3646988912;Taip;7;1;0;8
16798;Žiburėlis;Nykštukai;8535429783;Ne;10;1;0;11
16799;Žiburėlis;Nykštukai;9670396828;Taip;16;0;0;16
16800;Žiburėlis;Nykštukai;7211961512;Ne;0;7;0;7
16801;Žiburėlis;Nykštukai;2928528630;Ne;8;4;0;12
16802;Žiburėlis;Nykštukai;2624326930;Taip;5;7;0;12
16803;Žiburėlis;Nykštukai;6300247811;Taip;11;0;0;11
16804;Žiburėlis;Nykštukai;3033049328;Taip;0;5;0;5
16805;Žiburėlis;Nykštukai;7862546963;Taip;14;0;0;14
16806;Žiburėlis;Nykštukai;8902837168;Taip;14;0;0;14
16807;Žiburėlis;Nykštukai;5303511810;Taip;11;0;0;11
16808;Žiburėlis;Nykštukai;3262856058;Ne;10;9;0;19
16809;Žiburėlis;Nykštukai;5816890413;Taip;15;1;0;16
16810;Žiburėlis;"Žiniukai ";1463581257;Ne;0;1;0;1
16811;Žiburėlis;"Žiniukai ";90296810303;Taip;2;2;0;4
16812;Žiburėlis;"Žiniukai ";78896331135;Taip;5;2;0;7
16813;Žiburėlis;"Žiniukai ";32837087738;Taip;0;1;0;1
16814;Žiburėlis;"Žiniukai ";78861342608;Ne;0;2;0;2
16815;Žiburėlis;"Žiniukai ";49081936325;Taip;0;4;0;4
16816;Žiburėlis;"Žiniukai ";7135920347;Taip;8;1;0;9
16817;Žiburėlis;"Žiniukai ";61148040564;Taip;0;2;0;2
16818;Žiburėlis;"Žiniukai ";25826760783;Taip;11;1;0;12
16819;Žiburėlis;"Žiniukai ";45509849089;Taip;5;2;0;7
16820;Žiburėlis;"Žiniukai ";73054546792;Taip;0;4;0;4
16821;Žiburėlis;"Žiniukai ";16721946185;Taip;0;3;0;3
16822;Žiburėlis;"Žiniukai ";1937753510;Taip;0;1;0;1
16823;Žiburėlis;"Žiniukai ";42442737710;Taip;0;1;0;1
16824;Žiburėlis;"Žiniukai ";16215414453;Taip;0;2;0;2
16825;Žiburėlis;"Žiniukai ";77674964341;Taip;11;1;0;12
16826;Žiburėlis;"Smalsiukai ";4631640931;Taip;0;1;0;1
16827;Žiburėlis;"Smalsiukai ";5006361324;Taip;0;1;0;1
16828;Žiburėlis;"Smalsiukai ";1876645582;Taip;10;1;0;11
16829;Žiburėlis;"Smalsiukai ";4187381976;Taip;0;3;0;3
16830;Žiburėlis;"Smalsiukai ";7424129974;Ne;10;3;0;13
16831;Žiburėlis;"Smalsiukai ";2982016133;Taip;2;1;0;3
16832;Žiburėlis;"Smalsiukai ";5517458323;Taip;6;0;0;6
16833;Žiburėlis;"Smalsiukai ";1720078356;Taip;0;2;0;2
16834;Žiburėlis;"Smalsiukai ";57892276898;Taip;9;3;0;12
16835;Žiburėlis;"Smalsiukai ";13256396372;Taip;4;2;0;6
16836;Žiburėlis;"Smalsiukai ";87417486808;Taip;0;3;0;3
16837;Žiburėlis;"Smalsiukai ";68423991252;Taip;0;5;0;5
16838;Žiburėlis;"Smalsiukai ";7518552326;Taip;3;0;0;3
16839;Žiburėlis;"Smalsiukai ";25134435204;Taip;0;2;0;2
16840;Žiburėlis;"Smalsiukai ";3966740507;Ne;0;1;0;1
16841;Žiburėlis;"Smalsiukai ";1115857147;Taip;13;0;0;13
16842;Žiburėlis;"Giliukai ";52216192635;Taip;3;1;0;4
16843;Žiburėlis;"Giliukai ";4355778076;Taip;5;0;0;5
16844;Žiburėlis;"Giliukai ";92490398630;Taip;8;1;0;9
16845;Žiburėlis;"Giliukai ";67168630669;Taip;2;1;0;3
16846;Žiburėlis;"Giliukai ";3867540155;Taip;6;0;0;6
16847;Žiburėlis;"Giliukai ";7578655857;Ne;0;1;0;1
16848;Žiburėlis;"Giliukai ";75538036055;Taip;0;4;0;4
16849;Žiburėlis;"Giliukai ";9253393819;Taip;0;1;0;1
16850;Žiburėlis;"Giliukai ";8677998615;Taip;6;1;0;7
16851;Žiburėlis;"Giliukai ";2796489509;Taip;4;0;0;4
16852;Žiburėlis;"Giliukai ";18739941845;Taip;2;0;0;2
16853;Žiburėlis;"Giliukai ";24639355056;Taip;13;1;0;14
16854;Žiburėlis;"Giliukai ";6519139977;Taip;10;8;0;18
16855;Žiburėlis;"Giliukai ";7861704875;Ne;4;1;0;5
16856;Žiburėlis;"Giliukai ";34873231652;Taip;0;3;0;3
16857;Žiburėlis;"Giliukai ";1125662904;Taip;8;2;0;10
16858;Žiburėlis;"Giliukai ";2175751377;Taip;7;1;1;9
16859;Žiburėlis;"Giliukai ";8531121002;Ne;0;1;4;5
16860;Žiburėlis;"Giliukai ";28985997205;Taip;7;1;2;10
16861;Žiburėlis;"1 klasė";5914668910;Ne;0;1;0;1
16862;Žiburėlis;"1 klasė";95216886081;Taip;0;1;0;1
16863;Žiburėlis;"1 klasė";37375035477;Taip;0;1;0;1
16864;Žiburėlis;"1 klasė";54487369856;Taip;0;1;0;1
16865;Žiburėlis;"1 klasė";1483522393;Taip;3;1;0;4
16866;Žiburėlis;"1 klasė";93584914250;Taip;0;1;0;1
16867;Žiburėlis;"1 klasė";1858285649;Taip;0;1;0;1
16868;Žiburėlis;"1 klasė";41774939326;Taip;0;1;0;1
16869;Žiburėlis;"1 klasė";5778346952;Taip;0;1;0;1
16870;Žiburėlis;"1 klasė";67896676967;Taip;0;1;0;1
16871;Žiburėlis;"1 klasė";1852949849;Ne;0;1;0;1
16872;Žiburėlis;"1 klasė";95176636771;Taip;0;1;0;1
16873;Žiburėlis;"1 klasė";88801862582;Taip;4;1;0;5
16874;Žiburėlis;Meškiukai;7070952018;Taip;0;3;0;3
16875;Žiburėlis;Meškiukai;874653320;Taip;0;1;0;1
16876;Žiburėlis;Meškiukai;38096163093;Taip;6;2;0;8
16877;Žiburėlis;Meškiukai;96004573835;Taip;0;2;0;2
16878;Žiburėlis;Meškiukai;549348368;Taip;0;3;0;3
16879;Žiburėlis;Meškiukai;1728059994;Taip;0;1;0;1
16880;Žiburėlis;Meškiukai;1523632106;Taip;17;0;0;17
16881;Žiburėlis;Meškiukai;9069606713;Ne;6;0;0;6
16882;Žiburėlis;Meškiukai;46449810717;Taip;5;0;0;5
16883;Žiburėlis;Meškiukai;3678560815;Taip;0;11;0;11
16884;Žiburėlis;Meškiukai;57749440744;Taip;10;2;0;12
16885;Žiburėlis;Meškiukai;1614403409;Taip;0;3;0;3
16886;Žiburėlis;Meškiukai;808556747;Taip;0;12;0;12
16887;Žiburėlis;Meškiukai;43206636255;Taip;0;1;0;1
16888;Žiburėlis;Meškiukai;60150682872;Taip;0;6;0;6
16889;Žiburėlis;Meškiukai;50869669391;Taip;10;1;0;11
16890;Žiburėlis;Meškiukai;31669188580;Taip;5;0;0;5
16891;Žiburėlis;Meškiukai;30337030701;Taip;8;0;0;8
16892;Žiburėlis;Meškiukai;1612968712;Taip;0;1;0;1
16893;Žiburėlis;Meškiukai;5495813195;Taip;7;3;3;13
16894;Žiburėlis;Viščiukai;2491972986;Taip;12;1;0;13
16895;Žiburėlis;Viščiukai;8970153523;Taip;13;0;0;13
16896;Žiburėlis;Viščiukai;9589823198;Taip;0;1;0;1
16897;Žiburėlis;Viščiukai;2702814930;Taip;0;1;0;1
16898;Žiburėlis;Viščiukai;4387021429;Taip;0;3;0;3
16899;Žiburėlis;Viščiukai;7865562941;Ne;1;1;0;2
16900;Žiburėlis;Viščiukai;8973307069;Ne;5;0;0;5
16901;Žiburėlis;Viščiukai;5002691930;Taip;9;0;0;9
16902;Žiburėlis;Viščiukai;8133371774;Taip;10;0;0;10
16903;Žiburėlis;Viščiukai;4916545915;Taip;6;1;0;7
16904;Žiburėlis;Viščiukai;1775465307;Taip;0;1;0;1
16905;Žiburėlis;Viščiukai;6647598068;Taip;2;0;0;2
16906;Žiburėlis;Viščiukai;4109288891;Taip;17;0;0;17
16907;Žiburėlis;Viščiukai;7111530833;Ne;15;1;0;16
16908;Žiburėlis;Viščiukai;7825665451;Taip;6;0;0;6
16909;Žiburėlis;"Drambliukai ";7633450988;Taip;11;2;0;13
16910;Žiburėlis;"Drambliukai ";6830200578;Ne;10;0;3;13
16911;Žiburėlis;"Drambliukai ";2253167147;Taip;19;0;0;19
16912;Žiburėlis;"Drambliukai ";7402647048;Taip;5;0;0;5
16913;Žiburėlis;"Drambliukai ";8215816053;Ne;0;7;0;7
16914;Žiburėlis;"Drambliukai ";9352485231;Taip;0;2;0;2
16915;Žiburėlis;"Drambliukai ";4710995351;Taip;10;0;0;10
16916;Žiburėlis;"Drambliukai ";2292895729;Taip;0;18;0;18
16917;Žiburėlis;"Drambliukai ";5098955523;Taip;3;4;3;10
16918;Žiburėlis;"Drambliukai ";6250610187;Taip;0;13;4;17
16919;Žiburėlis;"Drambliukai ";5629404179;Taip;0;13;0;13
16920;Žiburėlis;"Drambliukai ";9806454408;Taip;0;1;0;1
16921;Žiburėlis;"Drambliukai ";1764592065;Taip;0;1;0;1
16922;Žiburėlis;"Drambliukai ";8686565770;Taip;0;3;0;3
16923;Žiburėlis;"Drambliukai ";3938379566;Taip;8;0;0;8
16924;Žiburėlis;"Drambliukai ";5556807335;Taip;8;0;0;8
16925;Žiburėlis;"Drambliukai ";8346571253;Taip;0;2;0;2
16926;Žiburėlis;"2 klasė";78965453247;Ne;0;1;0;1
16927;Žiburėlis;"2 klasė";91489560481;Taip;0;1;0;1
16928;Žiburėlis;"2 klasė";86214644730;Taip;3;1;0;4
16929;Žiburėlis;"2 klasė";50386629614;Taip;2;1;0;3
16930;Žiburėlis;"2 klasė";29289711001;Ne;0;21;0;21
16931;Žiburėlis;"2 klasė";3462265950;Taip;0;21;0;21
16932;Žiburėlis;"2 klasė";97596344387;Taip;4;1;0;5
16933;Žiburėlis;"2 klasė";67880120356;Taip;0;1;0;1
16934;Žiburėlis;"2 klasė";83887875309;Taip;1;1;0;2
16935;Žiburėlis;"2 klasė";75779767358;Ne;0;1;0;1
16936;Žiburėlis;"2 klasė";33877368082;Taip;0;1;0;1
16937;Žiburėlis;"2 klasė";40167464240;Taip;0;1;0;1
16938;Žiburėlis;"2 klasė";91397954329;Taip;0;1;0;1
16939;Žiburėlis;"2 klasė";1266445858;Taip;0;1;0;1
16940;Žiburėlis;"2 klasė";19924188057;Taip;0;1;0;1
16941;Žiburėlis;"2 klasė";16657264022;Taip;2;1;0;3
16942;Žiburėlis;"2 klasė";23334642950;Taip;0;1;0;1
16943;Žiburėlis;"2 klasė";4909760547;Taip;0;1;0;1
16944;Žiburėlis;"3 klasė";8108287017;Ne;0;21;0;21
16945;Žiburėlis;"3 klasė";7328501055;Ne;0;1;1;2
16946;Žiburėlis;"3 klasė";6555937866;Ne;0;1;0;1
16947;Žiburėlis;"3 klasė";9986286327;Ne;0;21;0;21
16948;Žiburėlis;"3 klasė";8967516850;Ne;3;1;0;4
16949;Žiburėlis;"3 klasė";4955196776;Ne;0;1;0;1
16950;Žiburėlis;"3 klasė";5730454385;Ne;0;1;1;2
16951;Žiburėlis;"3 klasė";7420310542;Ne;5;1;0;6
16952;Žiburėlis;"3 klasė";9030168070;Ne;0;1;0;1
16953;Žiburėlis;"3 klasė";5120367724;Ne;3;1;1;5
16954;Žiburėlis;"3 klasė";5154752431;Ne;5;1;0;6
16955;Žiburėlis;"3 klasė";2895056046;Ne;3;1;1;5
16956;Žiburėlis;"3 klasė";2980656238;Ne;0;1;0;1
16957;Žiburėlis;"3 klasė";9444201589;Ne;4;1;0;5
16958;Žiburėlis;"3 klasė";6532799193;Ne;6;1;0;7
16959;Žiburėlis;"3 klasė";5587135070;Ne;6;1;0;7
16960;Žiburėlis;"3 klasė";7971654401;Ne;0;1;1;2
16961;Žiburėlis;"3 klasė";7244452816;Ne;0;1;0;1
16962;Žiburėlis;"4 klasė";2145461317;Ne;1;1;0;2
16963;Žiburėlis;"4 klasė";6992801094;Ne;8;1;0;9
16964;Žiburėlis;"4 klasė";7451312098;Ne;0;1;0;1
16965;Žiburėlis;"4 klasė";4444164248;Ne;0;1;0;1
16966;Žiburėlis;"4 klasė";8755335337;Ne;0;21;0;21
16967;Žiburėlis;"4 klasė";9803636658;Ne;0;21;0;21
16968;Žiburėlis;"4 klasė";7239532785;Ne;0;1;0;1
16969;Žiburėlis;"4 klasė";9676316394;Ne;0;1;0;1
16970;Žiburėlis;"4 klasė";8942909201;Ne;0;1;0;1
16971;Žiburėlis;"4 klasė";3493549126;Ne;0;21;0;21
16972;Žiburėlis;"4 klasė";6088424692;Ne;0;21;0;21
16973;Žiburėlis;"4 klasė";5999075406;Ne;0;21;0;21
16974;Žiburėlis;"4 klasė";8539444386;Ne;3;1;0;4
16975;Žiburėlis;"4 klasė";3931688013;Ne;3;1;0;4
16976;Žiburėlis;"4 klasė";1769155142;Ne;0;1;0;1
16977;Justinukas;SMALSUČIŲ;7005815238;Taip;3;0;0;3
16978;Justinukas;SMALSUČIŲ;13170636069;Taip;0;2;0;2
16979;Justinukas;SMALSUČIŲ;3118698712;Taip;0;1;0;1
16980;Justinukas;SMALSUČIŲ;3312575449;Taip;0;2;0;2
16981;Justinukas;SMALSUČIŲ;1773690115;Taip;10;1;0;11
16982;Justinukas;SMALSUČIŲ;1121936989;Taip;0;1;0;1
16983;Justinukas;SMALSUČIŲ;46705419124;Taip;15;1;0;16
16984;Justinukas;SMALSUČIŲ;49343952061;Ne;0;1;0;1
16985;Justinukas;SMALSUČIŲ;8741735734;Taip;5;0;5;10
16986;Justinukas;SMALSUČIŲ;2160609412;Taip;0;1;0;1
16987;Justinukas;SMALSUČIŲ;8529082669;Taip;0;7;0;7
16988;Justinukas;SMALSUČIŲ;7678062264;Taip;15;2;0;17
16989;Justinukas;SMALSUČIŲ;1830060403;Taip;0;7;0;7
16990;Justinukas;SMALSUČIŲ;6597383913;Taip;0;0;1;1
16991;Justinukas;SMALSUČIŲ;9349373645;Ne;0;3;1;4
16992;Justinukas;SMALSUČIŲ;3062444365;Taip;0;2;0;2
16993;Justinukas;SMALSUČIŲ;93600065957;Taip;18;0;0;18
16994;Justinukas;SMALSUČIŲ;2317566323;Taip;13;0;1;14
16995;Justinukas;SMALSUČIŲ;1704933971;Taip;6;0;0;6
16996;Justinukas;SMALSUČIŲ;9343761295;Taip;0;12;0;12
16997;Justinukas;SVAJOKLIŲ;9822696769;Taip;0;14;0;14
16998;Justinukas;SVAJOKLIŲ;34905919221;Taip;0;2;0;2
16999;Justinukas;SVAJOKLIŲ;1627717901;Taip;0;1;0;1
17000;Justinukas;SVAJOKLIŲ;6234625191;Ne;1;2;0;3
17001;Justinukas;SVAJOKLIŲ;752609119;Taip;0;1;0;1
17002;Justinukas;SVAJOKLIŲ;5225263863;Taip;0;4;0;4
17003;Justinukas;SVAJOKLIŲ;3863971540;Taip;0;6;0;6
17004;Justinukas;SVAJOKLIŲ;43527855441;Taip;0;1;0;1
17005;Justinukas;SVAJOKLIŲ;16029286933;Taip;0;2;0;2
17006;Justinukas;SVAJOKLIŲ;8971898312;Taip;14;3;0;17
17007;Justinukas;SVAJOKLIŲ;48101258124;Taip;0;5;0;5
17008;Justinukas;SVAJOKLIŲ;1216138998;Taip;0;17;0;17
17009;Justinukas;SVAJOKLIŲ;1814943669;Taip;0;1;0;1
17010;Justinukas;SVAJOKLIŲ;37288931495;Taip;8;0;0;8
17011;Justinukas;SVAJOKLIŲ;8636869322;Ne;15;0;0;15
17012;Justinukas;SVAJOKLIŲ;6766493175;Taip;0;2;0;2
17013;Justinukas;SVAJOKLIŲ;5494500249;Taip;0;2;0;2
17014;Justinukas;SVAJOKLIŲ;6816901962;Taip;0;9;0;9
17015;Justinukas;SVAJOKLIŲ;3657642693;Taip;8;2;0;10
17016;Justinukas;"SAULĖS ZUIKIŲ";1550323727;Taip;2;2;0;4
17017;Justinukas;"SAULĖS ZUIKIŲ";40999006978;Taip;0;1;0;1
17018;Justinukas;"SAULĖS ZUIKIŲ";29875250126;Taip;0;0;1;1
17019;Justinukas;"SAULĖS ZUIKIŲ";3813820356;Taip;15;1;0;16
17020;Justinukas;"SAULĖS ZUIKIŲ";3215259838;Taip;17;1;0;18
17021;Justinukas;"SAULĖS ZUIKIŲ";66240994100;Taip;0;5;0;5
17022;Justinukas;"SAULĖS ZUIKIŲ";8350429513;Taip;11;0;0;11
17023;Justinukas;"SAULĖS ZUIKIŲ";2532510817;Taip;0;2;0;2
17024;Justinukas;"SAULĖS ZUIKIŲ";52253951149;Taip;0;4;0;4
17025;Justinukas;"SAULĖS ZUIKIŲ";9411813711;Taip;7;1;0;8
17026;Justinukas;"SAULĖS ZUIKIŲ";1806484271;Ne;0;1;0;1
17027;Justinukas;"SAULĖS ZUIKIŲ";78270625975;Taip;21;0;0;21
17028;Justinukas;"SAULĖS ZUIKIŲ";5215250778;Taip;16;0;0;16
17029;Justinukas;"SAULĖS ZUIKIŲ";49880907488;Taip;3;0;0;3
17030;Justinukas;"SAULĖS ZUIKIŲ";76257661228;Taip;0;4;0;4
17031;Justinukas;"SAULĖS ZUIKIŲ";1967313365;Taip;0;0;5;5
17032;Justinukas;"SAULĖS ZUIKIŲ";56402748009;Taip;0;1;0;1
17033;Justinukas;PABIRUČIŲ;7727870261;Ne;11;3;0;14
17034;Justinukas;PABIRUČIŲ;6482808707;Taip;11;1;0;12
17035;Justinukas;PABIRUČIŲ;4756483798;Ne;11;0;0;11
17036;Justinukas;PABIRUČIŲ;3206751576;Taip;0;3;0;3
17037;Justinukas;PABIRUČIŲ;6470287041;Taip;13;0;0;13
17038;Justinukas;PABIRUČIŲ;3268913601;Taip;14;0;0;14
17039;Justinukas;PABIRUČIŲ;2017929633;Taip;2;2;0;4
17040;Justinukas;PABIRUČIŲ;7710916537;Taip;15;1;0;16
17041;Justinukas;PABIRUČIŲ;4194429972;Ne;14;1;0;15
17042;Justinukas;PABIRUČIŲ;8913463448;Ne;16;0;0;16
17043;Justinukas;PABIRUČIŲ;7854674833;Taip;5;1;0;6
17044;Justinukas;PABIRUČIŲ;3768735503;Taip;18;0;0;18
17045;Justinukas;PABIRUČIŲ;2241816838;Taip;6;0;0;6
17046;Justinukas;PABIRUČIŲ;8086378912;Taip;12;0;0;12
17047;Justinukas;PABIRUČIŲ;4271601149;Taip;0;1;0;1
17048;Justinukas;PABIRUČIŲ;8603454290;Taip;10;2;0;12
17049;Justinukas;PABIRUČIŲ;5928377774;Taip;16;0;0;16
17050;Justinukas;PABIRUČIŲ;4698732792;Taip;7;0;0;7
17051;Justinukas;PABIRUČIŲ;5524861976;Taip;0;1;0;1
17052;Justinukas;PABIRUČIŲ;2160089993;Taip;9;0;0;9
17053;Justinukas;PABIRUČIŲ;8878782037;Taip;5;1;2;8
17054;Justinukas;PABIRUČIŲ;2585198498;Taip;15;0;0;15
17055;Justinukas;VYTURIUKŲ;1319540676;Taip;0;3;1;4
17056;Justinukas;VYTURIUKŲ;1585956968;Taip;9;1;0;10
17057;Justinukas;VYTURIUKŲ;4056697803;Taip;0;16;0;16
17058;Justinukas;VYTURIUKŲ;1181972027;Taip;0;7;0;7
17059;Justinukas;VYTURIUKŲ;59176678396;Taip;7;1;0;8
17060;Justinukas;VYTURIUKŲ;1598234416;Taip;0;1;0;1
17061;Justinukas;VYTURIUKŲ;1555183700;Taip;12;2;0;14
17062;Justinukas;VYTURIUKŲ;1785794727;Taip;10;1;0;11
17063;Justinukas;VYTURIUKŲ;99512297006;Taip;7;2;0;9
17064;Justinukas;VYTURIUKŲ;28095047700;Taip;6;3;0;9
17065;Justinukas;VYTURIUKŲ;91620507403;Taip;3;0;1;4
17066;Justinukas;VYTURIUKŲ;35192728896;Taip;0;6;0;6
17067;Justinukas;VYTURIUKŲ;13774489893;Taip;10;4;2;16
17068;Justinukas;VYTURIUKŲ;2002649360;Taip;5;2;0;7
17069;Justinukas;VYTURIUKŲ;30823793919;Taip;0;0;1;1
17070;Justinukas;VYTURIUKŲ;1956705813;Taip;0;0;1;1
17071;Justinukas;VYTURIUKŲ;89330918024;Ne;6;0;0;6
17072;Justinukas;VYTURIUKŲ;49578167204;Taip;0;2;0;2
17073;Justinukas;VYTURIUKŲ;1490500434;Ne;12;2;0;14
17074;Justinukas;KODĖLČIUKŲ;5876182759;Taip;5;2;0;7
17075;Justinukas;KODĖLČIUKŲ;8566530492;Taip;0;7;0;7
17076;Justinukas;KODĖLČIUKŲ;9226989209;Taip;5;0;0;5
17077;Justinukas;KODĖLČIUKŲ;1341026177;Taip;2;0;0;2
17078;Justinukas;KODĖLČIUKŲ;2268124610;Taip;0;5;0;5
17079;Justinukas;KODĖLČIUKŲ;5978993456;Taip;11;6;0;17
17080;Justinukas;KODĖLČIUKŲ;5870609685;Ne;12;1;0;13
17081;Justinukas;KODĖLČIUKŲ;8965456115;Taip;0;1;0;1
17082;Justinukas;KODĖLČIUKŲ;8874979704;Taip;3;5;0;8
17083;Justinukas;KODĖLČIUKŲ;3193143474;Taip;4;0;0;4
17084;Justinukas;KODĖLČIUKŲ;3013789713;Taip;0;1;0;1
17085;Justinukas;KODĖLČIUKŲ;3611504027;Taip;0;10;0;10
17086;Justinukas;KODĖLČIUKŲ;8650379074;Taip;21;0;0;21
17087;Justinukas;KODĖLČIUKŲ;6886461269;Taip;6;0;0;6
17088;Justinukas;KODĖLČIUKŲ;2594906884;Taip;15;0;0;15
17089;Justinukas;KODĖLČIUKŲ;5922926572;Taip;0;2;0;2
17090;Justinukas;KODĖLČIUKŲ;2808141352;Taip;10;0;0;10
17091;Justinukas;KODĖLČIUKŲ;7066065324;Taip;10;0;0;10
17092;Justinukas;VIKRUOLIŲ;57621616956;Taip;6;1;0;7
17093;Justinukas;VIKRUOLIŲ;59108759161;Taip;4;0;1;5
17094;Justinukas;VIKRUOLIŲ;2776259830;Taip;0;1;0;1
17095;Justinukas;VIKRUOLIŲ;79934530654;Taip;0;4;0;4
17096;Justinukas;VIKRUOLIŲ;95467011497;Ne;0;7;0;7
17097;Justinukas;VIKRUOLIŲ;48732379120;Ne;0;1;0;1
17098;Justinukas;VIKRUOLIŲ;1844038414;Taip;3;7;0;10
17099;Justinukas;VIKRUOLIŲ;2952798555;Taip;4;0;1;5
17100;Justinukas;VIKRUOLIŲ;54102488427;Taip;0;4;0;4
17101;Justinukas;VIKRUOLIŲ;28543773229;Taip;3;1;0;4
17102;Justinukas;VIKRUOLIŲ;68853730495;Taip;0;2;0;2
17103;Justinukas;VIKRUOLIŲ;70062275466;Taip;2;2;0;4
17104;Justinukas;VIKRUOLIŲ;80827159258;Taip;6;0;0;6
17105;Justinukas;VIKRUOLIŲ;311074533;Taip;21;0;0;21
17106;Justinukas;VIKRUOLIŲ;7120661911;Taip;0;1;0;1
17107;Justinukas;VIKRUOLIŲ;55151392377;Taip;0;2;0;2
17108;Justinukas;VIKRUOLIŲ;1955952962;Ne;0;6;0;6
17109;Justinukas;VIKRUOLIŲ;1480054888;Taip;11;0;0;11
17110;Justinukas;VIKRUOLIŲ;5199005933;Taip;6;2;0;8
17111;Justinukas;VIKRUOLIŲ;2120659659;Taip;10;0;0;10
17112;Justinukas;PELEDŽIUKŲ;6268022925;Taip;15;0;1;16
17113;Justinukas;PELEDŽIUKŲ;1405642653;Taip;0;2;0;2
17114;Justinukas;PELEDŽIUKŲ;1976450069;Taip;0;0;3;3
17115;Justinukas;PELEDŽIUKŲ;90692179185;Taip;0;8;0;8
17116;Justinukas;PELEDŽIUKŲ;61301662234;Taip;0;9;0;9
17117;Justinukas;PELEDŽIUKŲ;2027779101;Ne;0;1;2;3
17118;Justinukas;PELEDŽIUKŲ;8742157840;Taip;0;1;0;1
17119;Justinukas;PELEDŽIUKŲ;55089909579;Taip;5;1;0;6
17120;Justinukas;PELEDŽIUKŲ;12741015006;Ne;0;9;0;9
17121;Justinukas;PELEDŽIUKŲ;48908098476;Taip;0;5;0;5
17122;Justinukas;PELEDŽIUKŲ;1956136425;Taip;0;5;0;5
17123;Justinukas;PELEDŽIUKŲ;8748370028;Taip;10;0;5;15
17124;Justinukas;PELEDŽIUKŲ;5282345380;Ne;10;3;0;13
17125;Justinukas;PELEDŽIUKŲ;5610993611;Taip;0;1;0;1
17126;Justinukas;PELEDŽIUKŲ;67366895767;Taip;0;6;0;6
17127;Justinukas;PELEDŽIUKŲ;3427720250;Ne;0;0;2;2
17128;Justinukas;ŽIRNIUKŲ;1447493567;Taip;6;0;14;20
17129;Justinukas;ŽIRNIUKŲ;4328855128;Taip;0;7;0;7
17130;Justinukas;ŽIRNIUKŲ;8185266162;Taip;15;0;0;15
17131;Justinukas;ŽIRNIUKŲ;9569479551;Taip;1;0;0;1
17132;Justinukas;ŽIRNIUKŲ;6184892609;Taip;8;0;1;9
17133;Justinukas;ŽIRNIUKŲ;8242805821;Taip;4;0;13;17
17134;Justinukas;ŽIRNIUKŲ;1779138446;Taip;2;0;0;2
17135;Justinukas;ŽIRNIUKŲ;4897823765;Ne;10;2;0;12
17136;Justinukas;ŽIRNIUKŲ;3777745443;Taip;21;0;0;21
17137;Justinukas;ŽIRNIUKŲ;8564006025;Taip;21;0;0;21
17138;Justinukas;ŽIRNIUKŲ;5490753578;Taip;18;0;0;18
17139;Justinukas;ŽIRNIUKŲ;5711628356;Taip;2;2;1;5
17140;Justinukas;ŽIRNIUKŲ;4699181819;Taip;2;4;0;6
17141;Justinukas;ŽIRNIUKŲ;9151163087;Taip;0;1;0;1
17142;Justinukas;ŽIRNIUKŲ;6984802993;Taip;0;0;2;2
17143;Justinukas;GUDRUČIŲ;2495027317;Taip;18;3;0;21
17144;Justinukas;GUDRUČIŲ;5337728911;Taip;10;4;0;14
17145;Justinukas;GUDRUČIŲ;2378107030;Taip;9;2;0;11
17146;Justinukas;GUDRUČIŲ;7031501155;Taip;6;1;0;7
17147;Justinukas;GUDRUČIŲ;9714895573;Taip;0;6;0;6
17148;Justinukas;GUDRUČIŲ;7135292839;Taip;0;0;2;2
17149;Justinukas;GUDRUČIŲ;9037601873;Taip;8;2;0;10
17150;Justinukas;GUDRUČIŲ;7035968183;Taip;7;3;0;10
17151;Justinukas;GUDRUČIŲ;5583929465;Taip;9;1;0;10
17152;Justinukas;GUDRUČIŲ;8874149122;Taip;0;0;1;1
17153;Justinukas;GUDRUČIŲ;4169517353;Taip;5;0;0;5
17154;Justinukas;GUDRUČIŲ;3138582167;Taip;2;8;0;10
17155;Justinukas;GUDRUČIŲ;3082687604;Taip;13;0;0;13
17156;Justinukas;GUDRUČIŲ;7989662358;Taip;6;0;0;6
17157;Justinukas;GUDRUČIŲ;2362568676;Taip;17;0;0;17
17158;Justinukas;GUDRUČIŲ;9413817052;Taip;0;1;1;2
17159;Justinukas;BORUŽIUKŲ;6897988246;Taip;0;2;2;4
17160;Justinukas;BORUŽIUKŲ;4542350401;Taip;10;1;0;11
17161;Justinukas;BORUŽIUKŲ;4347647695;Taip;16;0;0;16
17162;Justinukas;BORUŽIUKŲ;3388483002;Taip;12;0;1;13
17163;Justinukas;BORUŽIUKŲ;9998493076;Taip;0;1;0;1
17164;Justinukas;BORUŽIUKŲ;1129392970;Taip;2;0;0;2
17165;Justinukas;BORUŽIUKŲ;8281005516;Taip;16;0;0;16
17166;Justinukas;BORUŽIUKŲ;1398976932;Taip;1;0;2;3
17167;Justinukas;BORUŽIUKŲ;9823188609;Taip;0;8;1;9
17168;Justinukas;BORUŽIUKŲ;1977242147;Taip;15;0;0;15
17169;Justinukas;BORUŽIUKŲ;4574673585;Taip;0;1;0;1
17170;Justinukas;BORUŽIUKŲ;7006338378;Taip;11;1;0;12
17171;Justinukas;BORUŽIUKŲ;7166828675;Ne;10;0;6;16
17172;Justinukas;BORUŽIUKŲ;39916867354;Taip;0;1;0;1
17173;Justinukas;BORUŽIUKŲ;4010638658;Taip;0;1;0;1
17174;Justinukas;BORUŽIUKŲ;1172609518;Ne;13;0;2;15
17175;Justinukas;BORUŽIUKŲ;1616324236;Taip;0;1;0;1
17176;Justinukas;BORUŽIUKŲ;3030820917;Taip;0;6;6;12
17177;Justinukas;BORUŽIUKŲ;4430183106;Ne;16;1;1;18
17178;Justinukas;BORUŽIUKŲ;1507699415;Taip;7;2;0;9
17179;Aidas;Boružėlių;8915901727;Taip;0;1;0;1
17180;Aidas;Boružėlių;5311183877;Taip;1;4;0;5
17181;Aidas;Boružėlių;5962551687;Taip;6;1;0;7
17182;Aidas;Drugelių;5346078886;Taip;0;1;0;1
17183;Aidas;Drugelių;7094228848;Ne;0;3;0;3
17184;Aidas;Drugelių;5560434420;Ne;0;3;0;3
17185;Aidas;Aitvariukų;1505697405;Ne;0;1;0;1
17186;Aidas;Aitvariukų;6835234112;Taip;0;1;0;1
17187;Aidas;Aitvariukų;3473596157;Taip;0;3;0;3
17188;Aidas;Aitvariukų;3748420427;Taip;0;1;0;1
17189;Aidas;"Meškučių kl.";2970002617;Ne;0;1;0;1
17190;Aidas;"Meškučių kl.";8177181962;Ne;0;1;0;1
17191;Aidas;"Meškučių kl.";4980030389;Ne;0;1;0;1
17192;Aidas;"Meškučių kl.";5806540190;Taip;0;1;0;1
17193;Aidas;"Meškučių kl.";7803641933;Ne;0;1;0;1
17194;Aidas;"Meškučių kl.";8056436399;Ne;0;1;0;1
17195;Aidas;"Meškučių kl.";5100740847;Ne;0;1;0;1
17196;Aidas;"Meškučių kl.";8377829773;Ne;0;1;0;1
17197;Aidas;"Gaidelių kl.";3442250711;Ne;0;6;0;6
17198;Aidas;"Gaidelių kl.";6213577188;Ne;9;4;0;13
17199;Aidas;"Gaidelių kl.";2446003793;Ne;0;1;0;1
17200;Aidas;"Gaidelių kl.";7740504510;Ne;0;1;0;1
17201;Aidas;"Gaidelių kl.";2681438925;Ne;0;3;0;3
17202;Aidas;"Gaidelių kl.";2234931428;Ne;0;1;0;1
17203;Aidas;"Kiškelių kl";5388697695;Ne;0;1;0;1
17204;Aidas;"Kiškelių kl";7354905114;Ne;1;3;0;4
17205;Aidas;"Kiškelių kl";6868265902;Ne;0;1;0;1
17206;Aidas;"Kiškelių kl";4738867530;Taip;0;1;0;1
17207;Aidas;"Kiškelių kl";5905008395;Ne;0;1;0;1
17208;Aidas;"Kiškelių kl";9613466086;Taip;10;1;0;11
17209;Aidas;"Ančiukų kl.";9816043688;Ne;0;8;0;8
17210;Aidas;"Ančiukų kl.";20604410476;Ne;0;1;0;1
17211;Aidas;"Ančiukų kl.";63508565206;Ne;0;1;0;1
17212;Aidas;"Ančiukų kl.";1079077463;Taip;0;2;0;2
17213;Aidas;"Ančiukų kl.";3194974747;Ne;0;1;0;1
17214;Aidas;"Ančiukų kl.";72751441075;Taip;0;1;0;1
17215;Aidas;"Ančiukų kl.";2000234311;Taip;0;1;0;1
17216;Aidas;"Ančiukų kl.";3366848846;Taip;15;1;0;16
17217;Aidas;"Ančiukų kl.";17920063762;Taip;5;1;0;6
17218;Aidas;"Ančiukų kl.";2954393415;Taip;0;1;0;1
17219;Aidas;"Pelėdžiukų kl.";5326012529;Ne;0;1;0;1
17220;Aidas;"Pelėdžiukų kl.";5655286565;Ne;0;1;0;1
17221;Aidas;"Pelėdžiukų kl.";3279914631;Ne;0;3;0;3
17222;Aidas;"Pelėdžiukų kl.";7148658584;Ne;0;1;0;1
17223;Aidas;"Pelėdžiukų kl.";2945444897;Taip;0;4;0;4
17224;Aidas;"Papūgėlių kl.";3447250754;Ne;0;1;0;1
17225;Aidas;"Papūgėlių kl.";3352587395;Ne;0;1;0;1
17226;Aidas;"Papūgėlių kl.";4372628947;Ne;0;4;0;4
17227;Aidas;"Papūgėlių kl.";7821044288;Ne;0;1;0;1
17228;Aidas;"Papūgėlių kl.";1010885560;Ne;0;1;0;1
17229;Aidas;"Papūgėlių kl.";1322335360;Taip;0;1;0;1
17230;Aidas;"Papūgėlių kl.";3808707012;Ne;0;2;0;2
17231;Aidas;"Papūgėlių kl.";8642665550;Ne;0;6;0;6
17232;Aidas;"Papūgėlių kl.";5309862220;Taip;0;1;0;1
17233;Aidas;"Saulutės kl.";1535004699;Ne;0;16;0;16
17234;Aidas;"Saulutės kl.";62142659591;Taip;7;1;0;8
17235;Aidas;"Saulutės kl.";74897451962;Taip;0;1;0;1
17236;Aidas;"Saulutės kl.";4890362155;Taip;0;1;0;1
17237;Aidas;"Saulutės kl.";6778658540;Taip;0;1;0;1
17238;Aidas;"Saulutės kl.";7329254454;Taip;0;1;0;1
17239;Aidas;"Saulutės kl.";3127870635;Taip;2;0;0;2
17240;Aidas;"Saulutės kl.";1999375828;Taip;0;15;0;15
17241;Aidas;"Katinėlių kl.";6356218442;Ne;0;1;0;1
17242;Aidas;"Katinėlių kl.";4990112920;Taip;0;1;0;1
17243;Aidas;"Katinėlių kl.";92425322676;Ne;0;6;0;6
17244;Aidas;"Katinėlių kl.";4081645294;Ne;0;1;0;1
17245;Aidas;"Katinėlių kl.";81654551230;Taip;0;2;0;2
17246;Aidas;"Katinėlių kl.";1742331213;Ne;4;1;0;5
17247;Aidas;"Katinėlių kl.";9944901942;Ne;0;2;0;2
17248;Bangelė;Aštuonkojai;1953702121;Taip;5;0;2;7
17249;Bangelė;Aštuonkojai;22773040549;Taip;0;0;10;10
17250;Bangelė;Aštuonkojai;1377575533;Taip;7;0;1;8
17251;Bangelė;Aštuonkojai;7059603451;Taip;0;6;0;6
17252;Bangelė;Aštuonkojai;2045465669;Taip;9;1;0;10
17253;Bangelė;Aštuonkojai;5142785037;Taip;0;1;0;1
17254;Bangelė;Aštuonkojai;4865289474;Taip;14;0;0;14
17255;Bangelė;Aštuonkojai;5135762163;Taip;0;10;4;14
17256;Bangelė;Aštuonkojai;6559186441;Taip;11;0;2;13
17257;Bangelė;Aštuonkojai;95548866362;Taip;0;10;0;10
17258;Bangelė;Aštuonkojai;4187165474;Taip;10;0;0;10
17259;Bangelė;Aštuonkojai;1594486275;Taip;0;4;0;4
17260;Bangelė;Aštuonkojai;6508452044;Taip;0;6;0;6
17261;Bangelė;Aštuonkojai;6739499483;Ne;8;0;4;12
17262;Bangelė;Delfinukai,;2503946448;Taip;9;0;0;9
17263;Bangelė;Delfinukai,;2027892816;Taip;8;0;3;11
17264;Bangelė;Delfinukai,;3338203753;Taip;0;0;1;1
17265;Bangelė;Delfinukai,;9150185864;Taip;0;0;4;4
17266;Bangelė;Delfinukai,;1661384764;Ne;0;0;4;4
17267;Bangelė;Delfinukai,;9341038058;Taip;0;0;1;1
17268;Bangelė;Delfinukai,;6173470021;Taip;13;0;0;13
17269;Bangelė;Delfinukai,;1728085772;Taip;5;1;1;7
17270;Bangelė;Delfinukai,;55668308050;Taip;0;13;0;13
17271;Bangelė;Delfinukai,;1032881464;Ne;15;0;0;15
17272;Bangelė;Delfinukai,;5950451237;Taip;6;0;0;6
17273;Bangelė;Delfinukai,;1377734102;Taip;8;0;1;9
17274;Bangelė;Delfinukai,;5504180016;Taip;0;0;6;6
17275;Bangelė;Delfinukai,;6927540308;Taip;7;1;1;9
17276;Bangelė;Delfinukai,;4122927034;Ne;5;10;0;15
17277;Bangelė;Delfinukai,;4401389067;Ne;0;1;1;2
17278;Bangelė;Delfinukai,;9464115339;Taip;18;0;0;18
17279;Bangelė;Delfinukai,;9397947662;Taip;0;4;0;4
17280;Bangelė;"Saulės spindulėliai";81379253837;Ne;0;1;6;7
17281;Bangelė;"Saulės spindulėliai";20827674346;Taip;8;2;0;10
17282;Bangelė;"Saulės spindulėliai";83691968186;Taip;0;14;0;14
17283;Bangelė;"Saulės spindulėliai";76618850202;Taip;0;1;0;1
17284;Bangelė;"Saulės spindulėliai";84855013193;Taip;0;1;0;1
17285;Bangelė;"Saulės spindulėliai";51571795638;Ne;0;1;0;1
17286;Bangelė;"Saulės spindulėliai";68082711504;Taip;0;1;0;1
17287;Bangelė;"Saulės spindulėliai";18979714088;Taip;0;6;0;6
17288;Bangelė;"Saulės spindulėliai";89458174517;Taip;2;1;0;3
17289;Bangelė;"Saulės spindulėliai";24895047229;Taip;0;10;0;10
17290;Bangelė;"Saulės spindulėliai";45145282759;Ne;7;1;0;8
17291;Bangelė;"Saulės spindulėliai";2067377559;Taip;0;3;0;3
17292;Bangelė;"Saulės spindulėliai";1312545465;Taip;0;2;0;2
17293;Bangelė;"Saulės spindulėliai";8280327053;Ne;0;0;3;3
17294;Bangelė;"Saulės spindulėliai";1862514267;Taip;0;2;0;2
17295;Bangelė;"Saulės spindulėliai";61812452736;Taip;0;0;2;2
17296;Bangelė;"Pingvinukai ";1390623903;Taip;0;8;0;8
17297;Bangelė;"Pingvinukai ";6145050734;Taip;11;0;0;11
17298;Bangelė;"Pingvinukai ";3634678954;Taip;7;1;0;8
17299;Bangelė;"Pingvinukai ";2156837975;Taip;6;0;0;6
17300;Bangelė;"Pingvinukai ";3063439996;Ne;21;0;0;21
17301;Bangelė;"Pingvinukai ";6953698592;Taip;3;1;2;6
17302;Bangelė;"Pingvinukai ";1754002501;Taip;6;0;0;6
17303;Bangelė;"Pingvinukai ";1351714626;Taip;11;0;0;11
17304;Bangelė;"Pingvinukai ";8336001702;Ne;6;0;6;12
17305;Bangelė;"Pingvinukai ";5546256869;Taip;12;0;0;12
17306;Bangelė;"Pingvinukai ";8748218387;Ne;6;0;0;6
17307;Bangelė;"Pingvinukai ";6980232224;Ne;0;1;3;4
17308;Bangelė;"Pingvinukai ";8875703109;Taip;0;1;0;1
17309;Bangelė;"Pingvinukai ";9842873660;Ne;8;5;1;14
17310;Bangelė;"Pingvinukai ";3696611509;Taip;18;0;0;18
17311;Bangelė;"Pingvinukai ";3022508446;Taip;7;1;2;10
17312;Bangelė;"Pingvinukai ";9788923823;Taip;17;0;0;17
17313;Bangelė;Žuvytės;9983202427;Ne;11;1;1;13
17314;Bangelė;Žuvytės;47454787439;Taip;11;0;0;11
17315;Bangelė;Žuvytės;2112394008;Taip;5;1;4;10
17316;Bangelė;Žuvytės;4571869439;Taip;0;1;0;1
17317;Bangelė;Žuvytės;6712145066;Taip;8;0;0;8
17318;Bangelė;Žuvytės;1528387105;Taip;7;1;0;8
17319;Bangelė;Žuvytės;4506651162;Taip;10;0;0;10
17320;Bangelė;Žuvytės;9672505885;Taip;11;0;1;12
17321;Bangelė;Žuvytės;7248631013;Taip;12;0;0;12
17322;Bangelė;Žuvytės;7723290276;Taip;15;0;0;15
17323;Bangelė;Žuvytės;9822287576;Taip;16;0;5;21
17324;Bangelė;Žuvytės;7375004714;Ne;17;0;2;19
17325;Bangelė;Žuvytės;7701956270;Taip;0;0;5;5
17326;Bangelė;Žuvytės;1367082230;Taip;11;0;1;12
17327;Bangelė;Žuvytės;1348995498;Ne;7;7;0;14
17328;Bangelė;Ruoniai;76353372848;Taip;0;1;2;3
17329;Bangelė;Ruoniai;99771696381;Taip;0;2;0;2
17330;Bangelė;Ruoniai;17608442103;Taip;0;7;0;7
17331;Bangelė;Ruoniai;60823401986;Taip;0;1;2;3
17332;Bangelė;Ruoniai;84797019693;Ne;3;4;0;7
17333;Bangelė;Ruoniai;91953522637;Taip;0;0;1;1
17334;Bangelė;Ruoniai;99823581960;Taip;0;5;0;5
17335;Bangelė;Ruoniai;2423625777;Taip;0;1;7;8
17336;Bangelė;Ruoniai;77615973000;Taip;0;1;1;2
17337;Bangelė;Ruoniai;411039166;Taip;0;5;0;5
17338;Bangelė;Ruoniai;3115177810;Ne;5;0;1;6
17339;Bangelė;Ruoniai;1790881495;Taip;5;1;0;6
17340;Bangelė;Ruoniai;1683377649;Taip;0;5;0;5
17341;Bangelė;Ruoniai;7114709352;Taip;19;0;0;19
17342;Bangelė;Ruoniai;5159962168;Taip;6;6;0;12
17343;Bangelė;Ruoniai;1065164865;Taip;0;0;12;12
17344;Bangelė;Ruoniai;2195543161;Ne;0;0;1;1
17345;Bangelė;Ruoniai;42739113312;Ne;0;0;2;2
17346;Bangelė;"Pagrandukai ";4250589212;Taip;12;0;1;13
17347;Bangelė;"Pagrandukai ";4036461205;Taip;0;2;0;2
17348;Bangelė;"Pagrandukai ";7434358474;Taip;0;8;0;8
17349;Bangelė;"Pagrandukai ";7434879947;Taip;2;0;0;2
17350;Bangelė;"Pagrandukai ";2491928697;Taip;9;3;0;12
17351;Bangelė;"Pagrandukai ";6819322060;Taip;0;0;3;3
17352;Bangelė;"Pagrandukai ";9790680407;Taip;14;0;0;14
17353;Bangelė;"Pagrandukai ";8535477233;Taip;0;0;3;3
17354;Bangelė;"Pagrandukai ";8575020060;Taip;0;1;2;3
17355;Bangelė;"Pagrandukai ";5747403413;Ne;0;2;0;2
17356;Bangelė;"Pagrandukai ";6480681705;Taip;0;2;0;2
17357;Bangelė;"Zuikučiai ";9954762483;Taip;8;3;0;11
17358;Bangelė;"Zuikučiai ";5597329949;Taip;11;4;0;15
17359;Bangelė;"Zuikučiai ";4494049529;Taip;0;0;3;3
17360;Bangelė;"Zuikučiai ";9268294844;Taip;6;0;0;6
17361;Bangelė;"Zuikučiai ";9980881014;Taip;0;0;1;1
17362;Bangelė;"Zuikučiai ";4532810332;Taip;15;0;2;17
17363;Bangelė;"Zuikučiai ";2946714377;Taip;0;1;0;1
17364;Bangelė;"Zuikučiai ";3016778137;Taip;21;0;0;21
17365;Bangelė;"Zuikučiai ";3334029244;Taip;11;0;1;12
17366;Bangelė;"Zuikučiai ";7174742281;Taip;15;2;0;17
17367;Bangelė;"Zuikučiai ";6806911810;Taip;10;3;0;13
17368;Gėlynas;PAKALNUTĖ;6375754699;Taip;0;0;1;1
17369;Gėlynas;PAKALNUTĖ;2349352560;Taip;0;1;0;1
17370;Gėlynas;PAKALNUTĖ;4445250490;Taip;0;1;0;1
17371;Gėlynas;PAKALNUTĖ;9911225363;Taip;5;1;0;6
17372;Gėlynas;PAKALNUTĖ;1257113113;Taip;2;0;0;2
17373;Gėlynas;PAKALNUTĖ;2906909558;Taip;0;0;3;3
17374;Gėlynas;PAKALNUTĖ;3365442661;Taip;0;0;8;8
17375;Gėlynas;PAKALNUTĖ;77283628988;Ne;0;4;0;4
17376;Gėlynas;PAKALNUTĖ;6528464599;Taip;0;0;7;7
17377;Gėlynas;PAKALNUTĖ;8464074679;Taip;7;1;3;11
17378;Gėlynas;PAKALNUTĖ;5395474698;Taip;0;3;0;3
17379;Gėlynas;PAKALNUTĖ;8615943743;Taip;4;1;0;5
17380;Gėlynas;PAKALNUTĖ;7814357385;Taip;7;0;0;7
17381;Gėlynas;PAKALNUTĖ;1674569569;Taip;1;2;0;3
17382;Gėlynas;PAKALNUTĖ;5695333666;Taip;0;2;0;2
17383;Gėlynas;PAKALNUTĖ;2348787949;Taip;6;0;0;6
17384;Gėlynas;VARPELIS;72991081966;Taip;0;1;0;1
17385;Gėlynas;VARPELIS;14307514975;Taip;4;0;0;4
17386;Gėlynas;VARPELIS;93919808581;Taip;0;7;0;7
17387;Gėlynas;VARPELIS;31532261756;Taip;0;6;0;6
17388;Gėlynas;VARPELIS;7735904549;Ne;0;2;0;2
17389;Gėlynas;VARPELIS;99637531213;Taip;0;1;0;1
17390;Gėlynas;VARPELIS;85912494214;Taip;0;1;0;1
17391;Gėlynas;VARPELIS;22067595840;Taip;6;1;0;7
17392;Gėlynas;VARPELIS;75827864070;Taip;0;6;0;6
17393;Gėlynas;VARPELIS;91530210644;Ne;0;1;0;1
17394;Gėlynas;VARPELIS;75222833700;Taip;4;1;0;5
17395;Gėlynas;VARPELIS;95681874019;Taip;0;2;0;2
17396;Gėlynas;VARPELIS;40702362906;Taip;0;1;0;1
17397;Gėlynas;VARPELIS;1406567756;Taip;0;8;0;8
17398;Gėlynas;VARPELIS;58542813068;Ne;0;1;0;1
17399;Gėlynas;VARPELIS;23134075402;Taip;0;1;0;1
17400;Gėlynas;VARPELIS;63379609794;Taip;0;7;0;7
17401;Gėlynas;VARPELIS;2100188574;Taip;0;11;0;11
17402;Gėlynas;VARPELIS;16850449718;Taip;4;0;0;4
17403;Gėlynas;RAKTAŽOLĖ;1797681067;Taip;0;1;0;1
17404;Gėlynas;RAKTAŽOLĖ;1117528954;Ne;7;1;0;8
17405;Gėlynas;RAKTAŽOLĖ;57429063547;Taip;4;11;0;15
17406;Gėlynas;RAKTAŽOLĖ;7796794153;Taip;0;1;0;1
17407;Gėlynas;RAKTAŽOLĖ;6264361257;Ne;0;12;0;12
17408;Gėlynas;RAKTAŽOLĖ;1047462165;Taip;0;1;0;1
17409;Gėlynas;RAKTAŽOLĖ;1754734306;Ne;0;6;0;6
17410;Gėlynas;RAKTAŽOLĖ;9780911032;Taip;0;7;0;7
17411;Gėlynas;RAKTAŽOLĖ;84546885977;Ne;7;9;0;16
17412;Gėlynas;RAKTAŽOLĖ;5135747448;Taip;0;2;0;2
17413;Gėlynas;RAKTAŽOLĖ;7808971151;Taip;10;1;0;11
17414;Gėlynas;RAKTAŽOLĖ;1036951275;Taip;0;0;1;1
17415;Gėlynas;RAKTAŽOLĖ;7337987259;Taip;0;2;0;2
17416;Gėlynas;RAKTAŽOLĖ;9026298982;Ne;0;8;0;8
17417;Gėlynas;RAKTAŽOLĖ;4382465307;Taip;19;1;0;20
17418;Gėlynas;RAKTAŽOLĖ;3890687425;Taip;0;5;0;5
17419;Gėlynas;RAKTAŽOLĖ;7562201835;Taip;0;3;0;3
17420;Gėlynas;RAKTAŽOLĖ;3572020585;Taip;0;1;0;1
17421;Gėlynas;RAKTAŽOLĖ;1557503831;Taip;0;0;2;2
17422;Gėlynas;RAKTAŽOLĖ;2417880374;Taip;0;0;3;3
17423;Gėlynas;SAULĖGRĄŽA;1995694892;Taip;0;0;2;2
17424;Gėlynas;SAULĖGRĄŽA;1191494598;Taip;0;0;2;2
17425;Gėlynas;SAULĖGRĄŽA;1407350449;Taip;7;0;2;9
17426;Gėlynas;SAULĖGRĄŽA;1676904275;Taip;0;0;3;3
17427;Gėlynas;SAULĖGRĄŽA;2050384850;Taip;0;5;0;5
17428;Gėlynas;SAULĖGRĄŽA;85310323038;Taip;0;2;0;2
17429;Gėlynas;SAULĖGRĄŽA;47220216751;Taip;0;2;0;2
17430;Gėlynas;SAULĖGRĄŽA;2099722437;Taip;2;1;0;3
17431;Gėlynas;SAULĖGRĄŽA;86881175896;Taip;0;7;0;7
17432;Gėlynas;SAULĖGRĄŽA;1608626732;Taip;10;5;0;15
17433;Gėlynas;SAULĖGRĄŽA;17587435701;Taip;9;0;2;11
17434;Gėlynas;SAULĖGRĄŽA;1363040744;Taip;0;1;3;4
17435;Gėlynas;SAULĖGRĄŽA;2018911523;Taip;3;1;13;17
17436;Gėlynas;SAULĖGRĄŽA;1431418368;Taip;5;1;0;6
17437;Gėlynas;SAULĖGRĄŽA;1881249769;Taip;0;1;0;1
17438;Gėlynas;SAULĖGRĄŽA;15277524754;Taip;5;0;0;5
17439;Gėlynas;SAULĖGRĄŽA;8324564359;Taip;2;0;0;2
17440;Gėlynas;RAMUNĖLĖ;6451922757;Taip;11;0;0;11
17441;Gėlynas;RAMUNĖLĖ;3549079170;Taip;14;0;0;14
17442;Gėlynas;RAMUNĖLĖ;4983822000;Taip;5;8;1;14
17443;Gėlynas;RAMUNĖLĖ;5898582218;Taip;0;4;0;4
17444;Gėlynas;RAMUNĖLĖ;2742456983;Taip;10;0;0;10
17445;Gėlynas;RAMUNĖLĖ;5124029118;Ne;0;9;0;9
17446;Gėlynas;RAMUNĖLĖ;6815740588;Ne;0;2;0;2
17447;Gėlynas;RAMUNĖLĖ;5541707540;Taip;0;3;0;3
17448;Gėlynas;RAMUNĖLĖ;5964419627;Taip;10;0;1;11
17449;Gėlynas;RAMUNĖLĖ;4824667762;Taip;0;5;0;5
17450;Gėlynas;RAMUNĖLĖ;2141722631;Taip;3;9;0;12
17451;Gėlynas;RAMUNĖLĖ;1505666690;Taip;0;0;3;3
17452;Gėlynas;RAMUNĖLĖ;3492361041;Taip;0;0;2;2
17453;Gėlynas;RAMUNĖLĖ;4505012978;Taip;0;13;0;13
17454;Gėlynas;RAMUNĖLĖ;3606076029;Taip;0;7;0;7
17455;Gėlynas;ŽIBUTĖ;1015554617;Taip;10;1;0;11
17456;Gėlynas;ŽIBUTĖ;5634213306;Taip;0;0;2;2
17457;Gėlynas;ŽIBUTĖ;5320531856;Taip;0;1;1;2
17458;Gėlynas;ŽIBUTĖ;9724668402;Taip;0;1;0;1
17459;Gėlynas;ŽIBUTĖ;1822933936;Taip;11;0;0;11
17460;Gėlynas;ŽIBUTĖ;8999346908;Taip;5;11;0;16
17461;Gėlynas;ŽIBUTĖ;6114995335;Taip;0;0;6;6
17462;Gėlynas;ŽIBUTĖ;7998013477;Ne;5;0;1;6
17463;Gėlynas;ŽIBUTĖ;9330385153;Taip;0;0;8;8
17464;Gėlynas;ŽIBUTĖ;2784709117;Taip;5;0;0;5
17465;Gėlynas;ŽIBUTĖ;9462822190;Ne;0;1;0;1
17466;Gėlynas;ŽIBUTĖ;9508507084;Taip;0;13;0;13
17467;Gėlynas;ŽIBUTĖ;5291444399;Ne;9;1;0;10
17468;Obelėlė;Bildukai;43664898514;Taip;10;1;0;11
17469;Obelėlė;Bildukai;58388471530;Taip;10;1;0;11
17470;Obelėlė;Bildukai;34628612328;Taip;0;1;3;4
17471;Obelėlė;Bildukai;2024391462;Taip;0;1;0;1
17472;Obelėlė;Bildukai;75737109657;Taip;0;1;2;3
17473;Obelėlė;Bildukai;1466324860;Taip;0;1;0;1
17474;Obelėlė;Bildukai;52857531341;Taip;0;9;0;9
17475;Obelėlė;Bildukai;68222818886;Ne;2;1;1;4
17476;Obelėlė;Bildukai;1831642058;Taip;6;3;0;9
17477;Obelėlė;Bildukai;13913516066;Taip;10;0;0;10
17478;Obelėlė;Bildukai;50077685481;Taip;0;2;0;2
17479;Obelėlė;Bildukai;14986936220;Taip;0;0;8;8
17480;Obelėlė;Bildukai;88058597079;Taip;0;2;1;3
17481;Obelėlė;Bildukai;22986329944;Ne;0;1;1;2
17482;Obelėlė;Bildukai;29677456066;Taip;4;1;0;5
17483;Obelėlė;Bildukai;646883449;Taip;0;1;1;2
17484;Obelėlė;Bildukai;89380447507;Taip;0;1;0;1
17485;Obelėlė;Bildukai;65936525141;Taip;0;5;0;5
17486;Obelėlė;Bildukai;1816297607;Ne;0;1;2;3
17487;Obelėlė;Bildukai;19376935875;Ne;0;1;0;1
17488;Obelėlė;Gudručiai;2014314139;Taip;5;0;1;6
17489;Obelėlė;Gudručiai;9900484892;Taip;14;4;1;19
17490;Obelėlė;Gudručiai;6145113624;Taip;5;0;0;5
17491;Obelėlė;Gudručiai;9586720282;Taip;1;0;0;1
17492;Obelėlė;Gudručiai;9567704282;Taip;4;0;0;4
17493;Obelėlė;Gudručiai;9305279614;Taip;16;0;0;16
17494;Obelėlė;Gudručiai;4015702815;Taip;4;0;6;10
17495;Obelėlė;Gudručiai;5141585309;Taip;0;0;4;4
17496;Obelėlė;Gudručiai;9736557012;Taip;19;0;0;19
17497;Obelėlė;Gudručiai;6720058972;Taip;4;0;0;4
17498;Obelėlė;Gudručiai;4451814487;Taip;21;0;0;21
17499;Obelėlė;Gudručiai;2053807216;Taip;12;0;1;13
17500;Obelėlė;Gudručiai;1184082097;Taip;16;0;0;16
17501;Obelėlė;Gudručiai;6466755394;Taip;0;2;0;2
17502;Obelėlė;Gudručiai;1312484983;Taip;21;0;0;21
17503;Obelėlė;Gudručiai;1565630870;Taip;0;8;0;8
17504;Obelėlė;Gudručiai;1598785483;Taip;16;0;0;16
17505;Obelėlė;Drugeliai;5960204860;Taip;5;7;0;12
17506;Obelėlė;Drugeliai;1874574001;Taip;4;0;0;4
17507;Obelėlė;Drugeliai;1271351257;Taip;10;1;3;14
17508;Obelėlė;Drugeliai;1980250599;Taip;1;0;0;1
17509;Obelėlė;Drugeliai;1185247095;Taip;0;5;0;5
17510;Obelėlė;Drugeliai;8115772385;Taip;0;0;3;3
17511;Obelėlė;Drugeliai;2018689468;Taip;0;1;0;1
17512;Obelėlė;Drugeliai;7120041402;Taip;0;0;3;3
17513;Obelėlė;Drugeliai;9059791812;Taip;0;6;0;6
17514;Obelėlė;Drugeliai;4835765774;Taip;0;0;4;4
17515;Obelėlė;Drugeliai;8173154620;Taip;0;5;1;6
17516;Obelėlė;Drugeliai;46597815116;Taip;0;0;4;4
17517;Obelėlė;Drugeliai;65578250853;Taip;0;0;5;5
17518;Obelėlė;Drugeliai;1044733634;Taip;0;0;1;1
17519;Obelėlė;Drugeliai;1847501295;Taip;14;0;0;14
17520;Obelėlė;Drugeliai;6006139132;Taip;0;0;4;4
17521;Obelėlė;Drugeliai;6676145522;Taip;0;1;1;2
17522;Obelėlė;Drugeliai;6693601673;Taip;10;7;0;17
17523;Obelėlė;Pasakaitė;1695933896;Taip;4;0;2;6
17524;Obelėlė;Pasakaitė;1833543299;Taip;5;0;0;5
17525;Obelėlė;Pasakaitė;1555780072;Taip;0;0;3;3
17526;Obelėlė;Pasakaitė;79601449969;Ne;0;0;4;4
17527;Obelėlė;Pasakaitė;3330983614;Taip;0;1;2;3
17528;Obelėlė;Pasakaitė;4257479486;Taip;0;0;4;4
17529;Obelėlė;Pasakaitė;8394566707;Taip;0;0;5;5
17530;Obelėlė;Pasakaitė;9527363918;Taip;5;0;0;5
17531;Obelėlė;Pasakaitė;10939948244;Taip;0;0;2;2
17532;Obelėlė;Pasakaitė;1707652145;Taip;0;1;0;1
17533;Obelėlė;Pasakaitė;1141707374;Taip;0;1;0;1
17534;Obelėlė;Pasakaitė;6789881144;Taip;0;1;0;1
17535;Obelėlė;Pasakaitė;6036130112;Taip;0;1;2;3
17536;Obelėlė;Pasakaitė;8324404990;Taip;15;0;0;15
17537;Obelėlė;Pasakaitė;1893470952;Taip;4;0;7;11
17538;Obelėlė;Pasakaitė;7754276632;Taip;0;21;0;21
17539;Obelėlė;Svajokliai;7647724926;Taip;0;0;4;4
17540;Obelėlė;Svajokliai;8202131299;Ne;5;1;1;7
17541;Obelėlė;Svajokliai;57788788343;Taip;0;3;0;3
17542;Obelėlė;Svajokliai;2014450377;Taip;0;0;5;5
17543;Obelėlė;Svajokliai;5512990125;Taip;0;1;1;2
17544;Obelėlė;Svajokliai;1824412493;Taip;0;9;0;9
17545;Obelėlė;Svajokliai;2105005710;Taip;0;1;0;1
17546;Obelėlė;Svajokliai;52277220462;Ne;0;1;2;3
17547;Obelėlė;Svajokliai;1210385417;Taip;0;1;6;7
17548;Obelėlė;Svajokliai;8904956649;Ne;0;0;2;2
17549;Obelėlė;Svajokliai;82119081040;Taip;0;0;2;2
17550;Obelėlė;Svajokliai;1536889615;Taip;0;1;1;2
17551;Obelėlė;Svajokliai;1484822838;Taip;0;1;7;8
17552;Obelėlė;Smalsučiai;43103357250;Taip;0;0;2;2
17553;Obelėlė;Smalsučiai;6347375324;Taip;0;3;0;3
17554;Obelėlė;Smalsučiai;1337679766;Taip;0;1;1;2
17555;Obelėlė;Smalsučiai;2107924334;Taip;0;0;1;1
17556;Obelėlė;Smalsučiai;75387550210;Taip;8;0;0;8
17557;Obelėlė;Smalsučiai;72224972200;Taip;0;1;0;1
17558;Obelėlė;Smalsučiai;72467035839;Taip;0;1;9;10
17559;Obelėlė;Smalsučiai;3220190193;Ne;0;1;4;5
17560;Obelėlė;Smalsučiai;39757539751;Taip;0;2;0;2
17561;Obelėlė;Smalsučiai;20691217408;Taip;0;1;0;1
17562;Obelėlė;Smalsučiai;35495444231;Ne;0;0;9;9
17563;Obelėlė;Smalsučiai;97298049429;Taip;0;1;2;3
17564;Obelėlė;Smalsučiai;68776273648;Taip;0;1;6;7
17565;Obelėlė;Smalsučiai;2605865270;Taip;0;0;1;1
17566;Obelėlė;Smalsučiai;1915402358;Taip;1;0;0;1
17567;Obelėlė;Smalsučiai;1758206243;Taip;0;1;2;3
17568;Obelėlė;Smalsučiai;78242377913;Taip;0;1;0;1
17569;Obelėlė;Pabiručiai;1586544097;Taip;0;0;4;4
17570;Obelėlė;Pabiručiai;94350358246;Taip;0;1;0;1
17571;Obelėlė;Pabiručiai;74915473313;Taip;4;1;0;5
17572;Obelėlė;Pabiručiai;79388410820;Taip;0;1;0;1
17573;Obelėlė;Pabiručiai;40103909643;Taip;0;9;0;9
17574;Obelėlė;Pabiručiai;1420633482;Taip;0;0;1;1
17575;Obelėlė;Pabiručiai;1698995389;Taip;0;0;1;1
17576;Obelėlė;Pabiručiai;79669290078;Ne;0;0;1;1
17577;Obelėlė;Pabiručiai;31018018065;Taip;0;0;1;1
17578;Obelėlė;Pabiručiai;2015165566;Ne;1;0;1;2
17579;Obelėlė;Pabiručiai;16430825029;Taip;0;0;1;1
17580;Obelėlė;Pabiručiai;8882103124;Taip;0;0;2;2
17581;Obelėlė;Pabiručiai;5471194804;Taip;0;1;1;2
17582;Obelėlė;Pabiručiai;69055416041;Taip;0;9;0;9
17583;Obelėlė;Pabiručiai;74455701543;Taip;12;0;1;13
17584;Obelėlė;Pabiručiai;74564453474;Taip;0;0;6;6
17585;Obelėlė;Strakaliukai;1706102918;Taip;5;0;4;9
17586;Obelėlė;Strakaliukai;2770477678;Taip;0;13;0;13
17587;Obelėlė;Strakaliukai;8682794598;Taip;0;0;3;3
17588;Obelėlė;Strakaliukai;8754552660;Taip;13;5;0;18
17589;Obelėlė;Strakaliukai;8092024850;Taip;2;0;2;4
17590;Obelėlė;Strakaliukai;9716500560;Taip;4;0;0;4
17591;Obelėlė;Strakaliukai;4251418414;Taip;6;3;0;9
17592;Obelėlė;Strakaliukai;7128421330;Taip;10;0;3;13
17593;Obelėlė;Strakaliukai;5943314566;Taip;0;21;0;21
17594;Obelėlė;Strakaliukai;3116100694;Taip;14;0;0;14
17595;Obelėlė;Strakaliukai;5326258755;Taip;0;3;4;7
17596;Obelėlė;Strakaliukai;5741823041;Taip;0;0;1;1
17597;Obelėlė;Strakaliukai;8050551266;Taip;5;0;1;6
17598;Obelėlė;Strakaliukai;1180508643;Taip;0;1;0;1
17599;Obelėlė;Strakaliukai;7124393375;Taip;0;0;8;8
17600;Obelėlė;Strakaliukai;1040304018;Taip;3;0;0;3
17601;Obelėlė;Strakaliukai;2571249434;Taip;3;0;0;3
17602;Obelėlė;Strakaliukai;7514587933;Taip;0;17;0;17
17603;Obelėlė;Strakaliukai;5001844064;Taip;8;0;1;9
17604;Obelėlė;Saulutė;98290583667;Ne;21;0;0;21
17605;Obelėlė;Saulutė;77954383604;Taip;2;0;0;2
17606;Obelėlė;Saulutė;1826138505;Taip;0;0;1;1
17607;Obelėlė;Saulutė;38968623613;Taip;0;0;4;4
17608;Obelėlė;Saulutė;1741425229;Taip;5;0;2;7
17609;Obelėlė;Saulutė;1336592238;Taip;7;0;1;8
17610;Obelėlė;Saulutė;1240673124;Taip;1;0;0;1
17611;Obelėlė;Saulutė;24010838180;Taip;0;5;0;5
17612;Obelėlė;Saulutė;1935023634;Taip;14;0;1;15
17613;Obelėlė;Saulutė;1061262980;Taip;6;1;1;8
17614;Obelėlė;Saulutė;2099500866;Taip;0;0;1;1
17615;Obelėlė;Saulutė;1352415596;Ne;0;0;4;4
17616;Obelėlė;Saulutė;6054898307;Taip;10;5;0;15
17617;Obelėlė;Saulutė;3076493150;Taip;5;0;4;9
17618;Obelėlė;Saulutė;1521926754;Ne;20;0;0;20
17619;Obelėlė;Saulutė;6720229368;Ne;4;0;7;11
17620;Obelėlė;Saulutė;1021948127;Taip;10;0;0;10
17621;Obelėlė;Saulutė;4107928390;Taip;0;0;2;2
17622;Obelėlė;Saulutė;4396725994;Taip;0;0;1;1
17623;Obelėlė;Rieduliukai;8173307704;Taip;0;21;0;21
17624;Obelėlė;Rieduliukai;6364101139;Taip;6;1;0;7
17625;Obelėlė;Rieduliukai;6020342761;Taip;4;0;0;4
17626;Obelėlė;Rieduliukai;4987747783;Taip;0;0;1;1
17627;Obelėlė;Rieduliukai;5085970254;Taip;5;0;2;7
17628;Obelėlė;Rieduliukai;8709758561;Taip;21;0;0;21
17629;Obelėlė;Rieduliukai;5739522736;Taip;2;0;0;2
17630;Obelėlė;Rieduliukai;2631405243;Taip;6;0;0;6
17631;Obelėlė;Rieduliukai;1867185320;Taip;18;0;1;19
17632;Obelėlė;Rieduliukai;9796759067;Taip;6;0;0;6
17633;Obelėlė;Rieduliukai;6720808705;Taip;5;0;6;11
17634;Obelėlė;Rieduliukai;7850656031;Taip;5;0;0;5
17635;Obelėlė;Rieduliukai;9084969712;Taip;3;1;0;4
17636;Obelėlė;Žirniukai;7794072582;Taip;18;0;0;18
17637;Obelėlė;Žirniukai;9641297002;Taip;0;0;2;2
17638;Obelėlė;Žirniukai;8918176312;Taip;0;0;4;4
17639;Obelėlė;Žirniukai;9070960601;Taip;0;21;0;21
17640;Obelėlė;Žirniukai;7003947655;Taip;10;1;0;11
17641;Obelėlė;Žirniukai;3986892111;Taip;0;1;0;1
17642;Obelėlė;Žirniukai;1705232474;Taip;0;0;2;2
17643;Obelėlė;Žirniukai;5620250331;Taip;9;0;0;9
17644;Obelėlė;Žirniukai;5588467580;Taip;6;0;15;21
17645;Obelėlė;Žirniukai;8231489868;Taip;8;0;0;8
17646;Obelėlė;Žirniukai;7094715237;Taip;0;0;5;5
17647;Obelėlė;Žirniukai;4489212434;Taip;11;0;5;16
17648;Obelėlė;Žirniukai;8183287212;Taip;0;0;2;2
17649;Obelėlė;Žirniukai;8604451971;Taip;21;0;0;21
17650;Obelėlė;Bičiuliai;9031690002;Taip;9;0;0;9
17651;Obelėlė;Bičiuliai;3425736276;Taip;5;0;1;6
17652;Obelėlė;Bičiuliai;1507072248;Taip;15;0;0;15
17653;Obelėlė;Bičiuliai;5776116844;Taip;10;2;2;14
17654;Obelėlė;Bičiuliai;8487088625;Taip;0;1;0;1
17655;Obelėlė;Bičiuliai;1630067014;Taip;0;2;1;3
17656;Obelėlė;Bičiuliai;1537769810;Taip;0;0;3;3
17657;Obelėlė;Bičiuliai;8371648703;Taip;0;0;1;1
17658;Obelėlė;Bičiuliai;3517342646;Taip;5;0;2;7
17659;Obelėlė;Bičiuliai;8757731600;Taip;0;0;6;6
17660;Obelėlė;Bičiuliai;2329734472;Taip;0;2;0;2
17661;Obelėlė;Bičiuliai;1419189517;Taip;5;0;1;6
17662;Obelėlė;Bičiuliai;4220808775;Taip;5;0;1;6
17663;Obelėlė;Bičiuliai;8155712451;Ne;0;0;1;1
17664;Obelėlė;Bičiuliai;7934760271;Taip;5;0;5;10
17665;Obelėlė;Bičiuliai;4849175527;Taip;6;0;2;8
17666;Obelėlė;Bičiuliai;1362135757;Ne;10;0;5;15
17667;Obelėlė;Bičiuliai;3769993089;Taip;0;0;2;2
17668;Obelėlė;Bičiuliai;5374979248;Taip;15;0;1;16
17669;Obelėlė;Bičiuliai;5568285702;Taip;0;0;2;2
17670;Spygliukas;Bitutės;9975117461;Taip;0;0;4;4
17671;Spygliukas;Bitutės;16828631895;Ne;0;0;2;2
17672;Spygliukas;Bitutės;4653108810;Ne;0;6;0;6
17673;Spygliukas;Bitutės;2980459339;Taip;0;1;0;1
17674;Spygliukas;Bitutės;7421000718;Taip;3;0;1;4
17675;Spygliukas;Bitutės;8103481313;Taip;16;0;1;17
17676;Spygliukas;Bitutės;4430242310;Taip;8;2;0;10
17677;Spygliukas;Bitutės;1228469923;Ne;0;0;1;1
17678;Spygliukas;Bitutės;5022615426;Taip;5;0;0;5
17679;Spygliukas;Bitutės;7250958367;Taip;0;3;0;3
17680;Spygliukas;Bitutės;9001243644;Taip;6;1;0;7
17681;Spygliukas;Bitutės;8646122773;Taip;7;5;0;12
17682;Spygliukas;Bitutės;4933577424;Taip;0;1;0;1
17683;Spygliukas;Bitutės;2935281062;Ne;9;0;2;11
17684;Spygliukas;Bitutės;8992822256;Taip;0;1;4;5
17685;Spygliukas;Bitutės;1940209166;Ne;4;0;0;4
17686;Spygliukas;Bitutės;1855897974;Ne;0;1;0;1
17687;Spygliukas;Boružėlės;1939828587;Taip;0;10;1;11
17688;Spygliukas;Boružėlės;1238940921;Taip;0;7;1;8
17689;Spygliukas;Boružėlės;9288806012;Taip;0;1;0;1
17690;Spygliukas;Boružėlės;1151844475;Taip;0;1;0;1
17691;Spygliukas;Boružėlės;4104158994;Taip;5;0;4;9
17692;Spygliukas;Boružėlės;10858715103;Taip;0;1;0;1
17693;Spygliukas;Boružėlės;1002603766;Taip;4;2;0;6
17694;Spygliukas;Boružėlės;34209607173;Taip;7;0;0;7
17695;Spygliukas;Boružėlės;1842315404;Taip;0;1;0;1
17696;Spygliukas;Boružėlės;73047963456;Taip;5;1;2;8
17697;Spygliukas;Boružėlės;92279064240;Taip;5;3;0;8
17698;Spygliukas;Boružėlės;30201229961;Ne;0;4;2;6
17699;Spygliukas;Boružėlės;79584454527;Taip;0;11;0;11
17700;Spygliukas;Boružėlės;47977103711;Taip;0;1;0;1
17701;Spygliukas;Boružėlės;1321926079;Taip;6;0;1;7
17702;Spygliukas;Boružėlės;9513387087;Ne;4;1;6;11
17703;Spygliukas;Boružėlės;1193015656;Taip;0;0;1;1
17704;Spygliukas;Ežiukai;1832756255;Taip;4;2;0;6
17705;Spygliukas;Ežiukai;2126162527;Taip;3;0;0;3
17706;Spygliukas;Ežiukai;1260920726;Ne;5;10;0;15
17707;Spygliukas;Ežiukai;42285404110;Taip;0;1;0;1
17708;Spygliukas;Ežiukai;2040903312;Taip;1;5;0;6
17709;Spygliukas;Ežiukai;3037648954;Taip;0;1;3;4
17710;Spygliukas;Ežiukai;1211969263;Taip;17;0;0;17
17711;Spygliukas;Ežiukai;7219659640;Taip;0;1;0;1
17712;Spygliukas;Ežiukai;4355472423;Taip;0;0;2;2
17713;Spygliukas;Ežiukai;53324066837;Ne;4;1;0;5
17714;Spygliukas;Ežiukai;9957292202;Taip;0;1;1;2
17715;Spygliukas;Ežiukai;1298381738;Taip;6;2;3;11
17716;Spygliukas;Ežiukai;7649832094;Taip;1;0;5;6
17717;Spygliukas;Ežiukai;5780485510;Taip;0;0;1;1
17718;Spygliukas;Ežiukai;8686118262;Taip;5;0;0;5
17719;Spygliukas;Ežiukai;5253108181;Taip;5;0;0;5
17720;Spygliukas;Ežiukai;3785469286;Taip;0;0;3;3
17721;Spygliukas;Ežiukai;29015391754;Taip;0;1;0;1
17722;Spygliukas;Ežiukai;84556142803;Taip;11;0;0;11
17723;Spygliukas;Geniukai;6242194100;Taip;5;0;0;5
17724;Spygliukas;Geniukai;4577592862;Ne;12;0;0;12
17725;Spygliukas;Geniukai;4721066953;Ne;0;0;2;2
17726;Spygliukas;Geniukai;4949371837;Taip;6;0;3;9
17727;Spygliukas;Geniukai;4650693672;Taip;0;5;0;5
17728;Spygliukas;Geniukai;6835488489;Taip;0;5;1;6
17729;Spygliukas;Geniukai;3658613027;Ne;0;0;2;2
17730;Spygliukas;Geniukai;2463585133;Taip;3;0;0;3
17731;Spygliukas;Geniukai;3365209400;Ne;0;0;1;1
17732;Spygliukas;Geniukai;6457632191;Ne;14;0;0;14
17733;Spygliukas;Geniukai;1691209405;Taip;11;0;0;11
17734;Spygliukas;Geniukai;5962360012;Taip;0;0;1;1
17735;Spygliukas;Geniukai;2739564216;Taip;0;0;7;7
17736;Spygliukas;Geniukai;4610504338;Taip;3;0;1;4
17737;Spygliukas;Geniukai;7900652746;Taip;5;4;0;9
17738;Spygliukas;Geniukai;5778081118;Taip;20;0;0;20
17739;Spygliukas;Geniukai;6000906766;Taip;17;0;0;17
17740;Spygliukas;Geniukai;50047868918;Ne;7;0;1;8
17741;Spygliukas;Riešutėliai;1227595604;Ne;0;14;0;14
17742;Spygliukas;Riešutėliai;21074122407;Taip;5;1;0;6
17743;Spygliukas;Riešutėliai;26697357569;Taip;0;6;0;6
17744;Spygliukas;Riešutėliai;84487759175;Taip;2;0;0;2
17745;Spygliukas;Riešutėliai;47077562116;Taip;0;1;0;1
17746;Spygliukas;Riešutėliai;12711940653;Taip;0;1;0;1
17747;Spygliukas;Riešutėliai;68487983068;Taip;0;1;2;3
17748;Spygliukas;Riešutėliai;1341415412;Taip;0;1;0;1
17749;Spygliukas;Riešutėliai;7829656569;Taip;0;1;0;1
17750;Spygliukas;Riešutėliai;1122973994;Taip;2;1;0;3
17751;Spygliukas;Riešutėliai;45296663285;Taip;0;1;0;1
17752;Spygliukas;Riešutėliai;56991221970;Taip;6;2;0;8
17753;Spygliukas;Riešutėliai;1971162865;Taip;4;1;5;10
17754;Spygliukas;Riešutėliai;1076152986;Ne;5;0;0;5
17755;Spygliukas;Riešutėliai;97773415559;Taip;0;1;0;1
17756;Spygliukas;Riešutėliai;7020789651;Taip;0;1;0;1
17757;Spygliukas;Riešutėliai;77970187363;Taip;0;2;2;4
17758;Spygliukas;Riešutėliai;43541072654;Taip;0;1;2;3
17759;Spygliukas;Pelėdžiukai;1447408559;Taip;0;1;0;1
17760;Spygliukas;Pelėdžiukai;80768950728;Ne;0;4;0;4
17761;Spygliukas;Pelėdžiukai;15887839786;Taip;0;1;0;1
17762;Spygliukas;Pelėdžiukai;28639466275;Taip;0;0;2;2
17763;Spygliukas;Pelėdžiukai;67896776952;Ne;0;4;0;4
17764;Spygliukas;Pelėdžiukai;38040423877;Taip;0;2;0;2
17765;Spygliukas;Pelėdžiukai;88332181449;Taip;0;1;3;4
17766;Spygliukas;Pelėdžiukai;20248450562;Ne;1;2;4;7
17767;Spygliukas;Pelėdžiukai;58880461920;Taip;2;0;0;2
17768;Spygliukas;Pelėdžiukai;90555084491;Taip;0;4;0;4
17769;Spygliukas;Pelėdžiukai;91727550789;Taip;0;2;3;5
17770;Spygliukas;Pelėdžiukai;42786380899;Taip;0;1;2;3
17771;Spygliukas;Pelėdžiukai;1398592801;Taip;1;1;0;2
17772;Spygliukas;Pelėdžiukai;1482370515;Taip;4;5;0;9
17773;Spygliukas;Pelėdžiukai;35839138942;Taip;0;1;0;1
17774;Spygliukas;Pelėdžiukai;88798186419;Taip;3;3;0;6
17775;Spygliukas;Zylutės;7271659513;Taip;0;21;0;21
17776;Spygliukas;Zylutės;8604767396;Ne;8;0;1;9
17777;Spygliukas;Zylutės;4634660174;Taip;5;0;1;6
17778;Spygliukas;Zylutės;4368224847;Taip;4;1;1;6
17779;Spygliukas;Zylutės;9316731983;Taip;5;0;5;10
17780;Spygliukas;Zylutės;5012876830;Taip;5;0;0;5
17781;Spygliukas;Zylutės;2315421636;Taip;0;0;1;1
17782;Spygliukas;Zylutės;8708083787;Taip;18;1;0;19
17783;Spygliukas;Zylutės;7125425492;Taip;0;0;4;4
17784;Spygliukas;Zylutės;7928675053;Taip;10;2;0;12
17785;Spygliukas;Zylutės;1974541155;Taip;1;4;0;5
17786;Spygliukas;Zylutės;4505044604;Taip;0;0;3;3
17787;Spygliukas;Zylutės;2989701249;Taip;17;0;0;17
17788;Spygliukas;Zylutės;6630979640;Taip;11;0;1;12
17789;Spygliukas;Zylutės;9086986643;Taip;0;5;0;5
17790;Spygliukas;Zylutės;9052337501;Taip;5;1;0;6
17791;Spygliukas;Skruzdėliukai;8404929784;Taip;0;0;9;9
17792;Spygliukas;Skruzdėliukai;3041184642;Taip;0;1;0;1
17793;Spygliukas;Skruzdėliukai;9070219319;Taip;0;2;0;2
17794;Spygliukas;Skruzdėliukai;8476882854;Taip;8;2;0;10
17795;Spygliukas;Skruzdėliukai;9112172144;Ne;20;0;0;20
17796;Spygliukas;Skruzdėliukai;2395961015;Taip;0;1;0;1
17797;Spygliukas;Skruzdėliukai;9413950200;Taip;5;4;0;9
17798;Spygliukas;Skruzdėliukai;1333556956;Taip;0;1;0;1
17799;Spygliukas;Skruzdėliukai;4835818382;Taip;7;0;0;7
17800;Spygliukas;Skruzdėliukai;8869320003;Taip;10;2;0;12
17801;Spygliukas;Skruzdėliukai;8270525839;Taip;7;4;0;11
17802;Spygliukas;Skruzdėliukai;3697691132;Taip;15;0;0;15
17803;Spygliukas;Skruzdėliukai;4053158210;Taip;0;4;0;4
17804;Spygliukas;Skruzdėliukai;9444569348;Taip;16;0;0;16
17805;Spygliukas;Voveraitės;5049529300;Taip;0;1;0;1
17806;Spygliukas;Voveraitės;1987926577;Taip;0;11;0;11
17807;Spygliukas;Voveraitės;1773639994;Taip;0;1;6;7
17808;Spygliukas;Voveraitės;2066739772;Taip;5;1;1;7
17809;Spygliukas;Voveraitės;8596667547;Ne;0;1;0;1
17810;Spygliukas;Voveraitės;1042495269;Taip;0;1;0;1
17811;Spygliukas;Voveraitės;1590677993;Taip;4;1;6;11
17812;Spygliukas;Voveraitės;1030973848;Taip;0;0;1;1
17813;Spygliukas;Voveraitės;8801225066;Taip;4;1;2;7
17814;Spygliukas;Voveraitės;8453683673;Ne;5;1;0;6
17815;Spygliukas;Voveraitės;1045253540;Ne;0;0;3;3
17816;Spygliukas;Voveraitės;8048474808;Taip;6;0;3;9
17817;Spygliukas;Voveraitės;45881077771;Taip;0;4;0;4
17818;Spygliukas;Voveraitės;1415694208;Taip;0;1;0;1
17819;Spygliukas;Giliukų;6405496193;Taip;5;0;0;5
17820;Spygliukas;Giliukų;9219327706;Taip;9;0;0;9
17821;Spygliukas;Giliukų;1426267001;Taip;7;0;2;9
17822;Spygliukas;Giliukų;1234195733;Taip;5;3;0;8
17823;Spygliukas;Giliukų;6758336405;Taip;10;0;1;11
17824;Spygliukas;Giliukų;6587957213;Taip;6;0;2;8
17825;Spygliukas;Giliukų;8877911083;Taip;20;0;1;21
17826;Spygliukas;Giliukų;1177439438;Taip;2;10;0;12
17827;Spygliukas;Giliukų;7313828707;Taip;15;1;0;16
17828;Spygliukas;Giliukų;2272141731;Taip;0;13;0;13
17829;Vieversys;Žirniukai;8129139979;Taip;5;4;0;9
17830;Vieversys;Žirniukai;1149316471;Taip;0;11;0;11
17831;Vieversys;Žirniukai;1728554204;Taip;0;1;0;1
17832;Vieversys;Žirniukai;6787960120;Taip;10;0;0;10
17833;Vieversys;Žirniukai;9612415733;Taip;5;7;0;12
17834;Vieversys;Žirniukai;5917328379;Taip;11;0;2;13
17835;Vieversys;Žirniukai;53977164888;Taip;0;3;0;3
17836;Vieversys;Žirniukai;82594887399;Taip;5;2;0;7
17837;Vieversys;Žirniukai;7500147648;Taip;0;1;0;1
17838;Vieversys;Žirniukai;9835682858;Taip;0;15;0;15
17839;Vieversys;Žirniukai;5286521728;Taip;10;2;0;12
17840;Vieversys;Žirniukai;8038341998;Taip;0;4;0;4
17841;Vieversys;Žirniukai;1247565595;Taip;0;1;0;1
17842;Vieversys;Žirniukai;6720355390;Taip;17;0;0;17
17843;Vieversys;Žirniukai;4313822180;Taip;0;1;0;1
17844;Vieversys;Žirniukai;7812227428;Ne;0;1;0;1
17845;Vieversys;Žirniukai;4455039401;Taip;0;1;0;1
17846;Vieversys;Žirniukai;5810605263;Taip;0;0;2;2
17847;Vieversys;Varpelių;38299255111;Taip;0;1;0;1
17848;Vieversys;Varpelių;34168958939;Taip;0;1;0;1
17849;Vieversys;Varpelių;25198979253;Taip;3;3;1;7
17850;Vieversys;Varpelių;50929651251;Taip;0;1;0;1
17851;Vieversys;Varpelių;65625227882;Taip;0;1;0;1
17852;Vieversys;Varpelių;29002693436;Taip;0;1;3;4
17853;Vieversys;Varpelių;41282339758;Taip;0;2;0;2
17854;Vieversys;Varpelių;6427430220;Taip;7;1;0;8
17855;Vieversys;Varpelių;72475350152;Taip;0;3;0;3
17856;Vieversys;Varpelių;11528430680;Taip;0;2;0;2
17857;Vieversys;Varpelių;67471794738;Taip;7;1;0;8
17858;Vieversys;Varpelių;13768739410;Taip;0;2;0;2
17859;Vieversys;Varpelių;79197759451;Taip;0;2;0;2
17860;Vieversys;Varpelių;2010825247;Ne;21;0;0;21
17861;Vieversys;Varpelių;89564962534;Taip;2;1;0;3
17862;Vieversys;Varpelių;65696183376;Taip;0;2;0;2
17863;Vieversys;Varpelių;2561825171;Taip;0;0;2;2
17864;Vieversys;Varpelių;87314456133;Ne;0;0;3;3
17865;Vieversys;Kiškučių;2511719188;Ne;0;2;0;2
17866;Vieversys;Kiškučių;6077365803;Taip;6;1;0;7
17867;Vieversys;Kiškučių;5337856442;Taip;0;2;3;5
17868;Vieversys;Kiškučių;5051310223;Ne;4;1;2;7
17869;Vieversys;Kiškučių;75434941104;Taip;1;1;0;2
17870;Vieversys;Kiškučių;83420473111;Taip;0;5;0;5
17871;Vieversys;Kiškučių;26092685300;Ne;4;3;0;7
17872;Vieversys;Kiškučių;56670426557;Taip;0;1;0;1
17873;Vieversys;Kiškučių;72651951788;Taip;0;0;1;1
17874;Vieversys;Kiškučių;22275121492;Taip;0;2;0;2
17875;Vieversys;Kiškučių;34494816770;Taip;0;1;0;1
17876;Vieversys;Kiškučių;27123496741;Taip;0;1;0;1
17877;Vieversys;Kiškučių;66155667200;Taip;0;1;0;1
17878;Vieversys;Kiškučių;7126970560;Taip;0;2;0;2
17879;Vieversys;Kiškučių;93582609868;Taip;0;2;0;2
17880;Vieversys;Kiškučių;35144734547;Taip;8;12;0;20
17881;Vieversys;Pelėdžiukų;8421719030;Taip;0;0;3;3
17882;Vieversys;Pelėdžiukų;77272293257;Taip;10;0;0;10
17883;Vieversys;Pelėdžiukų;94463134058;Taip;10;1;0;11
17884;Vieversys;Pelėdžiukų;5434952733;Taip;10;5;1;16
17885;Vieversys;Pelėdžiukų;2193074123;Taip;0;1;0;1
17886;Vieversys;Pelėdžiukų;7007620994;Taip;7;1;4;12
17887;Vieversys;Pelėdžiukų;9499315463;Taip;0;3;0;3
17888;Vieversys;Pelėdžiukų;9774365819;Taip;0;5;0;5
17889;Vieversys;Pelėdžiukų;9494957750;Taip;0;1;2;3
17890;Vieversys;Pelėdžiukų;2521488728;Taip;0;0;4;4
17891;Vieversys;Pelėdžiukų;6473759470;Taip;0;6;0;6
17892;Vieversys;Pelėdžiukų;1120594293;Taip;0;6;0;6
17893;Vieversys;Pelėdžiukų;1273951001;Taip;0;0;7;7
17894;Vieversys;Pelėdžiukų;48430863473;Taip;10;1;0;11
17895;Vieversys;Pelėdžiukų;50181034746;Taip;6;0;1;7
17896;Vieversys;Pelėdžiukų;52420072025;Taip;0;3;5;8
17897;Vieversys;Pelėdžiukų;1027693153;Taip;0;0;2;2
17898;Vieversys;Pelėdžiukų;5871715452;Taip;0;1;2;3
17899;Vieversys;Pelėdžiukų;9659337657;Ne;8;0;0;8
17900;Vieversys;Pelėdžiukų;3458399180;Taip;13;5;0;18
17901;Vieversys;Pelėdžiukų;1361156816;Taip;10;1;0;11
17902;Vieversys;Saulučių;53189421149;Taip;0;1;0;1
17903;Vieversys;Saulučių;81494754248;Taip;0;3;0;3
17904;Vieversys;Saulučių;12419984038;Taip;0;1;0;1
17905;Vieversys;Saulučių;78901148667;Taip;0;1;0;1
17906;Vieversys;Saulučių;1601102808;Ne;0;1;1;2
17907;Vieversys;Saulučių;84134333980;Taip;0;1;0;1
17908;Vieversys;Saulučių;9980447111;Taip;0;0;1;1
17909;Vieversys;Saulučių;2733479642;Taip;0;2;0;2
17910;Vieversys;Saulučių;25507613416;Ne;0;1;0;1
17911;Vieversys;Saulučių;1307701524;Taip;0;3;0;3
17912;Vieversys;Saulučių;8966153890;Taip;0;1;0;1
17913;Vieversys;Saulučių;1025794194;Taip;5;0;0;5
17914;Vieversys;Saulučių;2006826758;Taip;0;1;0;1
17915;Vieversys;Kregždučių;55553505459;Taip;0;3;3;6
17916;Vieversys;Kregždučių;16002848795;Taip;0;3;3;6
17917;Vieversys;Kregždučių;1933907389;Taip;0;1;0;1
17918;Vieversys;Kregždučių;1462608187;Ne;0;1;0;1
17919;Vieversys;Kregždučių;2130449373;Taip;0;1;0;1
17920;Vieversys;Kregždučių;44086673096;Taip;0;1;0;1
17921;Vieversys;Kregždučių;89223502405;Taip;0;5;0;5
17922;Vieversys;Kregždučių;41215224179;Taip;15;1;0;16
17923;Vieversys;Kregždučių;938801303;Taip;0;3;0;3
17924;Vieversys;Kregždučių;2141967793;Taip;0;1;1;2
17925;Vieversys;Kregždučių;2128428329;Taip;3;1;0;4
17926;Vieversys;Kregždučių;1190396975;Taip;0;1;0;1
17927;Vieversys;Kregždučių;62465517391;Taip;0;4;0;4
17928;Vieversys;Kregždučių;5123994167;Taip;0;0;1;1
17929;Vieversys;Kregždučių;12524976076;Taip;0;1;0;1
17930;Vieversys;Kregždučių;1300013110;Taip;0;1;2;3
17931;Vieversys;Kregždučių;61101237391;Taip;0;1;1;2
17932;Vieversys;Kregždučių;1716198618;Taip;0;11;0;11
17933;Vieversys;Kregždučių;8213134622;Taip;0;1;0;1
17934;Vieversys;Kregždučių;2879546284;Taip;0;1;2;3
17935;Vieversys;Kregždučių;3839507103;Taip;0;1;0;1
17936;Vieversys;Kregždučių;46624143347;Taip;5;0;0;5
17937;Vieversys;Kregždučių;73657188876;Taip;4;0;0;4
17938;Vieversys;Boružėlių;6236703869;Taip;0;0;1;1
17939;Vieversys;Boružėlių;6116471730;Ne;0;1;0;1
17940;Vieversys;Boružėlių;1815073796;Taip;0;1;0;1
17941;Vieversys;Boružėlių;32630544785;Taip;0;0;3;3
17942;Vieversys;Boružėlių;20960056744;Ne;5;1;1;7
17943;Vieversys;Boružėlių;58287759954;Taip;6;0;0;6
17944;Vieversys;Boružėlių;72395946516;Ne;0;0;1;1
17945;Vieversys;Boružėlių;86213464121;Taip;0;1;1;2
17946;Vieversys;Boružėlių;55764266970;Taip;10;1;0;11
17947;Vieversys;Boružėlių;1588939300;Taip;12;0;0;12
17948;Vieversys;Boružėlių;86119860485;Taip;3;0;0;3
17949;Vieversys;Boružėlių;1028950997;Taip;0;0;8;8
17950;Vieversys;Boružėlių;14574836082;Ne;5;1;1;7
17951;Vieversys;Boružėlių;95886969053;Taip;1;0;1;2
17952;Vieversys;Boružėlių;95891054066;Taip;1;0;0;1
17953;Vieversys;Boružėlių;5197639355;Taip;7;4;0;11
17954;Vieversys;Boružėlių;1715902540;Taip;0;5;0;5
17955;Vieversys;Bitučių;9972526744;Taip;0;4;0;4
17956;Vieversys;Bitučių;5654533451;Taip;0;1;0;1
17957;Vieversys;Bitučių;6127272124;Taip;0;1;2;3
17958;Vieversys;Bitučių;3405502715;Taip;14;0;0;14
17959;Vieversys;Bitučių;9985374057;Taip;0;10;0;10
17960;Vieversys;Bitučių;9308040716;Taip;5;0;0;5
17961;Vieversys;Bitučių;6031200259;Ne;1;0;0;1
17962;Vieversys;Bitučių;4072323869;Taip;6;1;0;7
17963;Vieversys;Bitučių;6110034652;Taip;3;1;0;4
17964;Vieversys;Bitučių;4024758152;Taip;0;1;0;1
17965;Vieversys;Bitučių;6194712643;Taip;0;1;0;1
17966;Vieversys;Bitučių;7596355010;Taip;11;5;0;16
17967;Vieversys;Bitučių;4892622551;Ne;0;0;1;1
17968;Vieversys;Bitučių;2140887757;Taip;0;0;1;1
17969;Vieversys;Bitučių;4690095102;Taip;10;1;0;11
17970;Vieversys;Bitučių;4968278870;Taip;9;0;1;10
17971;Vieversys;Smalsučių;5922485482;Taip;1;0;1;2
17972;Vieversys;Smalsučių;9164615794;Taip;0;5;0;5
17973;Vieversys;Smalsučių;3684937630;Taip;10;2;0;12
17974;Vieversys;Smalsučių;6563139211;Taip;0;1;0;1
17975;Vieversys;Smalsučių;4294676988;Taip;0;2;1;3
17976;Vieversys;Smalsučių;3917758713;Taip;0;2;0;2
17977;Vieversys;Smalsučių;4835022593;Taip;0;0;2;2
17978;Vieversys;Smalsučių;4778339658;Taip;17;1;0;18
17979;Vieversys;Smalsučių;3249717073;Taip;5;4;0;9
17980;Vieversys;Smalsučių;7120329258;Taip;5;4;0;9
17981;Vieversys;Smalsučių;9387421639;Taip;13;2;0;15
17982;Vieversys;Smalsučių;8174124875;Taip;4;0;0;4
17983;Vieversys;Smalsučių;5769453869;Taip;0;2;0;2
17984;Vieversys;Smalsučių;5789530087;Taip;14;0;3;17
17985;Vieversys;Smalsučių;3755410640;Ne;0;0;3;3
17986;Vieversys;Smalsučių;1322495361;Taip;15;0;0;15
17987;Vieversys;Kodėlčiukų;9003308318;Taip;0;0;1;1
17988;Vieversys;Kodėlčiukų;69275621813;Taip;16;3;0;19
17989;Vieversys;Kodėlčiukų;1455615413;Taip;8;0;2;10
17990;Vieversys;Kodėlčiukų;1970088958;Ne;17;0;0;17
17991;Vieversys;Kodėlčiukų;1586720551;Taip;3;0;0;3
17992;Vieversys;Kodėlčiukų;9012978017;Taip;0;10;0;10
17993;Vieversys;Kodėlčiukų;1766638116;Taip;0;0;7;7
17994;Vieversys;Kodėlčiukų;1599787985;Ne;6;0;1;7
17995;Vieversys;Kodėlčiukų;1491424075;Taip;16;0;1;17
17996;Vieversys;Kodėlčiukų;1361494430;Taip;0;0;7;7
17997;Vieversys;Kodėlčiukų;9829388743;Taip;0;11;0;11
17998;Vieversys;Kodėlčiukų;1878278158;Taip;0;1;2;3
17999;Vieversys;Kodėlčiukų;7315438787;Taip;0;5;0;5
18000;Vieversys;Kodėlčiukų;16617102917;Taip;6;1;0;7
18001;Vieversys;Kodėlčiukų;1793994492;Taip;0;0;16;16
18002;Vieversys;Kodėlčiukų;2236904814;Taip;9;0;1;10
18003;Vieversys;Kodėlčiukų;7385860819;Taip;0;0;1;1
18004;Vieversys;Kodėlčiukų;9680719247;Taip;5;0;0;5
18005;Vieversys;Kodėlčiukų;2294276744;Taip;5;1;0;6
18006;Vieversys;Kodėlčiukų;3640960566;Taip;11;0;1;12
18007;Vieversys;Kodėlčiukų;2006325359;Taip;0;5;1;6
18008;Vieversys;NYKŠTUKAI;9453100342;Taip;6;0;1;7
18009;Vieversys;NYKŠTUKAI;3947405446;Taip;10;0;0;10
18010;Vieversys;NYKŠTUKAI;7364582681;Taip;6;2;2;10
18011;Vieversys;NYKŠTUKAI;4088189914;Taip;5;1;0;6
18012;Vieversys;NYKŠTUKAI;7399326463;Taip;16;0;0;16
18013;Vieversys;NYKŠTUKAI;4565799599;Taip;5;1;0;6
18014;Vieversys;NYKŠTUKAI;9884517851;Taip;6;4;0;10
18015;Vieversys;NYKŠTUKAI;6765094662;Ne;16;0;3;19
18016;Vieversys;NYKŠTUKAI;5683183310;Taip;5;0;0;5
18017;Vieversys;NYKŠTUKAI;8587368497;Taip;11;3;0;14
18018;Vieversys;NYKŠTUKAI;6838828193;Taip;4;0;0;4
18019;Vieversys;NYKŠTUKAI;2027613318;Taip;0;3;0;3
18020;Vieversys;NYKŠTUKAI;1478357320;Taip;0;9;0;9
18021;Vieversys;DRUGELIAI;9093088054;Taip;4;0;6;10
18022;Vieversys;DRUGELIAI;6808541662;Taip;8;0;0;8
18023;Vieversys;DRUGELIAI;2849852593;Taip;10;0;1;11
18024;Vieversys;DRUGELIAI;5486475468;Taip;8;0;0;8
18025;Vieversys;DRUGELIAI;8141710663;Taip;11;0;0;11
18026;Vieversys;DRUGELIAI;2230503026;Taip;16;1;0;17
18027;Vieversys;DRUGELIAI;5645852451;Taip;6;1;1;8
18028;Vieversys;DRUGELIAI;3122763958;Taip;6;0;1;7
18029;Vieversys;DRUGELIAI;2529690060;Taip;7;0;2;9
18030;Vieversys;DRUGELIAI;9088171869;Taip;9;0;2;11
18031;Vieversys;DRUGELIAI;1685531183;Ne;16;0;0;16
18032;Vieversys;DRUGELIAI;7998100115;Taip;7;4;0;11
18033;Vieversys;DRUGELIAI;3156245273;Taip;0;0;1;1
18034;Vieversys;DRUGELIAI;7568415178;Taip;9;0;0;9
18035;Vieversys;DRUGELIAI;4870401841;Taip;12;1;0;13
18036;Žirmūnėliai;SAULUTĖS;8030469722;Taip;0;7;0;7
18037;Žirmūnėliai;SAULUTĖS;1258769646;Taip;1;2;1;4
18038;Žirmūnėliai;SAULUTĖS;3166454638;Taip;0;1;0;1
18039;Žirmūnėliai;SAULUTĖS;73664204182;Taip;3;1;1;5
18040;Žirmūnėliai;SAULUTĖS;1725143117;Taip;0;1;0;1
18041;Žirmūnėliai;SAULUTĖS;1073135587;Taip;0;15;0;15
18042;Žirmūnėliai;SAULUTĖS;4598761492;Taip;0;7;0;7
18043;Žirmūnėliai;SAULUTĖS;3128190518;Taip;0;1;0;1
18044;Žirmūnėliai;SAULUTĖS;1478039469;Taip;12;0;0;12
18045;Žirmūnėliai;SAULUTĖS;6896145409;Taip;0;1;0;1
18046;Žirmūnėliai;SAULUTĖS;1255857051;Taip;0;10;0;10
18047;Žirmūnėliai;SAULUTĖS;72738770293;Taip;8;0;0;8
18048;Žirmūnėliai;SAULUTĖS;4517290068;Taip;0;1;0;1
18049;Žirmūnėliai;SAULUTĖS;1582563837;Taip;6;0;0;6
18050;Žirmūnėliai;SAULUTĖS;1381923106;Taip;11;1;0;12
18051;Žirmūnėliai;SAULUTĖS;5037669167;Taip;19;0;0;19
18052;Žirmūnėliai;SAULUTĖS;1761284228;Taip;4;0;0;4
18053;Žirmūnėliai;SAULUTĖS;41018224936;Taip;0;0;1;1
18054;Žirmūnėliai;SAULUTĖS;1894070647;Taip;0;10;0;10
18055;Žirmūnėliai;SAULUTĖS;1347664230;Taip;10;1;0;11
18056;Žirmūnėliai;SAULUTĖS;1302022463;Taip;0;6;0;6
18057;Žirmūnėliai;GILIUKAI;37231106844;Taip;8;6;0;14
18058;Žirmūnėliai;GILIUKAI;5673929155;Taip;0;1;0;1
18059;Žirmūnėliai;GILIUKAI;50829749038;Taip;9;1;0;10
18060;Žirmūnėliai;GILIUKAI;68678277635;Taip;6;0;0;6
18061;Žirmūnėliai;GILIUKAI;1818060330;Taip;0;1;0;1
18062;Žirmūnėliai;GILIUKAI;1963980356;Taip;0;8;0;8
18063;Žirmūnėliai;GILIUKAI;1302040861;Ne;0;1;1;2
18064;Žirmūnėliai;GILIUKAI;99546532431;Taip;0;1;0;1
18065;Žirmūnėliai;GILIUKAI;1816123753;Taip;0;4;0;4
18066;Žirmūnėliai;GILIUKAI;1308593517;Taip;5;6;0;11
18067;Žirmūnėliai;GILIUKAI;53028161711;Taip;0;12;0;12
18068;Žirmūnėliai;GILIUKAI;6578685370;Ne;0;1;0;1
18069;Žirmūnėliai;GILIUKAI;1493536049;Taip;0;6;0;6
18070;Žirmūnėliai;GILIUKAI;1734624632;Taip;0;8;1;9
18071;Žirmūnėliai;GILIUKAI;1626619024;Taip;0;2;0;2
18072;Žirmūnėliai;GILIUKAI;8824743884;Taip;0;7;2;9
18073;Žirmūnėliai;GILIUKAI;1556389237;Taip;0;0;3;3
18074;Žirmūnėliai;GILIUKAI;1764226619;Taip;0;1;0;1
18075;Žirmūnėliai;GILIUKAI;1183883183;Taip;0;14;0;14
18076;Žirmūnėliai;GILIUKAI;7929881052;Ne;10;3;0;13
18077;Žirmūnėliai;DAINORĖLIAI;6493142538;Taip;5;0;0;5
18078;Žirmūnėliai;DAINORĖLIAI;1655437833;Taip;0;0;7;7
18079;Žirmūnėliai;DAINORĖLIAI;2693415717;Taip;3;0;7;10
18080;Žirmūnėliai;DAINORĖLIAI;8930536051;Taip;8;0;0;8
18081;Žirmūnėliai;DAINORĖLIAI;7953019230;Taip;15;2;0;17
18082;Žirmūnėliai;DAINORĖLIAI;6982109508;Taip;0;0;21;21
18083;Žirmūnėliai;DAINORĖLIAI;3458810185;Ne;5;0;3;8
18084;Žirmūnėliai;DAINORĖLIAI;3994865244;Taip;0;0;21;21
18085;Žirmūnėliai;DAINORĖLIAI;3640979388;Taip;5;6;0;11
18086;Žirmūnėliai;DAINORĖLIAI;6878528100;Taip;5;1;0;6
18087;Žirmūnėliai;DAINORĖLIAI;8440187348;Taip;9;0;1;10
18088;Žirmūnėliai;DAINORĖLIAI;9402567487;Taip;8;0;0;8
18089;Žirmūnėliai;DAINORĖLIAI;1832367936;Taip;0;0;2;2
18090;Žirmūnėliai;DAINORĖLIAI;9759491055;Taip;3;0;3;6
18091;Žirmūnėliai;DAINORĖLIAI;3297360222;Ne;3;0;6;9
18092;Žirmūnėliai;DAINORĖLIAI;1127214387;Taip;14;0;1;15
18093;Žirmūnėliai;DAINORĖLIAI;4101748829;Taip;15;0;0;15
18094;Žirmūnėliai;DAINORĖLIAI;2379638934;Taip;0;6;0;6
18095;Žirmūnėliai;DAINORĖLIAI;6448582622;Taip;18;0;0;18
18096;Žirmūnėliai;DAINORĖLIAI;2661052835;Taip;0;4;0;4
18097;Žirmūnėliai;DAINORĖLIAI;7011701994;Ne;6;0;0;6
18098;Žirmūnėliai;DRUGELIAI;4218266688;Taip;4;0;0;4
18099;Žirmūnėliai;DRUGELIAI;7020486370;Taip;0;1;0;1
18100;Žirmūnėliai;DRUGELIAI;3449815783;Taip;6;0;0;6
18101;Žirmūnėliai;DRUGELIAI;9541122034;Taip;0;3;0;3
18102;Žirmūnėliai;DRUGELIAI;5736502380;Ne;0;3;1;4
18103;Žirmūnėliai;DRUGELIAI;9154874729;Taip;0;3;0;3
18104;Žirmūnėliai;DRUGELIAI;9378860669;Taip;5;2;0;7
18105;Žirmūnėliai;DRUGELIAI;8607934394;Taip;0;7;1;8
18106;Žirmūnėliai;DRUGELIAI;5723289396;Taip;5;0;0;5
18107;Žirmūnėliai;DRUGELIAI;7892626521;Taip;0;2;0;2
18108;Žirmūnėliai;DRUGELIAI;8999160836;Taip;0;2;4;6
18109;Žirmūnėliai;DRUGELIAI;8209309240;Taip;0;7;0;7
18110;Žirmūnėliai;DRUGELIAI;5209700153;Taip;1;0;1;2
18111;Žirmūnėliai;DRUGELIAI;2837129621;Taip;8;2;1;11
18112;Žirmūnėliai;DRUGELIAI;1273684243;Taip;0;0;3;3
18113;Žirmūnėliai;DRUGELIAI;2971175236;Taip;0;2;8;10
18114;Žirmūnėliai;DRUGELIAI;6594728970;Taip;8;2;1;11
18115;Žirmūnėliai;DRUGELIAI;5090067954;Ne;1;0;0;1
18116;Žirmūnėliai;DRUGELIAI;7422544482;Taip;2;0;0;2
18117;Žirmūnėliai;DRUGELIAI;4336415033;Taip;6;0;1;7
18118;Žirmūnėliai;DRUGELIAI;9241738140;Taip;17;1;0;18
18119;Žirmūnėliai;BORUŽIUKAI;99393944540;Taip;0;2;0;2
18120;Žirmūnėliai;BORUŽIUKAI;76779474158;Taip;12;1;0;13
18121;Žirmūnėliai;BORUŽIUKAI;18242077086;Taip;0;1;0;1
18122;Žirmūnėliai;BORUŽIUKAI;37429281370;Taip;0;2;1;3
18123;Žirmūnėliai;BORUŽIUKAI;19044383213;Taip;5;0;0;5
18124;Žirmūnėliai;BORUŽIUKAI;1119678857;Taip;0;5;0;5
18125;Žirmūnėliai;BORUŽIUKAI;77024387002;Taip;0;1;0;1
18126;Žirmūnėliai;BORUŽIUKAI;99980167497;Taip;0;1;0;1
18127;Žirmūnėliai;BORUŽIUKAI;88436070676;Taip;0;2;0;2
18128;Žirmūnėliai;BORUŽIUKAI;66100956443;Taip;0;0;1;1
18129;Žirmūnėliai;BORUŽIUKAI;85286691926;Taip;8;2;1;11
18130;Žirmūnėliai;BORUŽIUKAI;1634724759;Taip;0;5;0;5
18131;Žirmūnėliai;BORUŽIUKAI;7777166572;Taip;0;7;0;7
18132;Žirmūnėliai;BORUŽIUKAI;20851917855;Taip;0;14;0;14
18133;Žirmūnėliai;BORUŽIUKAI;26463655365;Ne;10;2;0;12
18134;Žirmūnėliai;BORUŽIUKAI;32213803056;Taip;0;5;0;5
18135;Žirmūnėliai;BORUŽIUKAI;1157270725;Taip;0;18;0;18
18136;Žirmūnėliai;BORUŽIUKAI;22592450568;Taip;5;1;0;6
18137;Žirmūnėliai;BORUŽIUKAI;78535860714;Taip;0;2;0;2
18138;Žirmūnėliai;EŽIUKAI;75310341519;Taip;0;1;0;1
18139;Žirmūnėliai;EŽIUKAI;36822027549;Taip;0;1;6;7
18140;Žirmūnėliai;EŽIUKAI;1563132542;Taip;0;1;6;7
18141;Žirmūnėliai;EŽIUKAI;31231655300;Taip;10;1;4;15
18142;Žirmūnėliai;EŽIUKAI;5450253994;Taip;4;0;0;4
18143;Žirmūnėliai;EŽIUKAI;97123184267;Ne;0;0;1;1
18144;Žirmūnėliai;EŽIUKAI;67024451309;Taip;7;1;1;9
18145;Žirmūnėliai;EŽIUKAI;39347099487;Taip;0;2;0;2
18146;Žirmūnėliai;EŽIUKAI;58158145123;Taip;1;2;0;3
18147;Žirmūnėliai;EŽIUKAI;30933761145;Taip;0;1;0;1
18148;Žirmūnėliai;EŽIUKAI;33441696614;Taip;5;0;0;5
18149;Žirmūnėliai;EŽIUKAI;51268874840;Taip;0;3;0;3
18150;Žirmūnėliai;EŽIUKAI;34205058356;Taip;0;1;0;1
18151;Žirmūnėliai;EŽIUKAI;57457297276;Taip;0;1;0;1
18152;Žirmūnėliai;EŽIUKAI;1023642666;Taip;16;1;0;17
18153;Žirmūnėliai;EŽIUKAI;9039313646;Taip;0;1;5;6
18154;Žirmūnėliai;EŽIUKAI;7386776624;Taip;0;1;5;6
18155;Žirmūnėliai;ŽVIRBLIUKAI;73552867802;Taip;0;3;0;3
18156;Žirmūnėliai;ŽVIRBLIUKAI;38316483993;Taip;0;1;0;1
18157;Žirmūnėliai;ŽVIRBLIUKAI;1250060420;Taip;5;1;0;6
18158;Žirmūnėliai;ŽVIRBLIUKAI;1477593223;Ne;0;5;0;5
18159;Žirmūnėliai;ŽVIRBLIUKAI;3896978775;Taip;0;0;4;4
18160;Žirmūnėliai;ŽVIRBLIUKAI;1235090013;Taip;0;2;0;2
18161;Žirmūnėliai;ŽVIRBLIUKAI;4136421440;Taip;0;11;0;11
18162;Žirmūnėliai;ŽVIRBLIUKAI;87693490164;Taip;0;2;0;2
18163;Žirmūnėliai;ŽVIRBLIUKAI;65010448998;Taip;0;2;0;2
18164;Žirmūnėliai;ŽVIRBLIUKAI;45541156029;Taip;0;3;0;3
18165;Žirmūnėliai;ŽVIRBLIUKAI;96121856269;Taip;6;2;0;8
18166;Žirmūnėliai;ŽVIRBLIUKAI;28826938550;Taip;5;0;2;7
18167;Žirmūnėliai;ŽVIRBLIUKAI;65810358813;Taip;0;1;3;4
18168;Žirmūnėliai;ŽVIRBLIUKAI;12766765793;Taip;8;3;0;11
18169;Žirmūnėliai;ŽVIRBLIUKAI;86142962074;Taip;0;2;0;2
18170;Žirmūnėliai;ŽVIRBLIUKAI;61531418513;Taip;0;1;0;1
18171;Žirmūnėliai;ŽVIRBLIUKAI;6531982232;Taip;0;1;0;1
18172;Žirmūnėliai;ŽVIRBLIUKAI;1914464845;Taip;5;2;2;9
18173;Žirmūnėliai;ŽVIRBLIUKAI;20902834369;Taip;0;3;0;3
18174;Žirmūnėliai;SPALVELĖS;4986702792;Ne;0;3;1;4
18175;Žirmūnėliai;SPALVELĖS;3691651489;Taip;0;0;7;7
18176;Žirmūnėliai;SPALVELĖS;1120531178;Taip;0;1;0;1
18177;Žirmūnėliai;SPALVELĖS;1273301982;Taip;0;2;3;5
18178;Žirmūnėliai;SPALVELĖS;29952298800;Taip;0;0;21;21
18179;Žirmūnėliai;SPALVELĖS;8348616350;Taip;0;2;0;2
18180;Žirmūnėliai;SPALVELĖS;2127930970;Taip;4;2;0;6
18181;Žirmūnėliai;SPALVELĖS;3150467744;Taip;0;1;0;1
18182;Žirmūnėliai;SPALVELĖS;4330975876;Taip;0;1;0;1
18183;Žirmūnėliai;SPALVELĖS;4710829908;Taip;0;2;0;2
18184;Žirmūnėliai;SPALVELĖS;7918747416;Taip;15;0;0;15
18185;Žirmūnėliai;SPALVELĖS;1865240339;Taip;10;0;0;10
18186;Žirmūnėliai;SPALVELĖS;8339819296;Taip;7;2;0;9
18187;Žirmūnėliai;SPALVELĖS;51723882387;Taip;0;1;5;6
18188;Žirmūnėliai;SPALVELĖS;8308074932;Taip;0;2;4;6
18189;Žirmūnėliai;SPALVELĖS;1017903291;Ne;1;11;0;12
18190;Žirmūnėliai;SPALVELĖS;33296480709;Taip;5;0;3;8
18191;Žirmūnėliai;SPALVELĖS;52524235797;Ne;1;0;0;1
18192;Žirmūnėliai;SPALVELĖS;9482910388;Taip;6;8;0;14
18193;Žirmūnėliai;DEBESĖLIAI;64969220116;Taip;0;20;0;20
18194;Žirmūnėliai;DEBESĖLIAI;1690539251;Taip;0;3;0;3
18195;Žirmūnėliai;DEBESĖLIAI;1542147528;Taip;6;1;1;8
18196;Žirmūnėliai;DEBESĖLIAI;5527904792;Taip;0;15;0;15
18197;Žirmūnėliai;DEBESĖLIAI;6161223611;Taip;5;0;0;5
18198;Žirmūnėliai;DEBESĖLIAI;31403739893;Taip;10;0;0;10
18199;Žirmūnėliai;DEBESĖLIAI;9926432375;Ne;0;3;0;3
18200;Žirmūnėliai;DEBESĖLIAI;2263604297;Taip;0;7;0;7
18201;Žirmūnėliai;DEBESĖLIAI;1618573494;Taip;0;21;0;21
18202;Žirmūnėliai;DEBESĖLIAI;5611315994;Taip;5;1;1;7
18203;Žirmūnėliai;DEBESĖLIAI;6337036947;Taip;3;6;0;9
18204;Žirmūnėliai;DEBESĖLIAI;7528704460;Taip;5;1;1;7
18205;Žirmūnėliai;DEBESĖLIAI;3006508357;Ne;0;1;1;2
18206;Žirmūnėliai;DEBESĖLIAI;5125341440;Taip;4;1;0;5
18207;Žirmūnėliai;DEBESĖLIAI;6647641423;Taip;14;0;0;14
18208;Žirmūnėliai;DEBESĖLIAI;3351861764;Taip;7;0;0;7
18209;Žirmūnėliai;DEBESĖLIAI;3274576752;Taip;15;0;1;16
18210;Žirmūnėliai;DEBESĖLIAI;1234956674;Taip;0;2;4;6
18211;Žirmūnėliai;DEBESĖLIAI;3540307559;Taip;8;1;1;10
18212;Žirmūnėliai;VIŠČIUKAI;6597451758;Taip;9;0;1;10
18213;Žirmūnėliai;VIŠČIUKAI;6875484657;Taip;0;0;8;8
18214;Žirmūnėliai;VIŠČIUKAI;7410921362;Taip;5;0;0;5
18215;Žirmūnėliai;VIŠČIUKAI;3431320961;Taip;3;0;0;3
18216;Žirmūnėliai;VIŠČIUKAI;3532895278;Taip;0;0;1;1
18217;Žirmūnėliai;VIŠČIUKAI;8432654056;Taip;11;0;1;12
18218;Žirmūnėliai;VIŠČIUKAI;8538773532;Taip;0;5;1;6
18219;Žirmūnėliai;VIŠČIUKAI;8459217612;Taip;18;0;0;18
18220;Žirmūnėliai;VIŠČIUKAI;2959090234;Taip;21;0;0;21
18221;Žirmūnėliai;VIŠČIUKAI;9871163622;Taip;10;0;1;11
18222;Žirmūnėliai;VIŠČIUKAI;5089884149;Taip;14;0;1;15
18223;Žirmūnėliai;VIŠČIUKAI;1356219744;Taip;0;11;0;11
18224;Žirmūnėliai;VIŠČIUKAI;1791977446;Taip;6;0;1;7
18225;Žirmūnėliai;VIŠČIUKAI;6259368139;Taip;20;1;0;21
18226;Žirmūnėliai;VIŠČIUKAI;4548601585;Taip;14;0;0;14
18227;Žirmūnėliai;VIŠČIUKAI;9367849317;Taip;9;0;0;9
18228;Žirmūnėliai;VIŠČIUKAI;9892620134;Taip;0;0;3;3
18229;Žirmūnėliai;VIŠČIUKAI;8627403283;Taip;4;0;2;6
18230;Žirmūnėliai;ZUIKUČIŲ;3562689670;Taip;0;4;0;4
18231;Žirmūnėliai;ZUIKUČIŲ;1571242696;Taip;5;0;0;5
18232;Žirmūnėliai;ZUIKUČIŲ;1401001989;Ne;12;0;0;12
18233;Žirmūnėliai;ZUIKUČIŲ;8631248243;Taip;0;0;17;17
18234;Žirmūnėliai;ZUIKUČIŲ;2866010286;Taip;9;0;0;9
18235;Žirmūnėliai;ZUIKUČIŲ;2904787614;Taip;17;0;0;17
18236;Žirmūnėliai;ZUIKUČIŲ;1025809131;Taip;14;0;0;14
18237;Žirmūnėliai;ZUIKUČIŲ;5929166560;Taip;6;1;4;11
18238;Žirmūnėliai;ZUIKUČIŲ;5104310002;Taip;2;0;1;3
18239;Žirmūnėliai;ZUIKUČIŲ;2506945279;Taip;0;17;0;17
18240;Žirmūnėliai;ZUIKUČIŲ;1473482823;Ne;2;0;0;2
18241;Žirmūnėliai;ZUIKUČIŲ;6899109664;Taip;0;6;0;6
18242;Žirmūnėliai;ZUIKUČIŲ;3949374730;Taip;10;0;0;10
18243;Žirmūnėliai;ZUIKUČIŲ;3767421827;Taip;0;0;14;14
18244;Žirmūnėliai;ZUIKUČIŲ;4327504033;Taip;4;0;0;4
18245;Žirmūnėliai;ZUIKUČIŲ;6869102228;Taip;0;1;5;6
18246;Žirmūnėliai;ZUIKUČIŲ;2841958534;Taip;8;1;1;10
18247;Žirmūnėliai;ZUIKUČIŲ;6430944858;Taip;5;0;0;5
18248;Žirmūnėliai;OBUOLIUKAI;9666769523;Taip;15;2;0;17
18249;Žirmūnėliai;OBUOLIUKAI;24877884441;Taip;0;8;0;8
18250;Žirmūnėliai;OBUOLIUKAI;85408994677;Taip;3;0;0;3
18251;Žirmūnėliai;OBUOLIUKAI;2336720944;Taip;0;3;4;7
18252;Žirmūnėliai;OBUOLIUKAI;1110585472;Taip;6;1;1;8
18253;Žirmūnėliai;OBUOLIUKAI;93072181228;Ne;2;2;0;4
18254;Žirmūnėliai;OBUOLIUKAI;155054610;Taip;0;4;7;11
18255;Žirmūnėliai;OBUOLIUKAI;89429083939;Taip;10;1;0;11
18256;Žirmūnėliai;OBUOLIUKAI;36305353664;Taip;9;0;0;9
18257;Žirmūnėliai;OBUOLIUKAI;4030572434;Taip;0;4;0;4
18258;Žirmūnėliai;OBUOLIUKAI;6758118659;Taip;0;4;0;4
18259;Žirmūnėliai;OBUOLIUKAI;53081289792;Taip;0;2;2;4
18260;Žirmūnėliai;OBUOLIUKAI;4675716163;Taip;11;0;0;11
18261;Žirmūnėliai;OBUOLIUKAI;2216383670;Ne;0;0;6;6
18262;Žirmūnėliai;OBUOLIUKAI;47645482781;Taip;1;2;0;3
18263;Žirmūnėliai;OBUOLIUKAI;9232201424;Ne;8;1;0;9
18264;Žirmūnėliai;OBUOLIUKAI;9448136354;Ne;0;9;5;14
18265;Žirmūnėliai;OBUOLIUKAI;19389343819;Taip;0;1;1;2
18266;Žirmūnėliai;OBUOLIUKAI;2094542223;Ne;3;11;0;14
18267;Dainorėliai;VARPELIAI;87242570532;Taip;5;1;0;6
18268;Dainorėliai;VARPELIAI;31902102771;Taip;0;3;2;5
18269;Dainorėliai;VARPELIAI;18233813290;Taip;0;2;0;2
18270;Dainorėliai;VARPELIAI;6176171443;Taip;0;1;0;1
18271;Dainorėliai;VARPELIAI;88781762328;Taip;5;3;1;9
18272;Dainorėliai;VARPELIAI;9319771186;Taip;0;2;4;6
18273;Dainorėliai;VARPELIAI;8719834064;Taip;9;2;0;11
18274;Dainorėliai;VARPELIAI;5693385617;Taip;1;1;5;7
18275;Dainorėliai;VARPELIAI;8267213392;Ne;0;7;0;7
18276;Dainorėliai;VARPELIAI;5959380807;Taip;0;2;0;2
18277;Dainorėliai;VARPELIAI;2938732886;Taip;0;2;0;2
18278;Dainorėliai;VARPELIAI;3183793211;Taip;4;1;0;5
18279;Dainorėliai;VARPELIAI;2797544232;Taip;5;0;0;5
18280;Dainorėliai;VARPELIAI;65467351140;Taip;0;3;4;7
18281;Dainorėliai;VARPELIAI;8521878734;Taip;0;1;0;1
18282;Dainorėliai;VARPELIAI;1928369859;Taip;5;1;0;6
18283;Dainorėliai;VARPELIAI;6909583023;Taip;10;1;0;11
18284;Dainorėliai;VARPELIAI;6430425182;Taip;0;2;0;2
18285;Dainorėliai;VARPELIAI;4269946363;Taip;4;8;2;14
18286;Dainorėliai;VARPELIAI;1088248393;Taip;10;3;3;16
18287;Dainorėliai;ŽIOGELIAI;99597416067;Taip;3;2;0;5
18288;Dainorėliai;ŽIOGELIAI;88201007119;Taip;6;2;0;8
18289;Dainorėliai;ŽIOGELIAI;31267856584;Ne;0;6;0;6
18290;Dainorėliai;ŽIOGELIAI;18936645521;Ne;8;1;0;9
18291;Dainorėliai;ŽIOGELIAI;35528654099;Taip;0;8;0;8
18292;Dainorėliai;ŽIOGELIAI;32573583030;Taip;0;4;0;4
18293;Dainorėliai;ŽIOGELIAI;1470784692;Taip;0;1;0;1
18294;Dainorėliai;ŽIOGELIAI;35134511946;Taip;7;0;0;7
18295;Dainorėliai;ŽIOGELIAI;67124516230;Taip;5;0;0;5
18296;Dainorėliai;ŽIOGELIAI;17358842027;Taip;3;1;0;4
18297;Dainorėliai;ŽIOGELIAI;54344466523;Taip;0;2;0;2
18298;Dainorėliai;ŽIOGELIAI;63211091321;Taip;0;5;0;5
18299;Dainorėliai;ŽIOGELIAI;45577031767;Taip;8;6;0;14
18300;Dainorėliai;ŽIOGELIAI;92157879830;Ne;0;2;0;2
18301;Dainorėliai;ŽIOGELIAI;80499999855;Taip;0;1;0;1
18302;Dainorėliai;ŽIOGELIAI;72073028506;Ne;5;1;0;6
18303;Dainorėliai;ŽIOGELIAI;3761026792;Taip;10;1;0;11
18304;Dainorėliai;ŽIOGELIAI;58071607976;Taip;0;5;2;7
18305;Dainorėliai;DRUGELIAI;6411939690;Taip;5;4;0;9
18306;Dainorėliai;DRUGELIAI;50432354832;Taip;0;2;0;2
18307;Dainorėliai;DRUGELIAI;19286303769;Taip;0;1;0;1
18308;Dainorėliai;DRUGELIAI;2483267929;Taip;0;3;0;3
18309;Dainorėliai;DRUGELIAI;1015870220;Taip;0;3;0;3
18310;Dainorėliai;DRUGELIAI;6404337541;Taip;0;0;3;3
18311;Dainorėliai;DRUGELIAI;94480397292;Taip;4;0;4;8
18312;Dainorėliai;DRUGELIAI;53935690864;Taip;2;1;0;3
18313;Dainorėliai;DRUGELIAI;86187568203;Taip;0;4;1;5
18314;Dainorėliai;DRUGELIAI;5238082419;Taip;6;0;0;6
18315;Dainorėliai;DRUGELIAI;49483881135;Taip;11;1;0;12
18316;Dainorėliai;DRUGELIAI;1626877066;Taip;4;0;0;4
18317;Dainorėliai;DRUGELIAI;1158895670;Taip;12;2;0;14
18318;Dainorėliai;DRUGELIAI;4087344015;Taip;3;0;0;3
18319;Dainorėliai;DRUGELIAI;3128897752;Taip;5;0;1;6
18320;Dainorėliai;DRUGELIAI;1357413314;Taip;3;1;3;7
18321;Dainorėliai;DRUGELIAI;1515552402;Ne;0;8;0;8
18322;Dainorėliai;DRUGELIAI;36313982965;Taip;0;2;2;4
18323;Dainorėliai;"3 klasė";4792505132;Taip;0;1;0;1
18324;Dainorėliai;"3 klasė";9028699114;Taip;0;1;0;1
18325;Dainorėliai;"3 klasė";1629229178;Ne;0;1;0;1
18326;Dainorėliai;"3 klasė";3109138914;Taip;0;1;0;1
18327;Dainorėliai;"3 klasė";6513001151;Taip;0;1;0;1
18328;Dainorėliai;"3 klasė";7332518731;Taip;0;1;0;1
18329;Dainorėliai;"3 klasė";7013545705;Taip;0;1;0;1
18330;Dainorėliai;"3 klasė";5181789063;Taip;0;1;0;1
18331;Dainorėliai;"3 klasė";4642369086;Taip;3;1;0;4
18332;Dainorėliai;"3 klasė";7589862952;Ne;0;1;0;1
18333;Dainorėliai;"3 klasė";2135997501;Taip;4;1;0;5
18334;Dainorėliai;"3 klasė";2991348691;Taip;0;1;0;1
18335;Dainorėliai;"3 klasė";1472986325;Ne;1;1;0;2
18336;Dainorėliai;"3 klasė";9691052273;Taip;10;1;0;11
18337;Dainorėliai;"3 klasė";4631981231;Ne;1;1;0;2
18338;Dainorėliai;"3 klasė";6576505338;Ne;5;1;0;6
18339;Dainorėliai;"3 klasė";47031645815;Ne;3;1;0;4
18340;Dainorėliai;"3 klasė";1734712911;Taip;0;1;0;1
18341;Dainorėliai;"3 klasė";6898321145;Taip;0;1;0;1
18342;Dainorėliai;"3 klasė";8014881349;Taip;0;1;0;1
18343;Dainorėliai;"3 klasė";2685423821;Taip;0;1;0;1
18344;Dainorėliai;"3 klasė";3713835329;Taip;0;1;0;1
18345;Dainorėliai;"3 klasė";4309610318;Taip;0;1;0;1
18346;Dainorėliai;"3 klasė";3916502039;Taip;3;1;0;4
18347;Dainorėliai;"4 klasė";1289801462;Taip;0;1;0;1
18348;Dainorėliai;"4 klasė";7327414673;Taip;0;1;0;1
18349;Dainorėliai;"4 klasė";6497830034;Taip;0;1;0;1
18350;Dainorėliai;"4 klasė";8569165891;Taip;0;1;0;1
18351;Dainorėliai;"4 klasė";7309477306;Taip;0;1;0;1
18352;Dainorėliai;"4 klasė";3683531357;Ne;3;1;0;4
18353;Dainorėliai;"4 klasė";4490125789;Taip;1;1;0;2
18354;Dainorėliai;"4 klasė";4497264004;Taip;2;1;0;3
18355;Dainorėliai;"4 klasė";2704452184;Taip;0;1;0;1
18356;Dainorėliai;"4 klasė";5468429196;Taip;0;1;0;1
18357;Dainorėliai;"4 klasė";2519518637;Taip;0;1;0;1
18358;Dainorėliai;"4 klasė";5072041112;Taip;0;1;0;1
18359;Dainorėliai;"4 klasė";1347410803;Taip;2;1;0;3
18360;Dainorėliai;"4 klasė";2164782968;Ne;0;1;0;1
18361;Dainorėliai;"4 klasė";1311444933;Taip;0;1;0;1
18362;Dainorėliai;"4 klasė";3053044929;Taip;0;1;0;1
18363;Dainorėliai;"4 klasė";5177714429;Ne;2;1;0;3
18364;Dainorėliai;"4 klasė";4275023010;Taip;4;1;0;5
18365;Dainorėliai;"4 klasė";74881322515;Taip;0;1;0;1
18366;Dainorėliai;"4 klasė";4691497223;Taip;7;1;0;8
18367;Dainorėliai;SAULUTĖS;4798415786;Taip;0;1;2;3
18368;Dainorėliai;SAULUTĖS;5102030168;Taip;14;0;0;14
18369;Dainorėliai;SAULUTĖS;6704354150;Taip;3;5;0;8
18370;Dainorėliai;SAULUTĖS;4612995336;Taip;10;0;0;10
18371;Dainorėliai;SAULUTĖS;5687390372;Taip;0;1;0;1
18372;Dainorėliai;SAULUTĖS;6697149560;Taip;8;0;2;10
18373;Dainorėliai;SAULUTĖS;3605697179;Taip;0;0;3;3
18374;Dainorėliai;SAULUTĖS;8977759216;Ne;12;1;1;14
18375;Dainorėliai;SAULUTĖS;8857018998;Taip;18;0;0;18
18376;Dainorėliai;SAULUTĖS;7118473669;Ne;0;1;1;2
18377;Dainorėliai;SAULUTĖS;4307591123;Taip;11;0;0;11
18378;Dainorėliai;SAULUTĖS;2070086316;Taip;4;1;0;5
18379;Dainorėliai;SAULUTĖS;5632663846;Taip;5;6;4;15
18380;Dainorėliai;SAULUTĖS;7804441689;Taip;13;0;0;13
18381;Dainorėliai;SAULUTĖS;6090746954;Taip;0;1;0;1
18382;Dainorėliai;SAULUTĖS;5410183494;Taip;6;0;3;9
18383;Dainorėliai;SAULUTĖS;9130473411;Taip;3;0;0;3
18384;Dainorėliai;SAULUTĖS;5587907483;Ne;16;0;0;16
18385;Dainorėliai;SAULUTĖS;1547686786;Taip;11;1;0;12
18386;Dainorėliai;SAULUTĖS;3762178533;Taip;1;1;0;2
18387;Dainorėliai;PUMPURĖLIŲ;6513417505;Taip;11;4;0;15
18388;Dainorėliai;PUMPURĖLIŲ;2293472716;Taip;0;0;3;3
18389;Dainorėliai;PUMPURĖLIŲ;5605084046;Taip;4;1;0;5
18390;Dainorėliai;PUMPURĖLIŲ;8015545426;Taip;0;1;4;5
18391;Dainorėliai;PUMPURĖLIŲ;4286864865;Taip;8;0;0;8
18392;Dainorėliai;PUMPURĖLIŲ;1554081754;Taip;13;0;0;13
18393;Dainorėliai;PUMPURĖLIŲ;9568647033;Taip;0;16;0;16
18394;Dainorėliai;PUMPURĖLIŲ;2823401633;Taip;6;0;0;6
18395;Dainorėliai;PUMPURĖLIŲ;7054808979;Ne;9;8;0;17
18396;Dainorėliai;PUMPURĖLIŲ;9562194143;Taip;0;0;5;5
18397;Dainorėliai;PUMPURĖLIŲ;1381923971;Taip;18;4;0;22
18398;Dainorėliai;PUMPURĖLIŲ;4033317616;Taip;20;0;0;20
18399;Dainorėliai;PUMPURĖLIŲ;6449332338;Taip;0;4;0;4
18400;Dainorėliai;PUMPURĖLIŲ;9285865812;Taip;0;4;0;4
18401;Dainorėliai;PUMPURĖLIŲ;6284140548;Taip;11;4;0;15
18402;Dainorėliai;PUMPURĖLIŲ;5283566263;Ne;7;4;0;11
18403;Dainorėliai;PUMPURĖLIŲ;1826360100;Taip;5;0;0;5
18404;Dainorėliai;DEBESĖLIŲ;1300411811;Taip;0;15;0;15
18405;Dainorėliai;DEBESĖLIŲ;2003536788;Taip;0;11;0;11
18406;Dainorėliai;DEBESĖLIŲ;4648003100;Taip;0;14;0;14
18407;Dainorėliai;DEBESĖLIŲ;14071513289;Taip;10;1;0;11
18408;Dainorėliai;DEBESĖLIŲ;6378297641;Taip;2;1;0;3
18409;Dainorėliai;DEBESĖLIŲ;40762091796;Taip;0;13;0;13
18410;Dainorėliai;DEBESĖLIŲ;6373805301;Ne;0;11;0;11
18411;Dainorėliai;DEBESĖLIŲ;1355661922;Taip;3;0;0;3
18412;Dainorėliai;DEBESĖLIŲ;5189351158;Ne;0;0;3;3
18413;Dainorėliai;DEBESĖLIŲ;42514000113;Ne;0;9;0;9
18414;Dainorėliai;DEBESĖLIŲ;2093218810;Taip;10;2;0;12
18415;Dainorėliai;DEBESĖLIŲ;4058545269;Taip;0;3;0;3
18416;Dainorėliai;DEBESĖLIŲ;2531690903;Taip;0;11;0;11
18417;Dainorėliai;DEBESĖLIŲ;74139269246;Taip;2;1;1;4
18418;Dainorėliai;DEBESĖLIŲ;1046385778;Taip;0;7;0;7
18419;Dainorėliai;DEBESĖLIŲ;25015347703;Taip;6;15;0;21
18420;Dainorėliai;DEBESĖLIŲ;6994378824;Taip;7;4;0;11
18421;Dainorėliai;DEBESĖLIŲ;4112888398;Taip;10;7;0;17
18422;Lokiukas;BITUTĖS;6758550653;Taip;21;0;0;21
18423;Lokiukas;BITUTĖS;1040288021;Taip;20;1;0;21
18424;Lokiukas;BITUTĖS;1733486244;Taip;5;1;0;6
18425;Lokiukas;BITUTĖS;6336140882;Taip;0;9;3;12
18426;Lokiukas;BITUTĖS;9142262360;Taip;0;1;0;1
18427;Lokiukas;BITUTĖS;8775608581;Taip;0;1;0;1
18428;Lokiukas;BITUTĖS;1752784666;Taip;4;1;0;5
18429;Lokiukas;BITUTĖS;34546519642;Taip;0;0;1;1
18430;Lokiukas;BITUTĖS;1025576053;Taip;5;1;3;9
18431;Lokiukas;BITUTĖS;6069516217;Taip;0;12;0;12
18432;Lokiukas;BITUTĖS;7943213321;Taip;5;1;0;6
18433;Lokiukas;BITUTĖS;8915504279;Taip;2;2;2;6
18434;Lokiukas;BITUTĖS;4007839265;Taip;6;2;0;8
18435;Lokiukas;BITUTĖS;8796640190;Taip;13;1;0;14
18436;Lokiukas;BITUTĖS;5943412920;Taip;0;1;0;1
18437;Lokiukas;BITUTĖS;2885398200;Taip;0;1;0;1
18438;Lokiukas;BITUTĖS;3694653020;Taip;10;0;0;10
18439;Lokiukas;BITUTĖS;4379238557;Taip;5;4;0;9
18440;Lokiukas;BITUTĖS;2052174669;Taip;7;4;0;11
18441;Lokiukas;BITUTĖS;8902619265;Taip;5;4;0;9
18442;Lokiukas;BITUTĖS;9336617879;Taip;0;2;2;4
18443;Lokiukas;BITUTĖS;3485639108;Taip;0;2;1;3
18444;Lokiukas;"1 B klasė";18336619115;Taip;2;0;0;2
18445;Lokiukas;"1 B klasė";32506466236;Taip;5;0;0;5
18446;Lokiukas;"1 B klasė";7324496782;Taip;21;0;0;21
18447;Lokiukas;"1 B klasė";10811780420;Taip;2;0;0;2
18448;Lokiukas;"1 B klasė";28796727185;Taip;16;0;0;16
18449;Lokiukas;"1 B klasė";96046361641;Taip;6;0;0;6
18450;Lokiukas;"1 B klasė";95910336503;Taip;2;0;0;2
18451;Lokiukas;"1 B klasė";88415635113;Taip;10;0;0;10
18452;Lokiukas;"1 B klasė";7497324442;Ne;21;0;0;21
18453;Lokiukas;"1 B klasė";7903535850;Taip;11;0;0;11
18454;Lokiukas;"1 B klasė";61890775725;Taip;1;0;0;1
18455;Lokiukas;"1 B klasė";24221829774;Taip;5;0;0;5
18456;Lokiukas;"1 B klasė";58513885211;Taip;7;0;0;7
18457;Lokiukas;"1 B klasė";57958699478;Ne;3;0;0;3
18458;Lokiukas;"1 B klasė";79109699217;Taip;4;0;0;4
18459;Lokiukas;"1 B klasė";18646642032;Taip;6;0;0;6
18460;Lokiukas;"1 B klasė";50713289266;Ne;3;0;0;3
18461;Lokiukas;"1 B klasė";20231469825;Ne;5;0;0;5
18462;Lokiukas;"1 B klasė";1146878499;Taip;6;0;0;6
18463;Lokiukas;"1 B klasė";46587243900;Taip;6;0;0;6
18464;Lokiukas;"1 B klasė";9141446821;Taip;1;0;0;1
18465;Lokiukas;"1 B klasė";75507005694;Taip;2;0;0;2
18466;Lokiukas;"1 B klasė";73426072972;Ne;16;0;0;16
18467;Lokiukas;"1 B klasė";59913848400;Taip;16;0;0;16
18468;Lokiukas;"1 B klasė";39867459515;Taip;8;0;0;8
18469;Lokiukas;"1 B klasė";2105377652;Taip;1;0;0;1
18470;Lokiukas;"1 B klasė";2105377652;Taip;1;0;0;1
18471;Lokiukas;"1 B klasė";62268017779;Taip;8;0;0;8
18472;Lokiukas;"1 B klasė";62268017779;Taip;8;0;0;8
18473;Lokiukas;"1 A klasė";15406362908;Taip;3;0;0;3
18474;Lokiukas;"1 A klasė";45122233067;Taip;3;0;0;3
18475;Lokiukas;"1 A klasė";21802863853;Taip;3;0;0;3
18476;Lokiukas;"1 A klasė";84682977618;Taip;5;0;0;5
18477;Lokiukas;"1 A klasė";22979689191;Taip;5;0;0;5
18478;Lokiukas;"1 A klasė";80754592972;Taip;4;0;0;4
18479;Lokiukas;"1 A klasė";14903100496;Taip;3;0;0;3
18480;Lokiukas;"1 A klasė";99706061553;Taip;3;0;0;3
18481;Lokiukas;"1 A klasė";7785940412;Taip;21;0;0;21
18482;Lokiukas;"1 A klasė";24099693663;Taip;21;0;0;21
18483;Lokiukas;"1 A klasė";72092394330;Taip;8;0;0;8
18484;Lokiukas;"1 A klasė";9413274607;Taip;4;0;0;4
18485;Lokiukas;"1 A klasė";35769782473;Taip;16;0;0;16
18486;Lokiukas;"1 A klasė";38531751377;Taip;3;0;0;3
18487;Lokiukas;"1 A klasė";80793623068;Ne;9;0;0;9
18488;Lokiukas;"1 A klasė";25170045140;Ne;21;0;0;21
18489;Lokiukas;"1 A klasė";10948160841;Taip;21;0;0;21
18490;Lokiukas;"1 A klasė";4608275224;Taip;8;0;0;8
18491;Lokiukas;"1 A klasė";43070670534;Taip;2;0;0;2
18492;Lokiukas;"1 A klasė";59840033826;Taip;21;0;0;21
18493;Lokiukas;"1 A klasė";1855267362;Taip;3;0;0;3
18494;Lokiukas;"1 A klasė";84273668685;Taip;2;0;0;2
18495;Lokiukas;"1 A klasė";9747265775;Taip;3;0;0;3
18496;Lokiukas;"1 A klasė";5198408183;Taip;3;0;0;3
18497;Lokiukas;"1 A klasė";93374754851;Ne;6;0;0;6
18498;Lokiukas;"1 A klasė";15685936471;Taip;3;0;0;3
18499;Lokiukas;"1 A klasė";97609897018;Taip;4;0;0;4
18500;Lokiukas;"1 A klasė";23688235312;Taip;3;0;0;3
18501;Lokiukas;"1 A klasė";15574258138;Ne;2;0;0;2
18502;Lokiukas;"1 A klasė";9077016953;Taip;6;0;0;6
18503;Lokiukas;GUDRUČIAI;7334971595;Ne;12;1;0;13
18504;Lokiukas;GUDRUČIAI;83279104490;Taip;8;0;0;8
18505;Lokiukas;GUDRUČIAI;7235277422;Taip;9;1;1;11
18506;Lokiukas;GUDRUČIAI;7130407913;Taip;0;1;1;2
18507;Lokiukas;GUDRUČIAI;1072148409;Taip;0;1;1;2
18508;Lokiukas;GUDRUČIAI;57505829630;Taip;0;1;1;2
18509;Lokiukas;GUDRUČIAI;7628603262;Taip;2;1;0;3
18510;Lokiukas;GUDRUČIAI;2959877846;Taip;2;1;1;4
18511;Lokiukas;GUDRUČIAI;32714964224;Taip;3;1;0;4
18512;Lokiukas;GUDRUČIAI;8920359311;Taip;0;4;0;4
18513;Lokiukas;GUDRUČIAI;1133294157;Taip;8;1;0;9
18514;Lokiukas;GUDRUČIAI;38884246104;Ne;0;1;3;4
18515;Lokiukas;GUDRUČIAI;29396361769;Taip;0;5;1;6
18516;Lokiukas;GUDRUČIAI;51059574159;Taip;3;0;0;3
18517;Lokiukas;GUDRUČIAI;2955445066;Ne;0;1;6;7
18518;Lokiukas;BORUŽĖLĖS;4849031542;Taip;0;12;0;12
18519;Lokiukas;BORUŽĖLĖS;9307491947;Taip;11;0;0;11
18520;Lokiukas;BORUŽĖLĖS;3744484616;Taip;9;1;1;11
18521;Lokiukas;BORUŽĖLĖS;8286358519;Taip;9;1;0;10
18522;Lokiukas;BORUŽĖLĖS;2625981190;Taip;15;1;0;16
18523;Lokiukas;BORUŽĖLĖS;4585621105;Taip;0;1;0;1
18524;Lokiukas;BORUŽĖLĖS;5522089503;Taip;15;1;2;18
18525;Lokiukas;BORUŽĖLĖS;8576418875;Taip;20;1;0;21
18526;Lokiukas;BORUŽĖLĖS;4617372387;Taip;16;0;0;16
18527;Lokiukas;BORUŽĖLĖS;6869785650;Taip;5;7;0;12
18528;Lokiukas;BORUŽĖLĖS;8630112458;Taip;10;1;0;11
18529;Lokiukas;BORUŽĖLĖS;5467387832;Taip;14;0;0;14
18530;Lokiukas;BORUŽĖLĖS;6245610875;Taip;16;3;0;19
18531;Lokiukas;BORUŽĖLĖS;3930463578;Taip;5;1;4;10
18532;Lokiukas;BORUŽĖLĖS;3333990952;Taip;11;0;0;11
18533;Lokiukas;BORUŽĖLĖS;5548875714;Taip;11;0;0;11
18534;Lokiukas;BORUŽĖLĖS;1833001939;Taip;0;6;7;13
18535;Lokiukas;BORUŽĖLĖS;2660616022;Taip;8;0;0;8
18536;Lokiukas;BORUŽĖLĖS;9798351980;Taip;8;0;2;10
18537;Lokiukas;BORUŽĖLĖS;5401463671;Ne;8;4;0;12
18538;Lokiukas;BORUŽĖLĖS;9996442005;Ne;3;3;0;6
18539;Lokiukas;BORUŽĖLĖS;4317453894;Taip;0;2;1;3
18540;Lokiukas;BORUŽĖLĖS;1226376844;Ne;11;8;0;19
18541;Lokiukas;ANČIUKAI;5518041213;Taip;11;0;1;12
18542;Lokiukas;ANČIUKAI;8738488104;Taip;11;0;1;12
18543;Lokiukas;ANČIUKAI;9834746275;Taip;0;16;0;16
18544;Lokiukas;ANČIUKAI;4197547631;Taip;0;7;2;9
18545;Lokiukas;ANČIUKAI;7783006852;Taip;4;0;0;4
18546;Lokiukas;ANČIUKAI;8596706753;Taip;20;1;0;21
18547;Lokiukas;ANČIUKAI;7006828256;Taip;5;1;0;6
18548;Lokiukas;ANČIUKAI;2782818158;Taip;0;1;3;4
18549;Lokiukas;ANČIUKAI;1170293017;Taip;6;2;0;8
18550;Lokiukas;ANČIUKAI;7532603655;Taip;0;2;0;2
18551;Lokiukas;ANČIUKAI;2021477393;Taip;0;4;0;4
18552;Lokiukas;ANČIUKAI;4442073527;Taip;8;5;0;13
18553;Lokiukas;ANČIUKAI;4206181176;Taip;0;1;0;1
18554;Lokiukas;ANČIUKAI;4858829710;Taip;7;1;0;8
18555;Lokiukas;KODĖLČIUKAI;2548712970;Taip;8;1;0;9
18556;Lokiukas;KODĖLČIUKAI;2673522432;Taip;6;1;0;7
18557;Lokiukas;KODĖLČIUKAI;8399364170;Taip;5;2;0;7
18558;Lokiukas;KODĖLČIUKAI;4427448272;Taip;4;0;0;4
18559;Lokiukas;KODĖLČIUKAI;4580716838;Taip;1;2;1;4
18560;Lokiukas;KODĖLČIUKAI;1201125655;Taip;0;1;0;1
18561;Lokiukas;KODĖLČIUKAI;67133709394;Taip;15;1;0;16
18562;Lokiukas;KODĖLČIUKAI;73696992182;Taip;8;1;0;9
18563;Lokiukas;KODĖLČIUKAI;1056075876;Taip;0;1;0;1
18564;Lokiukas;KODĖLČIUKAI;82025637099;Taip;4;1;0;5
18565;Lokiukas;KODĖLČIUKAI;73515179103;Taip;8;0;0;8
18566;Lokiukas;KODĖLČIUKAI;131300206;Taip;3;2;0;5
18567;Lokiukas;KODĖLČIUKAI;66528256040;Taip;0;3;0;3
18568;Lokiukas;KODĖLČIUKAI;7495691956;Ne;10;1;2;13
18569;Lokiukas;KODĖLČIUKAI;83528495608;Ne;8;0;0;8
18570;Lokiukas;KODĖLČIUKAI;1333650630;Ne;0;1;0;1
18571;Lokiukas;KODĖLČIUKAI;52940830874;Taip;0;7;0;7
18572;Lokiukas;KODĖLČIUKAI;8240261104;Taip;0;2;0;2
18573;Lokiukas;KODĖLČIUKAI;41809745552;Taip;13;1;1;15
18574;Lokiukas;KODĖLČIUKAI;83086633109;Taip;10;1;0;11
18575;Lokiukas;DRUGELIAI;7942641594;Taip;7;1;0;8
18576;Lokiukas;DRUGELIAI;8568285232;Taip;0;3;0;3
18577;Lokiukas;DRUGELIAI;5453470660;Taip;0;3;0;3
18578;Lokiukas;DRUGELIAI;14605095801;Taip;0;1;2;3
18579;Lokiukas;DRUGELIAI;46838695582;Taip;0;7;0;7
18580;Lokiukas;DRUGELIAI;2642065594;Taip;5;2;0;7
18581;Lokiukas;DRUGELIAI;1626698185;Taip;6;0;0;6
18582;Lokiukas;DRUGELIAI;39222094073;Taip;14;0;1;15
18583;Lokiukas;DRUGELIAI;1695680881;Taip;0;1;0;1
18584;Lokiukas;DRUGELIAI;69364831994;Taip;5;1;0;6
18585;Lokiukas;DRUGELIAI;78106313493;Taip;10;0;0;10
18586;Lokiukas;DRUGELIAI;1625137322;Taip;7;6;0;13
18587;Lokiukas;DRUGELIAI;1381505711;Taip;0;12;0;12
18588;Lokiukas;DRUGELIAI;8452600632;Taip;5;11;0;16
18589;Lokiukas;DRUGELIAI;7386571822;Ne;10;1;2;13
18590;Lokiukas;DRUGELIAI;35890122494;Taip;9;1;0;10
18591;Lokiukas;DRUGELIAI;1210407640;Taip;0;5;2;7
18592;Lokiukas;DRUGELIAI;7591418969;Taip;10;1;0;11
18593;Lokiukas;DRUGELIAI;8270572748;Taip;10;1;0;11
18594;Lokiukas;DRUGELIAI;8036643654;Taip;16;0;0;16
18595;Lokiukas;DRUGELIAI;2476231041;Ne;0;1;0;1
18596;Lokiukas;"2 A klasė";67818191566;Taip;8;0;0;8
18597;Lokiukas;"2 A klasė";45280536946;Taip;21;0;0;21
18598;Lokiukas;"2 A klasė";53087036306;Taip;21;0;0;21
18599;Lokiukas;"2 A klasė";79223457439;Ne;14;0;0;14
18600;Lokiukas;"2 A klasė";75613665040;Taip;2;0;0;2
18601;Lokiukas;"2 A klasė";1143130271;Taip;2;0;0;2
18602;Lokiukas;"2 A klasė";86623153797;Taip;2;0;0;2
18603;Lokiukas;"2 A klasė";27050402360;Ne;9;0;0;9
18604;Lokiukas;"2 A klasė";43389930516;Taip;2;0;0;2
18605;Lokiukas;"2 A klasė";53245573692;Taip;3;0;0;3
18606;Lokiukas;"2 A klasė";23222644824;Taip;7;0;0;7
18607;Lokiukas;"2 A klasė";52296454506;Ne;3;0;0;3
18608;Lokiukas;"2 A klasė";66999644935;Taip;21;0;0;21
18609;Lokiukas;"2 A klasė";72167964645;Ne;6;0;0;6
18610;Lokiukas;"2 A klasė";2143040924;Taip;21;0;0;21
18611;Lokiukas;"2 A klasė";3206276637;Taip;21;0;0;21
18612;Lokiukas;"2 A klasė";5775631777;Ne;8;0;0;8
18613;Lokiukas;"2 A klasė";25058082693;Ne;21;0;0;21
18614;Lokiukas;"2 A klasė";38636200254;Ne;2;0;0;2
18615;Lokiukas;"2 A klasė";47410036889;Taip;2;0;0;2
18616;Lokiukas;"2 A klasė";53544600623;Taip;21;0;0;21
18617;Lokiukas;"2 A klasė";14341255985;Taip;8;0;0;8
18618;Lokiukas;"2 A klasė";6702448475;Taip;2;0;0;2
18619;Lokiukas;"2 A klasė";82966541165;Taip;4;0;0;4
18620;Lokiukas;"2 A klasė";80180114948;Taip;15;0;0;15
18621;Lokiukas;"2 A klasė";42292408557;Taip;3;0;0;3
18622;Lokiukas;"2 A klasė";10240586503;Taip;21;0;0;21
18623;Lokiukas;"2 A klasė";3703002168;Taip;4;0;0;4
18624;Lokiukas;"2 B klasė";35018370441;Taip;1;0;0;1
18625;Lokiukas;"2 B klasė";60370754283;Taip;1;0;0;1
18626;Lokiukas;"2 B klasė";98289469398;Taip;1;0;0;1
18627;Lokiukas;"2 B klasė";15445053855;Taip;1;0;0;1
18628;Lokiukas;"2 B klasė";3262579895;Taip;7;0;0;7
18629;Lokiukas;"2 B klasė";17622979450;Taip;2;0;0;2
18630;Lokiukas;"2 B klasė";51554951703;Taip;5;0;0;5
18631;Lokiukas;"2 B klasė";88947878548;Ne;1;0;0;1
18632;Lokiukas;"2 B klasė";29198900240;Taip;2;0;0;2
18633;Lokiukas;"2 B klasė";17034757778;Taip;4;0;0;4
18634;Lokiukas;"2 B klasė";1716358913;Taip;1;0;0;1
18635;Lokiukas;"2 B klasė";77441549037;Taip;3;0;0;3
18636;Lokiukas;"2 B klasė";79301547085;Ne;1;0;0;1
18637;Lokiukas;"2 B klasė";10897713744;Taip;7;0;0;7
18638;Lokiukas;"2 B klasė";16889795010;Ne;21;0;0;21
18639;Lokiukas;"2 B klasė";45805925058;Taip;6;0;0;6
18640;Lokiukas;"2 B klasė";5067673212;Taip;2;0;0;2
18641;Lokiukas;"2 B klasė";1104333637;Taip;1;0;0;1
18642;Lokiukas;"2 B klasė";79597160668;Taip;1;0;0;1
18643;Lokiukas;"2 B klasė";45735190114;Taip;21;0;0;21
18644;Lokiukas;"2 B klasė";37669645510;Taip;1;0;0;1
18645;Lokiukas;"2 B klasė";2353550739;Taip;21;0;0;21
18646;Lokiukas;"2 B klasė";15004419516;Taip;2;0;0;2
18647;Lokiukas;"2 B klasė";69089214980;Taip;6;0;0;6
18648;Lokiukas;"3 A klasė";2374089307;Ne;1;0;0;1
18649;Lokiukas;"3 A klasė";2607988265;Taip;10;0;0;10
18650;Lokiukas;"3 A klasė";4992275038;Taip;1;0;0;1
18651;Lokiukas;"3 A klasė";1492303633;Taip;1;0;0;1
18652;Lokiukas;"3 A klasė";6856770462;Ne;6;0;0;6
18653;Lokiukas;"3 A klasė";8766212402;Ne;5;0;0;5
18654;Lokiukas;"3 A klasė";5559967651;Taip;15;0;0;15
18655;Lokiukas;"3 A klasė";3528533437;Taip;21;0;0;21
18656;Lokiukas;"3 A klasė";5465758477;Taip;1;0;0;1
18657;Lokiukas;"3 A klasė";5700685872;Ne;2;0;0;2
18658;Lokiukas;"3 A klasė";6496662759;Taip;11;0;0;11
18659;Lokiukas;"3 A klasė";5737714024;Ne;1;0;0;1
18660;Lokiukas;"3 A klasė";7069020705;Ne;4;0;0;4
18661;Lokiukas;"3 A klasė";6129602024;Ne;1;0;0;1
18662;Lokiukas;"3 A klasė";9199283952;Taip;21;0;0;21
18663;Lokiukas;"3 A klasė";8378630091;Taip;6;0;0;6
18664;Lokiukas;"3 A klasė";3138145333;Ne;21;0;0;21
18665;Lokiukas;"3 A klasė";3506723678;Taip;2;0;0;2
18666;Lokiukas;"3 A klasė";1555365851;Ne;14;0;0;14
18667;Lokiukas;"3 A klasė";4615481025;Ne;6;0;0;6
18668;Lokiukas;"3 A klasė";5889819809;Ne;1;0;0;1
18669;Lokiukas;"3 A klasė";8499895935;Taip;21;0;0;21
18670;Lokiukas;"3 A klasė";7553457572;Ne;10;0;0;10
18671;Lokiukas;"3 A klasė";1571404671;Taip;12;0;0;12
18672;Lokiukas;"3 A klasė";1729941577;Taip;11;0;0;11
18673;Lokiukas;"3 B klasė";5745254234;Taip;4;0;0;4
18674;Lokiukas;"3 B klasė";8189433550;Taip;21;0;0;21
18675;Lokiukas;"3 B klasė";9114504810;Taip;3;0;0;3
18676;Lokiukas;"3 B klasė";1048772300;Taip;12;0;0;12
18677;Lokiukas;"3 B klasė";2021690274;Taip;3;0;0;3
18678;Lokiukas;"3 B klasė";5918592397;Taip;8;0;0;8
18679;Lokiukas;"3 B klasė";6538311120;Taip;11;0;0;11
18680;Lokiukas;"3 B klasė";7595514531;Taip;8;0;0;8
18681;Lokiukas;"3 B klasė";7144013238;Ne;12;0;0;12
18682;Lokiukas;"3 B klasė";8235437961;Taip;4;0;0;4
18683;Lokiukas;"3 B klasė";2905935730;Taip;21;0;0;21
18684;Lokiukas;"3 B klasė";8395026474;Ne;4;0;0;4
18685;Lokiukas;"3 B klasė";7439047502;Taip;3;0;0;3
18686;Lokiukas;"3 B klasė";8954484534;Taip;3;0;0;3
18687;Lokiukas;"3 B klasė";7722830021;Taip;5;0;0;5
18688;Lokiukas;"3 B klasė";9681048306;Taip;21;0;0;21
18689;Lokiukas;"3 B klasė";1388342336;Taip;6;0;0;6
18690;Lokiukas;"3 B klasė";1746819279;Taip;4;0;0;4
18691;Lokiukas;"3 B klasė";4418425219;Taip;10;0;0;10
18692;Lokiukas;"3 B klasė";3364994110;Taip;21;0;0;21
18693;Lokiukas;"3 B klasė";6063796643;Taip;3;0;0;3
18694;Lokiukas;"3 B klasė";6663700618;Taip;3;0;0;3
18695;Lokiukas;"3 B klasė";6151885589;Taip;4;0;0;4
18696;Lokiukas;"3 B klasė";1440437389;Taip;3;0;0;3
18697;Lokiukas;"3 B klasė";2059112380;Taip;3;0;0;3
18698;Lokiukas;"3 B klasė";1676862169;Ne;3;0;0;3
18699;Lokiukas;"4 A klasė";2220223549;Taip;21;0;0;21
18700;Lokiukas;"4 A klasė";7349936354;Ne;2;0;0;2
18701;Lokiukas;"4 A klasė";8192834838;Taip;5;0;0;5
18702;Lokiukas;"4 A klasė";7086818828;Taip;17;0;0;17
18703;Lokiukas;"4 A klasė";8959417696;Taip;3;0;0;3
18704;Lokiukas;"4 A klasė";1362995666;Taip;2;0;0;2
18705;Lokiukas;"4 A klasė";4873942674;Taip;21;0;0;21
18706;Lokiukas;"4 A klasė";2745780921;Taip;8;0;0;8
18707;Lokiukas;"4 A klasė";3007573139;Taip;13;0;0;13
18708;Lokiukas;"4 A klasė";5058488696;Taip;3;0;0;3
18709;Lokiukas;"4 A klasė";6008557035;Taip;13;0;0;13
18710;Lokiukas;"4 A klasė";1243245356;Taip;2;0;0;2
18711;Lokiukas;"4 A klasė";9322204885;Taip;21;0;0;21
18712;Lokiukas;"4 A klasė";1822055099;Ne;21;0;0;21
18713;Lokiukas;"4 A klasė";3700837936;Taip;8;0;0;8
18714;Lokiukas;"4 A klasė";6022402998;Taip;11;0;0;11
18715;Lokiukas;"4 A klasė";9743363133;Taip;13;0;0;13
18716;Lokiukas;"4 A klasė";2029507962;Taip;10;0;0;10
18717;Lokiukas;"4 A klasė";88967710414;Taip;7;0;0;7
18718;Lokiukas;"4 A klasė";88967710414;Taip;7;0;0;7
18719;Lokiukas;"4 A klasė";2129701351;Taip;15;0;0;15
18720;Lokiukas;"4 B klasė";1692231191;Taip;1;0;0;1
18721;Lokiukas;"4 B klasė";2284932363;Taip;8;0;0;8
18722;Lokiukas;"4 B klasė";4160279615;Taip;13;0;0;13
18723;Lokiukas;"4 B klasė";4368235682;Taip;1;0;0;1
18724;Lokiukas;"4 B klasė";9376247296;Taip;13;0;0;13
18725;Lokiukas;"4 B klasė";7943448919;Taip;5;0;0;5
18726;Lokiukas;"4 B klasė";9922964495;Taip;6;0;0;6
18727;Lokiukas;"4 B klasė";8822883914;Ne;13;0;0;13
18728;Lokiukas;"4 B klasė";6270747705;Taip;1;0;0;1
18729;Lokiukas;"4 B klasė";9390626220;Taip;21;0;0;21
18730;Lokiukas;"4 B klasė";5562737843;Taip;3;0;0;3
18731;Lokiukas;"4 B klasė";4467643205;Taip;3;0;0;3
18732;Lokiukas;"4 B klasė";6110849113;Taip;6;0;0;6
18733;Lokiukas;"4 B klasė";8175005473;Taip;10;0;0;10
18734;Lokiukas;"4 B klasė";4504812769;Taip;9;0;0;9
18735;Lokiukas;"4 B klasė";6210160161;Taip;18;0;0;18
18736;Lokiukas;"4 B klasė";1860245985;Ne;21;0;0;21
18737;Lokiukas;"4 B klasė";1727242060;Taip;21;0;0;21
18738;Lokiukas;"4 B klasė";8300861451;Taip;10;0;0;10
18739;Lokiukas;"4 B klasė";7692067948;Taip;2;0;0;2
18740;Lokiukas;"4 B klasė";7728788069;Taip;21;0;0;21
18741;Lokiukas;"4 B klasė";9985555940;Taip;21;0;0;21
18742;Lokiukas;"4 B klasė";4447860405;Taip;21;0;0;21
18743;Lokiukas;"4 B klasė";3823547337;Taip;7;0;0;7
18744;Lokiukas;"4 B klasė";5496591880;Taip;21;0;0;21
18745;Lokiukas;"4 B klasė";1491789191;Taip;2;0;0;2
18746;Lokiukas;"4 B klasė";1419846182;Taip;3;0;0;3
18747;Lokiukas;"4 B klasė";9310088026;Taip;2;0;0;2
18748;Lokiukas;"4 B klasė";1787800667;Taip;5;0;0;5
18749;Šaltinėlis;Ančiukų;3011747942;Taip;0;10;0;10
18750;Šaltinėlis;Ančiukų;9769491789;Taip;0;14;0;14
18751;Šaltinėlis;Ančiukų;56396772538;Taip;0;3;0;3
18752;Šaltinėlis;Ančiukų;6462738640;Taip;12;0;0;12
18753;Šaltinėlis;Ančiukų;3493429067;Taip;0;2;0;2
18754;Šaltinėlis;Ančiukų;77872075694;Taip;3;0;0;3
18755;Šaltinėlis;Ančiukų;9218883174;Ne;11;2;0;13
18756;Šaltinėlis;Ančiukų;7133143923;Taip;0;9;0;9
18757;Šaltinėlis;Ančiukų;9820788524;Taip;0;16;0;16
18758;Šaltinėlis;Ančiukų;2630875135;Taip;11;4;0;15
18759;Šaltinėlis;Ančiukų;2973820849;Ne;11;1;0;12
18760;Šaltinėlis;Ančiukų;6487378225;Taip;8;0;0;8
18761;Šaltinėlis;Ančiukų;1464992631;Taip;19;0;0;19
18762;Šaltinėlis;Ančiukų;9274165569;Taip;0;9;0;9
18763;Šaltinėlis;Ančiukų;8500790262;Taip;14;0;0;14
18764;Šaltinėlis;Ančiukų;4332884673;Taip;17;0;0;17
18765;Šaltinėlis;Ančiukų;9362495172;Ne;14;0;0;14
18766;Šaltinėlis;Ančiukų;7737797979;Taip;20;0;0;20
18767;Šaltinėlis;Ančiukų;5455278072;Taip;11;0;0;11
18768;Šaltinėlis;Ančiukų;6887838949;Taip;6;4;0;10
18769;Šaltinėlis;Ančiukų;2084451705;Ne;5;1;0;6
18770;Šaltinėlis;Bitučių;3455754351;Taip;0;1;0;1
18771;Šaltinėlis;Bitučių;1224027643;Taip;0;4;0;4
18772;Šaltinėlis;Bitučių;35748040565;Taip;0;1;2;3
18773;Šaltinėlis;Bitučių;86592374576;Taip;15;1;0;16
18774;Šaltinėlis;Bitučių;3022926855;Ne;4;1;0;5
18775;Šaltinėlis;Bitučių;32264290873;Taip;0;0;1;1
18776;Šaltinėlis;Bitučių;1767635282;Taip;8;1;1;10
18777;Šaltinėlis;Bitučių;1390316465;Taip;7;1;1;9
18778;Šaltinėlis;Bitučių;37786438977;Taip;0;8;0;8
18779;Šaltinėlis;Bitučių;5442943843;Taip;0;1;2;3
18780;Šaltinėlis;Bitučių;6764006747;Taip;0;0;1;1
18781;Šaltinėlis;Bitučių;1658370782;Ne;0;14;0;14
18782;Šaltinėlis;Bitučių;10918276041;Ne;0;1;0;1
18783;Šaltinėlis;Bitučių;66575684640;Taip;0;1;0;1
18784;Šaltinėlis;Bitučių;13808708760;Taip;0;1;0;1
18785;Šaltinėlis;Bitučių;1718488108;Taip;11;1;0;12
18786;Šaltinėlis;Bitučių;79406746980;Taip;0;9;0;9
18787;Šaltinėlis;Bitučių;3577137327;Taip;13;1;0;14
18788;Šaltinėlis;Bitučių;48525545812;Taip;0;7;0;7
18789;Šaltinėlis;Bitučių;7073644279;Taip;0;1;0;1
18790;Šaltinėlis;Bitučių;1190394855;Taip;0;1;1;2
18791;Šaltinėlis;Bitučių;1456486363;Taip;0;12;0;12
18792;Šaltinėlis;Bitučių;32949623652;Taip;0;13;0;13
18793;Šaltinėlis;Bitučių;1614411921;Ne;0;5;0;5
18794;Šaltinėlis;Bitučių;29359826470;Taip;5;0;0;5
18795;Šaltinėlis;Bitučių;6176560054;Ne;0;1;0;1
18796;Šaltinėlis;Saulutės;7311831014;Taip;6;0;0;6
18797;Šaltinėlis;Saulutės;5854723120;Taip;15;2;0;17
18798;Šaltinėlis;Saulutės;5833136956;Taip;0;1;0;1
18799;Šaltinėlis;Saulutės;3483756240;Taip;11;0;0;11
18800;Šaltinėlis;Saulutės;6380346298;Taip;3;0;0;3
18801;Šaltinėlis;Saulutės;5799032398;Taip;15;0;1;16
18802;Šaltinėlis;Saulutės;5525740049;Taip;4;1;0;5
18803;Šaltinėlis;Saulutės;5382567842;Taip;0;1;2;3
18804;Šaltinėlis;Saulutės;1978469605;Ne;0;3;0;3
18805;Šaltinėlis;Saulutės;9762392403;Ne;12;0;0;12
18806;Šaltinėlis;Saulutės;4743907195;Taip;18;0;0;18
18807;Šaltinėlis;Saulutės;5343279219;Taip;10;1;0;11
18808;Šaltinėlis;Saulutės;7118672118;Taip;16;0;1;17
18809;Šaltinėlis;Saulutės;2465009553;Taip;3;1;1;5
18810;Šaltinėlis;Saulutės;9108653045;Taip;0;8;0;8
18811;Šaltinėlis;Saulutės;5345738219;Ne;9;0;0;9
18812;Šaltinėlis;Saulutės;3579974049;Taip;10;2;0;12
18813;Šaltinėlis;Saulutės;6721510313;Ne;9;1;0;10
18814;Šaltinėlis;Saulutės;7650840990;Taip;5;1;0;6
18815;Šaltinėlis;Meškiukų;3264138693;Taip;11;6;0;17
18816;Šaltinėlis;Meškiukų;2013810425;Taip;2;3;0;5
18817;Šaltinėlis;Meškiukų;1045163890;Taip;9;3;1;13
18818;Šaltinėlis;Meškiukų;8555517284;Taip;10;0;2;12
18819;Šaltinėlis;Meškiukų;9757246434;Taip;18;0;0;18
18820;Šaltinėlis;Meškiukų;1073305554;Taip;16;0;0;16
18821;Šaltinėlis;Meškiukų;7483928256;Taip;5;0;0;5
18822;Šaltinėlis;Meškiukų;3516760367;Taip;5;0;3;8
18823;Šaltinėlis;Meškiukų;2628936055;Taip;20;0;0;20
18824;Šaltinėlis;Meškiukų;5256665649;Taip;12;0;3;15
18825;Šaltinėlis;Meškiukų;2700475528;Taip;0;2;0;2
18826;Šaltinėlis;Meškiukų;1035890284;Ne;8;0;0;8
18827;Šaltinėlis;Meškiukų;6880337593;Ne;6;0;0;6
18828;Šaltinėlis;Meškiukų;9305706589;Ne;0;3;0;3
18829;Šaltinėlis;Meškiukų;8902634958;Ne;16;0;0;16
18830;Šaltinėlis;Meškiukų;9968637187;Taip;0;0;5;5
18831;Šaltinėlis;Nykštukai;1823048790;Taip;7;0;1;8
18832;Šaltinėlis;Nykštukai;9522524163;Taip;12;2;0;14
18833;Šaltinėlis;Nykštukai;4681460322;Taip;0;3;0;3
18834;Šaltinėlis;Nykštukai;4430546695;Taip;21;0;0;21
18835;Šaltinėlis;Nykštukai;1686009371;Taip;20;0;0;20
18836;Šaltinėlis;Nykštukai;9075507649;Taip;8;0;0;8
18837;Šaltinėlis;Nykštukai;7068058767;Taip;13;0;0;13
18838;Šaltinėlis;Nykštukai;8914777163;Taip;11;1;0;12
18839;Šaltinėlis;Nykštukai;7387221265;Taip;9;1;0;10
18840;Šaltinėlis;Nykštukai;3073692882;Taip;10;0;0;10
18841;Šaltinėlis;Nykštukai;2126751248;Taip;5;0;2;7
18842;Šaltinėlis;Nykštukai;7133044918;Taip;14;0;0;14
18843;Šaltinėlis;Nykštukai;2806453623;Taip;12;0;0;12
18844;Šaltinėlis;Nykštukai;8695191968;Taip;20;0;0;20
18845;Šaltinėlis;Nykštukai;8506287076;Taip;5;0;1;6
18846;Šaltinėlis;Perliukų;17147527171;Ne;4;1;0;5
18847;Šaltinėlis;Perliukų;11083638216;Taip;0;1;5;6
18848;Šaltinėlis;Perliukų;52507085619;Taip;6;0;1;7
18849;Šaltinėlis;Perliukų;23301579810;Taip;0;0;1;1
18850;Šaltinėlis;Perliukų;2146141461;Taip;0;1;0;1
18851;Šaltinėlis;Perliukų;1958647188;Taip;0;3;0;3
18852;Šaltinėlis;Perliukų;2034838765;Taip;3;0;1;4
18853;Šaltinėlis;Perliukų;1935762293;Taip;0;9;3;12
18854;Šaltinėlis;Perliukų;1583520894;Ne;10;7;0;17
18855;Šaltinėlis;Perliukų;1023238509;Taip;0;5;0;5
18856;Šaltinėlis;Perliukų;84494627465;Taip;0;5;1;6
18857;Šaltinėlis;Perliukų;98941037508;Taip;0;1;3;4
18858;Šaltinėlis;Perliukų;1004445904;Taip;0;1;0;1
18859;Šaltinėlis;Perliukų;9425353041;Taip;0;9;0;9
18860;Šaltinėlis;Perliukų;526307704;Taip;4;13;0;17
18861;Šaltinėlis;Perliukų;7262120071;Ne;0;1;0;1
18862;Šaltinėlis;Perliukų;6068980312;Taip;15;0;1;16
18863;Šaltinėlis;Perliukų;5869977541;Taip;15;0;0;15
18864;Šaltinėlis;Perliukų;4416064304;Ne;0;1;5;6
18865;Šaltinėlis;Perliukų;2333071711;Ne;4;0;1;5
18866;Šaltinėlis;Perliukų;1580090516;Taip;5;0;3;8
18867;Šaltinėlis;BORUŽĖLĖS;6645807642;Ne;14;0;0;14
18868;Šaltinėlis;BORUŽĖLĖS;8896316882;Taip;5;4;0;9
18869;Šaltinėlis;BORUŽĖLĖS;5325974488;Taip;14;1;0;15
18870;Šaltinėlis;BORUŽĖLĖS;1445108285;Taip;6;1;0;7
18871;Šaltinėlis;BORUŽĖLĖS;9759912102;Taip;12;0;0;12
18872;Šaltinėlis;BORUŽĖLĖS;6586783795;Taip;18;0;0;18
18873;Šaltinėlis;BORUŽĖLĖS;9691993251;Taip;0;0;2;2
18874;Šaltinėlis;BORUŽĖLĖS;4248763165;Taip;10;0;0;10
18875;Šaltinėlis;BORUŽĖLĖS;2189112609;Taip;5;0;0;5
18876;Šaltinėlis;BORUŽĖLĖS;9674923143;Taip;12;0;0;12
18877;Šaltinėlis;BORUŽĖLĖS;2022956307;Taip;18;0;0;18
18878;Šaltinėlis;BORUŽĖLĖS;7955094634;Taip;11;0;0;11
18879;Šaltinėlis;BORUŽĖLĖS;4664741207;Taip;13;0;0;13
18880;Šaltinėlis;BORUŽĖLĖS;9950106412;Taip;14;0;0;14
18881;Šaltinėlis;BORUŽĖLĖS;8995077908;Taip;20;0;0;20
18882;Šaltinėlis;"4B klasė";2413295020;Ne;0;21;0;21
18883;Šaltinėlis;"4B klasė";7404225862;Ne;0;1;0;1
18884;Šaltinėlis;"4B klasė";3375856084;Ne;0;3;0;3
18885;Šaltinėlis;"4B klasė";8670777468;Ne;0;1;0;1
18886;Šaltinėlis;"4B klasė";1687964284;Ne;0;1;0;1
18887;Šaltinėlis;"4B klasė";5105961386;Ne;0;1;0;1
18888;Šaltinėlis;"4B klasė";7121732840;Ne;0;21;0;21
18889;Šaltinėlis;"4B klasė";7917468152;Taip;0;10;0;10
18890;Šaltinėlis;"4B klasė";4335720836;Ne;0;2;0;2
18891;Šaltinėlis;"4B klasė";4994088781;Ne;0;1;0;1
18892;Šaltinėlis;"4B klasė";3680528737;Ne;0;7;0;7
18893;Šaltinėlis;"4B klasė";9708038079;Ne;0;3;0;3
18894;Šaltinėlis;"4B klasė";2160937385;Ne;0;21;0;21
18895;Šaltinėlis;"4B klasė";6381956693;Ne;0;21;0;21
18896;Šaltinėlis;"4B klasė";5181754988;Ne;0;3;0;3
18897;Šaltinėlis;"4B klasė";4543101402;Ne;0;1;0;1
18898;Šaltinėlis;1A;14213856824;Taip;0;1;0;1
18899;Šaltinėlis;1A;80649337160;Taip;0;2;0;2
18900;Šaltinėlis;1A;92958012146;Taip;0;1;0;1
18901;Šaltinėlis;1A;84656960510;Taip;0;1;0;1
18902;Šaltinėlis;1A;83621946293;Taip;0;21;0;21
18903;Šaltinėlis;1A;67808618878;Ne;0;1;0;1
18904;Šaltinėlis;1A;1278910777;Taip;0;2;0;2
18905;Šaltinėlis;1A;9647785988;Ne;0;21;0;21
18906;Šaltinėlis;1A;82671662416;Taip;0;2;0;2
18907;Šaltinėlis;1A;54025577281;Taip;0;14;0;14
18908;Šaltinėlis;1A;29482180151;Taip;0;5;0;5
18909;Šaltinėlis;1A;54753218491;Taip;0;1;0;1
18910;Šaltinėlis;1A;86029472773;Taip;0;13;0;13
18911;Šaltinėlis;1A;64821172553;Taip;0;1;0;1
18912;Šaltinėlis;1A;5744976843;Taip;0;21;0;21
18913;Šaltinėlis;1A;25459069972;Ne;0;1;0;1
18914;Šaltinėlis;1A;6669392157;Taip;0;2;0;2
18915;Šaltinėlis;1A;89358384113;Taip;0;13;0;13
18916;Šaltinėlis;1A;28956971978;Taip;0;2;0;2
18917;Šaltinėlis;1A;4050444191;Taip;0;1;0;1
18918;Šaltinėlis;1A;89093437170;Taip;0;2;0;2
18919;Šaltinėlis;1A;51872331010;Taip;0;1;0;1
18920;Šaltinėlis;1A;5056986469;Taip;0;21;0;21
18921;Šaltinėlis;1A;488285764;Taip;0;1;0;1
18922;Šaltinėlis;"2A klasė";83657465071;Taip;0;1;0;1
18923;Šaltinėlis;"2A klasė";86309198604;Taip;0;1;0;1
18924;Šaltinėlis;"2A klasė";9705941341;Taip;0;21;0;21
18925;Šaltinėlis;"2A klasė";38496350161;Taip;0;21;0;21
18926;Šaltinėlis;"2A klasė";62612067151;Taip;0;3;0;3
18927;Šaltinėlis;"2A klasė";96133834896;Ne;0;21;0;21
18928;Šaltinėlis;"2A klasė";2323456393;Ne;0;21;0;21
18929;Šaltinėlis;"2A klasė";56279691365;Taip;0;2;0;2
18930;Šaltinėlis;"2A klasė";4587186145;Taip;0;1;0;1
18931;Šaltinėlis;"2A klasė";70948186548;Taip;0;2;0;2
18932;Šaltinėlis;"2A klasė";47045578599;Taip;0;1;0;1
18933;Šaltinėlis;"2A klasė";36718328105;Taip;0;5;0;5
18934;Šaltinėlis;"2A klasė";86995081866;Taip;0;2;0;2
18935;Šaltinėlis;"2A klasė";7929809205;Ne;0;5;0;5
18936;Šaltinėlis;"2A klasė";29683761586;Ne;0;3;0;3
18937;Šaltinėlis;"2A klasė";40769315138;Taip;0;2;0;2
18938;Šaltinėlis;"2A klasė";7563879445;Ne;0;1;0;1
18939;Šaltinėlis;"2A klasė";66754907606;Taip;0;21;0;21
18940;Šaltinėlis;"2A klasė";35387543586;Taip;0;3;0;3
18941;Šaltinėlis;"2A klasė";9927833966;Ne;0;2;0;2
18942;Šaltinėlis;"3A klasė";7214517805;Ne;0;21;0;21
18943;Šaltinėlis;"3A klasė";9978493148;Ne;0;1;0;1
18944;Šaltinėlis;"3A klasė";1839665658;Ne;0;1;0;1
18945;Šaltinėlis;"3A klasė";8445115141;Ne;0;4;0;4
18946;Šaltinėlis;"3A klasė";1450894955;Ne;0;21;0;21
18947;Šaltinėlis;"3A klasė";8898225999;Ne;0;21;0;21
18948;Šaltinėlis;"3A klasė";6044895102;Ne;0;1;0;1
18949;Šaltinėlis;"3A klasė";7967108692;Ne;0;1;0;1
18950;Šaltinėlis;"3A klasė";4843823058;Ne;0;2;0;2
18951;Šaltinėlis;"3A klasė";92001008485;Taip;0;1;0;1
18952;Šaltinėlis;"3A klasė";7264810605;Ne;0;6;0;6
18953;Šaltinėlis;"3A klasė";7058348243;Ne;0;1;0;1
18954;Šaltinėlis;"3A klasė";5012608633;Ne;0;2;0;2
18955;Šaltinėlis;"3A klasė";2076892804;Ne;0;2;0;2
18956;Šaltinėlis;"3A klasė";8680271000;Ne;0;21;0;21
18957;Šaltinėlis;"3A klasė";6876036723;Ne;0;1;0;1
18958;Šaltinėlis;"3A klasė";6171441011;Ne;0;1;0;1
18959;Šaltinėlis;"4A klasė";9057225956;Ne;0;1;0;1
18960;Šaltinėlis;"4A klasė";8714253922;Ne;0;3;0;3
18961;Šaltinėlis;"4A klasė";6765467361;Ne;0;5;0;5
18962;Šaltinėlis;"4A klasė";2010277249;Ne;0;2;0;2
18963;Šaltinėlis;"4A klasė";3636296862;Ne;0;1;0;1
18964;Šaltinėlis;"4A klasė";4062628468;Ne;0;1;0;1
18965;Šaltinėlis;"4A klasė";6948074305;Ne;0;1;0;1
18966;Šaltinėlis;"4A klasė";2154195956;Ne;0;21;0;21
18967;Šaltinėlis;"4A klasė";47857916979;Taip;0;21;0;21
18968;Šaltinėlis;"4A klasė";6443537515;Ne;0;1;0;1
18969;Šaltinėlis;"4A klasė";57928407025;Ne;0;21;0;21
18970;Šaltinėlis;"4A klasė";8503985429;Ne;0;8;0;8
18971;Šaltinėlis;"4A klasė";4977611599;Ne;0;2;0;2
18972;Šaltinėlis;"4A klasė";24414070672;Ne;0;21;0;21
18973;Šaltinėlis;"4A klasė";3553168020;Ne;0;3;0;3
18974;Šaltinėlis;3B;7142082502;Ne;0;21;0;21
18975;Šaltinėlis;3B;6719801285;Ne;0;1;0;1
18976;Šaltinėlis;3B;1756003648;Taip;0;21;0;21
18977;Šaltinėlis;3B;4141263000;Ne;0;2;0;2
18978;Šaltinėlis;3B;3863654037;Ne;0;2;0;2
18979;Šaltinėlis;3B;5776007602;Ne;0;1;0;1
18980;Šaltinėlis;3B;3037854361;Ne;0;1;0;1
18981;Šaltinėlis;3B;2089316824;Ne;0;7;0;7
18982;Šaltinėlis;3B;7420737103;Ne;0;1;0;1
18983;Šaltinėlis;3B;8380122669;Ne;0;1;0;1
18984;Šaltinėlis;3B;82404351290;Taip;0;1;0;1
18985;Šaltinėlis;3B;5999279571;Ne;0;1;0;1
18986;Šaltinėlis;3B;3329317171;Ne;0;2;0;2
18987;Šaltinėlis;3B;8219291385;Ne;0;1;0;1
18988;Šaltinėlis;3B;49275031765;Taip;0;2;0;2
18989;Šaltinėlis;1B;93256161233;Taip;0;6;0;6
18990;Šaltinėlis;1B;83173349544;Taip;0;1;0;1
18991;Šaltinėlis;1B;39088869084;Taip;0;3;0;3
18992;Šaltinėlis;1B;95542489944;Taip;0;1;0;1
18993;Šaltinėlis;1B;3072314714;Taip;0;1;0;1
18994;Šaltinėlis;1B;1220687492;Taip;0;1;0;1
18995;Šaltinėlis;1B;74337710550;Ne;0;1;0;1
18996;Šaltinėlis;1B;35401075864;Ne;0;21;0;21
18997;Šaltinėlis;1B;19630605543;Taip;0;1;0;1
18998;Šaltinėlis;1B;3626545396;Ne;0;3;0;3
18999;Šaltinėlis;1B;72372808270;Taip;0;1;0;1
19000;Šaltinėlis;1B;1924418657;Taip;0;4;0;4
19001;Šaltinėlis;1B;77194317310;Taip;0;6;0;6
19002;Šaltinėlis;1B;57847832778;Taip;0;1;0;1
19003;Šaltinėlis;1B;70315400705;Ne;0;1;0;1
19004;Šaltinėlis;1B;81082410620;Taip;0;1;0;1
19005;Šaltinėlis;1B;1422035829;Taip;0;21;0;21
19006;Šaltinėlis;1B;84522552145;Taip;0;1;0;1
19007;Šaltinėlis;1B;7711903999;Ne;0;1;0;1
19008;Šaltinėlis;1B;6317111400;Taip;0;1;0;1
19009;Šaltinėlis;1B;4762756751;Ne;0;1;0;1
19010;Gabijėlė;GANDRIUKŲ;4498088417;Taip;1;0;0;1
19011;Gabijėlė;GANDRIUKŲ;9706026832;Taip;9;3;0;12
19012;Gabijėlė;GANDRIUKŲ;7087892822;Taip;11;0;1;12
19013;Gabijėlė;GANDRIUKŲ;2550300871;Taip;6;1;0;7
19014;Gabijėlė;GANDRIUKŲ;5057272847;Taip;19;0;1;20
19015;Gabijėlė;GANDRIUKŲ;3548399391;Taip;0;0;6;6
19016;Gabijėlė;GANDRIUKŲ;2215880644;Taip;11;0;9;20
19017;Gabijėlė;GANDRIUKŲ;8904768332;Taip;15;0;2;17
19018;Gabijėlė;GANDRIUKŲ;3799003783;Taip;3;0;0;3
19019;Gabijėlė;GANDRIUKŲ;8572833698;Taip;6;0;3;9
19020;Gabijėlė;GANDRIUKŲ;2491503656;Taip;0;4;0;4
19021;Gabijėlė;LAKŠTINGALIUKŲ;92624581275;Taip;0;2;0;2
19022;Gabijėlė;LAKŠTINGALIUKŲ;38094271521;Taip;0;1;1;2
19023;Gabijėlė;LAKŠTINGALIUKŲ;53325200270;Taip;0;2;0;2
19024;Gabijėlė;LAKŠTINGALIUKŲ;45682950511;Taip;0;0;1;1
19025;Gabijėlė;LAKŠTINGALIUKŲ;49951048159;Taip;5;1;1;7
19026;Gabijėlė;LAKŠTINGALIUKŲ;1451870519;Ne;2;1;0;3
19027;Gabijėlė;LAKŠTINGALIUKŲ;2131349938;Taip;0;3;0;3
19028;Gabijėlė;LAKŠTINGALIUKŲ;67649373235;Taip;4;0;0;4
19029;Gabijėlė;LAKŠTINGALIUKŲ;9376398157;Taip;0;1;1;2
19030;Gabijėlė;LAKŠTINGALIUKŲ;80455285324;Taip;2;2;0;4
19031;Gabijėlė;LAKŠTINGALIUKŲ;2220139259;Ne;0;1;3;4
19032;Gabijėlė;LAKŠTINGALIUKŲ;82760473229;Taip;0;2;0;2
19033;Gabijėlė;LAKŠTINGALIUKŲ;77966124767;Taip;0;1;0;1
19034;Gabijėlė;LAKŠTINGALIUKŲ;54950294060;Taip;0;4;0;4
19035;Gabijėlė;LAKŠTINGALIUKŲ;1988838165;Taip;3;0;0;3
19036;Gabijėlė;LAKŠTINGALIUKŲ;89100449385;Taip;4;1;0;5
19037;Gabijėlė;LAKŠTINGALIUKŲ;67189240970;Taip;0;12;0;12
19038;Gabijėlė;LAKŠTINGALIUKŲ;1240051312;Taip;0;1;4;5
19039;Gabijėlė;LAKŠTINGALIUKŲ;4662981914;Taip;6;2;0;8
19040;Gabijėlė;LAKŠTINGALIUKŲ;1945407792;Taip;0;1;0;1
19041;Gabijėlė;ŽVIRBLIUKŲ;7043775905;Taip;0;3;0;3
19042;Gabijėlė;ŽVIRBLIUKŲ;4475530177;Taip;13;0;1;14
19043;Gabijėlė;ŽVIRBLIUKŲ;5743861607;Taip;0;0;2;2
19044;Gabijėlė;ŽVIRBLIUKŲ;7410541320;Taip;0;19;0;19
19045;Gabijėlė;ŽVIRBLIUKŲ;4493192224;Taip;20;0;0;20
19046;Gabijėlė;ŽVIRBLIUKŲ;9259964641;Taip;0;0;2;2
19047;Gabijėlė;ŽVIRBLIUKŲ;3268231136;Ne;0;10;0;10
19048;Gabijėlė;ŽVIRBLIUKŲ;8879972953;Taip;0;16;0;16
19049;Gabijėlė;ŽVIRBLIUKŲ;5332825339;Taip;5;0;2;7
19050;Gabijėlė;ŽVIRBLIUKŲ;9627906252;Taip;8;0;7;15
19051;Gabijėlė;ŽVIRBLIUKŲ;2264669298;Ne;0;6;0;6
19052;Gabijėlė;ŽVIRBLIUKŲ;5942625633;Taip;0;0;2;2
19053;Gabijėlė;ŽVIRBLIUKŲ;7417179112;Taip;0;0;1;1
19054;Gabijėlė;ŽVIRBLIUKŲ;5387026410;Taip;0;0;1;1
19055;Gabijėlė;ŽVIRBLIUKŲ;8292463617;Taip;6;0;1;7
19056;Gabijėlė;ŽVIRBLIUKŲ;3155403180;Taip;13;0;1;14
19057;Gabijėlė;ŽVIRBLIUKŲ;1158461185;Taip;13;0;1;14
19058;Gabijėlė;ŽVIRBLIUKŲ;6604681536;Ne;0;15;0;15
19059;Gabijėlė;ŽVIRBLIUKŲ;3218415151;Taip;21;0;0;21
19060;Gabijėlė;ŽVIRBLIUKŲ;8384795164;Ne;5;0;0;5
19061;Gabijėlė;ŽVIRBLIUKŲ;4146051969;Ne;0;15;0;15
19062;Gabijėlė;ŽVIRBLIUKŲ;6674038058;Taip;12;0;0;12
19063;Gabijėlė;ŽVIRBLIUKŲ;8823299212;Taip;1;1;0;2
19064;Gabijėlė;GENIUKŲ;3445433386;Taip;0;8;0;8
19065;Gabijėlė;GENIUKŲ;2980295345;Taip;5;1;0;6
19066;Gabijėlė;GENIUKŲ;1862655595;Taip;0;1;0;1
19067;Gabijėlė;GENIUKŲ;7312628876;Taip;0;2;0;2
19068;Gabijėlė;GENIUKŲ;1581688238;Taip;10;1;0;11
19069;Gabijėlė;GENIUKŲ;5301905117;Taip;0;12;0;12
19070;Gabijėlė;GENIUKŲ;3176075887;Taip;0;11;0;11
19071;Gabijėlė;GENIUKŲ;6866641272;Taip;11;0;0;11
19072;Gabijėlė;GENIUKŲ;9972967198;Taip;21;0;0;21
19073;Gabijėlė;GENIUKŲ;8305098808;Ne;0;1;0;1
19074;Gabijėlė;GENIUKŲ;1589534853;Ne;9;0;1;10
19075;Gabijėlė;GENIUKŲ;3020599503;Taip;0;13;0;13
19076;Gabijėlė;GENIUKŲ;4234733280;Taip;15;0;0;15
19077;Gabijėlė;GENIUKŲ;1922979974;Ne;10;2;0;12
19078;Gabijėlė;GENIUKŲ;6482824000;Taip;8;0;0;8
19079;Gabijėlė;GENIUKŲ;5962852108;Taip;16;0;0;16
19080;Gabijėlė;GENIUKŲ;7178676049;Taip;0;1;0;1
19081;Gabijėlė;GENIUKŲ;2009199650;Taip;0;2;0;2
19082;Gabijėlė;GENIUKŲ;2431615096;Taip;21;0;0;21
19083;Gabijėlė;GENIUKŲ;3289157020;Taip;21;0;0;21
19084;Gabijėlė;DAGILIUKŲ;9348393550;Taip;0;3;0;3
19085;Gabijėlė;DAGILIUKŲ;4264925447;Taip;0;3;0;3
19086;Gabijėlė;DAGILIUKŲ;9120107749;Taip;18;0;0;18
19087;Gabijėlė;DAGILIUKŲ;7426579018;Taip;8;3;0;11
19088;Gabijėlė;DAGILIUKŲ;9783343968;Taip;0;1;0;1
19089;Gabijėlė;DAGILIUKŲ;6438144206;Taip;6;6;1;13
19090;Gabijėlė;DAGILIUKŲ;8078326688;Taip;0;0;1;1
19091;Gabijėlė;DAGILIUKŲ;3017939983;Ne;6;0;0;6
19092;Gabijėlė;DAGILIUKŲ;4462129182;Taip;12;0;0;12
19093;Gabijėlė;DAGILIUKŲ;8662914262;Taip;0;1;0;1
19094;Gabijėlė;DAGILIUKŲ;9280283478;Ne;17;0;0;17
19095;Gabijėlė;DAGILIUKŲ;9503639471;Taip;3;0;1;4
19096;Gabijėlė;DAGILIUKŲ;1988597157;Ne;10;10;0;20
19097;Gabijėlė;DAGILIUKŲ;8036572198;Taip;15;6;0;21
19098;Gabijėlė;DAGILIUKŲ;9895518740;Taip;16;0;0;16
19099;Gabijėlė;DAGILIUKŲ;1455856766;Taip;5;1;10;16
19100;Gabijėlė;DAGILIUKŲ;6322094719;Taip;0;6;0;6
19101;Gabijėlė;DAGILIUKŲ;9449023766;Taip;0;1;0;1
19102;Gabijėlė;DAGILIUKŲ;2254104149;Taip;7;0;0;7
19103;Gabijėlė;DAGILIUKŲ;1286688629;Taip;13;0;0;13
19104;Gabijėlė;DAGILIUKŲ;4797994026;Taip;9;2;0;11
19105;Gabijėlė;PELEDŽIUKŲ;1068556799;Taip;0;3;0;3
19106;Gabijėlė;PELEDŽIUKŲ;1171257945;Ne;0;3;1;4
19107;Gabijėlė;PELEDŽIUKŲ;8044682830;Taip;0;2;0;2
19108;Gabijėlė;PELEDŽIUKŲ;43109352262;Taip;0;9;0;9
19109;Gabijėlė;PELEDŽIUKŲ;1747282196;Taip;0;1;0;1
19110;Gabijėlė;PELEDŽIUKŲ;1491653325;Taip;0;1;0;1
19111;Gabijėlė;PELEDŽIUKŲ;1608940997;Taip;0;2;0;2
19112;Gabijėlė;PELEDŽIUKŲ;3610392405;Taip;0;1;0;1
19113;Gabijėlė;PELEDŽIUKŲ;4916964663;Taip;0;4;0;4
19114;Gabijėlė;PELEDŽIUKŲ;17443601729;Ne;11;0;2;13
19115;Gabijėlė;PELEDŽIUKŲ;1286307671;Taip;18;0;1;19
19116;Gabijėlė;PELEDŽIUKŲ;37544281230;Taip;0;0;4;4
19117;Gabijėlė;PELEDŽIUKŲ;8428069167;Taip;2;0;1;3
19118;Gabijėlė;PELEDŽIUKŲ;4726771205;Ne;0;0;5;5
19119;Gabijėlė;PELEDŽIUKŲ;24035160251;Taip;21;0;0;21
19120;Gabijėlė;PELEDŽIUKŲ;38497069329;Taip;0;3;2;5
19121;Gabijėlė;PELEDŽIUKŲ;54948441867;Taip;9;0;2;11
19122;Gabijėlė;PELEDŽIUKŲ;65735862964;Taip;0;1;0;1
19123;Gabijėlė;PELEDŽIUKŲ;8746641978;Ne;0;0;1;1
19124;Gabijėlė;KREGZDŽIUKŲ;84945768423;Taip;0;2;0;2
19125;Gabijėlė;KREGZDŽIUKŲ;41661694634;Taip;0;1;0;1
19126;Gabijėlė;KREGZDŽIUKŲ;1743647754;Ne;0;1;0;1
19127;Gabijėlė;KREGZDŽIUKŲ;79544806044;Taip;0;1;0;1
19128;Gabijėlė;KREGZDŽIUKŲ;34683603878;Taip;3;2;0;5
19129;Gabijėlė;KREGZDŽIUKŲ;13013873198;Taip;0;1;0;1
19130;Gabijėlė;KREGZDŽIUKŲ;91643373754;Taip;1;8;3;12
19131;Gabijėlė;KREGZDŽIUKŲ;7298662616;Taip;0;8;0;8
19132;Gabijėlė;KREGZDŽIUKŲ;5884453557;Taip;3;1;0;4
19133;Gabijėlė;KREGZDŽIUKŲ;61217725255;Ne;0;1;0;1
19134;Gabijėlė;KREGZDŽIUKŲ;53576382572;Ne;0;1;0;1
19135;Gabijėlė;KREGZDŽIUKŲ;2958504770;Taip;0;1;1;2
19136;Gabijėlė;KREGZDŽIUKŲ;16720415967;Taip;0;6;0;6
19137;Gabijėlė;KREGZDŽIUKŲ;34998957585;Taip;8;1;4;13
19138;Gabijėlė;KREGZDŽIUKŲ;1770578935;Taip;0;2;0;2
19139;Gabijėlė;KREGZDŽIUKŲ;1455625997;Taip;0;1;0;1
19140;Gabijėlė;KREGZDŽIUKŲ;1937862725;Taip;0;1;0;1
19141;Gabijėlė;KREGZDŽIUKŲ;25732601952;Taip;0;1;0;1
19142;Gabijėlė;KREGZDŽIUKŲ;1217019582;Taip;0;1;1;2
19143;Gabijėlė;KREGZDŽIUKŲ;46552208567;Taip;0;6;0;6
19144;Gabijėlė;KREGZDŽIUKŲ;62457368692;Taip;0;1;0;1
19145;Gabijėlė;KREGZDŽIUKŲ;26058036933;Taip;0;1;0;1
19146;Gabijėlė;KREGZDŽIUKŲ;84120660883;Taip;0;1;0;1
19147;Gabijėlė;KREGZDŽIUKŲ;36447115547;Taip;0;1;0;1
19148;Gabijėlė;KREGZDŽIUKŲ;69294465170;Taip;0;9;0;9
19149;Gabijėlė;ZYLIUKŲ;41421082754;Taip;0;2;0;2
19150;Gabijėlė;ZYLIUKŲ;90540638931;Taip;0;2;0;2
19151;Gabijėlė;ZYLIUKŲ;20248530233;Taip;0;8;0;8
19152;Gabijėlė;ZYLIUKŲ;25691510343;Taip;0;1;0;1
19153;Gabijėlė;ZYLIUKŲ;70110432877;Taip;4;2;0;6
19154;Gabijėlė;ZYLIUKŲ;84464214049;Taip;0;5;0;5
19155;Gabijėlė;ZYLIUKŲ;62562568076;Taip;7;1;1;9
19156;Gabijėlė;ZYLIUKŲ;1505873499;Taip;0;1;1;2
19157;Gabijėlė;ZYLIUKŲ;1257150362;Ne;0;1;0;1
19158;Gabijėlė;ZYLIUKŲ;32203098792;Taip;0;9;0;9
19159;Gabijėlė;ZYLIUKŲ;1642361191;Ne;0;5;2;7
19160;Gabijėlė;ZYLIUKŲ;1036201997;Taip;10;3;0;13
19161;Gabijėlė;ZYLIUKŲ;60548215051;Taip;1;1;0;2
19162;Gabijėlė;ZYLIUKŲ;7778613039;Taip;5;1;1;7
19163;Gabijėlė;ZYLIUKŲ;31458685084;Taip;2;3;0;5
19164;Gabijėlė;ZYLIUKŲ;16804922682;Taip;14;1;0;15
19165;Gabijėlė;ZYLIUKŲ;1213013384;Ne;0;1;0;1
19166;Gabijėlė;ZYLIUKŲ;2010619186;Ne;0;1;4;5
19167;Gabijėlė;ZYLIUKŲ;1145863002;Taip;5;2;0;7
19168;Gabijėlė;ZYLIUKŲ;1649556120;Taip;0;4;2;6
19169;Gabijėlė;VOLUNGĖLIŲ;1779924073;Ne;1;1;1;3
19170;Gabijėlė;VOLUNGĖLIŲ;4166739739;Taip;0;6;0;6
19171;Gabijėlė;VOLUNGĖLIŲ;1492231030;Taip;0;6;0;6
19172;Gabijėlė;VOLUNGĖLIŲ;1317309811;Taip;0;4;0;4
19173;Gabijėlė;VOLUNGĖLIŲ;1523331860;Taip;8;1;0;9
19174;Gabijėlė;VOLUNGĖLIŲ;21740150080;Taip;0;9;0;9
19175;Gabijėlė;VOLUNGĖLIŲ;5558919097;Taip;0;0;1;1
19176;Gabijėlė;VOLUNGĖLIŲ;9683524530;Taip;10;0;4;14
19177;Gabijėlė;VOLUNGĖLIŲ;46021970332;Ne;0;7;0;7
19178;Gabijėlė;VOLUNGĖLIŲ;8480479946;Taip;9;3;0;12
19179;Gabijėlė;VOLUNGĖLIŲ;13265905500;Taip;0;2;0;2
19180;Gabijėlė;VOLUNGĖLIŲ;43737170074;Taip;9;0;1;10
19181;Gabijėlė;VOLUNGĖLIŲ;1480704497;Taip;0;3;0;3
19182;Gabijėlė;VOLUNGĖLIŲ;1669529717;Taip;8;0;0;8
19183;Gabijėlė;VOLUNGĖLIŲ;5704281727;Taip;0;1;1;2
19184;Gabijėlė;VOLUNGĖLIŲ;95685721388;Taip;0;2;0;2
19185;Gabijėlė;VOLUNGĖLIŲ;76416239647;Ne;3;0;0;3
19186;Gabijėlė;VOLUNGĖLIŲ;2102821834;Taip;0;1;0;1
19187;Gabijėlė;VOLUNGĖLIŲ;2051109865;Ne;0;5;0;5
19188;Gabijėlė;VOLUNGĖLIŲ;64252867351;Ne;0;16;0;16
19189;Gabijėlė;ANČIUKŲ;43123279348;Taip;0;19;0;19
19190;Gabijėlė;ANČIUKŲ;2036978425;Taip;0;7;0;7
19191;Gabijėlė;ANČIUKŲ;5219706067;Taip;0;19;0;19
19192;Gabijėlė;ANČIUKŲ;10796114623;Ne;0;6;0;6
19193;Gabijėlė;ANČIUKŲ;3454412432;Ne;0;0;7;7
19194;Gabijėlė;ANČIUKŲ;4752631976;Taip;16;0;0;16
19195;Gabijėlė;ANČIUKŲ;9822093084;Taip;17;0;0;17
19196;Gabijėlė;ANČIUKŲ;1415184607;Taip;6;0;2;8
19197;Gabijėlė;ANČIUKŲ;85836097485;Taip;9;0;2;11
19198;Gabijėlė;ANČIUKŲ;28017865889;Taip;0;8;0;8
19199;Gabijėlė;ANČIUKŲ;1917587420;Taip;6;11;0;17
19200;Gabijėlė;ANČIUKŲ;1465584524;Taip;11;0;1;12
19201;Gabijėlė;ANČIUKŲ;6198439092;Taip;11;0;2;13
19202;Gabijėlė;ANČIUKŲ;5783373671;Taip;7;6;0;13
19203;Gabijėlė;ANČIUKŲ;7948343328;Taip;14;0;0;14
19204;Gabijėlė;ANČIUKŲ;2052892422;Ne;0;0;1;1
19205;Gabijėlė;ANČIUKŲ;8111239476;Taip;0;15;0;15
19206;Gabijėlė;ANČIUKŲ;6766770793;Taip;3;0;1;4
19207;Gabijėlė;ANČIUKŲ;8778396292;Ne;10;0;1;11
19208;Gabijėlė;ANČIUKŲ;4085049535;Taip;0;18;0;18
19209;Gabijėlė;ANČIUKŲ;8893637755;Taip;0;11;0;11
19210;Gabijėlė;BALANDŽIUKŲ;4110081664;Taip;0;0;4;4
19211;Gabijėlė;BALANDŽIUKŲ;6719097956;Taip;0;1;0;1
19212;Gabijėlė;BALANDŽIUKŲ;9157819780;Taip;0;8;0;8
19213;Gabijėlė;BALANDŽIUKŲ;2921208571;Taip;8;0;0;8
19214;Gabijėlė;BALANDŽIUKŲ;1045338865;Taip;0;0;4;4
19215;Gabijėlė;BALANDŽIUKŲ;4330624300;Taip;3;0;0;3
19216;Gabijėlė;BALANDŽIUKŲ;33124420723;Taip;0;0;10;10
19217;Gabijėlė;BALANDŽIUKŲ;2097260657;Taip;10;0;2;12
19218;Gabijėlė;BALANDŽIUKŲ;8131229306;Taip;10;0;0;10
19219;Gabijėlė;BALANDŽIUKŲ;8525869648;Taip;0;5;0;5
19220;Gabijėlė;BALANDŽIUKŲ;56914218692;Taip;5;0;4;9
19221;Gabijėlė;BALANDŽIUKŲ;2070050969;Taip;11;2;0;13
19222;Gabijėlė;BALANDŽIUKŲ;7144977279;Ne;0;0;1;1
19223;Gabijėlė;BALANDŽIUKŲ;15049855022;Taip;6;0;0;6
19224;Gabijėlė;BALANDŽIUKŲ;2776579713;Taip;0;2;0;2
19225;Gabijėlė;BALANDŽIUKŲ;9197020006;Taip;0;6;0;6
19226;Gabijėlė;BALANDŽIUKŲ;1273722177;Taip;17;0;0;17
19227;Gabijėlė;VYTURIUKŲ;3484413830;Taip;0;3;0;3
19228;Gabijėlė;VYTURIUKŲ;87868591956;Taip;4;0;0;4
19229;Gabijėlė;VYTURIUKŲ;1859288888;Ne;12;0;0;12
19230;Gabijėlė;VYTURIUKŲ;44322663690;Ne;5;0;2;7
19231;Gabijėlė;VYTURIUKŲ;1479311429;Ne;3;0;0;3
19232;Gabijėlė;VYTURIUKŲ;4765125810;Taip;0;1;1;2
19233;Gabijėlė;VYTURIUKŲ;1219257874;Taip;8;0;1;9
19234;Gabijėlė;VYTURIUKŲ;39269336820;Taip;0;6;0;6
19235;Gabijėlė;VYTURIUKŲ;1829866148;Ne;8;0;2;10
19236;Gabijėlė;VYTURIUKŲ;47989272121;Ne;0;4;0;4
19237;Gabijėlė;VYTURIUKŲ;5736000160;Taip;12;0;2;14
19238;Gabijėlė;VYTURIUKŲ;9320327120;Taip;0;2;0;2
19239;Gabijėlė;VYTURIUKŲ;4632508075;Taip;10;1;1;12
19240;Gabijėlė;VYTURIUKŲ;1426802917;Taip;9;0;2;11
19241;Gabijėlė;VYTURIUKŲ;41212490042;Taip;12;0;2;14
19242;Gabijėlė;VYTURIUKŲ;1287165224;Taip;0;2;0;2
19243;Gabijėlė;VYTURIUKŲ;34609028374;Taip;0;1;0;1
19244;Gabijėlė;VYTURIUKŲ;1185452849;Taip;0;1;0;1
19245;Gabijėlė;VYTURIUKŲ;90520726029;Taip;5;0;1;6
19246;Gabijėlė;VYTURIUKŲ;6492199649;Taip;5;0;1;6
19247;Pilaitukas;BITUTĖS;4305634374;Taip;0;1;2;3
19248;Pilaitukas;BITUTĖS;3519198814;Taip;4;0;0;4
19249;Pilaitukas;BITUTĖS;8169484415;Taip;0;0;4;4
19250;Pilaitukas;BITUTĖS;1729494874;Taip;0;1;3;4
19251;Pilaitukas;BITUTĖS;2242454299;Taip;0;0;4;4
19252;Pilaitukas;BITUTĖS;9793278788;Taip;0;1;0;1
19253;Pilaitukas;BITUTĖS;4082490488;Taip;7;1;1;9
19254;Pilaitukas;BITUTĖS;3345387791;Taip;0;0;1;1
19255;Pilaitukas;BITUTĖS;3913169122;Taip;0;1;0;1
19256;Pilaitukas;BITUTĖS;3541354283;Taip;0;10;0;10
19257;Pilaitukas;BITUTĖS;7342388716;Taip;0;0;2;2
19258;Pilaitukas;BITUTĖS;5740951665;Taip;20;1;0;21
19259;Pilaitukas;BITUTĖS;4591799893;Taip;21;0;0;21
19260;Pilaitukas;BITUTĖS;6308557885;Taip;21;0;0;21
19261;Pilaitukas;BITUTĖS;6514731102;Taip;21;0;0;21
19262;Pilaitukas;BITUTĖS;5988165204;Taip;2;0;0;2
19263;Pilaitukas;BITUTĖS;3037850837;Ne;0;0;5;5
19264;Pilaitukas;BITUTĖS;9126553732;Taip;9;0;0;9
19265;Pilaitukas;BITUTĖS;7438112270;Taip;5;0;3;8
19266;Pilaitukas;ZUIKUČIAI;8993885764;Ne;0;1;0;1
19267;Pilaitukas;ZUIKUČIAI;5206637809;Taip;11;0;2;13
19268;Pilaitukas;ZUIKUČIAI;5288784331;Taip;4;0;1;5
19269;Pilaitukas;ZUIKUČIAI;8255398803;Ne;11;0;1;12
19270;Pilaitukas;ZUIKUČIAI;2862447956;Taip;5;1;0;6
19271;Pilaitukas;ZUIKUČIAI;8727175656;Taip;5;1;0;6
19272;Pilaitukas;ZUIKUČIAI;8207194955;Taip;0;0;2;2
19273;Pilaitukas;ZUIKUČIAI;5640802570;Ne;6;0;3;9
19274;Pilaitukas;ZUIKUČIAI;9260893320;Taip;0;0;2;2
19275;Pilaitukas;ZUIKUČIAI;9988041515;Taip;0;2;0;2
19276;Pilaitukas;ZUIKUČIAI;9108428738;Taip;0;2;0;2
19277;Pilaitukas;ZUIKUČIAI;1607454890;Taip;0;0;1;1
19278;Pilaitukas;ZUIKUČIAI;9878890346;Ne;3;0;1;4
19279;Pilaitukas;ZUIKUČIAI;6838035491;Taip;5;0;4;9
19280;Pilaitukas;ZUIKUČIAI;5710747769;Taip;12;0;0;12
19281;Pilaitukas;ZUIKUČIAI;7568744500;Taip;5;0;1;6
19282;Pilaitukas;ZUIKUČIAI;5407354218;Taip;9;0;2;11
19283;Pilaitukas;ZUIKUČIAI;9414051187;Taip;6;10;0;16
19284;Pilaitukas;ANČIUKAI;92108889661;Taip;16;0;0;16
19285;Pilaitukas;ANČIUKAI;9724892897;Taip;0;0;1;1
19286;Pilaitukas;ANČIUKAI;36338976218;Taip;0;2;0;2
19287;Pilaitukas;ANČIUKAI;1114477688;Taip;0;1;0;1
19288;Pilaitukas;ANČIUKAI;1512181401;Taip;6;0;1;7
19289;Pilaitukas;ANČIUKAI;3821748678;Taip;0;0;1;1
19290;Pilaitukas;ANČIUKAI;6222888898;Taip;5;0;0;5
19291;Pilaitukas;ANČIUKAI;8319676743;Taip;0;1;2;3
19292;Pilaitukas;ANČIUKAI;4505384039;Taip;9;0;0;9
19293;Pilaitukas;ANČIUKAI;5206439753;Taip;0;6;0;6
19294;Pilaitukas;ANČIUKAI;79485847381;Taip;9;1;0;10
19295;Pilaitukas;ANČIUKAI;5211988291;Taip;1;0;0;1
19296;Pilaitukas;ANČIUKAI;87760608710;Taip;0;0;20;20
19297;Pilaitukas;ANČIUKAI;7909465673;Taip;6;1;0;7
19298;Pilaitukas;ANČIUKAI;2298935154;Taip;3;0;0;3
19299;Pilaitukas;ANČIUKAI;4694691187;Taip;6;0;1;7
19300;Pilaitukas;ANČIUKAI;9224653856;Taip;6;0;1;7
19301;Pilaitukas;ANČIUKAI;58250008277;Taip;5;0;0;5
19302;Pilaitukas;MEŠKIUKAI;57931719105;Taip;0;1;0;1
19303;Pilaitukas;MEŠKIUKAI;14554050141;Taip;0;0;2;2
19304;Pilaitukas;MEŠKIUKAI;9015675095;Taip;4;0;0;4
19305;Pilaitukas;MEŠKIUKAI;2929868229;Taip;0;1;0;1
19306;Pilaitukas;MEŠKIUKAI;1135880899;Taip;5;0;0;5
19307;Pilaitukas;MEŠKIUKAI;4505147961;Taip;0;0;2;2
19308;Pilaitukas;MEŠKIUKAI;9618329726;Taip;16;0;0;16
19309;Pilaitukas;MEŠKIUKAI;6514784647;Taip;5;0;0;5
19310;Pilaitukas;MEŠKIUKAI;4038320896;Taip;12;0;1;13
19311;Pilaitukas;MEŠKIUKAI;3794882532;Taip;0;0;1;1
19312;Pilaitukas;MEŠKIUKAI;18466900688;Taip;4;5;0;9
19313;Pilaitukas;MEŠKIUKAI;2736736697;Ne;0;0;5;5
19314;Pilaitukas;MEŠKIUKAI;3214740183;Ne;0;1;0;1
19315;Pilaitukas;MEŠKIUKAI;39600380611;Taip;11;0;1;12
19316;Pilaitukas;MEŠKIUKAI;5604992163;Taip;10;1;0;11
19317;Pilaitukas;MEŠKIUKAI;9450834035;Taip;10;1;0;11
19318;Pilaitukas;MEŠKIUKAI;5689385925;Taip;0;3;0;3
19319;Pilaitukas;MEŠKIUKAI;1003278169;Ne;0;0;1;1
19320;Pilaitukas;MEŠKIUKAI;6117985788;Taip;6;0;0;6
19321;Pilaitukas;MEŠKIUKAI;9924612250;Taip;0;1;1;2
19322;Pilaitukas;ŽUVYTĖS;83886439719;Taip;0;1;1;2
19323;Pilaitukas;ŽUVYTĖS;74367577786;Taip;0;1;0;1
19324;Pilaitukas;ŽUVYTĖS;8441380474;Taip;0;6;0;6
19325;Pilaitukas;ŽUVYTĖS;79398058989;Taip;0;1;1;2
19326;Pilaitukas;ŽUVYTĖS;53049608654;Taip;0;6;0;6
19327;Pilaitukas;ŽUVYTĖS;62992423192;Taip;0;1;2;3
19328;Pilaitukas;ŽUVYTĖS;1707355162;Taip;1;0;2;3
19329;Pilaitukas;ŽUVYTĖS;27233065857;Ne;0;1;0;1
19330;Pilaitukas;ŽUVYTĖS;49728283339;Taip;0;1;0;1
19331;Pilaitukas;ŽUVYTĖS;1824063553;Taip;0;1;0;1
19332;Pilaitukas;ŽUVYTĖS;37415672544;Taip;5;1;0;6
19333;Pilaitukas;ŽUVYTĖS;44413072002;Taip;0;1;0;1
19334;Pilaitukas;ŽUVYTĖS;66377321935;Taip;0;1;0;1
19335;Pilaitukas;ŽUVYTĖS;63470473930;Taip;5;3;0;8
19336;Pilaitukas;ŽUVYTĖS;45165187254;Taip;0;1;1;2
19337;Pilaitukas;ŽUVYTĖS;1286286153;Ne;5;1;0;6
19338;Pilaitukas;ŽUVYTĖS;1896452184;Taip;4;2;0;6
19339;Pilaitukas;ŽUVYTĖS;49542027658;Taip;4;1;0;5
19340;Pilaitukas;ŽUVYTĖS;3723836301;Taip;4;1;0;5
19341;Pilaitukas;ŽUVYTĖS;6913383121;Ne;0;1;0;1
19342;Pilaitukas;ŽUVYTĖS;50368168240;Taip;0;1;0;1
19343;Pilaitukas;ŽUVYTĖS;81347327136;Taip;11;0;0;11
19344;Pilaitukas;ŽUVYTĖS;72753220553;Taip;2;0;0;2
19345;Pilaitukas;PAUKŠTELIAI;68262699910;Taip;0;0;1;1
19346;Pilaitukas;PAUKŠTELIAI;98876022289;Taip;6;6;0;12
19347;Pilaitukas;PAUKŠTELIAI;25872504305;Taip;0;1;1;2
19348;Pilaitukas;PAUKŠTELIAI;26318820010;Taip;0;1;0;1
19349;Pilaitukas;PAUKŠTELIAI;68819621853;Taip;0;5;1;6
19350;Pilaitukas;PAUKŠTELIAI;99558991322;Taip;0;3;0;3
19351;Pilaitukas;PAUKŠTELIAI;61458733284;Taip;0;0;6;6
19352;Pilaitukas;PAUKŠTELIAI;32580431386;Taip;5;1;0;6
19353;Pilaitukas;PAUKŠTELIAI;95753711905;Taip;1;0;0;1
19354;Pilaitukas;PAUKŠTELIAI;46467461875;Ne;5;8;0;13
19355;Pilaitukas;PAUKŠTELIAI;89335569661;Ne;6;2;0;8
19356;Pilaitukas;PAUKŠTELIAI;49882457703;Ne;0;1;0;1
19357;Pilaitukas;PAUKŠTELIAI;17314387753;Taip;0;0;1;1
19358;Pilaitukas;PAUKŠTELIAI;36677686051;Taip;0;0;1;1
19359;Pilaitukas;PAUKŠTELIAI;56237836622;Taip;0;2;0;2
19360;Pilaitukas;PAUKŠTELIAI;98123777614;Taip;0;5;0;5
19361;Pilaitukas;PAUKŠTELIAI;93292073339;Taip;5;1;0;6
19362;Pilaitukas;PAUKŠTELIAI;27134663020;Taip;5;1;0;6
19363;Pilaitukas;PAUKŠTELIAI;29035791508;Ne;0;2;2;4
19364;Pilaitukas;BORUŽĖLĖS;98045145204;Taip;0;1;3;4
19365;Pilaitukas;BORUŽĖLĖS;2145561638;Taip;0;2;0;2
19366;Pilaitukas;BORUŽĖLĖS;14937983736;Taip;0;1;0;1
19367;Pilaitukas;BORUŽĖLĖS;2308673826;Taip;0;1;7;8
19368;Pilaitukas;BORUŽĖLĖS;1714711904;Taip;3;0;1;4
19369;Pilaitukas;BORUŽĖLĖS;2436416327;Taip;11;0;0;11
19370;Pilaitukas;BORUŽĖLĖS;2561804291;Taip;0;0;2;2
19371;Pilaitukas;BORUŽĖLĖS;9414846817;Taip;10;0;2;12
19372;Pilaitukas;BORUŽĖLĖS;56069293343;Taip;0;1;0;1
19373;Pilaitukas;BORUŽĖLĖS;7156205658;Taip;11;0;1;12
19374;Pilaitukas;BORUŽĖLĖS;8364902911;Taip;2;0;0;2
19375;Pilaitukas;BORUŽĖLĖS;5063602139;Ne;0;0;2;2
19376;Pilaitukas;BORUŽĖLĖS;5984878126;Taip;0;11;2;13
19377;Pilaitukas;BORUŽĖLĖS;84508228457;Taip;0;0;1;1
19378;Pilaitukas;BORUŽĖLĖS;1142014148;Taip;3;1;0;4
19379;Pilaitukas;BORUŽĖLĖS;95439358242;Ne;1;0;0;1
19380;Pilaitukas;BORUŽĖLĖS;6024861998;Taip;11;0;0;11
19381;Pilaitukas;BORUŽĖLĖS;58416972423;Taip;13;0;0;13
19382;Pilaitukas;BORUŽĖLĖS;9898379569;Taip;0;0;2;2
19383;Pilaitukas;DRUGELIAI;7961518607;Taip;1;0;0;1
19384;Pilaitukas;DRUGELIAI;7082054458;Taip;1;0;0;1
19385;Pilaitukas;DRUGELIAI;64601938351;Taip;0;8;0;8
19386;Pilaitukas;DRUGELIAI;62416017620;Taip;0;1;4;5
19387;Pilaitukas;DRUGELIAI;5185051301;Taip;10;0;0;10
19388;Pilaitukas;DRUGELIAI;38456484551;Taip;0;5;0;5
19389;Pilaitukas;DRUGELIAI;7838787153;Taip;15;1;0;16
19390;Pilaitukas;DRUGELIAI;2613078582;Taip;0;17;0;17
19391;Pilaitukas;DRUGELIAI;1704055907;Taip;0;8;1;9
19392;Pilaitukas;DRUGELIAI;1677962644;Taip;0;19;0;19
19393;Pilaitukas;DRUGELIAI;4745358362;Taip;0;19;0;19
19394;Pilaitukas;DRUGELIAI;3483758882;Taip;0;0;1;1
19395;Pilaitukas;DRUGELIAI;7853910193;Taip;13;0;0;13
19396;Pilaitukas;DRUGELIAI;6646474196;Taip;10;0;0;10
19397;Pilaitukas;DRUGELIAI;9801214344;Ne;3;0;4;7
19398;Pilaitukas;DRUGELIAI;5331915157;Taip;1;0;2;3
19399;Pilaitukas;DRUGELIAI;8302624354;Taip;11;0;0;11
19400;Pilaitukas;DRUGELIAI;5422289286;Taip;4;1;1;6
19401;Pilaitukas;DRUGELIAI;1272758839;Taip;7;1;1;9
19402;Pilaitukas;PELIUKAI;89730708991;Taip;0;1;0;1
19403;Pilaitukas;PELIUKAI;28559756114;Taip;0;1;0;1
19404;Pilaitukas;PELIUKAI;54387359229;Taip;0;1;1;2
19405;Pilaitukas;PELIUKAI;29229117661;Taip;0;10;0;10
19406;Pilaitukas;PELIUKAI;15303269615;Taip;0;3;0;3
19407;Pilaitukas;PELIUKAI;12327235652;Ne;0;1;0;1
19408;Pilaitukas;PELIUKAI;26063381713;Ne;4;0;1;5
19409;Pilaitukas;PELIUKAI;90148331957;Taip;0;1;0;1
19410;Pilaitukas;PELIUKAI;89719236172;Ne;0;5;0;5
19411;Pilaitukas;PELIUKAI;49084081967;Taip;2;1;0;3
19412;Pilaitukas;PELIUKAI;3685682772;Taip;0;21;0;21
19413;Pilaitukas;PELIUKAI;25608611239;Taip;5;0;0;5
19414;Pilaitukas;PELIUKAI;54706920576;Taip;1;0;0;1
19415;Pilaitukas;PELIUKAI;1168958446;Taip;0;1;0;1
19416;Pilaitukas;PELIUKAI;8152280709;Taip;2;1;0;3
19417;Pilaitukas;PELIUKAI;42514613325;Taip;5;0;0;5
19418;Pilaitukas;PELIUKAI;1611616941;Taip;0;8;0;8
19419;Pilaitukas;PELIUKAI;1726805610;Taip;7;0;0;7
19420;Pilaitukas;PELIUKAI;68571454940;Ne;2;1;3;6
19421;Pilaitukas;PELIUKAI;1779631590;Taip;4;1;0;5
19422;Pilaitukas;KAČIUKAI;74264627858;Taip;21;0;0;21
19423;Pilaitukas;KAČIUKAI;71072645939;Taip;0;2;0;2
19424;Pilaitukas;KAČIUKAI;70465651068;Taip;0;2;0;2
19425;Pilaitukas;KAČIUKAI;4283157555;Taip;5;0;0;5
19426;Pilaitukas;KAČIUKAI;90472705680;Taip;0;1;0;1
19427;Pilaitukas;KAČIUKAI;58064353914;Taip;0;1;0;1
19428;Pilaitukas;KAČIUKAI;92823052045;Taip;6;10;0;16
19429;Pilaitukas;KAČIUKAI;7032684121;Taip;5;1;0;6
19430;Pilaitukas;KAČIUKAI;28902841059;Taip;3;1;0;4
19431;Pilaitukas;KAČIUKAI;2045735700;Taip;8;1;0;9
19432;Pilaitukas;KAČIUKAI;78048449266;Taip;0;1;0;1
19433;Pilaitukas;KAČIUKAI;82688660737;Taip;4;0;0;4
19434;Pilaitukas;KAČIUKAI;4348058482;Taip;0;2;0;2
19435;Pilaitukas;KAČIUKAI;34346418650;Ne;1;0;0;1
19436;Pilaitukas;KAČIUKAI;9496336005;Taip;7;1;0;8
19437;Pilaitukas;KAČIUKAI;6069797837;Taip;5;6;0;11
19438;Pilaitukas;SAULUTĖS;7222856683;Taip;0;21;0;21
19439;Pilaitukas;SAULUTĖS;6436694057;Taip;5;0;5;10
19440;Pilaitukas;SAULUTĖS;4719223490;Taip;8;0;2;10
19441;Pilaitukas;SAULUTĖS;8787181006;Taip;0;9;0;9
19442;Pilaitukas;SAULUTĖS;9247501721;Taip;5;0;0;5
19443;Pilaitukas;SAULUTĖS;3825942473;Taip;0;11;1;12
19444;Pilaitukas;SAULUTĖS;9870994949;Taip;9;0;4;13
19445;Pilaitukas;SAULUTĖS;3298272815;Taip;15;0;0;15
19446;Pilaitukas;SAULUTĖS;1731106179;Taip;14;0;0;14
19447;Pilaitukas;SAULUTĖS;8767785444;Taip;6;3;0;9
19448;Pilaitukas;SAULUTĖS;2697591669;Ne;0;0;1;1
19449;Pilaitukas;SAULUTĖS;3954210452;Ne;10;0;0;10
19450;Pilaitukas;SAULUTĖS;3772830210;Ne;8;0;1;9
19451;Pilaitukas;SAULUTĖS;1611371690;Taip;20;0;0;20
19452;Pilaitukas;SAULUTĖS;9974310580;Taip;1;2;0;3
19453;Pilaitukas;MENULIUKAI;4014329370;Taip;13;0;0;13
19454;Pilaitukas;MENULIUKAI;9774222130;Taip;18;0;0;18
19455;Pilaitukas;MENULIUKAI;4810825253;Taip;10;1;0;11
19456;Pilaitukas;MENULIUKAI;9556421129;Taip;16;0;0;16
19457;Pilaitukas;MENULIUKAI;8168228529;Ne;0;0;6;6
19458;Pilaitukas;MENULIUKAI;5421602723;Taip;3;1;2;6
19459;Pilaitukas;MENULIUKAI;7604004800;Taip;13;0;0;13
19460;Pilaitukas;MENULIUKAI;8501376663;Taip;5;0;1;6
19461;Pilaitukas;MENULIUKAI;6833933586;Taip;8;0;2;10
19462;Pilaitukas;MENULIUKAI;1270365948;Taip;12;0;0;12
19463;Pilaitukas;MENULIUKAI;2416277190;Taip;0;21;0;21
19464;Pilaitukas;MENULIUKAI;7808204054;Ne;0;0;1;1
19465;Pilaitukas;ĖŽIUKAI;9653647227;Taip;0;1;20;21
19466;Pilaitukas;ĖŽIUKAI;5326689274;Taip;10;0;11;21
19467;Pilaitukas;ĖŽIUKAI;2463482642;Taip;0;0;4;4
19468;Pilaitukas;ĖŽIUKAI;9038324313;Taip;5;0;1;6
19469;Pilaitukas;ĖŽIUKAI;2406183145;Taip;0;2;0;2
19470;Pilaitukas;ĖŽIUKAI;2379660463;Taip;0;2;0;2
19471;Pilaitukas;ĖŽIUKAI;1585341963;Taip;0;1;0;1
19472;Pilaitukas;ĖŽIUKAI;3080014745;Taip;12;1;0;13
19473;Pilaitukas;ĖŽIUKAI;5353687011;Taip;4;8;0;12
19474;Pilaitukas;ĖŽIUKAI;6102253106;Taip;0;0;1;1
19475;Pilaitukas;ĖŽIUKAI;8009040109;Taip;0;2;2;4
19476;Pilaitukas;ĖŽIUKAI;4022543517;Taip;0;1;0;1
19477;Pilaitukas;ĖŽIUKAI;7594484959;Taip;0;5;1;6
19478;Pilaitukas;ĖŽIUKAI;6525191057;Taip;5;0;3;8
19479;"Naujųjų verkių";Lopšelinė;1045355492;Taip;10;0;0;10
19480;"Naujųjų verkių";Lopšelinė;3825572125;Taip;0;2;0;2
19481;"Naujųjų verkių";Lopšelinė;8223747534;Taip;20;0;0;20
19482;"Naujųjų verkių";Lopšelinė;9200073539;Taip;0;1;0;1
19483;"Naujųjų verkių";Lopšelinė;1693323032;Taip;16;0;0;16
19484;"Naujųjų verkių";Lopšelinė;7010430969;Taip;0;1;0;1
19485;"Naujųjų verkių";Lopšelinė;9462019924;Taip;0;1;0;1
19486;"Naujųjų verkių";Lopšelinė;3459439843;Taip;0;4;0;4
19487;"Naujųjų verkių";Lopšelinė;7510541192;Taip;4;1;0;5
19488;"Naujųjų verkių";Darželinė;12970840107;Taip;0;0;3;3
19489;"Naujųjų verkių";Darželinė;70974231925;Taip;0;6;0;6
19490;"Naujųjų verkių";Darželinė;96956603806;Taip;0;1;0;1
19491;"Naujųjų verkių";Darželinė;60556803369;Taip;0;1;0;1
19492;"Naujųjų verkių";Darželinė;2636744220;Taip;0;5;0;5
19493;"Naujųjų verkių";Darželinė;45101251137;Taip;0;6;0;6
19494;"Naujųjų verkių";Darželinė;1321551506;Taip;0;4;0;4
19495;"Naujųjų verkių";Darželinė;1061601585;Taip;0;5;0;5
19496;"Naujųjų verkių";Darželinė;19360482785;Ne;0;2;0;2
19497;"Naujųjų verkių";Darželinė;49937307547;Taip;21;0;0;21
19498;"Naujųjų verkių";Darželinė;89540088936;Taip;6;0;0;6
19499;"Naujųjų verkių";Darželinė;1023447413;Taip;0;1;0;1
19500;"Naujųjų verkių";Darželinė;7872515649;Taip;19;0;0;19
19501;"Naujųjų verkių";Darželinė;9840473841;Taip;0;3;0;3
19502;"Naujųjų verkių";Darželinė;63932903598;Taip;0;3;0;3
19503;"Naujųjų verkių";Darželinė;3572188688;Taip;5;0;0;5
19504;Švelnukas;Pelėdžiukai;97312326369;Taip;0;1;0;1
19505;Švelnukas;Pelėdžiukai;35501839416;Taip;0;6;0;6
19506;Švelnukas;Pelėdžiukai;54159329795;Taip;0;1;0;1
19507;Švelnukas;Pelėdžiukai;56353311492;Taip;0;1;20;21
19508;Švelnukas;Pelėdžiukai;73720184241;Taip;5;1;0;6
19509;Švelnukas;Pelėdžiukai;94832155557;Taip;14;5;0;19
19510;Švelnukas;Pelėdžiukai;1398812288;Taip;0;3;0;3
19511;Švelnukas;Pelėdžiukai;4006769867;Taip;0;1;0;1
19512;Švelnukas;Pelėdžiukai;39249642586;Taip;0;1;1;2
19513;Švelnukas;Pelėdžiukai;12011187563;Taip;0;1;0;1
19514;Švelnukas;Pelėdžiukai;72764312386;Ne;0;1;0;1
19515;Švelnukas;Pelėdžiukai;59229958089;Taip;0;3;0;3
19516;Švelnukas;Pelėdžiukai;57026029080;Taip;0;1;0;1
19517;Švelnukas;Pelėdžiukai;30679686753;Taip;0;1;1;2
19518;Švelnukas;Pelėdžiukai;32473329970;Ne;0;3;0;3
19519;Švelnukas;Pelėdžiukai;50326830712;Ne;0;3;1;4
19520;Švelnukas;Pelėdžiukai;16880708270;Taip;0;1;0;1
19521;Švelnukas;Pelėdžiukai;19279790066;Taip;0;1;0;1
19522;Švelnukas;Pelėdžiukai;76470453844;Taip;0;1;0;1
19523;Švelnukas;Pelėdžiukai;88430357193;Taip;0;1;1;2
19524;Švelnukas;Pelėdžiukai;52477782880;Taip;1;0;0;1
19525;Švelnukas;Ežiukai;79306550532;Taip;0;1;0;1
19526;Švelnukas;Ežiukai;68248605297;Taip;0;1;0;1
19527;Švelnukas;Ežiukai;41867077386;Ne;0;0;5;5
19528;Švelnukas;Ežiukai;64192510147;Taip;0;2;0;2
19529;Švelnukas;Ežiukai;41365412569;Taip;0;1;4;5
19530;Švelnukas;Ežiukai;25374873288;Taip;0;1;2;3
19531;Švelnukas;Ežiukai;15308444101;Taip;0;0;7;7
19532;Švelnukas;Ežiukai;6282389058;Taip;0;1;0;1
19533;Švelnukas;Ežiukai;1755384216;Ne;3;1;1;5
19534;Švelnukas;Ežiukai;23795609183;Taip;4;0;1;5
19535;Švelnukas;Ežiukai;31881188589;Taip;3;1;0;4
19536;Švelnukas;Ežiukai;38902466526;Taip;10;0;2;12
19537;Švelnukas;Ežiukai;33263455673;Taip;0;1;2;3
19538;Švelnukas;Ežiukai;8399963483;Taip;0;0;2;2
19539;Švelnukas;Ežiukai;4711482287;Taip;5;0;2;7
19540;Švelnukas;Ežiukai;8681264696;Taip;5;1;0;6
19541;Švelnukas;Ežiukai;3126384599;Ne;0;0;4;4
19542;Švelnukas;Ežiukai;5608926908;Taip;17;0;0;17
19543;Švelnukas;Ežiukai;4373567509;Ne;15;0;1;16
19544;Švelnukas;Ežiukai;56642886337;Taip;0;1;1;2
19545;Švelnukas;Švelnukai;4681584014;Taip;0;0;5;5
19546;Švelnukas;Švelnukai;8211289456;Taip;5;0;0;5
19547;Švelnukas;Švelnukai;6607578153;Taip;7;0;3;10
19548;Švelnukas;Švelnukai;6798179840;Taip;0;0;3;3
19549;Švelnukas;Švelnukai;8847738918;Taip;0;1;0;1
19550;Švelnukas;Švelnukai;5212827184;Taip;0;1;0;1
19551;Švelnukas;Švelnukai;2464467471;Taip;1;0;2;3
19552;Švelnukas;Švelnukai;5213589179;Taip;5;3;0;8
19553;Švelnukas;Švelnukai;1963518457;Taip;0;21;0;21
19554;Švelnukas;Švelnukai;5936821902;Taip;2;0;3;5
19555;Švelnukas;Boružiukai;1951447127;Taip;10;0;0;10
19556;Švelnukas;Boružiukai;3849957906;Taip;0;0;2;2
19557;Švelnukas;Boružiukai;5550841477;Taip;9;0;0;9
19558;Švelnukas;Boružiukai;5974324302;Taip;6;0;0;6
19559;Švelnukas;Boružiukai;9722532034;Taip;3;0;1;4
19560;Švelnukas;Boružiukai;2400781175;Taip;8;0;1;9
19561;Švelnukas;Boružiukai;1264256177;Taip;10;0;1;11
19562;Švelnukas;Boružiukai;1332533332;Taip;15;0;0;15
19563;Švelnukas;Boružiukai;8787505507;Taip;0;0;2;2
19564;Švelnukas;Boružiukai;4134678301;Ne;5;0;0;5
19565;Švelnukas;Boružiukai;8458233793;Taip;0;0;3;3
19566;Švelnukas;Boružiukai;7967996032;Taip;0;5;0;5
19567;Švelnukas;Boružiukai;8951980999;Taip;0;0;3;3
19568;Švelnukas;Boružiukai;4990399144;Taip;4;3;0;7
19569;Švelnukas;Boružiukai;9575767514;Taip;0;0;5;5
19570;Švelnukas;Boružiukai;5409130195;Taip;16;0;0;16
19571;Švelnukas;Boružiukai;9479536507;Taip;0;0;1;1
19572;Švelnukas;Boružiukai;2088128734;Ne;2;0;0;2
19573;Švelnukas;Boružiukai;3145935641;Taip;0;3;0;3
19574;Švelnukas;Smalsučiai;76418408780;Taip;0;1;0;1
19575;Švelnukas;Smalsučiai;82202942341;Taip;0;5;0;5
19576;Švelnukas;Smalsučiai;63394075248;Taip;0;3;0;3
19577;Švelnukas;Smalsučiai;53619702326;Taip;0;1;0;1
19578;Švelnukas;Smalsučiai;1183982303;Taip;0;2;0;2
19579;Švelnukas;Smalsučiai;74759523550;Taip;0;1;0;1
19580;Švelnukas;Smalsučiai;87770765141;Taip;5;0;0;5
19581;Švelnukas;Smalsučiai;47645479348;Taip;0;1;0;1
19582;Švelnukas;Smalsučiai;19117783391;Taip;6;0;6;12
19583;Švelnukas;Smalsučiai;26077395334;Ne;11;6;2;19
19584;Švelnukas;Smalsučiai;15711256627;Taip;0;2;0;2
19585;Švelnukas;Smalsučiai;95780894209;Taip;0;0;2;2
19586;Švelnukas;Smalsučiai;76563731138;Taip;0;11;0;11
19587;Švelnukas;Smalsučiai;3388721433;Taip;0;1;0;1
19588;Švelnukas;Smalsučiai;1742714140;Taip;5;1;0;6
19589;Švelnukas;Smalsučiai;54425041280;Taip;0;1;0;1
19590;Švelnukas;Smalsučiai;91569132037;Taip;5;0;1;6
19591;Švelnukas;Smalsučiai;34570338962;Taip;0;0;2;2
19592;Švelnukas;Smalsučiai;78611632021;Taip;0;0;14;14
19593;Švelnukas;Smalsučiai;15774114007;Taip;1;0;2;3
19594;Švelnukas;Smalsučiai;26312856720;Taip;0;0;5;5
19595;Švelnukas;Nykštukai;8221642452;Taip;0;1;0;1
19596;Švelnukas;Nykštukai;2141519946;Taip;0;2;0;2
19597;Švelnukas;Nykštukai;8771953161;Taip;0;6;2;8
19598;Švelnukas;Nykštukai;5327209876;Ne;0;6;0;6
19599;Švelnukas;Nykštukai;2282356211;Taip;1;1;1;3
19600;Švelnukas;Nykštukai;4697253853;Ne;0;1;1;2
19601;Švelnukas;Nykštukai;7387060610;Taip;0;2;0;2
19602;Švelnukas;Nykštukai;1762528313;Taip;0;1;5;6
19603;Švelnukas;Nykštukai;7380948648;Taip;8;0;0;8
19604;Švelnukas;Nykštukai;3473146893;Taip;8;0;0;8
19605;Švelnukas;Nykštukai;3370028567;Taip;6;0;0;6
19606;Švelnukas;Nykštukai;6633233824;Taip;17;0;0;17
19607;Švelnukas;Nykštukai;2106591525;Ne;9;3;0;12
19608;Švelnukas;Nykštukai;93497358197;Taip;0;3;0;3
19609;Švelnukas;Nykštukai;2971380970;Taip;0;1;4;5
19610;Švelnukas;Nykštukai;3389897065;Taip;0;1;4;5
19611;Švelnukas;Nykštukai;4302735157;Taip;6;0;0;6
19612;Švelnukas;Nykštukai;2785396019;Ne;0;0;2;2
19613;Švelnukas;Nykštukai;6195335543;Ne;0;0;2;2
19614;Boružėlė;"Nykštukai gudručiai";16750834044;Taip;8;0;0;8
19615;Boružėlė;"Nykštukai gudručiai";17133057179;Taip;0;7;0;7
19616;Boružėlė;"Nykštukai gudručiai";48975225740;Taip;0;2;0;2
19617;Boružėlė;"Nykštukai gudručiai";61157651941;Ne;0;1;0;1
19618;Boružėlė;"Nykštukai gudručiai";27819440058;Taip;0;2;0;2
19619;Boružėlė;"Nykštukai gudručiai";62849453206;Taip;8;2;0;10
19620;Boružėlė;"Nykštukai gudručiai";90752643228;Taip;0;3;0;3
19621;Boružėlė;"Nykštukai gudručiai";91349343635;Taip;0;1;0;1
19622;Boružėlė;"Nykštukai gudručiai";52470353273;Taip;7;1;0;8
19623;Boružėlė;"Nykštukai gudručiai";3659004986;Taip;4;0;0;4
19624;Boružėlė;"Nykštukai gudručiai";28726593347;Taip;11;2;0;13
19625;Boružėlė;"Nykštukai gudručiai";47122226309;Taip;0;1;0;1
19626;Boružėlė;"Nykštukai gudručiai";13957276157;Taip;5;2;0;7
19627;Boružėlė;"Nykštukai gudručiai";55985459125;Ne;0;2;0;2
19628;Boružėlė;"Nykštukai gudručiai";68875252308;Taip;0;2;0;2
19629;Boružėlė;"Nykštukai gudručiai";229765248;Taip;0;1;0;1
19630;Boružėlė;"Nykštukai gudručiai";82591189080;Taip;2;2;0;4
19631;Boružėlė;"Nykštukai gudručiai";5105514215;Taip;0;1;0;1
19632;Boružėlė;"Nykštukai gudručiai";64502791927;Taip;0;3;0;3
19633;Boružėlė;"Nykštukai gudručiai";95194187600;Taip;0;3;0;3
19634;Boružėlė;"Nykštukai gudručiai";59772973857;Taip;6;2;0;8
19635;Boružėlė;"Nykštukai gudručiai";473765285;Taip;1;0;0;1
19636;Boružėlė;"Saulės zuikučiai";4554260776;Taip;21;0;0;21
19637;Boružėlė;"Saulės zuikučiai";8259586236;Taip;5;0;0;5
19638;Boružėlė;"Saulės zuikučiai";3955841578;Taip;5;1;0;6
19639;Boružėlė;"Saulės zuikučiai";5516103398;Taip;6;0;0;6
19640;Boružėlė;"Saulės zuikučiai";5298170118;Taip;4;2;1;7
19641;Boružėlė;"Saulės zuikučiai";9271331800;Taip;2;0;0;2
19642;Boružėlė;"Saulės zuikučiai";2133849514;Taip;0;2;0;2
19643;Boružėlė;"Saulės zuikučiai";1116012068;Ne;8;3;0;11
19644;Boružėlė;"Saulės zuikučiai";3412892266;Taip;13;1;0;14
19645;Boružėlė;"Saulės zuikučiai";1292298259;Taip;0;2;0;2
19646;Boružėlė;"Saulės zuikučiai";7256396576;Taip;0;1;0;1
19647;Boružėlė;"Saulės zuikučiai";4323998138;Taip;7;0;1;8
19648;Boružėlė;"Saulės zuikučiai";2087238951;Taip;0;2;0;2
19649;Boružėlė;"Saulės zuikučiai";4999277693;Taip;8;1;0;9
19650;Boružėlė;"Saulės zuikučiai";6990311896;Taip;5;1;0;6
19651;Boružėlė;"Saulės zuikučiai";4509233532;Taip;5;4;0;9
19652;Boružėlė;"Saulės zuikučiai";3952645542;Taip;9;1;0;10
19653;Boružėlė;Gėlytės;4023646693;Taip;0;1;0;1
19654;Boružėlė;Gėlytės;51321138507;Taip;0;12;6;18
19655;Boružėlė;Gėlytės;62298785353;Taip;6;3;0;9
19656;Boružėlė;Gėlytės;84087304104;Taip;11;1;0;12
19657;Boružėlė;Gėlytės;11785706048;Taip;16;1;0;17
19658;Boružėlė;Gėlytės;41726574939;Taip;5;0;0;5
19659;Boružėlė;Gėlytės;81433480408;Taip;0;3;0;3
19660;Boružėlė;Gėlytės;77207874939;Taip;0;1;0;1
19661;Boružėlė;Gėlytės;60999303687;Taip;0;2;0;2
19662;Boružėlė;Gėlytės;86742600111;Taip;0;3;2;5
19663;Boružėlė;Gėlytės;43579952892;Taip;0;0;2;2
19664;Boružėlė;Gėlytės;54530233692;Ne;0;2;0;2
19665;Boružėlė;Gėlytės;25443948372;Taip;0;1;1;2
19666;Boružėlė;Gėlytės;33639051694;Taip;4;1;5;10
19667;Boružėlė;Gėlytės;57842027470;Taip;7;2;0;9
19668;Boružėlė;Gėlytės;1010790194;Taip;0;2;0;2
19669;Boružėlė;Gėlytės;1813949172;Taip;0;4;0;4
19670;Boružėlė;Gėlytės;5306841409;Ne;0;1;0;1
19671;Boružėlė;Gėlytės;1080735912;Taip;0;2;0;2
19672;Boružėlė;Gėlytės;43198292519;Taip;0;2;0;2
19673;Boružėlė;Smalsutis;5129244830;Taip;8;0;0;8
19674;Boružėlė;Smalsutis;6927100979;Taip;0;0;5;5
19675;Boružėlė;Smalsutis;4947670606;Taip;0;0;7;7
19676;Boružėlė;Smalsutis;5267216044;Taip;3;0;0;3
19677;Boružėlė;Smalsutis;7263730692;Taip;0;10;0;10
19678;Boružėlė;Smalsutis;5708558321;Taip;4;1;0;5
19679;Boružėlė;Smalsutis;6484173786;Taip;11;0;0;11
19680;Boružėlė;Smalsutis;6742157071;Taip;0;0;1;1
19681;Boružėlė;Smalsutis;39553430808;Taip;0;0;1;1
19682;Boružėlė;Smalsutis;4958704459;Taip;0;1;0;1
19683;Boružėlė;Smalsutis;5618586722;Taip;0;1;0;1
19684;Boružėlė;Smalsutis;8493908653;Taip;0;0;1;1
19685;Boružėlė;Smalsutis;4283064680;Taip;0;0;1;1
19686;Boružėlė;Smalsutis;2447148171;Ne;0;3;1;4
19687;Boružėlė;Smalsutis;1391562352;Taip;0;0;1;1
19688;Boružėlė;Drugeliai;8357946299;Taip;3;2;0;5
19689;Boružėlė;Drugeliai;1130980139;Taip;5;1;0;6
19690;Boružėlė;Drugeliai;6463583187;Taip;0;3;1;4
19691;Boružėlė;Drugeliai;6049501362;Ne;0;1;0;1
19692;Boružėlė;Drugeliai;3136028536;Taip;4;1;0;5
19693;Boružėlė;Drugeliai;2211576663;Taip;4;3;0;7
19694;Boružėlė;Drugeliai;1559001916;Taip;2;1;0;3
19695;Boružėlė;Drugeliai;4233602822;Taip;0;2;0;2
19696;Boružėlė;Drugeliai;9463322491;Taip;0;3;0;3
19697;Boružėlė;Drugeliai;3108758436;Taip;8;0;1;9
19698;Boružėlė;Drugeliai;8482813204;Taip;3;1;1;5
19699;Boružėlė;Drugeliai;6902130914;Taip;4;0;2;6
19700;Boružėlė;Drugeliai;3459207879;Ne;2;2;2;6
19701;Boružėlė;Drugeliai;1545244006;Taip;0;3;2;5
19702;Boružėlė;Drugeliai;6980022864;Taip;7;2;0;9
19703;Boružėlė;Drugeliai;7756929745;Taip;9;0;0;9
19704;Boružėlė;Drugeliai;5726187445;Taip;0;0;5;5
19705;Boružėlė;Drugeliai;2308405580;Taip;0;0;4;4
19706;Boružėlė;Vyturėliai;1913540317;Taip;3;4;0;7
19707;Boružėlė;Vyturėliai;1950269258;Taip;0;7;0;7
19708;Boružėlė;Vyturėliai;1591582954;Taip;0;6;0;6
19709;Boružėlė;Vyturėliai;9180459278;Taip;0;1;0;1
19710;Boružėlė;Vyturėliai;3322567969;Taip;0;1;0;1
19711;Boružėlė;Vyturėliai;1718509953;Taip;0;1;0;1
19712;Boružėlė;Vyturėliai;8311383437;Taip;0;1;1;2
19713;Boružėlė;Vyturėliai;7534482245;Ne;7;1;0;8
19714;Boružėlė;Vyturėliai;3310676316;Taip;0;5;0;5
19715;Boružėlė;Vyturėliai;87834777247;Ne;4;6;0;10
19716;Boružėlė;Vyturėliai;50071056728;Taip;6;10;0;16
19717;Boružėlė;Vyturėliai;2098408445;Taip;0;2;0;2
19718;Boružėlė;Vyturėliai;8706461730;Taip;0;7;0;7
19719;Boružėlė;Vyturėliai;5337704114;Taip;0;3;0;3
19720;Boružėlė;Vyturėliai;8146684259;Taip;0;1;0;1
19721;Boružėlė;Vyturėliai;8225622711;Taip;0;3;0;3
19722;Boružėlė;Vyturėliai;9150703371;Taip;13;3;0;16
19723;Boružėlė;Vyturėliai;5811751925;Taip;0;2;2;4
19724;Boružėlė;Vyturėliai;7136428795;Taip;0;5;0;5
19725;Boružėlė;Žvaigždutės;9838823214;Taip;16;0;0;16
19726;Boružėlė;Žvaigždutės;7825636053;Taip;0;9;0;9
19727;Boružėlė;Žvaigždutės;7901880926;Taip;8;1;0;9
19728;Boružėlė;Žvaigždutės;6242220139;Taip;5;4;1;10
19729;Boružėlė;Žvaigždutės;1663216529;Taip;3;0;0;3
19730;Boružėlė;Žvaigždutės;3489498503;Taip;0;5;2;7
19731;Boružėlė;Žvaigždutės;5274016839;Taip;0;1;0;1
19732;Boružėlė;Žvaigždutės;6972646373;Taip;2;2;0;4
19733;Boružėlė;Žvaigždutės;9720535449;Taip;10;2;1;13
19734;Boružėlė;Žvaigždutės;6435556131;Taip;10;2;1;13
19735;Boružėlė;Žvaigždutės;3140264242;Taip;10;2;0;12
19736;Boružėlė;Žvaigždutės;1136249597;Taip;15;1;0;16
19737;Boružėlė;Žvaigždutės;8029389952;Taip;9;1;0;10
19738;Boružėlė;Žvaigždutės;5307997577;Taip;10;0;5;15
19739;Boružėlė;Žvaigždutės;7078709057;Taip;15;1;0;16
19740;Boružėlė;Žvaigždutės;8213060214;Taip;10;0;0;10
19741;Boružėlė;Žvaigždutės;8916241914;Taip;0;1;0;1
19742;Boružėlė;Žvaigždutės;6724101421;Taip;0;2;0;2
19743;Boružėlė;Ąžuoliukai;5774358876;Taip;0;5;3;8
19744;Boružėlė;Ąžuoliukai;4519645340;Taip;0;3;3;6
19745;Boružėlė;Ąžuoliukai;24315678618;Taip;15;0;0;15
19746;Boružėlė;Ąžuoliukai;5138737297;Taip;5;1;0;6
19747;Boružėlė;Ąžuoliukai;2618814096;Ne;0;6;0;6
19748;Boružėlė;Ąžuoliukai;3040376382;Taip;0;3;4;7
19749;Boružėlė;Ąžuoliukai;3912668735;Taip;5;3;0;8
19750;Boružėlė;Ąžuoliukai;3840860155;Taip;2;5;0;7
19751;Boružėlė;Ąžuoliukai;3869817904;Taip;0;3;1;4
19752;Boružėlė;Ąžuoliukai;7722277859;Taip;0;6;0;6
19753;Boružėlė;Ąžuoliukai;6954794465;Taip;5;3;3;11
19754;Boružėlė;Ąžuoliukai;6545116373;Taip;10;6;0;16
19755;Boružėlė;Ąžuoliukai;5832223872;Taip;0;2;0;2
19756;Boružėlė;Ąžuoliukai;3695411422;Taip;0;16;1;17
19757;Boružėlė;Ąžuoliukai;5148410392;Ne;0;0;2;2
19758;Boružėlė;Ąžuoliukai;45181369655;Taip;6;3;0;9
19759;Boružėlė;Ąžuoliukai;2077228543;Taip;0;2;0;2
19760;Boružėlė;Ąžuoliukai;6022191251;Taip;6;5;0;11
19761;Boružėlė;Saulutės;55049551150;Taip;5;3;0;8
19762;Boružėlė;Saulutės;1311485296;Taip;0;3;1;4
19763;Boružėlė;Saulutės;64389558278;Taip;0;5;1;6
19764;Boružėlė;Saulutės;46425201501;Taip;0;1;0;1
19765;Boružėlė;Saulutės;1399195259;Taip;6;7;0;13
19766;Boružėlė;Saulutės;72321159041;Taip;0;1;0;1
19767;Boružėlė;Saulutės;1247185819;Taip;0;1;0;1
19768;Boružėlė;Saulutės;1910653135;Taip;7;5;0;12
19769;Boružėlė;Saulutės;1527135537;Taip;7;2;0;9
19770;Boružėlė;Saulutės;8814486475;Taip;0;3;0;3
19771;Boružėlė;Saulutės;48414697489;Taip;0;2;0;2
19772;Boružėlė;Saulutės;3004650727;Taip;4;0;0;4
19773;Boružėlė;Saulutės;4567360023;Taip;0;1;0;1
19774;Boružėlė;Saulutės;96500755145;Ne;0;1;0;1
19775;Boružėlė;Saulutės;1506999888;Taip;5;2;0;7
19776;Boružėlė;Saulutės;2402968573;Taip;0;2;0;2
19777;Boružėlė;Saulutės;2690216341;Ne;0;5;1;6
19778;Boružėlė;Saulutės;1456577285;Taip;0;1;0;1
19779;Boružėlė;Saulutės;8659850691;Taip;0;2;0;2
19780;Boružėlė;Saulutės;4562962568;Taip;0;2;0;2
19781;Boružėlė;Saulutės;64347371263;Taip;0;2;0;2
19782;Boružėlė;Saulutės;1040409859;Taip;0;3;0;3
19783;Boružėlė;Saulutės;1750151078;Taip;11;2;0;13
19784;Boružėlė;Saulutės;1580917200;Taip;0;1;0;1
19785;Boružėlė;Saulutės;89046897963;Taip;0;1;0;1
19786;Boružėlė;Ežiukai;1637965530;Taip;6;1;0;7
19787;Boružėlė;Ežiukai;80490841186;Taip;5;0;0;5
19788;Boružėlė;Ežiukai;9645420240;Taip;9;1;0;10
19789;Boružėlė;Ežiukai;97765175729;Taip;6;0;0;6
19790;Boružėlė;Ežiukai;9436674675;Taip;6;4;0;10
19791;Boružėlė;Ežiukai;58923894463;Taip;13;2;0;15
19792;Boružėlė;Ežiukai;27456755162;Taip;0;3;0;3
19793;Boružėlė;Ežiukai;1339605077;Taip;0;5;0;5
19794;Boružėlė;Ežiukai;80239337645;Taip;4;3;0;7
19795;Boružėlė;Ežiukai;1007058344;Taip;11;1;0;12
19796;Boružėlė;Ežiukai;86859788504;Taip;13;1;0;14
19797;Boružėlė;Ežiukai;2138048547;Ne;0;5;0;5
19798;Boružėlė;Ežiukai;1431869021;Taip;7;1;0;8
19799;Boružėlė;Ežiukai;1474967056;Taip;10;0;0;10
19800;Boružėlė;Ežiukai;1732533643;Taip;0;4;0;4
19801;Boružėlė;Ežiukai;62548032852;Taip;5;2;0;7
19802;Boružėlė;Ežiukai;87991501724;Taip;8;1;0;9
19803;Boružėlė;Ežiukai;17258743024;Taip;0;8;0;8
19804;Boružėlė;Ežiukai;31109596405;Taip;0;8;0;8
19805;Boružėlė;Ežiukai;3702413611;Taip;4;0;0;4
19806;Boružėlė;Ežiukai;49403734292;Taip;5;0;0;5
19807;Boružėlė;Ežiukai;46486992436;Taip;5;2;0;7
19808;Boružėlė;Ežiukai;39704329817;Ne;10;1;0;11
19809;Boružėlė;Ežiukai;61932744418;Taip;5;1;0;6
19810;Boružėlė;Ežiukai;1459630343;Taip;0;8;0;8
19811;Boružėlė;Ežiukai;8266904750;Taip;5;4;0;9
19812;Boružėlė;Ežiukai;80378241169;Taip;9;2;0;11
19813;Boružėlė;Ežiukai;73347816357;Taip;9;1;0;10
19814;Boružėlė;Boružiukai;4433248526;Taip;2;0;1;3
19815;Boružėlė;Boružiukai;3288141024;Taip;9;5;0;14
19816;Boružėlė;Boružiukai;7942043844;Taip;10;6;0;16
19817;Boružėlė;Boružiukai;3226733236;Taip;10;3;0;13
19818;Boružėlė;Boružiukai;2842256033;Taip;2;1;0;3
19819;Boružėlė;Boružiukai;7262515868;Taip;0;5;0;5
19820;Boružėlė;Boružiukai;1146297996;Taip;8;3;0;11
19821;Boružėlė;Boružiukai;3340082011;Taip;6;0;0;6
19822;Boružėlė;Boružiukai;4020348640;Taip;10;0;0;10
19823;Boružėlė;Boružiukai;1166207929;Taip;7;1;0;8
19824;Boružėlė;Boružiukai;2561969142;Taip;6;0;1;7
19825;Boružėlė;Boružiukai;7956982615;Ne;21;0;0;21
19826;Boružėlė;Boružiukai;6070356395;Taip;17;0;0;17
19827;Boružėlė;Boružiukai;1547802140;Taip;7;0;0;7
19828;Boružėlė;Boružiukai;4637656311;Taip;9;0;0;9
19829;Boružėlė;Boružiukai;5768415821;Taip;14;0;6;20
19830;Boružėlė;Nykštukai;6590829182;Ne;5;1;2;8
19831;Boružėlė;Nykštukai;8141240094;Taip;0;2;0;2
19832;Boružėlė;Nykštukai;3129825206;Taip;0;10;0;10
19833;Boružėlė;Nykštukai;2349571778;Taip;5;6;0;11
19834;Boružėlė;Nykštukai;3171990207;Taip;0;5;0;5
19835;Boružėlė;Nykštukai;1894170218;Taip;10;0;0;10
19836;Boružėlė;Nykštukai;1784594085;Taip;12;1;0;13
19837;Boružėlė;Nykštukai;3509512899;Taip;13;1;0;14
19838;Boružėlė;Nykštukai;8888151470;Taip;13;1;0;14
19839;Boružėlė;Nykštukai;3430953692;Ne;17;1;0;18
19840;Boružėlė;Nykštukai;6166247730;Taip;0;3;0;3
19841;Boružėlė;Nykštukai;8365962523;Taip;0;4;0;4
19842;Boružėlė;Nykštukai;6876323023;Taip;0;17;0;17
19843;Boružėlė;Nykštukai;2744894565;Taip;0;1;20;21
19844;Boružėlė;Nykštukai;9771767352;Taip;5;7;3;15
19845;Boružėlė;Nykštukai;5825164520;Taip;7;0;0;7
19846;Boružėlė;Nykštukai;4990831292;Taip;19;0;0;19
19847;Žaliakalnio;Drugeliai;38025903441;Taip;0;2;0;2
19848;Žaliakalnio;Drugeliai;98394011032;Ne;0;3;0;3
19849;Žaliakalnio;Drugeliai;96127127960;Ne;18;0;0;18
19850;Žaliakalnio;Drugeliai;69892069029;Taip;0;1;0;1
19851;Žaliakalnio;Drugeliai;1012597457;Taip;0;6;0;6
19852;Žaliakalnio;Drugeliai;55967554391;Taip;5;0;0;5
19853;Žaliakalnio;Drugeliai;1357321617;Taip;0;1;0;1
19854;Žaliakalnio;Drugeliai;1967580906;Ne;0;1;0;1
19855;Žaliakalnio;Drugeliai;19165022144;Taip;0;1;0;1
19856;Žaliakalnio;Drugeliai;5428225559;Ne;9;1;2;12
19857;Žaliakalnio;Drugeliai;56222558457;Taip;0;1;0;1
19858;Žaliakalnio;Drugeliai;2059763621;Taip;0;0;7;7
19859;Žaliakalnio;Drugeliai;21032761681;Taip;0;1;1;2
19860;Žaliakalnio;Drugeliai;1919996835;Ne;0;1;0;1
19861;Žaliakalnio;Drugeliai;12010376482;Taip;0;1;0;1
19862;Žaliakalnio;Drugeliai;12932356909;Taip;0;1;0;1
19863;Žaliakalnio;Drugeliai;6270421264;Ne;0;0;1;1
19864;Žaliakalnio;Boružėlių;5843020412;Taip;5;3;0;8
19865;Žaliakalnio;Boružėlių;9625531462;Taip;11;10;0;21
19866;Žaliakalnio;Boružėlių;6699373334;Taip;11;10;0;21
19867;Žaliakalnio;Boružėlių;7087535800;Taip;12;0;0;12
19868;Žaliakalnio;Boružėlių;1528111839;Ne;2;0;0;2
19869;Žaliakalnio;Boružėlių;7023886811;Taip;0;1;0;1
19870;Žaliakalnio;Boružėlių;1673321992;Taip;9;2;0;11
19871;Žaliakalnio;Boružėlių;2284465378;Taip;0;16;0;16
19872;Žaliakalnio;Boružėlių;2808776865;Taip;12;1;0;13
19873;Žaliakalnio;Boružėlių;2278681435;Taip;12;0;0;12
19874;Žaliakalnio;Boružėlių;6547167325;Taip;6;1;0;7
19875;Žaliakalnio;Boružėlių;5157814568;Taip;0;0;2;2
19876;Žaliakalnio;Boružėlių;9421259943;Taip;17;0;0;17
19877;Žaliakalnio;Boružėlių;3445649442;Taip;5;3;0;8
19878;Žaliakalnio;Boružėlių;3105500733;Taip;3;4;0;7
19879;Žaliakalnio;Boružėlių;4864834075;Taip;1;7;0;8
19880;Žaliakalnio;Boružėlių;5764128482;Taip;2;19;0;21
19881;Žaliakalnio;Boružėlių;9848057352;Ne;0;19;0;19
19882;Žaliakalnio;Boružėlių;1200844791;Ne;11;7;0;18
19883;Žaliakalnio;Boružėlių;8052539476;Taip;11;8;0;19
19884;Žaliakalnio;Zuikučiai;1592051491;Ne;5;4;0;9
19885;Žaliakalnio;Zuikučiai;6088333997;Taip;9;6;0;15
19886;Žaliakalnio;Zuikučiai;2621828772;Taip;0;3;0;3
19887;Žaliakalnio;Zuikučiai;2673619031;Taip;0;1;0;1
19888;Žaliakalnio;Zuikučiai;5843314345;Taip;0;4;0;4
19889;Žaliakalnio;Zuikučiai;7447278960;Taip;0;12;0;12
19890;Žaliakalnio;Zuikučiai;2180165053;Taip;15;3;0;18
19891;Žaliakalnio;Zuikučiai;6823528666;Taip;11;3;0;14
19892;Žaliakalnio;Zuikučiai;3509064089;Taip;0;3;0;3
19893;Žaliakalnio;Zuikučiai;7000429934;Taip;0;6;0;6
19894;Žaliakalnio;Zuikučiai;5730610895;Taip;4;3;0;7
19895;Žaliakalnio;Zuikučiai;6881070397;Taip;0;3;0;3
19896;Žaliakalnio;Zuikučiai;8209559343;Taip;5;1;0;6
19897;Žaliakalnio;Zuikučiai;3835667120;Taip;0;6;0;6
19898;Žaliakalnio;Zuikučiai;9799056285;Taip;0;1;0;1
19899;Žaliakalnio;Zuikučiai;1321592040;Taip;1;2;0;3
19900;Žaliakalnio;Zuikučiai;8298313285;Taip;0;1;0;1
19901;Žaliakalnio;Zuikučiai;9331287916;Taip;1;9;0;10
19902;Žaliakalnio;Zuikučiai;6726832258;Taip;5;1;0;6
19903;Žaliakalnio;Zuikučiai;4607456527;Taip;6;4;0;10
19904;Žaliakalnio;Zuikučiai;4511376806;Taip;5;4;0;9
19905;Žaliakalnio;Zuikučiai;1144375065;Ne;0;0;2;2
19906;Žaliakalnio;Bitutė;23692122313;Ne;0;4;0;4
19907;Žaliakalnio;Bitutė;47735728560;Taip;0;4;0;4
19908;Žaliakalnio;Bitutė;26003637304;Taip;0;4;0;4
19909;Žaliakalnio;Bitutė;1673236492;Taip;3;0;0;3
19910;Žaliakalnio;Bitutė;46360583256;Taip;15;0;0;15
19911;Žaliakalnio;Bitutė;1027036769;Ne;0;3;0;3
19912;Žaliakalnio;Bitutė;1142844672;Taip;10;11;0;21
19913;Žaliakalnio;Bitutė;1447567627;Taip;0;1;0;1
19914;Žaliakalnio;Bitutė;1909837418;Ne;0;1;0;1
19915;Žaliakalnio;Bitutė;56508324349;Taip;0;2;0;2
19916;Žaliakalnio;Bitutė;92533370070;Ne;3;0;0;3
19917;Žaliakalnio;Bitutė;5761499050;Taip;2;3;0;5
19918;Žaliakalnio;Nykštukų;9057678671;Ne;0;4;0;4
19919;Žaliakalnio;Nykštukų;19192494119;Taip;0;2;0;2
19920;Žaliakalnio;Nykštukų;91524700281;Taip;0;2;0;2
19921;Žaliakalnio;Nykštukų;1753760382;Taip;0;2;0;2
19922;Žaliakalnio;Nykštukų;1657390839;Taip;0;6;0;6
19923;Žaliakalnio;Nykštukų;2655227703;Taip;5;1;0;6
19924;Žaliakalnio;Nykštukų;8085215871;Taip;0;6;0;6
19925;Žaliakalnio;Nykštukų;8469042778;Taip;4;0;2;6
19926;Žaliakalnio;Nykštukų;41844570217;Ne;0;4;0;4
19927;Žaliakalnio;Nykštukų;6638075273;Ne;21;0;0;21
19928;Žaliakalnio;Nykštukų;21744638321;Taip;0;3;0;3
19929;Žaliakalnio;Nykštukų;1514982516;Taip;5;2;0;7
19930;Žaliakalnio;Nykštukų;1497932659;Ne;0;0;1;1
19931;Žaliakalnio;Nykštukų;5946168564;Ne;3;7;0;10
19932;Žaliakalnio;Nykštukų;1589546605;Taip;0;2;0;2
19933;Žaliakalnio;Nykštukų;44058368949;Ne;5;4;0;9
19934;Žaliakalnio;Nykštukų;1511544568;Taip;0;7;0;7
19935;Žaliakalnio;ŽIOGELIAI;1413563085;Ne;5;2;0;7
19936;Žaliakalnio;ŽIOGELIAI;7449949339;Ne;3;0;0;3
19937;Žaliakalnio;ŽIOGELIAI;6379145626;Ne;21;0;0;21
19938;Žaliakalnio;ŽIOGELIAI;7094914749;Taip;18;0;0;18
19939;Žaliakalnio;ŽIOGELIAI;2607433844;Taip;0;0;1;1
19940;Žaliakalnio;ŽIOGELIAI;2432935088;Ne;11;0;0;11
19941;Žaliakalnio;ŽIOGELIAI;9771191966;Taip;21;0;0;21
19942;Žaliakalnio;ŽIOGELIAI;2426844621;Ne;9;1;0;10
19943;Žaliakalnio;ŽIOGELIAI;4961762841;Taip;1;0;0;1
19944;Žaliakalnio;ŽIOGELIAI;5752912101;Ne;16;0;0;16
19945;Žaliakalnio;ŽIOGELIAI;9967098834;Ne;11;0;0;11
19946;Žaliakalnio;ŽIOGELIAI;1133557422;Taip;0;3;0;3
19947;Žaliakalnio;ŽIOGELIAI;3464935314;Taip;11;4;0;15
19948;Žaliakalnio;ŽIOGELIAI;4497938258;Taip;3;5;0;8
19949;Žaliakalnio;ŽIOGELIAI;7648422668;Ne;13;1;0;14
19950;Žaliakalnio;ŽIOGELIAI;4702470511;Taip;0;9;0;9
19951;Žaliakalnio;ŽIOGELIAI;2272043654;Taip;4;0;0;4
19952;Žaliakalnio;ŽIOGELIAI;9363615751;Taip;0;10;0;10
19953;Volungė;Bitutės;1866419277;Taip;5;1;1;7
19954;Volungė;Bitutės;73677227470;Taip;0;0;2;2
19955;Volungė;Bitutės;58770101384;Taip;0;0;12;12
19956;Volungė;Bitutės;38549010202;Taip;9;0;0;9
19957;Volungė;Bitutės;77965211614;Taip;0;1;4;5
19958;Volungė;Bitutės;33437446320;Taip;0;1;0;1
19959;Volungė;Bitutės;57009443613;Taip;5;1;0;6
19960;Volungė;Bitutės;87185412767;Ne;0;1;2;3
19961;Volungė;Bitutės;1002996169;Taip;0;9;0;9
19962;Volungė;Bitutės;51999447522;Taip;0;1;1;2
19963;Volungė;Bitutės;54054647743;Taip;11;0;0;11
19964;Volungė;Bitutės;50724446122;Taip;0;0;2;2
19965;Volungė;Bitutės;33864104545;Taip;6;1;1;8
19966;Volungė;Bitutės;1673755671;Taip;0;1;6;7
19967;Volungė;Bitutės;1177104323;Taip;0;1;4;5
19968;Volungė;Bitutės;7623915697;Taip;0;1;1;2
19969;Volungė;Bitutės;6426464927;Taip;7;6;0;13
19970;Volungė;Bitutės;25298531632;Ne;5;2;2;9
19971;Volungė;Boružiukai;28521139566;Ne;0;1;2;3
19972;Volungė;Boružiukai;1574141255;Taip;3;1;1;5
19973;Volungė;Boružiukai;18572342676;Taip;0;1;9;10
19974;Volungė;Boružiukai;1921353660;Taip;1;0;1;2
19975;Volungė;Boružiukai;16359638255;Taip;0;1;0;1
19976;Volungė;Boružiukai;1776413826;Taip;2;0;0;2
19977;Volungė;Boružiukai;83169035513;Taip;1;1;1;3
19978;Volungė;Boružiukai;52112359999;Ne;0;0;1;1
19979;Volungė;Boružiukai;55920793056;Taip;0;2;2;4
19980;Volungė;Boružiukai;73555360631;Ne;0;1;0;1
19981;Volungė;Boružiukai;1766449043;Taip;0;1;1;2
19982;Volungė;Boružiukai;55892369610;Taip;0;1;1;2
19983;Volungė;Boružiukai;23806383679;Taip;0;1;8;9
19984;Volungė;Žvirbliukai;2547777148;Ne;0;2;0;2
19985;Volungė;Žvirbliukai;7965601199;Taip;9;0;0;9
19986;Volungė;Žvirbliukai;8287344195;Taip;12;1;0;13
19987;Volungė;Žvirbliukai;5710662590;Taip;2;0;0;2
19988;Volungė;Žvirbliukai;1528289101;Taip;5;0;0;5
19989;Volungė;Žvirbliukai;4839484528;Taip;10;0;4;14
19990;Volungė;Žvirbliukai;9188994935;Taip;0;10;0;10
19991;Volungė;Žvirbliukai;8285309230;Taip;17;0;4;21
19992;Volungė;Žvirbliukai;7149986415;Taip;0;0;14;14
19993;Volungė;Žvirbliukai;5174427959;Taip;2;0;6;8
19994;Volungė;Žvirbliukai;7867741556;Ne;0;0;2;2
19995;Volungė;Žvirbliukai;3430719834;Ne;0;1;0;1
19996;Volungė;Žvirbliukai;8459167833;Taip;0;4;0;4
19997;Volungė;Žvirbliukai;6028582927;Taip;14;0;0;14
19998;Volungė;Žvirbliukai;8784150784;Taip;0;10;0;10
19999;Volungė;Žvirbliukai;1137713075;Taip;21;0;0;21
20000;Volungė;Žvirbliukai;9578228103;Taip;5;0;0;5
20001;Volungė;Žvirbliukai;6431477042;Taip;6;0;2;8
20002;Volungė;Žvirbliukai;4986234066;Taip;0;0;4;4
20003;Volungė;Žvirbliukai;4598763851;Taip;12;0;1;13
20004;Volungė;Žvirbliukai;2322594823;Taip;6;1;0;7
20005;Volungė;Žiogeliai;6360834021;Taip;0;7;0;7
20006;Volungė;Žiogeliai;4856240879;Taip;0;0;2;2
20007;Volungė;Žiogeliai;8767261039;Taip;15;0;1;16
20008;Volungė;Žiogeliai;9100947038;Taip;12;0;1;13
20009;Volungė;Žiogeliai;4694016281;Taip;0;0;21;21
20010;Volungė;Žiogeliai;9749609738;Taip;11;0;2;13
20011;Volungė;Žiogeliai;8640511964;Ne;10;0;4;14
20012;Volungė;Žiogeliai;5170536566;Taip;0;1;2;3
20013;Volungė;Žiogeliai;8421730419;Taip;6;0;2;8
20014;Volungė;Žiogeliai;6532202782;Taip;0;0;5;5
20015;Volungė;Žiogeliai;2712034356;Taip;11;3;0;14
20016;Volungė;Žiogeliai;6074678642;Taip;21;0;0;21
20017;Volungė;Žiogeliai;2246291631;Ne;12;0;0;12
20018;Volungė;Žiogeliai;2456643081;Taip;0;0;5;5
20019;Volungė;Pelėdžiukai;1032406917;Taip;6;2;0;8
20020;Volungė;Pelėdžiukai;2106837525;Taip;6;0;1;7
20021;Volungė;Pelėdžiukai;1105647976;Ne;21;0;0;21
20022;Volungė;Pelėdžiukai;1705153224;Taip;5;0;3;8
20023;Volungė;Pelėdžiukai;2048619311;Taip;5;9;0;14
20024;Volungė;Pelėdžiukai;1205393441;Taip;0;1;0;1
20025;Volungė;Pelėdžiukai;3675279848;Taip;4;0;4;8
20026;Volungė;Pelėdžiukai;9097775073;Ne;6;0;0;6
20027;Volungė;Pelėdžiukai;1938717633;Taip;4;10;0;14
20028;Volungė;Pelėdžiukai;56766828567;Taip;5;0;0;5
20029;Volungė;Pelėdžiukai;1072302178;Taip;6;0;0;6
20030;Volungė;Pelėdžiukai;6977873198;Taip;5;1;0;6
20031;Volungė;Pelėdžiukai;1917593287;Taip;7;0;2;9
20032;Volungė;Pelėdžiukai;2558681375;Taip;0;0;6;6
20033;Volungė;Pelėdžiukai;85731265908;Taip;3;0;1;4
20034;Volungė;Pelėdžiukai;1861218588;Taip;5;0;3;8
20035;Volungė;Pelėdžiukai;5483140534;Taip;0;5;1;6
20036;Volungė;Pelėdžiukai;8236836742;Taip;9;0;1;10
20037;Volungė;Pelėdžiukai;1158253769;Ne;5;0;1;6
20038;Volungė;Pelėdžiukai;3632828615;Taip;0;0;3;3
20039;Volungė;Drugeliai;2111319986;Taip;0;1;0;1
20040;Volungė;Drugeliai;1742777458;Taip;0;0;3;3
20041;Volungė;Drugeliai;2139675610;Taip;0;4;0;4
20042;Volungė;Drugeliai;1752357091;Taip;0;7;1;8
20043;Volungė;Drugeliai;1974360497;Taip;4;0;3;7
20044;Volungė;Drugeliai;86769531194;Taip;5;1;2;8
20045;Volungė;Drugeliai;86784613109;Taip;0;0;1;1
20046;Volungė;Drugeliai;3803129970;Taip;7;0;0;7
20047;Volungė;Drugeliai;1726933019;Taip;0;1;7;8
20048;Volungė;Drugeliai;1333045175;Ne;0;0;6;6
20049;Volungė;Drugeliai;1900204936;Taip;3;0;0;3
20050;Volungė;Drugeliai;1333755594;Taip;0;0;4;4
20051;Volungė;Drugeliai;1539188909;Taip;0;1;7;8
20052;Volungė;Drugeliai;1731981819;Ne;6;1;0;7
20053;Volungė;Drugeliai;2763686861;Taip;0;0;1;1
20054;Volungė;Drugeliai;19340864795;Taip;0;0;4;4
20055;Volungė;Drugeliai;3155184296;Taip;0;1;9;10
20056;Volungė;Drugeliai;7075466773;Taip;0;0;12;12
20057;Volungė;Drugeliai;1291153830;Taip;0;14;0;14
20058;Volungė;Drugeliai;1167124464;Taip;12;1;3;16
20059;Volungė;"SKRUZDĖLIUKAI ";8174587725;Taip;7;0;4;11
20060;Volungė;"SKRUZDĖLIUKAI ";7521910384;Taip;10;0;0;10
20061;Volungė;"SKRUZDĖLIUKAI ";5240126123;Taip;0;1;0;1
20062;Volungė;"SKRUZDĖLIUKAI ";8268202101;Taip;3;1;0;4
20063;Volungė;"SKRUZDĖLIUKAI ";2566901599;Taip;2;0;3;5
20064;Volungė;"SKRUZDĖLIUKAI ";3215314804;Ne;0;0;3;3
20065;Volungė;"SKRUZDĖLIUKAI ";2420242319;Taip;0;1;4;5
20066;Volungė;"SKRUZDĖLIUKAI ";1120682487;Taip;0;1;5;6
20067;Volungė;"SKRUZDĖLIUKAI ";1366066359;Taip;0;4;1;5
20068;Volungė;"SKRUZDĖLIUKAI ";9068889427;Ne;5;1;2;8
20069;Volungė;"SKRUZDĖLIUKAI ";6565522808;Taip;0;6;0;6
20070;Volungė;"SKRUZDĖLIUKAI ";1225378067;Ne;0;0;2;2
20071;Volungė;"SKRUZDĖLIUKAI ";3356901662;Taip;15;0;2;17
20072;Volungė;"SKRUZDĖLIUKAI ";9082860913;Taip;6;0;4;10
20073;Volungė;"SKRUZDĖLIUKAI ";7973680488;Taip;0;1;0;1
20074;Volungė;"SKRUZDĖLIUKAI ";9629567682;Taip;5;0;2;7
20075;Volungė;"SKRUZDĖLIUKAI ";2187800215;Taip;0;1;0;1
20076;Volungė;"SKRUZDĖLIUKAI ";3814647332;Taip;0;1;2;3
20077;Volungė;"SKRUZDĖLIUKAI ";4123080241;Taip;12;0;0;12
20078;Volungė;Zylutės;8905401944;Taip;16;0;0;16
20079;Volungė;Zylutės;2530804242;Taip;4;0;2;6
20080;Volungė;Zylutės;2686827560;Taip;12;0;0;12
20081;Volungė;Zylutės;9973604148;Taip;5;0;0;5
20082;Volungė;Zylutės;6782622442;Ne;4;0;2;6
20083;Volungė;Zylutės;5354511593;Taip;0;6;8;14
20084;Volungė;Zylutės;7574856429;Taip;21;0;0;21
20085;Volungė;Zylutės;9729285419;Taip;0;1;11;12
20086;Volungė;Zylutės;5284011092;Taip;0;0;6;6
20087;Volungė;Zylutės;2981560931;Taip;10;0;2;12
20088;Volungė;Zylutės;4252713086;Taip;0;0;5;5
20089;Volungė;Zylutės;4427076715;Taip;0;0;7;7
20090;Volungė;Zylutės;3020629341;Taip;3;0;3;6
20091;Volungė;Zylutės;1164632050;Taip;10;0;0;10
20092;Giliukas;SMALSUČIAI;1289574961;Taip;0;1;0;1
20093;Giliukas;SMALSUČIAI;1664239181;Taip;0;2;0;2
20094;Giliukas;SMALSUČIAI;9747155435;Taip;0;21;0;21
20095;Giliukas;SMALSUČIAI;2006450088;Ne;1;2;0;3
20096;Giliukas;SMALSUČIAI;89954209937;Taip;0;0;2;2
20097;Giliukas;SMALSUČIAI;40373221046;Taip;0;1;0;1
20098;Giliukas;SMALSUČIAI;9461909264;Taip;4;0;0;4
20099;Giliukas;SMALSUČIAI;8575067944;Ne;15;0;0;15
20100;Giliukas;SMALSUČIAI;1463748654;Taip;0;3;0;3
20101;Giliukas;SMALSUČIAI;45270647252;Taip;0;2;0;2
20102;Giliukas;SMALSUČIAI;26109227683;Taip;0;0;2;2
20103;Giliukas;SMALSUČIAI;1417138570;Taip;0;1;0;1
20104;Giliukas;SMALSUČIAI;4053376466;Ne;14;1;0;15
20105;Giliukas;SMALSUČIAI;1406371374;Ne;2;2;0;4
20106;Giliukas;SMALSUČIAI;34155615138;Ne;0;1;0;1
20107;Giliukas;SMALSUČIAI;10326073797;Taip;0;3;1;4
20108;Giliukas;SMALSUČIAI;7732836522;Taip;5;0;1;6
20109;Giliukas;SMALSUČIAI;5914236976;Taip;21;0;0;21
20110;Giliukas;SMALSUČIAI;9225515816;Taip;0;1;0;1
20111;Giliukas;SMALSUČIAI;6453425490;Taip;15;0;1;16
20112;Giliukas;SMALSUČIAI;1190611675;Ne;0;2;2;4
20113;Giliukas;SMALSUČIAI;14318411597;Taip;0;9;1;10
20114;Giliukas;GUDRUČIAI;2099862126;Taip;0;0;3;3
20115;Giliukas;GUDRUČIAI;51201920656;Taip;1;0;0;1
20116;Giliukas;GUDRUČIAI;2617670085;Ne;0;3;0;3
20117;Giliukas;GUDRUČIAI;1649456516;Taip;10;2;0;12
20118;Giliukas;GUDRUČIAI;1431811346;Taip;1;2;0;3
20119;Giliukas;GUDRUČIAI;76716908362;Taip;1;2;0;3
20120;Giliukas;GUDRUČIAI;1771662094;Taip;0;1;0;1
20121;Giliukas;GUDRUČIAI;1869027087;Taip;4;2;0;6
20122;Giliukas;GUDRUČIAI;4145860286;Taip;0;0;1;1
20123;Giliukas;GUDRUČIAI;7223355423;Taip;8;1;0;9
20124;Giliukas;GUDRUČIAI;1624952768;Ne;0;2;0;2
20125;Giliukas;GUDRUČIAI;84750777858;Taip;6;2;0;8
20126;Giliukas;GUDRUČIAI;1665908531;Taip;0;1;0;1
20127;Giliukas;GUDRUČIAI;76463522285;Taip;0;0;1;1
20128;Giliukas;GUDRUČIAI;1910800137;Taip;3;13;0;16
20129;Giliukas;GUDRUČIAI;9826756136;Taip;0;21;0;21
20130;Giliukas;GUDRUČIAI;1733875411;Taip;0;2;0;2
20131;Giliukas;GUDRUČIAI;8284364049;Taip;0;2;0;2
20132;Giliukas;GUDRUČIAI;80254838594;Taip;0;21;0;21
20133;Giliukas;GUDRUČIAI;4163391813;Taip;0;21;0;21
20134;Giliukas;GUDRUČIAI;50289768374;Taip;0;21;0;21
20135;Giliukas;GUDRUČIAI;6154379463;Taip;0;21;0;21
20136;Giliukas;ŠNEKUČIAI;24030146209;Taip;0;21;0;21
20137;Giliukas;ŠNEKUČIAI;3847358328;Taip;16;1;0;17
20138;Giliukas;ŠNEKUČIAI;1890147760;Taip;0;21;0;21
20139;Giliukas;ŠNEKUČIAI;1469477982;Ne;11;2;1;14
20140;Giliukas;ŠNEKUČIAI;3983555939;Taip;6;2;0;8
20141;Giliukas;ŠNEKUČIAI;7780118692;Taip;4;9;0;13
20142;Giliukas;ŠNEKUČIAI;2951628295;Taip;0;2;0;2
20143;Giliukas;ŠNEKUČIAI;9401247559;Taip;0;2;0;2
20144;Giliukas;ŠNEKUČIAI;5994213515;Taip;0;21;0;21
20145;Giliukas;ŠNEKUČIAI;4916844983;Taip;0;1;0;1
20146;Giliukas;ŠNEKUČIAI;5787041097;Taip;18;0;0;18
20147;Giliukas;ŠNEKUČIAI;4987348316;Taip;4;3;2;9
20148;Giliukas;ŠNEKUČIAI;7159681896;Taip;0;5;0;5
20149;Giliukas;ŠNEKUČIAI;7540576615;Taip;0;21;0;21
20150;Giliukas;ŠNEKUČIAI;7386694567;Taip;0;21;0;21
20151;Giliukas;ŠNEKUČIAI;1734336095;Taip;0;21;0;21
20152;Giliukas;PABIRUČIAI;6469454991;Taip;0;21;0;21
20153;Giliukas;PABIRUČIAI;8267507304;Ne;6;6;0;12
20154;Giliukas;PABIRUČIAI;4854370266;Taip;5;3;0;8
20155;Giliukas;PABIRUČIAI;9608331265;Taip;0;3;0;3
20156;Giliukas;PABIRUČIAI;1870173947;Taip;6;0;5;11
20157;Giliukas;PABIRUČIAI;9644050818;Taip;0;3;2;5
20158;Giliukas;PABIRUČIAI;3150981084;Taip;14;1;0;15
20159;Giliukas;PABIRUČIAI;3137768675;Taip;7;1;1;9
20160;Giliukas;PABIRUČIAI;5816317197;Taip;9;2;0;11
20161;Giliukas;PABIRUČIAI;9408948207;Taip;6;1;0;7
20162;Giliukas;PABIRUČIAI;2003990493;Taip;16;0;0;16
20163;Giliukas;PABIRUČIAI;4960232685;Taip;8;0;2;10
20164;Giliukas;PABIRUČIAI;6338583515;Taip;0;2;1;3
20165;Giliukas;PABIRUČIAI;9458151965;Taip;0;0;8;8
20166;Giliukas;PABIRUČIAI;6703080106;Taip;12;1;0;13
20167;Giliukas;PABIRUČIAI;4912872957;Taip;0;21;0;21
20168;Giliukas;PABIRUČIAI;8502974441;Taip;0;21;0;21
20169;"Lazdynų mokykla";Drugeliai;10453975773;Taip;0;11;0;11
20170;"Lazdynų mokykla";Drugeliai;93091209041;Taip;15;1;0;16
20171;"Lazdynų mokykla";Drugeliai;89878430155;Taip;0;1;0;1
20172;"Lazdynų mokykla";Drugeliai;1117304239;Taip;0;3;3;6
20173;"Lazdynų mokykla";Drugeliai;2079967590;Taip;2;0;0;2
20174;"Lazdynų mokykla";Drugeliai;6209271043;Taip;0;3;4;7
20175;"Lazdynų mokykla";Drugeliai;7154882168;Taip;0;21;0;21
20176;"Lazdynų mokykla";Drugeliai;28132502877;Taip;9;0;0;9
20177;"Lazdynų mokykla";Drugeliai;6835150864;Ne;0;6;0;6
20178;"Lazdynų mokykla";Drugeliai;9449948668;Taip;0;8;0;8
20179;"Lazdynų mokykla";Drugeliai;4520091712;Taip;9;0;1;10
20180;"Lazdynų mokykla";Drugeliai;1177208864;Ne;21;0;0;21
20181;"Lazdynų mokykla";Drugeliai;8472834181;Taip;4;0;0;4
20182;"Lazdynų mokykla";Drugeliai;9196184984;Taip;11;0;0;11
20183;"Lazdynų mokykla";Drugeliai;2469486746;Taip;13;0;0;13
20184;"Lazdynų mokykla";Drugeliai;6394098306;Taip;9;0;3;12
20185;"Lazdynų mokykla";Drugeliai;5982024698;Taip;5;0;0;5
20186;"Lazdynų mokykla";Drugeliai;2027751624;Taip;0;0;1;1
20187;"Lazdynų mokykla";Zuikučiai;1065999533;Ne;7;1;0;8
20188;"Lazdynų mokykla";Zuikučiai;5613360688;Ne;8;0;0;8
20189;"Lazdynų mokykla";Zuikučiai;40995112936;Taip;13;1;0;14
20190;"Lazdynų mokykla";Zuikučiai;9591838054;Taip;0;7;0;7
20191;"Lazdynų mokykla";Zuikučiai;8847547438;Ne;6;1;0;7
20192;"Lazdynų mokykla";Zuikučiai;6615724604;Taip;2;1;0;3
20193;"Lazdynų mokykla";Zuikučiai;9386629495;Taip;11;0;0;11
20194;"Lazdynų mokykla";Zuikučiai;1817040419;Taip;0;2;0;2
20195;"Lazdynų mokykla";Zuikučiai;1910670134;Ne;0;7;0;7
20196;"Lazdynų mokykla";Zuikučiai;25106446270;Ne;5;4;0;9
20197;"Lazdynų mokykla";Zuikučiai;9123178095;Taip;0;11;0;11
20198;"Lazdynų mokykla";Zuikučiai;8152577445;Ne;10;0;0;10
20199;"Lazdynų mokykla";Zuikučiai;6848743350;Taip;2;8;0;10
20200;"Lazdynų mokykla";Zuikučiai;1365362641;Taip;4;0;0;4
20201;"Lazdynų mokykla";Zuikučiai;3435025978;Taip;1;0;7;8
20202;"Lazdynų mokykla";Zuikučiai;7549389699;Ne;6;1;0;7
20203;"Lazdynų mokykla";Zuikučiai;8899186547;Taip;15;0;1;16
20204;"Lazdynų mokykla";Zuikučiai;5465094647;Taip;8;0;0;8
20205;"Lazdynų mokykla";Zuikučiai;1044630813;Taip;0;5;0;5
20206;"Lazdynų mokykla";RUPG;8280802645;Taip;7;1;1;9
20207;"Lazdynų mokykla";RUPG;2495494392;Taip;0;21;0;21
20208;"Lazdynų mokykla";RUPG;14092687895;Taip;0;1;0;1
20209;"Lazdynų mokykla";RUPG;11571302488;Taip;7;1;4;12
20210;"Lazdynų mokykla";RUPG;83425301719;Taip;0;1;0;1
20211;"Lazdynų mokykla";RUPG;7809088591;Ne;7;1;0;8
20212;"Lazdynų mokykla";RUPG;1558843252;Taip;0;1;1;2
20213;"Lazdynų mokykla";RUPG;53011933771;Taip;0;2;0;2
20214;"Lazdynų mokykla";RUPG;5286305468;Ne;0;4;0;4
20215;"Lazdynų mokykla";RUPG;7639418071;Ne;0;1;0;1
20216;"Lazdynų mokykla";RUPG;10051044012;Taip;0;1;1;2
20217;"Lazdynų mokykla";RUPG;83174865018;Taip;3;1;0;4
20218;"Lazdynų mokykla";RUPG;3746366243;Taip;18;0;0;18
20219;"Lazdynų mokykla";RUPG;59028339197;Taip;8;1;0;9
20220;"Lazdynų mokykla";RUPG;13284428796;Taip;7;1;0;8
20221;"Lazdynų mokykla";RUPG;2054450461;Taip;3;1;0;4
20222;"Lazdynų mokykla";RUPG;9380814933;Taip;8;1;3;12
20223;"Lazdynų mokykla";RUPG;1837465174;Taip;0;7;0;7
20224;"Lazdynų mokykla";PG;6813765251;Taip;10;1;0;11
20225;"Lazdynų mokykla";PG;6453272974;Taip;0;5;0;5
20226;"Lazdynų mokykla";PG;1602013811;Taip;0;4;0;4
20227;"Lazdynų mokykla";PG;38094866639;Taip;5;1;0;6
20228;"Lazdynų mokykla";PG;58679808617;Ne;0;1;0;1
20229;"Lazdynų mokykla";PG;3349776899;Taip;0;3;0;3
20230;"Lazdynų mokykla";PG;5039060603;Taip;6;1;0;7
20231;"Lazdynų mokykla";PG;5357769446;Taip;0;3;0;3
20232;"Lazdynų mokykla";PG;7276376278;Taip;8;1;1;10
20233;"„Atžalyno” mokykla-darželis";Giliukai;40936892543;Taip;0;1;0;1
20234;"„Atžalyno” mokykla-darželis";Giliukai;1426814743;Taip;0;1;5;6
20235;"„Atžalyno” mokykla-darželis";Giliukai;7699590933;Taip;0;1;0;1
20236;"„Atžalyno” mokykla-darželis";Giliukai;17672482867;Taip;0;1;2;3
20237;"„Atžalyno” mokykla-darželis";Giliukai;9038892388;Taip;0;1;0;1
20238;"„Atžalyno” mokykla-darželis";Giliukai;4537410041;Taip;0;1;2;3
20239;"„Atžalyno” mokykla-darželis";Giliukai;1233812908;Ne;0;1;13;14
20240;"„Atžalyno” mokykla-darželis";Giliukai;91701621174;Taip;0;1;4;5
20241;"„Atžalyno” mokykla-darželis";Giliukai;98404616387;Taip;0;1;1;2
20242;"„Atžalyno” mokykla-darželis";Giliukai;1267427191;Taip;0;1;11;12
20243;"„Atžalyno” mokykla-darželis";Giliukai;42069870710;Taip;0;1;0;1
20244;"„Atžalyno” mokykla-darželis";Giliukai;28021807339;Taip;0;1;0;1
20245;"„Atžalyno” mokykla-darželis";Giliukai;67652620656;Taip;0;1;1;2
20246;"„Atžalyno” mokykla-darželis";Giliukai;1275007023;Taip;0;0;4;4
20247;"„Atžalyno” mokykla-darželis";Giliukai;17110908746;Taip;0;1;5;6
20248;"„Atžalyno” mokykla-darželis";Giliukai;96867169512;Taip;0;1;0;1
20249;"„Atžalyno” mokykla-darželis";Giliukai;1481021352;Taip;14;0;0;14
20250;"„Atžalyno” mokykla-darželis";Giliukai;94908008744;Taip;1;1;0;2
20251;"„Atžalyno” mokykla-darželis";Giliukai;1997515382;Ne;0;1;8;9
20252;"„Atžalyno” mokykla-darželis";Giliukai;8806492917;Taip;6;1;1;8
20253;"„Atžalyno” mokykla-darželis";Giliukai;8495976081;Ne;0;1;0;1
20254;"„Atžalyno” mokykla-darželis";Giliukai;77204026281;Taip;0;1;3;4
20255;"„Atžalyno” mokykla-darželis";Giliukai;1342370096;Taip;0;1;4;5
20256;"„Atžalyno” mokykla-darželis";Giliukai;3943563359;Taip;11;1;1;13
20257;"„Atžalyno” mokykla-darželis";Riešutėliai;4784990018;Taip;0;10;0;10
20258;"„Atžalyno” mokykla-darželis";Riešutėliai;4345420422;Taip;15;0;1;16
20259;"„Atžalyno” mokykla-darželis";Riešutėliai;71840666522;Taip;0;10;0;10
20260;"„Atžalyno” mokykla-darželis";Riešutėliai;4290226052;Ne;13;1;1;15
20261;"„Atžalyno” mokykla-darželis";Riešutėliai;4422345256;Taip;0;0;1;1
20262;"„Atžalyno” mokykla-darželis";Riešutėliai;5596753512;Ne;5;1;1;7
20263;"„Atžalyno” mokykla-darželis";Riešutėliai;9806203065;Taip;12;0;0;12
20264;"„Atžalyno” mokykla-darželis";Riešutėliai;4832534190;Ne;7;0;0;7
20265;"„Atžalyno” mokykla-darželis";Riešutėliai;1151879281;Ne;0;1;12;13
20266;"„Atžalyno” mokykla-darželis";Riešutėliai;8008000299;Taip;0;0;4;4
20267;"„Atžalyno” mokykla-darželis";Riešutėliai;9215658103;Taip;0;0;1;1
20268;"„Atžalyno” mokykla-darželis";Riešutėliai;3484401937;Taip;0;0;7;7
20269;"„Atžalyno” mokykla-darželis";Riešutėliai;7652421432;Taip;0;0;1;1
20270;"„Atžalyno” mokykla-darželis";Riešutėliai;2002555659;Taip;7;0;2;9
20271;"„Atžalyno” mokykla-darželis";Riešutėliai;37897965773;Taip;0;0;3;3
20272;"„Atžalyno” mokykla-darželis";Riešutėliai;8254801574;Taip;0;0;3;3
20273;"„Atžalyno” mokykla-darželis";Riešutėliai;9013323901;Taip;12;2;1;15
20274;"„Atžalyno” mokykla-darželis";Riešutėliai;3529875728;Taip;0;0;1;1
20275;"„Atžalyno” mokykla-darželis";Žirniukai;6903825217;Taip;7;2;0;9
20276;"„Atžalyno” mokykla-darželis";Žirniukai;9101301819;Taip;12;1;0;13
20277;"„Atžalyno” mokykla-darželis";Žirniukai;6602037942;Taip;0;0;1;1
20278;"„Atžalyno” mokykla-darželis";Žirniukai;7579781779;Taip;17;0;0;17
20279;"„Atžalyno” mokykla-darželis";Žirniukai;1915676392;Ne;10;0;0;10
20280;"„Atžalyno” mokykla-darželis";Žirniukai;7669725276;Taip;10;0;2;12
20281;"„Atžalyno” mokykla-darželis";Žirniukai;5986664970;Taip;18;0;0;18
20282;"„Atžalyno” mokykla-darželis";Žirniukai;9913048992;Taip;11;2;0;13
20283;"„Atžalyno” mokykla-darželis";Žirniukai;4616870552;Taip;0;0;2;2
20284;"„Atžalyno” mokykla-darželis";Žirniukai;4107946143;Taip;7;0;1;8
20285;"„Atžalyno” mokykla-darželis";Žirniukai;7883570492;Ne;7;0;0;7
20286;"„Atžalyno” mokykla-darželis";Žirniukai;7502911642;Taip;15;0;0;15
20287;"„Atžalyno” mokykla-darželis";Žirniukai;8320161812;Taip;1;0;0;1
20288;"„Atžalyno” mokykla-darželis";Žirniukai;5335059675;Taip;8;1;1;10
20289;"„Atžalyno” mokykla-darželis";Žirniukai;1766599777;Taip;3;8;3;14
20290;"„Atžalyno” mokykla-darželis";Žirniukai;6922776405;Ne;12;0;0;12
20291;"„Atžalyno” mokykla-darželis";Žirniukai;9690554753;Taip;21;0;0;21
20292;"„Atžalyno” mokykla-darželis";Žirniukai;1961428224;Ne;11;0;0;11
20293;"Vilniaus Emilijos Pliaterytės progimnazija";PELĖDŽIUKAI;1475766630;Taip;17;2;0;19
20294;"Vilniaus Emilijos Pliaterytės progimnazija";PELĖDŽIUKAI;6025990670;Taip;5;0;0;5
20295;"Vilniaus Emilijos Pliaterytės progimnazija";PELĖDŽIUKAI;1758561647;Taip;12;1;0;13
20296;"Vilniaus Emilijos Pliaterytės progimnazija";PELĖDŽIUKAI;1551926849;Taip;5;0;0;5
20297;"Vilniaus Emilijos Pliaterytės progimnazija";PELĖDŽIUKAI;9980215936;Ne;0;2;0;2
20298;"Vilniaus Emilijos Pliaterytės progimnazija";PELĖDŽIUKAI;6406833864;Taip;0;10;2;12
20299;"Vilniaus Emilijos Pliaterytės progimnazija";PELĖDŽIUKAI;2450382256;Taip;0;1;0;1
20300;"Vilniaus Emilijos Pliaterytės progimnazija";PELĖDŽIUKAI;7540156488;Taip;9;4;0;13
20301;"Vilniaus Emilijos Pliaterytės progimnazija";PELĖDŽIUKAI;4146983741;Taip;3;2;0;5
20302;"Vilniaus Emilijos Pliaterytės progimnazija";PELĖDŽIUKAI;9886869275;Taip;0;1;4;5
20303;"Vilniaus Emilijos Pliaterytės progimnazija";PELĖDŽIUKAI;8202177756;Taip;4;1;0;5
20304;"Vilniaus Emilijos Pliaterytės progimnazija";PELĖDŽIUKAI;96590022188;Taip;0;3;0;3
20305;"Vilniaus Emilijos Pliaterytės progimnazija";PELĖDŽIUKAI;15309143797;Taip;0;1;0;1
20306;"Vilniaus Emilijos Pliaterytės progimnazija";PELĖDŽIUKAI;63585262568;Taip;0;0;5;5
20307;"Vilniaus Emilijos Pliaterytės progimnazija";PELĖDŽIUKAI;1653793823;Taip;5;3;0;8
20308;"Vilniaus Emilijos Pliaterytės progimnazija";BITUTĖS;68989648581;Taip;5;3;3;11
20309;"Vilniaus Emilijos Pliaterytės progimnazija";BITUTĖS;8848135087;Taip;0;6;0;6
20310;"Vilniaus Emilijos Pliaterytės progimnazija";BITUTĖS;49658335428;Taip;0;7;0;7
20311;"Vilniaus Emilijos Pliaterytės progimnazija";BITUTĖS;18253351529;Taip;0;7;0;7
20312;"Vilniaus Emilijos Pliaterytės progimnazija";BITUTĖS;40082135876;Taip;0;1;2;3
20313;"Vilniaus Emilijos Pliaterytės progimnazija";BITUTĖS;57217727711;Taip;5;0;0;5
20314;"Vilniaus Emilijos Pliaterytės progimnazija";BITUTĖS;57461575212;Taip;0;1;0;1
20315;"Vilniaus Emilijos Pliaterytės progimnazija";BITUTĖS;3419150668;Ne;0;1;0;1
20316;"Vilniaus Emilijos Pliaterytės progimnazija";BITUTĖS;9371122369;Taip;0;0;3;3
20317;"Vilniaus Emilijos Pliaterytės progimnazija";BITUTĖS;4680059512;Taip;0;9;2;11
20318;"Vilniaus Emilijos Pliaterytės progimnazija";BITUTĖS;3608072547;Taip;0;1;0;1
20319;"Vilniaus Emilijos Pliaterytės progimnazija";BITUTĖS;8303408604;Taip;0;13;0;13
20320;"Vilniaus Emilijos Pliaterytės progimnazija";BITUTĖS;1082350468;Taip;4;1;0;5
20321;"Vilniaus Emilijos Pliaterytės progimnazija";BITUTĖS;3431209621;Ne;0;1;0;1
20322;"Vilniaus Emilijos Pliaterytės progimnazija";BITUTĖS;2519294942;Taip;0;1;3;4
20323;"Vilniaus Emilijos Pliaterytės progimnazija";BITUTĖS;2188905055;Taip;0;3;1;4
20324;"Vilniaus Karaliaus Mindaugo pagrindinė mokykla";"PUG 3";1860540266;Taip;0;0;11;11
20325;"Vilniaus Karaliaus Mindaugo pagrindinė mokykla";"PUG 3";9555191234;Taip;0;0;11;11
20326;"Vilniaus Karaliaus Mindaugo pagrindinė mokykla";"PUG 3";9136681731;Taip;0;0;2;2
20327;"Vilniaus Karaliaus Mindaugo pagrindinė mokykla";"PUG 3";3680257542;Ne;0;0;8;8
20328;"Vilniaus Karaliaus Mindaugo pagrindinė mokykla";"PUG 3";1257750782;Taip;0;1;1;2
20329;"Vilniaus Karaliaus Mindaugo pagrindinė mokykla";"PUG 3";1401502095;Ne;4;0;6;10
20330;"Vilniaus Karaliaus Mindaugo pagrindinė mokykla";"PUG 3";65541524010;Taip;6;1;0;7
20331;"Vilniaus Karaliaus Mindaugo pagrindinė mokykla";"PUG 3";61864833085;Taip;5;0;0;5
20332;"Vilniaus Karaliaus Mindaugo pagrindinė mokykla";"PUG 3";1823039323;Taip;0;0;2;2
20333;"Vilniaus Karaliaus Mindaugo pagrindinė mokykla";"PUG 3";1969208564;Taip;10;0;0;10
20334;"Vilniaus Karaliaus Mindaugo pagrindinė mokykla";"PUG 3";3447871828;Taip;0;1;0;1
20335;"Vilniaus Karaliaus Mindaugo pagrindinė mokykla";"PUG 3";7596203918;Taip;5;0;0;5
20336;"Vilniaus Karaliaus Mindaugo pagrindinė mokykla";"PUG 3";45774870210;Taip;0;2;0;2
20337;"Vilniaus Karaliaus Mindaugo pagrindinė mokykla";"PUG 3";10083948781;Taip;0;1;0;1
20338;"Vilniaus Karaliaus Mindaugo pagrindinė mokykla";"PUG 2";2027114365;Taip;5;0;1;6
20339;"Vilniaus Karaliaus Mindaugo pagrindinė mokykla";"PUG 2";2787942076;Taip;0;0;2;2
20340;"Vilniaus Karaliaus Mindaugo pagrindinė mokykla";"PUG 2";39088931809;Taip;0;0;1;1
20341;"Vilniaus Karaliaus Mindaugo pagrindinė mokykla";"PUG 2";1812197417;Ne;0;0;1;1
20342;"Vilniaus Karaliaus Mindaugo pagrindinė mokykla";"PUG 2";46282997811;Taip;0;0;1;1
20343;"Vilniaus Karaliaus Mindaugo pagrindinė mokykla";"PUG 2";41323355319;Taip;0;0;3;3
20344;"Vilniaus Karaliaus Mindaugo pagrindinė mokykla";"PUG 2";7641286244;Taip;0;1;2;3
20345;"Vilniaus Karaliaus Mindaugo pagrindinė mokykla";"PUG 2";1245722149;Taip;0;0;10;10
20346;"Vilniaus Karaliaus Mindaugo pagrindinė mokykla";"PUG 2";7259413060;Taip;0;0;15;15
20347;"Vilniaus Karaliaus Mindaugo pagrindinė mokykla";"PUG 2";13211267463;Taip;0;2;6;8
20348;"Vilniaus Karaliaus Mindaugo pagrindinė mokykla";"PUG 2";8452554061;Taip;0;1;2;3
20349;"Vilniaus Karaliaus Mindaugo pagrindinė mokykla";"PUG 2";21847996888;Taip;0;1;1;2
20350;"Vilniaus Karaliaus Mindaugo pagrindinė mokykla";"PUG 2";32806315077;Taip;0;0;1;1
20351;"Vilniaus Karaliaus Mindaugo pagrindinė mokykla";"PUG 2";48069555680;Taip;0;1;6;7
20352;"Vilniaus Karaliaus Mindaugo pagrindinė mokykla";"PUG 2";55747365118;Taip;12;0;1;13
20353;"Vilniaus Karaliaus Mindaugo pagrindinė mokykla";"PUG 1";5049742406;Ne;0;0;1;1
20354;"Vilniaus Karaliaus Mindaugo pagrindinė mokykla";"PUG 1";56814748796;Taip;15;0;1;16
20355;"Vilniaus Karaliaus Mindaugo pagrindinė mokykla";"PUG 1";14054918119;Ne;0;2;0;2
20356;"Vilniaus Karaliaus Mindaugo pagrindinė mokykla";"PUG 1";152363521;Taip;7;8;0;15
20357;"Vilniaus Karaliaus Mindaugo pagrindinė mokykla";"PUG 1";18443760034;Taip;0;0;1;1
20358;"Vilniaus Karaliaus Mindaugo pagrindinė mokykla";"PUG 1";61301531283;Taip;11;1;0;12
20359;"Vilniaus Karaliaus Mindaugo pagrindinė mokykla";"PUG 1";5052576808;Taip;0;1;0;1
20360;"Vilniaus Karaliaus Mindaugo pagrindinė mokykla";"PUG 1";7561608160;Taip;0;1;0;1
20361;"Vilniaus Karaliaus Mindaugo pagrindinė mokykla";"PUG 1";8567961973;Taip;0;1;0;1
20362;"Vilniaus Karaliaus Mindaugo pagrindinė mokykla";"PUG 1";3468743460;Taip;0;1;14;15
20363;"Vilniaus Karaliaus Mindaugo pagrindinė mokykla";"PUG 1";1934113564;Ne;0;8;1;9
20364;"Vilniaus Karaliaus Mindaugo pagrindinė mokykla";"PUG 1";1967327730;Taip;5;4;10;19
20365;"Vilniaus Karaliaus Mindaugo pagrindinė mokykla";"PUG 1";1417730062;Taip;5;4;10;19
20366;"Vilniaus Karaliaus Mindaugo pagrindinė mokykla";"PUG 1";7798858993;Taip;0;0;2;2
20367;"Vilniaus Karaliaus Mindaugo pagrindinė mokykla";"PUG 1";93604802567;Taip;0;0;1;1
20368;"Vilniaus Karaliaus Mindaugo pagrindinė mokykla";"PUG 1";2026314698;Taip;13;0;3;16
20369;"Vilniaus Baltupių progimnazija";Kodėlčiukai;61434205619;Taip;0;2;0;2
20370;"Vilniaus Baltupių progimnazija";Kodėlčiukai;1423766054;Taip;0;0;3;3
20371;"Vilniaus Baltupių progimnazija";Kodėlčiukai;6565950314;Taip;0;0;2;2
20372;"Vilniaus Baltupių progimnazija";Kodėlčiukai;9512110089;Taip;5;1;1;7
20373;"Vilniaus Baltupių progimnazija";Kodėlčiukai;5693741068;Ne;6;0;2;8
20374;"Vilniaus Baltupių progimnazija";Kodėlčiukai;1435972746;Taip;0;2;0;2
20375;"Vilniaus Baltupių progimnazija";Kodėlčiukai;1756560941;Taip;0;1;2;3
20376;"Vilniaus Baltupių progimnazija";Kodėlčiukai;23183915482;Taip;6;1;1;8
20377;"Vilniaus Baltupių progimnazija";Kodėlčiukai;77960723329;Taip;0;0;1;1
20378;"Vilniaus Baltupių progimnazija";Kodėlčiukai;1766518710;Taip;5;10;0;15
20379;"Vilniaus Baltupių progimnazija";Kodėlčiukai;3127742267;Taip;5;1;0;6
20380;"Vilniaus Baltupių progimnazija";Kodėlčiukai;61072571858;Taip;8;1;0;9
20381;"Vilniaus Baltupių progimnazija";Kodėlčiukai;285754903;Taip;8;1;0;9
20382;"Vilniaus Baltupių progimnazija";Kodėlčiukai;82893485399;Taip;4;1;0;5
20383;"Vilniaus Baltupių progimnazija";Kodėlčiukai;60386582602;Taip;0;1;3;4
20384;"Vilniaus Baltupių progimnazija";Kodėlčiukai;4674740550;Taip;0;1;2;3
20385;"Vilniaus Baltupių progimnazija";Kodėlčiukai;59444737813;Taip;0;6;0;6
20386;"Vilniaus Baltupių progimnazija";Kodėlčiukai;12162032447;Taip;10;1;0;11
20387;"Vilniaus Baltupių progimnazija";Kodėlčiukai;40376432941;Taip;5;7;0;12
20388;"Vilniaus Baltupių progimnazija";Smalsučiai;74116167225;Taip;0;1;4;5
20389;"Vilniaus Baltupių progimnazija";Smalsučiai;41950550071;Ne;0;1;0;1
20390;"Vilniaus Baltupių progimnazija";Smalsučiai;43183534908;Taip;0;1;1;2
20391;"Vilniaus Baltupių progimnazija";Smalsučiai;2027225055;Taip;8;0;1;9
20392;"Vilniaus Baltupių progimnazija";Smalsučiai;28510314765;Taip;0;1;1;2
20393;"Vilniaus Baltupių progimnazija";Smalsučiai;6541323688;Taip;0;1;0;1
20394;"Vilniaus Baltupių progimnazija";Smalsučiai;51805829511;Taip;0;1;3;4
20395;"Vilniaus Baltupių progimnazija";Smalsučiai;4071266695;Taip;11;0;1;12
20396;"Vilniaus Baltupių progimnazija";Smalsučiai;62371949439;Ne;0;1;0;1
20397;"Vilniaus Baltupių progimnazija";Smalsučiai;484847222;Taip;0;1;0;1
20398;"Vilniaus Baltupių progimnazija";Smalsučiai;96812991513;Taip;5;1;0;6
20399;"Vilniaus Baltupių progimnazija";Smalsučiai;61360761151;Taip;0;1;1;2
20400;"Vilniaus Baltupių progimnazija";Smalsučiai;85813209902;Taip;0;1;0;1
20401;"Vilniaus Baltupių progimnazija";Smalsučiai;3100442808;Taip;0;3;0;3
20402;"Vilniaus Baltupių progimnazija";Smalsučiai;51243218101;Taip;0;1;2;3
20403;"Vilniaus Baltupių progimnazija";Smalsučiai;2464612365;Ne;5;0;0;5
20404;"Vilniaus Baltupių progimnazija";Smalsučiai;6452806962;Taip;5;1;0;6
20405;"Vilniaus Levo Karsavino vidurinė mokykla";"Priešmokyklinukai A";6379177542;Taip;0;1;0;1
20406;"Vilniaus Levo Karsavino vidurinė mokykla";"Priešmokyklinukai A";1840757726;Taip;15;1;0;16
20407;"Vilniaus Levo Karsavino vidurinė mokykla";"Priešmokyklinukai A";36362624522;Taip;6;1;3;10
20408;"Vilniaus Levo Karsavino vidurinė mokykla";"Priešmokyklinukai A";60768660940;Taip;0;8;0;8
20409;"Vilniaus Levo Karsavino vidurinė mokykla";"Priešmokyklinukai A";9756832600;Taip;0;3;0;3
20410;"Vilniaus Levo Karsavino vidurinė mokykla";"Priešmokyklinukai A";6965021762;Taip;0;3;0;3
20411;"Vilniaus Levo Karsavino vidurinė mokykla";"Priešmokyklinukai A";71494345484;Taip;0;3;0;3
20412;"Vilniaus Levo Karsavino vidurinė mokykla";"Priešmokyklinukai A";1035415228;Taip;0;3;0;3
20413;"Vilniaus Levo Karsavino vidurinė mokykla";"Priešmokyklinukai A";26012978171;Taip;7;1;2;10
20414;"Vilniaus Levo Karsavino vidurinė mokykla";"Priešmokyklinukai A";24566804095;Taip;0;6;0;6
20415;"Vilniaus Levo Karsavino vidurinė mokykla";"Priešmokyklinukai A";27116746304;Taip;0;1;2;3
20416;"Vilniaus Levo Karsavino vidurinė mokykla";"Priešmokyklinukai A";86343860903;Taip;0;1;6;7
20417;"Vilniaus Levo Karsavino vidurinė mokykla";"Priešmokyklinukai A";11546608192;Taip;0;1;2;3
20418;"Vilniaus Levo Karsavino vidurinė mokykla";"Priešmokyklinukai A";3847912854;Taip;0;1;7;8
20419;"Vilniaus Levo Karsavino vidurinė mokykla";"Priešmokyklinukai A";5332069480;Taip;13;0;0;13
20420;"Vilniaus Levo Karsavino vidurinė mokykla";"Priešmokyklinukai A";1620139958;Taip;0;11;0;11
20421;"Vilniaus Levo Karsavino vidurinė mokykla";"Priešmokyklinukai A";1356029457;Taip;7;1;0;8
20422;"Vilniaus Levo Karsavino vidurinė mokykla";"Priešmokyklinukai A";89044270439;Taip;10;1;0;11
20423;"Vilniaus Levo Karsavino vidurinė mokykla";"Priešmokyklinukai A";8870341896;Taip;0;1;4;5
20424;"Vilniaus Liepkalnio Pagrindinė Mokykla";Bitutės;1181500775;Taip;0;1;1;2
20425;"Vilniaus Liepkalnio Pagrindinė Mokykla";Bitutės;5028304472;Taip;0;1;1;2
20426;"Vilniaus Liepkalnio Pagrindinė Mokykla";Bitutės;3784549444;Taip;0;1;0;1
20427;"Vilniaus Liepkalnio Pagrindinė Mokykla";Bitutės;73391370015;Taip;0;1;1;2
20428;"Vilniaus Liepkalnio Pagrindinė Mokykla";Bitutės;8550048533;Ne;0;1;4;5
20429;"Vilniaus Liepkalnio Pagrindinė Mokykla";Bitutės;1614647892;Taip;0;1;1;2
20430;"Vilniaus Liepkalnio Pagrindinė Mokykla";Bitutės;1886141947;Taip;0;1;3;4
20431;"Vilniaus Liepkalnio Pagrindinė Mokykla";Bitutės;8372336161;Ne;9;1;2;12
20432;"Vilniaus Liepkalnio Pagrindinė Mokykla";Bitutės;1141466643;Taip;0;1;0;1
20433;"Vilniaus Pranciškaus Skorinos gimnazija";Saulytė;72376520386;Taip;2;1;4;7
20434;"Vilniaus Pranciškaus Skorinos gimnazija";Saulytė;6268191102;Ne;12;1;0;13
20435;"Vilniaus Pranciškaus Skorinos gimnazija";Saulytė;9902282505;Taip;11;0;0;11
20436;"Vilniaus Pranciškaus Skorinos gimnazija";Saulytė;3374669528;Taip;0;1;1;2
20437;"Vilniaus Pranciškaus Skorinos gimnazija";Saulytė;2214122633;Taip;0;2;0;2
20438;"Vilniaus Pranciškaus Skorinos gimnazija";Saulytė;48454225305;Taip;0;1;1;2
20439;"Vilniaus Pranciškaus Skorinos gimnazija";Saulytė;77518622497;Taip;11;2;0;13
20440;"Vilniaus Pranciškaus Skorinos gimnazija";Saulytė;69884900143;Taip;12;1;1;14
20441;"Vilniaus Pranciškaus Skorinos gimnazija";Saulytė;10188975432;Taip;0;3;0;3
20442;"Vilniaus Pranciškaus Skorinos gimnazija";Saulytė;1326855282;Taip;11;1;0;12
20443;"Vilniaus Pranciškaus Skorinos gimnazija";Saulytė;8996622650;Ne;1;1;5;7
20444;"Vilniaus Pranciškaus Skorinos gimnazija";Saulytė;1332354208;Taip;4;1;0;5
20445;"Vilniaus Pranciškaus Skorinos gimnazija";Saulytė;78048289126;Taip;2;1;0;3
20446;"Vilniaus Pranciškaus Skorinos gimnazija";Saulytė;2135571148;Ne;0;2;1;3
20447;"Vilniaus Pranciškaus Skorinos gimnazija";Saulytė;1098174103;Taip;0;4;0;4
20448;"Vilniaus Pranciškaus Skorinos gimnazija";Saulytė;3697024369;Taip;0;1;1;2
20449;"Vilniaus Pranciškaus Skorinos gimnazija";Saulytė;2034261990;Taip;0;1;0;1
20450;"Vilniaus Pranciškaus Skorinos gimnazija";Saulytė;91720422401;Taip;11;1;0;12
20451;"Vilniaus Pranciškaus Skorinos gimnazija";Saulytė;1590889839;Taip;14;1;0;15
20452;"Vilniaus Pranciškaus Skorinos gimnazija";Saulytė;8198614500;Taip;0;1;3;4
20453;"Vilniaus Pranciškaus Skorinos gimnazija";Saulytė;8585340012;Ne;3;1;0;4
20454;"Vilniaus Simono Konarskio vidurinės mokykla";"1 gr.";4600958567;Taip;0;1;0;1
20455;"Vilniaus Simono Konarskio vidurinės mokykla";"1 gr.";5738026683;Taip;2;1;0;3
20456;"Vilniaus Simono Konarskio vidurinės mokykla";"1 gr.";24072345175;Taip;0;1;0;1
20457;"Vilniaus Simono Konarskio vidurinės mokykla";"1 gr.";2749669816;Taip;8;1;0;9
20458;"Vilniaus Simono Konarskio vidurinės mokykla";"1 gr.";51558463647;Taip;0;1;0;1
20459;"Vilniaus Simono Konarskio vidurinės mokykla";"1 gr.";49643543408;Taip;0;1;0;1
20460;"Vilniaus Simono Konarskio vidurinės mokykla";"1 gr.";93797285418;Ne;5;1;0;6
20461;"Vilniaus Simono Konarskio vidurinės mokykla";"1 gr.";30126718224;Taip;0;1;0;1
20462;"Vilniaus Simono Konarskio vidurinės mokykla";"1 gr.";47729405181;Taip;0;1;0;1
20463;"Vilniaus Simono Konarskio vidurinės mokykla";"1 gr.";88609559814;Taip;0;1;0;1
20464;"Vilniaus Simono Konarskio vidurinės mokykla";"1 gr.";41776089342;Taip;0;1;0;1
20465;"Vilniaus Simono Konarskio vidurinės mokykla";"1 gr.";69882566734;Taip;4;1;0;5
20466;"Vilniaus Simono Konarskio vidurinės mokykla";"1 gr.";7559190407;Taip;6;1;0;7
20467;"Vilniaus Simono Konarskio vidurinės mokykla";"1 gr.";28845494407;Taip;0;1;0;1
20468;"Vilniaus Simono Konarskio vidurinės mokykla";"1 gr.";9585599736;Taip;0;1;0;1
20469;"Vilniaus Simono Konarskio vidurinės mokykla";"1 gr.";2125176999;Ne;0;1;0;1
20470;"Vilniaus Simono Konarskio vidurinės mokykla";"1 gr.";7591001646;Ne;0;1;0;1
20471;"Vilniaus Trakų Vokės gimnazija";Priešmokyklinė;84749146259;Taip;0;1;0;1
20472;"Vilniaus Trakų Vokės gimnazija";Priešmokyklinė;37080835526;Taip;0;5;0;5
20473;"Vilniaus Trakų Vokės gimnazija";Priešmokyklinė;92262591306;Taip;0;2;0;2
20474;"Vilniaus Trakų Vokės gimnazija";Priešmokyklinė;49616069190;Taip;8;2;0;10
20475;"Vilniaus Trakų Vokės gimnazija";Priešmokyklinė;76399539244;Taip;0;0;2;2
20476;"Vilniaus Trakų Vokės gimnazija";Priešmokyklinė;96632696431;Taip;0;0;1;1
20477;"Vilniaus Trakų Vokės gimnazija";Priešmokyklinė;9642375918;Taip;5;1;0;6
20478;"Vilniaus Trakų Vokės gimnazija";Priešmokyklinė;1809637955;Taip;0;1;2;3
20479;"Vilniaus Trakų Vokės gimnazija";Priešmokyklinė;43780546254;Taip;0;1;3;4
20480;"Vilniaus Trakų Vokės gimnazija";Priešmokyklinė;1858168427;Taip;0;7;0;7
20481;"Vilniaus Trakų Vokės gimnazija";Priešmokyklinė;39658854196;Taip;5;1;1;7
20482;"Vilniaus Trakų Vokės gimnazija";Priešmokyklinė;32336388708;Taip;0;9;0;9
20483;"Vilniaus Trakų Vokės gimnazija";Priešmokyklinė;1994808263;Taip;0;1;1;2
20484;"Vilniaus Trakų Vokės gimnazija";Priešmokyklinė;1805549433;Taip;0;1;0;1
20485;"Vilniaus Trakų Vokės gimnazija";Priešmokyklinė;68968521202;Taip;0;1;1;2
20486;"Vilniaus Trakų Vokės gimnazija";Priešmokyklinė;1837766168;Taip;0;3;0;3
20487;"Vilniaus Trakų Vokės gimnazija";Priešmokyklinė;38738283929;Taip;2;0;0;2
20488;"Vilniaus Trakų Vokės gimnazija";Priešmokyklinė;71993634591;Taip;0;1;0;1
20489;"Vilniaus Trakų Vokės gimnazija";Priešmokyklinė;66607811394;Taip;0;1;0;1
20490;"Vilniaus Trakų Vokės gimnazija";Priešmokyklinė;95403241312;Taip;0;0;2;2
20491;"Vilniaus Trakų Vokės gimnazija";"Priešmokyklinė 2";28609993291;Taip;4;1;0;5
20492;"Vilniaus Trakų Vokės gimnazija";"Priešmokyklinė 2";2742109510;Taip;0;5;0;5
20493;"Vilniaus Trakų Vokės gimnazija";"Priešmokyklinė 2";4137954109;Taip;0;1;4;5
20494;"Vilniaus Trakų Vokės gimnazija";"Priešmokyklinė 2";41050699676;Taip;3;1;0;4
20495;"Vilniaus Trakų Vokės gimnazija";"Priešmokyklinė 2";76000339425;Ne;0;1;0;1
20496;"Vilniaus Trakų Vokės gimnazija";"Priešmokyklinė 2";4025564140;Ne;0;1;3;4
20497;"Vilniaus Trakų Vokės gimnazija";"Priešmokyklinė 2";42898142937;Ne;0;1;0;1
20498;"Vilniaus Trakų Vokės gimnazija";"Priešmokyklinė 2";7405750799;Ne;0;16;0;16
20499;"Vilniaus Trakų Vokės gimnazija";"Priešmokyklinė 2";9212173480;Taip;8;0;0;8
20500;"Vilniaus Trakų Vokės gimnazija";"Priešmokyklinė 2";29983824202;Taip;0;1;1;2
20501;"Vilniaus Trakų Vokės gimnazija";"Priešmokyklinė 2";39185053006;Taip;0;4;0;4
20502;"Vilniaus Trakų Vokės gimnazija";"Priešmokyklinė 2";6075862061;Taip;0;7;0;7
20503;"Vilniaus Trakų Vokės gimnazija";"Priešmokyklinė 2";1246702054;Taip;0;1;1;2
20504;"Vilniaus Trakų Vokės gimnazija";"Priešmokyklinė 2";1604147234;Taip;5;1;0;6
20505;"Vilniaus Trakų Vokės gimnazija";"Priešmokyklinė 2";2671842885;Taip;0;1;1;2
20506;"Vilniaus Ryto progimnazija";Pelėdžiukai;8927710614;Taip;0;1;1;2
20507;"Vilniaus Ryto progimnazija";Pelėdžiukai;5003717844;Taip;0;0;1;1
20508;"Vilniaus Ryto progimnazija";Pelėdžiukai;2033804954;Taip;3;2;0;5
20509;"Vilniaus Ryto progimnazija";Pelėdžiukai;88370692635;Taip;3;1;0;4
20510;"Vilniaus Ryto progimnazija";Pelėdžiukai;4459592042;Taip;8;0;1;9
20511;"Vilniaus Ryto progimnazija";Pelėdžiukai;53152433196;Taip;1;0;0;1
20512;"Vilniaus Ryto progimnazija";Pelėdžiukai;4334517915;Taip;0;0;1;1
20513;"Vilniaus Ryto progimnazija";Vyturiukai;79094523868;Taip;0;1;0;1
20514;"Vilniaus Ryto progimnazija";Vyturiukai;98670272543;Taip;0;4;0;4
20515;"Vilniaus Ryto progimnazija";Vyturiukai;5202479867;Taip;5;1;0;6
20516;"Vilniaus Ryto progimnazija";Vyturiukai;1480772531;Taip;0;1;0;1
20517;"Vilniaus Ryto progimnazija";Vyturiukai;35463696785;Taip;7;1;0;8
20518;"Vilniaus Ryto progimnazija";Vyturiukai;11940207202;Taip;0;0;1;1
20519;"Vilniaus Ryto progimnazija";Vyturiukai;22316575729;Taip;0;1;0;1
20520;"Vilniaus Ryto progimnazija";Vyturiukai;8782782031;Taip;0;2;0;2
20521;"Vilniaus Ryto progimnazija";Vyturiukai;5157022077;Taip;0;6;0;6
20522;"Vilniaus Ryto progimnazija";Vyturiukai;1037795359;Taip;0;1;0;1
20523;"Vilniaus Ryto progimnazija";Vyturiukai;24547508796;Ne;7;0;0;7
20524;"Vilniaus Ryto progimnazija";Vyturiukai;24021665703;Taip;9;3;0;12
20525;"Vilniaus Ryto progimnazija";Vyturiukai;7602825079;Taip;9;3;0;12
20526;"Vilniaus Salininkų gimnazija";"Priešmokyklinė A";8897523583;Taip;0;5;0;5
20527;"Vilniaus Salininkų gimnazija";"Priešmokyklinė A";1507178637;Taip;0;5;0;5
20528;"Vilniaus Salininkų gimnazija";"Priešmokyklinė A";7015482971;Taip;0;1;0;1
20529;"Vilniaus Salininkų gimnazija";"Priešmokyklinė A";81713688097;Taip;0;1;0;1
20530;"Vilniaus Salininkų gimnazija";"Priešmokyklinė A";77477857775;Taip;0;1;0;1
20531;"Vilniaus Salininkų gimnazija";"Priešmokyklinė A";93466518815;Taip;0;18;0;18
20532;"Vilniaus Salininkų gimnazija";"Priešmokyklinė A";86262807558;Taip;0;1;2;3
20533;"Vilniaus Salininkų gimnazija";"Priešmokyklinė A";8726140660;Ne;0;1;0;1
20534;"Vilniaus Salininkų gimnazija";"Priešmokyklinė A";1614501473;Taip;0;8;0;8
20535;"Vilniaus Salininkų gimnazija";"Priešmokyklinė A";1489067126;Taip;0;2;0;2
20536;"Vilniaus Salininkų gimnazija";"Priešmokyklinė A";32201000670;Taip;0;1;0;1
20537;"Vilniaus Salininkų gimnazija";"Priešmokyklinė A";75056599725;Taip;0;4;0;4
20538;"Vilniaus Salininkų gimnazija";"Priešmokyklinė A";3263103387;Ne;16;1;0;17
20539;"Vilniaus Salininkų gimnazija";"Priešmokyklinė A";72090235276;Taip;0;1;2;3
20540;"Vilniaus Salininkų gimnazija";"PRIEŠMOKYKLINĖ B";54352547774;Taip;3;1;0;4
20541;"Vilniaus Salininkų gimnazija";"PRIEŠMOKYKLINĖ B";87653480003;Taip;7;1;0;8
20542;"Vilniaus Salininkų gimnazija";"PRIEŠMOKYKLINĖ B";2035304515;Ne;0;21;0;21
20543;"Vilniaus Salininkų gimnazija";"PRIEŠMOKYKLINĖ B";1632485114;Taip;0;21;0;21
20544;"Vilniaus Salininkų gimnazija";"PRIEŠMOKYKLINĖ B";1619190849;Taip;2;1;0;3
20545;"Vilniaus Salininkų gimnazija";"PRIEŠMOKYKLINĖ B";5483806059;Taip;0;21;0;21
20546;"Vilniaus Salininkų gimnazija";"PRIEŠMOKYKLINĖ B";74503311061;Taip;0;1;0;1
20547;"Vilniaus Salininkų gimnazija";"PRIEŠMOKYKLINĖ B";6978618796;Taip;5;1;0;6
20548;"Vilniaus Salininkų gimnazija";"PRIEŠMOKYKLINĖ B";61252066272;Ne;0;21;0;21
20549;"Vilniaus Salininkų gimnazija";"PRIEŠMOKYKLINĖ B";9441176013;Taip;0;21;0;21
20550;"Vilniaus Salininkų gimnazija";"PRIEŠMOKYKLINĖ B";16879258172;Taip;0;21;0;21
20551;"Vilniaus Salininkų gimnazija";"PRIEŠMOKYKLINĖ B";88149790626;Taip;0;1;0;1
20552;"Vilniaus Salininkų gimnazija";"PRIEŠMOKYKLINĖ B";2081621978;Taip;0;21;0;21
20553;"Vilniaus Salininkų gimnazija";"PRIEŠMOKYKLINĖ B";2097313917;Taip;0;1;0;1
20554;"Vilniaus Salininkų gimnazija";"PRIEŠMOKYKLINĖ B";56301286871;Taip;0;21;0;21
20555;"Vilniaus Salininkų gimnazija";"PRIEŠMOKYKLINĖ B";69329549093;Taip;0;1;0;1
20556;"Vilniaus Salininkų gimnazija";"PRIEŠMOKYKLINĖ B";8258045565;Taip;1;1;0;2
20557;"Vilniaus Salininkų gimnazija";"PRIEŠMOKYKLINĖ B";10179604964;Taip;0;1;0;1
20558;"Vilniaus Salininkų gimnazija";"PRIEŠMOKYKLINĖ B";1364275404;Taip;0;1;0;1
20559;"Vilniaus Spindulio pagrindinė mokykla";PM2;24363585231;Taip;0;1;0;1
20560;"Vilniaus Spindulio pagrindinė mokykla";PM2;1882976317;Taip;0;2;0;2
20561;"Vilniaus Spindulio pagrindinė mokykla";PM2;30064453011;Ne;3;1;2;6
20562;"Vilniaus Spindulio pagrindinė mokykla";PM2;37530814188;Taip;0;2;1;3
20563;"Vilniaus Spindulio pagrindinė mokykla";PM2;94392092103;Ne;0;1;1;2
20564;"Vilniaus Spindulio pagrindinė mokykla";PM2;8335398345;Taip;0;2;0;2
20565;"Vilniaus Spindulio pagrindinė mokykla";PM2;1119763619;Taip;3;1;1;5
20566;"Vilniaus Spindulio pagrindinė mokykla";PM2;1275460051;Taip;5;1;1;7
20567;"Vilniaus Spindulio pagrindinė mokykla";PM2;51442842468;Taip;0;2;0;2
20568;"Vilniaus Spindulio pagrindinė mokykla";PM2;70985723823;Ne;0;1;0;1
20569;"Vilniaus Spindulio pagrindinė mokykla";PM2;89455376961;Taip;4;0;0;4
20570;"Vilniaus Spindulio pagrindinė mokykla";PM2;8096536272;Ne;0;1;0;1
20571;"Vilniaus Spindulio pagrindinė mokykla";PM2;8367775964;Taip;0;4;0;4
20572;"Vilniaus Spindulio pagrindinė mokykla";PM2;82176273307;Taip;5;1;0;6
20573;"Vilniaus Spindulio pagrindinė mokykla";PM2;38262299304;Taip;0;3;0;3
20574;"Vilniaus Spindulio pagrindinė mokykla";PM2;4402050671;Taip;0;1;0;1
20575;"Vilniaus Spindulio pagrindinė mokykla";PM2;98839852579;Taip;0;1;0;1
20576;"Vilniaus Spindulio pagrindinė mokykla";PM2;96133788423;Taip;5;1;0;6
20577;"Vilniaus Vladislavo Sirokomlės vidurinė mokykla";Nykštukai;3757723755;Taip;0;21;0;21
20578;"Vilniaus Vladislavo Sirokomlės vidurinė mokykla";Nykštukai;6973757062;Taip;0;7;0;7
20579;"Vilniaus Vladislavo Sirokomlės vidurinė mokykla";Nykštukai;67365224459;Taip;0;7;2;9
20580;"Vilniaus Vladislavo Sirokomlės vidurinė mokykla";Nykštukai;1182643102;Taip;5;10;0;15
20581;"Vilniaus Vladislavo Sirokomlės vidurinė mokykla";Nykštukai;6027613840;Taip;0;6;0;6
20582;"Vilniaus Vladislavo Sirokomlės vidurinė mokykla";Nykštukai;7921336790;Taip;0;6;0;6
20583;"Vilniaus Vladislavo Sirokomlės vidurinė mokykla";Nykštukai;93097026538;Taip;4;6;0;10
20584;"Vilniaus Vladislavo Sirokomlės vidurinė mokykla";Nykštukai;87849011303;Taip;2;6;0;8
20585;"Vilniaus Vladislavo Sirokomlės vidurinė mokykla";Nykštukai;80664259551;Taip;0;6;0;6
20586;"Vilniaus Vladislavo Sirokomlės vidurinė mokykla";Nykštukai;19918665437;Taip;0;6;0;6
20587;"Vilniaus Vladislavo Sirokomlės vidurinė mokykla";Nykštukai;1755934341;Taip;0;21;0;21
20588;"Vilniaus Vladislavo Sirokomlės vidurinė mokykla";Nykštukai;8471020975;Taip;0;7;0;7
20589;"Vilniaus Vladislavo Sirokomlės vidurinė mokykla";Nykštukai;9715654332;Taip;0;6;0;6
20590;"Vilniaus Vladislavo Sirokomlės vidurinė mokykla";Nykštukai;67716590566;Taip;5;6;0;11
20591;"Vilniaus Vladislavo Sirokomlės vidurinė mokykla";Nykštukai;68958022216;Ne;0;6;0;6
20592;"Vilniaus Vladislavo Sirokomlės vidurinė mokykla";Smurfai;1277422207;Taip;0;1;0;1
20593;"Vilniaus Vladislavo Sirokomlės vidurinė mokykla";Smurfai;18847368957;Taip;0;1;0;1
20594;"Vilniaus Vladislavo Sirokomlės vidurinė mokykla";Smurfai;1824370122;Taip;0;6;0;6
20595;"Vilniaus Vladislavo Sirokomlės vidurinė mokykla";Smurfai;4727762605;Taip;0;3;0;3
20596;"Vilniaus Vladislavo Sirokomlės vidurinė mokykla";Smurfai;93964052608;Taip;2;1;0;3
20597;"Vilniaus Joachimo Lelevelio vidurinė mokykla";0A;2854451964;Taip;0;11;0;11
20598;"Vilniaus Joachimo Lelevelio vidurinė mokykla";0A;6406533101;Taip;0;7;0;7
20599;"Vilniaus Joachimo Lelevelio vidurinė mokykla";0A;3842907348;Taip;0;8;0;8
20600;"Vilniaus Joachimo Lelevelio vidurinė mokykla";0A;28504617099;Taip;0;24;0;24
20601;"Vilniaus Joachimo Lelevelio vidurinė mokykla";0A;8995997848;Taip;0;4;0;4
20602;"Vilniaus Joachimo Lelevelio vidurinė mokykla";0A;4513335615;Taip;0;4;2;6
20603;"Vilniaus Joachimo Lelevelio vidurinė mokykla";0A;4250816034;Taip;4;9;0;13
20604;"Vilniaus Joachimo Lelevelio vidurinė mokykla";0A;1771141306;Taip;0;10;0;10
20605;"Vilniaus Joachimo Lelevelio vidurinė mokykla";0A;7557437205;Taip;0;4;2;6
20606;"Vilniaus Joachimo Lelevelio vidurinė mokykla";0A;1615068173;Taip;5;5;0;10
20607;"Vilniaus Joachimo Lelevelio vidurinė mokykla";0A;2062489205;Taip;0;9;0;9
20608;"Vilniaus Joachimo Lelevelio vidurinė mokykla";0A;52212151760;Taip;0;4;0;4
20609;"Vilniaus Joachimo Lelevelio vidurinė mokykla";0A;98526928421;Taip;0;4;1;5
20610;"Vilniaus Joachimo Lelevelio vidurinė mokykla";0A;18542160352;Taip;3;5;0;8
20611;"Vilniaus Joachimo Lelevelio vidurinė mokykla";0A;1701035826;Ne;0;4;3;7
20612;"Vilniaus Joachimo Lelevelio vidurinė mokykla";0A;2059267616;Taip;2;4;0;6
20613;"Vilniaus Joachimo Lelevelio vidurinė mokykla";0A;87500842251;Taip;0;4;2;6
20614;"Vilniaus Joachimo Lelevelio vidurinė mokykla";0B;1398713963;Taip;0;4;3;7
20615;"Vilniaus Joachimo Lelevelio vidurinė mokykla";0B;7498447014;Ne;0;24;0;24
20616;"Vilniaus Joachimo Lelevelio vidurinė mokykla";0B;12358360731;Taip;0;5;0;5
20617;"Vilniaus Joachimo Lelevelio vidurinė mokykla";0B;1294879767;Taip;0;7;0;7
20618;"Vilniaus Joachimo Lelevelio vidurinė mokykla";0B;13127077816;Taip;0;24;0;24
20619;"Vilniaus Joachimo Lelevelio vidurinė mokykla";0B;5734485363;Ne;5;4;1;10
20620;"Vilniaus Joachimo Lelevelio vidurinė mokykla";0B;97106889191;Taip;0;24;0;24
20621;"Vilniaus Joachimo Lelevelio vidurinė mokykla";0B;1400614987;Taip;0;7;0;7
20622;"Vilniaus Joachimo Lelevelio vidurinė mokykla";0B;5826045578;Ne;0;4;0;4
20623;"Vilniaus Joachimo Lelevelio vidurinė mokykla";0B;94748215851;Taip;0;5;1;6
20624;"Vilniaus Joachimo Lelevelio vidurinė mokykla";0B;5628943541;Taip;0;5;2;7
20625;"Vilniaus Joachimo Lelevelio vidurinė mokykla";0B;65825430797;Taip;0;4;0;4
20626;"Vilniaus Joachimo Lelevelio vidurinė mokykla";0B;4537724747;Ne;0;4;2;6
20627;"Vilniaus Joachimo Lelevelio vidurinė mokykla";0C;77834846979;Taip;0;24;0;24
20628;"Vilniaus Joachimo Lelevelio vidurinė mokykla";0C;7474239709;Taip;0;24;0;24
20629;"Vilniaus Joachimo Lelevelio vidurinė mokykla";0C;4298878720;Ne;0;24;0;24
20630;"Vilniaus Joachimo Lelevelio vidurinė mokykla";0C;2066262598;Ne;0;4;0;4
20631;"Vilniaus Joachimo Lelevelio vidurinė mokykla";0C;6729635545;Taip;5;4;0;9
20632;"Vilniaus Joachimo Lelevelio vidurinė mokykla";0C;47825918748;Taip;0;8;0;8
20633;"Vilniaus Joachimo Lelevelio vidurinė mokykla";0C;74314676598;Taip;0;4;0;4
20634;"Vilniaus Joachimo Lelevelio vidurinė mokykla";0C;1634442815;Taip;0;4;2;6
20635;"Vilniaus Joachimo Lelevelio vidurinė mokykla";0C;8552721960;Taip;0;5;0;5
20636;"Vilniaus Juzefo Ignacijaus Kraševskio gimnazija";Priešmokyklinė;3992602769;Ne;2;1;2;5
20637;"Vilniaus Juzefo Ignacijaus Kraševskio gimnazija";Priešmokyklinė;96528175390;Ne;5;1;0;6
20638;"Vilniaus Juzefo Ignacijaus Kraševskio gimnazija";Priešmokyklinė;7947779677;Taip;2;1;1;4
20639;"Vilniaus Juzefo Ignacijaus Kraševskio gimnazija";Priešmokyklinė;45246620717;Taip;0;2;0;2
20640;"Vilniaus Juzefo Ignacijaus Kraševskio gimnazija";Priešmokyklinė;9640287886;Ne;12;1;1;14
20641;"Vilniaus Juzefo Ignacijaus Kraševskio gimnazija";Priešmokyklinė;67676283920;Taip;5;1;2;8
20642;"Vilniaus Juzefo Ignacijaus Kraševskio gimnazija";Priešmokyklinė;85741340293;Taip;0;1;3;4
20643;"Vilniaus Juzefo Ignacijaus Kraševskio gimnazija";Priešmokyklinė;3041637447;Taip;4;1;0;5
20644;"Vilniaus Juzefo Ignacijaus Kraševskio gimnazija";Priešmokyklinė;52109524827;Ne;0;1;3;4
20645;"Vilniaus Juzefo Ignacijaus Kraševskio gimnazija";Priešmokyklinė;42562816168;Ne;0;1;0;1
20646;"Vilniaus Juzefo Ignacijaus Kraševskio gimnazija";Priešmokyklinė;1963122314;Taip;6;6;3;15
20647;"Vilniaus Juzefo Ignacijaus Kraševskio gimnazija";Priešmokyklinė;9167719015;Ne;5;1;6;12
20648;"Vilniaus Juzefo Ignacijaus Kraševskio gimnazija";Priešmokyklinė;6560740320;Taip;0;1;0;1
20649;"Vilniaus Juzefo Ignacijaus Kraševskio gimnazija";Priešmokyklinė;6224053661;Taip;15;1;2;18
20650;"Vilniaus Juzefo Ignacijaus Kraševskio gimnazija";Priešmokyklinė;6879140016;Taip;0;21;0;21
20651;"Vilniaus Jono Pauliaus II progimnazija";Nykštukai;33235320630;Taip;0;1;0;1
20652;"Vilniaus Jono Pauliaus II progimnazija";Nykštukai;62887824954;Taip;2;1;0;3
20653;"Vilniaus Jono Pauliaus II progimnazija";Nykštukai;33266635443;Taip;0;2;0;2
20654;"Vilniaus Jono Pauliaus II progimnazija";Nykštukai;21391476676;Ne;0;1;0;1
20655;"Vilniaus Jono Pauliaus II progimnazija";Nykštukai;9286664165;Ne;0;1;1;2
20656;"Vilniaus Jono Pauliaus II progimnazija";Nykštukai;2441033469;Ne;0;9;0;9
20657;"Vilniaus Jono Pauliaus II progimnazija";Nykštukai;69740475863;Ne;5;1;0;6
20658;"Vilniaus Jono Pauliaus II progimnazija";Nykštukai;9711206546;Taip;5;1;0;6
20659;"Vilniaus Jono Pauliaus II progimnazija";Nykštukai;63900641942;Taip;8;1;0;9
20660;"Vilniaus Jono Pauliaus II progimnazija";Nykštukai;72881976363;Taip;8;1;0;9
20661;"Vilniaus Jono Pauliaus II progimnazija";Nykštukai;1448250372;Taip;0;1;1;2
20662;"Vilniaus Jono Pauliaus II progimnazija";Nykštukai;1974161463;Taip;0;1;0;1
20663;"Vilniaus Jono Pauliaus II progimnazija";Nykštukai;6069988171;Taip;0;1;0;1
20664;"Vilniaus Jono Pauliaus II progimnazija";Nykštukai;69919525470;Taip;5;16;0;21
20665;"Vilniaus Jono Pauliaus II progimnazija";Nykštukai;12487059850;Taip;0;1;0;1
20666;"Vilniaus Jono Pauliaus II progimnazija";Nykštukai;47716333909;Taip;0;1;1;2
20667;"Vilniaus Jono Pauliaus II progimnazija";Nykštukai;62372417041;Taip;0;1;1;2
20668;"Vilniaus Jono Pauliaus II progimnazija";Nykštukai;43690245314;Taip;6;1;0;7
20669;"Vilniaus Jono Pauliaus II progimnazija";Nykštukai;2030227606;Taip;3;1;0;4
20670;"Vilniaus Jono Pauliaus II progimnazija";Nykštukai;1623576857;Taip;0;1;0;1
20671;"Vilniaus Jono Pauliaus II progimnazija";Nykštukai;29087363179;Taip;0;1;0;1
20672;"Vilniaus Jono Pauliaus II progimnazija";Nykštukai;40427909744;Taip;0;6;0;6
20673;"Vilniaus Jono Pauliaus II progimnazija";Nykštukai;86192743256;Taip;0;1;0;1
20674;"Vilniaus Jono Pauliaus II progimnazija";Žiniukai;1911748280;Taip;0;2;0;2
20675;"Vilniaus Jono Pauliaus II progimnazija";Žiniukai;5306416511;Taip;8;1;0;9
20676;"Vilniaus Jono Pauliaus II progimnazija";Žiniukai;84947394033;Taip;0;1;0;1
20677;"Vilniaus Jono Pauliaus II progimnazija";Žiniukai;1148796296;Taip;0;4;0;4
20678;"Vilniaus Jono Pauliaus II progimnazija";Žiniukai;66327590524;Taip;0;4;0;4
20679;"Vilniaus Jono Pauliaus II progimnazija";Žiniukai;71909273139;Taip;5;1;0;6
20680;"Vilniaus Jono Pauliaus II progimnazija";Žiniukai;9949006053;Taip;20;1;0;21
20681;"Vilniaus Jono Pauliaus II progimnazija";Žiniukai;9000145666;Taip;0;21;0;21
20682;"Vilniaus Jono Pauliaus II progimnazija";Žiniukai;8259564583;Taip;0;1;0;1
20683;"Vilniaus Jono Pauliaus II progimnazija";Žiniukai;5323116194;Taip;7;2;0;9
20684;"Vilniaus Jono Pauliaus II progimnazija";Žiniukai;15597884044;Taip;0;1;0;1
20685;"Vilniaus Jono Pauliaus II progimnazija";Žiniukai;21795184411;Ne;0;6;0;6
20686;"Vilniaus Jono Pauliaus II progimnazija";Žiniukai;90741594830;Ne;0;1;0;1
20687;"Vilniaus Jono Pauliaus II progimnazija";Žiniukai;92871710315;Taip;0;1;0;1
20688;"Vilniaus Jono Pauliaus II progimnazija";Žiniukai;66338689682;Taip;0;2;0;2
20689;"Vilniaus Jono Pauliaus II progimnazija";Žiniukai;40117721972;Taip;10;1;0;11
20690;"Vilniaus Jono Pauliaus II progimnazija";Žiniukai;56656769188;Taip;0;1;3;4
20691;"Vilniaus Jono Pauliaus II progimnazija";Žiniukai;9962282406;Taip;2;1;1;4
20692;"Vilniaus Jono Pauliaus II progimnazija";Žiniukai;1000417905;Taip;0;5;0;5
20693;"Vilniaus Jono Pauliaus II progimnazija";Žiniukai;2132492766;Taip;6;1;0;7
20694;"Vilniaus Jono Pauliaus II progimnazija";Žiniukai;52202199212;Taip;8;1;0;9
20695;"Vilniaus Jono Pauliaus II progimnazija";Žiniukai;64337451741;Ne;0;1;1;2
20696;"Vilniaus Jono Pauliaus II progimnazija";Spindulėlis;6312963672;Taip;0;21;0;21
20697;"Vilniaus Jono Pauliaus II progimnazija";Spindulėlis;73847154996;Taip;0;2;0;2
20698;"Vilniaus Jono Pauliaus II progimnazija";Spindulėlis;38517844902;Taip;0;1;0;1
20699;"Vilniaus Jono Pauliaus II progimnazija";Spindulėlis;14754302946;Ne;0;1;0;1
20700;"Vilniaus Jono Pauliaus II progimnazija";Spindulėlis;1053502203;Ne;0;21;0;21
20701;"Vilniaus Jono Pauliaus II progimnazija";Spindulėlis;53090437775;Taip;11;1;0;12
20702;"Vilniaus Jono Pauliaus II progimnazija";Spindulėlis;82679341920;Taip;0;1;0;1
20703;"Vilniaus Jono Pauliaus II progimnazija";Spindulėlis;99037281876;Taip;0;1;0;1
20704;"Vilniaus Jono Pauliaus II progimnazija";Spindulėlis;78465993753;Ne;10;2;0;12
20705;"Vilniaus Jono Pauliaus II progimnazija";Spindulėlis;92991242443;Taip;12;1;0;13
20706;"Vilniaus Jono Pauliaus II progimnazija";Spindulėlis;85352317063;Taip;0;1;0;1
20707;"Vilniaus Jono Pauliaus II progimnazija";Spindulėlis;7126070419;Ne;15;2;0;17
20708;"Vilniaus Jono Pauliaus II progimnazija";Spindulėlis;1481976292;Taip;0;1;0;1
20709;"Vilniaus Jono Pauliaus II progimnazija";Spindulėlis;68841073274;Taip;0;3;0;3
20710;"Vilniaus Jono Pauliaus II progimnazija";Spindulėlis;9989277772;Taip;5;1;0;6
20711;"Vilniaus Jono Pauliaus II progimnazija";Spindulėlis;9275686861;Ne;10;2;2;14
20712;"Vilniaus Jono Pauliaus II progimnazija";Spindulėlis;17472648959;Taip;0;1;0;1
20713;"Vilniaus Jono Pauliaus II progimnazija";Spindulėlis;2957745091;Taip;5;1;0;6
20714;"Vilniaus Jono Pauliaus II progimnazija";Spindulėlis;4502784565;Ne;0;1;0;1
20715;"Vilniaus Jono Pauliaus II progimnazija";Spindulėlis;4113350416;Taip;15;1;0;16
20716;"Vilniaus Jono Pauliaus II progimnazija";Spindulėlis;2939189437;Ne;0;1;0;1
20717;"Vilniaus Jono Pauliaus II progimnazija";Spindulėlis;1573790467;Taip;0;3;0;3
20718;"Vilniaus Senamiesčio vidurinė mokykla";PG1;2869694644;Taip;0;1;6;7
20719;"Vilniaus Senamiesčio vidurinė mokykla";PG1;3511904436;Taip;0;4;0;4
20720;"Vilniaus Senamiesčio vidurinė mokykla";PG1;87869418489;Taip;6;1;1;8
20721;"Vilniaus Senamiesčio vidurinė mokykla";PG1;1905141424;Taip;0;1;3;4
20722;"Vilniaus Senamiesčio vidurinė mokykla";PG1;9906690140;Ne;0;21;0;21
20723;"Vilniaus Senamiesčio vidurinė mokykla";PG1;1984531468;Taip;0;4;0;4
20724;"Vilniaus Senamiesčio vidurinė mokykla";PG1;78593862724;Ne;0;1;6;7
20725;"Vilniaus Senamiesčio vidurinė mokykla";PG1;91834332717;Taip;0;1;1;2
20726;"Vilniaus Senamiesčio vidurinė mokykla";PG1;1882022060;Ne;0;1;3;4
20727;"Vilniaus Senamiesčio vidurinė mokykla";PG1;47953806522;Taip;3;1;0;4
20728;"Vilniaus Senamiesčio vidurinė mokykla";PG1;5536467023;Ne;0;1;0;1
20729;"Vilniaus Senamiesčio vidurinė mokykla";PG1;5721777059;Ne;5;1;0;6
20730;"Vilniaus Senamiesčio vidurinė mokykla";PG1;2864419137;Taip;0;11;0;11
20731;"Vilniaus Senamiesčio vidurinė mokykla";PG1;2764636358;Taip;0;1;1;2
20732;"Vilniaus Senamiesčio vidurinė mokykla";PG1;1369622524;Taip;0;21;0;21
20733;"Vilniaus Senamiesčio vidurinė mokykla";PG1;8449484660;Taip;0;1;3;4
20734;"Vilniaus Senamiesčio vidurinė mokykla";PG1;2094485999;Taip;0;1;1;2
20735;"Vilniaus Senamiesčio vidurinė mokykla";PG1;1813072867;Taip;6;2;0;8
20736;"Vilniaus Senamiesčio vidurinė mokykla";PG1;7764171885;Taip;0;1;3;4
20737;"Vilniaus Senamiesčio vidurinė mokykla";PG1;7756934694;Taip;0;6;0;6
20738;Gluosnis;KIŠKUČIAI;4591550636;Taip;5;3;0;8
20739;Gluosnis;KIŠKUČIAI;8689557248;Taip;15;0;0;15
20740;Gluosnis;KIŠKUČIAI;2984134115;Taip;13;0;3;16
20741;Gluosnis;KIŠKUČIAI;6955695422;Taip;17;0;0;17
20742;Gluosnis;KIŠKUČIAI;6140294839;Taip;12;0;0;12
20743;Gluosnis;KIŠKUČIAI;1305651237;Taip;8;0;5;13
20744;Gluosnis;KIŠKUČIAI;1341265560;Taip;12;6;0;18
20745;Gluosnis;KIŠKUČIAI;4285562600;Taip;19;0;0;19
20746;Gluosnis;KIŠKUČIAI;1773343262;Taip;5;0;0;5
20747;Gluosnis;KIŠKUČIAI;5432102004;Taip;15;0;3;18
20748;Gluosnis;KIŠKUČIAI;1712795835;Taip;12;0;0;12
20749;Gluosnis;KIŠKUČIAI;8009719622;Taip;10;0;1;11
20750;Gluosnis;KIŠKUČIAI;9833971809;Taip;19;0;0;19
20751;Gluosnis;KIŠKUČIAI;6883663577;Taip;17;0;0;17
20752;Gluosnis;KIŠKUČIAI;1512855055;Taip;9;0;5;14
20753;Gluosnis;KIŠKUČIAI;8383489040;Taip;8;0;7;15
20754;Gluosnis;KIŠKUČIAI;8337313448;Taip;17;0;0;17
20755;Gluosnis;KIŠKUČIAI;4632419177;Taip;16;0;0;16
20756;Gluosnis;EŽIUKAI;6113153127;Taip;15;0;0;15
20757;Gluosnis;EŽIUKAI;4153713911;Taip;13;5;0;18
20758;Gluosnis;EŽIUKAI;7073637619;Taip;7;0;1;8
20759;Gluosnis;EŽIUKAI;4493877427;Taip;19;0;0;19
20760;Gluosnis;EŽIUKAI;6612468095;Taip;18;0;0;18
20761;Gluosnis;EŽIUKAI;3323237449;Taip;14;2;0;16
20762;Gluosnis;EŽIUKAI;7769522093;Taip;16;0;0;16
20763;Gluosnis;EŽIUKAI;8928597187;Taip;0;0;16;16
20764;Gluosnis;EŽIUKAI;9993638596;Taip;0;0;6;6
20765;Gluosnis;EŽIUKAI;4107344313;Taip;10;0;2;12
20766;Gluosnis;EŽIUKAI;1101472999;Taip;6;0;0;6
20767;Gluosnis;EŽIUKAI;9888037899;Taip;7;0;5;12
20768;Gluosnis;EŽIUKAI;3273127718;Taip;5;0;15;20
20769;Gluosnis;EŽIUKAI;6768501780;Taip;8;0;1;9
20770;Gluosnis;EŽIUKAI;1351519995;Taip;21;0;0;21
20771;Gluosnis;MEŠKIUKAI;4022182529;Taip;18;0;0;18
20772;Gluosnis;MEŠKIUKAI;8981904827;Taip;13;0;3;16
20773;Gluosnis;MEŠKIUKAI;8998776286;Taip;16;0;0;16
20774;Gluosnis;MEŠKIUKAI;4506243333;Taip;17;0;0;17
20775;Gluosnis;MEŠKIUKAI;1846499141;Taip;16;0;5;21
20776;Gluosnis;MEŠKIUKAI;7935750427;Taip;15;1;0;16
20777;Gluosnis;MEŠKIUKAI;4905002832;Taip;8;0;0;8
20778;Gluosnis;MEŠKIUKAI;9201769624;Taip;0;0;6;6
20779;Gluosnis;MEŠKIUKAI;9102081648;Taip;3;0;2;5
20780;Gluosnis;MEŠKIUKAI;4498429439;Taip;13;0;1;14
20781;Gluosnis;MEŠKIUKAI;6067801976;Taip;18;0;0;18
20782;Gluosnis;MEŠKIUKAI;8259160584;Taip;20;0;0;20
20783;Gluosnis;MEŠKIUKAI;1235091885;Taip;19;0;0;19
20784;Gluosnis;MEŠKIUKAI;1165636758;Taip;11;0;1;12
20785;Gluosnis;MEŠKIUKAI;8499748544;Taip;11;0;0;11
20786;Gluosnis;MEŠKIUKAI;2867319899;Taip;12;0;0;12
20787;Gluosnis;MEŠKIUKAI;9699577397;Taip;0;0;6;6
20788;Gluosnis;BORUŽĖLĖS;8840658383;Taip;11;2;0;13
20789;Gluosnis;BORUŽĖLĖS;1102935178;Taip;1;0;2;3
20790;Gluosnis;BORUŽĖLĖS;8328948120;Ne;0;0;6;6
20791;Gluosnis;BORUŽĖLĖS;2167312808;Taip;9;0;0;9
20792;Gluosnis;BORUŽĖLĖS;3176305306;Ne;7;0;0;7
20793;Gluosnis;BORUŽĖLĖS;4204797742;Taip;7;11;0;18
20794;Gluosnis;BORUŽĖLĖS;6302765948;Taip;11;0;0;11
20795;Gluosnis;BORUŽĖLĖS;9938235476;Taip;4;0;0;4
20796;Gluosnis;BORUŽĖLĖS;2945796648;Taip;0;0;6;6
20797;Gluosnis;BORUŽĖLĖS;2173191971;Taip;16;0;0;16
20798;Gluosnis;BORUŽĖLĖS;4237053702;Taip;5;0;0;5
20799;Gluosnis;BORUŽĖLĖS;6320411660;Ne;0;0;1;1
20800;Gluosnis;BORUŽĖLĖS;7731887361;Taip;12;0;0;12
20801;Gluosnis;BORUŽĖLĖS;8502947568;Taip;10;0;0;10
20802;Gluosnis;BORUŽĖLĖS;9664090375;Taip;7;0;0;7
20803;Gluosnis;BORUŽĖLĖS;1335152703;Taip;6;0;6;12
20804;Gluosnis;BORUŽĖLĖS;1314992969;Taip;11;3;0;14
20805;Gluosnis;BORUŽĖLĖS;7833136455;Taip;14;0;0;14
20806;Gluosnis;BORUŽĖLĖS;5556821953;Ne;11;0;0;11
20807;Gluosnis;BORUŽĖLĖS;2515646510;Taip;0;0;5;5
20808;Gluosnis;BORUŽĖLĖS;3212658311;Taip;10;0;3;13
20809;Gluosnis;BORUŽĖLĖS;2603201633;Ne;8;0;1;9
20810;Gluosnis;LAPIUKAI;94487630173;Taip;11;2;0;13
20811;Gluosnis;LAPIUKAI;7445566160;Taip;15;0;2;17
20812;Gluosnis;LAPIUKAI;1933496033;Taip;0;2;0;2
20813;Gluosnis;LAPIUKAI;8259035822;Taip;0;4;0;4
20814;Gluosnis;LAPIUKAI;5354082364;Ne;11;0;2;13
20815;Gluosnis;LAPIUKAI;3758930567;Taip;3;0;0;3
20816;Gluosnis;LAPIUKAI;6536698798;Taip;15;0;0;15
20817;Gluosnis;LAPIUKAI;4960167173;Taip;0;1;6;7
20818;Gluosnis;LAPIUKAI;3504197974;Taip;0;0;2;2
20819;Gluosnis;LAPIUKAI;1153781469;Taip;11;0;2;13
20820;Gluosnis;LAPIUKAI;2181550091;Taip;2;0;2;4
20821;Gluosnis;LAPIUKAI;2810808007;Taip;17;2;0;19
20822;Gluosnis;LAPIUKAI;6163009686;Taip;5;0;0;5
20823;Gluosnis;LAPIUKAI;9146356004;Taip;15;0;1;16
20824;Gluosnis;LAPIUKAI;1671693932;Taip;6;0;0;6
20825;Gluosnis;LAPIUKAI;4005023841;Ne;1;0;2;3
20826;Gluosnis;LAPIUKAI;9497547057;Ne;11;0;1;12
20827;Gluosnis;LAPIUKAI;1119389682;Taip;0;0;1;1
20828;Gluosnis;PELĖDŽIUKAI;1739047746;Taip;0;0;7;7
20829;Gluosnis;PELĖDŽIUKAI;3840001741;Ne;4;0;0;4
20830;Gluosnis;PELĖDŽIUKAI;4856769984;Taip;9;0;3;12
20831;Gluosnis;PELĖDŽIUKAI;1944291082;Taip;4;0;3;7
20832;Gluosnis;PELĖDŽIUKAI;54773515741;Taip;0;1;0;1
20833;Gluosnis;PELĖDŽIUKAI;75777330223;Taip;0;0;5;5
20834;Gluosnis;PELĖDŽIUKAI;1319664504;Taip;0;0;3;3
20835;Gluosnis;PELĖDŽIUKAI;11053850075;Taip;0;1;0;1
20836;Gluosnis;PELĖDŽIUKAI;8925611940;Taip;4;0;5;9
20837;Gluosnis;PELĖDŽIUKAI;1269360325;Taip;4;0;2;6
20838;Gluosnis;PELĖDŽIUKAI;3107005229;Taip;0;6;5;11
20839;Gluosnis;PELĖDŽIUKAI;8014916932;Ne;0;0;3;3
20840;Gluosnis;PELĖDŽIUKAI;98818207299;Ne;5;0;0;5
20841;Gluosnis;PELĖDŽIUKAI;48170110340;Taip;3;0;0;3
20842;Gluosnis;PELĖDŽIUKAI;31133574731;Taip;10;3;0;13
20843;Gluosnis;PELĖDŽIUKAI;1244309058;Taip;4;0;3;7
20844;Gluosnis;PELĖDŽIUKAI;5853981937;Taip;5;1;0;6
20845;Gluosnis;PELĖDŽIUKAI;1730588815;Taip;0;0;1;1
20846;Gluosnis;PELĖDŽIUKAI;8788880196;Taip;12;0;5;17
20847;Gluosnis;PELĖDŽIUKAI;1984089149;Ne;14;0;2;16
20848;Gluosnis;PELĖDŽIUKAI;2562046934;Ne;5;0;0;5
20849;Gluosnis;VOVERIUKAI;4743331873;Taip;5;0;10;15
20850;Gluosnis;VOVERIUKAI;8719047997;Taip;19;0;0;19
20851;Gluosnis;VOVERIUKAI;5059528135;Taip;18;0;0;18
20852;Gluosnis;VOVERIUKAI;7075070566;Taip;0;0;2;2
20853;Gluosnis;VOVERIUKAI;7761376910;Taip;0;0;8;8
20854;Gluosnis;VOVERIUKAI;3434902234;Taip;3;0;1;4
20855;Gluosnis;VOVERIUKAI;1147279898;Taip;9;0;2;11
20856;Gluosnis;VOVERIUKAI;8928237970;Ne;21;0;0;21
20857;Gluosnis;VOVERIUKAI;9786252471;Taip;7;0;4;11
20858;Gluosnis;VOVERIUKAI;6493474181;Taip;0;0;4;4
20859;Gluosnis;VOVERIUKAI;6944918504;Taip;0;0;7;7
20860;Gluosnis;VOVERIUKAI;9669118189;Taip;5;0;3;8
20861;Gluosnis;VOVERIUKAI;3961201852;Taip;0;5;2;7
20862;Gluosnis;VOVERIUKAI;9379825678;Taip;0;0;1;1
20863;Gluosnis;VOVERIUKAI;1185903576;Taip;0;0;1;1
20864;Gluosnis;VOVERIUKAI;6113600571;Taip;0;0;8;8
20865;Gluosnis;VOVERIUKAI;6443602669;Taip;0;0;5;5
20866;Gluosnis;VOVERIUKAI;1565251804;Taip;0;0;2;2
20867;Gluosnis;DRUGELIAI;5949954525;Taip;14;0;0;14
20868;Gluosnis;DRUGELIAI;7537587118;Taip;7;0;4;11
20869;Gluosnis;DRUGELIAI;6478139233;Taip;11;0;3;14
20870;Gluosnis;DRUGELIAI;1716235604;Taip;5;12;0;17
20871;Gluosnis;DRUGELIAI;7642311375;Taip;12;0;0;12
20872;Gluosnis;DRUGELIAI;8430102757;Taip;15;0;0;15
20873;Gluosnis;DRUGELIAI;4125830926;Taip;12;0;1;13
20874;Gluosnis;DRUGELIAI;6358187113;Taip;18;0;0;18
20875;Gluosnis;DRUGELIAI;2260938817;Taip;9;0;0;9
20876;Gluosnis;DRUGELIAI;9084785666;Taip;9;0;0;9
20877;Gluosnis;DRUGELIAI;4940563623;Taip;20;0;0;20
20878;Gluosnis;DRUGELIAI;1113731535;Taip;17;0;0;17
20879;Gluosnis;DRUGELIAI;4653963373;Ne;16;0;0;16
20880;Gluosnis;DRUGELIAI;2458662117;Taip;1;0;0;1
20881;Gluosnis;DRUGELIAI;3936418539;Ne;9;0;1;10
20882;Gluosnis;DRUGELIAI;3810261864;Taip;10;0;0;10
20883;Gluosnis;DRUGELIAI;8314366921;Taip;3;0;2;5
20884;Gluosnis;DRUGELIAI;4220504133;Taip;8;0;0;8
20885;Gluosnis;DRUGELIAI;9931766935;Taip;17;0;0;17
20886;Gluosnis;DRUGELIAI;3527418865;Taip;17;0;0;17
20887;Gluosnis;BITUTĖS;4176300773;Taip;13;0;1;14
20888;Gluosnis;BITUTĖS;1848647593;Taip;10;1;0;11
20889;Gluosnis;BITUTĖS;2554790908;Taip;13;0;1;14
20890;Gluosnis;BITUTĖS;8281499182;Taip;12;0;0;12
20891;Gluosnis;BITUTĖS;5186060122;Taip;17;0;0;17
20892;Gluosnis;BITUTĖS;8690911930;Taip;15;0;0;15
20893;Gluosnis;BITUTĖS;2403029153;Taip;12;0;0;12
20894;Gluosnis;BITUTĖS;6432475763;Taip;4;0;2;6
20895;Gluosnis;BITUTĖS;9963769327;Taip;17;0;0;17
20896;Gluosnis;BITUTĖS;9542889575;Taip;10;0;0;10
20897;Gluosnis;BITUTĖS;1966484574;Taip;0;0;5;5
20898;Gluosnis;BITUTĖS;1170053777;Ne;10;0;0;10
20899;Gluosnis;BITUTĖS;4353195155;Taip;7;0;4;11
20900;Gluosnis;BITUTĖS;5889360726;Taip;4;1;1;6
20901;Gluosnis;BITUTĖS;3235523199;Taip;16;0;0;16
20902;Gluosnis;BITUTĖS;8035097045;Taip;5;0;1;6
20903;Gluosnis;BITUTĖS;3362089746;Taip;5;0;7;12
20904;Gluosnis;BITUTĖS;6767500085;Ne;18;0;0;18
20905;Gluosnis;BITUTĖS;4505504276;Taip;13;0;2;15
20906;Gluosnis;BITUTĖS;7390361159;Ne;5;0;1;6
20907;"Vilniaus Ateities mokykla";Priešmokyklinė;4422816945;Taip;0;21;0;21
20908;"Vilniaus Ateities mokykla";Priešmokyklinė;3856518725;Taip;0;21;0;21
20909;"Vilniaus Ateities mokykla";Priešmokyklinė;1119814512;Taip;0;21;0;21
20910;"Vilniaus Ateities mokykla";Priešmokyklinė;7104794885;Taip;0;21;0;21
20911;"Vilniaus Ateities mokykla";Priešmokyklinė;1420929477;Taip;0;21;0;21
20912;"Vilniaus Ateities mokykla";Priešmokyklinė;27840592998;Taip;0;21;0;21
20913;"Vilniaus Ateities mokykla";Priešmokyklinė;40706531692;Taip;0;21;0;21
20914;"Vilniaus Ateities mokykla";Priešmokyklinė;69095956441;Taip;0;21;0;21
20915;"Vilniaus Ateities mokykla";Priešmokyklinė;66162315180;Taip;0;21;0;21
20916;"Vilniaus Ateities mokykla";Priešmokyklinė;41745965224;Taip;0;21;0;21
20917;"Vilniaus Ateities mokykla";Priešmokyklinė;2083974132;Taip;0;21;0;21
20918;"Vilniaus Ateities mokykla";Priešmokyklinė;4339671951;Taip;0;21;0;21
20919;"Vilniaus Ateities mokykla";Priešmokyklinė;8520589200;Taip;0;21;0;21
20920;"Vilniaus Ateities mokykla";Priešmokyklinė;2854877428;Ne;0;21;0;21
20921;"Vilniaus Ateities mokykla";Priešmokyklinė;90324652854;Ne;0;21;0;21
20922;"Vilniaus Ateities mokykla";Priešmokyklinė;1868431609;Taip;0;21;0;21
20923;"Vilniaus Ateities mokykla";Priešmokyklinė;99734698213;Taip;0;21;0;21
20924;"Vilniaus Saulėtekio mokykla-daugiafunkcinis centras";Priešmokyklinė;7047619741;Taip;5;1;0;6
20925;"Vilniaus Saulėtekio mokykla-daugiafunkcinis centras";Priešmokyklinė;3447120578;Ne;0;1;1;2
20926;"Vilniaus Saulėtekio mokykla-daugiafunkcinis centras";Priešmokyklinė;1024982577;Ne;4;16;1;21
20927;"Vilniaus Saulėtekio mokykla-daugiafunkcinis centras";Priešmokyklinė;7061749750;Taip;0;1;0;1
20928;"Vilniaus Saulėtekio mokykla-daugiafunkcinis centras";Priešmokyklinė;51312232477;Taip;0;11;0;11
20929;"Vilniaus Saulėtekio mokykla-daugiafunkcinis centras";Priešmokyklinė;6414861823;Taip;4;2;0;6
20930;"Vilniaus Saulėtekio mokykla-daugiafunkcinis centras";Priešmokyklinė;7563665059;Ne;0;21;0;21
20931;"Vilniaus Saulėtekio mokykla-daugiafunkcinis centras";Priešmokyklinė;1421523719;Taip;0;11;2;13
20932;"Vilniaus Saulėtekio mokykla-daugiafunkcinis centras";Priešmokyklinė;5867141673;Taip;0;1;0;1
20933;"Vilniaus Saulėtekio mokykla-daugiafunkcinis centras";Priešmokyklinė;7686847474;Taip;0;1;0;1
20934;"Vilniaus Saulėtekio mokykla-daugiafunkcinis centras";Priešmokyklinė;5248302086;Taip;0;1;0;1
20935;"Vilniaus Saulėtekio mokykla-daugiafunkcinis centras";Priešmokyklinė;80029915729;Taip;0;21;0;21
20936;"Vilniaus Saulėtekio mokykla-daugiafunkcinis centras";Priešmokyklinė;1772051140;Taip;0;21;0;21
20937;"Vilniaus Saulėtekio mokykla-daugiafunkcinis centras";Priešmokyklinė;9932216845;Taip;5;1;0;6
20938;"Vilniaus Martyno Mažvydo progimnazija";PRIEŠMOKYKLINĖ;96793345108;Taip;2;1;0;3
20939;"Vilniaus Martyno Mažvydo progimnazija";PRIEŠMOKYKLINĖ;19181545360;Taip;9;1;0;10
20940;"Vilniaus Martyno Mažvydo progimnazija";PRIEŠMOKYKLINĖ;3905693699;Taip;0;1;0;1
20941;"Vilniaus Martyno Mažvydo progimnazija";PRIEŠMOKYKLINĖ;4858524232;Taip;0;21;0;21
20942;"Vilniaus Martyno Mažvydo progimnazija";PRIEŠMOKYKLINĖ;68127870846;Taip;5;1;0;6
20943;"Vilniaus Martyno Mažvydo progimnazija";PRIEŠMOKYKLINĖ;3964251862;Taip;0;1;4;5
20944;"Vilniaus Martyno Mažvydo progimnazija";PRIEŠMOKYKLINĖ;41410871117;Taip;0;1;0;1
20945;"Vilniaus Martyno Mažvydo progimnazija";PRIEŠMOKYKLINĖ;4773489765;Taip;0;1;0;1
20946;"Vilniaus Martyno Mažvydo progimnazija";PRIEŠMOKYKLINĖ;2032732500;Taip;0;1;0;1
20947;"Vilniaus Martyno Mažvydo progimnazija";PRIEŠMOKYKLINĖ;18742574853;Taip;1;2;1;4
20948;"Vilniaus Martyno Mažvydo progimnazija";PRIEŠMOKYKLINĖ;1126288017;Taip;0;1;1;2
20949;"Vilniaus Martyno Mažvydo progimnazija";PRIEŠMOKYKLINĖ;1148912605;Taip;0;2;0;2
20950;"Vilniaus Martyno Mažvydo progimnazija";PRIEŠMOKYKLINĖ;83270172138;Taip;0;1;0;1
20951;"Vilniaus Martyno Mažvydo progimnazija";PRIEŠMOKYKLINĖ;1693121016;Taip;0;1;0;1
20952;"Vilniaus Martyno Mažvydo progimnazija";PRIEŠMOKYKLINĖ;1993355696;Taip;3;1;0;4
20953;"Vilniaus Martyno Mažvydo progimnazija";PRIEŠMOKYKLINĖ;25732368565;Taip;0;21;0;21
20954;"Vilniaus Martyno Mažvydo progimnazija";PRIEŠMOKYKLINĖ;5973303255;Taip;0;1;3;4
20955;"Vilniaus Martyno Mažvydo progimnazija";PRIEŠMOKYKLINĖ;34352165481;Taip;0;2;2;4
20956;"Vilniaus Martyno Mažvydo progimnazija";PRIEŠMOKYKLINĖ;1726899445;Taip;0;1;0;1
20957;"Vilniaus Martyno Mažvydo progimnazija";PRIEŠMOKYKLINĖ;15196087730;Taip;0;1;0;1
20958;"Vilniaus Martyno Mažvydo progimnazija";PRIEŠMOKYKLINĖ;4134546404;Ne;5;1;0;6
