Nr.;"Darželio pavadinimas";"Grupės pavadinimas";"Vaiko Identifikacinis Nr.";"Deklaruotas mieste";"Pateisintos dėl ligos";"Pateisintos dėl kitų priežasčių";"Nepateisintos dienos";"Praleistos dienos Viso"
1;Aitvaras;"VIJURKAI (ALERG.)";1795308718;Taip;3;0;1;4
2;Aitvaras;"VIJURKAI (ALERG.)";9649742132;Taip;0;10;0;10
3;Aitvaras;"VIJURKAI (ALERG.)";84922258988;Taip;9;6;0;15
4;Aitvaras;"VIJURKAI (ALERG.)";1201862001;Ne;18;0;0;18
5;Aitvaras;"VIJURKAI (ALERG.)";8970519668;Ne;11;3;0;14
6;Aitvaras;"VIJURKAI (ALERG.)";1621302802;Taip;0;14;0;14
7;Aitvaras;"VIJURKAI (ALERG.)";94080483856;Taip;6;6;0;12
8;Aitvaras;"VIJURKAI (ALERG.)";5083382326;Taip;0;2;0;2
9;Aitvaras;"VIJURKAI (ALERG.)";1834535594;Taip;5;0;0;5
10;Aitvaras;"VIJURKAI (ALERG.)";7083046536;Taip;5;0;0;5
11;Aitvaras;"VIJURKAI (ALERG.)";1773366241;Taip;8;0;0;8
12;Aitvaras;"VIJURKAI (ALERG.)";1553462849;Ne;0;4;0;4
13;Aitvaras;"VIJURKAI (ALERG.)";1398792964;Taip;0;11;0;11
14;Aitvaras;"VIJURKAI (ALERG.)";5770779699;Taip;4;1;0;5
15;Aitvaras;"VIJURKAI (ALERG.)";2159901439;Taip;0;4;0;4
16;Aitvaras;"VIJURKAI (ALERG.)";3716313515;Taip;0;4;0;4
17;Aitvaras;"VIJURKAI (ALERG.)";8366627546;Taip;9;9;0;18
18;Aitvaras;"VIJURKAI (ALERG.)";1481849611;Taip;0;5;2;7
19;Aitvaras;"VIJURKAI (ALERG.)";1090979323;Taip;0;0;1;1
20;Aitvaras;"SMALSUČIAI (ALERG.)";85826303673;Ne;3;0;0;3
21;Aitvaras;"SMALSUČIAI (ALERG.)";7592535089;Taip;9;4;0;13
22;Aitvaras;"SMALSUČIAI (ALERG.)";9845539641;Ne;0;10;0;10
23;Aitvaras;"SMALSUČIAI (ALERG.)";44139920757;Ne;0;4;0;4
24;Aitvaras;"SMALSUČIAI (ALERG.)";3001619281;Taip;8;8;0;16
25;Aitvaras;"SMALSUČIAI (ALERG.)";4708741626;Taip;0;6;0;6
26;Aitvaras;"SMALSUČIAI (ALERG.)";1301667420;Taip;0;15;0;15
27;Aitvaras;"SMALSUČIAI (ALERG.)";47686798724;Taip;0;6;0;6
28;Aitvaras;"SMALSUČIAI (ALERG.)";1892295973;Ne;0;6;0;6
29;Aitvaras;"SMALSUČIAI (ALERG.)";89623351867;Taip;0;5;0;5
30;Aitvaras;"SMALSUČIAI (ALERG.)";5204534227;Taip;0;5;0;5
31;Aitvaras;"SMALSUČIAI (ALERG.)";2674192321;Taip;0;8;4;12
32;Aitvaras;"SMALSUČIAI (ALERG.)";37391225613;Taip;0;7;0;7
33;Aitvaras;"SMALSUČIAI (ALERG.)";36359228257;Taip;7;4;0;11
34;Aitvaras;"SMALSUČIAI (ALERG.)";31074942686;Taip;0;9;0;9
35;Aitvaras;"SMALSUČIAI (ALERG.)";13670186807;Taip;19;0;1;20
36;Aitvaras;"SMALSUČIAI (ALERG.)";76280361479;Taip;0;4;0;4
37;Aitvaras;"SMALSUČIAI (ALERG.)";85103026654;Taip;0;3;0;3
38;Aitvaras;"SMALSUČIAI (ALERG.)";12962784212;Ne;0;7;0;7
39;Aitvaras;"SMALSUČIAI (ALERG.)";14251469975;Taip;9;4;0;13
40;Aitvaras;PADAUŽIUKAI;75662895254;Taip;0;9;0;9
41;Aitvaras;PADAUŽIUKAI;46998364516;Taip;0;5;0;5
42;Aitvaras;PADAUŽIUKAI;1355296093;Taip;5;4;1;10
43;Aitvaras;PADAUŽIUKAI;54438500410;Taip;0;1;0;1
44;Aitvaras;PADAUŽIUKAI;1476238636;Taip;0;2;0;2
45;Aitvaras;PADAUŽIUKAI;1641140396;Ne;5;5;0;10
46;Aitvaras;PADAUŽIUKAI;2136550853;Ne;0;11;2;13
47;Aitvaras;PADAUŽIUKAI;64683090780;Ne;0;6;7;13
48;Aitvaras;PADAUŽIUKAI;87846069433;Taip;0;6;1;7
49;Aitvaras;PADAUŽIUKAI;30517554931;Taip;10;4;0;14
50;Aitvaras;PADAUŽIUKAI;1850900990;Taip;0;5;0;5
51;Aitvaras;PADAUŽIUKAI;69145890005;Taip;0;1;0;1
52;Aitvaras;PADAUŽIUKAI;89194677727;Taip;4;4;4;12
53;Aitvaras;PADAUŽIUKAI;45833790181;Taip;1;4;0;5
54;Aitvaras;PADAUŽIUKAI;1371102633;Taip;8;6;0;14
55;Aitvaras;PADAUŽIUKAI;24017694836;Taip;5;4;0;9
56;Aitvaras;PADAUŽIUKAI;2092431875;Taip;0;4;0;4
57;Aitvaras;PADAUŽIUKAI;12216502128;Taip;0;2;0;2
58;Aitvaras;PADAUŽIUKAI;64205113506;Taip;0;6;2;8
59;Aitvaras;PADAUŽIUKAI;1315081684;Taip;0;4;1;5
60;Aitvaras;PADAUŽIUKAI;25117529505;Taip;0;5;0;5
61;Aitvaras;PADAUŽIUKAI;403821197;Taip;0;4;0;4
62;Aitvaras;"AITVARIUKAI (ALERG.)";1542575012;Taip;4;2;1;7
63;Aitvaras;"AITVARIUKAI (ALERG.)";1223627682;Taip;0;6;0;6
64;Aitvaras;"AITVARIUKAI (ALERG.)";3471031093;Taip;9;0;0;9
65;Aitvaras;"AITVARIUKAI (ALERG.)";9810370596;Taip;3;8;0;11
66;Aitvaras;"AITVARIUKAI (ALERG.)";34735287315;Taip;7;4;0;11
67;Aitvaras;"AITVARIUKAI (ALERG.)";4833313373;Taip;8;0;0;8
68;Aitvaras;"AITVARIUKAI (ALERG.)";84919478493;Taip;5;0;0;5
69;Aitvaras;"AITVARIUKAI (ALERG.)";9745864667;Taip;4;5;0;9
70;Aitvaras;"AITVARIUKAI (ALERG.)";5389627560;Taip;7;0;0;7
71;Aitvaras;"AITVARIUKAI (ALERG.)";5956333024;Taip;0;5;0;5
72;Aitvaras;"AITVARIUKAI (ALERG.)";1636794584;Taip;11;2;0;13
73;Aitvaras;"AITVARIUKAI (ALERG.)";2953536545;Taip;2;4;0;6
74;Aitvaras;"AITVARIUKAI (ALERG.)";3535659630;Taip;0;3;0;3
75;Aitvaras;"AITVARIUKAI (ALERG.)";3488467265;Taip;3;4;0;7
76;Aitvaras;"AITVARIUKAI (ALERG.)";2566375128;Taip;0;3;0;3
77;Aitvaras;"AITVARIUKAI (ALERG.)";6356432078;Taip;0;4;0;4
78;Aitvaras;"AITVARIUKAI (ALERG.)";3639102842;Taip;0;6;0;6
79;Aitvaras;"AITVARIUKAI (ALERG.)";7243387750;Taip;14;3;0;17
80;Aitvaras;"AITVARIUKAI (ALERG.)";6587437949;Taip;2;9;0;11
81;Aitvaras;"AITVARIUKAI (ALERG.)";7461284958;Taip;5;4;0;9
82;Aitvaras;"SAULĖS ZUIKUČIAI  (ALERG.)";1019661577;Taip;0;2;0;2
83;Aitvaras;"SAULĖS ZUIKUČIAI  (ALERG.)";55369747065;Ne;9;2;0;11
84;Aitvaras;"SAULĖS ZUIKUČIAI  (ALERG.)";837021325;Taip;5;3;0;8
85;Aitvaras;"SAULĖS ZUIKUČIAI  (ALERG.)";1207249857;Taip;0;6;5;11
86;Aitvaras;"SAULĖS ZUIKUČIAI  (ALERG.)";30174058452;Taip;0;3;0;3
87;Aitvaras;"SAULĖS ZUIKUČIAI  (ALERG.)";24247118884;Taip;3;5;0;8
88;Aitvaras;"SAULĖS ZUIKUČIAI  (ALERG.)";1516018865;Taip;0;14;0;14
89;Aitvaras;"SAULĖS ZUIKUČIAI  (ALERG.)";1392528718;Taip;0;4;0;4
90;Aitvaras;"SAULĖS ZUIKUČIAI  (ALERG.)";2021772475;Ne;5;0;0;5
91;Aitvaras;"SAULĖS ZUIKUČIAI  (ALERG.)";1872130301;Taip;2;4;0;6
92;Aitvaras;"SAULĖS ZUIKUČIAI  (ALERG.)";6745376381;Taip;5;1;0;6
93;Aitvaras;"SAULĖS ZUIKUČIAI  (ALERG.)";3433178644;Ne;2;4;0;6
94;Aitvaras;"SAULĖS ZUIKUČIAI  (ALERG.)";69352006024;Taip;0;12;0;12
95;Aitvaras;"SAULĖS ZUIKUČIAI  (ALERG.)";2083332491;Ne;0;2;0;2
96;Aitvaras;"SAULĖS ZUIKUČIAI  (ALERG.)";61721665912;Taip;3;6;0;9
97;Aitvaras;"SAULĖS ZUIKUČIAI  (ALERG.)";6238828251;Taip;0;0;14;14
98;Aitvaras;"SAULĖS ZUIKUČIAI  (ALERG.)";1877245088;Taip;0;5;0;5
99;Aitvaras;"SAULĖS ZUIKUČIAI  (ALERG.)";5619137905;Taip;4;3;0;7
100;Aitvaras;"SAULĖS ZUIKUČIAI  (ALERG.)";4426643908;Taip;0;2;0;2
101;Aitvaras;"ŽEMYNUKAI (ALERG.)";1652681820;Taip;3;6;0;9
102;Aitvaras;"ŽEMYNUKAI (ALERG.)";6166757095;Taip;5;0;7;12
103;Aitvaras;"ŽEMYNUKAI (ALERG.)";5595233402;Taip;9;0;0;9
104;Aitvaras;"ŽEMYNUKAI (ALERG.)";2650483861;Taip;0;6;5;11
105;Aitvaras;"ŽEMYNUKAI (ALERG.)";5922357091;Ne;8;6;1;15
106;Aitvaras;"ŽEMYNUKAI (ALERG.)";6951219468;Taip;0;2;1;3
107;Aitvaras;"ŽEMYNUKAI (ALERG.)";4868552034;Taip;0;2;0;2
108;Aitvaras;"ŽEMYNUKAI (ALERG.)";1494094426;Taip;0;11;0;11
109;Aitvaras;"ŽEMYNUKAI (ALERG.)";9562494357;Taip;18;0;0;18
110;Aitvaras;"ŽEMYNUKAI (ALERG.)";6021342178;Taip;12;3;0;15
111;Aitvaras;"ŽEMYNUKAI (ALERG.)";9142513631;Taip;0;17;0;17
112;Aitvaras;"ŽEMYNUKAI (ALERG.)";2737503753;Taip;19;0;0;19
113;Aitvaras;"ŽEMYNUKAI (ALERG.)";4480921300;Taip;16;0;1;17
114;Aitvaras;"ŽEMYNUKAI (ALERG.)";8567255042;Ne;10;4;0;14
115;Aitvaras;"ŽEMYNUKAI (ALERG.)";6218019092;Taip;15;0;2;17
116;Aitvaras;"ŽEMYNUKAI (ALERG.)";7560642918;Taip;13;0;0;13
117;Aitvaras;"ŽEMYNUKAI (ALERG.)";3820930777;Taip;19;1;0;20
118;Aitvaras;"ŽEMYNUKAI (ALERG.)";6624986090;Taip;17;0;0;17
119;Aitvaras;"ŽEMYNUKAI (ALERG.)";4733627644;Taip;2;6;3;11
120;Aitvaras;"ŽEMYNUKAI (ALERG.)";3104109370;Taip;0;4;3;7
121;Aitvaras;"LINKSMUČIAI (ALERG.)";5238819066;Taip;0;7;0;7
122;Aitvaras;"LINKSMUČIAI (ALERG.)";7109001184;Taip;3;0;1;4
123;Aitvaras;"LINKSMUČIAI (ALERG.)";5378212904;Ne;14;0;0;14
124;Aitvaras;"LINKSMUČIAI (ALERG.)";3655710511;Taip;6;0;0;6
125;Aitvaras;"LINKSMUČIAI (ALERG.)";1091372798;Taip;0;2;0;2
126;Aitvaras;"LINKSMUČIAI (ALERG.)";8666824607;Ne;0;2;3;5
127;Aitvaras;"LINKSMUČIAI (ALERG.)";5612991255;Taip;0;2;3;5
128;Aitvaras;"LINKSMUČIAI (ALERG.)";5330618557;Ne;18;0;0;18
129;Aitvaras;"LINKSMUČIAI (ALERG.)";5504431748;Taip;5;0;0;5
130;Aitvaras;"LINKSMUČIAI (ALERG.)";8178703988;Taip;10;0;0;10
131;Aitvaras;"LINKSMUČIAI (ALERG.)";7260577885;Taip;0;5;0;5
132;Aitvaras;"LINKSMUČIAI (ALERG.)";1599183050;Taip;11;0;0;11
133;Aitvaras;"LINKSMUČIAI (ALERG.)";1115202169;Ne;0;20;0;20
134;Aitvaras;"LINKSMUČIAI (ALERG.)";7029464687;Taip;6;4;0;10
135;Aitvaras;"LINKSMUČIAI (ALERG.)";4613894944;Taip;4;0;0;4
136;Aitvaras;"LINKSMUČIAI (ALERG.)";2760970218;Taip;4;0;0;4
137;Aitvaras;"LINKSMUČIAI (ALERG.)";4120515569;Taip;9;0;0;9
138;Aitvaras;"LINKSMUČIAI (ALERG.)";4564723798;Taip;12;0;0;12
139;Aitvaras;"LINKSMUČIAI (ALERG.)";4612994715;Taip;7;0;0;7
140;Aitvaras;NAMINUKAI;40344230133;Taip;0;0;2;2
141;Aitvaras;NAMINUKAI;1493048970;Ne;11;0;0;11
142;Aitvaras;NAMINUKAI;1306408890;Taip;0;6;0;6
143;Aitvaras;NAMINUKAI;59572108690;Taip;0;4;0;4
144;Aitvaras;NAMINUKAI;74628671065;Taip;0;4;4;8
145;Aitvaras;NAMINUKAI;70367340825;Taip;0;4;6;10
146;Aitvaras;NAMINUKAI;62126044317;Taip;0;10;0;10
147;Aitvaras;NAMINUKAI;1790437467;Taip;0;5;0;5
148;Aitvaras;NAMINUKAI;46021715174;Taip;0;4;2;6
149;Aitvaras;NAMINUKAI;85560586048;Taip;0;0;3;3
150;Aitvaras;NAMINUKAI;26906648835;Taip;3;9;0;12
151;Aitvaras;NAMINUKAI;1681260995;Taip;0;2;1;3
152;Aitvaras;NAMINUKAI;42556460388;Taip;0;4;0;4
153;Aitvaras;NAMINUKAI;54496602809;Ne;5;0;2;7
154;Aitvaras;NAMINUKAI;1487264184;Taip;0;0;3;3
155;Aitvaras;NAMINUKAI;97382092851;Taip;0;8;0;8
156;Aitvaras;NAMINUKAI;1886917840;Taip;0;10;0;10
157;Aitvaras;NAMINUKAI;6647800967;Ne;3;4;0;7
158;Aitvaras;NAMINUKAI;52679806772;Taip;1;0;0;1
159;Aitvaras;NAMINUKAI;5103057090;Taip;12;0;0;12
160;Aitvaras;NAMINUKAI;3836513736;Taip;0;0;4;4
161;Aitvaras;ŠELMIAI;9332771711;Ne;2;1;0;3
162;Aitvaras;ŠELMIAI;6550426644;Taip;7;4;0;11
163;Aitvaras;ŠELMIAI;5818794912;Taip;0;0;2;2
164;Aitvaras;ŠELMIAI;58780461337;Taip;0;5;0;5
165;Aitvaras;ŠELMIAI;1116271183;Taip;12;0;0;12
166;Aitvaras;ŠELMIAI;7469656671;Taip;6;1;0;7
167;Aitvaras;ŠELMIAI;2408952971;Taip;4;1;0;5
168;Aitvaras;ŠELMIAI;2330782717;Taip;4;0;0;4
169;Aitvaras;ŠELMIAI;47875842134;Taip;0;7;1;8
170;Aitvaras;ŠELMIAI;40799643122;Taip;0;6;0;6
171;Aitvaras;ŠELMIAI;8784628567;Taip;0;6;0;6
172;Aitvaras;ŠELMIAI;2601983670;Taip;0;7;0;7
173;Aitvaras;ŠELMIAI;1387254053;Taip;6;2;5;13
174;Aitvaras;ŠELMIAI;8503279655;Taip;5;5;0;10
175;Aitvaras;ŠELMIAI;1105354193;Taip;0;7;0;7
176;Aitvaras;ŠELMIAI;2034293999;Taip;19;0;3;22
177;Aitvaras;ŠELMIAI;2804106417;Taip;0;2;1;3
178;Aitvaras;ŠELMIAI;2711888522;Taip;0;2;1;3
179;Aitvaras;ŠELMIAI;1996524718;Taip;10;1;2;13
180;Aitvaras;ŠELMIAI;4110585744;Ne;0;8;0;8
181;Aitvaras;ŠELMIAI;6010324894;Taip;11;0;2;13
182;Aitvaras;KODĖLČIUKAI;6214572150;Taip;21;0;0;21
183;Aitvaras;KODĖLČIUKAI;8065540507;Taip;0;0;13;13
184;Aitvaras;KODĖLČIUKAI;1288810999;Taip;12;0;4;16
185;Aitvaras;KODĖLČIUKAI;6501943902;Taip;12;1;0;13
186;Aitvaras;KODĖLČIUKAI;4350590529;Taip;5;0;2;7
187;Aitvaras;KODĖLČIUKAI;7777235021;Ne;14;2;2;18
188;Aitvaras;KODĖLČIUKAI;5641224483;Taip;0;8;2;10
189;Aitvaras;KODĖLČIUKAI;1830134108;Taip;0;17;0;17
190;Aitvaras;KODĖLČIUKAI;8121858940;Taip;4;0;0;4
191;Aitvaras;KODĖLČIUKAI;2452780076;Taip;16;0;0;16
192;Aitvaras;KODĖLČIUKAI;3178965623;Taip;0;6;0;6
193;Aitvaras;KODĖLČIUKAI;5905456814;Ne;12;1;0;13
194;Aitvaras;KODĖLČIUKAI;1761446849;Taip;11;0;0;11
195;Aitvaras;KODĖLČIUKAI;6739827530;Taip;11;1;0;12
196;Aitvaras;KODĖLČIUKAI;2807595769;Ne;10;0;0;10
197;Aitvaras;KODĖLČIUKAI;1252145346;Taip;10;0;4;14
198;Aitvaras;KODĖLČIUKAI;7455895024;Taip;7;2;1;10
199;Aitvaras;KODĖLČIUKAI;8439586875;Taip;12;0;0;12
200;Aitvaras;PABIRUČIAI;8043062737;Taip;9;1;0;10
201;Aitvaras;PABIRUČIAI;9039303562;Taip;21;0;0;21
202;Aitvaras;PABIRUČIAI;6080549524;Taip;21;0;0;21
203;Aitvaras;PABIRUČIAI;6060880045;Taip;9;1;0;10
204;Aitvaras;PABIRUČIAI;1376605323;Taip;8;1;0;9
205;Aitvaras;PABIRUČIAI;4106097701;Taip;0;8;0;8
206;Aitvaras;PABIRUČIAI;8512502118;Taip;8;1;2;11
207;Aitvaras;PABIRUČIAI;3347213578;Taip;21;0;0;21
208;Aitvaras;PABIRUČIAI;3053557807;Taip;9;1;0;10
209;Aitvaras;PABIRUČIAI;2821221241;Ne;15;1;0;16
210;Aitvaras;PABIRUČIAI;9453994213;Taip;5;0;0;5
211;Aitvaras;PABIRUČIAI;6048701733;Taip;3;6;0;9
212;Aitvaras;PABIRUČIAI;9024245490;Taip;9;1;4;14
213;Aitvaras;PABIRUČIAI;6110226958;Taip;9;1;6;16
214;Aitvaras;PABIRUČIAI;6126913961;Taip;18;0;0;18
215;Aitvaras;"SVAJOKLIAI  (ALERG.)";1606267845;Taip;0;5;1;6
216;Aitvaras;"SVAJOKLIAI  (ALERG.)";5856250605;Taip;11;4;0;15
217;Aitvaras;"SVAJOKLIAI  (ALERG.)";2004112424;Taip;16;0;0;16
218;Aitvaras;"SVAJOKLIAI  (ALERG.)";6084096300;Taip;0;0;1;1
219;Aitvaras;"SVAJOKLIAI  (ALERG.)";5750154036;Taip;0;7;0;7
220;Aitvaras;"SVAJOKLIAI  (ALERG.)";6201118021;Taip;0;21;0;21
221;Aitvaras;"SVAJOKLIAI  (ALERG.)";3133031845;Ne;7;0;0;7
222;Aitvaras;"SVAJOKLIAI  (ALERG.)";1275561645;Ne;0;2;2;4
223;Aitvaras;"SVAJOKLIAI  (ALERG.)";1879540041;Taip;0;6;0;6
224;Aitvaras;"SVAJOKLIAI  (ALERG.)";1347364985;Taip;0;5;1;6
225;Aitvaras;"SVAJOKLIAI  (ALERG.)";5425259260;Taip;9;5;0;14
226;Aitvaras;"SVAJOKLIAI  (ALERG.)";9228736015;Taip;11;4;0;15
227;Aitvaras;"SVAJOKLIAI  (ALERG.)";9763502346;Taip;21;0;0;21
228;Aitvaras;"SVAJOKLIAI  (ALERG.)";7568388141;Taip;2;11;0;13
229;Aitvaras;"SVAJOKLIAI  (ALERG.)";4204923580;Taip;4;2;0;6
230;Aitvaras;"SVAJOKLIAI  (ALERG.)";1532588441;Ne;3;1;0;4
231;Aitvaras;"SVAJOKLIAI  (ALERG.)";8206046301;Taip;6;0;1;7
232;Aitvaras;"SVAJOKLIAI  (ALERG.)";6572235324;Taip;11;4;0;15
233;Aitvaras;"SVAJOKLIAI  (ALERG.)";3005447572;Taip;8;0;0;8
234;Aitvaras;"SVAJOKLIAI  (ALERG.)";1859647003;Taip;16;2;0;18
235;Atžalėlės;Gėlytės;5742471497;Taip;7;0;1;8
236;Atžalėlės;Gėlytės;4284673729;Ne;2;18;0;20
237;Atžalėlės;Gėlytės;8695865604;Ne;0;11;0;11
238;Atžalėlės;Gėlytės;1137741059;Taip;2;0;0;2
239;Atžalėlės;Gėlytės;2385614957;Taip;5;1;3;9
240;Atžalėlės;Gėlytės;5432433423;Taip;0;0;1;1
241;Atžalėlės;Gėlytės;9715625283;Taip;12;4;0;16
242;Atžalėlės;Gėlytės;6024189665;Taip;7;0;1;8
243;Atžalėlės;Gėlytės;4682216852;Ne;0;0;7;7
244;Atžalėlės;Gėlytės;4238773173;Taip;0;4;2;6
245;Atžalėlės;Gėlytės;2131592139;Taip;6;6;0;12
246;Atžalėlės;Gėlytės;3191066669;Taip;16;0;0;16
247;Atžalėlės;Gėlytės;1500456945;Taip;0;0;3;3
248;Atžalėlės;Gėlytės;6177038838;Taip;0;4;1;5
249;Atžalėlės;Gėlytės;1722233272;Taip;9;7;0;16
250;Atžalėlės;Gėlytės;5310990513;Taip;0;4;1;5
251;Atžalėlės;Gėlytės;7702502252;Taip;0;15;0;15
252;Atžalėlės;Gėlytės;9189223222;Taip;0;13;0;13
253;Atžalėlės;Gėlytės;3283415814;Taip;0;1;0;1
254;Atžalėlės;Gėlytės;1146492807;Taip;4;0;8;12
255;Atžalėlės;Gėlytės;3870758086;Taip;0;4;0;4
256;Atžalėlės;Gėlytės;1036410428;Taip;0;2;0;2
257;Atžalėlės;Gėlytės;1450609695;Taip;0;6;0;6
258;Atžalėlės;Gėlytės;6202250600;Taip;10;0;3;13
259;Atžalėlės;Drugeliai;4643154006;Taip;2;4;0;6
260;Atžalėlės;Drugeliai;6903666624;Taip;7;6;0;13
261;Atžalėlės;Drugeliai;4902947406;Taip;4;3;0;7
262;Atžalėlės;Drugeliai;6570245757;Taip;5;2;1;8
263;Atžalėlės;Drugeliai;6132569107;Taip;10;0;0;10
264;Atžalėlės;Drugeliai;2315790531;Ne;0;8;0;8
265;Atžalėlės;Drugeliai;6782007470;Taip;0;2;8;10
266;Atžalėlės;Drugeliai;8393217418;Taip;10;5;0;15
267;Atžalėlės;Drugeliai;1805496887;Taip;5;0;9;14
268;Atžalėlės;Drugeliai;9463215947;Taip;0;1;0;1
269;Atžalėlės;Drugeliai;7953922166;Taip;2;5;0;7
270;Atžalėlės;Drugeliai;9222670655;Taip;0;9;0;9
271;Atžalėlės;Drugeliai;77261118958;Taip;0;5;1;6
272;Atžalėlės;Drugeliai;1429493246;Taip;8;8;0;16
273;Atžalėlės;Drugeliai;6114426973;Taip;14;4;0;18
274;Atžalėlės;Drugeliai;1456979448;Taip;0;12;0;12
275;Atžalėlės;Drugeliai;3571134734;Ne;14;5;0;19
276;Atžalėlės;Gandriukai;28910361902;Taip;0;8;0;8
277;Atžalėlės;Gandriukai;32154742975;Taip;1;0;0;1
278;Atžalėlės;Gandriukai;93452036571;Taip;6;7;0;13
279;Atžalėlės;Gandriukai;4483002806;Ne;4;0;8;12
280;Atžalėlės;Gandriukai;16442821393;Taip;0;6;0;6
281;Atžalėlės;Gandriukai;1197205716;Taip;5;0;0;5
282;Atžalėlės;Gandriukai;70694002130;Taip;6;0;3;9
283;Atžalėlės;Gandriukai;87334806437;Taip;0;4;0;4
284;Atžalėlės;Gandriukai;1204800605;Taip;0;9;0;9
285;Atžalėlės;Gandriukai;1074259644;Taip;6;5;0;11
286;Atžalėlės;Gandriukai;66107666615;Taip;5;0;0;5
287;Atžalėlės;Gandriukai;2124150483;Taip;0;7;0;7
288;Atžalėlės;Gandriukai;63867153552;Taip;0;15;0;15
289;Atžalėlės;Gandriukai;82049064201;Taip;0;0;1;1
290;Atžalėlės;Gandriukai;78120202936;Taip;11;0;0;11
291;Atžalėlės;Gandriukai;1011601294;Taip;0;9;0;9
292;Atžalėlės;Gandriukai;1299048195;Taip;5;4;0;9
293;Atžalėlės;Gandriukai;54869610865;Taip;0;4;0;4
294;Atžalėlės;Gandriukai;80500800894;Taip;5;4;5;14
295;Atžalėlės;Gandriukai;519493490;Ne;9;3;0;12
296;Atžalėlės;Gandriukai;82777644548;Taip;2;4;10;16
297;Atžalėlės;Gandriukai;23453799177;Taip;9;0;0;9
298;Atžalėlės;Gandriukai;78664848612;Taip;4;1;0;5
299;Atžalėlės;Voveriukai;52803011399;Taip;0;4;0;4
300;Atžalėlės;Voveriukai;30370285022;Taip;0;8;0;8
301;Atžalėlės;Voveriukai;1447259034;Taip;0;5;0;5
302;Atžalėlės;Voveriukai;64596277701;Taip;7;3;0;10
303;Atžalėlės;Voveriukai;3379307367;Taip;0;4;5;9
304;Atžalėlės;Voveriukai;62325712598;Taip;5;4;0;9
305;Atžalėlės;Voveriukai;1312772153;Taip;0;4;0;4
306;Atžalėlės;Voveriukai;6975941393;Taip;0;1;0;1
307;Atžalėlės;Voveriukai;1865339755;Taip;0;0;7;7
308;Atžalėlės;Voveriukai;8138683218;Taip;0;8;0;8
309;Atžalėlės;Voveriukai;4467364336;Taip;0;5;4;9
310;Atžalėlės;Voveriukai;1804802235;Taip;2;4;0;6
311;Atžalėlės;Voveriukai;1316154666;Taip;0;4;1;5
312;Atžalėlės;Voveriukai;9699811980;Taip;0;13;0;13
313;Atžalėlės;Voveriukai;8847754477;Taip;0;8;0;8
314;Atžalėlės;Voveriukai;7689394485;Taip;7;0;0;7
315;Atžalėlės;Voveriukai;2013707106;Taip;4;2;0;6
316;Atžalėlės;Voveriukai;2757744826;Ne;4;8;0;12
317;Atžalėlės;Voveriukai;3795729265;Taip;2;0;5;7
318;Atžalėlės;Voveriukai;8201582382;Taip;6;4;1;11
319;Atžalėlės;Voveriukai;4362058013;Taip;6;4;1;11
320;Atžalėlės;Voveriukai;51586822606;Taip;0;4;4;8
321;Atžalėlės;Voveriukai;8819893830;Ne;2;0;10;12
322;Atžalėlės;Žirniukai;4098210138;Ne;0;0;6;6
323;Atžalėlės;Žirniukai;7807313362;Taip;7;0;1;8
324;Atžalėlės;Žirniukai;4081717007;Taip;16;0;0;16
325;Atžalėlės;Žirniukai;9977104915;Taip;5;5;1;11
326;Atžalėlės;Žirniukai;6265777690;Taip;0;11;0;11
327;Atžalėlės;Žirniukai;7321516783;Taip;21;0;0;21
328;Atžalėlės;Žirniukai;6537864486;Taip;8;0;4;12
329;Atžalėlės;Žirniukai;8768704484;Taip;20;0;1;21
330;Atžalėlės;Žirniukai;6675588261;Taip;18;0;3;21
331;Atžalėlės;Žirniukai;1844980319;Ne;4;3;1;8
332;Atžalėlės;Žirniukai;5997958773;Ne;4;3;1;8
333;Atžalėlės;Žirniukai;8524244526;Ne;8;4;9;21
334;Atžalėlės;Žirniukai;1704679306;Taip;0;5;4;9
335;Atžalėlės;Žirniukai;7356877676;Taip;3;6;0;9
336;Atžalėlės;Žirniukai;6873507667;Taip;0;0;2;2
337;Atžalėlės;Žirniukai;2374624441;Taip;0;11;0;11
338;Atžalėlės;Ežiukai;8619613890;Taip;3;0;2;5
339;Atžalėlės;Ežiukai;8586739429;Taip;5;0;0;5
340;Atžalėlės;Ežiukai;1423254771;Taip;4;4;0;8
341;Atžalėlės;Ežiukai;3281114596;Taip;21;0;0;21
342;Atžalėlės;Ežiukai;1431197358;Taip;9;0;1;10
343;Atžalėlės;Ežiukai;4177753994;Taip;0;0;3;3
344;Atžalėlės;Ežiukai;3982090601;Taip;10;0;3;13
345;Atžalėlės;Ežiukai;9925178685;Taip;0;0;5;5
346;Atžalėlės;Ežiukai;2617568019;Taip;7;0;4;11
347;Atžalėlės;Ežiukai;8512283024;Taip;8;0;0;8
348;Atžalėlės;Ežiukai;4233689945;Taip;7;0;2;9
349;Atžalėlės;Ežiukai;9053620501;Taip;12;0;0;12
350;Atžalėlės;Ežiukai;8508450500;Taip;7;6;0;13
351;Atžalėlės;Ežiukai;3743308789;Taip;4;0;2;6
352;Atžalėlės;Ežiukai;2339599448;Ne;5;4;0;9
353;Atžalėlės;Paukšteliai;77693032830;Ne;0;14;0;14
354;Atžalėlės;Paukšteliai;99097316080;Taip;4;4;0;8
355;Atžalėlės;Paukšteliai;1576891322;Ne;3;4;0;7
356;Atžalėlės;Paukšteliai;18833055728;Taip;0;4;5;9
357;Atžalėlės;Paukšteliai;72360139252;Taip;2;12;0;14
358;Atžalėlės;Paukšteliai;54417643140;Taip;0;5;0;5
359;Atžalėlės;Paukšteliai;88525056192;Taip;0;0;7;7
360;Atžalėlės;Paukšteliai;30452835434;Taip;0;4;1;5
361;Atžalėlės;Paukšteliai;1046971571;Taip;3;4;5;12
362;Atžalėlės;Paukšteliai;71490200980;Taip;0;4;1;5
363;Atžalėlės;Paukšteliai;93709702327;Taip;0;0;1;1
364;Atžalėlės;Paukšteliai;90664899396;Taip;12;2;0;14
365;Atžalėlės;Paukšteliai;35472285094;Taip;0;4;0;4
366;Atžalėlės;Paukšteliai;93762990685;Taip;0;2;1;3
367;Atžalėlės;Paukšteliai;42752976301;Taip;0;4;8;12
368;Atžalėlės;Paukšteliai;27330226432;Ne;0;4;5;9
369;Atžalėlės;Paukšteliai;1714011798;Taip;0;4;0;4
370;Atžalėlės;Paukšteliai;57459192709;Ne;7;4;0;11
371;Atžalėlės;Paukšteliai;5438129052;Taip;0;2;7;9
372;Atžalėlės;Paukšteliai;1772202805;Taip;5;4;3;12
373;Atžalėlės;Paukšteliai;1063718923;Taip;0;2;0;2
374;Atžalėlės;Meškiukai;26878092629;Taip;0;10;0;10
375;Atžalėlės;Meškiukai;1083996834;Taip;0;11;0;11
376;Atžalėlės;Meškiukai;53385285795;Ne;5;4;0;9
377;Atžalėlės;Meškiukai;57197465236;Taip;0;4;3;7
378;Atžalėlės;Meškiukai;96954269567;Taip;0;4;1;5
379;Atžalėlės;Meškiukai;91094623082;Taip;0;5;0;5
380;Atžalėlės;Meškiukai;52163840804;Taip;6;4;0;10
381;Atžalėlės;Meškiukai;97667536161;Taip;0;11;0;11
382;Atžalėlės;Meškiukai;32165722689;Taip;5;3;0;8
383;Atžalėlės;Meškiukai;59994970570;Taip;10;4;3;17
384;Atžalėlės;Meškiukai;60841336326;Taip;2;3;2;7
385;Atžalėlės;Meškiukai;83433461267;Taip;0;7;0;7
386;Atžalėlės;Meškiukai;78909909613;Ne;11;4;0;15
387;Atžalėlės;Meškiukai;46263888918;Taip;0;16;0;16
388;Atžalėlės;Meškiukai;7315734265;Taip;0;6;1;7
389;Atžalėlės;Meškiukai;30776087985;Taip;3;4;2;9
390;Atžalėlės;Meškiukai;74153703568;Taip;5;4;0;9
391;Atžalėlės;Meškiukai;939302682;Taip;3;4;0;7
392;Atžalėlės;Meškiukai;40388417436;Taip;3;5;0;8
393;Atžalėlės;Meškiukai;45860181171;Taip;5;4;0;9
394;Atžalėlės;Meškiukai;1512766841;Taip;2;4;1;7
395;Atžalėlės;Meškiukai;76280495364;Taip;0;7;0;7
396;Atžalėlės;Meškiukai;1448431632;Taip;0;8;0;8
397;Atžalėlės;Meškiukai;4702130326;Taip;0;7;0;7
398;Aušrelė;PASAKIUKAI;2974714806;Ne;3;7;0;10
399;Aušrelė;PASAKIUKAI;1327431679;Taip;6;2;0;8
400;Aušrelė;PASAKIUKAI;8960462835;Taip;3;6;2;11
401;Aušrelė;PASAKIUKAI;6037757548;Taip;0;5;0;5
402;Aušrelė;PASAKIUKAI;7682402576;Taip;0;7;0;7
403;Aušrelė;PASAKIUKAI;1408751702;Taip;0;14;0;14
404;Aušrelė;PASAKIUKAI;6995749373;Taip;8;7;0;15
405;Aušrelė;PASAKIUKAI;8372554796;Taip;0;2;0;2
406;Aušrelė;PASAKIUKAI;1502146844;Ne;0;1;0;1
407;Aušrelė;PASAKIUKAI;8341539501;Taip;0;5;3;8
408;Aušrelė;PASAKIUKAI;8230362307;Taip;0;4;0;4
409;Aušrelė;PASAKIUKAI;9440600785;Taip;2;13;0;15
410;Aušrelė;PASAKIUKAI;91282753561;Taip;10;5;0;15
411;Aušrelė;PASAKIUKAI;4306578299;Taip;4;9;0;13
412;Aušrelė;PASAKIUKAI;5777214701;Taip;17;1;0;18
413;Aušrelė;PASAKIUKAI;6277405405;Taip;0;13;0;13
414;Aušrelė;PASAKIUKAI;3682523696;Taip;2;1;0;3
415;Aušrelė;PASAKIUKAI;6909708079;Ne;2;5;1;8
416;Aušrelė;BORUŽĖLĖS;6673034329;Ne;9;1;0;10
417;Aušrelė;BORUŽĖLĖS;4957581753;Ne;9;0;0;9
418;Aušrelė;BORUŽĖLĖS;3165692699;Ne;11;0;0;11
419;Aušrelė;BORUŽĖLĖS;1928260563;Taip;10;3;0;13
420;Aušrelė;BORUŽĖLĖS;2626569015;Taip;10;4;2;16
421;Aušrelė;BORUŽĖLĖS;2574681867;Taip;0;4;17;21
422;Aušrelė;BORUŽĖLĖS;1543314096;Taip;12;0;1;13
423;Aušrelė;BORUŽĖLĖS;6084682084;Taip;15;2;0;17
424;Aušrelė;BORUŽĖLĖS;8243716759;Taip;0;4;2;6
425;Aušrelė;BORUŽĖLĖS;6886505025;Taip;0;11;0;11
426;Aušrelė;BORUŽĖLĖS;3206495858;Taip;10;4;0;14
427;Aušrelė;BORUŽĖLĖS;7861208185;Taip;10;4;0;14
428;Aušrelė;BORUŽĖLĖS;1549962200;Taip;2;5;0;7
429;Aušrelė;BORUŽĖLĖS;4505922394;Taip;0;4;5;9
430;Aušrelė;BORUŽĖLĖS;4895872593;Taip;12;0;0;12
431;Aušrelė;BORUŽĖLĖS;1582618217;Taip;0;9;0;9
432;Aušrelė;BORUŽĖLĖS;7190665397;Taip;13;0;4;17
433;Aušrelė;BORUŽĖLĖS;2991828434;Taip;17;0;0;17
434;Aušrelė;SMALSUČIAI;76459345433;Ne;0;6;0;6
435;Aušrelė;SMALSUČIAI;17931731597;Taip;0;9;0;9
436;Aušrelė;SMALSUČIAI;8572216200;Taip;0;9;0;9
437;Aušrelė;SMALSUČIAI;74365190360;Taip;0;1;0;1
438;Aušrelė;SMALSUČIAI;1951435363;Taip;0;2;0;2
439;Aušrelė;SMALSUČIAI;3392276890;Taip;4;4;2;10
440;Aušrelė;SMALSUČIAI;14080739740;Taip;0;6;0;6
441;Aušrelė;SMALSUČIAI;73050137188;Taip;0;14;0;14
442;Aušrelė;SMALSUČIAI;49563719275;Taip;0;4;0;4
443;Aušrelė;SMALSUČIAI;7859894371;Taip;0;13;0;13
444;Aušrelė;SMALSUČIAI;1883795851;Taip;0;12;0;12
445;Aušrelė;SMALSUČIAI;68223308125;Ne;0;4;6;10
446;Aušrelė;SMALSUČIAI;90185478786;Taip;0;5;0;5
447;Aušrelė;SMALSUČIAI;26235102809;Taip;0;5;0;5
448;Aušrelė;SMALSUČIAI;42158121278;Taip;15;4;0;19
449;Aušrelė;SMALSUČIAI;78823564616;Taip;0;15;0;15
450;Aušrelė;SMALSUČIAI;1944021609;Taip;8;4;0;12
451;Aušrelė;SMALSUČIAI;1561253093;Taip;0;5;0;5
452;Aušrelė;SMALSUČIAI;1322089393;Taip;0;8;0;8
453;Aušrelė;SMALSUČIAI;94997479625;Ne;0;8;0;8
454;Aušrelė;KODĖLČIUKAI;12032618723;Taip;14;0;0;14
455;Aušrelė;KODĖLČIUKAI;75580617180;Taip;0;3;0;3
456;Aušrelė;KODĖLČIUKAI;24202090947;Ne;4;0;0;4
457;Aušrelė;KODĖLČIUKAI;50864528673;Ne;5;0;0;5
458;Aušrelė;KODĖLČIUKAI;2427329184;Taip;0;1;3;4
459;Aušrelė;KODĖLČIUKAI;24201363476;Taip;0;0;4;4
460;Aušrelė;KODĖLČIUKAI;39887348225;Taip;0;4;0;4
461;Aušrelė;KODĖLČIUKAI;1535153901;Taip;0;0;1;1
462;Aušrelė;KODĖLČIUKAI;63497657826;Taip;0;0;1;1
463;Aušrelė;KODĖLČIUKAI;8837069458;Taip;0;0;2;2
464;Aušrelė;KODĖLČIUKAI;36096756485;Taip;0;2;0;2
465;Aušrelė;KODĖLČIUKAI;1058114795;Taip;10;0;0;10
466;Aušrelė;KODĖLČIUKAI;19415824416;Taip;0;1;0;1
467;Aušrelė;KODĖLČIUKAI;4476948928;Taip;0;3;0;3
468;Aušrelė;KODĖLČIUKAI;44971525276;Taip;4;0;0;4
469;Aušrelė;KODĖLČIUKAI;26185247513;Taip;0;21;0;21
470;Aušrelė;KODĖLČIUKAI;9107952292;Taip;0;0;8;8
471;Aušrelė;KODĖLČIUKAI;58007820848;Taip;0;0;12;12
472;Aušrelė;PELĖDŽIUKAI;34891640909;Taip;0;7;0;7
473;Aušrelė;PELĖDŽIUKAI;5955421544;Ne;2;4;0;6
474;Aušrelė;PELĖDŽIUKAI;1706417053;Taip;6;0;1;7
475;Aušrelė;PELĖDŽIUKAI;31441512644;Taip;0;6;0;6
476;Aušrelė;PELĖDŽIUKAI;2030362509;Taip;0;8;0;8
477;Aušrelė;PELĖDŽIUKAI;1296552763;Taip;6;1;4;11
478;Aušrelė;PELĖDŽIUKAI;1160772086;Taip;21;0;0;21
479;Aušrelė;PELĖDŽIUKAI;1352195876;Taip;0;0;1;1
480;Aušrelė;PELĖDŽIUKAI;1599595256;Taip;0;6;0;6
481;Aušrelė;PELĖDŽIUKAI;2125080379;Taip;0;4;0;4
482;Aušrelė;PELĖDŽIUKAI;1539176090;Taip;0;10;0;10
483;Aušrelė;PELĖDŽIUKAI;1225272131;Taip;0;0;1;1
484;Aušrelė;PELĖDŽIUKAI;1868818387;Taip;2;0;0;2
485;Aušrelė;PELĖDŽIUKAI;2987088389;Ne;0;4;3;7
486;Aušrelė;PELĖDŽIUKAI;1506444915;Taip;0;12;0;12
487;Aušrelė;PELĖDŽIUKAI;5304765447;Taip;5;1;0;6
488;Aušrelė;PELĖDŽIUKAI;85739624682;Taip;21;0;0;21
489;Aušrelė;PELĖDŽIUKAI;6837623034;Taip;0;0;1;1
490;Aušrelė;PELĖDŽIUKAI;3974308431;Ne;0;1;0;1
491;Aušrelė;PELĖDŽIUKAI;1549596452;Taip;2;4;1;7
492;Aušrelė;AITVARIUKAI;49583107808;Taip;14;4;0;18
493;Aušrelė;AITVARIUKAI;2045076279;Taip;0;4;0;4
494;Aušrelė;AITVARIUKAI;1153416324;Taip;0;21;0;21
495;Aušrelė;AITVARIUKAI;1340754039;Taip;0;5;0;5
496;Aušrelė;AITVARIUKAI;42721248496;Taip;0;11;0;11
497;Aušrelė;AITVARIUKAI;79695989966;Taip;0;12;0;12
498;Aušrelė;AITVARIUKAI;1045290039;Taip;0;9;0;9
499;Aušrelė;AITVARIUKAI;51119593813;Taip;0;5;0;5
500;Aušrelė;AITVARIUKAI;5813735533;Taip;4;0;0;4
501;Aušrelė;AITVARIUKAI;18117725053;Taip;5;4;0;9
502;Aušrelė;AITVARIUKAI;27629722512;Taip;0;9;0;9
503;Aušrelė;AITVARIUKAI;1830501248;Ne;0;5;0;5
504;Aušrelė;AITVARIUKAI;65369497777;Taip;0;21;0;21
505;Aušrelė;AITVARIUKAI;1388327674;Taip;0;4;0;4
506;Aušrelė;AITVARIUKAI;1750555187;Taip;0;5;0;5
507;Aušrelė;AITVARIUKAI;8221635058;Taip;0;7;0;7
508;Aušrelė;AITVARIUKAI;1163757003;Taip;9;7;0;16
509;Aušrelė;AITVARIUKAI;1792774415;Taip;0;2;0;2
510;Aušrelė;AITVARIUKAI;21234588466;Taip;15;4;0;19
511;Aušrelė;BITUTĖS;5670986879;Ne;0;7;0;7
512;Aušrelė;BITUTĖS;2096291405;Taip;0;4;0;4
513;Aušrelė;BITUTĖS;6519246290;Taip;13;4;0;17
514;Aušrelė;BITUTĖS;54807413055;Taip;0;1;0;1
515;Aušrelė;BITUTĖS;7915176432;Taip;0;5;0;5
516;Aušrelė;BITUTĖS;2085252423;Ne;0;10;0;10
517;Aušrelė;BITUTĖS;1680740501;Taip;0;1;0;1
518;Aušrelė;BITUTĖS;1666951645;Taip;10;2;0;12
519;Aušrelė;BITUTĖS;1372660806;Taip;6;5;0;11
520;Aušrelė;BITUTĖS;1958425979;Taip;3;1;0;4
521;Aušrelė;BITUTĖS;72441793163;Ne;5;5;0;10
522;Aušrelė;BITUTĖS;6604163285;Ne;0;18;0;18
523;Aušrelė;BITUTĖS;1177022224;Taip;0;4;0;4
524;Aušrelė;BITUTĖS;5176016947;Taip;5;4;5;14
525;Aušrelė;BITUTĖS;1306572766;Ne;0;0;12;12
526;Aušrelė;BITUTĖS;3326145998;Taip;11;0;8;19
527;Aušrelė;BITUTĖS;8086305564;Ne;7;0;0;7
528;Aušrelė;ŽIRNIUKAI;6761263775;Taip;6;5;0;11
529;Aušrelė;ŽIRNIUKAI;3015028879;Taip;0;4;0;4
530;Aušrelė;ŽIRNIUKAI;8503309819;Taip;8;5;0;13
531;Aušrelė;ŽIRNIUKAI;2827216981;Taip;6;2;0;8
532;Aušrelė;ŽIRNIUKAI;2852596989;Taip;0;18;3;21
533;Aušrelė;ŽIRNIUKAI;7930717076;Taip;9;4;0;13
534;Aušrelė;ŽIRNIUKAI;4942168388;Taip;0;21;0;21
535;Aušrelė;ŽIRNIUKAI;6507218940;Taip;0;4;0;4
536;Aušrelė;ŽIRNIUKAI;2266390402;Taip;0;12;0;12
537;Aušrelė;ŽIRNIUKAI;8032661062;Taip;0;2;1;3
538;Aušrelė;ŽIRNIUKAI;4262596104;Taip;7;5;0;12
539;Aušrelė;ŽIRNIUKAI;2390128933;Taip;5;0;0;5
540;Aušrelė;ŽIRNIUKAI;9443641849;Taip;10;3;0;13
541;Aušrelė;ŽIRNIUKAI;1556010005;Taip;8;0;0;8
542;Aušrelė;ŽIRNIUKAI;7609339123;Taip;17;4;0;21
543;Aušrelė;ŽIRNIUKAI;7070013052;Taip;8;0;0;8
544;Aušrelė;ŽIRNIUKAI;5478028396;Ne;15;4;0;19
545;Aušrelė;ŽIRNIUKAI;5935579452;Taip;5;4;0;9
546;Aušrelė;ŽIRNIUKAI;2863655361;Taip;12;4;0;16
547;Aušrelė;ŽIRNIUKAI;3581155949;Taip;6;4;0;10
548;Aušrelė;ŽIRNIUKAI;2766357229;Ne;12;0;0;12
549;Aušrelė;GRYBUKAI;6911735462;Taip;16;4;0;20
550;Aušrelė;GRYBUKAI;5712867880;Taip;7;1;0;8
551;Aušrelė;GRYBUKAI;6002434911;Taip;0;11;0;11
552;Aušrelė;GRYBUKAI;4288695809;Taip;0;1;0;1
553;Aušrelė;GRYBUKAI;3807967685;Taip;9;0;0;9
554;Aušrelė;GRYBUKAI;5312189552;Taip;9;4;0;13
555;Aušrelė;GRYBUKAI;7327544406;Ne;4;4;0;8
556;Aušrelė;GRYBUKAI;5046027475;Ne;0;17;0;17
557;Aušrelė;GRYBUKAI;9566144610;Taip;0;4;3;7
558;Aušrelė;GRYBUKAI;3320399046;Taip;5;2;0;7
559;Aušrelė;GRYBUKAI;7723159748;Taip;0;6;0;6
560;Aušrelė;GRYBUKAI;7367268748;Taip;0;8;0;8
561;Aušrelė;GRYBUKAI;2030555139;Taip;0;15;0;15
562;Aušrelė;GRYBUKAI;1976613166;Taip;0;6;0;6
563;Aušrelė;GRYBUKAI;8338569001;Taip;2;3;0;5
564;Aušrelė;GRYBUKAI;6186758486;Taip;0;5;0;5
565;Aušrelė;GRYBUKAI;4248808572;Taip;20;1;0;21
566;Aušrelė;GRYBUKAI;3623813061;Taip;0;12;0;12
567;Aušrelė;GRYBUKAI;8771154216;Taip;0;4;1;5
568;Aušrelė;GRYBUKAI;8693750994;Taip;16;0;0;16
569;Aušrelė;GRYBUKAI;6308519574;Taip;3;0;0;3
570;Aušrelė;DRUGELIAI;2468245186;Taip;0;10;0;10
571;Aušrelė;DRUGELIAI;8210698019;Taip;7;14;0;21
572;Aušrelė;DRUGELIAI;2545065554;Taip;2;0;0;2
573;Aušrelė;DRUGELIAI;8411336992;Taip;15;0;0;15
574;Aušrelė;DRUGELIAI;2656152037;Taip;19;0;0;19
575;Aušrelė;DRUGELIAI;8917907028;Taip;21;0;0;21
576;Aušrelė;DRUGELIAI;7494298336;Taip;14;0;0;14
577;Aušrelė;DRUGELIAI;4012186237;Taip;11;0;0;11
578;Aušrelė;DRUGELIAI;3738923947;Ne;21;0;0;21
579;Aušrelė;DRUGELIAI;1741716341;Taip;0;21;0;21
580;Aušrelė;DRUGELIAI;3223092149;Taip;0;12;0;12
581;Aušrelė;DRUGELIAI;8580241126;Taip;5;0;2;7
582;Aušrelė;DRUGELIAI;9244715396;Taip;21;0;0;21
583;Aušrelė;DRUGELIAI;4227228548;Taip;7;0;0;7
584;Aušrelė;DRUGELIAI;8996445434;Taip;8;0;0;8
585;Aušrelė;DRUGELIAI;6109859056;Ne;16;1;0;17
586;Aušrelė;NYKŠTUKAI;6434548772;Taip;21;0;0;21
587;Aušrelė;NYKŠTUKAI;4595435635;Taip;14;6;0;20
588;Aušrelė;NYKŠTUKAI;1458580523;Taip;16;0;0;16
589;Aušrelė;NYKŠTUKAI;9158248746;Taip;6;0;0;6
590;Aušrelė;NYKŠTUKAI;5708459561;Taip;19;0;0;19
591;Aušrelė;NYKŠTUKAI;5125295651;Taip;0;4;0;4
592;Aušrelė;NYKŠTUKAI;6833654667;Taip;9;0;1;10
593;Aušrelė;NYKŠTUKAI;6601922746;Taip;0;11;0;11
594;Aušrelė;NYKŠTUKAI;8661284187;Taip;20;0;0;20
595;Aušrelė;NYKŠTUKAI;8029484123;Taip;20;0;0;20
596;Aušrelė;NYKŠTUKAI;9733877752;Taip;14;4;0;18
597;Aušrelė;NYKŠTUKAI;9608444990;Taip;0;8;0;8
598;Aušrelė;NYKŠTUKAI;1081603034;Taip;0;16;0;16
599;Aušrelė;NYKŠTUKAI;2311552230;Taip;0;16;0;16
600;Aušrelė;NYKŠTUKAI;5602774323;Taip;12;0;0;12
601;Beržynėlis;SVIRPLIUKAI;29356394553;Taip;4;9;0;13
602;Beržynėlis;SVIRPLIUKAI;45685658789;Taip;0;3;0;3
603;Beržynėlis;SVIRPLIUKAI;7649359221;Taip;4;2;0;6
604;Beržynėlis;SVIRPLIUKAI;74856278886;Taip;6;4;0;10
605;Beržynėlis;SVIRPLIUKAI;1207208151;Taip;13;0;0;13
606;Beržynėlis;SVIRPLIUKAI;1895493234;Taip;9;1;0;10
607;Beržynėlis;SVIRPLIUKAI;1583090840;Taip;6;0;0;6
608;Beržynėlis;SVIRPLIUKAI;7289803632;Taip;10;2;0;12
609;Beržynėlis;SVIRPLIUKAI;1682929565;Taip;2;3;0;5
610;Beržynėlis;SVIRPLIUKAI;1612137286;Taip;9;1;0;10
611;Beržynėlis;SVIRPLIUKAI;71505149611;Taip;6;0;0;6
612;Beržynėlis;SVIRPLIUKAI;5196910604;Taip;7;2;0;9
613;Beržynėlis;SVIRPLIUKAI;1395819329;Taip;11;0;0;11
614;Beržynėlis;SVIRPLIUKAI;7248602510;Ne;12;1;0;13
615;Beržynėlis;SVIRPLIUKAI;3641421009;Ne;6;0;0;6
616;Beržynėlis;SVIRPLIUKAI;2791734213;Taip;9;0;0;9
617;Beržynėlis;SVIRPLIUKAI;9566341884;Taip;18;1;0;19
618;Beržynėlis;SVIRPLIUKAI;3278699117;Taip;13;2;0;15
619;Beržynėlis;SVIRPLIUKAI;1838631438;Taip;12;0;0;12
620;Beržynėlis;SVIRPLIUKAI;1639928056;Taip;14;1;0;15
621;Beržynėlis;SVIRPLIUKAI;2681482042;Taip;8;0;0;8
622;Beržynėlis;SVIRPLIUKAI;1136091326;Taip;7;0;0;7
623;Beržynėlis;SVIRPLIUKAI;1516309509;Taip;7;6;0;13
624;Beržynėlis;SVIRPLIUKAI;6395436937;Ne;14;0;0;14
625;Beržynėlis;PELEDŽIUKAI;9035951859;Ne;0;4;0;4
626;Beržynėlis;PELEDŽIUKAI;27071588761;Taip;0;0;9;9
627;Beržynėlis;PELEDŽIUKAI;69893760439;Taip;0;3;0;3
628;Beržynėlis;PELEDŽIUKAI;6082843533;Taip;0;4;0;4
629;Beržynėlis;PELEDŽIUKAI;23484694902;Taip;9;0;0;9
630;Beržynėlis;PELEDŽIUKAI;50686761208;Ne;6;0;5;11
631;Beržynėlis;PELEDŽIUKAI;6002421623;Ne;0;6;8;14
632;Beržynėlis;PELEDŽIUKAI;59717323779;Ne;0;4;0;4
633;Beržynėlis;PELEDŽIUKAI;73555363332;Taip;0;6;2;8
634;Beržynėlis;PELEDŽIUKAI;69508373227;Taip;0;6;10;16
635;Beržynėlis;PELEDŽIUKAI;80418262829;Taip;0;6;5;11
636;Beržynėlis;PELEDŽIUKAI;48768116923;Taip;7;0;1;8
637;Beržynėlis;PELEDŽIUKAI;87966535672;Taip;0;2;1;3
638;Beržynėlis;PELEDŽIUKAI;48258183822;Taip;0;2;4;6
639;Beržynėlis;PELEDŽIUKAI;19892724367;Taip;14;1;0;15
640;Beržynėlis;PELEDŽIUKAI;13290088644;Taip;0;2;0;2
641;Beržynėlis;PELEDŽIUKAI;75283423384;Taip;0;6;0;6
642;Beržynėlis;ŽIOGELIAI;1893270997;Taip;0;2;0;2
643;Beržynėlis;ŽIOGELIAI;7929997884;Ne;0;4;0;4
644;Beržynėlis;ŽIOGELIAI;5114301953;Taip;0;5;0;5
645;Beržynėlis;ŽIOGELIAI;5308596559;Taip;12;1;0;13
646;Beržynėlis;ŽIOGELIAI;4035764376;Taip;8;0;0;8
647;Beržynėlis;ŽIOGELIAI;4970999989;Taip;2;2;0;4
648;Beržynėlis;ŽIOGELIAI;1325972861;Taip;16;0;1;17
649;Beržynėlis;ŽIOGELIAI;8297427176;Taip;0;6;0;6
650;Beržynėlis;ŽIOGELIAI;8688852668;Taip;0;4;3;7
651;Beržynėlis;ŽIOGELIAI;9540292311;Taip;0;7;6;13
652;Beržynėlis;ŽIOGELIAI;9088059487;Taip;0;2;6;8
653;Beržynėlis;ŽIOGELIAI;6218165554;Taip;0;0;10;10
654;Beržynėlis;ŽIOGELIAI;5473666098;Taip;0;2;4;6
655;Beržynėlis;ŽIOGELIAI;8591800387;Taip;0;2;1;3
656;Beržynėlis;ŽIOGELIAI;6739927917;Taip;0;4;5;9
657;Beržynėlis;ŽIOGELIAI;2971686368;Taip;0;5;0;5
658;Beržynėlis;ŽIOGELIAI;9409317403;Taip;6;6;0;12
659;Beržynėlis;ŽIOGELIAI;6334152631;Taip;7;7;0;14
660;Beržynėlis;ŽVIRBLIUKAI;7520394353;Taip;0;4;0;4
661;Beržynėlis;ŽVIRBLIUKAI;95544821432;Taip;0;6;4;10
662;Beržynėlis;ŽVIRBLIUKAI;1426962644;Taip;0;4;0;4
663;Beržynėlis;ŽVIRBLIUKAI;1527942602;Taip;0;6;4;10
664;Beržynėlis;ŽVIRBLIUKAI;1910024785;Taip;7;7;0;14
665;Beržynėlis;ŽVIRBLIUKAI;1367442186;Taip;6;0;4;10
666;Beržynėlis;ŽVIRBLIUKAI;1823144276;Ne;0;2;2;4
667;Beržynėlis;ŽVIRBLIUKAI;1464556813;Taip;0;6;0;6
668;Beržynėlis;ŽVIRBLIUKAI;1945230630;Taip;12;0;1;13
669;Beržynėlis;ŽVIRBLIUKAI;1466742506;Taip;5;5;0;10
670;Beržynėlis;ŽVIRBLIUKAI;2023412985;Taip;0;4;0;4
671;Beržynėlis;ŽVIRBLIUKAI;1578089280;Taip;0;4;0;4
672;Beržynėlis;ŽVIRBLIUKAI;96946855305;Taip;2;4;0;6
673;Beržynėlis;ŽVIRBLIUKAI;2067928004;Taip;0;2;4;6
674;Beržynėlis;ŽVIRBLIUKAI;87592204193;Ne;0;4;0;4
675;Beržynėlis;ŽVIRBLIUKAI;62962970458;Taip;0;14;0;14
676;Beržynėlis;ŽVIRBLIUKAI;17743947386;Taip;0;6;1;7
677;Beržynėlis;ŽVIRBLIUKAI;30539063473;Taip;0;4;0;4
678;Beržynėlis;ŽVIRBLIUKAI;1885972165;Taip;0;4;0;4
679;Beržynėlis;ŽVIRBLIUKAI;81022321678;Taip;0;0;2;2
680;Beržynėlis;ŽVIRBLIUKAI;1391844432;Taip;0;3;12;15
681;Beržynėlis;ŽVIRBLIUKAI;1014895926;Taip;0;3;12;15
682;Beržynėlis;ŽIRNIUKAI;8701990625;Taip;0;2;0;2
683;Beržynėlis;ŽIRNIUKAI;8880151537;Taip;0;11;0;11
684;Beržynėlis;ŽIRNIUKAI;2221708263;Taip;7;11;0;18
685;Beržynėlis;ŽIRNIUKAI;9580286493;Taip;9;0;0;9
686;Beržynėlis;ŽIRNIUKAI;6330033887;Taip;18;0;0;18
687;Beržynėlis;ŽIRNIUKAI;9503352345;Taip;13;0;0;13
688;Beržynėlis;ŽIRNIUKAI;5189335842;Taip;17;0;0;17
689;Beržynėlis;ŽIRNIUKAI;6293884233;Taip;6;0;0;6
690;Beržynėlis;ŽIRNIUKAI;4161974847;Ne;8;2;0;10
691;Beržynėlis;ŽIRNIUKAI;4270889499;Taip;5;0;0;5
692;Beržynėlis;ŽIRNIUKAI;3209966996;Taip;16;1;0;17
693;Beržynėlis;ŽIRNIUKAI;3345231579;Taip;2;19;0;21
694;Beržynėlis;ŽIRNIUKAI;2273629510;Taip;0;3;2;5
695;Beržynėlis;ŽIRNIUKAI;1799326151;Taip;0;3;2;5
696;Beržynėlis;VIŠČIUKAI;7953957525;Taip;0;10;0;10
697;Beržynėlis;VIŠČIUKAI;4466393687;Taip;9;0;0;9
698;Beržynėlis;VIŠČIUKAI;8280378527;Taip;11;3;0;14
699;Beržynėlis;VIŠČIUKAI;6713134631;Taip;4;0;0;4
700;Beržynėlis;VIŠČIUKAI;5593146590;Taip;4;0;0;4
701;Beržynėlis;VIŠČIUKAI;3334994408;Taip;15;0;1;16
702;Beržynėlis;VIŠČIUKAI;4774769217;Taip;4;0;2;6
703;Beržynėlis;VIŠČIUKAI;8881566865;Taip;7;0;7;14
704;Beržynėlis;VIŠČIUKAI;5194416351;Taip;4;4;0;8
705;Beržynėlis;VIŠČIUKAI;9754455116;Taip;5;4;0;9
706;Beržynėlis;VIŠČIUKAI;5069929376;Taip;4;0;1;5
707;Beržynėlis;VIŠČIUKAI;6272047137;Ne;2;4;0;6
708;Beržynėlis;VIŠČIUKAI;8233464088;Taip;8;0;0;8
709;Beržynėlis;VIŠČIUKAI;4013099670;Taip;0;2;0;2
710;Beržynėlis;VIŠČIUKAI;2892553878;Taip;13;2;2;17
711;Beržynėlis;VIŠČIUKAI;9777841895;Taip;17;0;0;17
712;Bildukas;"Svetliački savaitinė";80327840821;Taip;7;0;0;7
713;Bildukas;"Svetliački savaitinė";96874940646;Taip;0;1;2;3
714;Bildukas;"Svetliački savaitinė";6441340680;Taip;0;5;0;5
715;Bildukas;"Svetliački savaitinė";1029617146;Taip;0;10;0;10
716;Bildukas;"Svetliački savaitinė";1643122874;Taip;0;3;0;3
717;Bildukas;"Svetliački savaitinė";70033583066;Taip;0;5;0;5
718;Bildukas;"Svetliački savaitinė";75301544496;Taip;0;6;0;6
719;Bildukas;"Svetliački savaitinė";1023163775;Ne;0;7;0;7
720;Bildukas;"Svetliački savaitinė";5026245712;Taip;8;1;0;9
721;Bildukas;"Svetliački savaitinė";25050688839;Ne;0;8;0;8
722;Bildukas;"Svetliački savaitinė";1183272346;Ne;0;1;1;2
723;Bildukas;"Svetliački savaitinė";3226370339;Taip;0;0;12;12
724;Bildukas;"Svetliački savaitinė";6548776238;Taip;0;0;21;21
725;Bildukas;"Svetliački savaitinė";6219872984;Taip;2;0;0;2
726;Bildukas;"Svetliački savaitinė";2091204077;Taip;0;5;0;5
727;Bildukas;"Svetliački savaitinė";4112888719;Taip;0;0;21;21
728;Bildukas;"Svetliački savaitinė";3531285331;Taip;0;7;0;7
729;Bildukas;"Svetliački savaitinė";1409708149;Taip;9;0;0;9
730;Bildukas;"Zaičiata savaitinė ( keli alergiški vaikai)";8927489885;Taip;18;0;0;18
731;Bildukas;"Zaičiata savaitinė ( keli alergiški vaikai)";1312165385;Taip;3;1;3;7
732;Bildukas;"Zaičiata savaitinė ( keli alergiški vaikai)";1916522637;Taip;0;0;1;1
733;Bildukas;"Zaičiata savaitinė ( keli alergiški vaikai)";4168864882;Ne;5;2;1;8
734;Bildukas;"Zaičiata savaitinė ( keli alergiški vaikai)";1720671485;Taip;4;0;0;4
735;Bildukas;"Zaičiata savaitinė ( keli alergiški vaikai)";6376189019;Taip;0;9;0;9
736;Bildukas;"Zaičiata savaitinė ( keli alergiški vaikai)";5747277587;Taip;4;0;2;6
737;Bildukas;"Zaičiata savaitinė ( keli alergiški vaikai)";3239566139;Taip;0;6;3;9
738;Bildukas;"Zaičiata savaitinė ( keli alergiški vaikai)";5794471794;Taip;3;0;0;3
739;Bildukas;"Zaičiata savaitinė ( keli alergiški vaikai)";4894478262;Taip;8;0;4;12
740;Bildukas;"Zaičiata savaitinė ( keli alergiški vaikai)";2539486337;Taip;0;6;0;6
741;Bildukas;"Zaičiata savaitinė ( keli alergiški vaikai)";8496678513;Taip;2;0;0;2
742;Bildukas;"Zaičiata savaitinė ( keli alergiški vaikai)";2154916232;Taip;0;5;0;5
743;Bildukas;"Zaičiata savaitinė ( keli alergiški vaikai)";1566191212;Taip;3;4;0;7
744;Bildukas;"Zaičiata savaitinė ( keli alergiški vaikai)";9155896981;Taip;0;2;0;2
745;Bildukas;"Zaičiata savaitinė ( keli alergiški vaikai)";2989922538;Ne;17;0;0;17
746;Bildukas;"Zaičiata savaitinė ( keli alergiški vaikai)";8080989574;Taip;17;0;0;17
747;Bildukas;Gnomiki;8382899180;Taip;3;8;0;11
748;Bildukas;Gnomiki;1486878343;Taip;0;2;0;2
749;Bildukas;Gnomiki;1987773024;Taip;11;4;0;15
750;Bildukas;Gnomiki;5217751936;Taip;0;16;0;16
751;Bildukas;Gnomiki;8999239172;Taip;0;1;0;1
752;Bildukas;Gnomiki;9156801640;Ne;8;1;0;9
753;Bildukas;Gnomiki;9756326725;Taip;0;0;2;2
754;Bildukas;Gnomiki;9098427210;Taip;5;0;7;12
755;Bildukas;Gnomiki;8835111916;Taip;0;0;3;3
756;Bildukas;Gnomiki;5724787637;Taip;3;2;0;5
757;Bildukas;Gnomiki;9835391223;Taip;0;5;0;5
758;Bildukas;Gnomiki;2429527586;Taip;0;12;0;12
759;Bildukas;Gnomiki;4116831802;Ne;10;1;0;11
760;Bildukas;Gnomiki;4677564389;Taip;5;0;0;5
761;Bildukas;Zvonočki;4866401336;Taip;10;2;0;12
762;Bildukas;Zvonočki;1180357950;Taip;2;10;0;12
763;Bildukas;Zvonočki;99302309410;Taip;0;6;1;7
764;Bildukas;Zvonočki;91777282521;Ne;0;7;0;7
765;Bildukas;Zvonočki;1713133196;Ne;4;0;0;4
766;Bildukas;Zvonočki;1956741726;Taip;3;0;8;11
767;Bildukas;Zvonočki;1234033395;Ne;10;1;0;11
768;Bildukas;Zvonočki;4404602365;Taip;0;9;0;9
769;Bildukas;Zvonočki;8440936221;Taip;0;14;2;16
770;Bildukas;Zvonočki;4014493868;Taip;0;11;0;11
771;Bildukas;Zvonočki;6388514464;Taip;0;11;0;11
772;Bildukas;Zvonočki;4377803110;Taip;0;3;0;3
773;Bildukas;Zvonočki;7898746258;Taip;7;0;4;11
774;Bildukas;Zvonočki;9569296370;Taip;0;0;19;19
775;Bildukas;Zvonočki;1113168085;Taip;4;2;2;8
776;Bildukas;Zvonočki;1125206576;Taip;0;13;0;13
777;Bildukas;Zvonočki;4623727349;Taip;0;5;8;13
778;Bildukas;Zvonočki;1047459617;Taip;0;4;1;5
779;Birutės;SKRUZDELIUKŲ;7526975680;Ne;11;0;2;13
780;Birutės;SKRUZDELIUKŲ;4968068043;Taip;0;0;8;8
781;Birutės;SKRUZDELIUKŲ;1761065941;Taip;19;0;0;19
782;Birutės;SKRUZDELIUKŲ;3728361481;Taip;10;0;0;10
783;Birutės;SKRUZDELIUKŲ;9610268046;Taip;7;0;0;7
784;Birutės;SKRUZDELIUKŲ;4027700332;Taip;11;1;3;15
785;Birutės;SKRUZDELIUKŲ;7685356079;Ne;8;0;0;8
786;Birutės;SKRUZDELIUKŲ;4375683234;Taip;0;4;0;4
787;Birutės;SKRUZDELIUKŲ;1105133326;Taip;17;0;0;17
788;Birutės;SKRUZDELIUKŲ;8413760872;Taip;19;0;0;19
789;Birutės;SKRUZDELIUKŲ;8636113039;Taip;8;6;0;14
790;Birutės;SKRUZDELIUKŲ;9411016611;Taip;0;4;1;5
791;Birutės;SKRUZDELIUKŲ;7119951690;Taip;6;4;0;10
792;Birutės;SKRUZDELIUKŲ;1945532852;Taip;0;3;0;3
793;Birutės;SKRUZDELIUKŲ;7678475961;Ne;0;3;0;3
794;Birutės;SKRUZDELIUKŲ;5154903444;Taip;7;4;0;11
795;Birutės;SKRUZDELIUKŲ;9541516589;Taip;6;0;0;6
796;Birutės;SKRUZDELIUKŲ;5811810714;Ne;20;0;0;20
797;Birutės;SKRUZDELIUKŲ;6815916679;Taip;10;3;0;13
798;Birutės;SKRUZDELIUKŲ;7251592439;Taip;10;0;2;12
799;Birutės;SKRUZDELIUKŲ;7940403585;Taip;14;4;1;19
800;Birutės;SKRUZDELIUKŲ;4253571334;Taip;0;3;7;10
801;Birutės;SKRUZDELIUKŲ;9187671201;Taip;4;5;0;9
802;Birutės;BITUČIŲ;1599159924;Taip;17;0;0;17
803;Birutės;BITUČIŲ;33770983649;Taip;10;0;0;10
804;Birutės;BITUČIŲ;87693588654;Taip;0;7;1;8
805;Birutės;BITUČIŲ;1234596925;Taip;0;9;0;9
806;Birutės;BITUČIŲ;2975442228;Ne;13;0;2;15
807;Birutės;BITUČIŲ;5770026060;Taip;6;0;0;6
808;Birutės;BITUČIŲ;98391790116;Taip;0;0;8;8
809;Birutės;BITUČIŲ;5947971037;Taip;0;11;0;11
810;Birutės;BITUČIŲ;3870702348;Taip;0;0;6;6
811;Birutės;BITUČIŲ;7149060118;Ne;0;4;2;6
812;Birutės;BITUČIŲ;1064449916;Taip;0;11;0;11
813;Birutės;BITUČIŲ;3436637062;Taip;0;1;0;1
814;Birutės;BITUČIŲ;9769645272;Taip;10;0;1;11
815;Birutės;BITUČIŲ;8465645434;Taip;12;0;1;13
816;Birutės;BITUČIŲ;9722922540;Ne;15;0;0;15
817;Birutės;BITUČIŲ;7856891698;Taip;0;0;1;1
818;Birutės;BITUČIŲ;4427232735;Ne;0;0;8;8
819;Birutės;BITUČIŲ;6006110601;Ne;4;0;0;4
820;Birutės;BITUČIŲ;5164196372;Taip;2;6;0;8
821;Birutės;BITUČIŲ;3061210677;Taip;0;0;9;9
822;Birutės;BITUČIŲ;6431396285;Taip;5;0;2;7
823;Birutės;BITUČIŲ;6081472534;Taip;0;0;3;3
824;Birutės;BITUČIŲ;1719394957;Taip;0;4;0;4
825;Birutės;BITUČIŲ;5099524382;Taip;0;19;2;21
826;Birutės;BORUŽIUKAI;83627433055;Taip;0;4;0;4
827;Birutės;BORUŽIUKAI;48493277224;Taip;0;4;0;4
828;Birutės;BORUŽIUKAI;1244627213;Ne;0;2;3;5
829;Birutės;BORUŽIUKAI;44098551169;Taip;0;3;1;4
830;Birutės;BORUŽIUKAI;1228407191;Taip;0;4;0;4
831;Birutės;BORUŽIUKAI;76900751891;Taip;0;8;0;8
832;Birutės;BORUŽIUKAI;78441249067;Taip;10;0;0;10
833;Birutės;BORUŽIUKAI;1735549924;Taip;0;4;0;4
834;Birutės;BORUŽIUKAI;1905393478;Taip;0;3;0;3
835;Birutės;BORUŽIUKAI;1427891290;Taip;0;11;0;11
836;Birutės;BORUŽIUKAI;44844176536;Taip;0;4;3;7
837;Birutės;BORUŽIUKAI;81284166606;Taip;0;4;2;6
838;Birutės;BORUŽIUKAI;22452517583;Taip;0;5;0;5
839;Birutės;BORUŽIUKAI;9450257904;Taip;6;3;0;9
840;Birutės;BORUŽIUKAI;1596098119;Ne;0;3;3;6
841;Birutės;BORUŽIUKAI;60466633757;Taip;14;4;0;18
842;Birutės;BORUŽIUKAI;9936423295;Ne;0;4;0;4
843;Birutės;BORUŽIUKAI;4217246188;Taip;0;19;2;21
844;Birutės;BORUŽIUKAI;70370187632;Taip;0;9;0;9
845;Birutės;BORUŽIUKAI;1471448452;Taip;16;4;0;20
846;Birutės;BORUŽIUKAI;2167759374;Ne;0;4;2;6
847;Birutės;BORUŽIUKAI;1264545164;Taip;0;5;16;21
848;Birutės;DRUGELIAI;91202819016;Taip;0;3;0;3
849;Birutės;DRUGELIAI;1884820602;Taip;0;2;0;2
850;Birutės;DRUGELIAI;1447494370;Taip;8;4;0;12
851;Birutės;DRUGELIAI;79438789443;Ne;0;4;0;4
852;Birutės;DRUGELIAI;77244600491;Taip;15;0;4;19
853;Birutės;DRUGELIAI;49162494334;Taip;0;9;0;9
854;Birutės;DRUGELIAI;22036269009;Taip;0;3;0;3
855;Birutės;DRUGELIAI;3213573357;Taip;0;2;0;2
856;Birutės;DRUGELIAI;23540610503;Ne;0;4;0;4
857;Birutės;DRUGELIAI;3490951066;Taip;5;0;0;5
858;Birutės;DRUGELIAI;1163666527;Taip;6;3;0;9
859;Birutės;DRUGELIAI;32780299044;Taip;0;2;0;2
860;Birutės;DRUGELIAI;1346957081;Taip;5;2;0;7
861;Birutės;DRUGELIAI;88939598407;Taip;0;9;0;9
862;Birutės;DRUGELIAI;1950295916;Taip;0;5;0;5
863;Birutės;DRUGELIAI;9662009307;Taip;13;0;4;17
864;Birutės;DRUGELIAI;9860683556;Taip;0;1;3;4
865;Birutės;DRUGELIAI;53416654439;Taip;0;4;0;4
866;Birutės;DRUGELIAI;9886554192;Ne;0;0;3;3
867;Birutės;DRUGELIAI;6880300182;Taip;0;4;0;4
868;Birutės;DRUGELIAI;18503890312;Taip;0;3;0;3
869;Birutės;DRUGELIAI;5574120561;Taip;6;0;0;6
870;Birutės;DRUGELIAI;7215289265;Taip;0;5;2;7
871;Bitutė;Aitvariukų;90943054285;Taip;0;11;0;11
872;Bitutė;Aitvariukų;3254061362;Taip;0;2;0;2
873;Bitutė;Aitvariukų;6674923740;Taip;0;3;0;3
874;Bitutė;Aitvariukų;8394685672;Taip;3;4;0;7
875;Bitutė;Aitvariukų;3796188100;Taip;6;0;1;7
876;Bitutė;Aitvariukų;1846974702;Taip;0;4;0;4
877;Bitutė;Aitvariukų;1162903905;Taip;9;0;0;9
878;Bitutė;Aitvariukų;1560715159;Taip;17;4;0;21
879;Bitutė;Aitvariukų;2518730247;Taip;13;4;0;17
880;Bitutė;Aitvariukų;5895868876;Ne;19;0;1;20
881;Bitutė;Aitvariukų;8743734366;Taip;4;7;0;11
882;Bitutė;Aitvariukų;2804203556;Taip;19;2;0;21
883;Bitutė;Aitvariukų;5455919343;Taip;0;0;4;4
884;Bitutė;Aitvariukų;6737174004;Taip;0;5;0;5
885;Bitutė;Aitvariukų;3432065233;Taip;14;0;0;14
886;Bitutė;Aitvariukų;5679397165;Taip;4;12;0;16
887;Bitutė;Aitvariukų;1564763789;Taip;0;0;1;1
888;Bitutė;Aitvariukų;7456328992;Taip;3;6;0;9
889;Bitutė;Ežiukų;78233050805;Taip;4;5;0;9
890;Bitutė;Ežiukų;43167655810;Ne;5;6;1;12
891;Bitutė;Ežiukų;38137764071;Taip;7;4;0;11
892;Bitutė;Ežiukų;40949937934;Taip;9;0;0;9
893;Bitutė;Ežiukų;67601917966;Taip;3;4;0;7
894;Bitutė;Ežiukų;89380579477;Taip;5;2;0;7
895;Bitutė;Ežiukų;1824939092;Taip;0;0;3;3
896;Bitutė;Ežiukų;21280284948;Taip;4;4;1;9
897;Bitutė;Ežiukų;1262030751;Taip;0;4;2;6
898;Bitutė;Ežiukų;57841590670;Taip;9;4;0;13
899;Bitutė;Ežiukų;56287634684;Taip;7;5;0;12
900;Bitutė;Ežiukų;4315172747;Taip;0;6;3;9
901;Bitutė;Ežiukų;5126303823;Taip;9;5;0;14
902;Bitutė;Ežiukų;9838379838;Taip;0;21;0;21
903;Bitutė;Ežiukų;42098027592;Ne;11;0;0;11
904;Bitutė;Ežiukų;17953339860;Taip;6;6;0;12
905;Bitutė;Ežiukų;4764586168;Taip;4;5;3;12
906;Bitutė;Ežiukų;8905075899;Taip;16;0;0;16
907;Bitutė;Žvirbliukų;3804171750;Taip;0;4;0;4
908;Bitutė;Žvirbliukų;8545377054;Taip;0;10;1;11
909;Bitutė;Žvirbliukų;5406667195;Taip;13;1;0;14
910;Bitutė;Žvirbliukų;4458990772;Ne;6;1;1;8
911;Bitutė;Žvirbliukų;3723040682;Taip;0;7;0;7
912;Bitutė;Žvirbliukų;2190439190;Taip;10;0;0;10
913;Bitutė;Žvirbliukų;7113693496;Taip;5;0;1;6
914;Bitutė;Žvirbliukų;4177331531;Taip;4;0;2;6
915;Bitutė;Žvirbliukų;2483462846;Taip;7;0;0;7
916;Bitutė;Žvirbliukų;8186706520;Taip;0;21;0;21
917;Bitutė;Žvirbliukų;7678106084;Taip;0;3;0;3
918;Bitutė;Žvirbliukų;6044969600;Taip;5;4;0;9
919;Bitutė;Žvirbliukų;2444289145;Taip;0;1;0;1
920;Bitutė;Žvirbliukų;3517750478;Taip;0;8;0;8
921;Bitutė;Žvirbliukų;5291764696;Taip;5;0;2;7
922;Bitutė;Žvirbliukų;1942685472;Taip;0;13;0;13
923;Bitutė;Žvirbliukų;4303490614;Taip;0;10;0;10
924;Bitutė;Žvirbliukų;9523588597;Taip;5;1;0;6
925;Bitutė;Žvirbliukų;3654065124;Taip;0;11;0;11
926;Bitutė;Žvirbliukų;9166624750;Taip;21;0;0;21
927;Bitutė;Gandriukų;20823074269;Taip;3;7;0;10
928;Bitutė;Gandriukų;20308800957;Taip;0;1;0;1
929;Bitutė;Gandriukų;55394933894;Taip;0;7;0;7
930;Bitutė;Gandriukų;83034164893;Taip;0;7;0;7
931;Bitutė;Gandriukų;28698703670;Taip;0;5;0;5
932;Bitutė;Gandriukų;51014007755;Taip;0;10;0;10
933;Bitutė;Gandriukų;85845989245;Taip;0;4;0;4
934;Bitutė;Gandriukų;55763538285;Taip;0;0;2;2
935;Bitutė;Gandriukų;55722176820;Taip;0;5;0;5
936;Bitutė;Gandriukų;41836931870;Taip;7;4;0;11
937;Bitutė;Gandriukų;1926912966;Taip;10;5;0;15
938;Bitutė;Gandriukų;16096919364;Ne;0;3;0;3
939;Bitutė;Gandriukų;2007360730;Taip;8;3;1;12
940;Bitutė;Gandriukų;2004589442;Taip;0;12;0;12
941;Bitutė;Gandriukų;1514919519;Taip;8;5;0;13
942;Bitutė;Gandriukų;1756799209;Taip;1;3;0;4
943;Bitutė;Gandriukų;7858925572;Taip;0;8;0;8
944;Bitutė;Gandriukų;39963735248;Taip;6;0;0;6
945;Bitutė;Gandriukų;2311037144;Taip;0;1;0;1
946;Bitutė;Gandriukų;41659768159;Taip;0;6;0;6
947;Bitutė;Pelėdžiukai;2045667491;Taip;0;5;0;5
948;Bitutė;Pelėdžiukai;76504719475;Taip;9;1;1;11
949;Bitutė;Pelėdžiukai;29837823635;Taip;0;4;6;10
950;Bitutė;Pelėdžiukai;96246198900;Taip;0;4;0;4
951;Bitutė;Pelėdžiukai;40578882341;Taip;0;4;0;4
952;Bitutė;Pelėdžiukai;73214901448;Taip;0;8;0;8
953;Bitutė;Pelėdžiukai;239058855;Ne;12;4;1;17
954;Bitutė;Pelėdžiukai;94263857872;Taip;0;11;0;11
955;Bitutė;Pelėdžiukai;4311138099;Ne;9;8;0;17
956;Bitutė;Pelėdžiukai;27177678441;Taip;6;2;0;8
957;Bitutė;Pelėdžiukai;87682328632;Taip;4;0;0;4
958;Bitutė;Pelėdžiukai;13826670333;Taip;0;0;1;1
959;Bitutė;Pelėdžiukai;2004079473;Taip;0;4;0;4
960;Bitutė;Pelėdžiukai;5513662035;Taip;0;5;0;5
961;Bitutė;Pelėdžiukai;1799005979;Taip;15;4;0;19
962;Bitutė;Pelėdžiukai;1342209916;Taip;0;4;0;4
963;Bitutė;Pelėdžiukai;1235354320;Taip;0;2;1;3
964;Bitutė;Pelėdžiukai;1086803168;Taip;1;4;5;10
965;Bitutė;Pelėdžiukai;54838528906;Taip;5;4;1;10
966;Bitutė;Pelėdžiukai;5365203210;Taip;0;9;1;10
967;Bitutė;Boružėlių;6586888742;Taip;7;4;0;11
968;Bitutė;Boružėlių;5783154071;Taip;13;5;0;18
969;Bitutė;Boružėlių;6052204491;Taip;0;4;0;4
970;Bitutė;Boružėlių;37105491775;Ne;14;0;1;15
971;Bitutė;Boružėlių;50869152455;Taip;0;3;1;4
972;Bitutė;Boružėlių;9683582019;Taip;5;4;0;9
973;Bitutė;Boružėlių;7352524951;Taip;0;6;0;6
974;Bitutė;Boružėlių;27144303911;Taip;5;0;9;14
975;Bitutė;Boružėlių;1802887869;Ne;11;0;0;11
976;Bitutė;Boružėlių;51054491845;Taip;14;0;0;14
977;Bitutė;Boružėlių;5653055907;Taip;4;7;2;13
978;Bitutė;Boružėlių;1809034174;Taip;8;1;0;9
979;Bitutė;Boružėlių;5644789669;Taip;3;4;0;7
980;Bitutė;Boružėlių;2350260809;Taip;8;0;1;9
981;Bitutė;Boružėlių;1307749129;Taip;10;0;0;10
982;Bitutė;Boružėlių;3980455738;Taip;10;4;1;15
983;Bitutė;Boružėlių;6678928989;Taip;9;3;0;12
984;Bitutė;Boružėlių;6572832247;Taip;5;0;1;6
985;Bitutė;Boružėlių;8519978626;Taip;0;4;1;5
986;Bitutė;Šokliukų;8754340459;Taip;4;5;0;9
987;Bitutė;Šokliukų;91649072251;Taip;0;4;0;4
988;Bitutė;Šokliukų;22504941477;Taip;0;7;0;7
989;Bitutė;Šokliukų;4054959628;Taip;8;5;2;15
990;Bitutė;Šokliukų;74038944722;Taip;2;4;0;6
991;Bitutė;Šokliukų;9314363274;Taip;0;21;0;21
992;Bitutė;Šokliukų;1703630417;Taip;5;1;0;6
993;Bitutė;Šokliukų;80788107109;Taip;0;0;7;7
994;Bitutė;Šokliukų;14787330368;Taip;0;4;0;4
995;Bitutė;Šokliukų;6591291681;Taip;6;1;0;7
996;Bitutė;Šokliukų;86636444738;Taip;0;4;0;4
997;Bitutė;Šokliukų;1956718350;Ne;0;0;8;8
998;Bitutė;Šokliukų;11128936533;Taip;3;2;2;7
999;Bitutė;Šokliukų;2775304620;Taip;7;5;0;12
1000;Bitutė;Šokliukų;26573486858;Taip;0;2;0;2
1001;Bitutė;Šokliukų;2104500642;Taip;0;5;0;5
1002;Bitutė;Šokliukų;1385876629;Taip;4;0;0;4
1003;Bitutė;Šokliukų;84694903978;Taip;7;5;0;12
1004;Bitutė;Šokliukų;71957147569;Taip;0;5;0;5
1005;Bitutė;Šokliukų;98029500731;Taip;0;5;0;5
1006;Bitutė;Drugelių;2531472741;Taip;0;4;0;4
1007;Bitutė;Drugelių;74525712637;Taip;0;4;0;4
1008;Bitutė;Drugelių;56620848568;Taip;0;5;0;5
1009;Bitutė;Drugelių;2049938111;Taip;4;0;0;4
1010;Bitutė;Drugelių;58668298206;Taip;5;2;0;7
1011;Bitutė;Drugelių;1863634233;Taip;11;0;0;11
1012;Bitutė;Drugelių;9550491607;Taip;0;13;0;13
1013;Bitutė;Drugelių;3982159333;Taip;15;4;0;19
1014;Bitutė;Drugelių;27461264704;Taip;0;6;0;6
1015;Bitutė;Drugelių;29300327608;Taip;0;4;0;4
1016;Bitutė;Drugelių;50605497381;Taip;0;5;0;5
1017;Bitutė;Drugelių;1030677273;Taip;0;10;0;10
1018;Bitutė;Drugelių;92700808654;Ne;0;3;0;3
1019;Bitutė;Drugelių;3319657847;Taip;0;5;0;5
1020;Bitutė;Drugelių;1861373542;Taip;0;1;0;1
1021;Bitutė;Drugelių;7236048627;Taip;5;3;0;8
1022;Bitutė;Kiškučių;9451529077;Ne;12;0;0;12
1023;Bitutė;Kiškučių;2812580726;Taip;13;0;0;13
1024;Bitutė;Kiškučių;1907876695;Taip;5;4;0;9
1025;Bitutė;Kiškučių;7720798466;Taip;5;4;0;9
1026;Bitutė;Kiškučių;1662815358;Taip;0;6;2;8
1027;Bitutė;Kiškučių;1733189730;Taip;0;13;0;13
1028;Bitutė;Kiškučių;3227252972;Taip;3;2;0;5
1029;Bitutė;Kiškučių;9966437881;Taip;12;2;0;14
1030;Bitutė;Kiškučių;8373296210;Taip;7;4;1;12
1031;Bitutė;Kiškučių;1985958540;Taip;9;1;0;10
1032;Bitutė;Kiškučių;8743960488;Taip;4;0;0;4
1033;Bitutė;Kiškučių;9337144831;Taip;0;21;0;21
1034;Bitutė;Kiškučių;1024337077;Taip;16;0;3;19
1035;Bitutė;Kiškučių;4566919587;Taip;10;0;0;10
1036;Bitutė;Kiškučių;6569166515;Taip;3;7;0;10
1037;Bitutė;Kiškučių;2806899030;Taip;10;0;0;10
1038;Bitutė;Kiškučių;5443722813;Taip;5;7;0;12
1039;Bitutė;Kiškučių;1241863345;Taip;0;8;1;9
1040;Bitutė;Kiškučių;8789574593;Taip;11;0;1;12
1041;Bitutė;Kiškučių;8799003374;Taip;10;4;1;15
1042;Bitutė;"Viščiukų ";1348548294;Taip;12;8;0;20
1043;Bitutė;"Viščiukų ";8872286273;Taip;10;1;1;12
1044;Bitutė;"Viščiukų ";5169768042;Taip;0;0;1;1
1045;Bitutė;"Viščiukų ";7165511381;Taip;0;7;0;7
1046;Bitutė;"Viščiukų ";4527880105;Taip;6;5;2;13
1047;Bitutė;"Viščiukų ";1012702386;Taip;11;0;0;11
1048;Bitutė;"Viščiukų ";9834697190;Taip;6;0;0;6
1049;Bitutė;"Viščiukų ";9465186207;Taip;14;0;0;14
1050;Bitutė;"Viščiukų ";9924340801;Taip;15;0;0;15
1051;Bitutė;"Viščiukų ";4917599786;Taip;21;0;0;21
1052;Bitutė;"Viščiukų ";7979566741;Taip;0;21;0;21
1053;Bitutė;"Viščiukų ";9855080887;Taip;0;4;0;4
1054;Bitutė;"Viščiukų ";8211710975;Taip;0;10;0;10
1055;Bitutė;"Viščiukų ";7318555933;Taip;4;5;0;9
1056;Bitutė;"Viščiukų ";4513783927;Ne;9;2;0;11
1057;Bitutė;"Skruzdėliukai ";37364063140;Ne;0;4;0;4
1058;Bitutė;"Skruzdėliukai ";1590580158;Taip;0;1;0;1
1059;Bitutė;"Skruzdėliukai ";5910842956;Taip;13;0;0;13
1060;Bitutė;"Skruzdėliukai ";1913421864;Taip;3;3;0;6
1061;Bitutė;"Skruzdėliukai ";38436660859;Taip;0;4;3;7
1062;Bitutė;"Skruzdėliukai ";2126118124;Taip;6;0;9;15
1063;Bitutė;"Skruzdėliukai ";87960363246;Taip;0;4;1;5
1064;Bitutė;"Skruzdėliukai ";1064809221;Taip;21;0;0;21
1065;Bitutė;"Skruzdėliukai ";1521753712;Taip;6;13;0;19
1066;Bitutė;"Skruzdėliukai ";1307910515;Taip;0;0;4;4
1067;Bitutė;"Skruzdėliukai ";5886190377;Taip;0;4;0;4
1068;Bitutė;"Skruzdėliukai ";61233878620;Taip;5;6;0;11
1069;Bitutė;"Skruzdėliukai ";1130379531;Taip;4;5;0;9
1070;Bitutė;"Skruzdėliukai ";2031043488;Taip;3;9;0;12
1071;Bitutė;"Skruzdėliukai ";55469634385;Taip;5;0;0;5
1072;Bitutė;"Skruzdėliukai ";1354608761;Taip;6;1;0;7
1073;Bitutė;"Skruzdėliukai ";95252521365;Taip;4;1;9;14
1074;Bitutė;"Skruzdėliukai ";26206836171;Ne;0;4;4;8
1075;Bitutė;"Skruzdėliukai ";6969112590;Ne;0;2;0;2
1076;Bitutė;"Nykštukų ";5188828679;Taip;10;1;0;11
1077;Bitutė;"Nykštukų ";8109028957;Taip;10;1;0;11
1078;Bitutė;"Nykštukų ";6169426273;Taip;6;4;0;10
1079;Bitutė;"Nykštukų ";5942493696;Taip;8;0;0;8
1080;Bitutė;"Nykštukų ";2252157473;Taip;10;0;2;12
1081;Bitutė;"Nykštukų ";8439759353;Taip;0;3;0;3
1082;Bitutė;"Nykštukų ";2853616585;Taip;8;1;0;9
1083;Bitutė;"Nykštukų ";1423694056;Taip;5;0;1;6
1084;Bitutė;"Nykštukų ";5109258680;Taip;0;0;2;2
1085;Bitutė;"Nykštukų ";5686278261;Taip;8;0;0;8
1086;Bitutė;"Nykštukų ";7145036085;Taip;9;0;1;10
1087;Bitutė;"Nykštukų ";9602659259;Taip;3;5;0;8
1088;Bitutė;"Nykštukų ";6311396261;Taip;15;4;0;19
1089;Bitutė;"Nykštukų ";5378885117;Taip;10;3;0;13
1090;Coliukė;DRUGELIAI;6011110970;Ne;0;0;2;2
1091;Coliukė;DRUGELIAI;6725408547;Taip;8;0;0;8
1092;Coliukė;DRUGELIAI;5450167562;Taip;21;0;0;21
1093;Coliukė;DRUGELIAI;7248705010;Ne;14;0;0;14
1094;Coliukė;DRUGELIAI;8835394030;Taip;0;4;0;4
1095;Coliukė;DRUGELIAI;3427704550;Taip;0;7;0;7
1096;Coliukė;DRUGELIAI;5139645108;Taip;17;0;0;17
1097;Coliukė;DRUGELIAI;8209209881;Taip;0;4;3;7
1098;Coliukė;DRUGELIAI;3499575148;Taip;2;5;0;7
1099;Coliukė;DRUGELIAI;9462610674;Taip;12;4;0;16
1100;Coliukė;DRUGELIAI;2167230398;Taip;18;2;0;20
1101;Coliukė;DRUGELIAI;9331485675;Taip;13;6;0;19
1102;Coliukė;DRUGELIAI;2275327607;Taip;2;0;2;4
1103;Coliukė;DRUGELIAI;4188233426;Taip;16;0;0;16
1104;Coliukė;DRUGELIAI;4845247006;Taip;16;0;0;16
1105;Coliukė;DRUGELIAI;5349969025;Taip;4;0;0;4
1106;Coliukė;DRUGELIAI;3318808813;Taip;21;0;0;21
1107;Coliukė;BITUTĖS;93361426448;Taip;0;4;0;4
1108;Coliukė;BITUTĖS;82989338835;Taip;0;1;0;1
1109;Coliukė;BITUTĖS;37161702858;Ne;0;4;0;4
1110;Coliukė;BITUTĖS;1199350941;Taip;0;16;0;16
1111;Coliukė;BITUTĖS;1960898805;Taip;0;8;0;8
1112;Coliukė;BITUTĖS;58421006265;Taip;0;8;0;8
1113;Coliukė;BITUTĖS;6926730624;Taip;0;4;0;4
1114;Coliukė;BITUTĖS;9311775782;Taip;12;5;0;17
1115;Coliukė;BITUTĖS;81003830638;Taip;0;4;0;4
1116;Coliukė;BITUTĖS;36554487034;Taip;5;6;0;11
1117;Coliukė;BITUTĖS;1423711475;Taip;7;0;0;7
1118;Coliukė;BITUTĖS;7920728387;Taip;9;1;0;10
1119;Coliukė;BITUTĖS;1240946719;Taip;7;10;0;17
1120;Coliukė;BITUTĖS;4408284518;Taip;0;16;0;16
1121;Coliukė;BITUTĖS;3346269598;Taip;0;2;0;2
1122;Coliukė;BITUTĖS;6860757091;Taip;0;6;0;6
1123;Coliukė;BITUTĖS;1458763954;Taip;0;1;0;1
1124;Coliukė;BITUTĖS;1968467455;Taip;10;1;0;11
1125;Coliukė;BITUTĖS;3919482569;Taip;4;4;0;8
1126;Coliukė;BITUTĖS;1328505569;Ne;8;4;0;12
1127;Coliukė;BITUTĖS;4645245689;Taip;13;5;0;18
1128;Coliukė;VABALIUKAI;62876576078;Taip;6;0;0;6
1129;Coliukė;VABALIUKAI;26698840369;Taip;0;10;0;10
1130;Coliukė;VABALIUKAI;78760440826;Taip;0;9;0;9
1131;Coliukė;VABALIUKAI;22951260339;Taip;5;2;0;7
1132;Coliukė;VABALIUKAI;33158793202;Taip;0;2;0;2
1133;Coliukė;VABALIUKAI;33587152454;Taip;0;12;0;12
1134;Coliukė;VABALIUKAI;82064520362;Taip;12;0;0;12
1135;Coliukė;VABALIUKAI;57504928606;Taip;9;1;0;10
1136;Coliukė;VABALIUKAI;4649987214;Taip;12;0;0;12
1137;Coliukė;VABALIUKAI;63258983714;Taip;6;3;0;9
1138;Coliukė;VABALIUKAI;99200764707;Taip;11;5;0;16
1139;Coliukė;VABALIUKAI;1476750428;Taip;18;0;0;18
1140;Coliukė;VABALIUKAI;8323242104;Taip;0;9;0;9
1141;Coliukė;VABALIUKAI;9526108197;Ne;14;0;0;14
1142;Coliukė;VABALIUKAI;3539878011;Taip;0;1;0;1
1143;Coliukė;VABALIUKAI;4739310916;Taip;9;1;0;10
1144;Coliukė;VABALIUKAI;5541328815;Taip;11;0;0;11
1145;Coliukė;VABALIUKAI;1318558913;Taip;0;4;0;4
1146;Coliukė;VABALIUKAI;4010374947;Taip;15;0;0;15
1147;Coliukė;VABALIUKAI;7622526793;Taip;0;5;0;5
1148;Coliukė;VABALIUKAI;5163405988;Ne;12;2;0;14
1149;Coliukė;VABALIUKAI;3513604594;Ne;14;2;0;16
1150;Coliukė;NYKŠTUKAI;1659532709;Ne;2;3;0;5
1151;Coliukė;NYKŠTUKAI;1812071213;Taip;0;13;0;13
1152;Coliukė;NYKŠTUKAI;4747481676;Ne;0;7;0;7
1153;Coliukė;NYKŠTUKAI;83027842354;Ne;0;5;0;5
1154;Coliukė;NYKŠTUKAI;2168987649;Taip;10;4;0;14
1155;Coliukė;NYKŠTUKAI;2684151591;Taip;0;12;0;12
1156;Coliukė;NYKŠTUKAI;4499924331;Taip;5;5;0;10
1157;Coliukė;NYKŠTUKAI;4806478786;Taip;0;4;1;5
1158;Coliukė;NYKŠTUKAI;7566429633;Taip;0;4;0;4
1159;Coliukė;NYKŠTUKAI;9542366183;Taip;21;0;0;21
1160;Coliukė;NYKŠTUKAI;7670166244;Taip;0;10;0;10
1161;Coliukė;NYKŠTUKAI;1166820133;Ne;0;0;4;4
1162;Coliukė;NYKŠTUKAI;4845049639;Taip;14;4;0;18
1163;Coliukė;NYKŠTUKAI;1537341012;Taip;19;0;0;19
1164;Coliukė;NYKŠTUKAI;6403149921;Ne;19;0;0;19
1165;Coliukė;NYKŠTUKAI;1105879142;Taip;8;0;0;8
1166;Coliukė;NYKŠTUKAI;4022408510;Taip;0;0;2;2
1167;Coliukė;NYKŠTUKAI;1600495468;Taip;0;5;0;5
1168;Coliukė;NYKŠTUKAI;6781303455;Taip;4;7;0;11
1169;Coliukė;GĖLYTĖS;4498253271;Ne;8;0;5;13
1170;Coliukė;GĖLYTĖS;8149118599;Taip;21;0;0;21
1171;Coliukė;GĖLYTĖS;1390751418;Taip;9;1;0;10
1172;Coliukė;GĖLYTĖS;2078549599;Ne;17;0;0;17
1173;Coliukė;GĖLYTĖS;4881447596;Taip;9;4;0;13
1174;Coliukė;GĖLYTĖS;2844636823;Taip;13;0;1;14
1175;Coliukė;GĖLYTĖS;2385917598;Taip;10;0;0;10
1176;Coliukė;GĖLYTĖS;7345905007;Taip;14;0;0;14
1177;Coliukė;GĖLYTĖS;3628571567;Taip;7;2;0;9
1178;Coliukė;GĖLYTĖS;9752408693;Taip;8;5;0;13
1179;Coliukė;GĖLYTĖS;7216221020;Taip;11;0;0;11
1180;Coliukė;GĖLYTĖS;7358018315;Taip;5;0;1;6
1181;Coliukė;"BORUŽĖLĖS (SPEC.)";1988394967;Taip;4;6;0;10
1182;Coliukė;"BORUŽĖLĖS (SPEC.)";3746858489;Taip;0;3;0;3
1183;Coliukė;"BORUŽĖLĖS (SPEC.)";2080118127;Taip;0;1;0;1
1184;Coliukė;"BORUŽĖLĖS (SPEC.)";8070499557;Taip;0;12;0;12
1185;Coliukė;"BORUŽĖLĖS (SPEC.)";2617816991;Taip;6;0;0;6
1186;Coliukė;"BORUŽĖLĖS (SPEC.)";9368334915;Taip;0;3;1;4
1187;Coliukė;"BORUŽĖLĖS (SPEC.)";1233731506;Taip;3;8;0;11
1188;Coliukė;"BORUŽĖLĖS (SPEC.)";1644303265;Taip;5;0;1;6
1189;Coliukė;"BORUŽĖLĖS (SPEC.)";2555073719;Ne;9;0;0;9
1190;Coliukė;"BORUŽĖLĖS (SPEC.)";6170362846;Taip;14;0;0;14
1191;Coliukė;"BORUŽĖLĖS (SPEC.)";5706671963;Taip;3;8;0;11
1192;Čiauškutis;BITUTĖS;3499391608;Taip;2;5;0;7
1193;Čiauškutis;BITUTĖS;1443155220;Taip;0;12;0;12
1194;Čiauškutis;BITUTĖS;1804509009;Taip;7;1;0;8
1195;Čiauškutis;BITUTĖS;22717947028;Taip;0;11;0;11
1196;Čiauškutis;BITUTĖS;3917667527;Taip;2;0;2;4
1197;Čiauškutis;BITUTĖS;5900996969;Taip;17;0;0;17
1198;Čiauškutis;BITUTĖS;54635137954;Taip;0;0;3;3
1199;Čiauškutis;BITUTĖS;7060197354;Taip;5;0;1;6
1200;Čiauškutis;BITUTĖS;30480486366;Taip;0;4;2;6
1201;Čiauškutis;BITUTĖS;1732370199;Ne;3;4;7;14
1202;Čiauškutis;BITUTĖS;3370047940;Taip;2;0;1;3
1203;Čiauškutis;BITUTĖS;9208388159;Ne;0;0;16;16
1204;Čiauškutis;ŽVIRBLIUKAI;2044220236;Taip;0;5;3;8
1205;Čiauškutis;ŽVIRBLIUKAI;4037117222;Taip;3;0;0;3
1206;Čiauškutis;ŽVIRBLIUKAI;4239145386;Taip;0;6;0;6
1207;Čiauškutis;ŽVIRBLIUKAI;3490305325;Taip;18;0;0;18
1208;Čiauškutis;ŽVIRBLIUKAI;2633243682;Taip;0;2;0;2
1209;Čiauškutis;ŽVIRBLIUKAI;7009893338;Taip;10;0;0;10
1210;Čiauškutis;ŽVIRBLIUKAI;6705934636;Taip;0;1;0;1
1211;Čiauškutis;ŽVIRBLIUKAI;2511568496;Taip;0;0;21;21
1212;Čiauškutis;ŽVIRBLIUKAI;5957587644;Taip;5;0;8;13
1213;Čiauškutis;ŽVIRBLIUKAI;1733251156;Ne;11;0;0;11
1214;Čiauškutis;ŽVIRBLIUKAI;7654242839;Ne;8;5;0;13
1215;Čiauškutis;SAULUTĖS;6279678482;Taip;0;1;0;1
1216;Čiauškutis;SAULUTĖS;93468721158;Taip;12;1;0;13
1217;Čiauškutis;SAULUTĖS;2012201854;Taip;13;4;0;17
1218;Čiauškutis;SAULUTĖS;27158851138;Taip;0;9;0;9
1219;Čiauškutis;SAULUTĖS;78373250443;Taip;5;4;0;9
1220;Čiauškutis;SAULUTĖS;7755428393;Taip;6;1;0;7
1221;Čiauškutis;SAULUTĖS;3653044274;Taip;3;0;0;3
1222;Čiauškutis;SAULUTĖS;1417978731;Taip;7;5;0;12
1223;Čiauškutis;SAULUTĖS;1503190001;Taip;0;5;0;5
1224;Čiauškutis;SAULUTĖS;4817007142;Taip;6;0;3;9
1225;Čiauškutis;SAULUTĖS;1719875491;Taip;0;5;0;5
1226;Čiauškutis;SAULUTĖS;1486206292;Taip;5;2;0;7
1227;Čiauškutis;EŽIUKAI;7746580858;Taip;0;0;4;4
1228;Čiauškutis;EŽIUKAI;2411714732;Taip;0;0;3;3
1229;Čiauškutis;EŽIUKAI;2686038029;Taip;0;0;4;4
1230;Čiauškutis;EŽIUKAI;1928404791;Taip;7;0;9;16
1231;Čiauškutis;EŽIUKAI;6056618348;Taip;13;0;7;20
1232;Čiauškutis;EŽIUKAI;7489733038;Taip;0;0;2;2
1233;Čiauškutis;EŽIUKAI;5404165993;Taip;9;0;0;9
1234;Čiauškutis;EŽIUKAI;2554011985;Ne;7;2;0;9
1235;Čiauškutis;EŽIUKAI;1158816422;Ne;0;5;1;6
1236;Čiauškutis;EŽIUKAI;7239878097;Taip;0;4;0;4
1237;Čiauškutis;EŽIUKAI;5910818962;Ne;9;0;5;14
1238;Čiauškutis;DRUGELIAI;7080320173;Taip;13;1;2;16
1239;Čiauškutis;DRUGELIAI;7440425102;Ne;0;1;1;2
1240;Čiauškutis;DRUGELIAI;7312776041;Ne;5;1;1;7
1241;Čiauškutis;DRUGELIAI;1301573542;Ne;9;1;0;10
1242;Čiauškutis;DRUGELIAI;9072764004;Ne;13;0;1;14
1243;Čiauškutis;DRUGELIAI;1036358147;Ne;11;1;0;12
1244;Čiauškutis;DRUGELIAI;8690876173;Ne;12;1;0;13
1245;Čiauškutis;DRUGELIAI;1750040659;Taip;8;1;1;10
1246;Čiauškutis;DRUGELIAI;8346845876;Taip;0;1;2;3
1247;Čiauškutis;DRUGELIAI;98579606504;Taip;5;1;0;6
1248;Čiauškutis;DRUGELIAI;1426744251;Taip;14;0;0;14
1249;Čiauškutis;GENELIAI;3888278518;Ne;0;5;1;6
1250;Čiauškutis;GENELIAI;47866559654;Taip;0;5;0;5
1251;Čiauškutis;GENELIAI;2034456215;Taip;0;1;0;1
1252;Čiauškutis;GENELIAI;1404146538;Taip;0;5;1;6
1253;Čiauškutis;GENELIAI;8974089037;Taip;0;4;0;4
1254;Čiauškutis;GENELIAI;45303538716;Taip;0;6;0;6
1255;Čiauškutis;GENELIAI;7011763860;Taip;0;0;5;5
1256;Čiauškutis;GENELIAI;2273215873;Ne;0;5;0;5
1257;Čiauškutis;GENELIAI;7332285452;Taip;17;0;0;17
1258;Čiauškutis;GENELIAI;1233059816;Taip;0;7;0;7
1259;Čiauškutis;GENELIAI;28814860843;Taip;14;0;0;14
1260;Čiauškutis;GENELIAI;8483195434;Taip;0;1;0;1
1261;Čiauškutis;LINKSMUČIAI;4600623461;Taip;0;9;0;9
1262;Čiauškutis;LINKSMUČIAI;1332686904;Taip;0;9;0;9
1263;Čiauškutis;LINKSMUČIAI;55539901360;Ne;17;0;0;17
1264;Čiauškutis;LINKSMUČIAI;1380571576;Ne;0;12;0;12
1265;Čiauškutis;LINKSMUČIAI;1109018212;Taip;13;4;0;17
1266;Čiauškutis;LINKSMUČIAI;26779062894;Ne;2;2;0;4
1267;Čiauškutis;LINKSMUČIAI;8884708945;Taip;5;9;1;15
1268;Čiauškutis;LINKSMUČIAI;9603569117;Ne;5;0;0;5
1269;Čiauškutis;LINKSMUČIAI;2019831231;Taip;0;3;1;4
1270;Čiauškutis;LINKSMUČIAI;67405154291;Taip;0;3;2;5
1271;Čiauškutis;LINKSMUČIAI;1778900145;Taip;5;9;0;14
1272;Čiauškutis;KIŠKUČIAI;1474355889;Taip;0;4;0;4
1273;Čiauškutis;KIŠKUČIAI;72264057427;Taip;0;8;0;8
1274;Čiauškutis;KIŠKUČIAI;8808041204;Taip;12;1;0;13
1275;Čiauškutis;KIŠKUČIAI;2099735647;Taip;0;5;3;8
1276;Čiauškutis;KIŠKUČIAI;8992775168;Taip;4;0;6;10
1277;Čiauškutis;KIŠKUČIAI;1480363762;Taip;0;4;0;4
1278;Čiauškutis;KIŠKUČIAI;1849532875;Ne;4;0;1;5
1279;Čiauškutis;KIŠKUČIAI;2218793969;Taip;16;0;0;16
1280;Čiauškutis;KIŠKUČIAI;6115354862;Taip;2;1;0;3
1281;Čiauškutis;KIŠKUČIAI;5759367884;Taip;0;3;1;4
1282;Čiauškutis;KIŠKUČIAI;1456067541;Ne;0;4;1;5
1283;Čiauškutis;KIŠKUČIAI;7367933940;Taip;16;0;0;16
1284;Čiauškutis;LAPIUKAI;60265156684;Taip;1;0;2;3
1285;Čiauškutis;LAPIUKAI;31203540590;Taip;0;3;2;5
1286;Čiauškutis;LAPIUKAI;8857039064;Taip;0;1;0;1
1287;Čiauškutis;LAPIUKAI;1657452686;Ne;14;1;1;16
1288;Čiauškutis;LAPIUKAI;43313173294;Taip;0;2;0;2
1289;Čiauškutis;LAPIUKAI;5513758257;Taip;0;0;1;1
1290;Čiauškutis;LAPIUKAI;1739403100;Taip;3;0;0;3
1291;Čiauškutis;MEŠKUČIAI;1923832961;Taip;2;4;2;8
1292;Čiauškutis;MEŠKUČIAI;9240896780;Ne;0;0;1;1
1293;Čiauškutis;MEŠKUČIAI;4341825486;Taip;7;2;0;9
1294;Čiauškutis;MEŠKUČIAI;23373424554;Taip;0;2;0;2
1295;Čiauškutis;MEŠKUČIAI;8375416027;Taip;0;4;0;4
1296;Čiauškutis;MEŠKUČIAI;88294995405;Taip;0;7;0;7
1297;Čiauškutis;MEŠKUČIAI;1938531597;Ne;6;0;0;6
1298;Čiauškutis;MEŠKUČIAI;5739889733;Taip;8;4;0;12
1299;Čiauškutis;PELĖDŽIUKAI;7961309940;Taip;0;2;0;2
1300;Čiauškutis;PELĖDŽIUKAI;8728572783;Ne;0;4;0;4
1301;Čiauškutis;PELĖDŽIUKAI;1253449294;Taip;10;4;1;15
1302;Čiauškutis;PELĖDŽIUKAI;82575455120;Taip;9;0;0;9
1303;Čiauškutis;PELĖDŽIUKAI;6165710260;Taip;0;1;0;1
1304;Čiauškutis;PELĖDŽIUKAI;1546096184;Taip;0;1;0;1
1305;Čiauškutis;PELĖDŽIUKAI;4135020826;Taip;2;7;2;11
1306;Čiauškutis;PELĖDŽIUKAI;70690874267;Taip;0;8;0;8
1307;Čiauškutis;PELĖDŽIUKAI;5897061482;Taip;0;2;5;7
1308;Čiauškutis;PELĖDŽIUKAI;1079827182;Taip;0;1;1;2
1309;Čiauškutis;NYKŠTUKAI;6258150407;Taip;12;5;0;17
1310;Čiauškutis;NYKŠTUKAI;1621605644;Taip;0;1;0;1
1311;Čiauškutis;NYKŠTUKAI;4846025153;Taip;10;8;0;18
1312;Čiauškutis;NYKŠTUKAI;4898534899;Ne;6;5;0;11
1313;Čiauškutis;NYKŠTUKAI;4917339896;Taip;0;1;0;1
1314;Čiauškutis;NYKŠTUKAI;8030685444;Ne;6;1;0;7
1315;Čiauškutis;NYKŠTUKAI;1809511815;Taip;0;1;0;1
1316;Čiauškutis;NYKŠTUKAI;1533938659;Ne;0;4;0;4
1317;Čiauškutis;NYKŠTUKAI;1422589887;Taip;8;4;0;12
1318;Čiauškutis;NYKŠTUKAI;8709039752;Taip;11;0;0;11
1319;Delfinukas;Boružėlių;6935992202;Taip;2;4;0;6
1320;Delfinukas;Boružėlių;7904803011;Taip;7;1;1;9
1321;Delfinukas;Boružėlių;8186312409;Taip;5;1;0;6
1322;Delfinukas;Boružėlių;8148610460;Taip;6;4;0;10
1323;Delfinukas;Boružėlių;1484123788;Taip;0;4;0;4
1324;Delfinukas;Boružėlių;1873630966;Taip;9;0;0;9
1325;Delfinukas;Boružėlių;6531930806;Taip;0;4;0;4
1326;Delfinukas;Boružėlių;8076961367;Ne;0;2;0;2
1327;Delfinukas;Boružėlių;8439204095;Taip;0;3;0;3
1328;Delfinukas;Boružėlių;5783537897;Taip;4;0;0;4
1329;Delfinukas;Boružėlių;4989239822;Taip;0;0;1;1
1330;Delfinukas;Boružėlių;7638190553;Taip;0;5;0;5
1331;Delfinukas;Boružėlių;2010703982;Ne;0;1;0;1
1332;Delfinukas;Boružėlių;8728791932;Taip;0;0;1;1
1333;Delfinukas;Boružėlių;5794346039;Taip;10;1;0;11
1334;Delfinukas;Boružėlių;1153948822;Ne;3;1;0;4
1335;Delfinukas;Boružėlių;6700068320;Taip;5;4;0;9
1336;Delfinukas;Boružėlių;7277680544;Ne;0;8;0;8
1337;Delfinukas;Boružėlių;9099945815;Ne;5;1;0;6
1338;Delfinukas;Boružėlių;1212995285;Taip;9;0;0;9
1339;Delfinukas;Saulytės;65798709244;Ne;9;4;0;13
1340;Delfinukas;Saulytės;76643778833;Ne;0;7;0;7
1341;Delfinukas;Saulytės;35058841521;Ne;14;0;0;14
1342;Delfinukas;Saulytės;79934072325;Taip;0;6;0;6
1343;Delfinukas;Saulytės;2096874518;Taip;0;5;0;5
1344;Delfinukas;Saulytės;2009324145;Taip;0;6;1;7
1345;Delfinukas;Saulytės;27140729689;Taip;0;6;0;6
1346;Delfinukas;Saulytės;46847640903;Taip;0;2;8;10
1347;Delfinukas;Saulytės;4142864015;Ne;5;6;0;11
1348;Delfinukas;Saulytės;86601289023;Taip;0;1;0;1
1349;Delfinukas;Saulytės;16785309188;Taip;0;7;0;7
1350;Delfinukas;Saulytės;34563800372;Taip;13;2;0;15
1351;Delfinukas;Saulytės;2074439295;Taip;9;0;0;9
1352;Delfinukas;Saulytės;1939499375;Ne;9;3;0;12
1353;Delfinukas;Saulytės;1813240176;Taip;10;0;2;12
1354;Delfinukas;Saulytės;1293348150;Taip;5;1;0;6
1355;Delfinukas;Saulytės;1364873935;Taip;6;0;0;6
1356;Delfinukas;Saulytės;5912904296;Taip;13;0;0;13
1357;Delfinukas;Pelėdžiukų;3940838205;Ne;18;0;0;18
1358;Delfinukas;Pelėdžiukų;8774145277;Taip;2;8;0;10
1359;Delfinukas;Pelėdžiukų;1395257200;Taip;8;0;0;8
1360;Delfinukas;Pelėdžiukų;7249857412;Taip;9;6;0;15
1361;Delfinukas;Pelėdžiukų;2658828200;Taip;3;3;0;6
1362;Delfinukas;Pelėdžiukų;3770227955;Taip;17;0;0;17
1363;Delfinukas;Pelėdžiukų;6113662246;Taip;0;12;0;12
1364;Delfinukas;Pelėdžiukų;4710894128;Taip;9;0;0;9
1365;Delfinukas;Pelėdžiukų;1526129772;Taip;0;1;0;1
1366;Delfinukas;Pelėdžiukų;8659309242;Taip;0;6;3;9
1367;Delfinukas;Pelėdžiukų;1227257543;Taip;14;3;0;17
1368;Delfinukas;Pelėdžiukų;8882370994;Ne;21;0;0;21
1369;Delfinukas;Pelėdžiukų;8267992425;Taip;0;6;0;6
1370;Delfinukas;Pelėdžiukų;9319874239;Ne;0;4;0;4
1371;Delfinukas;Pelėdžiukų;2809947323;Taip;0;0;1;1
1372;Delfinukas;Pelėdžiukų;3465186420;Taip;0;3;0;3
1373;Delfinukas;Varliukų;1153333591;Ne;0;4;0;4
1374;Delfinukas;Varliukų;1091165849;Taip;4;0;1;5
1375;Delfinukas;Varliukų;9573336239;Taip;6;4;0;10
1376;Delfinukas;Varliukų;1454101129;Taip;0;3;0;3
1377;Delfinukas;Varliukų;1251961268;Taip;0;6;0;6
1378;Delfinukas;Varliukų;1789047913;Taip;0;12;6;18
1379;Delfinukas;Varliukų;3678131609;Ne;10;5;0;15
1380;Delfinukas;Varliukų;1194444282;Taip;5;1;0;6
1381;Delfinukas;Varliukų;9347513042;Taip;9;6;0;15
1382;Delfinukas;Varliukų;8875479631;Taip;13;3;0;16
1383;Delfinukas;Varliukų;3344476309;Taip;0;2;1;3
1384;Delfinukas;Varliukų;3955783379;Taip;6;10;0;16
1385;Delfinukas;Varliukų;9502789660;Taip;4;4;1;9
1386;Delfinukas;Varliukų;3489297719;Taip;5;9;1;15
1387;Delfinukas;Varliukų;1948438336;Ne;0;1;0;1
1388;Delfinukas;Varliukų;9266646602;Taip;21;0;0;21
1389;Delfinukas;Varliukų;3674481373;Taip;9;3;0;12
1390;Delfinukas;Varliukų;9516852657;Taip;9;5;0;14
1391;Delfinukas;Varliukų;1338476746;Taip;0;3;0;3
1392;Delfinukas;Varpelių;62769117892;Ne;6;1;0;7
1393;Delfinukas;Varpelių;8855690221;Taip;11;0;0;11
1394;Delfinukas;Varpelių;3093606855;Taip;7;1;0;8
1395;Delfinukas;Varpelių;6393090675;Taip;5;5;0;10
1396;Delfinukas;Varpelių;1268754720;Taip;0;7;0;7
1397;Delfinukas;Varpelių;1959331544;Taip;13;0;0;13
1398;Delfinukas;Varpelių;3718612458;Taip;21;0;0;21
1399;Delfinukas;Varpelių;43859975789;Taip;4;0;0;4
1400;Delfinukas;Varpelių;2531571615;Taip;0;10;0;10
1401;Delfinukas;Varpelių;91028452879;Taip;5;4;0;9
1402;Delfinukas;Varpelių;1325054642;Ne;8;4;0;12
1403;Delfinukas;Varpelių;7163839896;Ne;3;4;1;8
1404;Delfinukas;Varpelių;7493037613;Ne;3;4;1;8
1405;Delfinukas;Varpelių;4239224971;Taip;0;3;0;3
1406;Delfinukas;Varpelių;1650166115;Ne;7;4;0;11
1407;Delfinukas;Varpelių;5123666058;Ne;9;0;0;9
1408;Delfinukas;Varpelių;4713803167;Taip;0;0;21;21
1409;Delfinukas;Varpelių;8936645508;Taip;7;1;0;8
1410;Delfinukas;Varpelių;26626004000;Taip;15;0;0;15
1411;Delfinukas;Varpelių;6047881184;Taip;2;0;0;2
1412;Delfinukas;Delfinukai;6190642132;Taip;0;8;0;8
1413;Delfinukas;Delfinukai;17266052771;Taip;4;0;0;4
1414;Delfinukas;Delfinukai;57676205527;Taip;0;7;0;7
1415;Delfinukas;Delfinukai;71523999168;Taip;0;7;0;7
1416;Delfinukas;Delfinukai;46276990963;Taip;0;2;2;4
1417;Delfinukas;Delfinukai;7528505426;Taip;0;5;0;5
1418;Delfinukas;Delfinukai;545765924;Taip;18;0;0;18
1419;Delfinukas;Delfinukai;2402524470;Taip;12;0;0;12
1420;Delfinukas;Delfinukai;9168812609;Taip;0;1;0;1
1421;Delfinukas;Delfinukai;2135364149;Taip;2;1;0;3
1422;Delfinukas;Delfinukai;34706967888;Taip;0;0;21;21
1423;Delfinukas;Delfinukai;1848598718;Taip;6;2;0;8
1424;Delfinukas;Delfinukai;4435982727;Taip;0;6;0;6
1425;Delfinukas;Delfinukai;85274001355;Taip;0;4;0;4
1426;Delfinukas;Delfinukai;9821969586;Taip;0;11;0;11
1427;Delfinukas;Delfinukai;4569691896;Taip;14;0;0;14
1428;Delfinukas;Drugeliai;6561536457;Taip;0;4;2;6
1429;Delfinukas;Drugeliai;4179507316;Taip;5;4;0;9
1430;Delfinukas;Drugeliai;2701448160;Ne;5;0;0;5
1431;Delfinukas;Drugeliai;8440546956;Taip;7;0;0;7
1432;Delfinukas;Drugeliai;6201567680;Taip;10;0;0;10
1433;Delfinukas;Drugeliai;1672021829;Ne;2;0;4;6
1434;Delfinukas;Drugeliai;2429427703;Ne;6;0;0;6
1435;Delfinukas;Drugeliai;9921730735;Taip;12;0;0;12
1436;Delfinukas;Drugeliai;7826428639;Ne;12;1;0;13
1437;Delfinukas;Drugeliai;1000049779;Taip;19;0;0;19
1438;Delfinukas;Drugeliai;3071312399;Ne;10;0;4;14
1439;Delfinukas;Drugeliai;7886801955;Taip;0;0;21;21
1440;Delfinukas;Drugeliai;8227660508;Taip;10;0;4;14
1441;Delfinukas;Drugeliai;2883959240;Taip;9;0;0;9
1442;Delfinukas;Drugeliai;1160537966;Taip;5;7;5;17
1443;Delfinukas;Drugeliai;1430155044;Taip;0;4;4;8
1444;Delfinukas;Žuvytės;6578506861;Taip;5;0;2;7
1445;Delfinukas;Žuvytės;6572690788;Taip;0;12;0;12
1446;Delfinukas;Žuvytės;3397350274;Taip;4;0;0;4
1447;Delfinukas;Žuvytės;9520598359;Taip;13;0;0;13
1448;Delfinukas;Žuvytės;3804996594;Taip;14;0;0;14
1449;Delfinukas;Žuvytės;1136182876;Taip;2;4;0;6
1450;Delfinukas;Žuvytės;7873373923;Taip;4;0;0;4
1451;Delfinukas;Žuvytės;2066127119;Ne;0;4;0;4
1452;Delfinukas;Žuvytės;2869506388;Taip;0;4;1;5
1453;Delfinukas;Žuvytės;7487111570;Ne;6;3;0;9
1454;Delfinukas;Žuvytės;6844500395;Taip;0;6;3;9
1455;Delfinukas;Žuvytės;9074294473;Taip;6;0;7;13
1456;Delfinukas;Žuvytės;2445742257;Taip;0;0;21;21
1457;Delfinukas;Žuvytės;8938997208;Taip;19;0;0;19
1458;Delfinukas;Žuvytės;9934325492;Taip;4;0;0;4
1459;Delfinukas;Žuvytės;8160982025;Taip;9;2;0;11
1460;Delfinukas;Žuvytės;6949000708;Taip;0;0;4;4
1461;Delfinukas;Žuvytės;6322255194;Taip;0;6;0;6
1462;Delfinukas;Žuvytės;9898412288;Taip;11;0;2;13
1463;Delfinukas;Žuvytės;6445868759;Taip;0;2;0;2
1464;Delfinukas;Delfinai;2890469172;Taip;11;0;6;17
1465;Delfinukas;Delfinai;9628317328;Taip;9;6;0;15
1466;Delfinukas;Delfinai;8038737019;Taip;4;2;1;7
1467;Delfinukas;Delfinai;5797308373;Taip;11;0;0;11
1468;Delfinukas;Delfinai;6337962165;Taip;0;2;6;8
1469;Delfinukas;Delfinai;5241426445;Taip;8;4;0;12
1470;Delfinukas;Delfinai;8099120371;Taip;8;0;0;8
1471;Delfinukas;Delfinai;3108430680;Taip;0;5;0;5
1472;Delfinukas;Delfinai;7663934825;Ne;0;7;1;8
1473;Delfinukas;Delfinai;2382077576;Taip;6;1;0;7
1474;Delfinukas;Delfinai;1200205376;Taip;12;4;0;16
1475;Delfinukas;Delfinai;7629622746;Ne;11;1;0;12
1476;Delfinukas;Delfinai;4347116918;Taip;14;0;0;14
1477;Delfinukas;Delfinai;2784942324;Ne;8;2;0;10
1478;Delfinukas;Delfinai;1922513830;Taip;13;3;0;16
1479;Delfinukas;Paukšteliai;7609115506;Taip;0;2;0;2
1480;Delfinukas;Paukšteliai;6873181103;Taip;0;1;2;3
1481;Delfinukas;Paukšteliai;7868415893;Taip;0;0;21;21
1482;Delfinukas;Paukšteliai;2756574162;Taip;10;1;0;11
1483;Delfinukas;Paukšteliai;5060445169;Taip;0;1;2;3
1484;Delfinukas;Paukšteliai;6992505341;Ne;0;0;21;21
1485;Delfinukas;Paukšteliai;9927854348;Taip;7;0;4;11
1486;Delfinukas;Paukšteliai;8028279246;Taip;0;2;6;8
1487;Delfinukas;Paukšteliai;6884260821;Taip;0;0;21;21
1488;Delfinukas;Paukšteliai;9592384914;Taip;0;0;19;19
1489;Delfinukas;Paukšteliai;8328481987;Taip;0;0;21;21
1490;Delfinukas;Kiškučiai;98742243823;Taip;0;6;0;6
1491;Delfinukas;Kiškučiai;1498120150;Ne;0;7;0;7
1492;Delfinukas;Kiškučiai;7920401664;Taip;0;2;0;2
1493;Delfinukas;Kiškučiai;1767369189;Ne;7;6;0;13
1494;Delfinukas;Kiškučiai;1495145663;Ne;0;0;2;2
1495;Delfinukas;Kiškučiai;1301231548;Taip;0;5;4;9
1496;Delfinukas;Kiškučiai;1613911039;Taip;2;2;0;4
1497;Delfinukas;Kiškučiai;1477374660;Taip;11;1;2;14
1498;Delfinukas;Kiškučiai;1487082744;Taip;0;4;0;4
1499;Delfinukas;Kiškučiai;1011101007;Ne;0;4;0;4
1500;Delfinukas;Kiškučiai;2063259303;Taip;0;13;0;13
1501;Delfinukas;Kiškučiai;1166370228;Taip;0;2;0;2
1502;Delfinukas;Kiškučiai;96861425670;Taip;0;3;0;3
1503;Delfinukas;Kiškučiai;60320557464;Ne;5;2;0;7
1504;Delfinukas;Kiškučiai;1594700604;Taip;0;10;0;10
1505;Delfinukas;Kiškučiai;7509276953;Ne;6;0;0;6
1506;Delfinukas;Kiškučiai;49489087212;Taip;0;4;0;4
1507;Delfinukas;Kiškučiai;83920976768;Taip;8;4;0;12
1508;Drevinukas;ZUIKUČIAI;1720464417;Taip;3;4;2;9
1509;Drevinukas;ZUIKUČIAI;6095020718;Ne;7;0;0;7
1510;Drevinukas;ZUIKUČIAI;3981507849;Taip;0;4;0;4
1511;Drevinukas;ZUIKUČIAI;5679723776;Taip;1;4;0;5
1512;Drevinukas;ZUIKUČIAI;2857797268;Taip;0;0;3;3
1513;Drevinukas;ZUIKUČIAI;7753238387;Taip;0;0;1;1
1514;Drevinukas;ZUIKUČIAI;3875062228;Taip;11;0;0;11
1515;Drevinukas;ZUIKUČIAI;8130416781;Taip;9;4;1;14
1516;Drevinukas;ZUIKUČIAI;8479979176;Taip;16;0;0;16
1517;Drevinukas;ZUIKUČIAI;2531207946;Taip;14;0;0;14
1518;Drevinukas;ZUIKUČIAI;3972897839;Ne;12;0;0;12
1519;Drevinukas;ZUIKUČIAI;1152161183;Taip;5;2;0;7
1520;Drevinukas;ZUIKUČIAI;6256572875;Taip;2;0;1;3
1521;Drevinukas;ZUIKUČIAI;8936058501;Taip;5;0;4;9
1522;Drevinukas;ZUIKUČIAI;9772484901;Taip;0;5;0;5
1523;Drevinukas;ZUIKUČIAI;7520907833;Taip;0;9;0;9
1524;Drevinukas;ZUIKUČIAI;8625382465;Taip;9;0;0;9
1525;Drevinukas;ZUIKUČIAI;1099462840;Taip;0;1;0;1
1526;Drevinukas;ZUIKUČIAI;8611131264;Taip;0;14;0;14
1527;Drevinukas;ZUIKUČIAI;6833120798;Taip;12;0;0;12
1528;Drevinukas;ZUIKUČIAI;7607135647;Taip;10;0;0;10
1529;Drevinukas;AŽUOLIUKŲ;1970787957;Taip;0;8;0;8
1530;Drevinukas;AŽUOLIUKŲ;39014589824;Taip;0;4;0;4
1531;Drevinukas;AŽUOLIUKŲ;3625661236;Taip;0;7;0;7
1532;Drevinukas;AŽUOLIUKŲ;46323011887;Taip;0;4;1;5
1533;Drevinukas;AŽUOLIUKŲ;17722412785;Taip;10;4;1;15
1534;Drevinukas;AŽUOLIUKŲ;1437074990;Taip;0;4;1;5
1535;Drevinukas;AŽUOLIUKŲ;8325320616;Taip;0;4;1;5
1536;Drevinukas;AŽUOLIUKŲ;1577311253;Taip;6;4;0;10
1537;Drevinukas;AŽUOLIUKŲ;6539595624;Taip;7;0;2;9
1538;Drevinukas;AŽUOLIUKŲ;7570410899;Ne;2;9;7;18
1539;Drevinukas;AŽUOLIUKŲ;1929303009;Ne;5;0;4;9
1540;Drevinukas;AŽUOLIUKŲ;64093448834;Ne;5;0;3;8
1541;Drevinukas;AŽUOLIUKŲ;59090501289;Taip;5;0;1;6
1542;Drevinukas;AŽUOLIUKŲ;1585468549;Taip;0;13;0;13
1543;Drevinukas;AŽUOLIUKŲ;1276720097;Taip;10;6;0;16
1544;Drevinukas;AŽUOLIUKŲ;3604979285;Taip;8;4;2;14
1545;Drevinukas;AŽUOLIUKŲ;78348414683;Taip;3;5;2;10
1546;Drevinukas;AŽUOLIUKŲ;30667895560;Taip;0;4;3;7
1547;Drevinukas;AŽUOLIUKŲ;83194462453;Taip;0;6;0;6
1548;Drevinukas;AŽUOLIUKŲ;5521378389;Taip;0;3;3;6
1549;Drevinukas;PELĖDŽIUKAI;13638194271;Taip;0;4;0;4
1550;Drevinukas;PELĖDŽIUKAI;64560340218;Taip;9;3;0;12
1551;Drevinukas;PELĖDŽIUKAI;17456144256;Taip;0;4;2;6
1552;Drevinukas;PELĖDŽIUKAI;3066586415;Taip;0;4;4;8
1553;Drevinukas;PELĖDŽIUKAI;1250033881;Taip;2;4;1;7
1554;Drevinukas;PELĖDŽIUKAI;22050717457;Taip;0;4;1;5
1555;Drevinukas;PELĖDŽIUKAI;74690633233;Taip;2;4;0;6
1556;Drevinukas;PELĖDŽIUKAI;73923305630;Ne;0;4;1;5
1557;Drevinukas;PELĖDŽIUKAI;29000633056;Taip;0;4;3;7
1558;Drevinukas;PELĖDŽIUKAI;1254845545;Taip;0;5;1;6
1559;Drevinukas;PELĖDŽIUKAI;46006802320;Taip;0;7;0;7
1560;Drevinukas;PELĖDŽIUKAI;49704496121;Taip;0;4;0;4
1561;Drevinukas;PELĖDŽIUKAI;1978599912;Taip;0;4;2;6
1562;Drevinukas;PELĖDŽIUKAI;9657606451;Taip;6;7;0;13
1563;Drevinukas;PELĖDŽIUKAI;4150306697;Taip;0;21;0;21
1564;Drevinukas;PELĖDŽIUKAI;37485364300;Taip;0;2;6;8
1565;Drevinukas;PELĖDŽIUKAI;71447591085;Taip;6;8;1;15
1566;Drevinukas;PELĖDŽIUKAI;2483043689;Taip;0;4;0;4
1567;Drevinukas;PELĖDŽIUKAI;4980076288;Taip;0;3;3;6
1568;Drevinukas;BORUŽĖLĖS;7519369167;Taip;4;0;0;4
1569;Drevinukas;BORUŽĖLĖS;1123115847;Taip;11;4;2;17
1570;Drevinukas;BORUŽĖLĖS;1987939679;Taip;0;0;7;7
1571;Drevinukas;BORUŽĖLĖS;9336227821;Taip;0;6;0;6
1572;Drevinukas;BORUŽĖLĖS;4784716615;Taip;0;4;0;4
1573;Drevinukas;BORUŽĖLĖS;2070374746;Taip;0;0;7;7
1574;Drevinukas;BORUŽĖLĖS;9803670483;Taip;8;0;0;8
1575;Drevinukas;BORUŽĖLĖS;16952164778;Taip;0;9;0;9
1576;Drevinukas;BORUŽĖLĖS;3657451903;Taip;2;10;0;12
1577;Drevinukas;BORUŽĖLĖS;8180027849;Taip;0;4;3;7
1578;Drevinukas;BORUŽĖLĖS;4332606643;Ne;0;0;4;4
1579;Drevinukas;BORUŽĖLĖS;7632515230;Taip;17;0;0;17
1580;Drevinukas;BORUŽĖLĖS;6304169257;Taip;0;0;4;4
1581;Drevinukas;BORUŽĖLĖS;5686116320;Ne;0;0;1;1
1582;Drevinukas;BORUŽĖLĖS;56028675283;Taip;6;4;0;10
1583;Drevinukas;BORUŽĖLĖS;85288014888;Taip;0;6;0;6
1584;Drevinukas;BORUŽĖLĖS;1019214451;Taip;8;0;2;10
1585;Drevinukas;BITUTĖS;24300552411;Taip;2;4;0;6
1586;Drevinukas;BITUTĖS;96688324084;Taip;0;6;0;6
1587;Drevinukas;BITUTĖS;70347618653;Taip;1;4;4;9
1588;Drevinukas;BITUTĖS;30808032808;Taip;0;4;1;5
1589;Drevinukas;BITUTĖS;7088781332;Taip;0;3;0;3
1590;Drevinukas;BITUTĖS;67343152327;Ne;0;4;0;4
1591;Drevinukas;BITUTĖS;73165075762;Taip;7;0;0;7
1592;Drevinukas;BITUTĖS;91352351942;Taip;11;4;0;15
1593;Drevinukas;BITUTĖS;43573400232;Taip;3;3;0;6
1594;Drevinukas;BITUTĖS;43087053446;Taip;3;4;1;8
1595;Drevinukas;BITUTĖS;62294117396;Taip;2;4;0;6
1596;Drevinukas;BITUTĖS;7670120949;Ne;0;4;0;4
1597;Drevinukas;BITUTĖS;1180916359;Taip;0;4;4;8
1598;Drevinukas;BITUTĖS;63665560323;Taip;0;4;0;4
1599;Drevinukas;BITUTĖS;8943620706;Taip;0;0;10;10
1600;Drevinukas;BITUTĖS;4352184625;Taip;0;4;12;16
1601;Drevinukas;BITUTĖS;1025218361;Taip;0;0;1;1
1602;Drevinukas;BITUTĖS;1711831210;Taip;0;0;1;1
1603;Drevinukas;NYKŠTUKAI;4539246865;Ne;5;2;0;7
1604;Drevinukas;NYKŠTUKAI;7334626684;Taip;0;0;8;8
1605;Drevinukas;NYKŠTUKAI;2423143170;Taip;2;0;4;6
1606;Drevinukas;NYKŠTUKAI;5236292764;Taip;0;0;2;2
1607;Drevinukas;NYKŠTUKAI;1098647410;Taip;0;0;14;14
1608;Drevinukas;NYKŠTUKAI;2935175014;Taip;0;6;6;12
1609;Drevinukas;NYKŠTUKAI;5348609358;Taip;3;5;2;10
1610;Drevinukas;NYKŠTUKAI;2312241894;Taip;12;4;0;16
1611;Drevinukas;NYKŠTUKAI;5394143000;Taip;0;8;0;8
1612;Drevinukas;NYKŠTUKAI;4260123123;Taip;0;0;9;9
1613;Drevinukas;NYKŠTUKAI;5754055310;Taip;0;0;6;6
1614;Drevinukas;NYKŠTUKAI;3871506691;Taip;0;2;0;2
1615;Drevinukas;NYKŠTUKAI;6914111231;Taip;0;2;0;2
1616;Drevinukas;NYKŠTUKAI;3046196006;Taip;0;8;0;8
1617;Drevinukas;NYKŠTUKAI;3377957769;Taip;2;0;5;7
1618;Drevinukas;NYKŠTUKAI;3779983775;Taip;4;10;0;14
1619;Drevinukas;NYKŠTUKAI;1829421385;Taip;6;4;1;11
1620;Drevinukas;NYKŠTUKAI;4134729710;Ne;0;1;6;7
1621;Drevinukas;NYKŠTUKAI;8262224710;Taip;9;4;0;13
1622;Drevinukas;SMALSUČIAI;1644656704;Taip;16;0;2;18
1623;Drevinukas;SMALSUČIAI;1058927778;Taip;0;1;2;3
1624;Drevinukas;SMALSUČIAI;5673244101;Taip;12;4;0;16
1625;Drevinukas;SMALSUČIAI;1564065835;Taip;8;7;0;15
1626;Drevinukas;SMALSUČIAI;7689145214;Ne;9;4;1;14
1627;Drevinukas;SMALSUČIAI;8143614891;Ne;16;4;0;20
1628;Drevinukas;SMALSUČIAI;4262951360;Taip;2;4;7;13
1629;Drevinukas;SMALSUČIAI;9174977150;Taip;0;5;2;7
1630;Drevinukas;SMALSUČIAI;5928234487;Taip;0;7;1;8
1631;Drevinukas;SMALSUČIAI;3617533357;Taip;2;1;0;3
1632;Drevinukas;SMALSUČIAI;6904083734;Ne;0;0;2;2
1633;Drevinukas;SMALSUČIAI;5323434566;Taip;21;0;0;21
1634;Drevinukas;SMALSUČIAI;8744467866;Taip;0;0;6;6
1635;Drevinukas;SMALSUČIAI;3725760478;Taip;15;4;0;19
1636;Drevinukas;SMALSUČIAI;8239000041;Ne;5;0;6;11
1637;Drevinukas;ŽVIRBLIUKAI;3032536983;Taip;7;2;0;9
1638;Drevinukas;ŽVIRBLIUKAI;8556218971;Taip;6;0;0;6
1639;Drevinukas;ŽVIRBLIUKAI;5524567803;Taip;7;0;1;8
1640;Drevinukas;ŽVIRBLIUKAI;9016985238;Taip;0;0;5;5
1641;Drevinukas;ŽVIRBLIUKAI;2929598743;Taip;0;1;1;2
1642;Drevinukas;ŽVIRBLIUKAI;6373230526;Taip;6;0;1;7
1643;Drevinukas;ŽVIRBLIUKAI;4404254932;Taip;0;6;2;8
1644;Drevinukas;ŽVIRBLIUKAI;2378493422;Taip;5;4;0;9
1645;Drevinukas;ŽVIRBLIUKAI;8984653958;Taip;5;0;0;5
1646;Drevinukas;ŽVIRBLIUKAI;5620887702;Ne;0;4;0;4
1647;Drevinukas;ŽVIRBLIUKAI;2281463885;Ne;6;4;1;11
1648;Drevinukas;ŽVIRBLIUKAI;4662426451;Ne;0;0;4;4
1649;Drevinukas;ŽVIRBLIUKAI;7218201733;Taip;12;0;2;14
1650;Drevinukas;ŽVIRBLIUKAI;4076576850;Taip;10;0;9;19
1651;Drevinukas;ŽVIRBLIUKAI;4471405682;Taip;0;0;5;5
1652;Drevinukas;ŽVIRBLIUKAI;1859208322;Taip;11;0;0;11
1653;Drevinukas;ŽVIRBLIUKAI;5875459639;Taip;0;10;6;16
1654;Drevinukas;ŽVIRBLIUKAI;4312429104;Taip;0;0;3;3
1655;Drugelis;NYKŠTUKŲ;6452921695;Taip;1;2;0;3
1656;Drugelis;NYKŠTUKŲ;4927896706;Ne;5;0;0;5
1657;Drugelis;NYKŠTUKŲ;9316073597;Taip;6;2;0;8
1658;Drugelis;NYKŠTUKŲ;1255124184;Taip;5;1;0;6
1659;Drugelis;NYKŠTUKŲ;3551095669;Taip;4;5;0;9
1660;Drugelis;NYKŠTUKŲ;1785724340;Ne;4;10;0;14
1661;Drugelis;NYKŠTUKŲ;6632884258;Taip;10;5;0;15
1662;Drugelis;NYKŠTUKŲ;3061896520;Taip;3;2;0;5
1663;Drugelis;NYKŠTUKŲ;8070030439;Taip;3;2;0;5
1664;Drugelis;NYKŠTUKŲ;9612696781;Taip;0;0;2;2
1665;Drugelis;NYKŠTUKŲ;7447519502;Taip;5;5;0;10
1666;Drugelis;NYKŠTUKŲ;4523513611;Taip;0;6;3;9
1667;Drugelis;NYKŠTUKŲ;5692743298;Taip;4;3;0;7
1668;Drugelis;NYKŠTUKŲ;6594452094;Ne;7;7;0;14
1669;Drugelis;NYKŠTUKŲ;5122256823;Taip;0;1;0;1
1670;Drugelis;NYKŠTUKŲ;4825232236;Ne;9;1;1;11
1671;Drugelis;NYKŠTUKŲ;7477547789;Taip;9;2;0;11
1672;Drugelis;NYKŠTUKŲ;8752459733;Taip;7;2;0;9
1673;Drugelis;NYKŠTUKŲ;8717445483;Taip;0;9;0;9
1674;Drugelis;NYKŠTUKŲ;4158475365;Ne;9;1;1;11
1675;Drugelis;NYKŠTUKŲ;7609530453;Taip;7;0;0;7
1676;Drugelis;NYKŠTUKŲ;4867387611;Taip;11;3;0;14
1677;Drugelis;SMALSUČIŲ;3096906506;Taip;0;6;1;7
1678;Drugelis;SMALSUČIŲ;1576853049;Taip;0;5;2;7
1679;Drugelis;SMALSUČIŲ;1856912386;Ne;0;2;6;8
1680;Drugelis;SMALSUČIŲ;1255315664;Taip;8;0;0;8
1681;Drugelis;SMALSUČIŲ;7406396614;Taip;0;6;0;6
1682;Drugelis;SMALSUČIŲ;1217635751;Taip;0;0;9;9
1683;Drugelis;SMALSUČIŲ;68223183150;Ne;16;1;0;17
1684;Drugelis;SMALSUČIŲ;3479833265;Taip;0;3;2;5
1685;Drugelis;SMALSUČIŲ;3202149560;Taip;0;5;0;5
1686;Drugelis;SMALSUČIŲ;27569805506;Taip;0;10;1;11
1687;Drugelis;SMALSUČIŲ;1901608445;Taip;0;9;0;9
1688;Drugelis;SMALSUČIŲ;1160161173;Taip;0;4;0;4
1689;Drugelis;SMALSUČIŲ;1843605624;Taip;0;5;0;5
1690;Drugelis;SMALSUČIŲ;1506988472;Taip;0;7;0;7
1691;Drugelis;SMALSUČIŲ;1991420008;Taip;0;7;0;7
1692;Drugelis;SMALSUČIŲ;1421438458;Ne;0;6;1;7
1693;Drugelis;SMALSUČIŲ;53874036107;Taip;0;5;0;5
1694;Drugelis;SMALSUČIŲ;1961898730;Taip;0;6;0;6
1695;Drugelis;SMALSUČIŲ;4788423265;Taip;0;0;4;4
1696;Drugelis;SMALSUČIŲ;1541276266;Taip;0;6;0;6
1697;Drugelis;SMALSUČIŲ;5954059321;Ne;19;0;0;19
1698;Drugelis;SMALSUČIŲ;1888002607;Taip;0;2;1;3
1699;Drugelis;MUMINUKŲ;51963723965;Taip;20;0;0;20
1700;Drugelis;MUMINUKŲ;10841811704;Taip;0;8;0;8
1701;Drugelis;MUMINUKŲ;55662263930;Taip;0;8;0;8
1702;Drugelis;MUMINUKŲ;78391738678;Taip;0;5;1;6
1703;Drugelis;MUMINUKŲ;44627668646;Ne;0;5;0;5
1704;Drugelis;MUMINUKŲ;78311619943;Taip;0;4;0;4
1705;Drugelis;MUMINUKŲ;35386244403;Taip;0;8;0;8
1706;Drugelis;MUMINUKŲ;88073976875;Ne;9;5;0;14
1707;Drugelis;MUMINUKŲ;85362607749;Taip;0;2;0;2
1708;Drugelis;MUMINUKŲ;13989264253;Taip;14;4;0;18
1709;Drugelis;MUMINUKŲ;55339135155;Ne;9;5;0;14
1710;Drugelis;MUMINUKŲ;82465836364;Taip;0;4;0;4
1711;Drugelis;MUMINUKŲ;63173368598;Taip;0;4;0;4
1712;Drugelis;MUMINUKŲ;29713921940;Taip;2;4;1;7
1713;Drugelis;MUMINUKŲ;82441447907;Taip;12;0;0;12
1714;Drugelis;MUMINUKŲ;70288969200;Taip;0;4;0;4
1715;Drugelis;MUMINUKŲ;72147158912;Taip;0;4;0;4
1716;Drugelis;MUMINUKŲ;1240607928;Taip;0;6;0;6
1717;Drugelis;MUMINUKŲ;59819126556;Taip;14;0;0;14
1718;Drugelis;PŪKUOTUKAI;49035429728;Taip;0;2;1;3
1719;Drugelis;PŪKUOTUKAI;3156382280;Taip;0;6;2;8
1720;Drugelis;PŪKUOTUKAI;26436464504;Taip;0;5;0;5
1721;Drugelis;PŪKUOTUKAI;1657445173;Taip;4;5;4;13
1722;Drugelis;PŪKUOTUKAI;27379769302;Taip;0;4;0;4
1723;Drugelis;PŪKUOTUKAI;91538620813;Taip;2;2;0;4
1724;Drugelis;PŪKUOTUKAI;68716515660;Taip;5;5;0;10
1725;Drugelis;PŪKUOTUKAI;1162058481;Taip;0;5;0;5
1726;Drugelis;PŪKUOTUKAI;20943932955;Taip;0;0;4;4
1727;Drugelis;PŪKUOTUKAI;1667056936;Taip;9;1;4;14
1728;Drugelis;PŪKUOTUKAI;63777226415;Taip;0;1;0;1
1729;Drugelis;PŪKUOTUKAI;1005872691;Taip;0;8;0;8
1730;Drugelis;PŪKUOTUKAI;49678120281;Taip;18;0;0;18
1731;Drugelis;PŪKUOTUKAI;3403116175;Taip;21;0;0;21
1732;Drugelis;PŪKUOTUKAI;9654611393;Taip;9;4;0;13
1733;Drugelis;PŪKUOTUKAI;1651512363;Taip;6;0;1;7
1734;Drugelis;PŪKUOTUKAI;67282950717;Taip;0;0;5;5
1735;Drugelis;PŪKUOTUKAI;1546655542;Taip;0;0;13;13
1736;Drugelis;SPINDULIUKAI;1858504360;Taip;11;1;0;12
1737;Drugelis;SPINDULIUKAI;5194285627;Taip;13;2;0;15
1738;Drugelis;SPINDULIUKAI;8107970910;Taip;12;0;0;12
1739;Drugelis;SPINDULIUKAI;1666992752;Taip;13;0;0;13
1740;Drugelis;SPINDULIUKAI;9029137302;Taip;7;0;0;7
1741;Drugelis;SPINDULIUKAI;9907121223;Taip;13;0;0;13
1742;Drugelis;SPINDULIUKAI;3293212749;Taip;4;0;0;4
1743;Drugelis;SPINDULIUKAI;8500348389;Taip;11;0;0;11
1744;Drugelis;SPINDULIUKAI;9510744779;Taip;4;10;0;14
1745;Drugelis;SPINDULIUKAI;9836193857;Taip;2;2;0;4
1746;Drugelis;SPINDULIUKAI;5515894973;Taip;0;7;0;7
1747;Drugelis;SPINDULIUKAI;8282807535;Taip;0;4;0;4
1748;Drugelis;KIŠKUČIAI;6321332888;Taip;8;3;0;11
1749;Drugelis;KIŠKUČIAI;5902687211;Taip;0;0;5;5
1750;Drugelis;KIŠKUČIAI;7253876812;Taip;11;0;0;11
1751;Drugelis;KIŠKUČIAI;2146963673;Taip;18;0;0;18
1752;Drugelis;KIŠKUČIAI;2256221485;Taip;11;0;0;11
1753;Drugelis;KIŠKUČIAI;8812550811;Taip;0;4;10;14
1754;Drugelis;KIŠKUČIAI;3085309902;Taip;6;0;0;6
1755;Drugelis;KIŠKUČIAI;5661335344;Taip;15;0;0;15
1756;Drugelis;KIŠKUČIAI;3037496936;Taip;0;0;11;11
1757;Drugelis;KIŠKUČIAI;9345527734;Taip;4;0;0;4
1758;Drugelis;KIŠKUČIAI;6038184222;Taip;4;2;1;7
1759;Drugelis;KIŠKUČIAI;1816845006;Taip;2;2;0;4
1760;Drugelis;KIŠKUČIAI;8591548746;Taip;0;4;1;5
1761;"Du gaideliai";Uodelių;3507387826;Ne;10;9;0;19
1762;"Du gaideliai";Uodelių;4144269068;Taip;21;0;0;21
1763;"Du gaideliai";Uodelių;1785976627;Taip;9;0;4;13
1764;"Du gaideliai";Uodelių;2921485707;Taip;11;4;0;15
1765;"Du gaideliai";Uodelių;5894974508;Taip;0;5;0;5
1766;"Du gaideliai";Uodelių;1135098595;Taip;7;4;0;11
1767;"Du gaideliai";Uodelių;3370029981;Ne;11;6;2;19
1768;"Du gaideliai";Uodelių;5652662610;Taip;7;5;0;12
1769;"Du gaideliai";Uodelių;5103483956;Taip;7;3;0;10
1770;"Du gaideliai";Uodelių;6348951959;Taip;19;0;1;20
1771;"Du gaideliai";Uodelių;4378924981;Taip;3;2;0;5
1772;"Du gaideliai";Uodelių;3854355215;Taip;3;10;0;13
1773;"Du gaideliai";Uodelių;3849899284;Taip;3;6;0;9
1774;"Du gaideliai";Uodelių;7373413569;Taip;0;5;0;5
1775;"Du gaideliai";Uodelių;6783206132;Taip;19;0;0;19
1776;"Du gaideliai";Uodelių;2262425557;Taip;6;0;3;9
1777;"Du gaideliai";Uodelių;2240947701;Taip;9;0;3;12
1778;"Du gaideliai";Uodelių;6247706405;Taip;9;0;0;9
1779;"Du gaideliai";Uodelių;1268479215;Taip;20;0;0;20
1780;"Du gaideliai";OŽIUKŲ;2159833613;Taip;0;15;0;15
1781;"Du gaideliai";OŽIUKŲ;1549762923;Ne;0;5;0;5
1782;"Du gaideliai";OŽIUKŲ;5430986033;Taip;9;3;0;12
1783;"Du gaideliai";OŽIUKŲ;2601122166;Taip;12;0;0;12
1784;"Du gaideliai";OŽIUKŲ;6750787450;Taip;9;2;0;11
1785;"Du gaideliai";OŽIUKŲ;4387568448;Taip;0;2;9;11
1786;"Du gaideliai";OŽIUKŲ;1211005513;Taip;7;4;0;11
1787;"Du gaideliai";OŽIUKŲ;1500684755;Taip;21;0;0;21
1788;"Du gaideliai";OŽIUKŲ;7084763712;Taip;10;1;0;11
1789;"Du gaideliai";OŽIUKŲ;6715434585;Taip;9;4;0;13
1790;"Du gaideliai";OŽIUKŲ;9324740716;Taip;15;0;0;15
1791;"Du gaideliai";OŽIUKŲ;1230622413;Taip;6;5;0;11
1792;"Du gaideliai";OŽIUKŲ;94639433266;Taip;4;4;0;8
1793;"Du gaideliai";OŽIUKŲ;7783203480;Taip;7;0;0;7
1794;"Du gaideliai";OŽIUKŲ;1758546983;Taip;11;2;0;13
1795;"Du gaideliai";OŽIUKŲ;6203383711;Taip;13;0;0;13
1796;"Du gaideliai";OŽIUKŲ;1876870081;Taip;14;0;0;14
1797;"Du gaideliai";OŽIUKŲ;1962859229;Taip;9;0;0;9
1798;"Du gaideliai";OŽIUKŲ;1557413692;Taip;0;3;0;3
1799;"Du gaideliai";OŽIUKŲ;3560637865;Taip;11;4;0;15
1800;"Du gaideliai";OŽIUKŲ;3771563320;Taip;5;0;0;5
1801;"Du gaideliai";Vištyčių;1512578437;Ne;0;8;0;8
1802;"Du gaideliai";Vištyčių;1791530261;Taip;0;9;0;9
1803;"Du gaideliai";Vištyčių;1479672134;Taip;7;6;0;13
1804;"Du gaideliai";Vištyčių;50087080642;Taip;0;6;0;6
1805;"Du gaideliai";Vištyčių;25738622801;Taip;0;6;0;6
1806;"Du gaideliai";Vištyčių;1628346439;Taip;0;10;0;10
1807;"Du gaideliai";Vištyčių;14681393632;Taip;0;5;0;5
1808;"Du gaideliai";Vištyčių;1128234653;Taip;0;4;0;4
1809;"Du gaideliai";Vištyčių;60934378499;Taip;0;2;0;2
1810;"Du gaideliai";Vištyčių;91470338843;Taip;0;0;5;5
1811;"Du gaideliai";Vištyčių;6161829923;Taip;0;15;0;15
1812;"Du gaideliai";Vištyčių;30562958921;Ne;0;5;0;5
1813;"Du gaideliai";Vištyčių;85962801220;Taip;0;4;0;4
1814;"Du gaideliai";Vištyčių;1261678548;Taip;0;11;0;11
1815;"Du gaideliai";Vištyčių;73447542654;Taip;0;4;0;4
1816;"Du gaideliai";Vištyčių;41922349110;Taip;0;3;0;3
1817;"Du gaideliai";Vištyčių;1304400387;Taip;0;6;0;6
1818;"Du gaideliai";Vištyčių;1291620608;Taip;4;4;0;8
1819;"Du gaideliai";Vištyčių;1923863232;Taip;0;4;0;4
1820;"Du gaideliai";Vištyčių;1906486044;Taip;4;11;0;15
1821;"Du gaideliai";Vištyčių;13384312035;Taip;5;0;6;11
1822;"Du gaideliai";Vištyčių;80297570999;Taip;3;0;1;4
1823;"Du gaideliai";GAIDŽIUKŲ;2157315097;Taip;8;1;0;9
1824;"Du gaideliai";GAIDŽIUKŲ;25898248315;Taip;0;10;0;10
1825;"Du gaideliai";GAIDŽIUKŲ;14599820571;Taip;0;7;0;7
1826;"Du gaideliai";GAIDŽIUKŲ;73654636959;Taip;0;4;0;4
1827;"Du gaideliai";GAIDŽIUKŲ;82205925738;Taip;0;7;0;7
1828;"Du gaideliai";GAIDŽIUKŲ;1258859998;Taip;0;7;0;7
1829;"Du gaideliai";GAIDŽIUKŲ;10516676378;Taip;0;1;0;1
1830;"Du gaideliai";GAIDŽIUKŲ;56826255179;Ne;11;4;0;15
1831;"Du gaideliai";GAIDŽIUKŲ;9173656753;Ne;9;1;0;10
1832;"Du gaideliai";GAIDŽIUKŲ;1888402861;Taip;0;8;0;8
1833;"Du gaideliai";GAIDŽIUKŲ;8087660692;Taip;12;0;0;12
1834;"Du gaideliai";GAIDŽIUKŲ;31139048776;Taip;7;2;0;9
1835;"Du gaideliai";GAIDŽIUKŲ;59558745879;Ne;12;4;0;16
1836;"Du gaideliai";GAIDŽIUKŲ;1277603882;Taip;10;4;0;14
1837;"Du gaideliai";GAIDŽIUKŲ;46193129936;Taip;6;0;0;6
1838;"Du gaideliai";GAIDŽIUKŲ;1850550387;Taip;7;5;0;12
1839;"Du gaideliai";GAIDŽIUKŲ;11621795110;Taip;7;6;0;13
1840;"Du gaideliai";GAIDŽIUKŲ;5159654440;Taip;0;1;0;1
1841;"Du gaideliai";GAIDŽIUKŲ;8634553012;Ne;14;0;0;14
1842;"Du gaideliai";GAIDŽIUKŲ;1469877068;Taip;0;4;1;5
1843;"Du gaideliai";Musyčių;1633544390;Ne;16;0;0;16
1844;"Du gaideliai";Musyčių;7033276798;Taip;4;4;0;8
1845;"Du gaideliai";Musyčių;3247101840;Taip;15;4;0;19
1846;"Du gaideliai";Musyčių;5998344519;Taip;7;6;0;13
1847;"Du gaideliai";Musyčių;4798503931;Taip;10;0;0;10
1848;"Du gaideliai";Musyčių;6870356241;Taip;0;6;0;6
1849;"Du gaideliai";Musyčių;6053941133;Taip;5;5;0;10
1850;"Du gaideliai";Musyčių;6522707709;Ne;20;0;0;20
1851;"Du gaideliai";Musyčių;6120647567;Taip;10;3;0;13
1852;"Du gaideliai";Musyčių;8043896286;Taip;12;0;0;12
1853;"Du gaideliai";Musyčių;1156396094;Taip;19;0;0;19
1854;"Du gaideliai";Musyčių;7297661383;Taip;11;1;3;15
1855;"Du gaideliai";Musyčių;9356275460;Taip;10;5;4;19
1856;"Du gaideliai";Musyčių;6204233540;Taip;7;2;0;9
1857;"Du gaideliai";Musyčių;6015360076;Taip;7;7;0;14
1858;"Du gaideliai";Musyčių;5788923258;Taip;9;3;0;12
1859;"Du gaideliai";Musyčių;7391278306;Ne;19;0;0;19
1860;"Du gaideliai";Musyčių;8047413507;Taip;14;1;0;15
1861;"Du gaideliai";MALŪNO;1968978650;Taip;2;0;2;4
1862;"Du gaideliai";MALŪNO;6762171696;Taip;1;0;0;1
1863;"Du gaideliai";MALŪNO;2100449108;Taip;4;0;2;6
1864;"Du gaideliai";MALŪNO;2905083899;Taip;21;0;0;21
1865;"Du gaideliai";MALŪNO;9126780620;Taip;10;4;0;14
1866;"Du gaideliai";MALŪNO;3019797369;Taip;12;4;0;16
1867;"Du gaideliai";MALŪNO;6074296305;Taip;4;0;5;9
1868;"Du gaideliai";MALŪNO;2151825222;Taip;0;5;0;5
1869;"Du gaideliai";MALŪNO;7575534590;Taip;11;0;1;12
1870;"Du gaideliai";MALŪNO;5728374219;Taip;17;0;0;17
1871;"Du gaideliai";MALŪNO;7726490359;Taip;21;0;0;21
1872;"Du gaideliai";MALŪNO;8410547195;Taip;10;4;0;14
1873;"Du gaideliai";MALŪNO;4408537397;Taip;10;4;0;14
1874;Eglutė;RAMUNĖ;1485521357;Taip;9;4;0;13
1875;Eglutė;RAMUNĖ;6403410879;Taip;0;4;0;4
1876;Eglutė;RAMUNĖ;82910530417;Taip;0;7;0;7
1877;Eglutė;RAMUNĖ;7035023835;Ne;0;4;4;8
1878;Eglutė;RAMUNĖ;67038463806;Taip;0;4;1;5
1879;Eglutė;RAMUNĖ;61256135116;Taip;7;6;0;13
1880;Eglutė;RAMUNĖ;32102678081;Taip;5;4;0;9
1881;Eglutė;RAMUNĖ;65593915933;Ne;0;12;0;12
1882;Eglutė;RAMUNĖ;92526575353;Ne;0;4;3;7
1883;Eglutė;RAMUNĖ;26716650724;Taip;6;8;0;14
1884;Eglutė;RAMUNĖ;9375046883;Taip;0;4;0;4
1885;Eglutė;RAMUNĖ;2053316445;Taip;0;4;6;10
1886;Eglutė;RAMUNĖ;1125331552;Ne;0;4;1;5
1887;Eglutė;RAMUNĖ;83194451903;Ne;0;4;0;4
1888;Eglutė;RAMUNĖ;2029176205;Taip;3;4;1;8
1889;Eglutė;RAMUNĖ;83912035659;Taip;0;8;0;8
1890;Eglutė;RAMUNĖ;96140363702;Taip;0;5;1;6
1891;Eglutė;RAMUNĖ;40325923876;Taip;0;4;0;4
1892;Eglutė;RAMUNĖ;91896736509;Taip;0;12;0;12
1893;Eglutė;RAMUNĖ;50471207849;Taip;0;15;0;15
1894;Eglutė;RAMUNĖ;10122792768;Taip;0;5;0;5
1895;Eglutė;RAMUNĖ;1565149756;Taip;6;4;1;11
1896;Eglutė;RAMUNĖ;2092342476;Taip;2;11;0;13
1897;Eglutė;PELĖDŽIUKAI;60257242941;Taip;0;8;0;8
1898;Eglutė;PELĖDŽIUKAI;1909791840;Taip;0;4;2;6
1899;Eglutė;PELĖDŽIUKAI;2045454657;Taip;0;4;2;6
1900;Eglutė;PELĖDŽIUKAI;2395506996;Ne;0;2;3;5
1901;Eglutė;PELĖDŽIUKAI;43151626858;Taip;0;5;0;5
1902;Eglutė;PELĖDŽIUKAI;75731523422;Taip;0;2;1;3
1903;Eglutė;PELĖDŽIUKAI;6323002362;Taip;0;4;1;5
1904;Eglutė;PELĖDŽIUKAI;64518610112;Taip;0;4;0;4
1905;Eglutė;PELĖDŽIUKAI;1954232966;Taip;7;4;0;11
1906;Eglutė;PELĖDŽIUKAI;18202528233;Taip;0;4;5;9
1907;Eglutė;PELĖDŽIUKAI;55334393780;Taip;0;11;0;11
1908;Eglutė;PELĖDŽIUKAI;40880035310;Taip;7;3;1;11
1909;Eglutė;PELĖDŽIUKAI;5214574745;Taip;6;5;0;11
1910;Eglutė;PELĖDŽIUKAI;82988135134;Taip;0;4;0;4
1911;Eglutė;PELĖDŽIUKAI;93427464717;Taip;4;2;1;7
1912;Eglutė;PELĖDŽIUKAI;96041043843;Taip;0;4;0;4
1913;Eglutė;PELĖDŽIUKAI;37576322876;Taip;0;4;1;5
1914;Eglutė;PELĖDŽIUKAI;46002742287;Ne;0;4;0;4
1915;Eglutė;PELĖDŽIUKAI;95597529215;Taip;0;4;4;8
1916;Eglutė;PELĖDŽIUKAI;3997033;Ne;7;7;0;14
1917;Eglutė;PELĖDŽIUKAI;75229333120;Ne;0;4;6;10
1918;Eglutė;PELĖDŽIUKAI;44421461989;Taip;0;4;4;8
1919;Eglutė;PELĖDŽIUKAI;49380660477;Ne;2;9;0;11
1920;Eglutė;PELĖDŽIUKAI;84721839602;Taip;7;4;2;13
1921;Eglutė;KODĖLČIUKAI;85964105325;Taip;13;8;0;21
1922;Eglutė;KODĖLČIUKAI;1939447097;Ne;0;6;4;10
1923;Eglutė;KODĖLČIUKAI;1881111005;Ne;0;6;3;9
1924;Eglutė;KODĖLČIUKAI;1100326735;Ne;0;8;2;10
1925;Eglutė;KODĖLČIUKAI;1398611395;Taip;0;1;5;6
1926;Eglutė;KODĖLČIUKAI;2041825568;Taip;6;0;1;7
1927;Eglutė;KODĖLČIUKAI;1814357743;Taip;2;0;10;12
1928;Eglutė;KODĖLČIUKAI;1356175751;Taip;0;4;0;4
1929;Eglutė;KODĖLČIUKAI;2147042152;Taip;7;0;2;9
1930;Eglutė;KODĖLČIUKAI;1112445550;Taip;0;0;2;2
1931;Eglutė;KODĖLČIUKAI;78489473446;Taip;1;5;0;6
1932;Eglutė;KODĖLČIUKAI;63268716266;Taip;0;5;2;7
1933;Eglutė;KODĖLČIUKAI;1418516444;Taip;0;5;0;5
1934;Eglutė;KODĖLČIUKAI;2112417439;Ne;4;0;0;4
1935;Eglutė;KODĖLČIUKAI;64360778537;Taip;14;0;0;14
1936;Eglutė;KODĖLČIUKAI;1426211949;Ne;8;1;0;9
1937;Eglutė;KODĖLČIUKAI;1120848949;Taip;0;4;0;4
1938;Eglutė;KODĖLČIUKAI;1882915662;Taip;5;0;0;5
1939;Eglutė;KODĖLČIUKAI;1747424609;Taip;0;1;0;1
1940;Eglutė;KODĖLČIUKAI;1227167233;Taip;8;0;1;9
1941;Eglutė;KODĖLČIUKAI;1187563631;Taip;0;6;0;6
1942;Eglutė;KODĖLČIUKAI;90878878800;Taip;9;0;0;9
1943;Eglutė;KODĖLČIUKAI;7132999520;Taip;0;4;1;5
1944;Eglutė;OBUOLIUKAI;7047262367;Taip;17;0;0;17
1945;Eglutė;OBUOLIUKAI;3584247594;Taip;7;13;0;20
1946;Eglutė;OBUOLIUKAI;9967488317;Taip;7;2;0;9
1947;Eglutė;OBUOLIUKAI;6362265057;Taip;17;2;0;19
1948;Eglutė;OBUOLIUKAI;7404631298;Taip;17;0;0;17
1949;Eglutė;OBUOLIUKAI;1759383841;Taip;0;5;0;5
1950;Eglutė;OBUOLIUKAI;5924994736;Taip;13;0;0;13
1951;Eglutė;OBUOLIUKAI;7446423510;Taip;14;0;1;15
1952;Eglutė;OBUOLIUKAI;3390360525;Taip;8;4;0;12
1953;Eglutė;OBUOLIUKAI;7758643349;Taip;10;0;3;13
1954;Eglutė;OBUOLIUKAI;4348313801;Taip;0;4;12;16
1955;Eglutė;OBUOLIUKAI;4176597208;Taip;7;1;2;10
1956;Eglutė;OBUOLIUKAI;3883122650;Taip;0;12;0;12
1957;Eglutė;OBUOLIUKAI;9402686801;Taip;0;16;0;16
1958;Eglutė;OBUOLIUKAI;7778598035;Taip;8;0;2;10
1959;Eglutė;OBUOLIUKAI;8165126017;Taip;0;4;1;5
1960;Eglutė;OBUOLIUKAI;8943684351;Taip;7;4;0;11
1961;Eglutė;OBUOLIUKAI;9046652370;Taip;0;0;7;7
1962;Eglutė;OBUOLIUKAI;6597261061;Taip;6;0;1;7
1963;Eglutė;OBUOLIUKAI;6483580751;Ne;8;2;1;11
1964;Eglutė;OBUOLIUKAI;7859815752;Taip;9;6;0;15
1965;Eglutė;OBUOLIUKAI;9356785605;Ne;14;5;0;19
1966;Eglutė;KAŠTONAS;7823828202;Taip;5;0;0;5
1967;Eglutė;KAŠTONAS;1436966647;Taip;2;0;0;2
1968;Eglutė;KAŠTONAS;8523618773;Taip;2;0;11;13
1969;Eglutė;KAŠTONAS;1712276393;Ne;0;6;2;8
1970;Eglutė;KAŠTONAS;6891834971;Ne;0;10;0;10
1971;Eglutė;KAŠTONAS;8162972897;Taip;21;0;0;21
1972;Eglutė;KAŠTONAS;8364693548;Taip;0;12;0;12
1973;Eglutė;KAŠTONAS;3775081619;Taip;4;6;0;10
1974;Eglutė;KAŠTONAS;1265463853;Ne;0;0;7;7
1975;Eglutė;KAŠTONAS;3856651647;Taip;21;0;0;21
1976;Eglutė;KAŠTONAS;7307564177;Taip;0;1;9;10
1977;Eglutė;KAŠTONAS;1122308715;Taip;0;4;0;4
1978;Eglutė;KAŠTONAS;9992438336;Taip;2;0;5;7
1979;Eglutė;KAŠTONAS;8421062747;Taip;0;11;0;11
1980;Eglutė;KAŠTONAS;1908835124;Taip;0;5;0;5
1981;Eglutė;KAŠTONAS;1321901982;Taip;0;18;0;18
1982;Eglutė;KAŠTONAS;7354260503;Taip;0;7;0;7
1983;Eglutė;KAŠTONAS;9527732584;Taip;0;6;1;7
1984;Eglutė;KAŠTONAS;7629424045;Taip;0;6;7;13
1985;Eglutė;KAŠTONAS;5731355126;Taip;13;0;1;14
1986;Eglutė;KAŠTONAS;9439309687;Taip;0;0;6;6
1987;Eglutė;EŽIUKAI;20502611523;Taip;0;5;0;5
1988;Eglutė;EŽIUKAI;6570561861;Taip;7;0;3;10
1989;Eglutė;EŽIUKAI;8213137021;Taip;15;0;0;15
1990;Eglutė;EŽIUKAI;5604605766;Taip;9;4;0;13
1991;Eglutė;EŽIUKAI;4846517870;Taip;5;4;0;9
1992;Eglutė;EŽIUKAI;51884188642;Taip;0;5;4;9
1993;Eglutė;EŽIUKAI;62257831469;Taip;7;5;1;13
1994;Eglutė;EŽIUKAI;15019818974;Taip;10;4;0;14
1995;Eglutė;EŽIUKAI;9169758481;Ne;8;4;0;12
1996;Eglutė;EŽIUKAI;95274378693;Taip;0;4;1;5
1997;Eglutė;EŽIUKAI;3725462135;Taip;0;7;0;7
1998;Eglutė;EŽIUKAI;92489023262;Taip;0;5;3;8
1999;Eglutė;EŽIUKAI;77296894224;Taip;5;1;1;7
2000;Eglutė;EŽIUKAI;6542189095;Taip;0;7;4;11
2001;Eglutė;EŽIUKAI;7506194777;Taip;10;0;0;10
2002;Eglutė;EŽIUKAI;69979676570;Taip;5;5;1;11
2003;Eglutė;EŽIUKAI;1905376778;Taip;0;5;2;7
2004;Eglutė;EŽIUKAI;1308252968;Taip;7;5;0;12
2005;Eglutė;EŽIUKAI;60500002903;Taip;0;4;1;5
2006;Eglutė;EŽIUKAI;59228063911;Taip;0;4;1;5
2007;Eglutė;EŽIUKAI;12750056416;Taip;3;2;1;6
2008;Eglutė;EŽIUKAI;4570145972;Taip;5;4;0;9
2009;Eglutė;EŽIUKAI;89786711506;Taip;0;5;1;6
2010;Eglutė;GILĖ;7148210944;Ne;0;5;0;5
2011;Eglutė;GILĖ;3616979217;Taip;0;4;0;4
2012;Eglutė;GILĖ;2638807860;Taip;2;0;5;7
2013;Eglutė;GILĖ;8033370429;Ne;0;0;4;4
2014;Eglutė;GILĖ;3203786388;Taip;0;0;9;9
2015;Eglutė;GILĖ;1004866224;Taip;5;0;0;5
2016;Eglutė;GILĖ;9950953029;Taip;2;3;3;8
2017;Eglutė;GILĖ;3275796441;Taip;4;0;1;5
2018;Eglutė;GILĖ;3178489517;Taip;9;0;1;10
2019;Eglutė;GILĖ;6518497374;Ne;0;11;0;11
2020;Eglutė;GILĖ;6835296034;Taip;4;0;0;4
2021;Eglutė;GILĖ;8606991706;Taip;1;4;0;5
2022;Eglutė;GILĖ;1324622835;Taip;0;0;11;11
2023;Eglutė;GILĖ;2082716398;Taip;12;0;2;14
2024;Eglutė;GILĖ;3393414294;Taip;0;4;0;4
2025;Eglutė;GILĖ;9488150450;Taip;0;4;0;4
2026;Eglutė;GILĖ;9066178904;Taip;0;17;0;17
2027;Eglutė;GILĖ;24785196945;Ne;0;14;0;14
2028;Eglutė;SAULUTĖ;72153018644;Taip;0;11;0;11
2029;Eglutė;SAULUTĖ;27441180688;Ne;0;7;2;9
2030;Eglutė;SAULUTĖ;37487292437;Taip;0;8;0;8
2031;Eglutė;SAULUTĖ;1935089263;Taip;0;6;0;6
2032;Eglutė;SAULUTĖ;1555843610;Ne;0;8;0;8
2033;Eglutė;SAULUTĖ;1864153865;Taip;0;5;1;6
2034;Eglutė;SAULUTĖ;2547404429;Taip;0;4;0;4
2035;Eglutė;SAULUTĖ;49268076669;Taip;0;6;3;9
2036;Eglutė;SAULUTĖ;65985749472;Taip;0;5;1;6
2037;Eglutė;SAULUTĖ;20582720349;Taip;0;3;5;8
2038;Eglutė;SAULUTĖ;1347527598;Taip;4;4;0;8
2039;Eglutė;SAULUTĖ;1477651468;Taip;0;1;0;1
2040;Eglutė;SAULUTĖ;1533889475;Taip;0;5;0;5
2041;Eglutė;SAULUTĖ;1306820123;Taip;0;4;0;4
2042;Eglutė;SAULUTĖ;2109443590;Taip;7;4;0;11
2043;Eglutė;SAULUTĖ;1272418234;Taip;0;4;0;4
2044;Eglutė;SAULUTĖ;1753853153;Taip;14;1;0;15
2045;Eglutė;SAULUTĖ;1044133613;Taip;0;1;0;1
2046;Eglutė;SAULUTĖ;1206623876;Ne;4;11;0;15
2047;Eglutė;SAULUTĖ;1180482309;Taip;0;5;7;12
2048;Eglutė;SAULUTĖ;9506180285;Taip;0;5;0;5
2049;Eglutė;SAULUTĖ;2087083722;Taip;9;6;0;15
2050;Eglutė;SAULUTĖ;1859052313;Taip;0;4;0;4
2051;Eglutė;SAULUTĖ;7744905325;Taip;0;8;0;8
2052;Eglutė;ŠARKELĖ;6360881137;Ne;3;0;1;4
2053;Eglutė;ŠARKELĖ;9728550000;Taip;6;4;0;10
2054;Eglutė;ŠARKELĖ;1534556744;Taip;9;0;2;11
2055;Eglutė;ŠARKELĖ;3483007385;Ne;0;21;0;21
2056;Eglutė;ŠARKELĖ;1050313582;Ne;8;0;3;11
2057;Eglutė;ŠARKELĖ;5943856319;Taip;0;5;0;5
2058;Eglutė;ŠARKELĖ;8493750509;Taip;5;3;0;8
2059;Eglutė;ŠARKELĖ;2597978713;Taip;0;10;0;10
2060;Eglutė;ŠARKELĖ;3473388722;Taip;9;0;2;11
2061;Eglutė;ŠARKELĖ;2651867769;Taip;0;4;0;4
2062;Eglutė;ŠARKELĖ;7491022301;Taip;10;0;0;10
2063;Eglutė;ŠARKELĖ;2783338563;Taip;15;4;0;19
2064;Eglutė;ŠARKELĖ;6544877723;Ne;0;1;0;1
2065;Eglutė;ŠARKELĖ;6093932811;Taip;0;4;2;6
2066;Eglutė;ŠARKELĖ;1932785408;Taip;0;4;3;7
2067;Eglutė;ŠARKELĖ;4451772812;Taip;2;4;0;6
2068;Eglutė;ŠARKELĖ;4490295754;Taip;0;4;6;10
2069;Eglutė;ŠARKELĖ;1422631723;Ne;7;5;0;12
2070;Eglutė;ŠARKELĖ;4230594049;Taip;9;0;3;12
2071;Eglutė;ŠARKELĖ;6709551046;Ne;4;1;3;8
2072;Eglutė;NYKŠTUKAI;2615824395;Taip;8;0;2;10
2073;Eglutė;NYKŠTUKAI;5918429438;Taip;8;0;2;10
2074;Eglutė;NYKŠTUKAI;8622073117;Taip;21;0;0;21
2075;Eglutė;NYKŠTUKAI;5805450838;Ne;11;0;0;11
2076;Eglutė;NYKŠTUKAI;5518570006;Taip;9;8;0;17
2077;Eglutė;NYKŠTUKAI;5166183300;Taip;0;20;0;20
2078;Eglutė;NYKŠTUKAI;7800243796;Taip;21;0;0;21
2079;Eglutė;NYKŠTUKAI;6309529738;Taip;9;0;0;9
2080;Eglutė;NYKŠTUKAI;4489150480;Taip;0;0;11;11
2081;Eglutė;NYKŠTUKAI;3006381069;Taip;0;0;3;3
2082;Eglutė;NYKŠTUKAI;6105927493;Taip;3;0;0;3
2083;Eglutė;NYKŠTUKAI;9098132159;Taip;14;0;0;14
2084;Eglutė;NYKŠTUKAI;5840014240;Taip;0;0;21;21
2085;Eglutė;NYKŠTUKAI;2259077568;Taip;0;7;0;7
2086;Eglutė;NYKŠTUKAI;9084576953;Taip;6;0;2;8
2087;Eglutė;NYKŠTUKAI;8534997648;Taip;0;0;20;20
2088;Eglutė;NYKŠTUKAI;2425927050;Taip;5;6;4;15
2089;Eglutė;NYKŠTUKAI;9929681000;Taip;17;0;0;17
2090;Eglutė;ŽIRNIUKAI;6924344686;Taip;10;0;0;10
2091;Eglutė;ŽIRNIUKAI;5190045146;Taip;4;4;0;8
2092;Eglutė;ŽIRNIUKAI;1393626624;Taip;15;0;1;16
2093;Eglutė;ŽIRNIUKAI;6550999480;Taip;7;0;0;7
2094;Eglutė;ŽIRNIUKAI;6272115803;Ne;5;0;5;10
2095;Eglutė;ŽIRNIUKAI;2857760751;Taip;2;0;3;5
2096;Eglutė;ŽIRNIUKAI;8888784168;Taip;1;5;3;9
2097;Eglutė;ŽIRNIUKAI;9439982416;Taip;4;0;5;9
2098;Eglutė;ŽIRNIUKAI;2621445549;Taip;5;2;0;7
2099;Eglutė;ŽIRNIUKAI;8246870069;Taip;0;0;3;3
2100;Eglutė;ŽIRNIUKAI;9172488122;Taip;6;8;0;14
2101;Eglutė;ŽIRNIUKAI;1550045866;Taip;2;0;3;5
2102;Eglutė;ŽIRNIUKAI;3605053253;Taip;14;4;0;18
2103;Eglutė;ŽIRNIUKAI;2240154775;Taip;5;4;5;14
2104;Eglutė;ŽIRNIUKAI;8797889347;Taip;5;1;2;8
2105;Eglutė;ŽIRNIUKAI;1835565594;Taip;10;0;0;10
2106;Eglutė;ŽIRNIUKAI;8129230197;Taip;0;5;5;10
2107;Eglutė;ŽIRNIUKAI;5006042568;Taip;0;12;0;12
2108;Eglutė;ŽIRNIUKAI;5275306818;Taip;0;21;0;21
2109;Eglutė;BORUŽIUKAI;8933416279;Taip;12;1;5;18
2110;Eglutė;BORUŽIUKAI;1122907387;Taip;13;4;1;18
2111;Eglutė;BORUŽIUKAI;2816913563;Taip;11;0;0;11
2112;Eglutė;BORUŽIUKAI;1842517164;Taip;0;0;19;19
2113;Eglutė;BORUŽIUKAI;2357276888;Taip;0;11;0;11
2114;Eglutė;BORUŽIUKAI;3985929379;Taip;3;0;0;3
2115;Eglutė;BORUŽIUKAI;8588753136;Taip;13;0;0;13
2116;Eglutė;BORUŽIUKAI;2121177107;Taip;6;0;0;6
2117;Eglutė;BORUŽIUKAI;3398517047;Taip;0;6;0;6
2118;Eglutė;BORUŽIUKAI;6899575758;Taip;5;9;0;14
2119;Eglutė;BORUŽIUKAI;7530638623;Taip;17;0;0;17
2120;Eglutė;BORUŽIUKAI;8520403894;Taip;17;4;0;21
2121;Eglutė;BORUŽIUKAI;8711567312;Taip;15;0;0;15
2122;Eglutė;BORUŽIUKAI;3237476593;Taip;8;6;0;14
2123;Eglutė;BORUŽIUKAI;6328900251;Taip;8;5;0;13
2124;Eglutė;BORUŽIUKAI;1531942494;Taip;0;0;9;9
2125;Eglutė;BORUŽIUKAI;9661883776;Ne;13;4;0;17
2126;Eglutė;BORUŽIUKAI;5505398901;Taip;9;2;0;11
2127;Eglutė;BORUŽIUKAI;1872459729;Taip;17;4;0;21
2128;Eglutė;BORUŽIUKAI;5650957826;Taip;2;0;6;8
2129;Aušrinė;Varpeliai;2948716989;Taip;6;7;0;13
2130;Aušrinė;Varpeliai;6525761466;Taip;0;4;1;5
2131;Aušrinė;Varpeliai;3346154143;Taip;0;3;0;3
2132;Aušrinė;Varpeliai;8092890260;Taip;6;4;0;10
2133;Aušrinė;Varpeliai;3998988004;Taip;0;14;0;14
2134;Aušrinė;Varpeliai;5204445760;Taip;3;7;0;10
2135;Aušrinė;Varpeliai;9641020899;Taip;10;4;0;14
2136;Aušrinė;Varpeliai;5277217733;Ne;21;0;0;21
2137;Aušrinė;Varpeliai;1502013942;Taip;17;2;0;19
2138;Aušrinė;Varpeliai;2190583964;Taip;7;4;0;11
2139;Aušrinė;Varpeliai;3920229653;Taip;4;0;3;7
2140;Aušrinė;Varpeliai;5563356449;Taip;10;0;0;10
2141;Aušrinė;Varpeliai;9501262918;Taip;0;0;3;3
2142;Aušrinė;Varpeliai;8756465854;Taip;6;0;4;10
2143;Aušrinė;Varpeliai;2304972692;Ne;10;6;0;16
2144;Aušrinė;Varpeliai;6756184787;Ne;10;5;0;15
2145;Aušrinė;Varpeliai;4288487063;Taip;7;6;0;13
2146;Aušrinė;Varpeliai;5768470608;Taip;19;0;0;19
2147;Aušrinė;Varpeliai;4969561425;Taip;0;7;2;9
2148;Aušrinė;Bitutės;17061806895;Taip;2;5;1;8
2149;Aušrinė;Bitutės;7796318812;Taip;0;11;0;11
2150;Aušrinė;Bitutės;83017543760;Taip;0;4;0;4
2151;Aušrinė;Bitutės;6318538591;Taip;13;0;0;13
2152;Aušrinė;Bitutės;5090847702;Taip;4;0;0;4
2153;Aušrinė;Bitutės;1399518471;Taip;5;0;0;5
2154;Aušrinė;Bitutės;7507448059;Taip;0;9;0;9
2155;Aušrinė;Bitutės;1291308838;Ne;0;8;0;8
2156;Aušrinė;Bitutės;63299644698;Taip;14;3;0;17
2157;Aušrinė;Bitutės;5206206080;Taip;18;2;0;20
2158;Aušrinė;Bitutės;2263818210;Taip;6;2;0;8
2159;Aušrinė;Bitutės;1061646244;Ne;13;2;0;15
2160;Aušrinė;Bitutės;5738278121;Taip;16;0;0;16
2161;Aušrinė;Bitutės;4965640386;Taip;11;0;0;11
2162;Aušrinė;Bitutės;1139585557;Taip;0;11;0;11
2163;Aušrinė;Bitutės;4686825392;Taip;0;4;0;4
2164;Aušrinė;Bitutės;1908486900;Ne;4;4;0;8
2165;Aušrinė;Bitutės;1724192337;Taip;15;4;0;19
2166;Aušrinė;Bitutės;6608657740;Taip;9;0;0;9
2167;Aušrinė;Drugeliai;1996032555;Ne;0;8;0;8
2168;Aušrinė;Drugeliai;2043278242;Taip;13;4;0;17
2169;Aušrinė;Drugeliai;1343667707;Taip;9;0;0;9
2170;Aušrinė;Drugeliai;96010737590;Ne;15;1;0;16
2171;Aušrinė;Drugeliai;5729812682;Taip;0;4;4;8
2172;Aušrinė;Drugeliai;1133359254;Taip;0;0;21;21
2173;Aušrinė;Drugeliai;30244366906;Taip;0;4;0;4
2174;Aušrinė;Drugeliai;1184543607;Taip;13;0;0;13
2175;Aušrinė;Drugeliai;48118825872;Taip;4;9;0;13
2176;Aušrinė;Drugeliai;2069277030;Taip;4;2;0;6
2177;Aušrinė;Drugeliai;1206863546;Taip;0;5;1;6
2178;Aušrinė;Drugeliai;2022412040;Taip;14;0;0;14
2179;Aušrinė;Drugeliai;6265909152;Taip;12;0;7;19
2180;Aušrinė;Drugeliai;1532235421;Taip;2;0;0;2
2181;Aušrinė;Drugeliai;2212814026;Ne;13;0;1;14
2182;Aušrinė;Drugeliai;1927141701;Taip;0;0;9;9
2183;Aušrinė;Drugeliai;3356127625;Taip;7;0;6;13
2184;Aušrinė;Drugeliai;1151612627;Taip;4;4;1;9
2185;Aušrinė;Drugeliai;1515536619;Taip;5;5;0;10
2186;Aušrinė;Boružėlės;1298127839;Taip;0;5;0;5
2187;Aušrinė;Boružėlės;8364033602;Ne;9;6;0;15
2188;Aušrinė;Boružėlės;1009453682;Taip;12;8;0;20
2189;Aušrinė;Boružėlės;3544848804;Ne;9;0;1;10
2190;Aušrinė;Boružėlės;6136579994;Taip;8;0;0;8
2191;Aušrinė;Boružėlės;8463758715;Taip;0;4;0;4
2192;Aušrinė;Boružėlės;4579700769;Taip;0;8;0;8
2193;Aušrinė;Boružėlės;7268811782;Taip;4;7;0;11
2194;Aušrinė;Boružėlės;1831094707;Taip;0;10;0;10
2195;Aušrinė;Boružėlės;3593323270;Taip;0;4;1;5
2196;Aušrinė;Boružėlės;3795927209;Taip;7;4;0;11
2197;Aušrinė;Boružėlės;5283207520;Taip;0;4;11;15
2198;Aušrinė;Boružėlės;1116822936;Ne;0;3;3;6
2199;Aušrinė;Boružėlės;6226967695;Taip;0;0;1;1
2200;Aušrinė;Boružėlės;9226214856;Ne;14;0;0;14
2201;Aušrinė;Boružėlės;4562536818;Taip;9;0;0;9
2202;Aušrinė;Zuikučiai;8608907350;Taip;10;7;0;17
2203;Aušrinė;Zuikučiai;3291922401;Taip;0;4;4;8
2204;Aušrinė;Zuikučiai;8815055819;Taip;14;0;1;15
2205;Aušrinė;Zuikučiai;2199422694;Taip;11;0;0;11
2206;Aušrinė;Zuikučiai;1306244736;Taip;19;0;0;19
2207;Aušrinė;Zuikučiai;8186421282;Taip;10;0;0;10
2208;Aušrinė;Zuikučiai;9471287834;Taip;20;0;0;20
2209;Aušrinė;Zuikučiai;7071444498;Taip;0;5;2;7
2210;Aušrinė;Zuikučiai;6428753580;Taip;8;0;0;8
2211;Aušrinė;Zuikučiai;1336503878;Ne;21;0;0;21
2212;Aušrinė;Zuikučiai;3304937820;Taip;0;4;0;4
2213;Aušrinė;Zuikučiai;3581180895;Taip;0;0;2;2
2214;Aušrinė;Zuikučiai;5821077318;Taip;0;7;14;21
2215;Aušrinė;Zuikučiai;9117896572;Taip;10;3;2;15
2216;Aušrinė;Zuikučiai;9612956692;Taip;0;8;0;8
2217;Aušrinė;Meškiukai;3269357241;Taip;0;0;7;7
2218;Aušrinė;Meškiukai;2583331243;Taip;10;1;0;11
2219;Aušrinė;Meškiukai;2055282010;Taip;2;0;5;7
2220;Aušrinė;Meškiukai;2778931038;Taip;11;0;4;15
2221;Aušrinė;Meškiukai;8465864375;Taip;17;0;2;19
2222;Aušrinė;Meškiukai;7784329873;Taip;12;0;3;15
2223;Aušrinė;Meškiukai;7089883250;Taip;0;0;1;1
2224;Aušrinė;Meškiukai;5043122065;Taip;5;0;2;7
2225;Aušrinė;Meškiukai;7358925256;Taip;11;0;0;11
2226;Aušrinė;Meškiukai;5128863532;Ne;0;0;5;5
2227;Aušrinė;Meškiukai;7194803557;Ne;0;2;1;3
2228;Aušrinė;Meškiukai;9967737864;Taip;8;7;2;17
2229;Aušrinė;Meškiukai;4437786689;Taip;4;0;3;7
2230;Aušrinė;Meškiukai;9726826566;Taip;12;4;1;17
2231;"Geniukų kalvė";SAULUTĖS;2271582954;Taip;19;0;0;19
2232;"Geniukų kalvė";SAULUTĖS;9557055841;Ne;20;0;0;20
2233;"Geniukų kalvė";SAULUTĖS;3111400962;Taip;12;3;0;15
2234;"Geniukų kalvė";SAULUTĖS;4329782598;Taip;2;11;0;13
2235;"Geniukų kalvė";SAULUTĖS;8932671578;Taip;21;0;0;21
2236;"Geniukų kalvė";SAULUTĖS;9711047774;Taip;10;4;0;14
2237;"Geniukų kalvė";SAULUTĖS;1910363787;Taip;19;0;0;19
2238;"Geniukų kalvė";SAULUTĖS;7940706717;Taip;8;4;4;16
2239;"Geniukų kalvė";SAULUTĖS;9522911738;Taip;0;13;0;13
2240;"Geniukų kalvė";SAULUTĖS;4603185679;Taip;0;4;0;4
2241;"Geniukų kalvė";SAULUTĖS;5348211316;Taip;3;0;0;3
2242;"Geniukų kalvė";SAULUTĖS;7886553419;Taip;10;0;0;10
2243;"Geniukų kalvė";SAULUTĖS;6384832317;Taip;12;4;1;17
2244;"Geniukų kalvė";SAULUTĖS;4946218794;Taip;2;6;1;9
2245;"Geniukų kalvė";SAULUTĖS;4525874796;Taip;5;0;4;9
2246;"Geniukų kalvė";SAULUTĖS;7289942679;Taip;21;0;0;21
2247;"Geniukų kalvė";SAULUTĖS;4745451344;Taip;10;0;7;17
2248;"Geniukų kalvė";SAULUTĖS;9768077014;Taip;8;4;0;12
2249;"Geniukų kalvė";SAULUTĖS;7889781552;Taip;21;0;0;21
2250;"Geniukų kalvė";SAULUTĖS;3889643236;Ne;5;0;5;10
2251;"Geniukų kalvė";BITUTĖS;7745656622;Ne;10;0;1;11
2252;"Geniukų kalvė";BITUTĖS;6520429663;Taip;7;9;0;16
2253;"Geniukų kalvė";BITUTĖS;2718961466;Taip;3;5;1;9
2254;"Geniukų kalvė";BITUTĖS;4967513360;Ne;3;5;0;8
2255;"Geniukų kalvė";BITUTĖS;2016254460;Taip;0;10;0;10
2256;"Geniukų kalvė";BITUTĖS;5776314197;Taip;3;0;0;3
2257;"Geniukų kalvė";BITUTĖS;1897809684;Taip;7;4;0;11
2258;"Geniukų kalvė";BITUTĖS;4105170344;Taip;19;0;0;19
2259;"Geniukų kalvė";BITUTĖS;8872900558;Taip;6;0;0;6
2260;"Geniukų kalvė";BITUTĖS;6500641378;Taip;0;7;0;7
2261;"Geniukų kalvė";BITUTĖS;2143334688;Ne;2;1;0;3
2262;"Geniukų kalvė";BITUTĖS;6498149304;Taip;0;1;0;1
2263;"Geniukų kalvė";BITUTĖS;3984265624;Taip;0;16;0;16
2264;"Geniukų kalvė";BITUTĖS;4813232640;Taip;0;0;7;7
2265;"Geniukų kalvė";BITUTĖS;9676782662;Taip;7;5;0;12
2266;"Geniukų kalvė";BITUTĖS;5542539934;Taip;2;0;8;10
2267;"Geniukų kalvė";KIŠKUČIAI;1568133009;Ne;7;9;0;16
2268;"Geniukų kalvė";KIŠKUČIAI;4844734556;Taip;12;5;0;17
2269;"Geniukų kalvė";KIŠKUČIAI;4758435835;Taip;4;5;2;11
2270;"Geniukų kalvė";KIŠKUČIAI;2729442911;Ne;0;0;1;1
2271;"Geniukų kalvė";KIŠKUČIAI;4661051023;Taip;0;4;4;8
2272;"Geniukų kalvė";KIŠKUČIAI;8668696743;Ne;3;0;0;3
2273;"Geniukų kalvė";KIŠKUČIAI;2262014110;Taip;0;5;0;5
2274;"Geniukų kalvė";KIŠKUČIAI;43097490633;Taip;8;3;0;11
2275;"Geniukų kalvė";KIŠKUČIAI;2043786151;Taip;7;0;0;7
2276;"Geniukų kalvė";KIŠKUČIAI;1460456166;Taip;0;2;0;2
2277;"Geniukų kalvė";KIŠKUČIAI;8939171238;Ne;5;4;1;10
2278;"Geniukų kalvė";KIŠKUČIAI;2140334255;Taip;6;7;0;13
2279;"Geniukų kalvė";KIŠKUČIAI;2301758912;Taip;12;5;1;18
2280;"Geniukų kalvė";KIŠKUČIAI;8635708009;Taip;11;4;1;16
2281;"Geniukų kalvė";KIŠKUČIAI;9081596975;Ne;0;0;2;2
2282;"Geniukų kalvė";KIŠKUČIAI;30932565379;Taip;0;6;4;10
2283;"Geniukų kalvė";KIŠKUČIAI;2337226175;Ne;0;5;0;5
2284;"Geniukų kalvė";VYTURĖLIAI;37670000746;Ne;0;6;0;6
2285;"Geniukų kalvė";VYTURĖLIAI;31140342871;Taip;0;5;0;5
2286;"Geniukų kalvė";VYTURĖLIAI;70097449722;Taip;0;9;0;9
2287;"Geniukų kalvė";VYTURĖLIAI;11476134327;Taip;5;3;0;8
2288;"Geniukų kalvė";VYTURĖLIAI;68752448767;Taip;4;4;0;8
2289;"Geniukų kalvė";VYTURĖLIAI;61225085978;Taip;6;4;9;19
2290;"Geniukų kalvė";VYTURĖLIAI;83623361401;Ne;0;1;0;1
2291;"Geniukų kalvė";VYTURĖLIAI;87751274075;Taip;1;5;0;6
2292;"Geniukų kalvė";VYTURĖLIAI;71884588832;Taip;6;4;0;10
2293;"Geniukų kalvė";VYTURĖLIAI;26733422046;Taip;0;3;0;3
2294;"Geniukų kalvė";VYTURĖLIAI;96267794763;Ne;7;4;0;11
2295;"Geniukų kalvė";VYTURĖLIAI;91734868433;Ne;0;6;0;6
2296;"Geniukų kalvė";VYTURĖLIAI;1933003833;Taip;0;5;0;5
2297;"Geniukų kalvė";VYTURĖLIAI;1829858221;Taip;5;2;0;7
2298;"Geniukų kalvė";VYTURĖLIAI;1624933726;Taip;0;4;0;4
2299;"Geniukų kalvė";VYTURĖLIAI;1658082075;Taip;0;4;3;7
2300;"Geniukų kalvė";VYTURĖLIAI;1239061261;Taip;7;7;0;14
2301;"Geniukų kalvė";DRUGELIAI;1073117547;Ne;5;4;2;11
2302;"Geniukų kalvė";DRUGELIAI;51353124475;Ne;0;1;0;1
2303;"Geniukų kalvė";DRUGELIAI;52431368754;Ne;3;0;0;3
2304;"Geniukų kalvė";DRUGELIAI;30865528880;Taip;1;4;0;5
2305;"Geniukų kalvė";DRUGELIAI;66632618838;Taip;0;4;0;4
2306;"Geniukų kalvė";DRUGELIAI;35180545728;Taip;0;6;0;6
2307;"Geniukų kalvė";DRUGELIAI;88543141650;Taip;0;4;0;4
2308;"Geniukų kalvė";DRUGELIAI;96954076142;Taip;0;4;0;4
2309;"Geniukų kalvė";DRUGELIAI;27479616927;Taip;0;4;4;8
2310;"Geniukų kalvė";DRUGELIAI;30015301622;Taip;0;4;0;4
2311;"Geniukų kalvė";DRUGELIAI;26912425905;Taip;0;3;1;4
2312;"Geniukų kalvė";DRUGELIAI;38949678625;Taip;0;4;0;4
2313;"Geniukų kalvė";DRUGELIAI;74161080879;Taip;7;4;0;11
2314;"Geniukų kalvė";DRUGELIAI;80957343774;Taip;0;4;0;4
2315;"Geniukų kalvė";DRUGELIAI;99051569551;Taip;0;4;0;4
2316;"Geniukų kalvė";DRUGELIAI;50218457812;Ne;4;5;1;10
2317;"Geniukų kalvė";DRUGELIAI;7837682774;Taip;0;3;0;3
2318;"Geniukų kalvė";DRUGELIAI;8916930503;Taip;2;1;0;3
2319;"Geniukų kalvė";DRUGELIAI;2038860438;Taip;0;4;5;9
2320;"Geniukų kalvė";DRUGELIAI;93542861144;Taip;0;3;0;3
2321;"Geniukų kalvė";DRUGELIAI;1923449545;Taip;0;4;1;5
2322;"Geniukų kalvė";DRUGELIAI;1246234700;Ne;9;5;0;14
2323;"Geniukų kalvė";"SAULĖS ZUIKUČIAI";37079991701;Taip;0;0;1;1
2324;"Geniukų kalvė";"SAULĖS ZUIKUČIAI";49352255237;Taip;0;4;0;4
2325;"Geniukų kalvė";"SAULĖS ZUIKUČIAI";90227736128;Taip;0;8;0;8
2326;"Geniukų kalvė";"SAULĖS ZUIKUČIAI";54856843273;Taip;6;4;0;10
2327;"Geniukų kalvė";"SAULĖS ZUIKUČIAI";1806626063;Taip;0;5;0;5
2328;"Geniukų kalvė";"SAULĖS ZUIKUČIAI";1776042329;Taip;17;4;0;21
2329;"Geniukų kalvė";"SAULĖS ZUIKUČIAI";1716204178;Ne;0;0;15;15
2330;"Geniukų kalvė";"SAULĖS ZUIKUČIAI";1774738349;Taip;3;0;0;3
2331;"Geniukų kalvė";"SAULĖS ZUIKUČIAI";2120890722;Taip;0;12;0;12
2332;"Geniukų kalvė";"SAULĖS ZUIKUČIAI";87718471880;Taip;0;4;1;5
2333;"Geniukų kalvė";"SAULĖS ZUIKUČIAI";1415719190;Ne;0;12;0;12
2334;"Geniukų kalvė";"SAULĖS ZUIKUČIAI";83443339743;Taip;0;9;0;9
2335;"Geniukų kalvė";"SAULĖS ZUIKUČIAI";26215340428;Taip;0;5;0;5
2336;"Geniukų kalvė";"SAULĖS ZUIKUČIAI";1084055203;Taip;0;4;0;4
2337;"Geniukų kalvė";"SAULĖS ZUIKUČIAI";75791398203;Taip;0;3;0;3
2338;"Geniukų kalvė";"SAULĖS ZUIKUČIAI";1810973279;Taip;0;5;1;6
2339;"Geniukų kalvė";"SAULĖS ZUIKUČIAI";2094764804;Ne;0;4;1;5
2340;"Geniukų kalvė";"SAULĖS ZUIKUČIAI";3553253934;Taip;0;0;7;7
2341;"Geniukų kalvė";"SAULĖS ZUIKUČIAI";9669281441;Taip;13;4;0;17
2342;"Geniukų kalvė";"SAULĖS ZUIKUČIAI";3599151643;Taip;0;0;3;3
2343;"Geniukų kalvė";"SAULĖS ZUIKUČIAI";1818485774;Taip;14;5;0;19
2344;"Geniukų kalvė";SMALSUČIAI;44345867922;Taip;12;0;0;12
2345;"Geniukų kalvė";SMALSUČIAI;6928979691;Ne;0;5;5;10
2346;"Geniukų kalvė";SMALSUČIAI;82277353185;Taip;0;0;5;5
2347;"Geniukų kalvė";SMALSUČIAI;19181427380;Taip;0;7;0;7
2348;"Geniukų kalvė";SMALSUČIAI;1684481833;Taip;4;0;0;4
2349;"Geniukų kalvė";SMALSUČIAI;14939415217;Taip;0;0;3;3
2350;"Geniukų kalvė";SMALSUČIAI;1990303616;Taip;4;5;0;9
2351;"Geniukų kalvė";SMALSUČIAI;62774512989;Ne;9;0;0;9
2352;"Geniukų kalvė";SMALSUČIAI;45542289762;Taip;0;1;4;5
2353;"Geniukų kalvė";SMALSUČIAI;23964009189;Taip;0;5;0;5
2354;"Geniukų kalvė";SMALSUČIAI;42328019754;Taip;0;7;1;8
2355;"Geniukų kalvė";SMALSUČIAI;90435684305;Taip;0;1;0;1
2356;"Geniukų kalvė";SMALSUČIAI;84974376966;Taip;0;4;0;4
2357;"Geniukų kalvė";SMALSUČIAI;97616612192;Taip;0;4;0;4
2358;"Geniukų kalvė";SMALSUČIAI;93834840514;Taip;0;10;0;10
2359;"Geniukų kalvė";SMALSUČIAI;67762121244;Ne;0;4;0;4
2360;"Geniukų kalvė";SMALSUČIAI;1663744490;Taip;0;3;0;3
2361;"Geniukų kalvė";SMALSUČIAI;2003986836;Taip;0;10;0;10
2362;"Geniukų kalvė";SMALSUČIAI;1248190435;Taip;6;9;0;15
2363;"Geniukų kalvė";SMALSUČIAI;5792552722;Taip;0;0;1;1
2364;"Geniukų kalvė";SMALSUČIAI;6253940549;Taip;5;4;0;9
2365;"Geniukų kalvė";SMALSUČIAI;9416843495;Taip;0;0;1;1
2366;"Geniukų kalvė";SMALSUČIAI;65418822653;Taip;0;7;0;7
2367;"Geniukų kalvė";RUDNOSIUKAI;2082749897;Taip;0;8;0;8
2368;"Geniukų kalvė";RUDNOSIUKAI;7352976665;Ne;11;0;0;11
2369;"Geniukų kalvė";RUDNOSIUKAI;12109348143;Taip;0;4;0;4
2370;"Geniukų kalvė";RUDNOSIUKAI;93360165202;Taip;0;1;0;1
2371;"Geniukų kalvė";RUDNOSIUKAI;36553641202;Taip;0;7;0;7
2372;"Geniukų kalvė";RUDNOSIUKAI;16810843163;Taip;0;4;0;4
2373;"Geniukų kalvė";RUDNOSIUKAI;56705168000;Taip;0;4;0;4
2374;"Geniukų kalvė";RUDNOSIUKAI;75926614045;Taip;0;5;0;5
2375;"Geniukų kalvė";RUDNOSIUKAI;96448080708;Taip;3;12;0;15
2376;"Geniukų kalvė";RUDNOSIUKAI;1727967870;Taip;3;4;0;7
2377;"Geniukų kalvė";RUDNOSIUKAI;1794537433;Taip;0;4;0;4
2378;"Geniukų kalvė";RUDNOSIUKAI;29353737550;Taip;0;6;0;6
2379;"Geniukų kalvė";RUDNOSIUKAI;22074236863;Taip;10;4;0;14
2380;"Geniukų kalvė";RUDNOSIUKAI;8462193223;Taip;0;2;0;2
2381;"Geniukų kalvė";RUDNOSIUKAI;7269049874;Taip;0;8;0;8
2382;"Geniukų kalvė";PELĖDŽIUKAI;2217221922;Taip;10;0;0;10
2383;"Geniukų kalvė";PELĖDŽIUKAI;3826265557;Taip;3;5;0;8
2384;"Geniukų kalvė";PELĖDŽIUKAI;8271041553;Taip;0;1;0;1
2385;"Geniukų kalvė";PELĖDŽIUKAI;1237228692;Taip;0;0;1;1
2386;"Geniukų kalvė";PELĖDŽIUKAI;2938446054;Taip;0;4;0;4
2387;"Geniukų kalvė";PELĖDŽIUKAI;9976423099;Taip;2;0;0;2
2388;"Geniukų kalvė";PELĖDŽIUKAI;6070945557;Taip;0;3;0;3
2389;"Geniukų kalvė";PELĖDŽIUKAI;9990243525;Taip;6;3;2;11
2390;"Geniukų kalvė";PELĖDŽIUKAI;1051563985;Taip;0;7;0;7
2391;"Geniukų kalvė";PELĖDŽIUKAI;6174114461;Ne;14;0;0;14
2392;"Geniukų kalvė";PELĖDŽIUKAI;2659298240;Taip;0;4;0;4
2393;"Geniukų kalvė";PELĖDŽIUKAI;6024288147;Taip;0;8;0;8
2394;"Geniukų kalvė";PELĖDŽIUKAI;6737863183;Ne;4;17;0;21
2395;"Geniukų kalvė";PELĖDŽIUKAI;5704223824;Taip;0;3;0;3
2396;"Geniukų kalvė";PELĖDŽIUKAI;1811866428;Taip;0;4;0;4
2397;"Geniukų kalvė";PELĖDŽIUKAI;6410008429;Taip;0;4;0;4
2398;"Geniukų kalvė";PELĖDŽIUKAI;4843411757;Taip;0;5;0;5
2399;"Geniukų kalvė";PELĖDŽIUKAI;8770345339;Taip;7;0;6;13
2400;"Geniukų kalvė";BORUŽĖLĖS;9613720001;Taip;16;0;0;16
2401;"Geniukų kalvė";BORUŽĖLĖS;4958738745;Taip;0;2;0;2
2402;"Geniukų kalvė";BORUŽĖLĖS;4271763719;Taip;0;15;0;15
2403;"Geniukų kalvė";BORUŽĖLĖS;9069256760;Taip;20;0;0;20
2404;"Geniukų kalvė";BORUŽĖLĖS;5161535756;Taip;0;7;0;7
2405;"Geniukų kalvė";BORUŽĖLĖS;7501831333;Taip;7;4;0;11
2406;"Geniukų kalvė";BORUŽĖLĖS;3493492581;Taip;13;1;0;14
2407;"Geniukų kalvė";BORUŽĖLĖS;3085228868;Taip;0;5;0;5
2408;"Geniukų kalvė";BORUŽĖLĖS;3180116136;Taip;11;5;0;16
2409;"Geniukų kalvė";BORUŽĖLĖS;2904091819;Ne;9;6;0;15
2410;"Geniukų kalvė";BORUŽĖLĖS;6794151223;Taip;10;0;0;10
2411;"Geniukų kalvė";BORUŽĖLĖS;4777155321;Taip;12;0;0;12
2412;"Geniukų kalvė";BORUŽĖLĖS;1037854104;Taip;4;2;0;6
2413;"Geniukų kalvė";BORUŽĖLĖS;2180860623;Ne;4;5;0;9
2414;"Geniukų kalvė";BORUŽĖLĖS;7471964981;Ne;10;0;0;10
2415;"Geniukų kalvė";BORUŽĖLĖS;2205515766;Taip;10;4;0;14
2416;"Geniukų kalvė";BORUŽĖLĖS;8769761434;Taip;4;0;0;4
2417;"Geniukų kalvė";BORUŽĖLĖS;1891205998;Ne;0;6;0;6
2418;"Geniukų kalvė";BORUŽĖLĖS;9643242164;Ne;0;11;0;11
2419;"Geniukų kalvė";BORUŽĖLĖS;2665955524;Taip;6;9;0;15
2420;"Geniukų kalvė";BORUŽĖLĖS;4872435715;Taip;0;0;12;12
2421;"Geniukų kalvė";PAGRANDUKAI;9696452101;Taip;0;4;0;4
2422;"Geniukų kalvė";PAGRANDUKAI;2165793561;Taip;0;7;0;7
2423;"Geniukų kalvė";PAGRANDUKAI;1229056613;Taip;5;7;0;12
2424;"Geniukų kalvė";PAGRANDUKAI;7300853810;Taip;0;4;0;4
2425;"Geniukų kalvė";PAGRANDUKAI;2839299179;Taip;10;0;0;10
2426;"Geniukų kalvė";PAGRANDUKAI;6623491459;Taip;4;4;0;8
2427;"Geniukų kalvė";PAGRANDUKAI;2836282651;Taip;6;0;0;6
2428;"Geniukų kalvė";PAGRANDUKAI;9847003556;Taip;6;0;0;6
2429;"Geniukų kalvė";PAGRANDUKAI;2426186771;Taip;2;0;1;3
2430;"Geniukų kalvė";PAGRANDUKAI;3852896932;Taip;13;0;0;13
2431;"Geniukų kalvė";PAGRANDUKAI;1587839122;Taip;5;0;0;5
2432;"Geniukų kalvė";PAGRANDUKAI;4664026888;Taip;9;0;0;9
2433;"Geniukų kalvė";PAGRANDUKAI;6149037133;Taip;17;0;0;17
2434;"Geniukų kalvė";PAGRANDUKAI;5443596677;Taip;8;4;0;12
2435;"Geniukų kalvė";PAGRANDUKAI;5205178173;Taip;3;0;5;8
2436;"Geniukų kalvė";PAGRANDUKAI;7057284039;Taip;4;0;0;4
2437;"Geniukų kalvė";NYKŠTUKAI;4633553106;Taip;8;1;1;10
2438;"Geniukų kalvė";NYKŠTUKAI;5245434552;Taip;3;6;0;9
2439;"Geniukų kalvė";NYKŠTUKAI;4186376527;Taip;12;5;0;17
2440;"Geniukų kalvė";NYKŠTUKAI;1375674317;Taip;7;4;0;11
2441;"Geniukų kalvė";NYKŠTUKAI;7744441981;Taip;12;0;2;14
2442;"Geniukų kalvė";NYKŠTUKAI;1209268848;Taip;12;0;3;15
2443;"Geniukų kalvė";NYKŠTUKAI;5512172533;Taip;21;0;0;21
2444;"Geniukų kalvė";NYKŠTUKAI;1499735818;Taip;7;7;0;14
2445;"Geniukų kalvė";NYKŠTUKAI;2110578252;Taip;20;0;0;20
2446;"Geniukų kalvė";NYKŠTUKAI;8914605154;Taip;6;4;0;10
2447;"Geniukų kalvė";NYKŠTUKAI;1718428600;Taip;3;1;0;4
2448;"Geniukų kalvė";NYKŠTUKAI;4722801116;Taip;8;3;0;11
2449;"Geniukų kalvė";NYKŠTUKAI;2952604528;Taip;9;1;0;10
2450;"Geniukų kalvė";NYKŠTUKAI;5725034297;Taip;18;1;0;19
2451;"Geniukų kalvė";NYKŠTUKAI;8071493871;Taip;13;6;0;19
2452;"Geniukų kalvė";NYKŠTUKAI;2816691996;Taip;12;4;0;16
2453;"Geniukų kalvė";NYKŠTUKAI;5763009912;Taip;8;1;0;9
2454;Gelvonėlis;ĄŽUOLIUKAI;7919814808;Ne;0;9;0;9
2455;Gelvonėlis;ĄŽUOLIUKAI;9323579468;Taip;0;4;0;4
2456;Gelvonėlis;ĄŽUOLIUKAI;3830940009;Taip;0;5;0;5
2457;Gelvonėlis;ĄŽUOLIUKAI;2742000725;Taip;0;0;1;1
2458;Gelvonėlis;ĄŽUOLIUKAI;3147489259;Taip;14;4;0;18
2459;Gelvonėlis;ĄŽUOLIUKAI;2140799517;Taip;5;0;2;7
2460;Gelvonėlis;ĄŽUOLIUKAI;1284359362;Taip;0;4;0;4
2461;Gelvonėlis;ĄŽUOLIUKAI;9798684265;Taip;0;4;0;4
2462;Gelvonėlis;ĄŽUOLIUKAI;8775661719;Taip;0;5;4;9
2463;Gelvonėlis;ĄŽUOLIUKAI;21684706944;Taip;11;0;1;12
2464;Gelvonėlis;ĄŽUOLIUKAI;75676389361;Taip;18;0;0;18
2465;Gelvonėlis;ĄŽUOLIUKAI;2077783219;Taip;6;0;1;7
2466;Gelvonėlis;ĄŽUOLIUKAI;3089755141;Taip;0;6;0;6
2467;Gelvonėlis;ĄŽUOLIUKAI;1408313697;Taip;4;0;0;4
2468;Gelvonėlis;ĄŽUOLIUKAI;3670612781;Ne;12;1;0;13
2469;Gelvonėlis;ĄŽUOLIUKAI;69073786634;Taip;0;13;0;13
2470;Gelvonėlis;ĄŽUOLIUKAI;29928181395;Taip;2;0;1;3
2471;Gelvonėlis;ĄŽUOLIUKAI;6255253658;Taip;6;4;0;10
2472;Gelvonėlis;ĄŽUOLIUKAI;5511174729;Taip;0;4;7;11
2473;Gelvonėlis;ĄŽUOLIUKAI;1624125024;Taip;3;4;4;11
2474;Gelvonėlis;ĄŽUOLIUKAI;9387523651;Ne;0;13;0;13
2475;Gelvonėlis;ŽVIRBLIUKAI;1772713183;Taip;11;0;0;11
2476;Gelvonėlis;ŽVIRBLIUKAI;21250325232;Taip;0;6;0;6
2477;Gelvonėlis;ŽVIRBLIUKAI;5798439412;Taip;0;4;0;4
2478;Gelvonėlis;ŽVIRBLIUKAI;23181505838;Taip;0;9;0;9
2479;Gelvonėlis;ŽVIRBLIUKAI;2997738880;Taip;0;4;0;4
2480;Gelvonėlis;ŽVIRBLIUKAI;1373771258;Taip;0;6;0;6
2481;Gelvonėlis;ŽVIRBLIUKAI;92420286100;Taip;12;5;0;17
2482;Gelvonėlis;ŽVIRBLIUKAI;41610307448;Taip;0;5;0;5
2483;Gelvonėlis;ŽVIRBLIUKAI;87746258537;Taip;0;11;0;11
2484;Gelvonėlis;ŽVIRBLIUKAI;6635285387;Taip;0;0;2;2
2485;Gelvonėlis;ŽVIRBLIUKAI;1938913528;Taip;11;4;0;15
2486;Gelvonėlis;ŽVIRBLIUKAI;2096702999;Taip;9;1;0;10
2487;Gelvonėlis;ŽVIRBLIUKAI;17044138057;Taip;0;0;2;2
2488;Gelvonėlis;ŽVIRBLIUKAI;84863800926;Taip;0;6;0;6
2489;Gelvonėlis;ŽVIRBLIUKAI;1355742622;Ne;0;9;0;9
2490;Gelvonėlis;ŽVIRBLIUKAI;90961913967;Taip;0;4;0;4
2491;Gelvonėlis;ŽVIRBLIUKAI;1835508505;Taip;0;0;3;3
2492;Gelvonėlis;ŽVIRBLIUKAI;9784762153;Taip;10;6;0;16
2493;Gelvonėlis;ŽVIRBLIUKAI;9919860358;Taip;7;0;1;8
2494;Gelvonėlis;ŽVIRBLIUKAI;86895427397;Ne;10;2;0;12
2495;Gelvonėlis;RASELĖS;3325116198;Taip;0;4;5;9
2496;Gelvonėlis;RASELĖS;9847156800;Ne;7;8;0;15
2497;Gelvonėlis;RASELĖS;2153676615;Ne;7;9;0;16
2498;Gelvonėlis;RASELĖS;47302438188;Taip;0;0;1;1
2499;Gelvonėlis;RASELĖS;32893563601;Taip;0;9;0;9
2500;Gelvonėlis;RASELĖS;11697172905;Taip;0;10;0;10
2501;Gelvonėlis;RASELĖS;1221420212;Taip;7;8;0;15
2502;Gelvonėlis;RASELĖS;43145774484;Ne;13;0;0;13
2503;Gelvonėlis;RASELĖS;18237108866;Taip;0;9;0;9
2504;Gelvonėlis;RASELĖS;3271118581;Taip;0;4;4;8
2505;Gelvonėlis;RASELĖS;79607769503;Ne;0;7;0;7
2506;Gelvonėlis;RASELĖS;96792124844;Ne;0;7;0;7
2507;Gelvonėlis;RASELĖS;1400871061;Taip;0;4;0;4
2508;Gelvonėlis;RASELĖS;69221565557;Taip;5;5;0;10
2509;Gelvonėlis;RASELĖS;79899652046;Taip;0;6;1;7
2510;Gelvonėlis;RASELĖS;9108760720;Taip;0;5;0;5
2511;Gelvonėlis;RASELĖS;1776015014;Taip;7;4;0;11
2512;Gelvonėlis;RASELĖS;1648307847;Ne;0;4;8;12
2513;Gelvonėlis;SAULUTĖ;11807134557;Taip;0;5;0;5
2514;Gelvonėlis;SAULUTĖ;72859950160;Taip;0;8;0;8
2515;Gelvonėlis;SAULUTĖ;80973545044;Ne;0;0;21;21
2516;Gelvonėlis;SAULUTĖ;1512245903;Taip;0;7;0;7
2517;Gelvonėlis;SAULUTĖ;9396676137;Taip;0;5;0;5
2518;Gelvonėlis;SAULUTĖ;9353066785;Taip;0;4;0;4
2519;Gelvonėlis;SAULUTĖ;3121251271;Taip;0;9;0;9
2520;Gelvonėlis;SAULUTĖ;1750552925;Taip;10;4;0;14
2521;Gelvonėlis;SAULUTĖ;5098282548;Taip;5;4;0;9
2522;Gelvonėlis;SAULUTĖ;26468121179;Taip;0;5;0;5
2523;Gelvonėlis;SAULUTĖ;59592904001;Taip;0;4;0;4
2524;Gelvonėlis;SAULUTĖ;19782508652;Ne;0;5;0;5
2525;Gelvonėlis;SAULUTĖ;3859776410;Taip;20;0;0;20
2526;Gelvonėlis;SAULUTĖ;19955601762;Ne;8;3;0;11
2527;Gelvonėlis;SAULUTĖ;6405741006;Taip;9;0;0;9
2528;Gelvonėlis;SAULUTĖ;9595350871;Taip;12;0;0;12
2529;Gelvonėlis;SAULUTĖ;71806077882;Taip;7;7;0;14
2530;Gelvonėlis;SAULUTĖ;8475204684;Taip;0;6;0;6
2531;Gelvonėlis;SAULUTĖ;2622967319;Taip;0;8;0;8
2532;Gelvonėlis;SAULUTĖ;4830374546;Taip;12;9;0;21
2533;Gelvonėlis;SAULUTĖ;6226970200;Taip;15;0;0;15
2534;Gelvonėlis;SAULUTĖ;5759356754;Taip;0;7;0;7
2535;Gelvonėlis;SAULUTĖ;1042715433;Ne;0;9;0;9
2536;Gelvonėlis;PELĖDŽIUKAI;87693970225;Taip;0;13;0;13
2537;Gelvonėlis;PELĖDŽIUKAI;17021411833;Taip;0;4;0;4
2538;Gelvonėlis;PELĖDŽIUKAI;48593832088;Taip;0;4;3;7
2539;Gelvonėlis;PELĖDŽIUKAI;22201650331;Taip;0;6;0;6
2540;Gelvonėlis;PELĖDŽIUKAI;98009116912;Taip;5;0;0;5
2541;Gelvonėlis;PELĖDŽIUKAI;51375531815;Taip;0;4;1;5
2542;Gelvonėlis;PELĖDŽIUKAI;70550528579;Taip;10;4;3;17
2543;Gelvonėlis;PELĖDŽIUKAI;91507293029;Taip;0;7;0;7
2544;Gelvonėlis;PELĖDŽIUKAI;79847096929;Taip;0;4;7;11
2545;Gelvonėlis;PELĖDŽIUKAI;71199691102;Taip;0;15;0;15
2546;Gelvonėlis;PELĖDŽIUKAI;43250059460;Taip;0;1;0;1
2547;Gelvonėlis;PELĖDŽIUKAI;2218767947;Taip;0;4;1;5
2548;Gelvonėlis;PELĖDŽIUKAI;7277516341;Taip;0;4;3;7
2549;Gelvonėlis;PELĖDŽIUKAI;5393404051;Taip;7;4;1;12
2550;Gelvonėlis;PELĖDŽIUKAI;89916945860;Ne;0;4;2;6
2551;Gelvonėlis;PELĖDŽIUKAI;40127507796;Taip;0;4;1;5
2552;Gelvonėlis;PELĖDŽIUKAI;36610437375;Taip;0;0;3;3
2553;Gelvonėlis;PELĖDŽIUKAI;9970883470;Taip;0;10;0;10
2554;Gelvonėlis;PELĖDŽIUKAI;1902998389;Taip;0;2;3;5
2555;Gelvonėlis;PELĖDŽIUKAI;2146163687;Taip;0;8;0;8
2556;Gelvonėlis;PELĖDŽIUKAI;71076083278;Taip;10;4;2;16
2557;Gelvonėlis;DRUGELIAI;8209225630;Taip;15;0;0;15
2558;Gelvonėlis;DRUGELIAI;7936622964;Taip;0;6;0;6
2559;Gelvonėlis;DRUGELIAI;6856800484;Taip;0;3;0;3
2560;Gelvonėlis;DRUGELIAI;6554989142;Taip;16;1;0;17
2561;Gelvonėlis;DRUGELIAI;8056058298;Taip;0;2;0;2
2562;Gelvonėlis;DRUGELIAI;2698853686;Taip;0;17;0;17
2563;Gelvonėlis;DRUGELIAI;4112607183;Taip;15;0;0;15
2564;Gelvonėlis;DRUGELIAI;6585504578;Taip;17;0;0;17
2565;Gelvonėlis;DRUGELIAI;6243360625;Taip;0;9;0;9
2566;Gelvonėlis;DRUGELIAI;5790038422;Taip;5;2;0;7
2567;Gelvonėlis;DRUGELIAI;8515746171;Taip;0;2;0;2
2568;Gelvonėlis;VARPELIAI;3059903126;Taip;0;0;1;1
2569;Gelvonėlis;VARPELIAI;9149117970;Taip;14;0;0;14
2570;Gelvonėlis;VARPELIAI;3483144401;Taip;0;0;7;7
2571;Gelvonėlis;VARPELIAI;6451557430;Taip;0;7;0;7
2572;Gelvonėlis;VARPELIAI;6225854165;Taip;19;0;0;19
2573;Gelvonėlis;VARPELIAI;2791652988;Taip;6;3;0;9
2574;Gelvonėlis;VARPELIAI;2638430817;Ne;0;0;5;5
2575;Gelvonėlis;VARPELIAI;9600526942;Taip;9;6;0;15
2576;Gelvonėlis;VARPELIAI;1387948936;Taip;0;10;0;10
2577;Gelvonėlis;VARPELIAI;9650922918;Taip;0;2;0;2
2578;Gelvonėlis;VARPELIAI;1462716950;Taip;3;4;1;8
2579;Gelvonėlis;VARPELIAI;6949090250;Taip;21;0;0;21
2580;Gelvonėlis;VARPELIAI;9622818893;Taip;0;0;4;4
2581;Gelvonėlis;VARPELIAI;7194091189;Ne;4;0;1;5
2582;Gelvonėlis;VARPELIAI;3446593424;Taip;10;0;2;12
2583;Gelvonėlis;VARPELIAI;6478873536;Taip;21;0;0;21
2584;Gelvonėlis;VARPELIAI;6869418701;Taip;0;0;3;3
2585;Gelvonėlis;VARPELIAI;5207153784;Taip;0;12;0;12
2586;Gelvonėlis;VARPELIAI;3730493822;Taip;3;2;3;8
2587;Gelvonėlis;VARPELIAI;9304912028;Taip;4;0;0;4
2588;Gelvonėlis;BORUŽĖLĖS;1030246127;Taip;0;7;0;7
2589;Gelvonėlis;BORUŽĖLĖS;22575527531;Taip;8;4;0;12
2590;Gelvonėlis;BORUŽĖLĖS;1163833201;Taip;5;5;0;10
2591;Gelvonėlis;BORUŽĖLĖS;3379601736;Taip;0;12;0;12
2592;Gelvonėlis;BORUŽĖLĖS;1597669426;Taip;2;2;0;4
2593;Gelvonėlis;BORUŽĖLĖS;31744699590;Taip;0;4;3;7
2594;Gelvonėlis;BORUŽĖLĖS;9777094764;Taip;0;0;2;2
2595;Gelvonėlis;BORUŽĖLĖS;3936144045;Ne;0;2;1;3
2596;Gelvonėlis;BORUŽĖLĖS;12715604772;Taip;6;4;0;10
2597;Gelvonėlis;BORUŽĖLĖS;8050788182;Taip;0;18;0;18
2598;Gelvonėlis;BORUŽĖLĖS;91441127098;Taip;0;2;0;2
2599;Gelvonėlis;BORUŽĖLĖS;30812081628;Taip;0;0;5;5
2600;Gelvonėlis;BORUŽĖLĖS;1183745610;Taip;0;9;0;9
2601;Gelvonėlis;BORUŽĖLĖS;6266298514;Ne;0;10;0;10
2602;Gelvonėlis;BORUŽĖLĖS;3284385491;Taip;7;4;4;15
2603;Gelvonėlis;BORUŽĖLĖS;1610362831;Ne;9;6;0;15
2604;Gelvonėlis;BORUŽĖLĖS;1836155450;Taip;9;4;0;13
2605;Gelvonėlis;BORUŽĖLĖS;7903272826;Taip;9;0;0;9
2606;Gelvonėlis;NYKŠTUKAI;6604992169;Taip;0;6;0;6
2607;Gelvonėlis;NYKŠTUKAI;6556472766;Taip;21;0;0;21
2608;Gelvonėlis;NYKŠTUKAI;7182180008;Taip;2;2;0;4
2609;Gelvonėlis;NYKŠTUKAI;6598178467;Taip;12;6;0;18
2610;Gelvonėlis;NYKŠTUKAI;8885088900;Taip;10;1;0;11
2611;Gelvonėlis;NYKŠTUKAI;8622621570;Taip;12;0;4;16
2612;Gelvonėlis;NYKŠTUKAI;2400289466;Taip;4;7;0;11
2613;Gelvonėlis;NYKŠTUKAI;5129492284;Taip;6;0;1;7
2614;Gelvonėlis;NYKŠTUKAI;9493536517;Taip;10;0;0;10
2615;Gelvonėlis;NYKŠTUKAI;2288951845;Taip;4;4;1;9
2616;Gelvonėlis;NYKŠTUKAI;2515471132;Ne;4;0;5;9
2617;Gelvonėlis;NYKŠTUKAI;6505814802;Taip;0;1;2;3
2618;Gelvonėlis;NYKŠTUKAI;6319058542;Ne;11;0;1;12
2619;Gelvonėlis;NYKŠTUKAI;9538571448;Taip;5;1;0;6
2620;Gelvonėlis;NYKŠTUKAI;9147186080;Taip;7;8;0;15
2621;Gelvonėlis;NYKŠTUKAI;7620280474;Taip;0;0;2;2
2622;Gelvonėlis;NYKŠTUKAI;9059244134;Taip;0;8;0;8
2623;Gelvonėlis;NYKŠTUKAI;1987204544;Taip;7;6;0;13
2624;Gelvonėlis;NYKŠTUKAI;1085845218;Taip;9;0;0;9
2625;Gelvonėlis;NYKŠTUKAI;7195164378;Taip;17;4;0;21
2626;Gelvonėlis;NYKŠTUKAI;6153902752;Taip;0;0;8;8
2627;Gelvonėlis;BITUTĖS;7759317220;Ne;3;11;0;14
2628;Gelvonėlis;BITUTĖS;6196065515;Taip;5;2;0;7
2629;Gelvonėlis;BITUTĖS;2504468098;Taip;9;4;0;13
2630;Gelvonėlis;BITUTĖS;7983982378;Taip;0;6;0;6
2631;Gelvonėlis;BITUTĖS;5721858659;Taip;0;5;0;5
2632;Gelvonėlis;BITUTĖS;9667024635;Taip;5;0;0;5
2633;Gelvonėlis;BITUTĖS;2108690954;Taip;8;0;1;9
2634;Gelvonėlis;BITUTĖS;4855800131;Taip;0;4;1;5
2635;Gelvonėlis;BITUTĖS;1753617545;Taip;11;3;0;14
2636;Gelvonėlis;BITUTĖS;6189110767;Taip;0;8;0;8
2637;Gelvonėlis;BITUTĖS;3843881329;Ne;4;1;0;5
2638;Gelvonėlis;BITUTĖS;6317822775;Taip;6;0;0;6
2639;Gelvonėlis;BITUTĖS;9184192787;Taip;9;4;0;13
2640;Gelvonėlis;BITUTĖS;9369121356;Taip;10;0;0;10
2641;Gelvonėlis;BITUTĖS;2119550116;Taip;19;0;0;19
2642;Gelvonėlis;BITUTĖS;7826522180;Taip;0;0;1;1
2643;Gelvonėlis;BITUTĖS;9286500887;Taip;9;2;0;11
2644;Gelvonėlis;BITUTĖS;5095782784;Taip;21;0;0;21
2645;Gelvonėlis;BITUTĖS;1516164123;Taip;9;3;0;12
2646;Gelvonėlis;BITUTĖS;7226051965;Taip;0;3;0;3
2647;Gelvonėlis;BITUTĖS;3788522708;Taip;0;1;1;2
2648;Gelvonėlis;BITUTĖS;5047022305;Ne;16;1;0;17
2649;Gelvonėlis;RAMUNĖLĖS;3368423382;Taip;0;2;0;2
2650;Gelvonėlis;RAMUNĖLĖS;3973248307;Taip;14;0;0;14
2651;Gelvonėlis;RAMUNĖLĖS;5759407291;Taip;7;2;0;9
2652;Gelvonėlis;RAMUNĖLĖS;2163976198;Taip;8;0;0;8
2653;Gelvonėlis;RAMUNĖLĖS;5986018609;Taip;17;4;0;21
2654;Gelvonėlis;RAMUNĖLĖS;8766702456;Taip;2;6;0;8
2655;Gelvonėlis;RAMUNĖLĖS;1266479895;Taip;0;8;0;8
2656;Gelvonėlis;RAMUNĖLĖS;1004686756;Taip;4;0;0;4
2657;Gelvonėlis;RAMUNĖLĖS;5934077931;Taip;9;3;0;12
2658;Gelvonėlis;RAMUNĖLĖS;3271464159;Taip;16;1;0;17
2659;Gelvonėlis;RAMUNĖLĖS;2734462553;Taip;12;0;0;12
2660;Gelvonėlis;RAMUNĖLĖS;4280463938;Taip;0;2;0;2
2661;Gelvonėlis;RAMUNĖLĖS;4083370462;Taip;1;9;0;10
2662;Gelvonėlis;RAMUNĖLĖS;6068473734;Taip;13;0;0;13
2663;Gelvonėlis;RAMUNĖLĖS;8532801167;Taip;0;4;0;4
2664;Gervelė;ŽIRNIUKAI;9977349707;Taip;0;0;4;4
2665;Gervelė;ŽIRNIUKAI;7317091881;Taip;16;0;0;16
2666;Gervelė;ŽIRNIUKAI;4038179503;Taip;21;0;0;21
2667;Gervelė;ŽIRNIUKAI;4295743997;Taip;6;1;1;8
2668;Gervelė;ŽIRNIUKAI;7020599764;Taip;4;0;1;5
2669;Gervelė;ŽIRNIUKAI;4394752176;Taip;4;2;0;6
2670;Gervelė;ŽIRNIUKAI;6228025635;Taip;11;0;0;11
2671;Gervelė;ŽIRNIUKAI;6951455424;Taip;0;0;3;3
2672;Gervelė;ŽIRNIUKAI;9970293084;Taip;14;1;0;15
2673;Gervelė;ŽIRNIUKAI;8012122042;Taip;0;8;0;8
2674;Gervelė;ŽIRNIUKAI;1400044294;Taip;0;0;5;5
2675;Gervelė;ŽIRNIUKAI;7935059565;Taip;6;0;1;7
2676;Gervelė;ŽIRNIUKAI;5267617723;Taip;9;1;0;10
2677;Gervelė;ŽIRNIUKAI;5953552777;Taip;0;3;0;3
2678;Gervelė;ŽIRNIUKAI;6263562066;Ne;2;0;3;5
2679;Gervelė;ŽIRNIUKAI;6287806975;Ne;0;0;3;3
2680;Gervelė;ŽIRNIUKAI;5685222621;Taip;10;0;0;10
2681;Gervelė;ŽIRNIUKAI;6987657237;Taip;7;0;1;8
2682;Gervelė;LAŠIUKAI;8062089041;Taip;5;5;0;10
2683;Gervelė;LAŠIUKAI;2551280794;Taip;7;11;0;18
2684;Gervelė;LAŠIUKAI;1616949023;Taip;4;9;0;13
2685;Gervelė;LAŠIUKAI;9515308666;Taip;0;3;0;3
2686;Gervelė;LAŠIUKAI;3427400844;Taip;9;0;4;13
2687;Gervelė;LAŠIUKAI;8152446576;Taip;0;12;0;12
2688;Gervelė;LAŠIUKAI;6967078836;Taip;5;4;0;9
2689;Gervelė;LAŠIUKAI;7302238728;Ne;3;3;1;7
2690;Gervelė;LAŠIUKAI;7697761552;Taip;6;0;4;10
2691;Gervelė;LAŠIUKAI;5989713844;Taip;6;6;0;12
2692;Gervelė;LAŠIUKAI;4560752068;Taip;0;10;0;10
2693;Gervelė;LAŠIUKAI;1704033440;Taip;7;4;0;11
2694;Gervelė;LAŠIUKAI;4705514590;Ne;2;0;2;4
2695;Gervelė;LAŠIUKAI;89076506192;Taip;8;0;1;9
2696;Gervelė;LAŠIUKAI;87619285504;Taip;5;0;0;5
2697;Gervelė;LAŠIUKAI;1991238577;Taip;2;3;0;5
2698;Gervelė;LAŠIUKAI;2167744244;Taip;0;5;0;5
2699;Gervelė;LAŠIUKAI;3525060645;Taip;5;8;0;13
2700;Gervelė;PABIRUČIAI;2019214634;Taip;17;0;0;17
2701;Gervelė;PABIRUČIAI;88273293270;Taip;0;4;1;5
2702;Gervelė;PABIRUČIAI;3278950938;Taip;0;7;0;7
2703;Gervelė;PABIRUČIAI;52142182972;Taip;6;0;0;6
2704;Gervelė;PABIRUČIAI;62782512806;Taip;0;11;0;11
2705;Gervelė;PABIRUČIAI;1921567602;Taip;0;4;0;4
2706;Gervelė;PABIRUČIAI;8454703111;Taip;4;4;0;8
2707;Gervelė;PABIRUČIAI;1492459180;Taip;5;0;0;5
2708;Gervelė;PABIRUČIAI;1617055167;Taip;0;0;1;1
2709;Gervelė;PABIRUČIAI;1697536098;Taip;4;3;0;7
2710;Gervelė;PABIRUČIAI;49013139623;Taip;7;0;0;7
2711;Gervelė;PABIRUČIAI;2632272974;Taip;6;0;1;7
2712;Gervelė;PABIRUČIAI;1860333208;Taip;17;4;0;21
2713;Gervelė;PABIRUČIAI;2798349541;Ne;0;9;0;9
2714;Gervelė;PABIRUČIAI;9166145365;Taip;2;0;0;2
2715;Gervelė;PABIRUČIAI;6349428106;Taip;0;7;0;7
2716;Gervelė;PABIRUČIAI;73803372762;Taip;0;0;2;2
2717;Gervelė;PABIRUČIAI;8035942210;Taip;9;8;0;17
2718;Gervelė;BITUTĖS;1792726318;Ne;0;14;0;14
2719;Gervelė;BITUTĖS;85689668690;Taip;0;4;1;5
2720;Gervelė;BITUTĖS;44678807307;Ne;0;3;4;7
2721;Gervelė;BITUTĖS;1371549808;Taip;4;4;0;8
2722;Gervelė;BITUTĖS;15891512215;Taip;10;4;0;14
2723;Gervelė;BITUTĖS;48497142461;Ne;0;3;2;5
2724;Gervelė;BITUTĖS;76731434799;Ne;0;4;9;13
2725;Gervelė;BITUTĖS;24724452164;Taip;0;5;0;5
2726;Gervelė;BITUTĖS;27435616549;Taip;2;3;0;5
2727;Gervelė;BITUTĖS;1303396562;Ne;0;4;10;14
2728;Gervelė;BITUTĖS;32101040739;Ne;0;4;0;4
2729;Gervelė;BITUTĖS;5085234839;Taip;0;4;0;4
2730;Gervelė;BITUTĖS;97418410809;Ne;0;5;0;5
2731;Gervelė;BITUTĖS;65751519550;Ne;6;4;1;11
2732;Gervelė;BITUTĖS;1928679740;Taip;4;4;2;10
2733;Gervelė;BITUTĖS;1413157604;Taip;0;4;3;7
2734;Gervelė;BITUTĖS;81112128210;Taip;0;1;0;1
2735;Gervelė;BITUTĖS;65086547895;Taip;5;6;0;11
2736;Gervelė;BITUTĖS;2017094793;Taip;0;3;1;4
2737;Gervelė;BITUTĖS;8302493906;Ne;0;6;0;6
2738;Gervelė;BURATINO;1815418720;Taip;0;13;0;13
2739;Gervelė;BURATINO;6168558862;Taip;0;12;0;12
2740;Gervelė;BURATINO;1083567209;Taip;0;4;0;4
2741;Gervelė;BURATINO;3946391650;Taip;0;6;0;6
2742;Gervelė;BURATINO;7620764911;Taip;7;10;0;17
2743;Gervelė;BURATINO;5440557094;Taip;0;5;0;5
2744;Gervelė;BURATINO;9202293067;Taip;5;0;0;5
2745;Gervelė;BURATINO;9909794030;Taip;0;8;0;8
2746;Gervelė;BURATINO;2646901307;Taip;3;2;0;5
2747;Gervelė;BURATINO;9564303781;Taip;0;0;4;4
2748;Gervelė;BURATINO;78122408360;Taip;18;1;0;19
2749;Gervelė;BURATINO;8458769051;Taip;3;0;0;3
2750;Gervelė;BURATINO;9771780358;Taip;7;3;0;10
2751;Gervelė;BURATINO;9239897472;Taip;5;5;0;10
2752;Gervelė;BURATINO;8997525194;Taip;0;5;0;5
2753;Gervelė;VIŠČIUKŲ;6844406500;Taip;18;0;0;18
2754;Gervelė;VIŠČIUKŲ;8157865822;Taip;5;4;0;9
2755;Gervelė;VIŠČIUKŲ;2359854614;Taip;12;0;1;13
2756;Gervelė;VIŠČIUKŲ;8533480337;Taip;13;4;0;17
2757;Gervelė;VIŠČIUKŲ;2523056808;Taip;5;0;9;14
2758;Gervelė;VIŠČIUKŲ;6145405293;Taip;4;0;0;4
2759;Gervelė;VIŠČIUKŲ;1637204236;Taip;8;0;0;8
2760;Gervelė;VIŠČIUKŲ;2413995770;Taip;19;0;0;19
2761;Gervelė;VIŠČIUKŲ;6058944385;Taip;0;11;0;11
2762;Gervelė;VIŠČIUKŲ;1323074335;Taip;14;0;0;14
2763;Gervelė;VIŠČIUKŲ;3702908570;Taip;10;0;0;10
2764;Gervelė;VIŠČIUKŲ;4294916559;Taip;14;1;0;15
2765;Gervelė;VIŠČIUKŲ;3449674095;Taip;3;7;0;10
2766;Gervelė;VIŠČIUKŲ;5767158743;Taip;3;0;0;3
2767;Gervelė;VIŠČIUKŲ;4775822341;Taip;7;7;0;14
2768;Gervelė;VIŠČIUKŲ;3723783633;Taip;0;7;0;7
2769;Gilužis;Skruzdėliukų;35511006307;Taip;0;4;0;4
2770;Gilužis;Skruzdėliukų;44807904472;Taip;12;4;0;16
2771;Gilužis;Skruzdėliukų;1671692484;Ne;3;0;0;3
2772;Gilužis;Skruzdėliukų;1615293331;Taip;0;14;0;14
2773;Gilužis;Skruzdėliukų;9474400084;Taip;0;2;0;2
2774;Gilužis;Skruzdėliukų;5161095299;Taip;2;4;0;6
2775;Gilužis;Skruzdėliukų;70959404439;Taip;0;4;0;4
2776;Gilužis;Skruzdėliukų;8120898865;Taip;0;1;0;1
2777;Gilužis;Skruzdėliukų;8840822243;Taip;4;2;1;7
2778;Gilužis;Skruzdėliukų;4611735601;Taip;8;6;0;14
2779;Gilužis;Skruzdėliukų;4747769984;Taip;0;4;0;4
2780;Gilužis;Skruzdėliukų;5920357223;Taip;0;5;0;5
2781;Gilužis;Skruzdėliukų;8595541498;Taip;6;2;0;8
2782;Gilužis;Skruzdėliukų;5365582271;Taip;1;4;0;5
2783;Gilužis;Skruzdėliukų;7364297673;Taip;0;0;1;1
2784;Gilužis;Skruzdėliukų;4362244070;Ne;0;2;2;4
2785;Gilužis;Skruzdėliukų;2042514241;Taip;0;3;0;3
2786;Gilužis;Skruzdėliukų;3216004438;Taip;0;4;0;4
2787;Gilužis;Skruzdėliukų;7766747590;Taip;3;0;0;3
2788;Gilužis;Skruzdėliukų;4777937216;Ne;2;11;0;13
2789;Gilužis;Skruzdėliukų;48365991937;Ne;2;11;0;13
2790;Gilužis;Nykštukų;3132445117;Taip;4;1;0;5
2791;Gilužis;Nykštukų;4147821853;Taip;4;2;0;6
2792;Gilužis;Nykštukų;3473889426;Taip;4;5;0;9
2793;Gilužis;Nykštukų;9362581908;Taip;4;5;0;9
2794;Gilužis;Nykštukų;8899557365;Taip;0;2;1;3
2795;Gilužis;Nykštukų;2661894041;Taip;14;1;1;16
2796;Gilužis;Nykštukų;5109935385;Taip;0;7;0;7
2797;Gilužis;Nykštukų;7228498662;Taip;0;4;0;4
2798;Gilužis;Nykštukų;3335512812;Taip;0;9;0;9
2799;Gilužis;Nykštukų;1459273692;Taip;0;1;0;1
2800;Gilužis;Nykštukų;6093514885;Taip;9;2;0;11
2801;Gilužis;Nykštukų;4156613717;Ne;12;0;0;12
2802;Gilužis;Nykštukų;5713786735;Ne;8;2;2;12
2803;Gilužis;Nykštukų;2784416935;Taip;13;1;0;14
2804;Gilužis;Nykštukų;4956685016;Taip;0;2;0;2
2805;Gilužis;Nykštukų;6315155554;Ne;0;5;0;5
2806;Gilužis;Nykštukų;9332056404;Taip;5;4;2;11
2807;Gilužis;Nykštukų;4541291716;Taip;0;5;0;5
2808;Gilužis;Nykštukų;8522552650;Taip;3;5;2;10
2809;Gilužis;Nykštukų;3176305306;Ne;8;6;0;14
2810;Gilužis;Bitučių;7667792304;Taip;0;6;0;6
2811;Gilužis;Bitučių;33601993265;Taip;0;7;0;7
2812;Gilužis;Bitučių;36591400178;Taip;0;2;0;2
2813;Gilužis;Bitučių;79835099585;Taip;2;5;3;10
2814;Gilužis;Bitučių;86856314276;Taip;0;4;0;4
2815;Gilužis;Bitučių;6761901941;Taip;0;4;1;5
2816;Gilužis;Bitučių;86204525039;Taip;5;4;0;9
2817;Gilužis;Bitučių;66936354561;Taip;0;3;0;3
2818;Gilužis;Bitučių;31841898314;Taip;0;1;1;2
2819;Gilužis;Bitučių;37713407129;Taip;0;6;0;6
2820;Gilužis;Bitučių;58788039263;Taip;0;4;0;4
2821;Gilužis;Bitučių;99678737297;Taip;0;3;0;3
2822;Gilužis;Bitučių;35872947177;Taip;0;3;0;3
2823;Gilužis;Bitučių;67925251330;Taip;0;6;0;6
2824;Gilužis;Bitučių;75877736009;Taip;0;2;0;2
2825;Gilužis;Bitučių;77265792587;Taip;0;4;0;4
2826;Gilužis;Bitučių;98929035480;Taip;0;6;0;6
2827;Gilužis;Bitučių;16441506448;Taip;0;2;1;3
2828;Gilužis;Bitučių;60029145569;Taip;0;4;1;5
2829;Gilužis;Bitučių;84012597609;Ne;0;6;0;6
2830;Gilužis;Bitučių;44591290522;Taip;0;9;2;11
2831;Gilužis;Kačiukų;64044950817;Taip;9;4;0;13
2832;Gilužis;Kačiukų;97044945526;Taip;5;1;2;8
2833;Gilužis;Kačiukų;2452430134;Taip;0;5;0;5
2834;Gilužis;Kačiukų;97366385111;Taip;0;5;0;5
2835;Gilužis;Kačiukų;98833692687;Taip;0;4;1;5
2836;Gilužis;Kačiukų;90653192774;Taip;2;1;0;3
2837;Gilužis;Kačiukų;43427840545;Taip;3;0;0;3
2838;Gilužis;Kačiukų;69179380194;Taip;2;4;0;6
2839;Gilužis;Kačiukų;93911699181;Taip;0;5;1;6
2840;Gilužis;Kačiukų;27145205823;Taip;0;4;0;4
2841;Gilužis;Kačiukų;11999596704;Taip;0;4;0;4
2842;Gilužis;Kačiukų;40327951625;Ne;0;6;3;9
2843;Gilužis;Kačiukų;32385951346;Taip;3;11;0;14
2844;Gilužis;Kačiukų;69814504535;Ne;0;5;0;5
2845;Gilužis;Kačiukų;2826672081;Taip;0;3;0;3
2846;Gilužis;Kačiukų;48813257365;Ne;0;2;0;2
2847;Gilužis;Kačiukų;37836645040;Taip;0;3;0;3
2848;Gilužis;Kačiukų;90150093965;Taip;3;4;0;7
2849;Gilužis;Kačiukų;88997906780;Taip;0;4;0;4
2850;Gilužis;Kačiukų;1483999429;Taip;0;4;0;4
2851;Gilužis;Kačiukų;8442202778;Taip;3;4;0;7
2852;Gilužis;Kačiukų;51801100240;Taip;1;9;0;10
2853;Gilužis;Pelėdžiukų;5217748032;Ne;0;9;0;9
2854;Gilužis;Pelėdžiukų;5989314494;Taip;0;6;0;6
2855;Gilužis;Pelėdžiukų;7998695149;Taip;20;0;0;20
2856;Gilužis;Pelėdžiukų;7742783427;Taip;20;0;0;20
2857;Gilužis;Pelėdžiukų;7358572344;Taip;6;9;0;15
2858;Gilužis;Pelėdžiukų;1222370750;Ne;0;4;0;4
2859;Gilužis;Pelėdžiukų;9503516686;Taip;5;0;0;5
2860;Gilužis;Pelėdžiukų;9833451628;Taip;9;0;0;9
2861;Gilužis;Pelėdžiukų;6270071724;Taip;0;1;0;1
2862;Gilužis;Pelėdžiukų;7505729606;Taip;2;0;0;2
2863;Gilužis;Pelėdžiukų;7050440691;Taip;20;0;0;20
2864;Gilužis;Pelėdžiukų;4051726208;Taip;11;4;0;15
2865;Gilužis;Pelėdžiukų;7092060789;Taip;0;3;0;3
2866;Gilužis;Pelėdžiukų;4435227217;Ne;0;0;3;3
2867;Gilužis;Pelėdžiukų;1804218972;Taip;0;4;0;4
2868;Gilužis;Pelėdžiukų;1832039250;Taip;8;4;0;12
2869;Gilužis;Pelėdžiukų;3166161973;Taip;3;2;1;6
2870;Gilužis;Pelėdžiukų;5070988982;Taip;16;2;0;18
2871;Gilužis;Pelėdžiukų;7899274495;Taip;8;0;1;9
2872;Gilužis;Drugelių;1437220475;Taip;0;11;0;11
2873;Gilužis;Drugelių;36023384252;Taip;6;3;0;9
2874;Gilužis;Drugelių;44522730563;Taip;0;4;0;4
2875;Gilužis;Drugelių;9763902423;Ne;8;4;1;13
2876;Gilužis;Drugelių;1197884403;Ne;0;4;0;4
2877;Gilužis;Drugelių;6567065609;Taip;6;4;1;11
2878;Gilužis;Drugelių;1908578050;Taip;5;4;0;9
2879;Gilužis;Drugelių;6000255910;Taip;11;4;1;16
2880;Gilužis;Drugelių;96882209197;Ne;2;4;0;6
2881;Gilužis;Drugelių;79340379786;Ne;2;10;0;12
2882;Gilužis;Drugelių;6622443065;Ne;2;5;1;8
2883;Gilužis;Drugelių;1774912517;Taip;5;4;0;9
2884;Gilužis;Drugelių;80556519366;Taip;0;2;0;2
2885;Gilužis;Drugelių;1335467227;Taip;0;2;2;4
2886;Gilužis;Drugelių;2102777576;Taip;0;6;0;6
2887;Gilužis;Drugelių;82153346966;Ne;0;4;0;4
2888;Gilužis;Drugelių;7244188057;Ne;3;2;1;6
2889;Gilužis;Drugelių;93587767496;Taip;0;4;0;4
2890;Gilužis;Drugelių;55062344648;Taip;2;4;0;6
2891;Gilužis;Drugelių;2118119414;Ne;3;4;1;8
2892;Gilužis;Drugelių;82030031331;Taip;8;4;0;12
2893;Gilužis;Drugelių;7127446066;Ne;5;4;1;10
2894;Gilužis;Drugelių;73711363249;Taip;0;4;0;4
2895;Gilužis;Saulučių;17896774143;Taip;5;0;5;10
2896;Gilužis;Saulučių;9918995545;Taip;4;1;0;5
2897;Gilužis;Saulučių;4209000927;Taip;0;4;1;5
2898;Gilužis;Saulučių;8595551150;Taip;12;0;0;12
2899;Gilužis;Saulučių;4575619425;Taip;2;3;1;6
2900;Gilužis;Saulučių;8224691148;Taip;0;5;0;5
2901;Gilužis;Saulučių;4473810097;Taip;4;4;1;9
2902;Gilužis;Saulučių;96550272401;Taip;18;0;0;18
2903;Gilužis;Saulučių;69504888193;Taip;7;0;0;7
2904;Gilužis;Saulučių;2391630554;Taip;0;9;0;9
2905;Gilužis;Saulučių;18997894859;Taip;5;4;0;9
2906;Gilužis;Saulučių;7744997250;Ne;7;0;1;8
2907;Gilužis;Saulučių;32730847948;Taip;0;4;0;4
2908;Gilužis;Saulučių;3181765606;Taip;0;0;2;2
2909;Gilužis;Saulučių;5905237803;Taip;6;0;0;6
2910;Gilužis;Saulučių;79805583046;Taip;0;0;1;1
2911;Gilužis;Saulučių;2872439079;Taip;0;0;1;1
2912;Gilužis;Saulučių;28447690974;Taip;0;0;13;13
2913;Gilužis;Saulučių;87425898496;Taip;2;0;1;3
2914;Gilužis;Saulučių;35650138667;Taip;13;0;1;14
2915;Gilužis;Saulučių;9367673896;Taip;13;0;0;13
2916;Gilužis;Paukštelių;2033250993;Taip;7;4;1;12
2917;Gilužis;Paukštelių;1120628451;Taip;0;3;0;3
2918;Gilužis;Paukštelių;1772207635;Taip;11;4;0;15
2919;Gilužis;Paukštelių;9252084783;Taip;0;1;0;1
2920;Gilužis;Paukštelių;4265465127;Taip;0;6;0;6
2921;Gilužis;Paukštelių;1797199356;Taip;0;6;0;6
2922;Gilužis;Paukštelių;93844800610;Taip;0;1;0;1
2923;Gilužis;Paukštelių;92163197528;Taip;6;4;2;12
2924;Gilužis;Paukštelių;1962922981;Taip;8;4;0;12
2925;Gilužis;Paukštelių;2769830772;Taip;0;1;3;4
2926;Gilužis;Paukštelių;1259168003;Taip;0;2;0;2
2927;Gilužis;Paukštelių;91148708775;Taip;10;4;0;14
2928;Gilužis;Paukštelių;8933516128;Taip;3;4;1;8
2929;Gilužis;Paukštelių;49114819476;Taip;9;0;0;9
2930;Gilužis;Paukštelių;65698608589;Taip;1;4;0;5
2931;Gilužis;Paukštelių;1413931545;Taip;0;1;1;2
2932;Gilužis;Paukštelių;4754994261;Ne;2;1;0;3
2933;Gilužis;Paukštelių;49793977825;Taip;0;8;0;8
2934;Gilužis;Obuoliukų;27834192987;Taip;0;5;0;5
2935;Gilužis;Obuoliukų;1050659357;Taip;0;4;0;4
2936;Gilužis;Obuoliukų;72582220264;Taip;0;8;0;8
2937;Gilužis;Obuoliukų;2134161601;Taip;2;4;0;6
2938;Gilužis;Obuoliukų;1637726675;Taip;0;3;0;3
2939;Gilužis;Obuoliukų;1404236599;Taip;11;6;0;17
2940;Gilužis;Obuoliukų;1847232194;Taip;2;5;0;7
2941;Gilužis;Obuoliukų;2031851095;Taip;0;4;0;4
2942;Gilužis;Obuoliukų;8015495924;Taip;0;4;2;6
2943;Gilužis;Obuoliukų;96799037695;Taip;0;4;0;4
2944;Gilužis;Obuoliukų;2138402546;Taip;0;4;0;4
2945;Gilužis;Obuoliukų;1923605078;Taip;4;0;0;4
2946;Gilužis;Obuoliukų;1236164928;Taip;0;4;0;4
2947;Gilužis;Obuoliukų;84834458261;Taip;8;1;0;9
2948;Gilužis;Obuoliukų;5121769570;Taip;0;0;5;5
2949;Gilužis;Obuoliukų;1428994411;Taip;3;4;0;7
2950;Gilužis;Obuoliukų;5899163275;Taip;3;5;0;8
2951;Gilužis;Obuoliukų;2126527730;Taip;0;6;0;6
2952;Gilužis;Obuoliukų;53388692764;Taip;0;7;0;7
2953;Gilužis;Obuoliukų;1067512693;Taip;2;0;1;3
2954;Gilužis;KIŠKUČIŲ;98584480044;Taip;0;4;0;4
2955;Gilužis;KIŠKUČIŲ;1191967409;Taip;10;1;0;11
2956;Gilužis;KIŠKUČIŲ;1025400197;Taip;0;0;6;6
2957;Gilužis;KIŠKUČIŲ;1841556598;Taip;0;0;1;1
2958;Gilužis;KIŠKUČIŲ;24558082285;Taip;5;14;0;19
2959;Gilužis;KIŠKUČIŲ;31157032738;Taip;1;0;2;3
2960;Gilužis;KIŠKUČIŲ;69205729963;Taip;0;5;0;5
2961;Gilužis;KIŠKUČIŲ;1869058578;Taip;11;0;0;11
2962;Gilužis;KIŠKUČIŲ;1464348972;Taip;0;0;1;1
2963;Gilužis;KIŠKUČIŲ;7740703388;Taip;0;0;6;6
2964;Gilužis;KIŠKUČIŲ;1589884646;Taip;4;8;1;13
2965;Gilužis;KIŠKUČIŲ;54636558233;Taip;5;1;0;6
2966;Gilužis;KIŠKUČIŲ;1453976300;Taip;0;5;0;5
2967;Gilužis;KIŠKUČIŲ;57074114440;Taip;0;7;0;7
2968;Gilužis;KIŠKUČIŲ;1307302669;Taip;0;0;4;4
2969;Gilužis;KIŠKUČIŲ;1569805585;Taip;16;0;1;17
2970;Gilužis;KIŠKUČIŲ;1211233315;Taip;0;0;1;1
2971;Gilužis;Meškučių;5008795520;Taip;0;4;0;4
2972;Gilužis;Meškučių;9104396905;Taip;0;4;0;4
2973;Gilužis;Meškučių;15672746324;Taip;2;4;0;6
2974;Gilužis;Meškučių;8278207628;Ne;3;4;0;7
2975;Gilužis;Meškučių;2144919007;Taip;0;5;0;5
2976;Gilužis;Meškučių;6840555273;Taip;0;14;0;14
2977;Gilužis;Meškučių;2111997678;Taip;0;1;0;1
2978;Gilužis;Meškučių;1664140841;Ne;9;1;0;10
2979;Gilužis;Meškučių;1201973661;Taip;0;14;0;14
2980;Gilužis;Meškučių;99889836604;Taip;2;2;0;4
2981;Gilužis;Meškučių;93541096118;Taip;0;4;0;4
2982;Gilužis;Meškučių;41791785706;Ne;0;21;0;21
2983;Gilužis;Meškučių;3104707033;Ne;0;5;0;5
2984;Gilužis;Meškučių;3884351522;Ne;0;2;0;2
2985;Gilužis;Meškučių;48400196395;Taip;4;2;0;6
2986;Gilužis;Meškučių;1003733551;Taip;3;2;0;5
2987;Gilužis;Meškučių;41887832166;Taip;0;6;0;6
2988;Gilužis;Meškučių;57285847418;Taip;0;6;0;6
2989;Gilužis;Meškučių;37771334557;Taip;0;12;0;12
2990;Gilužis;Meškučių;3451034791;Ne;10;5;0;15
2991;Gilužis;Meškučių;1642252063;Taip;0;12;0;12
2992;Gilužis;Pagrandukai;6966795180;Taip;2;0;0;2
2993;Gilužis;Pagrandukai;7330938312;Taip;15;0;0;15
2994;Gilužis;Pagrandukai;6571132974;Taip;0;21;0;21
2995;Gilužis;Pagrandukai;9112993465;Taip;0;0;1;1
2996;Gilužis;Pagrandukai;5128383851;Taip;7;3;0;10
2997;Gilužis;Pagrandukai;7731169885;Taip;4;0;2;6
2998;Gilužis;Pagrandukai;1273655212;Taip;4;0;0;4
2999;Gilužis;Pagrandukai;1582241363;Taip;15;2;0;17
3000;Gilužis;Pagrandukai;8244385001;Taip;8;0;0;8
3001;Gilužis;Pagrandukai;4909329417;Taip;8;0;0;8
3002;Gilužis;Pagrandukai;4978922821;Taip;18;1;0;19
3003;Gilužis;Pagrandukai;2945406185;Taip;18;1;0;19
3004;Gilužis;Pagrandukai;7001112696;Taip;7;4;0;11
3005;Gilužis;Pagrandukai;8318405114;Taip;19;0;0;19
3006;Gilužis;Pagrandukai;6786334223;Taip;6;0;0;6
3007;Gilužis;Pagrandukai;1093643746;Taip;9;2;0;11
3008;Gilužis;Pagrandukai;6429142049;Taip;10;0;0;10
3009;Gilužis;Boružėlių;9421351780;Taip;16;0;0;16
3010;Gilužis;Boružėlių;5973671038;Taip;6;0;0;6
3011;Gilužis;Boružėlių;3399162399;Taip;6;0;0;6
3012;Gilužis;Boružėlių;4360261750;Ne;0;9;0;9
3013;Gilužis;Boružėlių;1634295583;Ne;0;9;1;10
3014;Gilužis;Boružėlių;6404411477;Taip;12;5;0;17
3015;Gilužis;Boružėlių;9186274541;Taip;19;0;0;19
3016;Gilužis;Boružėlių;6121625070;Taip;5;7;0;12
3017;Gilužis;Boružėlių;3419281756;Taip;0;7;0;7
3018;Gilužis;Boružėlių;4403218878;Taip;5;5;2;12
3019;Gilužis;Boružėlių;9097165155;Taip;16;0;0;16
3020;Gilužis;Boružėlių;1770064694;Taip;4;0;0;4
3021;Gilužis;Boružėlių;1862524255;Taip;5;4;0;9
3022;Gilužis;Boružėlių;6960673767;Taip;7;10;0;17
3023;Gilužis;Boružėlių;5728341732;Taip;3;4;1;8
3024;Gilužis;Boružėlių;4841014668;Taip;21;0;0;21
3025;Gilužis;Boružėlių;2585736095;Ne;7;0;5;12
3026;Gilužis;Boružėlių;7826015897;Taip;7;1;0;8
3027;Gintarėlis;PAPŪGĖLĖS;8498936096;Taip;4;1;0;5
3028;Gintarėlis;PAPŪGĖLĖS;8913652291;Taip;0;0;4;4
3029;Gintarėlis;PAPŪGĖLĖS;2485750596;Taip;13;4;0;17
3030;Gintarėlis;PAPŪGĖLĖS;1033624080;Ne;14;0;1;15
3031;Gintarėlis;PAPŪGĖLĖS;2919700367;Ne;9;0;0;9
3032;Gintarėlis;PAPŪGĖLĖS;1768789948;Taip;0;0;2;2
3033;Gintarėlis;PAPŪGĖLĖS;2595566032;Taip;0;1;0;1
3034;Gintarėlis;PAPŪGĖLĖS;9141438560;Taip;0;2;0;2
3035;Gintarėlis;PAPŪGĖLĖS;2235045173;Taip;9;0;1;10
3036;Gintarėlis;PAPŪGĖLĖS;9494521554;Taip;0;14;0;14
3037;Gintarėlis;PAPŪGĖLĖS;7494884360;Taip;0;12;0;12
3038;Gintarėlis;PAPŪGĖLĖS;7147842224;Taip;0;0;9;9
3039;Gintarėlis;PAPŪGĖLĖS;9648982613;Taip;0;0;5;5
3040;Gintarėlis;PAPŪGĖLĖS;5783939567;Ne;0;0;2;2
3041;Gintarėlis;PAPŪGĖLĖS;7674351459;Taip;0;5;0;5
3042;Gintarėlis;PAPŪGĖLĖS;6292664833;Taip;8;0;10;18
3043;Gintarėlis;PAPŪGĖLĖS;8610886062;Taip;0;3;1;4
3044;Gintarėlis;PAPŪGĖLĖS;5811396263;Taip;0;4;0;4
3045;Gintarėlis;PAPŪGĖLĖS;4904966263;Taip;0;5;0;5
3046;Gintarėlis;PAPŪGĖLĖS;1648843117;Ne;0;0;3;3
3047;Gintarėlis;PAPŪGĖLĖS;1861324153;Taip;0;6;0;6
3048;Gintarėlis;PAPŪGĖLĖS;3457974670;Ne;2;2;2;6
3049;Gintarėlis;PAPŪGĖLĖS;9382662838;Taip;4;0;4;8
3050;Gintarėlis;SPINDULIUKAI;96694096944;Taip;0;8;0;8
3051;Gintarėlis;SPINDULIUKAI;58118782421;Taip;0;8;0;8
3052;Gintarėlis;SPINDULIUKAI;65950042767;Taip;0;5;0;5
3053;Gintarėlis;SPINDULIUKAI;33863655816;Ne;0;6;0;6
3054;Gintarėlis;SPINDULIUKAI;11384063236;Taip;0;5;0;5
3055;Gintarėlis;SPINDULIUKAI;27532374357;Taip;2;6;0;8
3056;Gintarėlis;SPINDULIUKAI;8112379741;Ne;0;5;5;10
3057;Gintarėlis;SPINDULIUKAI;37848651606;Taip;0;6;6;12
3058;Gintarėlis;SPINDULIUKAI;56701557907;Ne;7;6;0;13
3059;Gintarėlis;SPINDULIUKAI;77140073438;Taip;4;4;2;10
3060;Gintarėlis;SPINDULIUKAI;18570638516;Taip;0;6;1;7
3061;Gintarėlis;SPINDULIUKAI;92436759875;Taip;2;5;0;7
3062;Gintarėlis;SPINDULIUKAI;1360843628;Taip;0;0;1;1
3063;Gintarėlis;SPINDULIUKAI;63037561278;Taip;0;7;0;7
3064;Gintarėlis;SPINDULIUKAI;92996401082;Taip;7;5;0;12
3065;Gintarėlis;SPINDULIUKAI;19506557567;Ne;0;5;0;5
3066;Gintarėlis;SPINDULIUKAI;24915581271;Taip;3;4;4;11
3067;Gintarėlis;SPINDULIUKAI;18222675927;Ne;0;6;0;6
3068;Gintarėlis;SPINDULIUKAI;3035023250;Taip;6;8;1;15
3069;Gintarėlis;SPINDULIUKAI;99077732058;Taip;0;4;0;4
3070;Gintarėlis;LAŠIUKAI;6893183889;Taip;0;2;9;11
3071;Gintarėlis;LAŠIUKAI;5880091191;Taip;0;2;8;10
3072;Gintarėlis;LAŠIUKAI;9584956349;Taip;19;0;0;19
3073;Gintarėlis;LAŠIUKAI;94354056029;Ne;0;5;0;5
3074;Gintarėlis;LAŠIUKAI;78359050717;Taip;7;0;0;7
3075;Gintarėlis;LAŠIUKAI;6457288028;Taip;0;5;0;5
3076;Gintarėlis;LAŠIUKAI;1002155392;Taip;14;0;0;14
3077;Gintarėlis;LAŠIUKAI;96416364735;Taip;5;6;0;11
3078;Gintarėlis;LAŠIUKAI;3504738389;Taip;0;4;1;5
3079;Gintarėlis;LAŠIUKAI;9130659549;Taip;15;0;0;15
3080;Gintarėlis;LAŠIUKAI;4660854883;Taip;0;4;0;4
3081;Gintarėlis;LAŠIUKAI;3799412062;Ne;0;4;3;7
3082;Gintarėlis;LAŠIUKAI;25210675029;Taip;0;4;2;6
3083;Gintarėlis;LAŠIUKAI;7192722296;Ne;8;1;0;9
3084;Gintarėlis;LAŠIUKAI;5024727902;Ne;0;6;0;6
3085;Gintarėlis;LAŠIUKAI;9040480798;Taip;0;4;0;4
3086;Gintarėlis;LAŠIUKAI;8055928882;Taip;0;14;0;14
3087;Gintarėlis;LAŠIUKAI;7644607132;Taip;8;4;0;12
3088;Gintarėlis;LAŠIUKAI;2088008759;Taip;2;4;0;6
3089;Gintarėlis;LAŠIUKAI;2036488789;Taip;9;0;0;9
3090;Gintarėlis;GAIDŽIUKAI;29645999843;Taip;5;6;2;13
3091;Gintarėlis;GAIDŽIUKAI;45480802894;Taip;7;2;1;10
3092;Gintarėlis;GAIDŽIUKAI;1539226211;Taip;0;16;0;16
3093;Gintarėlis;GAIDŽIUKAI;2043878016;Taip;0;4;0;4
3094;Gintarėlis;GAIDŽIUKAI;90891401453;Taip;0;2;0;2
3095;Gintarėlis;GAIDŽIUKAI;1770479969;Taip;3;6;0;9
3096;Gintarėlis;GAIDŽIUKAI;53971205498;Taip;0;6;2;8
3097;Gintarėlis;GAIDŽIUKAI;1441282039;Taip;16;0;0;16
3098;Gintarėlis;GAIDŽIUKAI;5835437020;Ne;11;2;3;16
3099;Gintarėlis;GAIDŽIUKAI;77591601744;Taip;8;2;0;10
3100;Gintarėlis;GAIDŽIUKAI;1076400051;Taip;0;8;0;8
3101;Gintarėlis;GAIDŽIUKAI;4660581415;Taip;0;2;0;2
3102;Gintarėlis;GAIDŽIUKAI;3794027499;Taip;15;0;0;15
3103;Gintarėlis;GAIDŽIUKAI;1327681704;Taip;4;2;0;6
3104;Gintarėlis;GAIDŽIUKAI;9234476307;Taip;5;2;0;7
3105;Gintarėlis;GAIDŽIUKAI;8206947475;Taip;0;0;4;4
3106;Gintarėlis;GAIDŽIUKAI;5916948150;Ne;0;2;0;2
3107;Gintarėlis;GAIDŽIUKAI;2203238888;Taip;0;1;0;1
3108;Gintarėlis;MEŠKUČIAI;8860898577;Taip;0;1;0;1
3109;Gintarėlis;MEŠKUČIAI;84375225995;Taip;0;4;0;4
3110;Gintarėlis;MEŠKUČIAI;1230510614;Taip;0;2;0;2
3111;Gintarėlis;MEŠKUČIAI;33786299764;Taip;0;6;0;6
3112;Gintarėlis;MEŠKUČIAI;33714823189;Taip;0;1;0;1
3113;Gintarėlis;MEŠKUČIAI;12332079305;Taip;0;4;0;4
3114;Gintarėlis;MEŠKUČIAI;86948612054;Taip;0;6;0;6
3115;Gintarėlis;MEŠKUČIAI;28514742083;Taip;0;12;0;12
3116;Gintarėlis;MEŠKUČIAI;8518137062;Taip;0;5;0;5
3117;Gintarėlis;MEŠKUČIAI;25360163411;Taip;0;11;0;11
3118;Gintarėlis;MEŠKUČIAI;1943647795;Ne;0;14;0;14
3119;Gintarėlis;MEŠKUČIAI;77802363719;Taip;0;4;0;4
3120;Gintarėlis;MEŠKUČIAI;61739452519;Taip;0;2;0;2
3121;Gintarėlis;MEŠKUČIAI;2529363136;Taip;3;3;0;6
3122;Gintarėlis;MEŠKUČIAI;10771368524;Taip;0;6;0;6
3123;Gintarėlis;MEŠKUČIAI;47480197789;Ne;0;11;0;11
3124;Gintarėlis;MEŠKUČIAI;36019373990;Ne;0;6;0;6
3125;Gintarėlis;MEŠKUČIAI;76302896259;Taip;0;6;2;8
3126;Gintarėlis;DRUGELIAI;2127877544;Ne;9;0;0;9
3127;Gintarėlis;DRUGELIAI;14840692502;Ne;0;12;0;12
3128;Gintarėlis;DRUGELIAI;1462949250;Ne;19;0;0;19
3129;Gintarėlis;DRUGELIAI;9737200226;Taip;0;2;2;4
3130;Gintarėlis;DRUGELIAI;6655809299;Taip;2;4;4;10
3131;Gintarėlis;DRUGELIAI;2614258442;Taip;1;13;0;14
3132;Gintarėlis;DRUGELIAI;1452402931;Ne;7;1;0;8
3133;Gintarėlis;DRUGELIAI;4217329880;Ne;3;5;0;8
3134;Gintarėlis;DRUGELIAI;1759217543;Taip;7;2;0;9
3135;Gintarėlis;DRUGELIAI;7571352126;Taip;0;6;1;7
3136;Gintarėlis;DRUGELIAI;50896429585;Taip;0;5;0;5
3137;Gintarėlis;DRUGELIAI;1042222561;Taip;7;3;0;10
3138;Gintarėlis;DRUGELIAI;1331684725;Ne;0;3;0;3
3139;Gintarėlis;DRUGELIAI;9687974376;Taip;6;3;6;15
3140;Gintarėlis;DRUGELIAI;8704248985;Taip;8;5;0;13
3141;Gintarėlis;DRUGELIAI;8419453060;Taip;0;2;2;4
3142;Gintarėlis;DRUGELIAI;6655645997;Taip;16;2;0;18
3143;Gintarėlis;DRUGELIAI;6080108998;Taip;16;2;0;18
3144;Gintarėlis;DRUGELIAI;7449437199;Taip;4;5;0;9
3145;Gintarėlis;DRUGELIAI;4076421692;Ne;9;2;2;13
3146;Gintarėlis;DRUGELIAI;2016067859;Taip;4;0;1;5
3147;Gintarėlis;DRUGELIAI;5355691986;Taip;3;11;0;14
3148;Gintarėlis;DRUGELIAI;8116557698;Taip;0;6;0;6
3149;Gintarėlis;DRUGELIAI;6898320582;Ne;0;4;0;4
3150;Gintarėlis;KAČIUKAI;5451653510;Taip;2;0;0;2
3151;Gintarėlis;KAČIUKAI;9903314418;Taip;0;3;0;3
3152;Gintarėlis;KAČIUKAI;63243392161;Taip;0;5;0;5
3153;Gintarėlis;KAČIUKAI;37612987791;Taip;0;4;0;4
3154;Gintarėlis;KAČIUKAI;26259581924;Taip;0;9;0;9
3155;Gintarėlis;KAČIUKAI;70787488885;Ne;0;6;3;9
3156;Gintarėlis;KAČIUKAI;31365533022;Ne;0;5;3;8
3157;Gintarėlis;KAČIUKAI;50715082496;Taip;0;3;3;6
3158;Gintarėlis;KAČIUKAI;1159773367;Taip;0;8;0;8
3159;Gintarėlis;KAČIUKAI;2050020230;Taip;0;8;0;8
3160;Gintarėlis;KAČIUKAI;54145290842;Taip;0;0;14;14
3161;Gintarėlis;KAČIUKAI;19813827223;Ne;6;0;0;6
3162;Gintarėlis;KAČIUKAI;98684742007;Ne;17;0;4;21
3163;Gintarėlis;KAČIUKAI;6421537455;Ne;9;0;3;12
3164;Gintarėlis;KAČIUKAI;1595816431;Taip;0;7;0;7
3165;Gintarėlis;KAČIUKAI;30446888177;Taip;7;0;0;7
3166;Gintarėlis;KAČIUKAI;63221497564;Taip;0;9;0;9
3167;Gintarėlis;KAČIUKAI;81135362098;Taip;0;0;2;2
3168;Gintarėlis;KAČIUKAI;58701768194;Taip;0;6;0;6
3169;Gintarėlis;KAČIUKAI;29480359781;Ne;8;0;6;14
3170;Gintarėlis;KAČIUKAI;7610677403;Ne;5;2;1;8
3171;Gintarėlis;KIŠKUČIAI;8665467175;Taip;13;1;0;14
3172;Gintarėlis;KIŠKUČIAI;1839619421;Taip;0;2;0;2
3173;Gintarėlis;KIŠKUČIAI;83754732536;Taip;3;4;0;7
3174;Gintarėlis;KIŠKUČIAI;89051269756;Ne;0;6;1;7
3175;Gintarėlis;KIŠKUČIAI;1642627920;Taip;0;0;1;1
3176;Gintarėlis;KIŠKUČIAI;1593455162;Taip;10;9;0;19
3177;Gintarėlis;KIŠKUČIAI;2043405414;Taip;0;12;0;12
3178;Gintarėlis;KIŠKUČIAI;3828845515;Taip;2;10;0;12
3179;Gintarėlis;KIŠKUČIAI;1069395570;Taip;0;4;0;4
3180;Gintarėlis;KIŠKUČIAI;1110150536;Taip;2;4;0;6
3181;Gintarėlis;KIŠKUČIAI;19402011412;Taip;0;5;0;5
3182;Gintarėlis;KIŠKUČIAI;96211766919;Taip;0;5;0;5
3183;Gintarėlis;KIŠKUČIAI;78697777550;Taip;0;0;2;2
3184;Gintarėlis;KIŠKUČIAI;85557344192;Taip;6;6;1;13
3185;Gintarėlis;KIŠKUČIAI;2970527490;Ne;5;1;0;6
3186;Gintarėlis;KIŠKUČIAI;4279681763;Taip;8;2;0;10
3187;Gintarėlis;KIŠKUČIAI;2032900352;Taip;6;4;1;11
3188;Gintarėlis;KIŠKUČIAI;3292572563;Taip;11;6;0;17
3189;Gintarėlis;KIŠKUČIAI;1543013649;Taip;0;2;2;4
3190;Gintarėlis;KIŠKUČIAI;24774460882;Ne;0;1;0;1
3191;Gintarėlis;KIŠKUČIAI;1028456578;Taip;0;2;1;3
3192;Gintarėlis;VYTURIUKAI;1553747935;Taip;0;14;0;14
3193;Gintarėlis;VYTURIUKAI;22394648690;Taip;0;6;0;6
3194;Gintarėlis;VYTURIUKAI;4902086873;Taip;9;0;1;10
3195;Gintarėlis;VYTURIUKAI;56124970238;Taip;0;6;0;6
3196;Gintarėlis;VYTURIUKAI;34606130829;Taip;0;7;0;7
3197;Gintarėlis;VYTURIUKAI;21658913551;Ne;14;1;0;15
3198;Gintarėlis;VYTURIUKAI;18715625324;Ne;5;2;1;8
3199;Gintarėlis;VYTURIUKAI;1191846491;Taip;2;3;0;5
3200;Gintarėlis;VYTURIUKAI;9740239182;Taip;0;0;4;4
3201;Gintarėlis;VYTURIUKAI;8405210216;Ne;4;0;2;6
3202;Gintarėlis;VYTURIUKAI;2721386855;Taip;4;0;2;6
3203;Gintarėlis;BORUŽĖLĖS;4971574875;Taip;2;4;0;6
3204;Gintarėlis;BORUŽĖLĖS;6277010268;Taip;15;0;0;15
3205;Gintarėlis;BORUŽĖLĖS;1771868868;Ne;0;15;0;15
3206;Gintarėlis;BORUŽĖLĖS;39372328122;Taip;0;5;0;5
3207;Gintarėlis;BORUŽĖLĖS;25451522701;Taip;5;6;0;11
3208;Gintarėlis;BORUŽĖLĖS;90216120878;Taip;0;20;0;20
3209;Gintarėlis;BORUŽĖLĖS;1929900615;Taip;0;9;0;9
3210;Gintarėlis;BORUŽĖLĖS;82344200095;Taip;0;1;0;1
3211;Gintarėlis;BORUŽĖLĖS;1168158494;Taip;2;7;0;9
3212;Gintarėlis;BORUŽĖLĖS;9255623049;Taip;0;16;0;16
3213;Gintarėlis;BORUŽĖLĖS;88451515187;Taip;0;9;0;9
3214;Gintarėlis;BORUŽĖLĖS;7703150488;Taip;7;0;0;7
3215;Gintarėlis;BORUŽĖLĖS;2145479870;Taip;5;5;0;10
3216;Gintarėlis;BORUŽĖLĖS;49506158711;Taip;2;8;2;12
3217;Gintarėlis;BORUŽĖLĖS;30066476338;Ne;0;7;0;7
3218;Gintarėlis;BORUŽĖLĖS;63146841406;Taip;0;0;21;21
3219;Gintarėlis;BORUŽĖLĖS;30334064319;Taip;9;2;0;11
3220;Gintarėlis;BORUŽĖLĖS;6426075546;Taip;0;3;0;3
3221;Gintarėlis;BORUŽĖLĖS;91798408335;Taip;0;7;0;7
3222;Gintarėlis;BORUŽĖLĖS;25684002087;Taip;0;10;0;10
3223;Gintarėlis;BORUŽĖLĖS;10826255781;Taip;0;2;9;11
3224;Gintarėlis;BORUŽĖLĖS;1505703905;Taip;0;12;0;12
3225;Gintarėlis;EŽIUKAI;1793785936;Taip;21;0;0;21
3226;Gintarėlis;EŽIUKAI;5464804183;Taip;9;0;0;9
3227;Gintarėlis;EŽIUKAI;1856031326;Taip;14;0;0;14
3228;Gintarėlis;EŽIUKAI;27890184523;Taip;6;9;0;15
3229;Gintarėlis;EŽIUKAI;1841482183;Taip;0;2;0;2
3230;Gintarėlis;EŽIUKAI;8074941282;Taip;0;7;1;8
3231;Gintarėlis;EŽIUKAI;2040989572;Taip;17;4;0;21
3232;Gintarėlis;EŽIUKAI;18008015227;Taip;0;5;0;5
3233;Gintarėlis;EŽIUKAI;1312688961;Taip;5;0;0;5
3234;Gintarėlis;EŽIUKAI;1672037617;Taip;0;4;0;4
3235;Gintarėlis;EŽIUKAI;51418692259;Taip;0;3;0;3
3236;Gintarėlis;EŽIUKAI;1398810524;Taip;5;4;0;9
3237;Gintarėlis;EŽIUKAI;74295947670;Taip;0;5;0;5
3238;Gintarėlis;EŽIUKAI;52644122529;Taip;0;4;0;4
3239;Gintarėlis;EŽIUKAI;2732338838;Taip;3;8;0;11
3240;Gintarėlis;EŽIUKAI;83686073097;Taip;7;0;0;7
3241;Gintarėlis;EŽIUKAI;7731823367;Taip;0;5;0;5
3242;Gintarėlis;EŽIUKAI;7053099543;Taip;0;4;1;5
3243;Gintarėlis;EŽIUKAI;56834651967;Taip;11;10;0;21
3244;Gintarėlis;EŽIUKAI;9705808868;Ne;4;2;0;6
3245;Gintarėlis;EŽIUKAI;13416505188;Taip;2;4;0;6
3246;Gintarėlis;EŽIUKAI;36350623756;Taip;0;4;3;7
3247;Gintarėlis;EŽIUKAI;96404879029;Taip;0;8;0;8
3248;Gintarėlis;EŽIUKAI;1725007540;Ne;0;4;0;4
3249;Gintarėlis;VIŠČIUKAI;5436695400;Ne;0;2;10;12
3250;Gintarėlis;VIŠČIUKAI;5921751507;Taip;10;0;0;10
3251;Gintarėlis;VIŠČIUKAI;2212296954;Taip;0;0;5;5
3252;Gintarėlis;VIŠČIUKAI;9963329170;Taip;0;6;2;8
3253;Gintarėlis;VIŠČIUKAI;5569843168;Taip;1;6;0;7
3254;Gintarėlis;VIŠČIUKAI;3665764153;Taip;4;2;3;9
3255;Gintarėlis;VIŠČIUKAI;9774056578;Taip;0;2;7;9
3256;Gintarėlis;VIŠČIUKAI;3825700024;Taip;6;3;0;9
3257;Gintarėlis;VIŠČIUKAI;7057877483;Taip;6;3;0;9
3258;Gintarėlis;VIŠČIUKAI;7875981690;Taip;0;14;0;14
3259;Gintarėlis;VIŠČIUKAI;2544338275;Taip;0;14;0;14
3260;Gintarėlis;VIŠČIUKAI;7182964126;Taip;4;3;0;7
3261;Gintarėlis;VIŠČIUKAI;4754929282;Taip;4;3;0;7
3262;Gintarėlis;VIŠČIUKAI;1011749698;Taip;6;6;2;14
3263;Gintarėlis;VIŠČIUKAI;8261770154;Taip;0;13;0;13
3264;Gintarėlis;VIŠČIUKAI;8547544537;Taip;16;0;0;16
3265;Gintarėlis;VIŠČIUKAI;4976069028;Taip;11;0;0;11
3266;Gintarėlis;VIŠČIUKAI;8375475174;Taip;15;1;0;16
3267;Gintarėlis;VIŠČIUKAI;9450900915;Taip;5;0;4;9
3268;Gintarėlis;VIŠČIUKAI;7061545258;Taip;13;3;0;16
3269;Gintarėlis;VIŠČIUKAI;9825811100;Taip;6;4;1;11
3270;Gintarėlis;"SAULĖS ZUIKUČIAI";8287685690;Taip;0;12;0;12
3271;Gintarėlis;"SAULĖS ZUIKUČIAI";6914904213;Taip;17;0;1;18
3272;Gintarėlis;"SAULĖS ZUIKUČIAI";1696337909;Taip;18;0;0;18
3273;Gintarėlis;"SAULĖS ZUIKUČIAI";1778573935;Taip;2;6;0;8
3274;Gintarėlis;"SAULĖS ZUIKUČIAI";5796729245;Taip;5;9;0;14
3275;Gintarėlis;"SAULĖS ZUIKUČIAI";9915887420;Taip;5;9;0;14
3276;Gintarėlis;"SAULĖS ZUIKUČIAI";3398936974;Ne;9;0;1;10
3277;Gintarėlis;"SAULĖS ZUIKUČIAI";5153948767;Taip;7;7;0;14
3278;Gintarėlis;"SAULĖS ZUIKUČIAI";9675201979;Taip;9;0;3;12
3279;Gintarėlis;"SAULĖS ZUIKUČIAI";7971810025;Ne;21;0;0;21
3280;Gintarėlis;"SAULĖS ZUIKUČIAI";2814569415;Ne;0;7;0;7
3281;Gintarėlis;"SAULĖS ZUIKUČIAI";6862629244;Ne;21;0;0;21
3282;Gintarėlis;"SAULĖS ZUIKUČIAI";9279399214;Taip;13;1;0;14
3283;Gintarėlis;"SAULĖS ZUIKUČIAI";8000297636;Taip;14;0;7;21
3284;Gintarėlis;"SAULĖS ZUIKUČIAI";6142819210;Taip;4;0;0;4
3285;Gintarėlis;"SAULĖS ZUIKUČIAI";7815317644;Taip;0;0;8;8
3286;Gintarėlis;"SAULĖS ZUIKUČIAI";3814485627;Taip;0;14;0;14
3287;Gintarėlis;"SAULĖS ZUIKUČIAI";3921015919;Taip;13;0;0;13
3288;Gintarėlis;"SAULĖS ZUIKUČIAI";2165332442;Taip;6;2;0;8
3289;Gintarėlis;"SAULĖS ZUIKUČIAI";5919205817;Taip;4;0;0;4
3290;Gintarėlis;"SAULĖS ZUIKUČIAI";1571260478;Ne;12;0;9;21
3291;Giraitė;Aviliukas;67009533810;Taip;0;0;3;3
3292;Giraitė;Aviliukas;62525988158;Taip;13;1;0;14
3293;Giraitė;Aviliukas;68804588518;Taip;13;7;0;20
3294;Giraitė;Aviliukas;809734624;Taip;4;5;0;9
3295;Giraitė;Aviliukas;44396075745;Ne;3;0;0;3
3296;Giraitė;Aviliukas;42330865487;Taip;5;1;0;6
3297;Giraitė;Aviliukas;34957067197;Taip;0;4;0;4
3298;Giraitė;Aviliukas;39627499338;Taip;7;1;1;9
3299;Giraitė;Aviliukas;86412433313;Ne;0;0;5;5
3300;Giraitė;Aviliukas;10778161174;Taip;0;7;0;7
3301;Giraitė;Aviliukas;94618756885;Taip;0;4;3;7
3302;Giraitė;Aviliukas;6449275481;Taip;7;0;9;16
3303;Giraitė;Aviliukas;37348466498;Taip;0;0;2;2
3304;Giraitė;Aviliukas;12568042778;Taip;0;0;1;1
3305;Giraitė;Aviliukas;45633008605;Taip;6;1;3;10
3306;Giraitė;Aviliukas;32804353567;Taip;0;0;3;3
3307;Giraitė;Aviliukas;24903085449;Taip;0;19;0;19
3308;Giraitė;Aviliukas;7868564343;Taip;11;2;0;13
3309;Giraitė;Aviliukas;5038998112;Ne;5;0;9;14
3310;Giraitė;Aviliukas;8423424896;Taip;0;7;0;7
3311;Giraitė;LapiukaI;6141730004;Taip;6;0;1;7
3312;Giraitė;LapiukaI;6325909670;Taip;13;0;0;13
3313;Giraitė;LapiukaI;7831526566;Taip;4;0;0;4
3314;Giraitė;LapiukaI;2740656695;Taip;0;0;6;6
3315;Giraitė;LapiukaI;5030697729;Taip;0;4;0;4
3316;Giraitė;LapiukaI;1921430434;Ne;21;0;0;21
3317;Giraitė;LapiukaI;5006156109;Taip;4;1;0;5
3318;Giraitė;LapiukaI;2393713210;Taip;3;0;4;7
3319;Giraitė;LapiukaI;4663343304;Ne;7;0;0;7
3320;Giraitė;LapiukaI;5382004098;Taip;12;0;0;12
3321;Giraitė;LapiukaI;9768754737;Ne;8;0;2;10
3322;Giraitė;LapiukaI;4296449093;Taip;0;5;0;5
3323;Giraitė;LapiukaI;1974159110;Taip;8;5;3;16
3324;Giraitė;LapiukaI;7428833348;Taip;0;1;2;3
3325;Giraitė;LapiukaI;8376809208;Taip;11;0;0;11
3326;Giraitė;LapiukaI;5532639133;Taip;2;8;0;10
3327;Giraitė;LapiukaI;4076402180;Taip;4;3;0;7
3328;Giraitė;LapiukaI;5902161665;Taip;15;0;0;15
3329;Giraitė;LapiukaI;4955786826;Taip;0;4;0;4
3330;Giraitė;LapiukaI;4260343903;Taip;10;0;3;13
3331;Giraitė;Voveriukai;7354834895;Taip;14;0;0;14
3332;Giraitė;Voveriukai;4387282125;Taip;10;4;0;14
3333;Giraitė;Voveriukai;2699984170;Taip;3;8;0;11
3334;Giraitė;Voveriukai;6265908751;Taip;0;4;0;4
3335;Giraitė;Voveriukai;4822168634;Taip;7;0;0;7
3336;Giraitė;Voveriukai;2074303013;Taip;2;7;0;9
3337;Giraitė;Voveriukai;6963656869;Ne;8;1;0;9
3338;Giraitė;Voveriukai;2088867630;Taip;2;0;0;2
3339;Giraitė;Voveriukai;3875214088;Taip;6;5;0;11
3340;Giraitė;Voveriukai;5202562049;Ne;5;0;2;7
3341;Giraitė;Voveriukai;7441871219;Taip;0;4;3;7
3342;Giraitė;Voveriukai;7481895278;Taip;7;9;0;16
3343;Giraitė;Voveriukai;3607198556;Taip;2;6;0;8
3344;Giraitė;Voveriukai;1945918102;Ne;2;0;0;2
3345;Giraitė;Voveriukai;8799195526;Taip;7;0;1;8
3346;Giraitė;Voveriukai;6225092500;Taip;10;0;0;10
3347;Giraitė;Voveriukai;4137699629;Taip;7;0;0;7
3348;Giraitė;Voveriukai;4932174149;Taip;14;0;0;14
3349;Giraitė;Voveriukai;3896789232;Taip;0;0;2;2
3350;Giraitė;Voveriukai;7919088987;Taip;4;6;0;10
3351;Giraitė;Voveriukai;5616242311;Taip;4;0;7;11
3352;Giraitė;Voveriukai;7739516049;Taip;9;0;1;10
3353;Giraitė;Grybukai;61477798910;Ne;2;2;0;4
3354;Giraitė;Grybukai;83995022535;Taip;2;4;2;8
3355;Giraitė;Grybukai;70668076883;Taip;0;9;1;10
3356;Giraitė;Grybukai;482311593;Taip;17;4;0;21
3357;Giraitė;Grybukai;34413917793;Taip;0;8;0;8
3358;Giraitė;Grybukai;1313395982;Ne;0;9;0;9
3359;Giraitė;Grybukai;62684217934;Taip;0;0;1;1
3360;Giraitė;Grybukai;19218675078;Taip;7;8;0;15
3361;Giraitė;Grybukai;20082610200;Ne;0;6;0;6
3362;Giraitė;Grybukai;2816941652;Ne;0;4;0;4
3363;Giraitė;Grybukai;98106730833;Taip;5;4;3;12
3364;Giraitė;Grybukai;10070775660;Taip;0;9;1;10
3365;Giraitė;Grybukai;10108398683;Taip;0;6;3;9
3366;Giraitė;Grybukai;6159111262;Taip;0;1;0;1
3367;Giraitė;Grybukai;5824936903;Taip;3;5;0;8
3368;Giraitė;Grybukai;1458304464;Taip;2;4;0;6
3369;Giraitė;Grybukai;68502311448;Taip;0;6;0;6
3370;Giraitė;Grybukai;2107606245;Taip;0;5;0;5
3371;Giraitė;Grybukai;1965752607;Taip;4;4;7;15
3372;Giraitė;Grybukai;48623826572;Taip;9;0;0;9
3373;Giraitė;Grybukai;70629522964;Ne;17;4;0;21
3374;Giraitė;Riešutėliai;3683700626;Taip;1;1;0;2
3375;Giraitė;Riešutėliai;8596389737;Taip;0;5;6;11
3376;Giraitė;Riešutėliai;5167002022;Taip;11;0;0;11
3377;Giraitė;Riešutėliai;9495968363;Taip;8;4;0;12
3378;Giraitė;Riešutėliai;1253151830;Taip;8;4;0;12
3379;Giraitė;Riešutėliai;5892950503;Taip;0;1;0;1
3380;Giraitė;Riešutėliai;4336519836;Taip;8;0;3;11
3381;Giraitė;Riešutėliai;9026736929;Taip;7;0;0;7
3382;Giraitė;Riešutėliai;9882372025;Taip;10;0;1;11
3383;Giraitė;Riešutėliai;5721669627;Taip;9;0;4;13
3384;Giraitė;Riešutėliai;5029839281;Ne;0;5;0;5
3385;Giraitė;Riešutėliai;23319979302;Taip;1;1;2;4
3386;Giraitė;Riešutėliai;4785524898;Taip;0;7;0;7
3387;Giraitė;Riešutėliai;8869728241;Taip;4;0;0;4
3388;Giraitė;Riešutėliai;4839351300;Taip;2;7;0;9
3389;Giraitė;Riešutėliai;1817075429;Taip;7;0;4;11
3390;Giraitė;Riešutėliai;6836412890;Taip;10;0;0;10
3391;Giraitė;Riešutėliai;9224845723;Taip;0;1;0;1
3392;Giraitė;Riešutėliai;4687228561;Taip;11;0;0;11
3393;Giraitė;Riešutėliai;9652807467;Taip;5;0;0;5
3394;Giraitė;Meškiukai;27501094616;Taip;5;4;0;9
3395;Giraitė;Meškiukai;2513312448;Taip;5;2;0;7
3396;Giraitė;Meškiukai;5367392810;Taip;4;8;0;12
3397;Giraitė;Meškiukai;1608876140;Taip;5;1;0;6
3398;Giraitė;Meškiukai;5461837332;Taip;5;0;4;9
3399;Giraitė;Meškiukai;1355594003;Taip;6;2;0;8
3400;Giraitė;Meškiukai;1560868105;Taip;7;1;0;8
3401;Giraitė;Meškiukai;1050699551;Taip;11;0;1;12
3402;Giraitė;Meškiukai;1876815077;Ne;4;0;0;4
3403;Giraitė;Meškiukai;1063628206;Taip;2;4;0;6
3404;Giraitė;Meškiukai;1318214394;Taip;5;0;0;5
3405;Giraitė;Meškiukai;1846118720;Taip;7;0;1;8
3406;Giraitė;Meškiukai;9195735923;Taip;4;0;2;6
3407;Giraitė;Meškiukai;65251975467;Taip;0;4;0;4
3408;Giraitė;Meškiukai;1704154980;Taip;14;0;0;14
3409;Giraitė;Meškiukai;1819657811;Taip;10;0;0;10
3410;Giraitė;Meškiukai;2571892050;Taip;7;0;0;7
3411;Giraitė;Meškiukai;6156715234;Taip;0;5;6;11
3412;Giraitė;Meškiukai;1594965200;Ne;7;0;1;8
3413;Giraitė;Meškiukai;9723242940;Taip;8;6;0;14
3414;Giraitė;Meškiukai;5726182600;Taip;14;0;2;16
3415;Giraitė;Meškiukai;1772790396;Ne;9;0;0;9
3416;Giraitė;Uogelės;37225101302;Taip;4;0;0;4
3417;Giraitė;Uogelės;3031181239;Taip;0;9;0;9
3418;Giraitė;Uogelės;99494458394;Taip;3;3;0;6
3419;Giraitė;Uogelės;1103462199;Taip;11;5;0;16
3420;Giraitė;Uogelės;1447893912;Taip;0;4;0;4
3421;Giraitė;Uogelės;49193108666;Ne;0;4;0;4
3422;Giraitė;Uogelės;31110630088;Taip;0;1;0;1
3423;Giraitė;Uogelės;1312761239;Taip;0;2;0;2
3424;Giraitė;Uogelės;43475840493;Taip;3;4;0;7
3425;Giraitė;Uogelės;30804922053;Taip;7;9;0;16
3426;Giraitė;Uogelės;2083472940;Taip;8;0;0;8
3427;Giraitė;Uogelės;1848908894;Taip;0;4;0;4
3428;Giraitė;Uogelės;99146206772;Taip;0;0;1;1
3429;Giraitė;Uogelės;5378240128;Taip;0;8;0;8
3430;Giraitė;Uogelės;43468579365;Taip;0;4;0;4
3431;Giraitė;Uogelės;74256775397;Ne;3;7;0;10
3432;Giraitė;Uogelės;65392345188;Taip;2;6;0;8
3433;Giraitė;Uogelės;7779733510;Taip;9;4;2;15
3434;Giraitė;Uogelės;8824642760;Taip;3;0;4;7
3435;Giraitė;Uogelės;1110792632;Taip;0;7;0;7
3436;Giraitė;Uogelės;8590987283;Taip;0;0;1;1
3437;Giraitė;Šaltinėlis;66760677758;Taip;2;4;0;6
3438;Giraitė;Šaltinėlis;33507817372;Taip;0;4;0;4
3439;Giraitė;Šaltinėlis;94197982724;Taip;0;6;0;6
3440;Giraitė;Šaltinėlis;22783526738;Taip;0;2;0;2
3441;Giraitė;Šaltinėlis;79459838218;Taip;3;4;0;7
3442;Giraitė;Šaltinėlis;1690407683;Taip;0;4;0;4
3443;Giraitė;Šaltinėlis;89948210310;Taip;7;8;0;15
3444;Giraitė;Šaltinėlis;26202357668;Taip;0;14;0;14
3445;Giraitė;Šaltinėlis;260305509;Taip;0;5;1;6
3446;Giraitė;Šaltinėlis;8986196352;Ne;0;4;0;4
3447;Giraitė;Šaltinėlis;9710265790;Taip;0;4;0;4
3448;Giraitė;Šaltinėlis;9493194946;Taip;2;4;0;6
3449;Giraitė;Šaltinėlis;17883856522;Taip;5;7;0;12
3450;Giraitė;Šaltinėlis;84373081236;Taip;0;1;0;1
3451;Giraitė;Šaltinėlis;1285310492;Taip;0;1;0;1
3452;Giraitė;Šaltinėlis;42953220489;Ne;0;3;0;3
3453;Giraitė;Šaltinėlis;1424661991;Taip;3;5;0;8
3454;Giraitė;Šaltinėlis;1284187551;Taip;0;7;0;7
3455;Giraitė;Šaltinėlis;1533533163;Taip;3;2;0;5
3456;Giraitė;Šaltinėlis;1816297607;Taip;0;5;1;6
3457;Giraitė;Boružėlės;5471577047;Taip;2;9;0;11
3458;Giraitė;Boružėlės;2307307454;Taip;19;0;0;19
3459;Giraitė;Boružėlės;9931533006;Taip;0;0;1;1
3460;Giraitė;Boružėlės;2102237550;Ne;8;0;0;8
3461;Giraitė;Boružėlės;1729871315;Taip;4;0;0;4
3462;Giraitė;Boružėlės;4121361794;Taip;11;0;0;11
3463;Giraitė;Boružėlės;6065010363;Taip;0;7;0;7
3464;Giraitė;Boružėlės;4317544803;Taip;10;0;0;10
3465;Giraitė;Boružėlės;5255040944;Taip;13;0;0;13
3466;Giraitė;Boružėlės;4843415587;Ne;11;3;0;14
3467;Giraitė;Boružėlės;2732715332;Taip;4;1;0;5
3468;Giraitė;Boružėlės;9927102264;Taip;12;0;0;12
3469;Giraitė;Boružėlės;7931998640;Taip;0;1;0;1
3470;Giraitė;Boružėlės;8908602761;Taip;5;4;0;9
3471;Giraitė;Boružėlės;4717851198;Taip;4;0;0;4
3472;Giraitė;Gandriukai;69883334049;Taip;5;4;4;13
3473;Giraitė;Gandriukai;1025627643;Taip;4;0;2;6
3474;Giraitė;Gandriukai;7547897354;Taip;0;0;2;2
3475;Giraitė;Gandriukai;26032013284;Taip;2;0;0;2
3476;Giraitė;Gandriukai;36650870278;Taip;7;4;0;11
3477;Giraitė;Gandriukai;82915040164;Taip;2;0;0;2
3478;Giraitė;Gandriukai;18968645937;Taip;0;0;3;3
3479;Giraitė;Gandriukai;64357457379;Taip;1;0;0;1
3480;Giraitė;Gandriukai;1022899992;Ne;0;0;1;1
3481;Giraitė;Gandriukai;1238299747;Ne;4;0;0;4
3482;Giraitė;Gandriukai;1054132082;Taip;2;0;0;2
3483;Giraitė;Gandriukai;8941330547;Taip;2;6;0;8
3484;Giraitė;Gandriukai;1111614295;Taip;5;3;3;11
3485;Giraitė;Gandriukai;9918028862;Taip;15;0;0;15
3486;Giraitė;Gandriukai;4031993742;Taip;1;0;3;4
3487;Giraitė;Gandriukai;2190246729;Ne;2;7;0;9
3488;Giraitė;Gandriukai;5810648237;Taip;13;0;2;15
3489;Giraitė;Gandriukai;5862292995;Taip;4;0;0;4
3490;Giraitė;Gandriukai;1375377927;Ne;13;0;1;14
3491;Giraitė;ŽVIRBLIUKAI;4444292550;Ne;5;0;1;6
3492;Giraitė;ŽVIRBLIUKAI;1958553421;Taip;0;0;3;3
3493;Giraitė;ŽVIRBLIUKAI;77765768952;Taip;3;4;1;8
3494;Giraitė;ŽVIRBLIUKAI;56380808064;Taip;0;12;0;12
3495;Giraitė;ŽVIRBLIUKAI;1181578380;Ne;12;1;0;13
3496;Giraitė;ŽVIRBLIUKAI;1547711379;Taip;4;4;0;8
3497;Giraitė;ŽVIRBLIUKAI;1641872824;Taip;0;1;0;1
3498;Giraitė;ŽVIRBLIUKAI;1234136698;Taip;6;0;0;6
3499;Giraitė;ŽVIRBLIUKAI;2065944230;Taip;5;0;0;5
3500;Giraitė;ŽVIRBLIUKAI;1464444782;Taip;5;0;3;8
3501;Giraitė;ŽVIRBLIUKAI;1435017557;Taip;19;0;0;19
3502;Giraitė;ŽVIRBLIUKAI;1149254911;Taip;3;0;0;3
3503;Giraitė;ŽVIRBLIUKAI;3628448974;Ne;14;1;0;15
3504;Giraitė;ŽVIRBLIUKAI;8020051188;Taip;2;3;0;5
3505;Giraitė;ŽVIRBLIUKAI;6197641912;Taip;4;0;1;5
3506;Giraitė;ŽVIRBLIUKAI;6973378079;Taip;2;4;0;6
3507;Giraitė;ŽVIRBLIUKAI;8000958461;Taip;16;0;2;18
3508;Giraitė;ŽVIRBLIUKAI;6233020671;Taip;1;0;3;4
3509;Giraitė;ŽVIRBLIUKAI;2990968206;Taip;0;1;0;1
3510;Giraitė;Kiškeliai;7551981095;Taip;5;0;0;5
3511;Giraitė;Kiškeliai;1583733838;Taip;0;1;0;1
3512;Giraitė;Kiškeliai;4009092043;Taip;5;0;0;5
3513;Giraitė;Kiškeliai;9728453316;Ne;0;0;1;1
3514;Giraitė;Kiškeliai;9392127689;Taip;16;0;0;16
3515;Giraitė;Kiškeliai;6677278422;Taip;21;0;0;21
3516;Giraitė;Kiškeliai;8461725999;Taip;4;0;4;8
3517;Giraitė;Kiškeliai;5086296808;Taip;0;5;4;9
3518;Giraitė;Kiškeliai;7395332578;Taip;17;0;0;17
3519;Giraitė;Kiškeliai;9471560738;Taip;4;0;0;4
3520;Giraitė;Kiškeliai;7230351549;Taip;5;12;0;17
3521;Giraitė;Kiškeliai;9114364139;Taip;13;0;0;13
3522;Giraitė;Kiškeliai;7678134658;Taip;0;0;2;2
3523;Giraitė;Kiškeliai;8873231715;Taip;9;0;3;12
3524;Giraitė;Kiškeliai;2416162886;Taip;21;0;0;21
3525;Gudrutis;Gandriukų;6742455931;Ne;0;0;4;4
3526;Gudrutis;Gandriukų;4193661251;Ne;16;0;0;16
3527;Gudrutis;Gandriukų;2396379813;Ne;0;0;10;10
3528;Gudrutis;Gandriukų;9042793284;Taip;0;4;1;5
3529;Gudrutis;Gandriukų;3888849808;Taip;0;14;0;14
3530;Gudrutis;Gandriukų;9797417587;Taip;0;3;0;3
3531;Gudrutis;Gandriukų;5574287734;Taip;0;9;0;9
3532;Gudrutis;Gandriukų;2431077357;Ne;6;0;1;7
3533;Gudrutis;Gandriukų;7116979528;Taip;0;4;1;5
3534;Gudrutis;Gandriukų;6747372184;Taip;0;0;4;4
3535;Gudrutis;Gandriukų;1693306014;Taip;0;13;0;13
3536;Gudrutis;Gandriukų;2865995680;Taip;0;0;1;1
3537;Gudrutis;Gandriukų;2074151024;Taip;5;0;0;5
3538;Gudrutis;Gandriukų;9841172472;Taip;19;0;0;19
3539;Gudrutis;Gandriukų;3359028602;Taip;7;4;0;11
3540;Gudrutis;Gandriukų;4945755164;Taip;3;6;0;9
3541;Gudrutis;Gandriukų;1190408818;Taip;18;0;0;18
3542;Gudrutis;Gandriukų;6443631536;Taip;0;0;3;3
3543;Gudrutis;Gandriukų;3363824185;Taip;2;4;0;6
3544;Gudrutis;Gandriukų;8398961969;Taip;0;0;1;1
3545;Gudrutis;"Saulės zuikučių";7773150642;Taip;0;3;0;3
3546;Gudrutis;"Saulės zuikučių";6835038962;Taip;7;0;5;12
3547;Gudrutis;"Saulės zuikučių";2118727861;Ne;3;0;2;5
3548;Gudrutis;"Saulės zuikučių";1725920873;Taip;8;0;2;10
3549;Gudrutis;"Saulės zuikučių";7664517480;Taip;7;0;5;12
3550;Gudrutis;"Saulės zuikučių";6731806925;Taip;0;4;1;5
3551;Gudrutis;"Saulės zuikučių";9701111916;Taip;10;0;0;10
3552;Gudrutis;"Saulės zuikučių";1228190677;Taip;4;10;0;14
3553;Gudrutis;"Saulės zuikučių";6198012431;Taip;5;6;2;13
3554;Gudrutis;"Saulės zuikučių";3646335609;Taip;0;0;6;6
3555;Gudrutis;"Saulės zuikučių";7871991275;Taip;0;9;0;9
3556;Gudrutis;"Saulės zuikučių";5580618896;Taip;0;9;0;9
3557;Gudrutis;"Saulės zuikučių";3625838131;Taip;0;9;0;9
3558;Gudrutis;"Saulės zuikučių";2337493193;Taip;0;3;0;3
3559;Gudrutis;"Saulės zuikučių";2764843216;Taip;0;4;0;4
3560;Gudrutis;"Saulės zuikučių";7955353991;Taip;0;1;0;1
3561;Gudrutis;Pelėdžiukų;1490739175;Taip;0;0;1;1
3562;Gudrutis;Pelėdžiukų;35401545938;Taip;0;4;2;6
3563;Gudrutis;Pelėdžiukų;1389133303;Taip;0;4;0;4
3564;Gudrutis;Pelėdžiukų;1823786522;Taip;4;5;2;11
3565;Gudrutis;Pelėdžiukų;1204945185;Taip;0;4;0;4
3566;Gudrutis;Pelėdžiukų;87981934125;Taip;2;4;2;8
3567;Gudrutis;Pelėdžiukų;1436950588;Taip;8;0;1;9
3568;Gudrutis;Pelėdžiukų;2453989647;Taip;0;0;3;3
3569;Gudrutis;Pelėdžiukų;1592255250;Taip;0;10;1;11
3570;Gudrutis;Pelėdžiukų;1618442704;Taip;0;3;2;5
3571;Gudrutis;Pelėdžiukų;77776725399;Taip;0;6;1;7
3572;Gudrutis;Pelėdžiukų;8768627605;Taip;5;4;4;13
3573;Gudrutis;Pelėdžiukų;8085295588;Taip;5;0;0;5
3574;Gudrutis;Pelėdžiukų;21494647270;Taip;0;7;0;7
3575;Gudrutis;Pelėdžiukų;18320321051;Taip;9;7;0;16
3576;Gudrutis;Pelėdžiukų;1156575830;Taip;7;4;0;11
3577;Gudrutis;Pelėdžiukų;74605225026;Taip;7;0;5;12
3578;Gudrutis;Pelėdžiukų;11383212272;Taip;5;11;0;16
3579;Gudrutis;Pelėdžiukų;1434565790;Taip;5;5;0;10
3580;Gudrutis;Pelėdžiukų;1238607523;Taip;0;1;0;1
3581;Gudrutis;Pelėdžiukų;8128313792;Taip;0;9;0;9
3582;Gudrutis;Pelėdžiukų;1998630017;Taip;0;4;1;5
3583;Gudrutis;BITUČIŲ;98473509715;Taip;0;1;2;3
3584;Gudrutis;BITUČIŲ;2012092629;Taip;14;4;0;18
3585;Gudrutis;BITUČIŲ;4727651235;Ne;8;0;0;8
3586;Gudrutis;BITUČIŲ;18813895572;Taip;0;5;0;5
3587;Gudrutis;BITUČIŲ;81252457503;Taip;0;4;1;5
3588;Gudrutis;BITUČIŲ;28075147728;Ne;0;4;1;5
3589;Gudrutis;BITUČIŲ;69437346100;Ne;5;0;1;6
3590;Gudrutis;BITUČIŲ;38591847769;Taip;4;4;0;8
3591;Gudrutis;BITUČIŲ;14626533681;Taip;0;4;2;6
3592;Gudrutis;BITUČIŲ;1174040508;Taip;0;6;5;11
3593;Gudrutis;BITUČIŲ;1013150817;Taip;0;4;0;4
3594;Gudrutis;BITUČIŲ;71306450171;Ne;6;0;0;6
3595;Gudrutis;BITUČIŲ;13755502342;Taip;0;5;1;6
3596;Gudrutis;BITUČIŲ;1261390117;Ne;0;8;0;8
3597;Gudrutis;BITUČIŲ;33123804925;Taip;0;4;1;5
3598;Gudrutis;BITUČIŲ;11324963268;Ne;0;1;0;1
3599;Gudrutis;BITUČIŲ;15665148606;Taip;7;4;0;11
3600;Gudrutis;BITUČIŲ;62735575539;Taip;0;4;1;5
3601;Gudrutis;BITUČIŲ;21999129886;Taip;0;3;0;3
3602;Gudrutis;BITUČIŲ;85886111222;Ne;0;4;0;4
3603;Gudrutis;BITUČIŲ;74606626459;Taip;0;4;0;4
3604;Gudrutis;BITUČIŲ;3363640861;Taip;2;3;0;5
3605;Gudrutis;BITUČIŲ;6824283429;Taip;6;4;1;11
3606;Gudrutis;Boružėlių;7934673005;Taip;4;0;4;8
3607;Gudrutis;Boružėlių;7006545234;Ne;16;1;0;17
3608;Gudrutis;Boružėlių;2199222671;Taip;0;6;0;6
3609;Gudrutis;Boružėlių;4814488445;Taip;8;0;0;8
3610;Gudrutis;Boružėlių;1587454709;Taip;5;8;0;13
3611;Gudrutis;Boružėlių;4628728628;Taip;0;8;0;8
3612;Gudrutis;Boružėlių;1670550212;Taip;0;8;0;8
3613;Gudrutis;Boružėlių;5241856014;Taip;9;0;1;10
3614;Gudrutis;Boružėlių;8500911420;Taip;2;0;0;2
3615;Gudrutis;Boružėlių;5728436444;Taip;9;0;0;9
3616;Gudrutis;Boružėlių;9041133527;Taip;0;2;0;2
3617;Gudrutis;Boružėlių;9328365491;Taip;9;0;0;9
3618;Gudrutis;Boružėlių;1384696362;Taip;5;0;0;5
3619;Gudrutis;Boružėlių;2619718027;Taip;0;4;1;5
3620;Gudrutis;Drugeliai;2487363252;Ne;0;2;2;4
3621;Gudrutis;Drugeliai;7984911632;Taip;0;5;0;5
3622;Gudrutis;Drugeliai;8165828215;Taip;8;7;0;15
3623;Gudrutis;Drugeliai;1701035039;Taip;0;4;0;4
3624;Gudrutis;Drugeliai;1012579870;Taip;8;1;6;15
3625;Gudrutis;Drugeliai;5508723821;Taip;6;4;0;10
3626;Gudrutis;Drugeliai;7755882832;Taip;12;1;0;13
3627;Gudrutis;Drugeliai;8512130106;Taip;0;1;0;1
3628;Gudrutis;Drugeliai;3814794448;Taip;19;0;0;19
3629;Gudrutis;Drugeliai;3919786807;Taip;7;0;0;7
3630;Gudrutis;Drugeliai;8807008147;Taip;7;0;5;12
3631;Gudrutis;Drugeliai;9249913155;Taip;11;0;1;12
3632;Gudrutis;Drugeliai;2197278086;Taip;3;6;0;9
3633;Gudrutis;Drugeliai;4773564048;Taip;6;0;3;9
3634;Gudrutis;Drugeliai;9044566825;Taip;2;4;0;6
3635;Jurginėlis;Ąžuoliukai;7753784918;Ne;0;0;18;18
3636;Jurginėlis;Ąžuoliukai;4852619394;Taip;13;0;0;13
3637;Jurginėlis;Ąžuoliukai;8972814655;Taip;7;0;2;9
3638;Jurginėlis;Ąžuoliukai;1829089083;Taip;0;8;1;9
3639;Jurginėlis;Ąžuoliukai;8784076886;Taip;11;0;0;11
3640;Jurginėlis;Ąžuoliukai;47243459592;Taip;5;0;0;5
3641;Jurginėlis;Ąžuoliukai;1954364886;Taip;3;0;3;6
3642;Jurginėlis;Ąžuoliukai;1563317396;Taip;0;0;3;3
3643;Jurginėlis;Ąžuoliukai;3068120316;Taip;5;4;0;9
3644;Jurginėlis;Ąžuoliukai;6111863896;Taip;0;13;0;13
3645;Jurginėlis;Ąžuoliukai;4851923549;Taip;5;0;4;9
3646;Jurginėlis;Ąžuoliukai;1467200002;Taip;0;0;1;1
3647;Jurginėlis;Ąžuoliukai;1758862051;Taip;0;1;0;1
3648;Jurginėlis;Ąžuoliukai;1974388885;Taip;20;1;0;21
3649;Jurginėlis;Ąžuoliukai;8338173095;Ne;0;0;2;2
3650;Jurginėlis;Ąžuoliukai;9589394406;Taip;0;4;2;6
3651;Jurginėlis;Ąžuoliukai;3027573572;Taip;17;0;0;17
3652;Jurginėlis;Ąžuoliukai;8920304044;Taip;0;12;3;15
3653;Jurginėlis;Žiogeliai;5892180334;Taip;0;9;0;9
3654;Jurginėlis;Žiogeliai;8144038013;Taip;13;2;0;15
3655;Jurginėlis;Žiogeliai;7928799065;Taip;0;9;0;9
3656;Jurginėlis;Žiogeliai;2624313807;Taip;3;10;0;13
3657;Jurginėlis;Žiogeliai;1547101731;Taip;14;0;0;14
3658;Jurginėlis;Žiogeliai;9646318532;Taip;0;5;0;5
3659;Jurginėlis;Žiogeliai;5242359650;Taip;5;6;0;11
3660;Jurginėlis;Žiogeliai;903039398;Taip;0;1;0;1
3661;Jurginėlis;Žiogeliai;1759218238;Taip;10;0;0;10
3662;Jurginėlis;Žiogeliai;1102466152;Taip;2;3;0;5
3663;Jurginėlis;Žiogeliai;4806248290;Taip;0;11;0;11
3664;Jurginėlis;Žiogeliai;1082593212;Taip;6;0;0;6
3665;Jurginėlis;Žiogeliai;1175441410;Taip;0;9;0;9
3666;Jurginėlis;Žiogeliai;1983924909;Taip;0;13;0;13
3667;Jurginėlis;Žiogeliai;2710889915;Taip;0;4;0;4
3668;Jurginėlis;Žiogeliai;1586599624;Taip;0;3;0;3
3669;Jurginėlis;Žiogeliai;7297672386;Taip;0;6;0;6
3670;Jurginėlis;Žiogeliai;1787311340;Taip;0;6;0;6
3671;Jurginėlis;Žiogeliai;2535601005;Taip;13;0;0;13
3672;Jurginėlis;Žiogeliai;2639125463;Taip;11;4;0;15
3673;Jurginėlis;Žiogeliai;6413324051;Taip;2;9;0;11
3674;Jurginėlis;Žiogeliai;3708774681;Taip;21;0;0;21
3675;Jurginėlis;Pelėdžiukų;49181526821;Taip;2;5;0;7
3676;Jurginėlis;Pelėdžiukų;35653034443;Taip;5;6;0;11
3677;Jurginėlis;Pelėdžiukų;59935106302;Taip;0;0;19;19
3678;Jurginėlis;Pelėdžiukų;91317327949;Taip;0;7;1;8
3679;Jurginėlis;Pelėdžiukų;52877525045;Taip;0;15;0;15
3680;Jurginėlis;Pelėdžiukų;36829106143;Taip;0;0;3;3
3681;Jurginėlis;Pelėdžiukų;97726131559;Taip;0;0;4;4
3682;Jurginėlis;Pelėdžiukų;45200409204;Taip;0;4;0;4
3683;Jurginėlis;Pelėdžiukų;2544904907;Ne;16;0;0;16
3684;Jurginėlis;Pelėdžiukų;8414893303;Taip;0;5;0;5
3685;Jurginėlis;Pelėdžiukų;70733592257;Taip;2;6;0;8
3686;Jurginėlis;Pelėdžiukų;7449558199;Taip;5;3;0;8
3687;Jurginėlis;Pelėdžiukų;54494144846;Taip;0;5;0;5
3688;Jurginėlis;Pelėdžiukų;6072633581;Taip;0;11;0;11
3689;Jurginėlis;Pelėdžiukų;57340494605;Taip;3;0;6;9
3690;Jurginėlis;Pelėdžiukų;18273043496;Taip;0;1;1;2
3691;Jurginėlis;Pelėdžiukų;91909797332;Taip;0;1;1;2
3692;Jurginėlis;Pelėdžiukų;7278855565;Ne;0;0;6;6
3693;Jurginėlis;Pelėdžiukų;1295024976;Taip;0;4;7;11
3694;Jurginėlis;Pelėdžiukų;1416995981;Taip;9;0;0;9
3695;Jurginėlis;Boružėlių;92559573466;Ne;7;5;0;12
3696;Jurginėlis;Boružėlių;7798931951;Taip;0;6;0;6
3697;Jurginėlis;Boružėlių;59618430487;Taip;0;2;0;2
3698;Jurginėlis;Boružėlių;13085086595;Taip;0;2;0;2
3699;Jurginėlis;Boružėlių;8217773164;Taip;10;11;0;21
3700;Jurginėlis;Boružėlių;29601247012;Taip;0;6;0;6
3701;Jurginėlis;Boružėlių;75192831969;Taip;0;6;0;6
3702;Jurginėlis;Boružėlių;29155768493;Taip;0;14;0;14
3703;Jurginėlis;Boružėlių;10095155757;Taip;0;3;0;3
3704;Jurginėlis;Boružėlių;67578476769;Taip;0;9;0;9
3705;Jurginėlis;Boružėlių;64852957209;Taip;0;4;0;4
3706;Jurginėlis;Boružėlių;64641268493;Taip;3;5;0;8
3707;Jurginėlis;Boružėlių;56382554421;Taip;0;6;0;6
3708;Jurginėlis;Boružėlių;51856181602;Ne;0;2;0;2
3709;Jurginėlis;Boružėlių;23049094719;Taip;0;8;0;8
3710;Jurginėlis;Boružėlių;72190891827;Taip;0;4;0;4
3711;Jurginėlis;Boružėlių;1742217696;Ne;12;5;0;17
3712;Jurginėlis;Boružėlių;52105378503;Taip;0;1;0;1
3713;Jurginėlis;Boružėlių;1868080361;Taip;0;5;0;5
3714;Jurginėlis;Bitučių;2106937059;Taip;0;9;0;9
3715;Jurginėlis;Bitučių;50470137888;Taip;2;4;3;9
3716;Jurginėlis;Bitučių;93055778306;Taip;0;5;0;5
3717;Jurginėlis;Bitučių;92688596347;Ne;0;15;0;15
3718;Jurginėlis;Bitučių;1175198086;Taip;0;6;0;6
3719;Jurginėlis;Bitučių;96017651718;Taip;2;4;4;10
3720;Jurginėlis;Bitučių;87566883270;Taip;0;8;0;8
3721;Jurginėlis;Bitučių;84691244839;Taip;0;6;0;6
3722;Jurginėlis;Bitučių;53783266582;Taip;2;4;0;6
3723;Jurginėlis;Bitučių;2557687323;Taip;0;0;5;5
3724;Jurginėlis;Bitučių;53924769958;Taip;0;2;0;2
3725;Jurginėlis;Bitučių;60988201430;Taip;0;3;0;3
3726;Jurginėlis;Bitučių;1421681717;Taip;15;0;1;16
3727;Jurginėlis;Bitučių;24615714793;Ne;2;9;0;11
3728;Jurginėlis;Bitučių;1058274970;Taip;0;4;13;17
3729;Jurginėlis;Bitučių;64524305038;Taip;2;7;0;9
3730;Jurginėlis;Bitučių;90786336005;Taip;0;9;0;9
3731;Jurginėlis;Bitučių;1041294212;Taip;0;4;3;7
3732;Jurginėlis;Bitučių;1191021311;Taip;0;14;0;14
3733;Jurginėlis;Skruzdeliukų;1343532870;Taip;0;6;0;6
3734;Jurginėlis;Skruzdeliukų;92602685294;Taip;0;9;0;9
3735;Jurginėlis;Skruzdeliukų;1485725580;Ne;4;2;4;10
3736;Jurginėlis;Skruzdeliukų;20527253593;Taip;3;6;0;9
3737;Jurginėlis;Skruzdeliukų;51685299187;Ne;0;6;0;6
3738;Jurginėlis;Skruzdeliukų;1881790340;Taip;0;17;0;17
3739;Jurginėlis;Skruzdeliukų;31143311410;Taip;0;1;0;1
3740;Jurginėlis;Skruzdeliukų;94107758268;Taip;0;18;0;18
3741;Jurginėlis;Skruzdeliukų;77480957625;Taip;6;2;0;8
3742;Jurginėlis;Skruzdeliukų;1258821883;Ne;0;2;2;4
3743;Jurginėlis;Skruzdeliukų;38755774035;Taip;9;0;0;9
3744;Jurginėlis;Skruzdeliukų;68109772993;Ne;12;1;0;13
3745;Jurginėlis;Skruzdeliukų;86427848578;Taip;7;1;0;8
3746;Jurginėlis;Skruzdeliukų;81064432153;Taip;8;4;0;12
3747;Jurginėlis;Skruzdeliukų;12659496203;Taip;0;0;4;4
3748;Jurginėlis;Skruzdeliukų;1828295769;Taip;0;2;0;2
3749;Jurginėlis;Skruzdeliukų;17286700686;Ne;0;0;1;1
3750;Jurginėlis;Skruzdeliukų;1506649972;Taip;0;6;0;6
3751;Jurginėlis;Drugelių;6181547354;Taip;24;0;0;24
3752;Jurginėlis;Drugelių;2221708420;Taip;6;0;4;10
3753;Jurginėlis;Drugelių;1340689348;Taip;17;0;3;20
3754;Jurginėlis;Drugelių;2925253653;Taip;20;2;0;22
3755;Jurginėlis;Drugelių;4967548277;Taip;17;2;0;19
3756;Jurginėlis;Drugelių;8443412187;Taip;0;0;4;4
3757;Jurginėlis;Drugelių;8779807396;Taip;16;0;1;17
3758;Jurginėlis;Drugelių;9507571301;Ne;12;0;3;15
3759;Jurginėlis;Drugelių;4292932046;Ne;10;1;4;15
3760;Jurginėlis;Drugelių;6968528293;Taip;14;5;0;19
3761;Jurginėlis;Drugelių;2417314519;Taip;14;1;0;15
3762;Jurginėlis;Drugelių;7809274980;Taip;4;0;4;8
3763;Jurginėlis;Drugelių;9946892497;Taip;21;0;2;23
3764;Jurginėlis;Drugelių;1455749921;Taip;2;22;0;24
3765;Jurginėlis;Drugelių;3079495897;Taip;11;4;2;17
3766;Jurginėlis;Drugelių;5984893389;Taip;0;12;0;12
3767;Jurginėlis;Drugelių;2490875633;Taip;16;0;0;16
3768;Jurginėlis;Drugelių;9882919290;Taip;0;0;2;2
3769;Jurginėlis;Drugelių;8727844649;Taip;14;0;1;15
3770;Jurginėlis;Drugelių;8876608072;Taip;0;13;0;13
3771;Jurginėlis;Žibučių;3284464951;Taip;8;10;0;18
3772;Jurginėlis;Žibučių;4158502752;Taip;0;15;0;15
3773;Jurginėlis;Žibučių;7990015623;Ne;10;2;0;12
3774;Jurginėlis;Žibučių;6579565337;Taip;3;3;0;6
3775;Jurginėlis;Žibučių;5921714669;Taip;2;3;0;5
3776;Jurginėlis;Žibučių;4463258777;Taip;6;0;2;8
3777;Jurginėlis;Žibučių;4827340942;Ne;13;0;1;14
3778;Jurginėlis;Žibučių;2627736026;Taip;20;2;0;22
3779;Jurginėlis;Žibučių;2548920722;Taip;20;0;0;20
3780;Jurginėlis;Žibučių;6806704355;Taip;0;0;3;3
3781;Jurginėlis;Žibučių;9288380246;Taip;12;0;0;12
3782;Jurginėlis;Žibučių;3627487971;Taip;1;2;1;4
3783;Jurginėlis;Žibučių;2214809186;Ne;8;0;1;9
3784;Jurginėlis;Žibučių;2225892248;Taip;0;2;2;4
3785;Jurginėlis;Žibučių;1414888906;Taip;8;0;0;8
3786;Jurginėlis;Žibučių;7288921301;Ne;24;0;0;24
3787;Jurginėlis;Žibučių;3031725530;Taip;8;3;0;11
3788;Jurginėlis;Žibučių;2364890732;Ne;0;0;12;12
3789;Jurginėlis;Zuikučių;6217229672;Ne;8;3;0;11
3790;Jurginėlis;Zuikučių;1762685527;Ne;0;9;0;9
3791;Jurginėlis;Zuikučių;1649208522;Ne;8;0;0;8
3792;Jurginėlis;Zuikučių;8084970770;Ne;9;0;2;11
3793;Jurginėlis;Zuikučių;87991288027;Ne;11;0;0;11
3794;Jurginėlis;Zuikučių;1400142372;Taip;0;7;0;7
3795;Jurginėlis;Zuikučių;2133447073;Taip;0;0;1;1
3796;Jurginėlis;Zuikučių;1656300401;Taip;0;3;0;3
3797;Jurginėlis;Zuikučių;1759031589;Taip;0;4;2;6
3798;Jurginėlis;Zuikučių;1945098580;Taip;9;5;0;14
3799;Jurginėlis;Zuikučių;1409480187;Ne;8;4;0;12
3800;Jurginėlis;Zuikučių;1780106633;Taip;0;7;0;7
3801;Jurginėlis;Zuikučių;8793129805;Taip;0;10;0;10
3802;Jurginėlis;Zuikučių;74303787465;Ne;2;13;0;15
3803;Jurginėlis;Zuikučių;2446630485;Taip;6;0;2;8
3804;Jurginėlis;Zuikučių;1434737480;Taip;13;0;0;13
3805;Jurginėlis;Zuikučių;7293372539;Ne;7;4;0;11
3806;Jurginėlis;Zuikučių;5386710069;Taip;17;0;0;17
3807;Jurginėlis;Zuikučių;7920082372;Ne;19;1;0;20
3808;Jurginėlis;Viščiukų;6729212950;Taip;0;0;1;1
3809;Jurginėlis;Viščiukų;6636147085;Taip;11;5;0;16
3810;Jurginėlis;Viščiukų;5734506036;Ne;8;8;0;16
3811;Jurginėlis;Viščiukų;1726968598;Taip;0;18;0;18
3812;Jurginėlis;Viščiukų;4979618298;Taip;9;0;2;11
3813;Jurginėlis;Viščiukų;5180951251;Taip;16;1;1;18
3814;Jurginėlis;Viščiukų;4981043400;Taip;0;0;1;1
3815;Jurginėlis;Viščiukų;9550110246;Taip;8;1;0;9
3816;Jurginėlis;Viščiukų;9506129699;Taip;16;0;0;16
3817;Jurginėlis;Viščiukų;3038732180;Taip;17;4;0;21
3818;Jurginėlis;Viščiukų;3541542063;Taip;10;0;0;10
3819;Jurginėlis;Viščiukų;9961083854;Taip;11;5;0;16
3820;Jurginėlis;Viščiukų;3699180485;Taip;0;6;2;8
3821;Jurginėlis;Viščiukų;4536086996;Ne;4;0;4;8
3822;Jurginėlis;Viščiukų;6542567172;Taip;21;0;0;21
3823;Jurginėlis;Meškiukų;8017976529;Ne;16;0;0;16
3824;Jurginėlis;Meškiukų;9289922622;Taip;19;0;1;20
3825;Jurginėlis;Meškiukų;9850874714;Taip;4;0;3;7
3826;Jurginėlis;Meškiukų;6202225321;Taip;10;0;4;14
3827;Jurginėlis;Meškiukų;3530906368;Ne;0;0;10;10
3828;Jurginėlis;Meškiukų;6587382160;Taip;17;0;0;17
3829;Jurginėlis;Meškiukų;1351306981;Taip;0;4;3;7
3830;Jurginėlis;Meškiukų;4944292549;Taip;11;5;0;16
3831;Jurginėlis;Meškiukų;5652597514;Taip;3;0;2;5
3832;Jurginėlis;Meškiukų;4432849717;Taip;0;16;0;16
3833;Jurginėlis;Meškiukų;6671759364;Taip;8;0;2;10
3834;Jurginėlis;Meškiukų;9146039217;Taip;5;0;0;5
3835;Jurginėlis;Meškiukų;3558752347;Taip;0;10;0;10
3836;Jurginėlis;Meškiukų;8097652962;Taip;10;0;1;11
3837;Jurginėlis;Meškiukų;8161347781;Taip;0;10;0;10
3838;Jurginėlis;Meškiukų;4113264904;Taip;10;0;2;12
3839;Jurginėlis;Gandriukų;7419836868;Ne;4;0;0;4
3840;Jurginėlis;Gandriukų;51603579121;Ne;0;4;0;4
3841;Jurginėlis;Gandriukų;87444065733;Taip;0;9;0;9
3842;Jurginėlis;Gandriukų;2179884441;Taip;0;18;0;18
3843;Jurginėlis;Gandriukų;2264351097;Taip;9;0;1;10
3844;Jurginėlis;Gandriukų;78496894090;Ne;2;0;7;9
3845;Jurginėlis;Gandriukų;99523320519;Taip;5;0;1;6
3846;Jurginėlis;Gandriukų;1498351759;Ne;19;0;0;19
3847;Jurginėlis;Gandriukų;1159550277;Taip;0;6;0;6
3848;Jurginėlis;Gandriukų;75383941896;Taip;11;0;0;11
3849;Jurginėlis;Gandriukų;1508705709;Taip;0;11;0;11
3850;Jurginėlis;Gandriukų;1773100970;Taip;0;0;2;2
3851;Jurginėlis;Gandriukų;1500087367;Taip;0;0;2;2
3852;Jurginėlis;Gandriukų;43368987046;Taip;7;5;0;12
3853;Jurginėlis;Gandriukų;6707289955;Taip;2;0;0;2
3854;Jurginėlis;Gandriukų;1927843089;Taip;4;0;0;4
3855;Jurginėlis;Gandriukų;8178112926;Taip;8;0;0;8
3856;Jurginėlis;Gandriukų;6475508583;Taip;17;0;3;20
3857;Jurginėlis;Gandriukų;9714764714;Taip;12;0;0;12
3858;Jurginėlis;Gandriukų;5756997642;Ne;11;2;0;13
3859;Karusėlė;PAGRANDUKAS;1621482372;Taip;6;5;0;11
3860;Karusėlė;PAGRANDUKAS;3330374479;Taip;19;0;0;19
3861;Karusėlė;PAGRANDUKAS;6183785840;Taip;0;4;0;4
3862;Karusėlė;PAGRANDUKAS;3984262482;Taip;18;0;0;18
3863;Karusėlė;PAGRANDUKAS;9130534156;Taip;18;0;0;18
3864;Karusėlė;PAGRANDUKAS;3660843696;Ne;12;2;0;14
3865;Karusėlė;PAGRANDUKAS;9805481603;Taip;14;0;0;14
3866;Karusėlė;PAGRANDUKAS;1412890120;Taip;7;8;0;15
3867;Karusėlė;PAGRANDUKAS;5132581245;Taip;14;1;0;15
3868;Karusėlė;PAGRANDUKAS;2160071272;Taip;4;0;0;4
3869;Karusėlė;PAGRANDUKAS;9462242426;Taip;6;4;0;10
3870;Karusėlė;PAGRANDUKAS;2412418335;Taip;5;1;0;6
3871;Karusėlė;PAGRANDUKAS;7393434659;Taip;5;0;0;5
3872;Karusėlė;PAGRANDUKAS;6826455161;Taip;0;2;2;4
3873;Karusėlė;PAGRANDUKAS;5695697634;Taip;12;0;0;12
3874;Karusėlė;PAGRANDUKAS;8127218866;Taip;16;0;0;16
3875;Karusėlė;PAGRANDUKAS;6062361348;Taip;15;0;0;15
3876;Karusėlė;PAGRANDUKAS;3620722907;Taip;0;5;3;8
3877;Karusėlė;PAGRANDUKAS;7013765804;Taip;18;1;0;19
3878;Karusėlė;PAGRANDUKAS;3429495073;Taip;17;0;0;17
3879;Karusėlė;PAGRANDUKAS;5951045233;Taip;16;0;0;16
3880;Karusėlė;PAGRANDUKAS;6252613489;Taip;0;12;0;12
3881;Karusėlė;PAGRANDUKAS;5595950213;Taip;16;0;0;16
3882;Karusėlė;PAGRANDUKAS;6004882312;Taip;19;0;0;19
3883;Karusėlė;NYKŠTUKAS;1560316431;Taip;0;8;0;8
3884;Karusėlė;NYKŠTUKAS;82963400142;Taip;7;4;2;13
3885;Karusėlė;NYKŠTUKAS;1567290218;Taip;0;11;0;11
3886;Karusėlė;NYKŠTUKAS;77290004668;Ne;0;0;2;2
3887;Karusėlė;NYKŠTUKAS;64652121316;Taip;0;5;0;5
3888;Karusėlė;NYKŠTUKAS;1250530261;Taip;8;5;0;13
3889;Karusėlė;NYKŠTUKAS;1397009220;Taip;0;10;0;10
3890;Karusėlė;NYKŠTUKAS;62938709605;Taip;12;0;1;13
3891;Karusėlė;NYKŠTUKAS;2064301292;Taip;0;5;0;5
3892;Karusėlė;NYKŠTUKAS;96150256487;Taip;2;0;0;2
3893;Karusėlė;NYKŠTUKAS;1680275369;Taip;4;6;0;10
3894;Karusėlė;NYKŠTUKAS;17728195505;Taip;8;4;0;12
3895;Karusėlė;NYKŠTUKAS;1534689679;Taip;9;0;0;9
3896;Karusėlė;NYKŠTUKAS;1226371512;Taip;6;0;1;7
3897;Karusėlė;NYKŠTUKAS;1311631554;Ne;10;0;0;10
3898;Karusėlė;NYKŠTUKAS;5481354767;Taip;9;1;0;10
3899;Karusėlė;NYKŠTUKAS;1135386852;Taip;18;0;0;18
3900;Karusėlė;NYKŠTUKAS;8419242504;Taip;6;0;3;9
3901;Karusėlė;NYKŠTUKAS;3875204515;Taip;5;5;1;11
3902;Karusėlė;NYKŠTUKAS;45634061915;Taip;0;10;0;10
3903;Karusėlė;NYKŠTUKAS;3453187182;Ne;0;0;1;1
3904;Karusėlė;BITUTĖ;33892845154;Taip;9;7;0;16
3905;Karusėlė;BITUTĖ;2526585854;Taip;0;11;0;11
3906;Karusėlė;BITUTĖ;15575896909;Taip;0;13;0;13
3907;Karusėlė;BITUTĖ;1839186035;Ne;14;4;0;18
3908;Karusėlė;BITUTĖ;2653604193;Taip;11;6;0;17
3909;Karusėlė;BITUTĖ;1065703569;Taip;12;4;0;16
3910;Karusėlė;BITUTĖ;4291893779;Ne;9;0;0;9
3911;Karusėlė;BITUTĖ;1295435839;Taip;2;0;0;2
3912;Karusėlė;BITUTĖ;1883944064;Taip;13;4;0;17
3913;Karusėlė;BITUTĖ;3870601809;Taip;7;8;0;15
3914;Karusėlė;BITUTĖ;2001623432;Taip;5;2;0;7
3915;Karusėlė;BITUTĖ;8033732937;Taip;0;7;0;7
3916;Karusėlė;BITUTĖ;1798723081;Ne;5;3;0;8
3917;Karusėlė;BITUTĖ;88371238657;Taip;7;7;0;14
3918;Karusėlė;BITUTĖ;1593728369;Taip;10;5;0;15
3919;Karusėlė;BITUTĖ;1809033214;Taip;14;4;0;18
3920;Karusėlė;BITUTĖ;9065247151;Taip;12;6;0;18
3921;Karusėlė;BITUTĖ;75574841532;Ne;0;9;0;9
3922;Karusėlė;BITUTĖ;25581881402;Taip;0;9;0;9
3923;Karusėlė;BITUTĖ;6417699445;Taip;7;5;0;12
3924;Karusėlė;BITUTĖ;1193711193;Taip;0;9;0;9
3925;Karusėlė;BORUŽĖLĖ;1705790474;Taip;5;6;1;12
3926;Karusėlė;BORUŽĖLĖ;8608177987;Taip;9;0;0;9
3927;Karusėlė;BORUŽĖLĖ;4890393582;Taip;8;0;0;8
3928;Karusėlė;BORUŽĖLĖ;1311907441;Taip;13;0;0;13
3929;Karusėlė;BORUŽĖLĖ;6313010762;Taip;0;5;0;5
3930;Karusėlė;BORUŽĖLĖ;5859827168;Taip;17;0;0;17
3931;Karusėlė;BORUŽĖLĖ;37349219339;Taip;12;2;0;14
3932;Karusėlė;BORUŽĖLĖ;49110267692;Taip;2;8;0;10
3933;Karusėlė;BORUŽĖLĖ;6811862463;Taip;5;9;0;14
3934;Karusėlė;BORUŽĖLĖ;5471989295;Taip;19;0;0;19
3935;Karusėlė;BORUŽĖLĖ;9753876554;Taip;2;7;0;9
3936;Karusėlė;BORUŽĖLĖ;1204919995;Taip;21;0;0;21
3937;Karusėlė;BORUŽĖLĖ;8717484092;Taip;7;6;0;13
3938;Karusėlė;BORUŽĖLĖ;5351690991;Taip;11;4;0;15
3939;Karusėlė;BORUŽĖLĖ;1994682683;Taip;7;7;0;14
3940;Karusėlė;BORUŽĖLĖ;5632697184;Taip;5;2;0;7
3941;Karusėlė;BORUŽĖLĖ;2247913568;Taip;9;1;0;10
3942;Karusėlė;BORUŽĖLĖ;4262640017;Ne;11;0;0;11
3943;Karusėlė;BORUŽĖLĖ;4845558814;Taip;14;5;0;19
3944;Karusėlė;BORUŽĖLĖ;8406462155;Ne;11;0;0;11
3945;Karusėlė;BORUŽĖLĖ;6495631086;Ne;0;10;0;10
3946;Karusėlė;BORUŽĖLĖ;1183484176;Taip;12;0;0;12
3947;Karusėlė;UOGELĖ;8182071103;Ne;0;9;0;9
3948;Karusėlė;UOGELĖ;8175498192;Taip;2;4;3;9
3949;Karusėlė;UOGELĖ;3053539045;Taip;6;2;1;9
3950;Karusėlė;UOGELĖ;9992989896;Taip;0;0;3;3
3951;Karusėlė;UOGELĖ;2084276906;Taip;9;2;0;11
3952;Karusėlė;UOGELĖ;1098106063;Taip;0;4;2;6
3953;Karusėlė;UOGELĖ;8665314366;Taip;0;4;0;4
3954;Karusėlė;UOGELĖ;5651238035;Taip;0;0;1;1
3955;Karusėlė;UOGELĖ;4121668687;Taip;3;0;0;3
3956;Karusėlė;UOGELĖ;8316147204;Taip;5;4;0;9
3957;Karusėlė;UOGELĖ;5504719953;Ne;7;0;11;18
3958;Karusėlė;UOGELĖ;5919009583;Taip;2;4;7;13
3959;Karusėlė;UOGELĖ;4199597984;Taip;0;5;0;5
3960;Karusėlė;UOGELĖ;2383023280;Taip;7;6;0;13
3961;Karusėlė;UOGELĖ;1575408822;Taip;0;16;0;16
3962;Karusėlė;UOGELĖ;3917113787;Taip;5;2;0;7
3963;Karusėlė;UOGELĖ;4068106379;Taip;0;4;2;6
3964;Karusėlė;UOGELĖ;1428516421;Taip;0;4;5;9
3965;Karusėlė;UOGELĖ;4638918427;Taip;0;0;2;2
3966;Karusėlė;UOGELĖ;3615957761;Taip;12;7;0;19
3967;Karusėlė;UOGELĖ;3514026443;Taip;0;4;0;4
3968;Karusėlė;UOGELĖ;1891147022;Taip;0;3;1;4
3969;Karusėlė;UOGELĖ;9389017016;Taip;15;0;1;16
3970;Karusėlė;GINTARĖLIS;89669425763;Taip;0;4;0;4
3971;Karusėlė;GINTARĖLIS;1058129883;Taip;15;4;0;19
3972;Karusėlė;GINTARĖLIS;1625704473;Taip;12;4;0;16
3973;Karusėlė;GINTARĖLIS;5267055924;Ne;0;7;0;7
3974;Karusėlė;GINTARĖLIS;17254955427;Taip;0;4;1;5
3975;Karusėlė;GINTARĖLIS;1467237683;Taip;0;4;0;4
3976;Karusėlė;GINTARĖLIS;33935704865;Taip;8;9;0;17
3977;Karusėlė;GINTARĖLIS;92286460424;Taip;0;17;0;17
3978;Karusėlė;GINTARĖLIS;80377577910;Taip;0;13;0;13
3979;Karusėlė;GINTARĖLIS;1302846796;Taip;6;9;0;15
3980;Karusėlė;GINTARĖLIS;6181109173;Ne;6;4;0;10
3981;Karusėlė;GINTARĖLIS;90635580825;Taip;0;10;0;10
3982;Karusėlė;GINTARĖLIS;93635113154;Taip;8;4;3;15
3983;Karusėlė;GINTARĖLIS;2386140324;Taip;21;0;0;21
3984;Karusėlė;GINTARĖLIS;90731574209;Ne;7;3;8;18
3985;Karusėlė;GINTARĖLIS;77007130834;Taip;2;4;0;6
3986;Karusėlė;GINTARĖLIS;6596029324;Taip;7;8;0;15
3987;Karusėlė;GINTARĖLIS;1477282992;Taip;0;12;0;12
3988;Karusėlė;GINTARĖLIS;1487641646;Taip;0;4;3;7
3989;Karusėlė;GINTARĖLIS;8008000299;Taip;12;4;1;17
3990;Karusėlė;GINTARĖLIS;9274456755;Taip;0;3;0;3
3991;Karusėlė;SAULUTĖ;1705251019;Taip;2;5;0;7
3992;Karusėlė;SAULUTĖ;64855471225;Taip;0;5;0;5
3993;Karusėlė;SAULUTĖ;45701480267;Taip;17;4;0;21
3994;Karusėlė;SAULUTĖ;35910852843;Taip;4;6;0;10
3995;Karusėlė;SAULUTĖ;1198992954;Taip;0;2;0;2
3996;Karusėlė;SAULUTĖ;1223992311;Taip;12;4;0;16
3997;Karusėlė;SAULUTĖ;6702329224;Taip;3;5;0;8
3998;Karusėlė;SAULUTĖ;1239411995;Ne;0;4;0;4
3999;Karusėlė;SAULUTĖ;4806666157;Ne;1;3;0;4
4000;Karusėlė;SAULUTĖ;10539595272;Taip;6;3;0;9
4001;Karusėlė;SAULUTĖ;52452661421;Taip;6;5;0;11
4002;Karusėlė;SAULUTĖ;54723578928;Taip;0;4;0;4
4003;Karusėlė;SAULUTĖ;2606829789;Ne;0;6;0;6
4004;Karusėlė;SAULUTĖ;91676265927;Taip;0;4;0;4
4005;Karusėlė;SAULUTĖ;63044693440;Taip;0;5;0;5
4006;Karusėlė;SAULUTĖ;23662916408;Taip;0;13;0;13
4007;Karusėlė;SAULUTĖ;99462674291;Taip;15;4;0;19
4008;Karusėlė;SAULUTĖ;59790578013;Taip;9;5;0;14
4009;Karusėlė;SAULUTĖ;2025180617;Taip;0;4;0;4
4010;Karusėlė;SAULUTĖ;7977835762;Taip;0;6;0;6
4011;Karusėlė;SAULUTĖ;1273810363;Taip;3;4;0;7
4012;Karusėlė;SAULUTĖ;25328680614;Taip;7;6;0;13
4013;Karusėlė;SAULUTĖ;2038274137;Taip;3;5;0;8
4014;Karusėlė;TIGRIUKAS;1982126099;Taip;15;1;0;16
4015;Karusėlė;TIGRIUKAS;1292576152;Taip;15;1;0;16
4016;Karusėlė;TIGRIUKAS;18831943978;Taip;4;2;0;6
4017;Karusėlė;TIGRIUKAS;1305485683;Taip;9;3;0;12
4018;Karusėlė;TIGRIUKAS;1817869518;Taip;12;0;0;12
4019;Karusėlė;TIGRIUKAS;1773362652;Taip;0;4;0;4
4020;Karusėlė;TIGRIUKAS;3752570475;Ne;7;0;0;7
4021;Karusėlė;TIGRIUKAS;8946147763;Taip;7;0;0;7
4022;Karusėlė;TIGRIUKAS;3960354989;Taip;10;0;0;10
4023;Karusėlė;TIGRIUKAS;1947403400;Taip;0;4;0;4
4024;Karusėlė;TIGRIUKAS;3690179876;Ne;14;1;0;15
4025;Karusėlė;TIGRIUKAS;7947148051;Taip;7;1;0;8
4026;Karusėlė;TIGRIUKAS;8076851284;Taip;7;2;0;9
4027;Karusėlė;TIGRIUKAS;5135054911;Taip;13;4;0;17
4028;Karusėlė;TIGRIUKAS;4426462711;Taip;8;1;0;9
4029;Karusėlė;TIGRIUKAS;8656806219;Taip;8;0;0;8
4030;Karusėlė;TIGRIUKAS;9484773068;Ne;7;0;0;7
4031;Karusėlė;TIGRIUKAS;8678437720;Taip;13;0;0;13
4032;Karusėlė;TIGRIUKAS;9868386182;Taip;0;1;0;1
4033;Karusėlė;TIGRIUKAS;1698478530;Taip;11;0;0;11
4034;Karusėlė;VAIVORYKŠTĖ;89727334417;Taip;0;18;0;18
4035;Karusėlė;VAIVORYKŠTĖ;21474974272;Taip;0;8;0;8
4036;Karusėlė;VAIVORYKŠTĖ;1629901230;Taip;0;5;0;5
4037;Karusėlė;VAIVORYKŠTĖ;2092642601;Taip;2;14;0;16
4038;Karusėlė;VAIVORYKŠTĖ;1097025436;Taip;0;2;0;2
4039;Karusėlė;VAIVORYKŠTĖ;1886562437;Taip;0;9;0;9
4040;Karusėlė;VAIVORYKŠTĖ;1915396083;Taip;0;4;0;4
4041;Karusėlė;VAIVORYKŠTĖ;1094853107;Taip;0;8;0;8
4042;Karusėlė;VAIVORYKŠTĖ;40499469616;Ne;0;5;0;5
4043;Karusėlė;VAIVORYKŠTĖ;26373120499;Taip;9;1;0;10
4044;Karusėlė;VAIVORYKŠTĖ;94058192792;Taip;5;1;1;7
4045;Karusėlė;VAIVORYKŠTĖ;78971949838;Taip;0;4;0;4
4046;Karusėlė;VAIVORYKŠTĖ;25859211954;Taip;2;3;0;5
4047;Karusėlė;VAIVORYKŠTĖ;47751458940;Taip;4;1;0;5
4048;Karusėlė;VAIVORYKŠTĖ;4878805177;Taip;6;0;1;7
4049;Karusėlė;VAIVORYKŠTĖ;68537797465;Taip;0;14;0;14
4050;Karusėlė;VAIVORYKŠTĖ;11336671763;Ne;21;0;0;21
4051;Karusėlė;VAIVORYKŠTĖ;9482894921;Taip;0;9;0;9
4052;Karusėlė;VAIVORYKŠTĖ;6580115367;Taip;0;1;1;2
4053;Karusėlė;VAIVORYKŠTĖ;1982350605;Taip;12;0;1;13
4054;Karusėlė;VAIVORYKŠTĖ;2098165226;Taip;6;4;0;10
4055;Karusėlė;"AUKSINĖ ŽUVELĖ";1289442716;Taip;7;4;0;11
4056;Karusėlė;"AUKSINĖ ŽUVELĖ";9855242602;Taip;8;4;0;12
4057;Karusėlė;"AUKSINĖ ŽUVELĖ";5627583683;Taip;18;0;0;18
4058;Karusėlė;"AUKSINĖ ŽUVELĖ";9561892809;Taip;19;0;0;19
4059;Karusėlė;"AUKSINĖ ŽUVELĖ";9726299722;Taip;8;6;0;14
4060;Karusėlė;"AUKSINĖ ŽUVELĖ";2894817418;Taip;0;10;0;10
4061;Karusėlė;"AUKSINĖ ŽUVELĖ";6546648346;Taip;0;6;0;6
4062;Karusėlė;"AUKSINĖ ŽUVELĖ";1581504806;Taip;2;9;0;11
4063;Karusėlė;"AUKSINĖ ŽUVELĖ";5985915835;Taip;13;0;0;13
4064;Karusėlė;"AUKSINĖ ŽUVELĖ";8063412271;Taip;18;0;0;18
4065;Karusėlė;"AUKSINĖ ŽUVELĖ";2242659064;Taip;16;0;0;16
4066;Karusėlė;"AUKSINĖ ŽUVELĖ";3514315636;Taip;14;0;0;14
4067;Karusėlė;"AUKSINĖ ŽUVELĖ";8085919723;Taip;14;0;0;14
4068;Karusėlė;"AUKSINĖ ŽUVELĖ";5444753290;Taip;13;5;0;18
4069;Karusėlė;RAMUNĖ;9344514262;Taip;21;0;0;21
4070;Karusėlė;RAMUNĖ;2215367063;Ne;0;17;0;17
4071;Karusėlė;RAMUNĖ;5146709341;Taip;5;4;0;9
4072;Karusėlė;RAMUNĖ;8331985564;Ne;14;0;0;14
4073;Karusėlė;RAMUNĖ;5803808409;Taip;0;13;0;13
4074;Karusėlė;RAMUNĖ;5855430678;Taip;0;2;1;3
4075;Karusėlė;RAMUNĖ;9400171357;Taip;17;2;0;19
4076;Karusėlė;RAMUNĖ;5766390337;Taip;0;14;0;14
4077;Karusėlė;RAMUNĖ;8987444198;Ne;0;3;0;3
4078;Karusėlė;RAMUNĖ;2007411601;Taip;14;0;0;14
4079;Karusėlė;RAMUNĖ;9996567374;Taip;0;5;2;7
4080;Karusėlė;RAMUNĖ;3696178849;Taip;18;0;0;18
4081;Karusėlė;RAMUNĖ;7814525717;Taip;0;3;0;3
4082;Karusėlė;RAMUNĖ;7489136297;Taip;10;4;0;14
4083;Karusėlė;RAMUNĖ;6424622497;Taip;0;5;0;5
4084;Karusėlė;RAMUNĖ;4879654321;Taip;3;0;0;3
4085;Karusėlė;RAMUNĖ;9656723409;Taip;0;5;0;5
4086;Kaštonas;NYKŠTUKAI;81834426663;Taip;9;4;0;13
4087;Kaštonas;NYKŠTUKAI;4806350914;Taip;15;3;0;18
4088;Kaštonas;NYKŠTUKAI;1781481896;Taip;5;3;0;8
4089;Kaštonas;NYKŠTUKAI;6701145026;Taip;6;3;0;9
4090;Kaštonas;NYKŠTUKAI;9287426151;Taip;5;4;0;9
4091;Kaštonas;NYKŠTUKAI;9168456496;Taip;5;3;0;8
4092;Kaštonas;NYKŠTUKAI;3059036526;Taip;2;3;0;5
4093;Kaštonas;NYKŠTUKAI;8990194475;Taip;0;9;0;9
4094;Kaštonas;NYKŠTUKAI;9702914628;Taip;1;8;0;9
4095;Kaštonas;NYKŠTUKAI;41221846403;Taip;0;1;0;1
4096;Kaštonas;NYKŠTUKAI;3773227028;Taip;0;8;0;8
4097;Kaštonas;NYKŠTUKAI;3863015751;Ne;11;1;0;12
4098;Kaštonas;NYKŠTUKAI;8564586014;Taip;21;0;0;21
4099;Kaštonas;NYKŠTUKAI;5099098185;Taip;0;3;0;3
4100;Kaštonas;NYKŠTUKAI;8166925991;Taip;11;4;0;15
4101;Kaštonas;NYKŠTUKAI;2165890763;Taip;11;1;0;12
4102;Kaštonas;NYKŠTUKAI;2417951642;Taip;5;5;0;10
4103;Kaštonas;NYKŠTUKAI;6511223066;Ne;6;7;0;13
4104;Kaštonas;NYKŠTUKAI;7519302152;Ne;9;5;0;14
4105;Kaštonas;NYKŠTUKAI;5884427036;Taip;17;0;0;17
4106;Kaštonas;DRUGELIAI;7641793210;Taip;0;5;0;5
4107;Kaštonas;DRUGELIAI;54580238237;Taip;0;7;0;7
4108;Kaštonas;DRUGELIAI;17123843027;Ne;0;10;0;10
4109;Kaštonas;DRUGELIAI;16395082273;Taip;0;5;0;5
4110;Kaštonas;DRUGELIAI;7229267783;Taip;10;4;0;14
4111;Kaštonas;DRUGELIAI;47802818774;Taip;0;5;0;5
4112;Kaštonas;DRUGELIAI;52064859848;Taip;0;7;0;7
4113;Kaštonas;DRUGELIAI;8748600333;Taip;0;7;0;7
4114;Kaštonas;DRUGELIAI;87941682538;Taip;3;5;0;8
4115;Kaštonas;DRUGELIAI;64168611850;Taip;0;6;0;6
4116;Kaštonas;DRUGELIAI;37382772659;Ne;0;10;0;10
4117;Kaštonas;DRUGELIAI;1186956315;Taip;9;3;0;12
4118;Kaštonas;DRUGELIAI;7481170301;Taip;0;10;0;10
4119;Kaštonas;DRUGELIAI;76576870173;Taip;0;3;0;3
4120;Kaštonas;DRUGELIAI;1313119270;Taip;10;1;0;11
4121;Kaštonas;DRUGELIAI;41926955433;Taip;6;5;0;11
4122;Kaštonas;DRUGELIAI;1023364928;Taip;9;0;0;9
4123;Kaštonas;DRUGELIAI;1668826784;Taip;0;4;0;4
4124;Kaštonas;DRUGELIAI;1152555202;Ne;2;14;0;16
4125;Kaštonas;DRUGELIAI;46191613797;Ne;0;9;0;9
4126;Kaštonas;DRUGELIAI;1626798162;Taip;6;8;0;14
4127;Kaštonas;DRUGELIAI;1931800904;Ne;5;8;0;13
4128;Kaštonas;DRUGELIAI;89221382880;Taip;10;2;0;12
4129;Kaštonas;KIŠKUČIAI;4444087861;Ne;13;0;0;13
4130;Kaštonas;KIŠKUČIAI;5969052108;Taip;1;0;0;1
4131;Kaštonas;KIŠKUČIAI;5610113641;Taip;4;8;0;12
4132;Kaštonas;KIŠKUČIAI;4824511567;Taip;17;0;0;17
4133;Kaštonas;KIŠKUČIAI;7553024183;Taip;14;1;0;15
4134;Kaštonas;KIŠKUČIAI;8151333699;Taip;16;0;0;16
4135;Kaštonas;KIŠKUČIAI;7841179083;Taip;0;21;0;21
4136;Kaštonas;KIŠKUČIAI;3649329598;Taip;0;12;0;12
4137;Kaštonas;KIŠKUČIAI;7508357392;Taip;5;4;0;9
4138;Kaštonas;KIŠKUČIAI;7956422880;Taip;7;6;0;13
4139;Kaštonas;KIŠKUČIAI;5328263421;Taip;8;1;0;9
4140;Kaštonas;KIŠKUČIAI;4033866425;Taip;0;9;0;9
4141;Kaštonas;KIŠKUČIAI;3961661158;Taip;0;12;0;12
4142;Kaštonas;KIŠKUČIAI;6251564828;Taip;0;17;0;17
4143;Kaštonas;KIŠKUČIAI;7291448857;Taip;16;0;0;16
4144;Kaštonas;KIŠKUČIAI;6175014441;Taip;6;5;0;11
4145;Kaštonas;KIŠKUČIAI;4450146424;Taip;0;14;0;14
4146;Kaštonas;KIŠKUČIAI;8257643251;Taip;14;0;0;14
4147;Kaštonas;KIŠKUČIAI;4215759647;Taip;6;4;0;10
4148;Kaštonas;BITUTĖS;2146285017;Taip;6;7;1;14
4149;Kaštonas;BITUTĖS;3967999408;Taip;10;3;0;13
4150;Kaštonas;BITUTĖS;39974835155;Taip;0;4;0;4
4151;Kaštonas;BITUTĖS;1162926887;Taip;15;0;0;15
4152;Kaštonas;BITUTĖS;1459614385;Taip;6;5;0;11
4153;Kaštonas;BITUTĖS;2801321116;Ne;2;2;0;4
4154;Kaštonas;BITUTĖS;9967553882;Taip;0;7;0;7
4155;Kaštonas;BITUTĖS;27082059521;Taip;0;5;0;5
4156;Kaštonas;BITUTĖS;1465714333;Taip;4;6;0;10
4157;Kaštonas;BITUTĖS;1252815477;Taip;7;4;0;11
4158;Kaštonas;BITUTĖS;9215070593;Taip;2;10;0;12
4159;Kaštonas;BITUTĖS;2149717496;Ne;0;1;0;1
4160;Kaštonas;BITUTĖS;2504312724;Taip;0;5;0;5
4161;Kaštonas;BITUTĖS;57362664278;Taip;0;3;0;3
4162;Kaštonas;BITUTĖS;1747580231;Ne;0;8;0;8
4163;Kaštonas;BITUTĖS;4449017708;Ne;14;1;0;15
4164;Kaštonas;BITUTĖS;3638565578;Ne;0;10;0;10
4165;Kaštonas;BITUTĖS;8906976150;Taip;6;4;0;10
4166;Kaštonas;BITUTĖS;2539596633;Taip;16;0;0;16
4167;Kaštonas;BITUTĖS;7776071299;Taip;11;0;0;11
4168;Kaštonas;BITUTĖS;3039980710;Taip;0;8;0;8
4169;Kaštonas;BITUTĖS;3507672150;Taip;6;5;0;11
4170;Kaštonas;BITUTĖS;1826015013;Taip;14;1;0;15
4171;Kaštonas;BITUTĖS;5630659056;Taip;10;3;0;13
4172;Kaštonas;BITUTĖS;2007064959;Taip;7;7;2;16
4173;Kaštonas;BITUTĖS;1859126564;Ne;0;14;0;14
4174;Kaštonas;BITUTĖS;2797443202;Taip;3;10;0;13
4175;Kaštonas;BITUTĖS;8446233414;Ne;10;9;0;19
4176;Kaštonas;MEŠKIUKAI;8042807487;Taip;7;4;0;11
4177;Kaštonas;MEŠKIUKAI;8297662673;Taip;17;0;0;17
4178;Kaštonas;MEŠKIUKAI;2711819539;Taip;12;5;0;17
4179;Kaštonas;MEŠKIUKAI;1367704050;Taip;4;10;0;14
4180;Kaštonas;MEŠKIUKAI;65960895249;Taip;11;3;0;14
4181;Kaštonas;MEŠKIUKAI;5722934228;Taip;0;5;0;5
4182;Kaštonas;MEŠKIUKAI;1049699735;Taip;14;0;0;14
4183;Kaštonas;MEŠKIUKAI;5557487532;Taip;5;1;0;6
4184;Kaštonas;MEŠKIUKAI;2760501432;Ne;0;6;0;6
4185;Kaštonas;MEŠKIUKAI;70838449788;Ne;5;0;0;5
4186;Kaštonas;MEŠKIUKAI;8797584508;Taip;19;0;0;19
4187;Kaštonas;MEŠKIUKAI;7138581709;Taip;18;0;0;18
4188;Kaštonas;MEŠKIUKAI;9965517774;Taip;18;0;0;18
4189;Kaštonas;MEŠKIUKAI;1249299633;Taip;0;3;0;3
4190;Kaštonas;MEŠKIUKAI;1196590128;Taip;0;8;0;8
4191;Kaštonas;MEŠKIUKAI;1385352925;Taip;2;5;0;7
4192;Kaštonas;MEŠKIUKAI;2125410714;Ne;5;3;0;8
4193;Kaštonas;MEŠKIUKAI;6606094891;Taip;12;1;0;13
4194;Kaštonas;MEŠKIUKAI;1364391105;Taip;12;1;0;13
4195;Kaštonas;MEŠKIUKAI;6967725663;Taip;0;17;0;17
4196;Kaštonas;MEŠKIUKAI;4956177048;Taip;14;0;0;14
4197;Kaštonas;MEŠKIUKAI;5153948802;Taip;11;7;0;18
4198;Kaštonas;MEŠKIUKAI;5157500600;Ne;11;0;0;11
4199;Kaštonas;BORUŽĖLĖS;9069518153;Taip;6;0;0;6
4200;Kaštonas;BORUŽĖLĖS;8214699601;Taip;0;10;0;10
4201;Kaštonas;BORUŽĖLĖS;2106924435;Taip;13;5;0;18
4202;Kaštonas;BORUŽĖLĖS;5307755844;Taip;3;6;0;9
4203;Kaštonas;BORUŽĖLĖS;7408901858;Taip;0;14;0;14
4204;Kaštonas;BORUŽĖLĖS;1761520786;Taip;5;2;0;7
4205;Kaštonas;BORUŽĖLĖS;8483888152;Taip;3;2;0;5
4206;Kaštonas;BORUŽĖLĖS;2877124424;Taip;0;9;0;9
4207;Kaštonas;BORUŽĖLĖS;8250964197;Taip;3;5;0;8
4208;Kaštonas;BORUŽĖLĖS;8275673303;Taip;0;16;0;16
4209;Kaštonas;BORUŽĖLĖS;6289073634;Ne;0;21;0;21
4210;Kaštonas;BORUŽĖLĖS;8582453109;Taip;0;5;0;5
4211;Kaštonas;BORUŽĖLĖS;5391954600;Taip;6;4;0;10
4212;Kaštonas;BORUŽĖLĖS;4616084852;Taip;3;5;0;8
4213;Kaštonas;BORUŽĖLĖS;1748975865;Taip;6;5;0;11
4214;Kaštonas;BORUŽĖLĖS;9285927858;Taip;17;2;0;19
4215;Kaštonas;BORUŽĖLĖS;2434765663;Taip;0;2;0;2
4216;Kaštonas;BORUŽĖLĖS;4837002666;Taip;16;0;0;16
4217;Kaštonas;BORUŽĖLĖS;7813580782;Taip;12;5;0;17
4218;Kaštonas;BORUŽĖLĖS;5659508302;Taip;0;1;0;1
4219;Krivūlė;SPINDULIUKAI;59978148537;Taip;9;2;1;12
4220;Krivūlė;SPINDULIUKAI;10728010124;Taip;2;4;2;8
4221;Krivūlė;SPINDULIUKAI;45328749559;Ne;6;0;0;6
4222;Krivūlė;SPINDULIUKAI;88714209343;Taip;0;0;12;12
4223;Krivūlė;SPINDULIUKAI;50715118246;Taip;10;5;1;16
4224;Krivūlė;SPINDULIUKAI;43180342657;Taip;2;1;3;6
4225;Krivūlė;SPINDULIUKAI;78895964424;Taip;0;4;5;9
4226;Krivūlė;SPINDULIUKAI;9864428506;Taip;5;4;2;11
4227;Krivūlė;SPINDULIUKAI;58431942;Taip;0;4;3;7
4228;Krivūlė;SPINDULIUKAI;48514609257;Taip;0;4;4;8
4229;Krivūlė;SPINDULIUKAI;49698343392;Taip;0;10;0;10
4230;Krivūlė;SPINDULIUKAI;1361647836;Taip;2;4;2;8
4231;Krivūlė;SPINDULIUKAI;3157698386;Taip;0;4;3;7
4232;Krivūlė;SPINDULIUKAI;26046598666;Taip;0;4;7;11
4233;Krivūlė;SPINDULIUKAI;52632731467;Taip;0;4;3;7
4234;Krivūlė;SPINDULIUKAI;1443815293;Taip;0;4;0;4
4235;Krivūlė;SPINDULIUKAI;1980001276;Taip;11;0;0;11
4236;Krivūlė;SPINDULIUKAI;14824959974;Taip;0;4;0;4
4237;Krivūlė;SPINDULIUKAI;65962324027;Ne;2;0;2;4
4238;Krivūlė;SPINDULIUKAI;1738370642;Taip;10;2;0;12
4239;Krivūlė;BORUŽĖLĖS;4969782237;Taip;0;1;8;9
4240;Krivūlė;BORUŽĖLĖS;3605506478;Taip;8;0;0;8
4241;Krivūlė;BORUŽĖLĖS;4896656209;Taip;7;0;0;7
4242;Krivūlė;BORUŽĖLĖS;4845515196;Taip;9;1;0;10
4243;Krivūlė;BORUŽĖLĖS;5676562063;Taip;7;0;1;8
4244;Krivūlė;BORUŽĖLĖS;6935969502;Taip;11;0;0;11
4245;Krivūlė;BORUŽĖLĖS;4972360440;Taip;6;0;2;8
4246;Krivūlė;BORUŽĖLĖS;7318064702;Taip;0;6;4;10
4247;Krivūlė;BORUŽĖLĖS;3912620138;Taip;0;0;4;4
4248;Krivūlė;BORUŽĖLĖS;3246787504;Taip;1;4;2;7
4249;Krivūlė;BORUŽĖLĖS;5531566792;Taip;0;0;6;6
4250;Krivūlė;BORUŽĖLĖS;2386053480;Taip;17;0;4;21
4251;Krivūlė;BORUŽĖLĖS;8586287004;Taip;0;0;16;16
4252;Krivūlė;BORUŽĖLĖS;4540069843;Taip;12;0;0;12
4253;Krivūlė;BORUŽĖLĖS;4297876008;Taip;11;4;0;15
4254;Krivūlė;BORUŽĖLĖS;2138125571;Taip;2;4;0;6
4255;Krivūlė;BORUŽĖLĖS;4257468922;Taip;0;4;0;4
4256;Krivūlė;BORUŽĖLĖS;4177660973;Taip;0;9;0;9
4257;Krivūlė;BORUŽĖLĖS;2517785727;Taip;0;0;1;1
4258;Krivūlė;BORUŽĖLĖS;2711010212;Taip;2;0;10;12
4259;Krivūlė;BORUŽĖLĖS;4025821636;Taip;14;0;0;14
4260;Krivūlė;DRUGELIŲ;1414837177;Taip;7;0;0;7
4261;Krivūlė;DRUGELIŲ;42861843152;Ne;9;0;0;9
4262;Krivūlė;DRUGELIŲ;37447518757;Taip;0;2;3;5
4263;Krivūlė;DRUGELIŲ;91645642209;Taip;13;0;0;13
4264;Krivūlė;DRUGELIŲ;1091759903;Taip;0;0;7;7
4265;Krivūlė;DRUGELIŲ;8646753324;Ne;3;0;1;4
4266;Krivūlė;DRUGELIŲ;3594180341;Ne;5;3;0;8
4267;Krivūlė;DRUGELIŲ;7042541581;Ne;0;3;0;3
4268;Krivūlė;DRUGELIŲ;50967415904;Ne;0;4;7;11
4269;Krivūlė;DRUGELIŲ;80991786508;Taip;5;4;0;9
4270;Krivūlė;DRUGELIŲ;1265788772;Taip;6;1;1;8
4271;Krivūlė;DRUGELIŲ;8463621294;Taip;0;4;2;6
4272;Krivūlė;DRUGELIŲ;55356606791;Taip;8;4;0;12
4273;Krivūlė;DRUGELIŲ;88645409146;Taip;0;1;2;3
4274;Krivūlė;DRUGELIŲ;98620856056;Taip;3;0;0;3
4275;Krivūlė;DRUGELIŲ;2913847919;Ne;4;4;0;8
4276;Krivūlė;DRUGELIŲ;4824008306;Taip;6;0;8;14
4277;Krivūlė;DRUGELIŲ;8500798014;Taip;0;0;6;6
4278;Krivūlė;"BITUTĖS (VALDOFRO)";46337826378;Taip;0;5;0;5
4279;Krivūlė;"BITUTĖS (VALDOFRO)";1588621536;Taip;0;0;7;7
4280;Krivūlė;"BITUTĖS (VALDOFRO)";97075230746;Taip;0;4;1;5
4281;Krivūlė;"BITUTĖS (VALDOFRO)";97859012083;Taip;5;5;0;10
4282;Krivūlė;"BITUTĖS (VALDOFRO)";2425023811;Taip;0;5;0;5
4283;Krivūlė;"BITUTĖS (VALDOFRO)";4838666934;Taip;0;4;0;4
4284;Krivūlė;"BITUTĖS (VALDOFRO)";3994278221;Taip;0;4;0;4
4285;Krivūlė;"BITUTĖS (VALDOFRO)";18486357195;Taip;9;3;2;14
4286;Krivūlė;"BITUTĖS (VALDOFRO)";4248042049;Taip;0;21;0;21
4287;Krivūlė;"BITUTĖS (VALDOFRO)";4982146852;Taip;0;21;0;21
4288;Krivūlė;"BITUTĖS (VALDOFRO)";3769812444;Taip;0;18;3;21
4289;Krivūlė;"BITUTĖS (VALDOFRO)";5128760019;Taip;0;18;3;21
4290;Krivūlė;"BITUTĖS (VALDOFRO)";1851097789;Taip;10;0;0;10
4291;Krivūlė;"BITUTĖS (VALDOFRO)";7789248863;Taip;2;4;0;6
4292;Krivūlė;"BITUTĖS (VALDOFRO)";2647149927;Ne;0;2;7;9
4293;Krivūlė;"BITUTĖS (VALDOFRO)";5113297248;Taip;0;5;8;13
4294;Krivūlė;"BITUTĖS (VALDOFRO)";9632352765;Ne;0;2;6;8
4295;Krivūlė;"BITUTĖS (VALDOFRO)";7848471009;Taip;3;0;4;7
4296;Krivūlė;"BITUTĖS (VALDOFRO)";5405660104;Taip;12;4;1;17
4297;Krivūlė;"BITUTĖS (VALDOFRO)";8834855616;Taip;0;0;3;3
4298;Krivūlė;EŽIUKAI;10433396718;Taip;0;5;0;5
4299;Krivūlė;EŽIUKAI;44741515819;Taip;0;4;0;4
4300;Krivūlė;EŽIUKAI;2099607493;Taip;0;5;3;8
4301;Krivūlė;EŽIUKAI;1290759541;Taip;0;4;1;5
4302;Krivūlė;EŽIUKAI;28308524979;Taip;8;4;0;12
4303;Krivūlė;EŽIUKAI;1590383390;Taip;0;0;2;2
4304;Krivūlė;EŽIUKAI;1699961817;Taip;0;4;7;11
4305;Krivūlė;EŽIUKAI;96319752378;Ne;8;0;0;8
4306;Krivūlė;EŽIUKAI;66981981114;Taip;0;0;1;1
4307;Krivūlė;EŽIUKAI;1113101710;Taip;0;0;3;3
4308;Krivūlė;EŽIUKAI;86659723162;Taip;0;0;6;6
4309;Krivūlė;EŽIUKAI;2125078552;Taip;5;4;2;11
4310;Krivūlė;EŽIUKAI;6753080815;Taip;0;3;4;7
4311;Krivūlė;EŽIUKAI;2903062788;Taip;3;0;4;7
4312;Krivūlė;EŽIUKAI;81401012140;Ne;0;0;5;5
4313;Krivūlė;EŽIUKAI;1039316424;Taip;0;4;2;6
4314;Krivūlė;EŽIUKAI;4648003100;Ne;0;3;0;3
4315;Krivūlė;EŽIUKAI;3655576855;Taip;5;4;2;11
4316;Krivūlė;NYKŠTUKAI;37502093836;Taip;7;4;0;11
4317;Krivūlė;NYKŠTUKAI;83840444975;Taip;7;4;0;11
4318;Krivūlė;NYKŠTUKAI;9267414141;Taip;0;4;1;5
4319;Krivūlė;NYKŠTUKAI;19674882649;Taip;0;4;3;7
4320;Krivūlė;NYKŠTUKAI;701438210;Taip;0;4;5;9
4321;Krivūlė;NYKŠTUKAI;73760357378;Taip;2;4;1;7
4322;Krivūlė;NYKŠTUKAI;3015266398;Taip;0;0;5;5
4323;Krivūlė;NYKŠTUKAI;2109315338;Taip;0;1;0;1
4324;Krivūlė;NYKŠTUKAI;7873123757;Taip;4;5;3;12
4325;Krivūlė;NYKŠTUKAI;97398901468;Taip;4;0;0;4
4326;Krivūlė;NYKŠTUKAI;10005041572;Taip;0;1;0;1
4327;Krivūlė;NYKŠTUKAI;1515185307;Taip;0;4;0;4
4328;Krivūlė;NYKŠTUKAI;1217856292;Ne;7;4;0;11
4329;Krivūlė;NYKŠTUKAI;3064591570;Taip;6;0;4;10
4330;Krivūlė;NYKŠTUKAI;6861483854;Ne;21;0;0;21
4331;Krivūlė;NYKŠTUKAI;3694497590;Taip;15;0;0;15
4332;Krivūlė;NYKŠTUKAI;7052198958;Taip;0;4;1;5
4333;Krivūlė;NYKŠTUKAI;5818988913;Taip;0;0;4;4
4334;Krivūlė;NYKŠTUKAI;6472138102;Taip;0;4;1;5
4335;Krivūlė;"PABIRUČIŲ (Vokiečių g. 1)";5753204752;Ne;0;0;6;6
4336;Krivūlė;"PABIRUČIŲ (Vokiečių g. 1)";2834012936;Taip;6;4;7;17
4337;Krivūlė;"PABIRUČIŲ (Vokiečių g. 1)";6241144079;Ne;0;2;5;7
4338;Krivūlė;"PABIRUČIŲ (Vokiečių g. 1)";7781918674;Taip;3;3;0;6
4339;Krivūlė;"PABIRUČIŲ (Vokiečių g. 1)";2659604299;Taip;4;0;2;6
4340;Krivūlė;"PABIRUČIŲ (Vokiečių g. 1)";2536472220;Taip;0;0;5;5
4341;Krivūlė;"PABIRUČIŲ (Vokiečių g. 1)";7436569684;Taip;0;0;6;6
4342;Krivūlė;"PABIRUČIŲ (Vokiečių g. 1)";1987255206;Taip;13;0;2;15
4343;Krivūlė;"PABIRUČIŲ (Vokiečių g. 1)";6072261879;Taip;20;0;0;20
4344;Krivūlė;"PABIRUČIŲ (Vokiečių g. 1)";7904390075;Ne;7;0;4;11
4345;Krivūlė;"PABIRUČIŲ (Vokiečių g. 1)";5149419581;Taip;0;0;1;1
4346;Krivūlė;"PABIRUČIŲ (Vokiečių g. 1)";7789605738;Taip;19;0;0;19
4347;Krivūlė;"PABIRUČIŲ (Vokiečių g. 1)";2594217776;Taip;5;0;3;8
4348;Krivūlė;"PABIRUČIŲ (Vokiečių g. 1)";5097101097;Taip;0;1;1;2
4349;Krivūlė;"PABIRUČIŲ (Vokiečių g. 1)";2408038213;Taip;12;4;0;16
4350;Krivūlė;"PABIRUČIŲ (Vokiečių g. 1)";9693693101;Taip;3;0;12;15
4351;Krivūlė;"PABIRUČIŲ (Vokiečių g. 1)";5462491857;Taip;4;0;0;4
4352;Krivūlė;"SMALSUČIŲ (Vokiečių g.1)";1113026818;Taip;4;4;0;8
4353;Krivūlė;"SMALSUČIŲ (Vokiečių g.1)";38355661182;Taip;6;4;6;16
4354;Krivūlė;"SMALSUČIŲ (Vokiečių g.1)";3405470634;Ne;10;0;0;10
4355;Krivūlė;"SMALSUČIŲ (Vokiečių g.1)";1371753067;Ne;0;0;4;4
4356;Krivūlė;"SMALSUČIŲ (Vokiečių g.1)";8301938009;Ne;0;0;2;2
4357;Krivūlė;"SMALSUČIŲ (Vokiečių g.1)";2769668641;Taip;0;0;6;6
4358;Krivūlė;"SMALSUČIŲ (Vokiečių g.1)";4668155071;Taip;0;0;7;7
4359;Krivūlė;"SMALSUČIŲ (Vokiečių g.1)";1774829898;Taip;8;0;1;9
4360;Krivūlė;"SMALSUČIŲ (Vokiečių g.1)";55527703561;Ne;0;0;5;5
4361;Krivūlė;"SMALSUČIŲ (Vokiečių g.1)";20999997254;Ne;0;3;2;5
4362;Krivūlė;"SMALSUČIŲ (Vokiečių g.1)";3583848327;Taip;0;4;8;12
4363;Krivūlė;"SMALSUČIŲ (Vokiečių g.1)";16591459661;Ne;0;0;9;9
4364;Krivūlė;"SMALSUČIŲ (Vokiečių g.1)";6429160371;Taip;4;0;7;11
4365;Krivūlė;"SMALSUČIŲ (Vokiečių g.1)";3924127476;Taip;0;5;0;5
4366;Krivūlė;"SMALSUČIŲ (Vokiečių g.1)";4261133734;Taip;7;0;2;9
4367;Krivūlė;"SMALSUČIŲ (Vokiečių g.1)";9388057389;Taip;6;4;4;14
4368;Krivūlė;"SMALSUČIŲ (Vokiečių g.1)";9801268758;Ne;4;0;0;4
4369;Krivūlė;"SMALSUČIŲ (Vokiečių g.1)";20743334216;Ne;0;9;0;9
4370;Krivūlė;"GUDRUČIŲ (Vokiečių g. 1)";8285580095;Taip;0;0;14;14
4371;Krivūlė;"GUDRUČIŲ (Vokiečių g. 1)";2096035763;Taip;0;6;0;6
4372;Krivūlė;"GUDRUČIŲ (Vokiečių g. 1)";80775017833;Taip;0;0;4;4
4373;Krivūlė;"GUDRUČIŲ (Vokiečių g. 1)";29755294214;Taip;0;0;1;1
4374;Krivūlė;"GUDRUČIŲ (Vokiečių g. 1)";6687699907;Taip;0;5;0;5
4375;Krivūlė;"GUDRUČIŲ (Vokiečių g. 1)";1587218379;Taip;6;4;0;10
4376;Krivūlė;"GUDRUČIŲ (Vokiečių g. 1)";2096927238;Ne;0;4;0;4
4377;Krivūlė;"GUDRUČIŲ (Vokiečių g. 1)";8301904575;Taip;11;0;0;11
4378;Krivūlė;"GUDRUČIŲ (Vokiečių g. 1)";49106308532;Taip;0;4;0;4
4379;Krivūlė;"GUDRUČIŲ (Vokiečių g. 1)";1600378710;Ne;0;0;4;4
4380;Krivūlė;"GUDRUČIŲ (Vokiečių g. 1)";1974755599;Taip;0;5;0;5
4381;Krivūlė;"GUDRUČIŲ (Vokiečių g. 1)";7477773004;Taip;5;0;1;6
4382;Krivūlė;"GUDRUČIŲ (Vokiečių g. 1)";2077383621;Taip;0;4;0;4
4383;Krivūlė;"GUDRUČIŲ (Vokiečių g. 1)";27151485531;Taip;1;4;4;9
4384;Krivūlė;"GUDRUČIŲ (Vokiečių g. 1)";1180183091;Taip;11;10;0;21
4385;Krivūlė;"GUDRUČIŲ (Vokiečių g. 1)";6543038595;Taip;0;1;3;4
4386;Krivūlė;"GUDRUČIŲ (Vokiečių g. 1)";1616662586;Ne;14;4;3;21
4387;Krivūlė;"GUDRUČIŲ (Vokiečių g. 1)";50186813736;Taip;11;0;0;11
4388;Kodėlčiukas;Saulutės;6517880481;Taip;10;0;0;10
4389;Kodėlčiukas;Saulutės;7080578299;Taip;11;4;3;18
4390;Kodėlčiukas;Saulutės;1725624698;Taip;0;6;0;6
4391;Kodėlčiukas;Saulutės;8393893311;Taip;9;0;0;9
4392;Kodėlčiukas;Saulutės;7509476161;Taip;8;0;0;8
4393;Kodėlčiukas;Saulutės;7327247516;Taip;3;0;0;3
4394;Kodėlčiukas;Saulutės;1645680526;Taip;2;3;0;5
4395;Kodėlčiukas;Saulutės;8992265000;Taip;9;0;2;11
4396;Kodėlčiukas;Saulutės;6285018663;Taip;12;1;0;13
4397;Kodėlčiukas;Saulutės;1033969800;Ne;15;0;0;15
4398;Kodėlčiukas;Saulutės;4179140476;Taip;21;0;0;21
4399;Kodėlčiukas;Saulutės;2433094435;Ne;8;0;1;9
4400;Kodėlčiukas;Saulutės;9042404309;Taip;0;0;9;9
4401;Kodėlčiukas;Saulutės;3276075664;Taip;0;2;1;3
4402;Kodėlčiukas;Saulutės;9476376350;Taip;0;0;1;1
4403;Kodėlčiukas;Saulutės;3141225891;Taip;0;4;6;10
4404;Kodėlčiukas;Saulutės;3315824027;Taip;14;0;2;16
4405;Kodėlčiukas;Saulutės;6692168722;Taip;16;0;0;16
4406;Kodėlčiukas;Saulutės;7611485881;Taip;1;4;0;5
4407;Kodėlčiukas;Nežiniukai;6045564826;Taip;19;0;0;19
4408;Kodėlčiukas;Nežiniukai;7136890681;Taip;1;0;0;1
4409;Kodėlčiukas;Nežiniukai;7971932716;Taip;1;0;0;1
4410;Kodėlčiukas;Nežiniukai;7282579315;Taip;0;0;2;2
4411;Kodėlčiukas;Nežiniukai;6905424567;Taip;5;0;2;7
4412;Kodėlčiukas;Nežiniukai;1233880820;Taip;21;0;0;21
4413;Kodėlčiukas;Nežiniukai;5443377251;Taip;6;4;2;12
4414;Kodėlčiukas;Nežiniukai;3150006441;Taip;2;3;3;8
4415;Kodėlčiukas;Nežiniukai;7626940433;Taip;6;3;0;9
4416;Kodėlčiukas;Nežiniukai;9803206596;Taip;9;0;0;9
4417;Kodėlčiukas;Nežiniukai;4917910801;Taip;16;0;0;16
4418;Kodėlčiukas;Nežiniukai;6248137523;Taip;0;0;1;1
4419;Kodėlčiukas;Nežiniukai;1699358514;Taip;13;0;0;13
4420;Kodėlčiukas;Nežiniukai;3473981974;Taip;12;0;0;12
4421;Kodėlčiukas;Nežiniukai;4038168647;Taip;16;4;0;20
4422;Kodėlčiukas;Nežiniukai;8378295683;Taip;0;11;0;11
4423;Kodėlčiukas;Nežiniukai;6000831611;Taip;7;0;0;7
4424;Kodėlčiukas;Nežiniukai;7286497455;Taip;0;0;10;10
4425;Kodėlčiukas;Nežiniukai;1603752483;Taip;9;0;1;10
4426;Kodėlčiukas;Nežiniukai;6074758814;Ne;2;9;0;11
4427;Kodėlčiukas;Gintarėliai;2560864315;Taip;0;4;0;4
4428;Kodėlčiukas;Gintarėliai;58406224468;Taip;0;9;0;9
4429;Kodėlčiukas;Gintarėliai;1485012710;Taip;5;0;2;7
4430;Kodėlčiukas;Gintarėliai;5520128823;Taip;9;1;2;12
4431;Kodėlčiukas;Gintarėliai;2062878300;Taip;14;4;0;18
4432;Kodėlčiukas;Gintarėliai;20084022099;Taip;4;0;4;8
4433;Kodėlčiukas;Gintarėliai;1950934087;Taip;6;0;0;6
4434;Kodėlčiukas;Gintarėliai;4884104023;Taip;12;0;3;15
4435;Kodėlčiukas;Gintarėliai;1632458573;Taip;4;0;1;5
4436;Kodėlčiukas;Gintarėliai;9332136116;Taip;11;0;0;11
4437;Kodėlčiukas;Gintarėliai;4944791330;Taip;0;4;5;9
4438;Kodėlčiukas;Gintarėliai;8219424737;Taip;16;0;0;16
4439;Kodėlčiukas;Gintarėliai;4849314647;Taip;0;0;1;1
4440;Kodėlčiukas;Gintarėliai;5202375085;Taip;6;0;0;6
4441;Kodėlčiukas;Gintarėliai;3758606327;Taip;3;4;2;9
4442;Kodėlčiukas;Gintarėliai;8647609373;Taip;21;0;0;21
4443;Kodėlčiukas;Gintarėliai;4738357524;Taip;0;0;7;7
4444;Kodėlčiukas;Gintarėliai;8075591032;Taip;7;5;0;12
4445;Kodėlčiukas;Gintarėliai;8873629130;Taip;16;0;0;16
4446;Kodėlčiukas;Šnekučiai;1844016431;Taip;11;0;1;12
4447;Kodėlčiukas;Šnekučiai;1550915654;Taip;2;0;2;4
4448;Kodėlčiukas;Šnekučiai;1935757837;Taip;3;11;0;14
4449;Kodėlčiukas;Šnekučiai;41123326737;Taip;0;3;0;3
4450;Kodėlčiukas;Šnekučiai;8114859362;Taip;5;4;5;14
4451;Kodėlčiukas;Šnekučiai;1666743304;Ne;6;0;0;6
4452;Kodėlčiukas;Šnekučiai;1432342305;Taip;5;0;4;9
4453;Kodėlčiukas;Šnekučiai;1584936719;Taip;9;0;0;9
4454;Kodėlčiukas;Šnekučiai;9178209049;Taip;0;2;11;13
4455;Kodėlčiukas;Šnekučiai;5988863934;Taip;0;15;0;15
4456;Kodėlčiukas;Šnekučiai;2742365461;Taip;0;6;0;6
4457;Kodėlčiukas;Šnekučiai;76164689333;Ne;12;4;0;16
4458;Kodėlčiukas;Šnekučiai;5386820408;Ne;0;12;0;12
4459;Kodėlčiukas;Šnekučiai;6194726931;Taip;5;7;0;12
4460;Kodėlčiukas;Šnekučiai;5782600824;Taip;0;2;3;5
4461;Kodėlčiukas;Šnekučiai;7074381835;Ne;16;3;0;19
4462;Kodėlčiukas;Šnekučiai;7757494295;Taip;0;15;0;15
4463;Kodėlčiukas;Šnekučiai;2988674717;Taip;8;5;0;13
4464;Kodėlčiukas;Šnekučiai;1834696935;Taip;0;0;1;1
4465;Kodėlčiukas;Šnekučiai;4273202718;Taip;9;4;0;13
4466;Kodėlčiukas;Pabiručiai;7630180473;Taip;10;0;3;13
4467;Kodėlčiukas;Pabiručiai;8140940288;Taip;0;4;0;4
4468;Kodėlčiukas;Pabiručiai;7246243975;Ne;7;4;0;11
4469;Kodėlčiukas;Pabiručiai;1600501494;Taip;7;4;0;11
4470;Kodėlčiukas;Pabiručiai;3782714343;Taip;4;0;0;4
4471;Kodėlčiukas;Pabiručiai;3880019350;Taip;20;0;1;21
4472;Kodėlčiukas;Pabiručiai;4818678923;Ne;14;0;1;15
4473;Kodėlčiukas;Pabiručiai;9589692031;Taip;15;0;3;18
4474;Kodėlčiukas;Pabiručiai;1906128091;Taip;11;4;0;15
4475;Kodėlčiukas;Pabiručiai;8302606312;Taip;2;9;2;13
4476;Kodėlčiukas;Pabiručiai;9460792167;Taip;7;1;1;9
4477;Kodėlčiukas;Pabiručiai;1218904283;Taip;13;0;4;17
4478;Kodėlčiukas;Pabiručiai;2929946390;Taip;13;2;0;15
4479;Kodėlčiukas;Pabiručiai;7324303899;Taip;0;2;2;4
4480;Kodėlčiukas;Pabiručiai;1256650715;Taip;15;0;1;16
4481;Kodėlčiukas;Pabiručiai;1052656432;Taip;2;0;0;2
4482;Kodėlčiukas;Pabiručiai;9794875862;Taip;0;0;2;2
4483;Kodėlčiukas;Pabiručiai;9528997865;Taip;17;4;0;21
4484;Kodėlčiukas;Pabiručiai;1919722425;Taip;0;4;1;5
4485;Kodėlčiukas;Pabiručiai;2593524511;Taip;0;4;1;5
4486;Kodėlčiukas;Pabiručiai;8879977943;Taip;9;2;0;11
4487;Kodėlčiukas;Smalsučiai;49317624340;Taip;0;10;2;12
4488;Kodėlčiukas;Smalsučiai;41477530966;Taip;0;0;1;1
4489;Kodėlčiukas;Smalsučiai;69860272843;Taip;0;5;0;5
4490;Kodėlčiukas;Smalsučiai;52040715568;Ne;0;12;0;12
4491;Kodėlčiukas;Smalsučiai;37852137155;Taip;0;4;0;4
4492;Kodėlčiukas;Smalsučiai;86134523927;Taip;6;4;0;10
4493;Kodėlčiukas;Smalsučiai;46307870009;Taip;9;4;4;17
4494;Kodėlčiukas;Smalsučiai;35337024913;Taip;0;8;0;8
4495;Kodėlčiukas;Smalsučiai;33432780322;Taip;15;4;0;19
4496;Kodėlčiukas;Smalsučiai;96270550335;Taip;5;7;0;12
4497;Kodėlčiukas;Smalsučiai;35779814505;Taip;2;4;5;11
4498;Kodėlčiukas;Smalsučiai;50234358109;Taip;9;0;2;11
4499;Kodėlčiukas;Smalsučiai;53066448447;Ne;9;4;3;16
4500;Kodėlčiukas;Smalsučiai;1518135854;Ne;0;3;0;3
4501;Kodėlčiukas;Smalsučiai;93698504377;Taip;0;9;0;9
4502;Kodėlčiukas;Smalsučiai;1951603132;Taip;9;0;0;9
4503;Kodėlčiukas;Smalsučiai;1614088526;Taip;7;0;0;7
4504;Kodėlčiukas;Smalsučiai;15211280060;Taip;2;5;0;7
4505;Kodėlčiukas;Smalsučiai;41664027247;Taip;3;10;0;13
4506;Kodėlčiukas;Smalsučiai;1291132247;Taip;1;2;2;5
4507;Kodėlčiukas;Giliukai;26010333641;Taip;0;11;1;12
4508;Kodėlčiukas;Giliukai;90443995599;Taip;0;7;0;7
4509;Kodėlčiukas;Giliukai;97902789189;Taip;5;4;0;9
4510;Kodėlčiukas;Giliukai;99164081259;Taip;0;4;0;4
4511;Kodėlčiukas;Giliukai;93684599166;Taip;12;4;0;16
4512;Kodėlčiukas;Giliukai;88371652763;Taip;0;4;0;4
4513;Kodėlčiukas;Giliukai;80767435810;Taip;0;4;6;10
4514;Kodėlčiukas;Giliukai;1825630143;Taip;15;4;0;19
4515;Kodėlčiukas;Giliukai;11130172902;Taip;3;4;1;8
4516;Kodėlčiukas;Giliukai;29830674331;Taip;0;4;0;4
4517;Kodėlčiukas;Giliukai;1330761392;Taip;6;4;0;10
4518;Kodėlčiukas;Giliukai;84905680496;Taip;10;3;0;13
4519;Kodėlčiukas;Giliukai;58893099621;Taip;0;2;2;4
4520;Kodėlčiukas;Giliukai;2637712514;Taip;0;4;3;7
4521;Kodėlčiukas;Giliukai;1354133871;Taip;0;0;10;10
4522;Kodėlčiukas;Giliukai;45393129631;Taip;6;0;2;8
4523;Kodėlčiukas;Giliukai;47667750562;Taip;0;4;2;6
4524;Kodėlčiukas;Giliukai;8204069897;Taip;0;4;0;4
4525;Kodėlčiukas;Giliukai;1938753417;Taip;0;0;1;1
4526;Kodėlčiukas;Giliukai;29319461634;Taip;7;4;0;11
4527;Kodėlčiukas;Gudručiai;20467065338;Ne;2;0;4;6
4528;Kodėlčiukas;Gudručiai;15580950604;Taip;0;0;7;7
4529;Kodėlčiukas;Gudručiai;32318234528;Ne;2;0;5;7
4530;Kodėlčiukas;Gudručiai;9315712284;Taip;0;0;6;6
4531;Kodėlčiukas;Gudručiai;18557158044;Taip;0;5;0;5
4532;Kodėlčiukas;Gudručiai;3542081571;Ne;7;0;1;8
4533;Kodėlčiukas;Gudručiai;84450296241;Taip;0;4;0;4
4534;Kodėlčiukas;Gudručiai;1234971388;Taip;0;4;1;5
4535;Kodėlčiukas;Gudručiai;1048653620;Ne;0;5;0;5
4536;Kodėlčiukas;Gudručiai;1662717348;Taip;3;0;4;7
4537;Kodėlčiukas;Gudručiai;1978279511;Taip;0;0;9;9
4538;Kodėlčiukas;Gudručiai;1251970125;Taip;0;0;3;3
4539;Kodėlčiukas;Gudručiai;6186365121;Taip;0;4;0;4
4540;Kodėlčiukas;Gudručiai;70940790491;Taip;9;0;1;10
4541;Kodėlčiukas;Gudručiai;6168432879;Taip;8;0;4;12
4542;Kodėlčiukas;Gudručiai;1106092960;Taip;0;1;3;4
4543;Kodėlčiukas;Gudručiai;8393750817;Taip;0;0;10;10
4544;Kodėlčiukas;Gudručiai;2061169442;Taip;8;0;2;10
4545;Kodėlčiukas;Gudručiai;1115828736;Taip;0;4;0;4
4546;Kodėlčiukas;Gudručiai;1723716524;Taip;2;4;1;7
4547;Kodėlčiukas;Gudručiai;87784905691;Taip;0;4;0;4
4548;Kodėlčiukas;Žirniukai;6988515253;Taip;21;0;0;21
4549;Kodėlčiukas;Žirniukai;3385551650;Taip;13;0;1;14
4550;Kodėlčiukas;Žirniukai;7430239198;Taip;12;0;2;14
4551;Kodėlčiukas;Žirniukai;7116594055;Taip;8;0;1;9
4552;Kodėlčiukas;Žirniukai;8890987483;Taip;6;0;0;6
4553;Kodėlčiukas;Žirniukai;4687333060;Taip;5;5;0;10
4554;Kodėlčiukas;Žirniukai;1491160730;Taip;2;0;0;2
4555;Kodėlčiukas;Žirniukai;2216791610;Taip;0;4;2;6
4556;Kodėlčiukas;Žirniukai;8400610717;Taip;11;0;0;11
4557;Kodėlčiukas;Žirniukai;9483378853;Ne;17;1;0;18
4558;Kodėlčiukas;Žirniukai;1191430672;Taip;8;0;0;8
4559;Kodėlčiukas;Žirniukai;3427610168;Taip;21;0;0;21
4560;Kodėlčiukas;Žirniukai;4543838852;Taip;14;0;0;14
4561;Kodėlčiukas;Žirniukai;7318908956;Taip;17;0;0;17
4562;Kodėlčiukas;Žirniukai;7326475644;Taip;17;0;4;21
4563;Kodėlčiukas;Žirniukai;9865803714;Ne;0;0;12;12
4564;Kodėlčiukas;Žirniukai;1801366890;Taip;12;0;0;12
4565;Kodėlčiukas;Žirniukai;6985788287;Taip;11;0;2;13
4566;Kodėlčiukas;Katinėliai;1087808091;Taip;2;4;2;8
4567;Kodėlčiukas;Katinėliai;2904858964;Taip;7;4;2;13
4568;Kodėlčiukas;Katinėliai;2987907651;Taip;6;0;2;8
4569;Kodėlčiukas;Katinėliai;3413659259;Taip;0;0;1;1
4570;Kodėlčiukas;Katinėliai;9278139998;Taip;8;0;0;8
4571;Kodėlčiukas;Katinėliai;8784531004;Taip;0;2;11;13
4572;Kodėlčiukas;Katinėliai;6008027505;Taip;0;5;0;5
4573;Kodėlčiukas;Katinėliai;7318196860;Taip;11;2;2;15
4574;Kodėlčiukas;Katinėliai;6014084915;Taip;0;11;0;11
4575;Kodėlčiukas;Katinėliai;1588132166;Taip;7;1;0;8
4576;Kodėlčiukas;Katinėliai;1180399735;Taip;0;0;5;5
4577;Kodėlčiukas;Katinėliai;8189938439;Taip;8;9;0;17
4578;Kodėlčiukas;Katinėliai;2964318343;Taip;17;0;0;17
4579;Kodėlčiukas;Katinėliai;1039982141;Taip;9;0;1;10
4580;Kodėlčiukas;Katinėliai;8427457478;Taip;20;0;0;20
4581;Kodėlčiukas;Nykštukai;3315862631;Taip;11;4;2;17
4582;Kodėlčiukas;Nykštukai;1705030069;Taip;21;0;0;21
4583;Kodėlčiukas;Nykštukai;9645987751;Taip;12;0;1;13
4584;Kodėlčiukas;Nykštukai;5860975805;Taip;4;0;0;4
4585;Kodėlčiukas;Nykštukai;8782155591;Taip;4;0;0;4
4586;Kodėlčiukas;Nykštukai;8104220950;Taip;0;5;0;5
4587;Kodėlčiukas;Nykštukai;2005453189;Taip;0;0;3;3
4588;Kodėlčiukas;Nykštukai;3442449482;Taip;5;0;1;6
4589;Kodėlčiukas;Nykštukai;8563412043;Taip;5;0;0;5
4590;Kodėlčiukas;Nykštukai;1683506414;Taip;14;0;0;14
4591;Kodėlčiukas;Nykštukai;7946010973;Taip;17;0;0;17
4592;Kodėlčiukas;Nykštukai;8971395173;Taip;14;0;0;14
4593;Kodėlčiukas;Nykštukai;8208448849;Taip;11;0;0;11
4594;Kodėlčiukas;Nykštukai;5896726125;Taip;4;0;2;6
4595;Kodėlčiukas;Nykštukai;3168418461;Taip;15;1;0;16
4596;Kodėlčiukas;Nykštukai;3068084704;Taip;21;0;0;21
4597;Kodėlčiukas;Nykštukai;5173730926;Taip;2;10;1;13
4598;Kodėlčiukas;Nykštukai;1289342844;Taip;9;3;0;12
4599;Kodėlčiukas;ŽIOGELIAI;2921181385;Taip;8;0;0;8
4600;Kodėlčiukas;ŽIOGELIAI;8263945732;Taip;3;0;4;7
4601;Kodėlčiukas;ŽIOGELIAI;4218096561;Taip;0;7;0;7
4602;Kodėlčiukas;ŽIOGELIAI;4514764005;Taip;0;0;1;1
4603;Kodėlčiukas;ŽIOGELIAI;2169307879;Taip;16;0;0;16
4604;Kodėlčiukas;ŽIOGELIAI;8910195286;Taip;5;0;3;8
4605;Kodėlčiukas;ŽIOGELIAI;4585226357;Taip;18;0;0;18
4606;Kodėlčiukas;ŽIOGELIAI;4884233329;Taip;21;0;0;21
4607;Kodėlčiukas;ŽIOGELIAI;4937929385;Taip;11;6;0;17
4608;Kodėlčiukas;ŽIOGELIAI;4165123345;Taip;19;0;0;19
4609;Kodėlčiukas;ŽIOGELIAI;5513530983;Taip;2;0;1;3
4610;Kodėlčiukas;ŽIOGELIAI;9135807341;Taip;14;0;2;16
4611;Kodėlčiukas;ŽIOGELIAI;6476445296;Taip;2;0;3;5
4612;Kodėlčiukas;ŽIOGELIAI;7612531087;Taip;0;4;1;5
4613;Kodėlčiukas;ŽIOGELIAI;6714818379;Taip;0;9;1;10
4614;Kodėlčiukas;ŽIOGELIAI;2808361570;Taip;6;0;1;7
4615;Kodėlčiukas;ŽIOGELIAI;2448536092;Ne;13;0;0;13
4616;Kodėlčiukas;BITUTĖS;3240221130;Taip;12;0;0;12
4617;Kodėlčiukas;BITUTĖS;5772071707;Taip;10;0;0;10
4618;Kodėlčiukas;BITUTĖS;5577154148;Taip;17;0;0;17
4619;Kodėlčiukas;BITUTĖS;1149682376;Taip;16;0;0;16
4620;Kodėlčiukas;BITUTĖS;9139424911;Taip;6;0;0;6
4621;Kodėlčiukas;BITUTĖS;5197946954;Taip;17;0;0;17
4622;Kodėlčiukas;BITUTĖS;7587203481;Taip;2;3;0;5
4623;Kodėlčiukas;BITUTĖS;2140552221;Taip;2;1;0;3
4624;Kodėlčiukas;BITUTĖS;9979034031;Taip;21;0;0;21
4625;Kodėlčiukas;BITUTĖS;4777496709;Taip;10;0;4;14
4626;Kodėlčiukas;BITUTĖS;7714816675;Taip;17;0;0;17
4627;Kodėlčiukas;BITUTĖS;3267687337;Taip;12;0;0;12
4628;Kodėlčiukas;BITUTĖS;4202423480;Taip;2;3;0;5
4629;Kodėlčiukas;BITUTĖS;9664432781;Taip;13;0;1;14
4630;Kodėlčiukas;BITUTĖS;8547039654;Taip;7;0;0;7
4631;Kodėlčiukas;BITUTĖS;5505788210;Taip;0;3;0;3
4632;Kodėlčiukas;BITUTĖS;6106526012;Taip;21;0;0;21
4633;Kodėlčiukas;BITUTĖS;2353960861;Taip;2;1;0;3
4634;Kodėlčiukas;VYŠNIUKAI;2162480212;Taip;0;0;1;1
4635;Kodėlčiukas;VYŠNIUKAI;3482802557;Taip;14;0;0;14
4636;Kodėlčiukas;VYŠNIUKAI;3778271049;Ne;7;4;1;12
4637;Kodėlčiukas;VYŠNIUKAI;1074477043;Taip;1;1;9;11
4638;Kodėlčiukas;VYŠNIUKAI;2542104903;Taip;10;0;4;14
4639;Kodėlčiukas;VYŠNIUKAI;3470151604;Taip;2;0;1;3
4640;Kodėlčiukas;VYŠNIUKAI;7510273691;Ne;9;0;2;11
4641;Kodėlčiukas;VYŠNIUKAI;4490196764;Ne;5;0;0;5
4642;Kodėlčiukas;VYŠNIUKAI;6761903865;Ne;6;0;0;6
4643;Kodėlčiukas;VYŠNIUKAI;9527296531;Taip;0;9;0;9
4644;Kodėlčiukas;VYŠNIUKAI;2351468626;Taip;12;4;0;16
4645;Kodėlčiukas;VYŠNIUKAI;6764015170;Ne;15;6;0;21
4646;Kodėlčiukas;VYŠNIUKAI;8447045958;Taip;13;0;0;13
4647;Kodėlčiukas;VYŠNIUKAI;7647582987;Ne;0;0;6;6
4648;Kodėlčiukas;VYŠNIUKAI;3403889915;Taip;12;5;0;17
4649;Kodėlčiukas;VYŠNIUKAI;1160612316;Taip;21;0;0;21
4650;Kodėlčiukas;VYŠNIUKAI;8606551477;Taip;13;0;0;13
4651;Kodėlčiukas;VYŠNIUKAI;8070400563;Taip;4;0;3;7
4652;Kodėlčiukas;VYŠNIUKAI;1992569595;Ne;7;0;9;16
4653;Kodėlčiukas;BORUŽĖLĖS;9109362006;Taip;7;0;1;8
4654;Kodėlčiukas;BORUŽĖLĖS;9169500252;Ne;7;0;7;14
4655;Kodėlčiukas;BORUŽĖLĖS;9724373368;Taip;2;9;4;15
4656;Kodėlčiukas;BORUŽĖLĖS;6941978169;Taip;9;0;0;9
4657;Kodėlčiukas;BORUŽĖLĖS;5075801618;Taip;11;4;0;15
4658;Kodėlčiukas;BORUŽĖLĖS;2819860331;Taip;0;3;0;3
4659;Kodėlčiukas;BORUŽĖLĖS;4941186694;Ne;6;0;1;7
4660;Kodėlčiukas;BORUŽĖLĖS;4866089623;Ne;0;0;6;6
4661;Kodėlčiukas;BORUŽĖLĖS;5952121209;Taip;15;4;0;19
4662;Kodėlčiukas;BORUŽĖLĖS;4230906452;Ne;0;0;6;6
4663;Kodėlčiukas;BORUŽĖLĖS;6505671642;Taip;0;0;1;1
4664;Kodėlčiukas;BORUŽĖLĖS;5985806014;Ne;6;2;0;8
4665;Kodėlčiukas;BORUŽĖLĖS;8779350309;Taip;0;0;3;3
4666;Kodėlčiukas;BORUŽĖLĖS;9208137169;Ne;6;3;6;15
4667;Kodėlčiukas;BORUŽĖLĖS;5876187643;Taip;0;0;2;2
4668;Kodėlčiukas;BORUŽĖLĖS;1206798597;Taip;2;4;1;7
4669;Kodėlčiukas;BORUŽĖLĖS;6587593805;Taip;0;0;3;3
4670;Kodėlčiukas;BORUŽĖLĖS;1827752731;Taip;5;4;1;10
4671;Kodėlčiukas;BORUŽĖLĖS;1005178052;Taip;4;6;0;10
4672;Kodėlčiukas;BORUŽĖLĖS;9252478832;Taip;5;0;1;6
4673;Kodėlčiukas;VYTURĖLIAI;42540143229;Taip;8;4;0;12
4674;Kodėlčiukas;VYTURĖLIAI;5922075420;Taip;6;1;3;10
4675;Kodėlčiukas;VYTURĖLIAI;82725509126;Taip;5;4;3;12
4676;Kodėlčiukas;VYTURĖLIAI;79742559803;Taip;2;4;0;6
4677;Kodėlčiukas;VYTURĖLIAI;68236236113;Taip;0;4;2;6
4678;Kodėlčiukas;VYTURĖLIAI;62309098505;Taip;4;4;1;9
4679;Kodėlčiukas;VYTURĖLIAI;14611425618;Ne;0;4;0;4
4680;Kodėlčiukas;VYTURĖLIAI;43335982030;Taip;0;4;3;7
4681;Kodėlčiukas;VYTURĖLIAI;49731697380;Taip;0;3;1;4
4682;Kodėlčiukas;VYTURĖLIAI;23065888472;Taip;0;5;0;5
4683;Kodėlčiukas;VYTURĖLIAI;98738524708;Taip;6;4;2;12
4684;Kodėlčiukas;VYTURĖLIAI;1905426469;Taip;0;6;2;8
4685;Kodėlčiukas;VYTURĖLIAI;1730913401;Taip;0;4;3;7
4686;Kodėlčiukas;VYTURĖLIAI;66109277013;Taip;0;6;0;6
4687;Kodėlčiukas;VYTURĖLIAI;1608321100;Taip;0;2;0;2
4688;Kodėlčiukas;VYTURĖLIAI;45910018746;Taip;10;6;0;16
4689;Kodėlčiukas;VYTURĖLIAI;48669541733;Taip;0;8;0;8
4690;Kodėlčiukas;VYTURĖLIAI;30952731344;Taip;0;4;0;4
4691;Kodėlčiukas;VYTURĖLIAI;1290630625;Taip;19;0;1;20
4692;Kodėlčiukas;VYTURĖLIAI;79090323340;Taip;0;6;1;7
4693;Kodėlčiukas;VYTURĖLIAI;49784617790;Taip;0;6;1;7
4694;Kodėlčiukas;DRUGELIAI;1850261935;Taip;18;0;0;18
4695;Kodėlčiukas;DRUGELIAI;6612336444;Taip;1;4;2;7
4696;Kodėlčiukas;DRUGELIAI;1645423279;Taip;5;4;3;12
4697;Kodėlčiukas;DRUGELIAI;1215911875;Taip;0;4;13;17
4698;Kodėlčiukas;DRUGELIAI;1333587997;Ne;0;4;0;4
4699;Kodėlčiukas;DRUGELIAI;7479165635;Taip;0;7;1;8
4700;Kodėlčiukas;DRUGELIAI;56907458719;Ne;0;4;1;5
4701;Kodėlčiukas;DRUGELIAI;9645382151;Taip;3;1;2;6
4702;Kodėlčiukas;DRUGELIAI;1208194459;Taip;6;1;2;9
4703;Kodėlčiukas;DRUGELIAI;1111723773;Taip;6;1;2;9
4704;Kodėlčiukas;DRUGELIAI;1550337708;Ne;4;0;0;4
4705;Kodėlčiukas;DRUGELIAI;24138056567;Taip;0;4;2;6
4706;Kodėlčiukas;DRUGELIAI;44431255380;Taip;0;3;3;6
4707;Kodėlčiukas;DRUGELIAI;93275059990;Taip;3;6;0;9
4708;Kodėlčiukas;DRUGELIAI;82927457803;Taip;0;4;0;4
4709;Kodėlčiukas;DRUGELIAI;50411894014;Ne;0;4;3;7
4710;Kodėlčiukas;DRUGELIAI;4030981879;Taip;0;4;1;5
4711;Kodėlčiukas;DRUGELIAI;1782784297;Taip;0;10;0;10
4712;Kodėlčiukas;DRUGELIAI;37250933602;Taip;5;7;0;12
4713;Klevelis;Gėlytės;1953918266;Taip;0;10;0;10
4714;Klevelis;Gėlytės;40799074112;Taip;0;4;0;4
4715;Klevelis;Gėlytės;68457250471;Ne;2;4;0;6
4716;Klevelis;Gėlytės;7309676894;Taip;0;9;0;9
4717;Klevelis;Gėlytės;1942666372;Taip;0;18;0;18
4718;Klevelis;Gėlytės;50441219517;Taip;0;2;0;2
4719;Klevelis;Gėlytės;8154620920;Ne;9;6;0;15
4720;Klevelis;Gėlytės;8584120396;Taip;2;2;0;4
4721;Klevelis;Gėlytės;9689230151;Taip;12;0;0;12
4722;Klevelis;Gėlytės;1757321892;Taip;3;0;0;3
4723;Klevelis;Gėlytės;23520576240;Taip;0;2;0;2
4724;Klevelis;Gėlytės;1851385706;Taip;0;11;0;11
4725;Klevelis;Gėlytės;5024289280;Taip;8;0;0;8
4726;Klevelis;Gėlytės;1685710938;Taip;0;4;0;4
4727;Klevelis;Gėlytės;5354831337;Ne;8;2;0;10
4728;Klevelis;Gėlytės;2744433344;Taip;0;7;0;7
4729;Klevelis;Gėlytės;7506522045;Taip;0;4;0;4
4730;Klevelis;Gėlytės;1606294984;Taip;7;6;0;13
4731;Klevelis;Gėlytės;2043650571;Ne;0;4;0;4
4732;Klevelis;Paukšteliai;4424095457;Taip;4;0;0;4
4733;Klevelis;Paukšteliai;7855598075;Taip;5;9;0;14
4734;Klevelis;Paukšteliai;5402403433;Taip;7;1;1;9
4735;Klevelis;Paukšteliai;1749117711;Taip;8;5;0;13
4736;Klevelis;Paukšteliai;3873345138;Ne;8;3;0;11
4737;Klevelis;Paukšteliai;9291855374;Taip;0;5;0;5
4738;Klevelis;Paukšteliai;7115198351;Taip;15;0;0;15
4739;Klevelis;Paukšteliai;8357021249;Taip;6;7;0;13
4740;Klevelis;Paukšteliai;4051246539;Ne;7;2;1;10
4741;Klevelis;Paukšteliai;6621769160;Taip;2;3;0;5
4742;Klevelis;Paukšteliai;5518309115;Taip;12;7;0;19
4743;Klevelis;Paukšteliai;4832348492;Taip;12;4;1;17
4744;Klevelis;Paukšteliai;9865628172;Ne;1;2;0;3
4745;Klevelis;Paukšteliai;8777858708;Ne;14;0;0;14
4746;Klevelis;Paukšteliai;6172016747;Taip;10;6;0;16
4747;Klevelis;Paukšteliai;4930308435;Taip;0;4;0;4
4748;Klevelis;Paukšteliai;6209223745;Ne;21;0;0;21
4749;Klevelis;Paukšteliai;4895554383;Taip;10;0;2;12
4750;Klevelis;Spindulėliai;36733972781;Ne;5;8;0;13
4751;Klevelis;Spindulėliai;85910214189;Ne;0;7;0;7
4752;Klevelis;Spindulėliai;27776527268;Ne;0;1;0;1
4753;Klevelis;Spindulėliai;1299222411;Taip;5;2;0;7
4754;Klevelis;Spindulėliai;2041814549;Taip;0;11;0;11
4755;Klevelis;Spindulėliai;30473769754;Taip;0;1;0;1
4756;Klevelis;Spindulėliai;1608781752;Taip;7;5;0;12
4757;Klevelis;Spindulėliai;32063805512;Taip;6;3;0;9
4758;Klevelis;Spindulėliai;5786557195;Taip;0;3;0;3
4759;Klevelis;Spindulėliai;1980755137;Taip;12;1;0;13
4760;Klevelis;Spindulėliai;88565114332;Taip;0;4;0;4
4761;Klevelis;Spindulėliai;4400576631;Taip;0;10;0;10
4762;Klevelis;Spindulėliai;9486892110;Taip;21;0;0;21
4763;Klevelis;Spindulėliai;2207041148;Taip;1;13;0;14
4764;Klevelis;Spindulėliai;58302265771;Ne;5;4;0;9
4765;Klevelis;Spindulėliai;4733970252;Taip;0;3;0;3
4766;Klevelis;Spindulėliai;9125827523;Taip;3;2;0;5
4767;Klevelis;Spindulėliai;3397741232;Ne;0;8;0;8
4768;Klevelis;Spindulėliai;1520846063;Taip;0;1;0;1
4769;Klevelis;Spindulėliai;4558350854;Ne;0;8;0;8
4770;Klevelis;Spindulėliai;1020095914;Taip;9;4;0;13
4771;Klevelis;Spindulėliai;5705915729;Taip;13;0;0;13
4772;Klevelis;BORUŽĖLĖS;5966215998;Taip;14;4;0;18
4773;Klevelis;BORUŽĖLĖS;4347007911;Taip;14;1;0;15
4774;Klevelis;BORUŽĖLĖS;2418583962;Taip;13;4;0;17
4775;Klevelis;BORUŽĖLĖS;1751440418;Taip;11;3;0;14
4776;Klevelis;BORUŽĖLĖS;5887929703;Taip;11;4;0;15
4777;Klevelis;BORUŽĖLĖS;5028027797;Taip;0;19;0;19
4778;Klevelis;BORUŽĖLĖS;9585785202;Taip;11;5;0;16
4779;Klevelis;BORUŽĖLĖS;7463376031;Taip;2;16;0;18
4780;Klevelis;BORUŽĖLĖS;6822089289;Taip;12;0;0;12
4781;Klevelis;BORUŽĖLĖS;6736740055;Taip;17;4;0;21
4782;Klevelis;BORUŽĖLĖS;3306549764;Taip;11;0;0;11
4783;Klevelis;BORUŽĖLĖS;6241611652;Taip;7;5;0;12
4784;Klevelis;BORUŽĖLĖS;3567687304;Taip;0;11;0;11
4785;Klevelis;BORUŽĖLĖS;6372245141;Taip;2;0;0;2
4786;Klevelis;BORUŽĖLĖS;2031118410;Taip;5;0;0;5
4787;Klevelis;BORUŽĖLĖS;6488139414;Taip;18;0;0;18
4788;Kurpaitė;Viščiukų;6568580994;Taip;0;19;0;19
4789;Kurpaitė;Viščiukų;1223396469;Taip;15;4;0;19
4790;Kurpaitė;Viščiukų;1095697246;Taip;9;2;0;11
4791;Kurpaitė;Viščiukų;4426311033;Taip;21;0;0;21
4792;Kurpaitė;Viščiukų;7703075096;Taip;14;0;0;14
4793;Kurpaitė;Viščiukų;6466518987;Taip;0;19;0;19
4794;Kurpaitė;Viščiukų;2757100599;Taip;10;0;0;10
4795;Kurpaitė;Viščiukų;8353856412;Taip;19;0;0;19
4796;Kurpaitė;Viščiukų;9769835612;Taip;12;0;0;12
4797;Kurpaitė;Viščiukų;5220314051;Taip;10;0;0;10
4798;Kurpaitė;Viščiukų;4188925256;Taip;0;21;0;21
4799;Kurpaitė;Viščiukų;1273426668;Taip;0;7;0;7
4800;Kurpaitė;Viščiukų;2290343066;Taip;3;0;0;3
4801;Kurpaitė;Viščiukų;8831080716;Taip;15;0;0;15
4802;Kurpaitė;Viščiukų;4592795281;Taip;0;18;0;18
4803;Kurpaitė;Viščiukų;8868415451;Taip;0;4;0;4
4804;Kurpaitė;Viščiukų;4684525618;Taip;0;21;0;21
4805;Kurpaitė;Gėlyčių;3003517700;Taip;4;0;0;4
4806;Kurpaitė;Gėlyčių;7897713994;Taip;11;4;0;15
4807;Kurpaitė;Gėlyčių;1660650556;Taip;0;8;0;8
4808;Kurpaitė;Gėlyčių;1457318954;Taip;2;0;0;2
4809;Kurpaitė;Gėlyčių;9063294667;Ne;0;8;0;8
4810;Kurpaitė;Gėlyčių;4964063637;Taip;17;0;0;17
4811;Kurpaitė;Gėlyčių;7546409044;Taip;0;17;0;17
4812;Kurpaitė;Gėlyčių;5609161523;Ne;14;0;0;14
4813;Kurpaitė;Gėlyčių;8669676262;Taip;0;1;0;1
4814;Kurpaitė;Gėlyčių;9480290430;Taip;0;4;0;4
4815;Kurpaitė;Gėlyčių;9655585527;Ne;21;0;0;21
4816;Kurpaitė;Gėlyčių;3634641300;Taip;9;0;0;9
4817;Kurpaitė;Gėlyčių;2827617670;Taip;7;0;0;7
4818;Kurpaitė;Gėlyčių;4602268315;Taip;6;0;0;6
4819;Kurpaitė;Gėlyčių;4168882748;Taip;0;4;0;4
4820;Kurpaitė;Drugelių;1236147310;Taip;8;2;0;10
4821;Kurpaitė;Drugelių;1641562196;Taip;7;4;0;11
4822;Kurpaitė;Drugelių;2200676656;Taip;0;5;0;5
4823;Kurpaitė;Drugelių;24410351286;Ne;0;13;0;13
4824;Kurpaitė;Drugelių;58127430940;Taip;0;7;0;7
4825;Kurpaitė;Drugelių;1606617694;Taip;0;17;0;17
4826;Kurpaitė;Drugelių;2359555461;Taip;0;6;0;6
4827;Kurpaitė;Drugelių;1151128660;Taip;0;5;0;5
4828;Kurpaitė;Drugelių;2116580903;Taip;0;13;0;13
4829;Kurpaitė;Drugelių;65434834152;Taip;0;10;0;10
4830;Kurpaitė;Drugelių;72710210157;Taip;0;6;0;6
4831;Kurpaitė;Drugelių;1218040871;Taip;0;21;0;21
4832;Kurpaitė;Drugelių;2890934301;Taip;0;7;0;7
4833;Kurpaitė;Drugelių;9435979008;Taip;12;2;0;14
4834;Kurpaitė;Drugelių;7431793716;Taip;0;19;0;19
4835;Kurpaitė;Drugelių;1505783589;Taip;0;7;0;7
4836;Kurpaitė;Drugelių;7249931704;Taip;0;2;0;2
4837;Kurpaitė;Pelyčių;5442955475;Taip;0;4;0;4
4838;Kurpaitė;Pelyčių;53385228310;Ne;0;2;0;2
4839;Kurpaitė;Pelyčių;42230129130;Taip;0;12;0;12
4840;Kurpaitė;Pelyčių;28569380108;Taip;0;9;0;9
4841;Kurpaitė;Pelyčių;97469119395;Taip;0;4;0;4
4842;Kurpaitė;Pelyčių;1936055251;Taip;0;4;0;4
4843;Kurpaitė;Pelyčių;5902371603;Taip;0;7;0;7
4844;Kurpaitė;Pelyčių;54840686231;Taip;0;3;0;3
4845;Kurpaitė;Pelyčių;49970457589;Taip;0;10;0;10
4846;Kurpaitė;Pelyčių;48526842780;Taip;0;3;0;3
4847;Kurpaitė;Pelyčių;38605683298;Taip;0;1;0;1
4848;Kurpaitė;Pelyčių;85698687930;Taip;8;1;0;9
4849;Kurpaitė;Pelyčių;48538300542;Taip;11;0;0;11
4850;Kurpaitė;Pelyčių;1730735673;Taip;0;9;0;9
4851;Kurpaitė;Pelyčių;62959992605;Taip;0;4;0;4
4852;Kurpaitė;Pelyčių;52852801754;Taip;0;4;0;4
4853;Kurpaitė;Pelyčių;43247754405;Taip;10;7;0;17
4854;Kurpaitė;Pelyčių;51115562424;Taip;10;0;0;10
4855;Kurpaitė;Pelyčių;31201788860;Taip;5;3;0;8
4856;Kurpaitė;Pelyčių;66920939967;Taip;0;4;0;4
4857;Kurpaitė;Pelyčių;5394176979;Taip;3;0;2;5
4858;Kūlverstukas;Saulutės;74829986958;Ne;0;9;3;12
4859;Kūlverstukas;Saulutės;7440474403;Taip;4;5;2;11
4860;Kūlverstukas;Saulutės;2072009099;Taip;9;0;4;13
4861;Kūlverstukas;Saulutės;1000393691;Taip;0;6;0;6
4862;Kūlverstukas;Saulutės;6577897961;Taip;5;0;0;5
4863;Kūlverstukas;Saulutės;3937419139;Taip;0;2;0;2
4864;Kūlverstukas;Saulutės;3162189859;Taip;0;13;6;19
4865;Kūlverstukas;Saulutės;1452422691;Taip;11;0;0;11
4866;Kūlverstukas;Saulutės;1240006602;Taip;5;0;0;5
4867;Kūlverstukas;Saulutės;2130099456;Taip;0;0;1;1
4868;Kūlverstukas;Saulutės;1226883894;Taip;0;1;1;2
4869;Kūlverstukas;Saulutės;37991935289;Taip;6;6;0;12
4870;Kūlverstukas;Saulutės;1699783763;Taip;0;10;0;10
4871;Kūlverstukas;Saulutės;3991821717;Taip;13;0;0;13
4872;Kūlverstukas;Saulutės;5488011852;Taip;7;0;1;8
4873;Kūlverstukas;Saulutės;8891671739;Taip;0;4;0;4
4874;Kūlverstukas;Saulutės;1617844709;Taip;11;0;9;20
4875;Kūlverstukas;Saulutės;4396230034;Ne;0;2;0;2
4876;Kūlverstukas;Saulutės;6975324309;Taip;0;5;1;6
4877;Kūlverstukas;Peledžiukai;21138396996;Taip;15;0;0;15
4878;Kūlverstukas;Peledžiukai;4028937969;Taip;13;5;0;18
4879;Kūlverstukas;Peledžiukai;85330859485;Taip;6;4;1;11
4880;Kūlverstukas;Peledžiukai;2179050825;Taip;0;4;0;4
4881;Kūlverstukas;Peledžiukai;46254945540;Ne;0;5;0;5
4882;Kūlverstukas;Peledžiukai;1260193245;Taip;19;0;0;19
4883;Kūlverstukas;Peledžiukai;10716234461;Ne;0;5;0;5
4884;Kūlverstukas;Peledžiukai;89179106633;Ne;0;7;0;7
4885;Kūlverstukas;Peledžiukai;79760811110;Taip;5;0;0;5
4886;Kūlverstukas;Peledžiukai;22294704115;Taip;0;4;0;4
4887;Kūlverstukas;Peledžiukai;46862868133;Taip;4;2;1;7
4888;Kūlverstukas;Peledžiukai;1816105412;Taip;8;4;0;12
4889;Kūlverstukas;Peledžiukai;1570383265;Taip;0;8;0;8
4890;Kūlverstukas;Peledžiukai;3737085009;Taip;0;2;0;2
4891;Kūlverstukas;Peledžiukai;47399326083;Taip;0;2;1;3
4892;Kūlverstukas;Peledžiukai;49788909084;Taip;7;4;3;14
4893;Kūlverstukas;Peledžiukai;1109035765;Taip;8;4;0;12
4894;Kūlverstukas;Peledžiukai;1471794813;Taip;4;0;1;5
4895;Kūlverstukas;Peledžiukai;1396533792;Ne;3;0;0;3
4896;Kūlverstukas;Peledžiukai;1009117653;Taip;10;0;0;10
4897;Kūlverstukas;Peledžiukai;8362459952;Taip;8;0;0;8
4898;Kūlverstukas;Gelytės;6287636806;Ne;9;0;0;9
4899;Kūlverstukas;Gelytės;2716194746;Taip;8;6;3;17
4900;Kūlverstukas;Gelytės;2101490038;Taip;10;0;0;10
4901;Kūlverstukas;Gelytės;2450625415;Taip;10;0;0;10
4902;Kūlverstukas;Gelytės;8092104136;Taip;0;4;5;9
4903;Kūlverstukas;Gelytės;7480593611;Ne;2;0;3;5
4904;Kūlverstukas;Gelytės;5372936730;Taip;9;0;1;10
4905;Kūlverstukas;Gelytės;7359354944;Taip;7;0;1;8
4906;Kūlverstukas;Gelytės;8853848991;Taip;0;2;0;2
4907;Kūlverstukas;Gelytės;4285624305;Ne;10;0;0;10
4908;Kūlverstukas;Gelytės;4073233921;Ne;0;0;3;3
4909;Kūlverstukas;Gelytės;2087570702;Taip;0;5;4;9
4910;Kūlverstukas;Gelytės;1932066021;Ne;12;0;1;13
4911;Kūlverstukas;Gelytės;5488852698;Taip;8;0;0;8
4912;Kūlverstukas;Gelytės;3069047204;Taip;0;12;6;18
4913;Kūlverstukas;Gelytės;5345423038;Taip;5;3;0;8
4914;Kūlverstukas;Gelytės;3270176280;Ne;0;14;0;14
4915;Kūlverstukas;Gelytės;2169480822;Taip;0;6;1;7
4916;Kūlverstukas;Gelytės;4173514390;Taip;9;0;3;12
4917;Kūlverstukas;Bitutės;9427388681;Taip;4;6;0;10
4918;Kūlverstukas;Bitutės;9096819614;Taip;7;4;2;13
4919;Kūlverstukas;Bitutės;4532151103;Taip;21;0;0;21
4920;Kūlverstukas;Bitutės;7505926208;Taip;5;9;0;14
4921;Kūlverstukas;Bitutės;1014630718;Taip;2;11;0;13
4922;Kūlverstukas;Bitutės;5103259175;Taip;6;5;1;12
4923;Kūlverstukas;Bitutės;9167460438;Taip;0;4;1;5
4924;Kūlverstukas;Bitutės;1898905623;Taip;11;0;0;11
4925;Kūlverstukas;Bitutės;2762230590;Taip;13;0;0;13
4926;Kūlverstukas;Bitutės;8319255735;Taip;17;0;4;21
4927;Kūlverstukas;Bitutės;6598688551;Taip;0;10;1;11
4928;Kūlverstukas;Bitutės;8556086501;Taip;0;5;5;10
4929;Kūlverstukas;Bitutės;7970898546;Taip;0;0;1;1
4930;Kūlverstukas;Bitutės;3162808486;Taip;9;0;0;9
4931;Kūlverstukas;Bitutės;1067182820;Taip;14;0;1;15
4932;Lakštingala;Saulutės;5692087454;Taip;0;5;2;7
4933;Lakštingala;Saulutės;95489864230;Taip;0;5;3;8
4934;Lakštingala;Saulutės;31221126819;Taip;0;6;1;7
4935;Lakštingala;Saulutės;57836156450;Taip;6;4;0;10
4936;Lakštingala;Saulutės;3426133948;Taip;5;7;0;12
4937;Lakštingala;Saulutės;79652151224;Ne;0;3;0;3
4938;Lakštingala;Saulutės;10653315095;Ne;7;4;0;11
4939;Lakštingala;Saulutės;50868279016;Taip;0;1;2;3
4940;Lakštingala;Saulutės;45850246980;Taip;0;5;0;5
4941;Lakštingala;Saulutės;2430795418;Ne;0;5;0;5
4942;Lakštingala;Saulutės;96792864646;Taip;0;5;0;5
4943;Lakštingala;Saulutės;93222430249;Taip;0;5;0;5
4944;Lakštingala;Saulutės;74001349345;Taip;0;5;0;5
4945;Lakštingala;Saulutės;37722153251;Taip;7;6;2;15
4946;Lakštingala;Saulutės;98717827320;Taip;0;6;1;7
4947;Lakštingala;Saulutės;40682764019;Taip;0;4;0;4
4948;Lakštingala;Saulutės;79583726414;Taip;12;4;0;16
4949;Lakštingala;Saulutės;68037499606;Taip;0;5;0;5
4950;Lakštingala;Saulutės;51586922715;Taip;0;12;0;12
4951;Lakštingala;Saulutės;89747320378;Taip;0;7;2;9
4952;Lakštingala;Saulutės;62866040506;Taip;0;5;0;5
4953;Lakštingala;Nykštukai;7931292601;Taip;21;0;0;21
4954;Lakštingala;Nykštukai;4700135106;Taip;8;0;3;11
4955;Lakštingala;Nykštukai;1863034132;Taip;14;0;1;15
4956;Lakštingala;Nykštukai;9879064676;Ne;10;0;0;10
4957;Lakštingala;Nykštukai;2941128360;Taip;0;4;0;4
4958;Lakštingala;Nykštukai;8284565948;Taip;14;0;0;14
4959;Lakštingala;Nykštukai;2423651716;Taip;1;0;0;1
4960;Lakštingala;Nykštukai;9912622093;Taip;8;0;0;8
4961;Lakštingala;Nykštukai;9489982241;Taip;5;5;0;10
4962;Lakštingala;Nykštukai;4032030375;Taip;6;9;0;15
4963;Lakštingala;Nykštukai;3993759015;Taip;21;0;0;21
4964;Lakštingala;Nykštukai;2652305131;Taip;2;0;1;3
4965;Lakštingala;Nykštukai;9725851433;Taip;11;0;0;11
4966;Lakštingala;Nykštukai;6332498461;Taip;11;5;0;16
4967;Lakštingala;Nykštukai;1655202909;Taip;9;5;2;16
4968;Lakštingala;Nykštukai;9375002191;Taip;0;8;0;8
4969;Lakštingala;Nykštukai;3832669008;Taip;21;0;0;21
4970;Lakštingala;Nykštukai;4857448665;Taip;9;0;0;9
4971;Lakštingala;Nykštukai;2304340938;Taip;14;0;0;14
4972;Lakštingala;Nykštukai;8217315818;Taip;10;0;1;11
4973;Lakštingala;Nykštukai;6292331193;Taip;8;0;0;8
4974;Lakštingala;Nykštukai;7994475429;Taip;8;0;0;8
4975;Lakštingala;Bitutės;3544861594;Taip;0;9;0;9
4976;Lakštingala;Bitutės;1422696792;Taip;0;7;3;10
4977;Lakštingala;Bitutės;16039738423;Taip;5;6;0;11
4978;Lakštingala;Bitutės;95149875628;Taip;0;15;0;15
4979;Lakštingala;Bitutės;72834597919;Taip;0;6;1;7
4980;Lakštingala;Bitutės;2106666739;Taip;17;4;0;21
4981;Lakštingala;Bitutės;91158318909;Taip;0;5;0;5
4982;Lakštingala;Bitutės;92129853333;Taip;0;1;0;1
4983;Lakštingala;Bitutės;14826956710;Ne;15;4;0;19
4984;Lakštingala;Bitutės;44713607631;Taip;0;3;0;3
4985;Lakštingala;Bitutės;63698553352;Taip;9;4;0;13
4986;Lakštingala;Bitutės;19356167631;Taip;0;6;2;8
4987;Lakštingala;Bitutės;45199150020;Taip;0;7;0;7
4988;Lakštingala;Bitutės;46426227002;Taip;0;4;3;7
4989;Lakštingala;Bitutės;24905526995;Taip;3;6;0;9
4990;Lakštingala;Bitutės;1056248263;Taip;0;5;2;7
4991;Lakštingala;Bitutės;56646163756;Taip;0;5;0;5
4992;Lakštingala;Bitutės;9610324086;Taip;0;0;3;3
4993;Lakštingala;Bitutės;7860949054;Taip;0;6;1;7
4994;Lakštingala;Bitutės;82319560992;Taip;5;8;0;13
4995;Lakštingala;Bitutės;2138306323;Taip;2;8;0;10
4996;Lakštingala;Pūkeliai;5598711072;Taip;17;0;0;17
4997;Lakštingala;Pūkeliai;8171357606;Taip;7;5;0;12
4998;Lakštingala;Pūkeliai;9774836470;Taip;9;5;0;14
4999;Lakštingala;Pūkeliai;1958696382;Taip;21;0;0;21
5000;Lakštingala;Pūkeliai;4542992319;Taip;16;0;0;16
5001;Lakštingala;Pūkeliai;9346986726;Taip;5;4;0;9
5002;Lakštingala;Pūkeliai;2593030897;Taip;9;0;0;9
5003;Lakštingala;Pūkeliai;7929034243;Taip;4;7;0;11
5004;Lakštingala;Pūkeliai;5854794141;Taip;5;4;0;9
5005;Lakštingala;Pūkeliai;6234559044;Taip;1;0;0;1
5006;Lakštingala;Pūkeliai;2130192341;Taip;12;0;0;12
5007;Lakštingala;Pūkeliai;8165998647;Taip;7;0;0;7
5008;Lakštingala;Pūkeliai;1458348357;Taip;0;4;0;4
5009;Lakštingala;Pūkeliai;4465752871;Taip;0;1;0;1
5010;Lakštingala;Pūkeliai;2430891944;Taip;3;0;0;3
5011;Lakštingala;Pūkeliai;5379344261;Taip;5;3;0;8
5012;Lakštingala;Pūkeliai;4722328994;Ne;8;0;0;8
5013;Lakštingala;Pūkeliai;7272454093;Taip;2;0;0;2
5014;Lakštingala;Pūkeliai;1587899391;Ne;9;0;0;9
5015;Lakštingala;Aitvariukai;3872205876;Taip;21;0;0;21
5016;Lakštingala;Aitvariukai;5851957031;Taip;4;0;1;5
5017;Lakštingala;Aitvariukai;4996777116;Taip;4;0;0;4
5018;Lakštingala;Aitvariukai;9390342572;Taip;10;5;0;15
5019;Lakštingala;Aitvariukai;7918688955;Taip;8;1;0;9
5020;Lakštingala;Aitvariukai;6701912968;Taip;4;2;9;15
5021;Lakštingala;Aitvariukai;3509165175;Ne;13;0;2;15
5022;Lakštingala;Aitvariukai;9694524137;Taip;0;4;0;4
5023;Lakštingala;Aitvariukai;4179366572;Taip;4;0;5;9
5024;Lakštingala;Aitvariukai;5949665703;Taip;9;0;0;9
5025;Lakštingala;Aitvariukai;8679582358;Taip;16;0;2;18
5026;Lakštingala;Aitvariukai;9147821017;Taip;21;0;0;21
5027;Lakštingala;Aitvariukai;5445945319;Taip;9;0;0;9
5028;Lakštingala;Aitvariukai;6597540627;Taip;7;0;0;7
5029;Lakštingala;Aitvariukai;2266870318;Taip;10;0;5;15
5030;Lakštingala;Aitvariukai;3791118736;Taip;1;0;8;9
5031;Lakštingala;Aitvariukai;6565318145;Taip;9;6;0;15
5032;Lakštingala;Aitvariukai;4384468922;Ne;0;0;10;10
5033;Lakštingala;Aitvariukai;5162605666;Taip;6;0;5;11
5034;Lakštingala;Aitvariukai;2073818724;Taip;8;0;0;8
5035;Lakštingala;Aitvariukai;2423761155;Taip;18;0;0;18
5036;Lakštingala;Boružiukai;9795993812;Taip;0;6;0;6
5037;Lakštingala;Boružiukai;3280380015;Taip;8;4;0;12
5038;Lakštingala;Boružiukai;9004336424;Ne;0;5;5;10
5039;Lakštingala;Boružiukai;87470014156;Taip;0;4;1;5
5040;Lakštingala;Boružiukai;8820053026;Taip;0;4;2;6
5041;Lakštingala;Boružiukai;2072883878;Taip;0;0;2;2
5042;Lakštingala;Boružiukai;4811759034;Taip;9;0;0;9
5043;Lakštingala;Boružiukai;1898853302;Ne;2;0;4;6
5044;Lakštingala;Boružiukai;2792618575;Taip;0;20;0;20
5045;Lakštingala;Boružiukai;55720630870;Taip;0;12;0;12
5046;Lakštingala;Boružiukai;4818524423;Taip;3;4;3;10
5047;Lakštingala;Boružiukai;1444534032;Taip;6;0;0;6
5048;Lakštingala;Boružiukai;6150013105;Taip;0;4;5;9
5049;Lakštingala;Boružiukai;9724531753;Ne;0;4;0;4
5050;Lakštingala;Boružiukai;3602820204;Taip;10;5;0;15
5051;Lakštingala;Boružiukai;1783776913;Taip;0;0;3;3
5052;Lakštingala;"KIŠKUČIAI (SAV.)";64992551832;Taip;0;8;0;8
5053;Lakštingala;"KIŠKUČIAI (SAV.)";1169891428;Taip;8;9;0;17
5054;Lakštingala;"KIŠKUČIAI (SAV.)";63039806752;Taip;0;3;0;3
5055;Lakštingala;"KIŠKUČIAI (SAV.)";1409132656;Taip;6;3;0;9
5056;Lakštingala;"KIŠKUČIAI (SAV.)";1236087612;Taip;8;3;0;11
5057;Lakštingala;"KIŠKUČIAI (SAV.)";80762133625;Taip;0;8;1;9
5058;Lakštingala;"KIŠKUČIAI (SAV.)";1128658722;Taip;10;0;0;10
5059;Lakštingala;"KIŠKUČIAI (SAV.)";9862985913;Taip;2;3;0;5
5060;Lakštingala;"KIŠKUČIAI (SAV.)";77712279907;Taip;0;1;1;2
5061;Lakštingala;"KIŠKUČIAI (SAV.)";2083229761;Taip;2;0;0;2
5062;Lakštingala;"KIŠKUČIAI (SAV.)";40853872375;Taip;0;5;0;5
5063;Lakštingala;"KIŠKUČIAI (SAV.)";1716046309;Ne;8;0;0;8
5064;Lakštingala;"KIŠKUČIAI (SAV.)";3660645944;Ne;5;5;0;10
5065;Lakštingala;"KIŠKUČIAI (SAV.)";7038977283;Ne;11;1;0;12
5066;Lakštingala;"KIŠKUČIAI (SAV.)";80142440362;Ne;0;4;0;4
5067;Lakštingala;"KIŠKUČIAI (SAV.)";7623300327;Taip;11;0;0;11
5068;Lakštingala;"KIŠKUČIAI (SAV.)";2241000661;Taip;11;0;0;11
5069;Lakštingala;"KIŠKUČIAI (SAV.)";78648398334;Ne;17;0;0;17
5070;Lakštingala;"KIŠKUČIAI (SAV.)";709506281;Taip;10;1;3;14
5071;Lakštingala;"KIŠKUČIAI (SAV.)";1408127186;Taip;3;5;0;8
5072;Lakštingala;"KIŠKUČIAI (SAV.)";8645237294;Taip;9;0;0;9
5073;Lakštingala;Žiogeliai;2104150466;Taip;7;0;0;7
5074;Lakštingala;Žiogeliai;9395512638;Taip;7;5;0;12
5075;Lakštingala;Žiogeliai;9689911725;Taip;9;4;0;13
5076;Lakštingala;Žiogeliai;1832608585;Taip;14;0;0;14
5077;Lakštingala;Žiogeliai;9958821769;Taip;0;0;8;8
5078;Lakštingala;Žiogeliai;7953724873;Taip;0;7;0;7
5079;Lakštingala;Žiogeliai;9800992468;Taip;8;4;0;12
5080;Lakštingala;Žiogeliai;1411121466;Taip;6;2;1;9
5081;Lakštingala;Žiogeliai;8944088082;Taip;12;2;1;15
5082;Lakštingala;Žiogeliai;9897713625;Taip;2;2;5;9
5083;Lakštingala;Žiogeliai;70798601578;Taip;0;11;0;11
5084;Lakštingala;Žiogeliai;1736130324;Taip;6;0;1;7
5085;Lakštingala;Žiogeliai;2039579203;Taip;6;0;1;7
5086;Lakštingala;Žiogeliai;6576202365;Taip;7;0;7;14
5087;Lakštingala;Žiogeliai;7900597697;Taip;0;3;2;5
5088;Lakštingala;Žiogeliai;9497327995;Taip;0;1;0;1
5089;Lakštingala;Žiogeliai;8470575927;Taip;0;0;2;2
5090;Lakštingala;Žiogeliai;1265027238;Taip;0;4;0;4
5091;Lakštingala;SPINDULIUKAI;19003276281;Taip;9;4;0;13
5092;Lakštingala;SPINDULIUKAI;31911078405;Taip;9;4;0;13
5093;Lakštingala;SPINDULIUKAI;59343571746;Taip;2;4;0;6
5094;Lakštingala;SPINDULIUKAI;601001178;Taip;0;7;0;7
5095;Lakštingala;SPINDULIUKAI;1263184555;Taip;6;5;0;11
5096;Lakštingala;SPINDULIUKAI;42012300013;Taip;0;6;1;7
5097;Lakštingala;SPINDULIUKAI;2002196654;Taip;0;4;0;4
5098;Lakštingala;SPINDULIUKAI;4261431738;Taip;0;6;0;6
5099;Lakštingala;SPINDULIUKAI;58847206918;Taip;0;1;0;1
5100;Lakštingala;SPINDULIUKAI;5033145687;Taip;0;6;1;7
5101;Lakštingala;SPINDULIUKAI;26288159700;Ne;0;3;4;7
5102;Lakštingala;SPINDULIUKAI;11399672681;Taip;0;2;3;5
5103;Lakštingala;SPINDULIUKAI;95832669291;Taip;0;7;0;7
5104;Lakštingala;SPINDULIUKAI;4183492894;Taip;0;2;0;2
5105;Lakštingala;SPINDULIUKAI;48160996499;Ne;0;1;1;2
5106;Lakštingala;SPINDULIUKAI;70748679017;Taip;0;2;0;2
5107;Lakštingala;SPINDULIUKAI;4770775472;Taip;0;4;0;4
5108;Lakštingala;SPINDULIUKAI;8838078447;Ne;2;6;1;9
5109;Lakštingala;SPINDULIUKAI;7448175606;Taip;0;12;0;12
5110;Lakštingala;SPINDULIUKAI;73039119839;Taip;0;21;0;21
5111;Lakštingala;Pėledžiukai;98609129644;Taip;0;9;0;9
5112;Lakštingala;Pėledžiukai;2635399411;Taip;0;0;10;10
5113;Lakštingala;Pėledžiukai;7325183642;Taip;21;0;0;21
5114;Lakštingala;Pėledžiukai;21094902562;Taip;5;0;0;5
5115;Lakštingala;Pėledžiukai;1297637335;Taip;3;4;0;7
5116;Lakštingala;Pėledžiukai;1271455798;Taip;3;4;0;7
5117;Lakštingala;Pėledžiukai;1868573076;Taip;0;4;2;6
5118;Lakštingala;Pėledžiukai;14410791110;Taip;4;0;1;5
5119;Lakštingala;Pėledžiukai;30840899725;Taip;0;0;1;1
5120;Lakštingala;Pėledžiukai;1676655778;Taip;7;0;8;15
5121;Lakštingala;Pėledžiukai;9381815353;Taip;0;4;6;10
5122;Lakštingala;Pėledžiukai;25449089230;Taip;0;7;0;7
5123;Lakštingala;Pėledžiukai;36367286465;Taip;0;0;5;5
5124;Lakštingala;Pėledžiukai;91671174585;Taip;0;4;1;5
5125;Lakštingala;Pėledžiukai;1347480198;Ne;0;6;0;6
5126;Lakštingala;Pėledžiukai;88947243829;Taip;6;5;0;11
5127;Lakštingala;Pėledžiukai;6329787217;Taip;0;9;0;9
5128;Lakštingala;Pėledžiukai;58056130761;Taip;0;12;0;12
5129;Lakštingala;Pėledžiukai;1310400524;Taip;5;1;4;10
5130;Lakštingala;Pėledžiukai;2013216779;Taip;0;3;1;4
5131;Lakštingala;Pėledžiukai;8890852891;Taip;0;0;7;7
5132;Lakštingala;Pėledžiukai;9998322501;Taip;2;0;13;15
5133;Lakštingala;Katinėliai;6780591792;Ne;17;4;0;21
5134;Lakštingala;Katinėliai;8422745100;Taip;0;13;0;13
5135;Lakštingala;Katinėliai;2022621678;Taip;0;0;12;12
5136;Lakštingala;Katinėliai;9762500668;Taip;0;4;0;4
5137;Lakštingala;Katinėliai;8703818797;Taip;19;0;0;19
5138;Lakštingala;Katinėliai;4365413054;Taip;3;0;3;6
5139;Lakštingala;Katinėliai;7455063702;Ne;0;0;19;19
5140;Lakštingala;Katinėliai;7640007392;Taip;21;0;0;21
5141;Lakštingala;Katinėliai;4784677514;Taip;21;0;0;21
5142;Lakštingala;Katinėliai;1619201521;Taip;4;0;0;4
5143;Lakštingala;Katinėliai;8429523368;Taip;0;0;16;16
5144;Lakštingala;Katinėliai;1767414096;Taip;6;0;1;7
5145;Lakštingala;Katinėliai;6668075753;Taip;9;0;4;13
5146;Lakštingala;Katinėliai;9081653166;Taip;0;4;1;5
5147;Lakštingala;Katinėliai;8160825203;Taip;3;0;1;4
5148;Lakštingala;Katinėliai;2371619895;Taip;13;0;0;13
5149;Lakštingala;Katinėliai;7404386777;Taip;0;0;7;7
5150;Lakštingala;Katinėliai;4698879435;Taip;5;4;0;9
5151;Lakštingala;Katinėliai;8722490845;Taip;0;0;3;3
5152;Lakštingala;Katinėliai;1220858944;Taip;9;0;0;9
5153;Lakštingala;Deimantėliai;3568151046;Taip;9;0;1;10
5154;Lakštingala;Deimantėliai;3369263112;Taip;21;0;0;21
5155;Lakštingala;Deimantėliai;4774354751;Taip;0;0;21;21
5156;Lakštingala;Deimantėliai;3766779594;Taip;3;0;0;3
5157;Lakštingala;Deimantėliai;7139669240;Taip;0;17;0;17
5158;Lakštingala;Deimantėliai;3050655193;Taip;16;0;0;16
5159;Lakštingala;Deimantėliai;2738882466;Taip;0;0;2;2
5160;Lakštingala;Deimantėliai;2663268027;Taip;0;0;21;21
5161;Lakštingala;Deimantėliai;6135103377;Taip;8;0;0;8
5162;Lakštingala;Deimantėliai;8075192528;Taip;0;0;17;17
5163;Lakštingala;Deimantėliai;9297542026;Taip;0;0;14;14
5164;Lakštingala;Deimantėliai;3618452008;Taip;4;0;0;4
5165;Lakštingala;Deimantėliai;3858771190;Taip;0;0;21;21
5166;Lakštingala;Deimantėliai;2723364075;Taip;0;0;20;20
5167;Lakštingala;Deimantėliai;8375506323;Taip;9;0;1;10
5168;Lakštingala;Deimantėliai;5258588961;Taip;17;0;0;17
5169;Lakštingala;Deimantėliai;3520592784;Taip;0;4;1;5
5170;Lakštingala;Deimantėliai;8717764626;Taip;8;0;1;9
5171;Lakštingala;Deimantėliai;2962846236;Taip;16;0;0;16
5172;Lakštingala;Deimantėliai;1474796466;Taip;21;0;0;21
5173;Lakštingala;Deimantėliai;6369696598;Taip;0;0;5;5
5174;Lašelis;VIŠČIUKAI;3982877012;Taip;5;5;3;13
5175;Lašelis;VIŠČIUKAI;1108744283;Taip;0;0;4;4
5176;Lašelis;VIŠČIUKAI;8324581018;Ne;0;2;0;2
5177;Lašelis;VIŠČIUKAI;6977000987;Taip;0;5;4;9
5178;Lašelis;VIŠČIUKAI;1268330178;Taip;4;4;6;14
5179;Lašelis;VIŠČIUKAI;1417989409;Taip;2;0;3;5
5180;Lašelis;VIŠČIUKAI;6090290046;Taip;0;4;0;4
5181;Lašelis;VIŠČIUKAI;1578956182;Taip;0;13;0;13
5182;Lašelis;VIŠČIUKAI;2500332755;Taip;0;4;0;4
5183;Lašelis;VIŠČIUKAI;1739797553;Taip;0;6;0;6
5184;Lašelis;VIŠČIUKAI;2113295854;Ne;0;0;7;7
5185;Lašelis;VIŠČIUKAI;65174922062;Taip;0;9;0;9
5186;Lašelis;VIŠČIUKAI;5046619730;Taip;2;0;2;4
5187;Lašelis;VIŠČIUKAI;1193336600;Taip;2;7;0;9
5188;Lašelis;VIŠČIUKAI;3741905080;Taip;0;3;8;11
5189;Lašelis;VIŠČIUKAI;6492909546;Ne;13;1;0;14
5190;Lašelis;VIŠČIUKAI;7471332824;Taip;6;7;0;13
5191;Lašelis;VIŠČIUKAI;4062516422;Taip;0;3;0;3
5192;Lašelis;VIŠČIUKAI;4599789649;Ne;11;2;1;14
5193;Lašelis;ŠYPSENA;2635903222;Taip;0;16;0;16
5194;Lašelis;ŠYPSENA;2204859014;Taip;9;0;5;14
5195;Lašelis;ŠYPSENA;3239288878;Taip;11;4;0;15
5196;Lašelis;ŠYPSENA;3144718477;Taip;8;0;0;8
5197;Lašelis;ŠYPSENA;1777442316;Ne;8;0;0;8
5198;Lašelis;ŠYPSENA;7998812497;Taip;0;11;0;11
5199;Lašelis;ŠYPSENA;6669130831;Taip;0;10;4;14
5200;Lašelis;ŠYPSENA;7351939034;Taip;3;7;0;10
5201;Lašelis;ŠYPSENA;7802622810;Taip;7;1;0;8
5202;Lašelis;ŠYPSENA;1886540733;Taip;0;0;9;9
5203;Lašelis;ŠYPSENA;6553762186;Taip;0;15;0;15
5204;Lašelis;ŠYPSENA;1085400709;Taip;0;12;0;12
5205;Lašelis;ŠYPSENA;6127747445;Taip;0;2;0;2
5206;Lašelis;ŠYPSENA;2912232814;Taip;0;4;1;5
5207;Lašelis;ŠYPSENA;4151582358;Taip;0;15;0;15
5208;Lašelis;ŠYPSENA;1646912457;Taip;0;13;0;13
5209;Lašelis;ŠYPSENA;6080664872;Taip;9;4;2;15
5210;Lašelis;ŠYPSENA;6829438486;Taip;0;1;0;1
5211;Lašelis;ŠYPSENA;1515920896;Ne;0;0;1;1
5212;Lašelis;NYKŠTUKAI;4320017329;Taip;7;1;0;8
5213;Lašelis;NYKŠTUKAI;60394164372;Taip;1;0;0;1
5214;Lašelis;NYKŠTUKAI;1584708183;Taip;0;8;0;8
5215;Lašelis;NYKŠTUKAI;713862923;Taip;0;5;0;5
5216;Lašelis;NYKŠTUKAI;2118500745;Taip;0;0;3;3
5217;Lašelis;NYKŠTUKAI;14934740494;Ne;0;9;0;9
5218;Lašelis;NYKŠTUKAI;7349722463;Taip;0;5;0;5
5219;Lašelis;NYKŠTUKAI;8332516807;Taip;4;0;1;5
5220;Lašelis;NYKŠTUKAI;10694830733;Ne;4;7;0;11
5221;Lašelis;NYKŠTUKAI;1282991939;Taip;0;3;0;3
5222;Lašelis;NYKŠTUKAI;82073061357;Taip;0;4;0;4
5223;Lašelis;NYKŠTUKAI;58391864442;Taip;0;7;0;7
5224;Lašelis;NYKŠTUKAI;5437008837;Taip;4;0;3;7
5225;Lašelis;NYKŠTUKAI;8873895533;Taip;0;5;0;5
5226;Lašelis;NYKŠTUKAI;1383759549;Taip;17;0;0;17
5227;Lašelis;NYKŠTUKAI;86191407652;Taip;0;4;0;4
5228;Lašelis;NYKŠTUKAI;9391594216;Taip;7;8;0;15
5229;Lašelis;NYKŠTUKAI;1987591278;Taip;14;0;1;15
5230;Lašelis;SAULUTĖ;1171647193;Taip;0;3;0;3
5231;Lašelis;SAULUTĖ;1711262987;Taip;0;4;0;4
5232;Lašelis;SAULUTĖ;29417065142;Taip;0;9;0;9
5233;Lašelis;SAULUTĖ;37726695989;Taip;0;7;0;7
5234;Lašelis;SAULUTĖ;87745170593;Taip;7;0;0;7
5235;Lašelis;SAULUTĖ;28071639285;Taip;4;0;0;4
5236;Lašelis;SAULUTĖ;85641710509;Taip;0;6;6;12
5237;Lašelis;SAULUTĖ;1635550414;Taip;0;11;0;11
5238;Lašelis;SAULUTĖ;1917927039;Taip;0;12;0;12
5239;Lašelis;SAULUTĖ;1099685342;Taip;0;9;0;9
5240;Lašelis;SAULUTĖ;40927906931;Taip;0;3;1;4
5241;Lašelis;SAULUTĖ;1534313851;Taip;0;6;0;6
5242;Lašelis;SAULUTĖ;34947111596;Taip;0;6;0;6
5243;Lašelis;BORUŽĖLĖS;2886967297;Taip;10;3;0;13
5244;Lašelis;BORUŽĖLĖS;8132517365;Taip;17;0;0;17
5245;Lašelis;BORUŽĖLĖS;1175045927;Taip;6;0;0;6
5246;Lašelis;BORUŽĖLĖS;2401058384;Ne;9;0;4;13
5247;Lašelis;BORUŽĖLĖS;1244168190;Taip;10;5;0;15
5248;Lašelis;BORUŽĖLĖS;2034007263;Taip;4;0;0;4
5249;Lašelis;BORUŽĖLĖS;7367305924;Taip;0;0;15;15
5250;Lašelis;BORUŽĖLĖS;3297005183;Ne;6;0;1;7
5251;Lašelis;BORUŽĖLĖS;8318512396;Taip;6;0;2;8
5252;Lašelis;BORUŽĖLĖS;7657786815;Taip;12;0;0;12
5253;Lašelis;BORUŽĖLĖS;7107685761;Taip;4;0;0;4
5254;Lašelis;BORUŽĖLĖS;3495676199;Taip;8;0;0;8
5255;Lašelis;BORUŽĖLĖS;3843163586;Taip;5;3;0;8
5256;Lašelis;BORUŽĖLĖS;6304391719;Taip;12;0;0;12
5257;Lašelis;BORUŽĖLĖS;1085950130;Taip;6;0;0;6
5258;Lašelis;SKRUZDELIUKAI;1817563074;Taip;0;4;0;4
5259;Lašelis;SKRUZDELIUKAI;3564781987;Taip;4;1;0;5
5260;Lašelis;SKRUZDELIUKAI;5392759654;Taip;21;0;0;21
5261;Lašelis;SKRUZDELIUKAI;1635921119;Ne;0;11;0;11
5262;Lašelis;SKRUZDELIUKAI;1824418095;Taip;7;7;0;14
5263;Lašelis;SKRUZDELIUKAI;7137348151;Taip;0;0;14;14
5264;Lašelis;SKRUZDELIUKAI;3995905195;Taip;7;0;0;7
5265;Lašelis;SKRUZDELIUKAI;6227091658;Taip;12;6;0;18
5266;Lašelis;SKRUZDELIUKAI;2223293390;Ne;2;0;0;2
5267;Lazdynėlis;BITUTĖS;4881322530;Taip;11;4;0;15
5268;Lazdynėlis;BITUTĖS;6643600680;Taip;10;0;1;11
5269;Lazdynėlis;BITUTĖS;5182241318;Ne;0;0;1;1
5270;Lazdynėlis;BITUTĖS;6762312809;Taip;7;2;0;9
5271;Lazdynėlis;BITUTĖS;8008332680;Taip;12;0;0;12
5272;Lazdynėlis;BITUTĖS;1748260780;Taip;0;21;0;21
5273;Lazdynėlis;BITUTĖS;4462819848;Taip;0;11;0;11
5274;Lazdynėlis;BITUTĖS;1574847460;Taip;0;7;2;9
5275;Lazdynėlis;BITUTĖS;5030400578;Taip;2;4;1;7
5276;Lazdynėlis;BITUTĖS;8159928299;Taip;5;2;0;7
5277;Lazdynėlis;BITUTĖS;9761942869;Taip;0;0;1;1
5278;Lazdynėlis;BITUTĖS;7911328294;Taip;7;9;0;16
5279;Lazdynėlis;BITUTĖS;1450181711;Taip;9;4;0;13
5280;Lazdynėlis;BITUTĖS;2044188250;Taip;9;2;0;11
5281;Lazdynėlis;BITUTĖS;4142277927;Taip;10;5;0;15
5282;Lazdynėlis;BITUTĖS;2032759165;Taip;5;0;0;5
5283;Lazdynėlis;BITUTĖS;4826167852;Taip;0;4;2;6
5284;Lazdynėlis;BITUTĖS;2802505435;Taip;0;0;3;3
5285;Lazdynėlis;BITUTĖS;6038907328;Ne;1;10;0;11
5286;Lazdynėlis;BITUTĖS;2586187455;Taip;10;5;0;15
5287;Lazdynėlis;BITUTĖS;2013752858;Taip;11;2;0;13
5288;Lazdynėlis;BITUTĖS;4545757725;Taip;0;6;0;6
5289;Lazdynėlis;BORUŽIUKAI;2168516394;Taip;0;4;0;4
5290;Lazdynėlis;BORUŽIUKAI;4961149717;Taip;0;4;3;7
5291;Lazdynėlis;BORUŽIUKAI;99475014554;Taip;0;0;5;5
5292;Lazdynėlis;BORUŽIUKAI;6156638726;Ne;21;0;0;21
5293;Lazdynėlis;BORUŽIUKAI;1321841783;Taip;0;4;0;4
5294;Lazdynėlis;BORUŽIUKAI;1055608079;Taip;0;1;0;1
5295;Lazdynėlis;BORUŽIUKAI;9570299877;Taip;0;21;0;21
5296;Lazdynėlis;BORUŽIUKAI;1715738053;Taip;0;1;0;1
5297;Lazdynėlis;BORUŽIUKAI;50390821034;Taip;0;4;0;4
5298;Lazdynėlis;BORUŽIUKAI;2112064241;Taip;16;0;0;16
5299;Lazdynėlis;BORUŽIUKAI;86740660262;Taip;0;4;0;4
5300;Lazdynėlis;BORUŽIUKAI;57448939020;Taip;11;5;0;16
5301;Lazdynėlis;BORUŽIUKAI;1789237348;Taip;0;11;0;11
5302;Lazdynėlis;BORUŽIUKAI;2007361692;Taip;0;4;0;4
5303;Lazdynėlis;BORUŽIUKAI;2105998927;Taip;0;4;1;5
5304;Lazdynėlis;BORUŽIUKAI;29288665418;Taip;21;0;0;21
5305;Lazdynėlis;BORUŽIUKAI;1559884361;Taip;12;1;0;13
5306;Lazdynėlis;BORUŽIUKAI;11379612306;Taip;0;7;0;7
5307;Lazdynėlis;BORUŽIUKAI;1650738939;Taip;0;4;0;4
5308;Lazdynėlis;BORUŽIUKAI;7237629135;Taip;2;7;0;9
5309;Lazdynėlis;BORUŽIUKAI;3863927885;Taip;11;4;0;15
5310;Lazdynėlis;BORUŽIUKAI;8945282683;Taip;0;5;0;5
5311;Lazdynėlis;BORUŽIUKAI;5838945434;Taip;0;4;0;4
5312;Lazdynėlis;BORUŽIUKAI;6230420677;Taip;0;3;0;3
5313;Lazdynėlis;KAČIUKAI;66134107213;Taip;0;4;2;6
5314;Lazdynėlis;KAČIUKAI;67819115627;Taip;0;4;1;5
5315;Lazdynėlis;KAČIUKAI;52949287680;Taip;0;8;1;9
5316;Lazdynėlis;KAČIUKAI;97795271362;Taip;17;4;0;21
5317;Lazdynėlis;KAČIUKAI;55167939220;Taip;0;9;0;9
5318;Lazdynėlis;KAČIUKAI;56747379453;Taip;0;5;0;5
5319;Lazdynėlis;KAČIUKAI;1634936961;Taip;12;9;0;21
5320;Lazdynėlis;KAČIUKAI;65438421685;Taip;0;5;0;5
5321;Lazdynėlis;KAČIUKAI;78302777769;Taip;0;11;0;11
5322;Lazdynėlis;KAČIUKAI;85340642919;Taip;0;8;0;8
5323;Lazdynėlis;KAČIUKAI;77950321376;Taip;0;9;0;9
5324;Lazdynėlis;KAČIUKAI;5068598385;Taip;0;4;0;4
5325;Lazdynėlis;KAČIUKAI;2491872016;Taip;0;4;0;4
5326;Lazdynėlis;KAČIUKAI;2740122426;Taip;0;8;2;10
5327;Lazdynėlis;KAČIUKAI;79847018203;Taip;0;7;0;7
5328;Lazdynėlis;KAČIUKAI;1126756897;Ne;0;5;0;5
5329;Lazdynėlis;KAČIUKAI;9881554733;Ne;0;4;0;4
5330;Lazdynėlis;KAČIUKAI;79583491543;Taip;0;3;0;3
5331;Lazdynėlis;KAČIUKAI;1878157118;Taip;0;1;1;2
5332;Lazdynėlis;KAČIUKAI;7242681767;Taip;6;6;0;12
5333;Lazdynėlis;KAČIUKAI;7737877729;Taip;0;8;0;8
5334;Lazdynėlis;VOVERIUKAI;4425724586;Taip;11;4;0;15
5335;Lazdynėlis;VOVERIUKAI;4928593615;Taip;0;5;0;5
5336;Lazdynėlis;VOVERIUKAI;6684940385;Taip;10;4;0;14
5337;Lazdynėlis;VOVERIUKAI;9187681789;Taip;12;2;0;14
5338;Lazdynėlis;VOVERIUKAI;6307407620;Taip;0;4;2;6
5339;Lazdynėlis;VOVERIUKAI;14427234202;Taip;0;4;2;6
5340;Lazdynėlis;VOVERIUKAI;1107441074;Ne;7;4;0;11
5341;Lazdynėlis;VOVERIUKAI;25596458181;Taip;0;21;0;21
5342;Lazdynėlis;VOVERIUKAI;24978945607;Taip;4;0;0;4
5343;Lazdynėlis;VOVERIUKAI;18498032472;Taip;10;0;0;10
5344;Lazdynėlis;VOVERIUKAI;158059657;Taip;11;0;2;13
5345;Lazdynėlis;VOVERIUKAI;1852865534;Taip;15;0;0;15
5346;Lazdynėlis;VOVERIUKAI;7789345652;Taip;0;1;4;5
5347;Lazdynėlis;VOVERIUKAI;3902772678;Taip;5;4;2;11
5348;Lazdynėlis;VOVERIUKAI;8822378464;Ne;16;0;0;16
5349;Lazdynėlis;VOVERIUKAI;6863715428;Taip;0;2;0;2
5350;Lazdynėlis;VOVERIUKAI;1386686123;Taip;0;4;1;5
5351;Lazdynėlis;VOVERIUKAI;2587142646;Taip;6;4;0;10
5352;Lazdynėlis;VOVERIUKAI;2603427970;Taip;0;21;0;21
5353;Lazdynėlis;VOVERIUKAI;2441835588;Taip;7;2;0;9
5354;Lazdynėlis;VOVERIUKAI;3043350186;Taip;0;1;0;1
5355;Lazdynėlis;VOVERIUKAI;44510351979;Taip;0;0;9;9
5356;Lazdynėlis;VOVERIUKAI;6762216509;Taip;0;0;2;2
5357;Lazdynėlis;VOVERIUKAI;7965433882;Taip;0;4;0;4
5358;Lazdynėlis;VOVERIUKAI;1424382629;Taip;8;4;0;12
5359;Lazdynėlis;RIEŠUTĖLIAI;53141612488;Taip;15;4;0;19
5360;Lazdynėlis;RIEŠUTĖLIAI;81489861336;Taip;3;5;1;9
5361;Lazdynėlis;RIEŠUTĖLIAI;11830560488;Taip;0;4;5;9
5362;Lazdynėlis;RIEŠUTĖLIAI;24433496244;Taip;7;6;0;13
5363;Lazdynėlis;RIEŠUTĖLIAI;99158632198;Taip;5;5;0;10
5364;Lazdynėlis;RIEŠUTĖLIAI;4510916643;Taip;5;5;0;10
5365;Lazdynėlis;RIEŠUTĖLIAI;91895608057;Taip;7;4;0;11
5366;Lazdynėlis;RIEŠUTĖLIAI;95091154108;Taip;13;0;0;13
5367;Lazdynėlis;RIEŠUTĖLIAI;95539787778;Taip;0;12;0;12
5368;Lazdynėlis;RIEŠUTĖLIAI;3000783343;Ne;6;5;0;11
5369;Lazdynėlis;RIEŠUTĖLIAI;75017112973;Taip;6;4;0;10
5370;Lazdynėlis;RIEŠUTĖLIAI;66392058189;Taip;0;5;0;5
5371;Lazdynėlis;RIEŠUTĖLIAI;93311489447;Taip;0;13;0;13
5372;Lazdynėlis;RIEŠUTĖLIAI;3980826951;Taip;10;0;2;12
5373;Lazdynėlis;RIEŠUTĖLIAI;8338944978;Taip;4;4;1;9
5374;Lazdynėlis;RIEŠUTĖLIAI;1213657708;Taip;5;4;0;9
5375;Lazdynėlis;RIEŠUTĖLIAI;1169424024;Taip;3;5;0;8
5376;Lazdynėlis;RIEŠUTĖLIAI;1257093165;Taip;0;0;2;2
5377;Lazdynėlis;RIEŠUTĖLIAI;42460029042;Taip;0;4;0;4
5378;Lazdynėlis;RIEŠUTĖLIAI;1166968513;Taip;0;3;2;5
5379;Lazdynėlis;RIEŠUTĖLIAI;58985240094;Taip;5;0;3;8
5380;Lazdynėlis;RIEŠUTĖLIAI;7044338769;Taip;6;4;0;10
5381;Lazdynėlis;RIEŠUTĖLIAI;9186165264;Taip;10;4;0;14
5382;Lazdynėlis;RIEŠUTĖLIAI;90528749634;Ne;0;4;0;4
5383;Lazdynėlis;ANČIUKAI;5557752248;Taip;4;4;6;14
5384;Lazdynėlis;ANČIUKAI;5888646355;Taip;8;0;1;9
5385;Lazdynėlis;ANČIUKAI;3678422730;Taip;0;2;0;2
5386;Lazdynėlis;ANČIUKAI;8295967906;Taip;6;0;0;6
5387;Lazdynėlis;ANČIUKAI;7076664657;Taip;0;4;8;12
5388;Lazdynėlis;ANČIUKAI;7864896721;Taip;14;0;1;15
5389;Lazdynėlis;ANČIUKAI;8435203145;Taip;0;21;0;21
5390;Lazdynėlis;ANČIUKAI;1335000592;Ne;7;0;0;7
5391;Lazdynėlis;ANČIUKAI;8314002741;Taip;0;0;5;5
5392;Lazdynėlis;ANČIUKAI;2998606948;Taip;5;0;0;5
5393;Lazdynėlis;ANČIUKAI;9886856760;Taip;5;0;0;5
5394;Lazdynėlis;ANČIUKAI;3062408541;Ne;0;21;0;21
5395;Lazdynėlis;ANČIUKAI;7941793866;Taip;15;0;0;15
5396;Lazdynėlis;ANČIUKAI;5796381191;Taip;0;3;1;4
5397;Lazdynėlis;ANČIUKAI;5708643953;Taip;0;0;2;2
5398;Lazdynėlis;ANČIUKAI;7545621720;Taip;4;4;3;11
5399;Lazdynėlis;ANČIUKAI;9582702244;Taip;5;1;0;6
5400;Lazdynėlis;ANČIUKAI;9231049001;Taip;0;2;3;5
5401;Lazdynėlis;ANČIUKAI;6164180360;Taip;12;0;4;16
5402;Lazdynėlis;GUDRUČIAI;11183641643;Taip;0;1;2;3
5403;Lazdynėlis;GUDRUČIAI;1543682603;Taip;0;9;0;9
5404;Lazdynėlis;GUDRUČIAI;6079498859;Ne;0;7;2;9
5405;Lazdynėlis;GUDRUČIAI;96599967318;Taip;3;7;0;10
5406;Lazdynėlis;GUDRUČIAI;44974714364;Taip;0;3;0;3
5407;Lazdynėlis;GUDRUČIAI;57304690488;Taip;0;4;0;4
5408;Lazdynėlis;GUDRUČIAI;57619129301;Taip;0;10;0;10
5409;Lazdynėlis;GUDRUČIAI;64086512959;Taip;0;11;0;11
5410;Lazdynėlis;GUDRUČIAI;56719158862;Taip;0;6;0;6
5411;Lazdynėlis;GUDRUČIAI;76657029807;Taip;0;9;2;11
5412;Lazdynėlis;GUDRUČIAI;41094911675;Taip;0;6;0;6
5413;Lazdynėlis;GUDRUČIAI;70505428445;Taip;0;7;1;8
5414;Lazdynėlis;GUDRUČIAI;1349582895;Ne;0;6;0;6
5415;Lazdynėlis;GUDRUČIAI;47140772153;Taip;9;2;0;11
5416;Lazdynėlis;GUDRUČIAI;34657435789;Taip;0;2;0;2
5417;Lazdynėlis;GUDRUČIAI;62863155757;Taip;0;6;0;6
5418;Lazdynėlis;GUDRUČIAI;34619798427;Taip;0;10;3;13
5419;Lazdynėlis;GUDRUČIAI;1909075641;Taip;0;5;1;6
5420;Lazdynėlis;GUDRUČIAI;2496563388;Taip;0;21;0;21
5421;Lazdynėlis;GUDRUČIAI;28670815274;Taip;3;4;0;7
5422;Lazdynėlis;GUDRUČIAI;8704566189;Taip;6;6;0;12
5423;Lazdynėlis;MEŠKIUKAI;3667994076;Taip;0;6;6;12
5424;Lazdynėlis;MEŠKIUKAI;3239107488;Ne;0;5;0;5
5425;Lazdynėlis;MEŠKIUKAI;1325204410;Taip;4;0;2;6
5426;Lazdynėlis;MEŠKIUKAI;3604282352;Taip;8;0;0;8
5427;Lazdynėlis;MEŠKIUKAI;3062924645;Taip;2;4;1;7
5428;Lazdynėlis;MEŠKIUKAI;8179584161;Taip;5;4;2;11
5429;Lazdynėlis;MEŠKIUKAI;8942906327;Ne;0;21;0;21
5430;Lazdynėlis;MEŠKIUKAI;9810842975;Taip;0;4;1;5
5431;Lazdynėlis;MEŠKIUKAI;7523052754;Taip;0;0;11;11
5432;Lazdynėlis;MEŠKIUKAI;8248185061;Taip;10;4;0;14
5433;Lazdynėlis;MEŠKIUKAI;8627994583;Taip;0;21;0;21
5434;Lazdynėlis;MEŠKIUKAI;9548653584;Taip;0;21;0;21
5435;Lazdynėlis;MEŠKIUKAI;8337458289;Taip;0;21;0;21
5436;Lazdynėlis;MEŠKIUKAI;3040417651;Taip;0;21;0;21
5437;Lazdynėlis;MEŠKIUKAI;4055450300;Ne;14;0;1;15
5438;Lazdynėlis;MEŠKIUKAI;3362193379;Taip;5;4;0;9
5439;Lazdynėlis;MEŠKIUKAI;1668899344;Taip;0;4;4;8
5440;Linelis;Giliukai;4443285231;Taip;0;4;3;7
5441;Linelis;Giliukai;79543604124;Taip;9;0;2;11
5442;Linelis;Giliukai;3300710386;Taip;5;0;1;6
5443;Linelis;Giliukai;1505058152;Ne;9;5;4;18
5444;Linelis;Giliukai;4644771654;Taip;2;6;6;14
5445;Linelis;Giliukai;94514045159;Taip;2;4;1;7
5446;Linelis;Giliukai;1270931913;Taip;3;4;5;12
5447;Linelis;Giliukai;1237521453;Taip;0;0;1;1
5448;Linelis;Giliukai;1270843542;Taip;0;4;3;7
5449;Linelis;Giliukai;1159267747;Taip;0;3;2;5
5450;Linelis;Giliukai;5903547677;Taip;0;0;1;1
5451;Linelis;Giliukai;58467930454;Taip;10;5;0;15
5452;Linelis;Giliukai;37069004807;Taip;0;0;5;5
5453;Linelis;Giliukai;5075219728;Taip;5;4;5;14
5454;Linelis;Giliukai;5302605429;Taip;5;0;4;9
5455;Linelis;Giliukai;1891722948;Ne;9;0;2;11
5456;Linelis;Giliukai;71647031404;Ne;11;0;2;13
5457;Linelis;Giliukai;1148540808;Taip;0;5;4;9
5458;Linelis;Giliukai;46788785414;Taip;0;4;2;6
5459;Linelis;Giliukai;3483401448;Ne;0;4;12;16
5460;Linelis;Giliukai;61862257310;Taip;0;0;10;10
5461;Linelis;Giliukai;1526473615;Ne;5;0;7;12
5462;Linelis;Saulutė;1623356368;Ne;6;0;1;7
5463;Linelis;Saulutė;1374116898;Ne;0;4;7;11
5464;Linelis;Saulutė;76034696439;Taip;0;3;2;5
5465;Linelis;Saulutė;77154624822;Taip;2;9;0;11
5466;Linelis;Saulutė;54594020356;Ne;0;9;5;14
5467;Linelis;Saulutė;4425214681;Taip;0;1;0;1
5468;Linelis;Saulutė;68038417200;Taip;0;4;3;7
5469;Linelis;Saulutė;60507620097;Taip;5;0;1;6
5470;Linelis;Saulutė;13522521866;Taip;0;9;0;9
5471;Linelis;Saulutė;92658776822;Taip;0;13;0;13
5472;Linelis;Saulutė;29074930927;Ne;0;9;3;12
5473;Linelis;Saulutė;1539102468;Taip;9;0;2;11
5474;Linelis;Saulutė;68089107580;Ne;0;10;2;12
5475;Linelis;Saulutė;1646521870;Ne;5;5;2;12
5476;Linelis;Saulutė;53442382594;Taip;0;4;1;5
5477;Linelis;Saulutė;87947273588;Taip;0;8;0;8
5478;Linelis;Saulutė;93959783827;Taip;0;4;2;6
5479;Linelis;Saulutė;73386013083;Taip;0;14;3;17
5480;Linelis;Saulutė;32821891070;Ne;9;14;0;23
5481;Linelis;Saulutė;18414199111;Taip;0;0;11;11
5482;Linelis;Saulutė;1908259203;Taip;0;4;5;9
5483;Linelis;Nykštukai;2194387139;Taip;0;0;3;3
5484;Linelis;Nykštukai;8339073780;Taip;6;0;1;7
5485;Linelis;Nykštukai;7530950218;Ne;5;4;2;11
5486;Linelis;Nykštukai;1194624252;Taip;9;0;2;11
5487;Linelis;Nykštukai;2391319590;Taip;2;5;1;8
5488;Linelis;Nykštukai;9666785036;Ne;0;3;1;4
5489;Linelis;Nykštukai;8095635609;Ne;0;3;1;4
5490;Linelis;Nykštukai;1887737859;Taip;0;4;0;4
5491;Linelis;Nykštukai;4126444564;Taip;3;4;5;12
5492;Linelis;Nykštukai;3158789663;Taip;0;0;2;2
5493;Linelis;Nykštukai;8837847094;Taip;20;0;0;20
5494;Linelis;Nykštukai;4738909947;Ne;7;2;0;9
5495;Linelis;Nykštukai;3189188757;Taip;9;3;0;12
5496;Linelis;Nykštukai;1351957198;Taip;7;0;2;9
5497;Linelis;Nykštukai;3682550072;Ne;0;3;2;5
5498;Linelis;Nykštukai;2857645329;Taip;0;1;2;3
5499;Linelis;Nykštukai;8654487151;Taip;0;0;2;2
5500;Linelis;Nykštukai;6160295507;Taip;5;0;6;11
5501;Linelis;Nykštukai;6374352500;Taip;0;1;0;1
5502;Linelis;Daigiukai;4464615995;Taip;9;0;0;9
5503;Linelis;Daigiukai;9775865557;Taip;0;0;1;1
5504;Linelis;Daigiukai;4456549120;Taip;3;0;5;8
5505;Linelis;Daigiukai;7320085613;Taip;9;4;0;13
5506;Linelis;Daigiukai;6460217912;Taip;0;8;2;10
5507;Linelis;Daigiukai;5668765825;Taip;0;12;0;12
5508;Linelis;Daigiukai;1612049897;Taip;5;4;7;16
5509;Linelis;Daigiukai;3954867816;Taip;9;9;1;19
5510;Linelis;Daigiukai;2228682366;Taip;6;9;0;15
5511;Linelis;Daigiukai;7011836009;Taip;16;0;5;21
5512;Linelis;Daigiukai;6735037523;Taip;6;0;5;11
5513;Linelis;Daigiukai;7881263225;Taip;5;5;0;10
5514;Linelis;Daigiukai;9147558926;Taip;0;15;0;15
5515;Linelis;Daigiukai;9920959446;Taip;2;5;0;7
5516;Linelis;Daigiukai;8623441952;Taip;10;0;7;17
5517;Linelis;Daigiukai;9154573489;Taip;0;0;2;2
5518;Linelis;Daigiukai;9024362190;Taip;0;0;8;8
5519;Markučiai;Žirniukų;4934200922;Taip;0;2;0;2
5520;Markučiai;Žirniukų;89393452327;Taip;4;4;2;10
5521;Markučiai;Žirniukų;86073430849;Taip;0;4;0;4
5522;Markučiai;Žirniukų;23712199138;Taip;0;2;0;2
5523;Markučiai;Žirniukų;59514770545;Taip;7;0;0;7
5524;Markučiai;Žirniukų;68178936347;Taip;2;4;0;6
5525;Markučiai;Žirniukų;62276512687;Taip;0;4;0;4
5526;Markučiai;Žirniukų;95776655287;Taip;9;1;1;11
5527;Markučiai;Žirniukų;47122307518;Taip;0;1;0;1
5528;Markučiai;Žirniukų;3498150320;Taip;0;4;1;5
5529;Markučiai;Žirniukų;95347461846;Taip;3;6;0;9
5530;Markučiai;Žirniukų;1962169822;Taip;0;2;0;2
5531;Markučiai;Žirniukų;1986626575;Taip;0;4;3;7
5532;Markučiai;Žirniukų;2397953983;Taip;8;4;0;12
5533;Markučiai;Nykštukų;46647877230;Taip;6;5;0;11
5534;Markučiai;Nykštukų;37101160556;Taip;0;5;2;7
5535;Markučiai;Nykštukų;1473258832;Taip;3;3;0;6
5536;Markučiai;Nykštukų;92394309416;Taip;5;2;2;9
5537;Markučiai;Nykštukų;5026941590;Taip;0;4;0;4
5538;Markučiai;Nykštukų;81140027425;Taip;0;4;0;4
5539;Markučiai;Nykštukų;6915912992;Taip;5;2;2;9
5540;Markučiai;Nykštukų;52920975294;Taip;0;1;0;1
5541;Markučiai;Nykštukų;88304161598;Taip;0;2;0;2
5542;Markučiai;Nykštukų;76003071176;Taip;10;1;0;11
5543;Markučiai;Nykštukų;1464123752;Taip;0;4;1;5
5544;Markučiai;Nykštukų;6639579832;Taip;5;4;0;9
5545;Markučiai;Nykštukų;9985442003;Taip;0;13;0;13
5546;Markučiai;Nykštukų;1507368475;Taip;7;4;0;11
5547;Markučiai;Nykštukų;1817367317;Taip;0;4;0;4
5548;Markučiai;Nykštukų;5954207590;Taip;8;4;0;12
5549;Markučiai;Pelėdžiukų;3386071459;Taip;15;0;0;15
5550;Markučiai;Pelėdžiukų;4653663237;Ne;22;0;0;22
5551;Markučiai;Pelėdžiukų;6260010822;Taip;0;3;1;4
5552;Markučiai;Pelėdžiukų;5727655114;Taip;0;0;3;3
5553;Markučiai;Pelėdžiukų;6740434675;Taip;0;0;5;5
5554;Markučiai;Pelėdžiukų;6707310242;Taip;22;0;1;23
5555;Markučiai;Pelėdžiukų;2256262371;Taip;17;6;0;23
5556;Markučiai;Pelėdžiukų;7947287013;Taip;17;7;0;24
5557;Markučiai;Pelėdžiukų;2543313198;Taip;2;7;3;12
5558;Markučiai;Pelėdžiukų;4418580273;Taip;0;0;1;1
5559;Markučiai;Pelėdžiukų;5522654429;Taip;6;12;3;21
5560;Markučiai;Pelėdžiukų;4860961508;Taip;19;0;0;19
5561;Markučiai;Pelėdžiukų;9219710045;Ne;15;0;0;15
5562;Markučiai;Pelėdžiukų;3525681034;Taip;2;0;4;6
5563;Markučiai;Pelėdžiukų;7312533881;Taip;2;0;4;6
5564;Markučiai;Boružėlių;9059302464;Taip;7;0;5;12
5565;Markučiai;Boružėlių;9220749889;Taip;14;0;0;14
5566;Markučiai;Boružėlių;2962530721;Taip;0;3;0;3
5567;Markučiai;Boružėlių;6574037877;Taip;8;0;2;10
5568;Markučiai;Boružėlių;5752762229;Taip;14;1;0;15
5569;Markučiai;Boružėlių;9789274040;Taip;10;5;0;15
5570;Markučiai;Boružėlių;1146968021;Taip;5;0;0;5
5571;Markučiai;Boružėlių;1171899107;Taip;0;14;0;14
5572;Markučiai;Boružėlių;8092642447;Ne;0;6;0;6
5573;Markučiai;Boružėlių;8078777204;Taip;17;0;0;17
5574;Markučiai;Boružėlių;8605357678;Taip;7;0;2;9
5575;Markučiai;Boružėlių;3755794133;Taip;12;0;0;12
5576;Markučiai;Boružėlių;8244065962;Ne;5;1;1;7
5577;Markučiai;Boružėlių;5902165968;Taip;6;0;0;6
5578;Markučiai;Boružėlių;4356736070;Taip;5;0;1;6
5579;Markučiai;Boružėlių;6055058096;Taip;17;0;4;21
5580;Markučiai;Boružėlių;5981692282;Taip;7;0;2;9
5581;Markučiai;Boružėlių;3739566642;Taip;21;0;0;21
5582;Markučiai;Boružėlių;6868394315;Taip;4;3;1;8
5583;Markučiai;Bitučių;1720541082;Ne;5;0;2;7
5584;Markučiai;Bitučių;8792524832;Taip;8;4;0;12
5585;Markučiai;Bitučių;1717624510;Taip;10;0;0;10
5586;Markučiai;Bitučių;9518247571;Taip;5;4;0;9
5587;Markučiai;Bitučių;4836298058;Taip;3;5;2;10
5588;Markučiai;Bitučių;9027071539;Taip;6;1;0;7
5589;Markučiai;Bitučių;8748794886;Taip;9;0;7;16
5590;Markučiai;Bitučių;7387460586;Taip;14;0;0;14
5591;Markučiai;Bitučių;8950442843;Taip;14;0;0;14
5592;Markučiai;Bitučių;2840564082;Ne;0;0;2;2
5593;Markučiai;Bitučių;3926993383;Taip;0;0;11;11
5594;Markučiai;Bitučių;6530101961;Taip;12;3;0;15
5595;Markučiai;Bitučių;1908302738;Taip;7;0;6;13
5596;Markučiai;Bitučių;7056367646;Taip;16;0;0;16
5597;Markučiai;Bitučių;8195584468;Taip;0;0;1;1
5598;Markučiai;Bitučių;2049497686;Taip;16;1;0;17
5599;Markučiai;Bitučių;9303448709;Taip;14;0;6;20
5600;Markučiai;Bitučių;8541042547;Taip;12;4;5;21
5601;Markučiai;Bitučių;1447116821;Taip;0;20;1;21
5602;Markučiai;Bitučių;6600535396;Taip;9;0;10;19
5603;Markučiai;Drugelių;2851424931;Taip;5;3;0;8
5604;Markučiai;Drugelių;1719927769;Taip;5;0;0;5
5605;Markučiai;Drugelių;1411292558;Taip;4;0;0;4
5606;Markučiai;Drugelių;63211076619;Taip;0;0;2;2
5607;Markučiai;Drugelių;2608111078;Ne;4;1;0;5
5608;Markučiai;Drugelių;9428254633;Taip;5;4;0;9
5609;Markučiai;Drugelių;4573605085;Ne;2;0;0;2
5610;Markučiai;Drugelių;19415636420;Taip;0;2;0;2
5611;Markučiai;Drugelių;24315961901;Taip;6;0;0;6
5612;Markučiai;Drugelių;45698891062;Taip;0;2;0;2
5613;Markučiai;Drugelių;22197471483;Taip;0;5;0;5
5614;Markučiai;Drugelių;9028932081;Taip;3;7;0;10
5615;Markučiai;Drugelių;11203825718;Taip;0;4;2;6
5616;Markučiai;Drugelių;7194049189;Taip;0;4;0;4
5617;Markučiai;Drugelių;1964223995;Taip;0;0;2;2
5618;Markučiai;Drugelių;23081602011;Ne;6;0;0;6
5619;Markučiai;Drugelių;9295954145;Taip;0;0;1;1
5620;Markučiai;Skruzdėliukų;1471334430;Taip;8;0;4;12
5621;Markučiai;Skruzdėliukų;9825799013;Ne;17;4;0;21
5622;Markučiai;Skruzdėliukų;8803226424;Taip;7;0;1;8
5623;Markučiai;Skruzdėliukų;20702694553;Taip;11;0;0;11
5624;Markučiai;Skruzdėliukų;55093673733;Taip;11;0;2;13
5625;Markučiai;Skruzdėliukų;39971140989;Taip;14;0;1;15
5626;Markučiai;Skruzdėliukų;54732351634;Taip;10;2;1;13
5627;Markučiai;Skruzdėliukų;1631270056;Taip;0;2;0;2
5628;Markučiai;Skruzdėliukų;1419433247;Taip;2;11;0;13
5629;Markučiai;Skruzdėliukų;1089500743;Taip;5;6;10;21
5630;Markučiai;Skruzdėliukų;2939795063;Taip;2;4;1;7
5631;Markučiai;Skruzdėliukų;9285037135;Taip;15;0;2;17
5632;Markučiai;Skruzdėliukų;1699369138;Taip;8;3;7;18
5633;Markučiai;Skruzdėliukų;1881218133;Taip;7;0;3;10
5634;Markučiai;Skruzdėliukų;8863238710;Ne;0;9;7;16
5635;Markučiai;Skruzdėliukų;68193563408;Taip;0;4;2;6
5636;Markučiai;Skruzdėliukų;92854605649;Taip;21;0;0;21
5637;Markučiai;Skruzdėliukų;7114409929;Taip;0;0;4;4
5638;Markučiai;Skruzdėliukų;1529531638;Taip;0;4;2;6
5639;Markučiai;Skruzdėliukų;4511936094;Taip;2;4;0;6
5640;Markučiai;ZUIKUČIŲ;4861535057;Taip;6;2;0;8
5641;Markučiai;ZUIKUČIŲ;1482203905;Taip;3;1;1;5
5642;Markučiai;ZUIKUČIŲ;2045207175;Taip;0;5;0;5
5643;Markučiai;ZUIKUČIŲ;11751635395;Taip;4;3;0;7
5644;Markučiai;ZUIKUČIŲ;1184908076;Taip;4;0;4;8
5645;Markučiai;ZUIKUČIŲ;7729045227;Taip;7;0;1;8
5646;Markučiai;ZUIKUČIŲ;8061880631;Taip;9;0;0;9
5647;Markučiai;ZUIKUČIŲ;1392582514;Taip;9;0;0;9
5648;Markučiai;ZUIKUČIŲ;7691410556;Taip;2;6;0;8
5649;Markučiai;ZUIKUČIŲ;6453095915;Taip;5;0;0;5
5650;Markučiai;ZUIKUČIŲ;6808291628;Taip;2;13;0;15
5651;Markučiai;ZUIKUČIŲ;5387571295;Taip;9;0;0;9
5652;Markučiai;ZUIKUČIŲ;3794643964;Taip;0;4;0;4
5653;Markučiai;ZUIKUČIŲ;91228262895;Taip;18;0;0;18
5654;Markučiai;ZUIKUČIŲ;7481923902;Taip;0;0;2;2
5655;Markučiai;ZUIKUČIŲ;1025406111;Taip;0;10;0;10
5656;Markučiai;ZUIKUČIŲ;7778551869;Ne;7;4;5;16
5657;Markučiai;ŽIOGELIŲ;5099997904;Taip;8;0;0;8
5658;Markučiai;ŽIOGELIŲ;3163226803;Taip;13;0;0;13
5659;Markučiai;ŽIOGELIŲ;1244026489;Taip;6;0;1;7
5660;Markučiai;ŽIOGELIŲ;76025616287;Taip;0;4;0;4
5661;Markučiai;ŽIOGELIŲ;1323922187;Taip;2;7;0;9
5662;Markučiai;ŽIOGELIŲ;54892037118;Taip;0;5;1;6
5663;Markučiai;ŽIOGELIŲ;1054802708;Taip;5;0;2;7
5664;Markučiai;ŽIOGELIŲ;67074776419;Taip;13;1;0;14
5665;Markučiai;ŽIOGELIŲ;1007919702;Taip;0;10;0;10
5666;Markučiai;ŽIOGELIŲ;1923521405;Taip;0;0;1;1
5667;Markučiai;ŽIOGELIŲ;1164386108;Taip;0;0;1;1
5668;Markučiai;ŽIOGELIŲ;7850311496;Taip;5;0;0;5
5669;Markučiai;ŽIOGELIŲ;2169583290;Taip;0;15;0;15
5670;Markučiai;ŽIOGELIŲ;3340385503;Taip;15;0;1;16
5671;Markučiai;ŽIOGELIŲ;1742944578;Taip;0;4;0;4
5672;Markučiai;Ežiukių;1827829954;Taip;2;1;0;3
5673;Markučiai;Ežiukių;4925856706;Taip;0;21;0;21
5674;Markučiai;Ežiukių;6570638672;Taip;9;2;0;11
5675;Markučiai;Ežiukių;1648283497;Taip;0;12;0;12
5676;Markučiai;Ežiukių;4186684938;Taip;19;0;0;19
5677;Markučiai;Ežiukių;5975331223;Taip;3;3;0;6
5678;Markučiai;Ežiukių;2687320408;Ne;13;0;0;13
5679;Markučiai;Ežiukių;1309122110;Ne;6;1;1;8
5680;Markučiai;Ežiukių;8990923872;Taip;17;0;0;17
5681;Markučiai;Ežiukių;2738553283;Taip;14;4;0;18
5682;Markučiai;Ežiukių;5246980173;Ne;13;0;0;13
5683;Markučiai;Ežiukių;1599633295;Taip;0;12;0;12
5684;Markučiai;Ežiukių;6308368050;Ne;16;0;0;16
5685;Markučiai;Ežiukių;4249158803;Taip;5;0;3;8
5686;Markučiai;Ežiukių;5958705106;Taip;0;3;1;4
5687;Markučiai;Ežiukių;1989923269;Taip;0;0;5;5
5688;Markučiai;Ežiukių;1769984489;Taip;0;0;5;5
5689;Markučiai;Ežiukių;7539605426;Taip;8;0;2;10
5690;Mažylis;"2 DARŽELIO GR.";2979849055;Ne;4;0;0;4
5691;Mažylis;"2 DARŽELIO GR.";4503734408;Taip;18;0;0;18
5692;Mažylis;"2 DARŽELIO GR.";6162880220;Taip;5;0;0;5
5693;Mažylis;"2 DARŽELIO GR.";9362249595;Taip;6;0;12;18
5694;Mažylis;"2 DARŽELIO GR.";1077493584;Taip;10;0;0;10
5695;Mažylis;"2 DARŽELIO GR.";6854350717;Taip;7;0;1;8
5696;Mažylis;"2 DARŽELIO GR.";2704741847;Taip;0;0;3;3
5697;Mažylis;"2 DARŽELIO GR.";5870983755;Ne;0;0;5;5
5698;Mažylis;"2 DARŽELIO GR.";7185347381;Taip;0;0;3;3
5699;Mažylis;"2 DARŽELIO GR.";3327673298;Ne;0;0;3;3
5700;Mažylis;"2 DARŽELIO GR.";4280547746;Taip;0;5;4;9
5701;Mažylis;"2 DARŽELIO GR.";9447747294;Taip;10;0;10;20
5702;Mažylis;"2 DARŽELIO GR.";2126108232;Taip;0;0;10;10
5703;Mažylis;"2 DARŽELIO GR.";9382248260;Taip;8;0;0;8
5704;Mažylis;"2 DARŽELIO GR.";1762105763;Taip;6;4;3;13
5705;Mažylis;"2 DARŽELIO GR.";2672500259;Taip;4;2;1;7
5706;Mažylis;"2 DARŽELIO GR.";8135596731;Taip;7;0;0;7
5707;Mažylis;"2 DARŽELIO GR.";8866980930;Taip;3;0;3;6
5708;Mažylis;"2 DARŽELIO GR.";4542742002;Taip;0;0;9;9
5709;Mažylis;"4 PRIEŠMOKYKLINĖ GR.";38333694019;Taip;0;0;12;12
5710;Mažylis;"4 PRIEŠMOKYKLINĖ GR.";4899739075;Taip;3;4;0;7
5711;Mažylis;"4 PRIEŠMOKYKLINĖ GR.";1217081615;Taip;0;0;3;3
5712;Mažylis;"4 PRIEŠMOKYKLINĖ GR.";67697608754;Taip;0;4;1;5
5713;Mažylis;"4 PRIEŠMOKYKLINĖ GR.";71414598607;Taip;0;4;0;4
5714;Mažylis;"4 PRIEŠMOKYKLINĖ GR.";2249845212;Taip;5;0;9;14
5715;Mažylis;"4 PRIEŠMOKYKLINĖ GR.";10093289570;Ne;3;4;1;8
5716;Mažylis;"4 PRIEŠMOKYKLINĖ GR.";94128544096;Taip;10;2;0;12
5717;Mažylis;"4 PRIEŠMOKYKLINĖ GR.";99612915803;Taip;14;0;5;19
5718;Mažylis;"4 PRIEŠMOKYKLINĖ GR.";72018918082;Taip;0;0;6;6
5719;Mažylis;"4 PRIEŠMOKYKLINĖ GR.";88409362086;Taip;0;4;0;4
5720;Mažylis;"4 PRIEŠMOKYKLINĖ GR.";34677678888;Ne;0;12;0;12
5721;Mažylis;"4 PRIEŠMOKYKLINĖ GR.";44917962136;Taip;0;4;6;10
5722;Mažylis;"4 PRIEŠMOKYKLINĖ GR.";1023886258;Ne;0;0;10;10
5723;Mažylis;"4 PRIEŠMOKYKLINĖ GR.";68630915872;Taip;0;0;2;2
5724;Mažylis;"4 PRIEŠMOKYKLINĖ GR.";1418120714;Taip;0;0;6;6
5725;Mažylis;"4 PRIEŠMOKYKLINĖ GR.";1381948803;Taip;12;0;3;15
5726;Mažylis;"4 PRIEŠMOKYKLINĖ GR.";1355103006;Taip;0;4;7;11
5727;Mažylis;"4 PRIEŠMOKYKLINĖ GR.";5570166468;Taip;5;0;5;10
5728;Mažylis;"3 DARŽELIO GR.";98057700570;Taip;0;4;0;4
5729;Mažylis;"3 DARŽELIO GR.";24303144913;Taip;8;0;0;8
5730;Mažylis;"3 DARŽELIO GR.";69238700097;Taip;0;4;3;7
5731;Mažylis;"3 DARŽELIO GR.";50868656860;Taip;21;0;0;21
5732;Mažylis;"3 DARŽELIO GR.";13841546358;Taip;0;4;1;5
5733;Mažylis;"3 DARŽELIO GR.";2070067356;Ne;7;0;1;8
5734;Mažylis;"3 DARŽELIO GR.";81907805809;Taip;13;0;2;15
5735;Mažylis;"3 DARŽELIO GR.";1999937720;Taip;0;4;2;6
5736;Mažylis;"3 DARŽELIO GR.";90336289067;Ne;0;4;1;5
5737;Mažylis;"3 DARŽELIO GR.";46239142395;Taip;0;0;1;1
5738;Mažylis;"3 DARŽELIO GR.";1021183555;Taip;0;9;4;13
5739;Mažylis;"3 DARŽELIO GR.";1910064549;Taip;0;0;1;1
5740;Mažylis;"3 DARŽELIO GR.";86823456557;Taip;1;0;1;2
5741;Mažylis;"3 DARŽELIO GR.";2299288258;Taip;7;0;1;8
5742;Mažylis;"3 DARŽELIO GR.";5479496104;Ne;9;0;0;9
5743;Mažylis;"3 DARŽELIO GR.";1520251270;Taip;0;0;10;10
5744;Mažylis;"3 DARŽELIO GR.";5271395545;Taip;0;0;9;9
5745;Mažylis;"6 DARŽELIO GR.";9411559447;Taip;18;0;0;18
5746;Mažylis;"6 DARŽELIO GR.";79181926145;Taip;16;0;0;16
5747;Mažylis;"6 DARŽELIO GR.";45148418456;Taip;18;3;0;21
5748;Mažylis;"6 DARŽELIO GR.";8352202912;Taip;0;4;1;5
5749;Mažylis;"6 DARŽELIO GR.";38277640135;Taip;10;4;0;14
5750;Mažylis;"6 DARŽELIO GR.";8899463988;Taip;0;0;9;9
5751;Mažylis;"6 DARŽELIO GR.";1663347167;Ne;18;0;0;18
5752;Mažylis;"6 DARŽELIO GR.";5063094678;Taip;5;0;6;11
5753;Mažylis;"6 DARŽELIO GR.";6920129837;Ne;7;0;1;8
5754;Mažylis;"6 DARŽELIO GR.";1460572347;Taip;4;0;0;4
5755;Mažylis;"6 DARŽELIO GR.";3860760654;Taip;0;0;5;5
5756;Mažylis;"6 DARŽELIO GR.";4486742281;Taip;0;0;4;4
5757;Mažylis;"6 DARŽELIO GR.";4252408251;Ne;0;0;3;3
5758;Mažylis;"6 DARŽELIO GR.";3217527771;Taip;3;4;0;7
5759;Mažylis;"6 DARŽELIO GR.";6134051712;Taip;8;2;0;10
5760;Mažylis;"6 DARŽELIO GR.";7416381505;Ne;13;0;0;13
5761;Mažylis;"6 DARŽELIO GR.";1514640197;Taip;0;0;8;8
5762;Mažylis;"6 DARŽELIO GR.";1002832487;Taip;5;0;4;9
5763;Mažylis;"6 DARŽELIO GR.";9608529135;Taip;0;0;9;9
5764;Mažylis;"6 DARŽELIO GR.";4645411379;Taip;0;4;0;4
5765;Mažylis;"1 NAUJA (LOPŠELIS)";6100650710;Taip;7;0;5;12
5766;Mažylis;"1 NAUJA (LOPŠELIS)";5685988186;Taip;0;0;3;3
5767;Mažylis;"1 NAUJA (LOPŠELIS)";7754956214;Taip;21;0;0;21
5768;Mažylis;"1 NAUJA (LOPŠELIS)";8589124394;Taip;7;0;0;7
5769;Mažylis;"1 NAUJA (LOPŠELIS)";7652390515;Ne;0;0;5;5
5770;Mažylis;"1 NAUJA (LOPŠELIS)";8639480781;Taip;7;0;1;8
5771;Mažylis;"1 NAUJA (LOPŠELIS)";2672864291;Taip;8;0;1;9
5772;Mažylis;"1 NAUJA (LOPŠELIS)";9401388775;Taip;18;0;0;18
5773;Mažylis;"1 NAUJA (LOPŠELIS)";6009637985;Taip;2;4;11;17
5774;Mažylis;"1 NAUJA (LOPŠELIS)";3400122626;Taip;0;0;5;5
5775;Mažylis;"1 NAUJA (LOPŠELIS)";6809320247;Taip;17;0;0;17
5776;Mažylis;"1 NAUJA (LOPŠELIS)";7106648054;Taip;9;0;0;9
5777;Mažylis;"1 NAUJA (LOPŠELIS)";9341935211;Taip;11;0;4;15
5778;Mažylis;"1 NAUJA (LOPŠELIS)";4817146074;Taip;5;0;2;7
5779;Mažylis;"1 NAUJA (LOPŠELIS)";2656290898;Taip;12;0;0;12
5780;Mažylis;"1 NAUJA (LOPŠELIS)";1420913875;Taip;7;0;3;10
5781;Mažylis;"5 PRIEŠMOKYKLINĖ GR. ";3436690709;Taip;4;0;2;6
5782;Mažylis;"5 PRIEŠMOKYKLINĖ GR. ";36307201422;Ne;0;4;1;5
5783;Mažylis;"5 PRIEŠMOKYKLINĖ GR. ";9958976870;Taip;0;4;10;14
5784;Mažylis;"5 PRIEŠMOKYKLINĖ GR. ";9095049088;Taip;5;0;1;6
5785;Mažylis;"5 PRIEŠMOKYKLINĖ GR. ";91436869919;Taip;0;4;3;7
5786;Mažylis;"5 PRIEŠMOKYKLINĖ GR. ";1391395429;Taip;5;0;1;6
5787;Mažylis;"5 PRIEŠMOKYKLINĖ GR. ";71577274183;Ne;4;0;1;5
5788;Mažylis;"5 PRIEŠMOKYKLINĖ GR. ";8318476578;Taip;6;0;4;10
5789;Mažylis;"5 PRIEŠMOKYKLINĖ GR. ";43986953632;Ne;0;4;0;4
5790;Mažylis;"5 PRIEŠMOKYKLINĖ GR. ";8439933210;Ne;0;0;3;3
5791;Mažylis;"5 PRIEŠMOKYKLINĖ GR. ";56438009944;Ne;0;8;0;8
5792;Mažylis;"5 PRIEŠMOKYKLINĖ GR. ";18640177395;Taip;0;0;1;1
5793;Mažylis;"5 PRIEŠMOKYKLINĖ GR. ";8490035231;Taip;0;13;0;13
5794;Mažylis;"5 PRIEŠMOKYKLINĖ GR. ";37676161966;Ne;7;4;0;11
5795;Mažylis;"5 PRIEŠMOKYKLINĖ GR. ";11471986928;Taip;8;0;2;10
5796;Mažylis;"5 PRIEŠMOKYKLINĖ GR. ";7774469604;Taip;0;0;9;9
5797;Mažylis;"5 PRIEŠMOKYKLINĖ GR. ";87637767247;Taip;10;0;10;20
5798;Mažylis;"5 PRIEŠMOKYKLINĖ GR. ";1692808423;Taip;0;0;4;4
5799;Mažylis;"5 PRIEŠMOKYKLINĖ GR. ";37179412928;Taip;0;4;0;4
5800;Medynėlis;BITUTĖS;1721728772;Taip;3;5;0;8
5801;Medynėlis;BITUTĖS;1870621987;Taip;0;3;1;4
5802;Medynėlis;BITUTĖS;51942577095;Taip;0;5;0;5
5803;Medynėlis;BITUTĖS;46570048371;Taip;1;0;0;1
5804;Medynėlis;BITUTĖS;57858019710;Ne;10;4;1;15
5805;Medynėlis;BITUTĖS;78341557395;Taip;3;4;0;7
5806;Medynėlis;BITUTĖS;13947002802;Taip;0;0;1;1
5807;Medynėlis;BITUTĖS;38838111813;Taip;12;4;0;16
5808;Medynėlis;BITUTĖS;72334464245;Ne;0;9;0;9
5809;Medynėlis;BITUTĖS;44971270687;Taip;0;4;0;4
5810;Medynėlis;BITUTĖS;39476010274;Ne;12;9;0;21
5811;Medynėlis;BITUTĖS;43383127907;Ne;6;3;2;11
5812;Medynėlis;BITUTĖS;7522506857;Taip;0;6;0;6
5813;Medynėlis;BITUTĖS;2055140361;Ne;0;5;0;5
5814;Medynėlis;BITUTĖS;1663988144;Taip;0;2;0;2
5815;Medynėlis;BITUTĖS;3684709853;Taip;0;4;0;4
5816;Medynėlis;BITUTĖS;65852278020;Taip;0;5;2;7
5817;Medynėlis;BITUTĖS;34879998108;Taip;0;4;0;4
5818;Medynėlis;DRUGELIAI;29673282359;Taip;0;6;0;6
5819;Medynėlis;DRUGELIAI;77267420461;Taip;7;0;0;7
5820;Medynėlis;DRUGELIAI;82368415455;Ne;2;4;0;6
5821;Medynėlis;DRUGELIAI;22422832248;Taip;7;7;0;14
5822;Medynėlis;DRUGELIAI;69233446672;Taip;0;4;0;4
5823;Medynėlis;DRUGELIAI;1673034349;Ne;7;6;0;13
5824;Medynėlis;DRUGELIAI;22845549109;Taip;0;4;0;4
5825;Medynėlis;DRUGELIAI;20592655649;Taip;0;5;0;5
5826;Medynėlis;DRUGELIAI;64603154583;Taip;13;4;0;17
5827;Medynėlis;DRUGELIAI;27434992072;Ne;0;4;0;4
5828;Medynėlis;DRUGELIAI;68940537831;Taip;0;10;0;10
5829;Medynėlis;DRUGELIAI;75083011184;Taip;4;10;0;14
5830;Medynėlis;DRUGELIAI;5748498291;Ne;0;5;0;5
5831;Medynėlis;DRUGELIAI;76282032727;Taip;0;1;0;1
5832;Medynėlis;DRUGELIAI;97943522374;Taip;6;4;0;10
5833;Medynėlis;DRUGELIAI;1864572888;Taip;0;4;0;4
5834;Medynėlis;DRUGELIAI;1828684971;Taip;4;4;0;8
5835;Medynėlis;DRUGELIAI;30399789674;Taip;14;1;0;15
5836;Medynėlis;SKRUZDĖLIUKAI;4024866819;Taip;7;2;0;9
5837;Medynėlis;SKRUZDĖLIUKAI;2418225089;Taip;3;5;0;8
5838;Medynėlis;SKRUZDĖLIUKAI;9413309043;Taip;0;4;3;7
5839;Medynėlis;SKRUZDĖLIUKAI;4581683292;Taip;9;11;0;20
5840;Medynėlis;SKRUZDĖLIUKAI;1795479738;Taip;12;6;0;18
5841;Medynėlis;SKRUZDĖLIUKAI;5530782065;Taip;9;0;0;9
5842;Medynėlis;SKRUZDĖLIUKAI;5269927048;Taip;12;0;2;14
5843;Medynėlis;SKRUZDĖLIUKAI;2427349194;Taip;9;0;0;9
5844;Medynėlis;SKRUZDĖLIUKAI;8948133343;Taip;0;6;0;6
5845;Medynėlis;SKRUZDĖLIUKAI;7633674694;Taip;10;2;0;12
5846;Medynėlis;SKRUZDĖLIUKAI;7244497661;Ne;0;4;4;8
5847;Medynėlis;SKRUZDĖLIUKAI;5995034919;Ne;0;0;5;5
5848;Medynėlis;SKRUZDĖLIUKAI;8775219704;Taip;3;3;0;6
5849;Medynėlis;SKRUZDĖLIUKAI;1658457155;Taip;3;4;2;9
5850;Medynėlis;SKRUZDĖLIUKAI;33981260502;Taip;0;4;4;8
5851;Medynėlis;SKRUZDĖLIUKAI;3773215372;Taip;2;5;0;7
5852;Medynėlis;SKRUZDĖLIUKAI;6343851636;Ne;7;0;2;9
5853;Medynėlis;VOVERIUKAI;2834559432;Taip;6;0;6;12
5854;Medynėlis;VOVERIUKAI;2310200034;Ne;0;12;0;12
5855;Medynėlis;VOVERIUKAI;90556319090;Taip;0;4;0;4
5856;Medynėlis;VOVERIUKAI;6999562417;Taip;11;4;0;15
5857;Medynėlis;VOVERIUKAI;5586407412;Taip;14;0;3;17
5858;Medynėlis;VOVERIUKAI;7108619017;Taip;0;6;0;6
5859;Medynėlis;VOVERIUKAI;8441104709;Taip;0;0;3;3
5860;Medynėlis;VOVERIUKAI;1820113382;Taip;0;6;0;6
5861;Medynėlis;VOVERIUKAI;9304002459;Taip;0;0;3;3
5862;Medynėlis;VOVERIUKAI;5982453884;Taip;11;0;0;11
5863;Medynėlis;VOVERIUKAI;1173510831;Taip;0;8;0;8
5864;Medynėlis;VOVERIUKAI;6406459222;Taip;2;11;0;13
5865;Medynėlis;VOVERIUKAI;2335108073;Ne;7;0;1;8
5866;Medynėlis;VOVERIUKAI;4985243068;Taip;8;0;2;10
5867;Medynėlis;VOVERIUKAI;2057309788;Taip;0;0;4;4
5868;Medynėlis;VOVERIUKAI;9073514151;Taip;10;3;0;13
5869;Medynėlis;VOVERIUKAI;4238860287;Ne;0;2;0;2
5870;Medynėlis;VOVERIUKAI;1750775033;Taip;9;0;0;9
5871;Medynėlis;VOVERIUKAI;9800678364;Taip;4;0;7;11
5872;Medynėlis;VOVERIUKAI;1237589979;Taip;10;0;4;14
5873;Medynėlis;MEŠKIUKAI;1434648803;Taip;0;1;9;10
5874;Medynėlis;MEŠKIUKAI;1975763240;Ne;2;1;2;5
5875;Medynėlis;MEŠKIUKAI;5347745655;Taip;0;12;0;12
5876;Medynėlis;MEŠKIUKAI;1781906016;Taip;0;8;0;8
5877;Medynėlis;MEŠKIUKAI;91658912153;Taip;0;4;0;4
5878;Medynėlis;MEŠKIUKAI;1269734734;Taip;0;12;0;12
5879;Medynėlis;MEŠKIUKAI;46445461622;Ne;0;7;0;7
5880;Medynėlis;MEŠKIUKAI;7226012217;Taip;0;4;11;15
5881;Medynėlis;MEŠKIUKAI;5007624930;Taip;0;15;0;15
5882;Medynėlis;MEŠKIUKAI;9476336240;Taip;0;5;0;5
5883;Medynėlis;MEŠKIUKAI;8629622922;Ne;0;9;4;13
5884;Medynėlis;MEŠKIUKAI;1479759021;Taip;0;2;0;2
5885;Medynėlis;MEŠKIUKAI;2389345601;Taip;0;0;1;1
5886;Medynėlis;MEŠKIUKAI;1635649525;Ne;0;7;0;7
5887;Medynėlis;MEŠKIUKAI;6479758789;Taip;0;0;8;8
5888;Medynėlis;MEŠKIUKAI;12287981032;Taip;4;0;0;4
5889;Medynėlis;MEŠKIUKAI;12812096047;Taip;6;0;13;19
5890;Medynėlis;MEŠKIUKAI;2326848026;Taip;0;0;8;8
5891;Medynėlis;MEŠKIUKAI;5924711043;Taip;0;0;6;6
5892;Medynėlis;MEŠKIUKAI;8143370943;Taip;0;0;11;11
5893;Medynėlis;MEŠKIUKAI;32683798983;Taip;7;4;0;11
5894;Medynėlis;MEŠKIUKAI;99799126572;Taip;0;8;0;8
5895;Medynėlis;PELĖDŽIUKAI;1379827887;Taip;11;4;2;17
5896;Medynėlis;PELĖDŽIUKAI;1829338208;Taip;0;1;4;5
5897;Medynėlis;PELĖDŽIUKAI;88240380945;Taip;0;6;2;8
5898;Medynėlis;PELĖDŽIUKAI;1129265551;Taip;16;2;0;18
5899;Medynėlis;PELĖDŽIUKAI;76668029492;Taip;12;0;1;13
5900;Medynėlis;PELĖDŽIUKAI;1080058205;Taip;9;3;0;12
5901;Medynėlis;PELĖDŽIUKAI;38759466139;Taip;0;6;1;7
5902;Medynėlis;PELĖDŽIUKAI;1968892466;Taip;7;1;0;8
5903;Medynėlis;PELĖDŽIUKAI;1194247621;Taip;17;0;0;17
5904;Medynėlis;PELĖDŽIUKAI;1755767517;Taip;7;4;0;11
5905;Medynėlis;PELĖDŽIUKAI;37435525923;Taip;0;0;6;6
5906;Medynėlis;PELĖDŽIUKAI;1415208530;Taip;13;0;4;17
5907;Medynėlis;PELĖDŽIUKAI;7804751416;Taip;10;6;0;16
5908;Medynėlis;PELĖDŽIUKAI;6182500688;Ne;9;0;3;12
5909;Medynėlis;PELĖDŽIUKAI;2831484614;Taip;16;0;0;16
5910;Medynėlis;PELĖDŽIUKAI;8122944228;Taip;6;4;2;12
5911;Medynėlis;PELĖDŽIUKAI;15047814683;Taip;0;4;0;4
5912;Medynėlis;PELĖDŽIUKAI;1937403950;Ne;0;4;1;5
5913;Medynėlis;PELĖDŽIUKAI;5636967783;Ne;5;0;2;7
5914;Medynėlis;PELĖDŽIUKAI;12150004702;Ne;4;0;2;6
5915;Medynėlis;BORUŽIUKAI;1657676226;Taip;2;4;0;6
5916;Medynėlis;BORUŽIUKAI;80165108645;Taip;0;1;0;1
5917;Medynėlis;BORUŽIUKAI;51192496113;Taip;0;6;0;6
5918;Medynėlis;BORUŽIUKAI;1314163134;Taip;0;4;0;4
5919;Medynėlis;BORUŽIUKAI;1010025777;Taip;0;5;0;5
5920;Medynėlis;BORUŽIUKAI;96544597673;Taip;10;4;0;14
5921;Medynėlis;BORUŽIUKAI;79786316561;Taip;0;6;3;9
5922;Medynėlis;BORUŽIUKAI;88550635466;Ne;0;1;0;1
5923;Medynėlis;BORUŽIUKAI;1936328805;Taip;0;1;0;1
5924;Medynėlis;BORUŽIUKAI;1693185124;Taip;0;9;0;9
5925;Medynėlis;BORUŽIUKAI;1563329598;Taip;0;9;0;9
5926;Medynėlis;BORUŽIUKAI;1611512841;Taip;14;2;0;16
5927;Medynėlis;BORUŽIUKAI;55848491611;Taip;6;1;0;7
5928;Medynėlis;BORUŽIUKAI;7061506238;Taip;0;1;0;1
5929;Medynėlis;BORUŽIUKAI;1192592678;Ne;16;2;0;18
5930;Medynėlis;BORUŽIUKAI;7628899696;Taip;14;0;0;14
5931;Medynėlis;BORUŽIUKAI;2044676215;Taip;0;5;0;5
5932;Medynėlis;BORUŽIUKAI;48636516521;Taip;13;0;0;13
5933;Medynėlis;BORUŽIUKAI;6374790540;Taip;4;2;0;6
5934;Medynėlis;EŽIUKAI;1409464952;Taip;10;4;1;15
5935;Medynėlis;EŽIUKAI;3398294520;Taip;0;0;2;2
5936;Medynėlis;EŽIUKAI;2026582294;Ne;2;7;0;9
5937;Medynėlis;EŽIUKAI;1437000615;Taip;0;9;0;9
5938;Medynėlis;EŽIUKAI;1208227740;Taip;0;4;0;4
5939;Medynėlis;EŽIUKAI;56154878520;Taip;15;1;0;16
5940;Medynėlis;EŽIUKAI;82365840630;Ne;3;1;1;5
5941;Medynėlis;EŽIUKAI;31443674861;Taip;0;5;0;5
5942;Medynėlis;EŽIUKAI;3165639252;Ne;0;2;0;2
5943;Medynėlis;EŽIUKAI;1882919126;Taip;0;13;0;13
5944;Medynėlis;EŽIUKAI;61158254770;Taip;0;3;0;3
5945;Medynėlis;EŽIUKAI;1216195798;Taip;5;4;0;9
5946;Medynėlis;EŽIUKAI;2406561273;Taip;9;1;0;10
5947;Medynėlis;EŽIUKAI;3225662051;Taip;18;0;1;19
5948;Medynėlis;EŽIUKAI;1311654913;Taip;0;4;0;4
5949;Medynėlis;EŽIUKAI;1915791061;Taip;9;0;0;9
5950;Medynėlis;EŽIUKAI;1036752305;Taip;0;7;0;7
5951;Medynėlis;ZUIKUČIAI;6706028300;Taip;4;0;0;4
5952;Medynėlis;ZUIKUČIAI;9520409342;Ne;8;0;0;8
5953;Medynėlis;ZUIKUČIAI;9438854582;Taip;10;0;0;10
5954;Medynėlis;ZUIKUČIAI;9079900803;Taip;13;0;4;17
5955;Medynėlis;ZUIKUČIAI;3856908872;Ne;7;0;5;12
5956;Medynėlis;ZUIKUČIAI;8276864168;Ne;5;0;0;5
5957;Medynėlis;ZUIKUČIAI;8074251036;Taip;7;10;0;17
5958;Medynėlis;ZUIKUČIAI;2932544910;Taip;8;0;0;8
5959;Medynėlis;ZUIKUČIAI;6955467123;Taip;4;0;2;6
5960;Medynėlis;ZUIKUČIAI;5785463517;Taip;11;0;0;11
5961;Medynėlis;ZUIKUČIAI;9184868565;Taip;2;4;0;6
5962;Medynėlis;ZUIKUČIAI;1621499650;Taip;8;5;0;13
5963;Medynėlis;ZUIKUČIAI;4222917765;Taip;8;5;0;13
5964;Medynėlis;ZUIKUČIAI;5571641847;Taip;7;2;0;9
5965;Medynėlis;ZUIKUČIAI;6681155625;Taip;0;7;0;7
5966;Medynėlis;ZUIKUČIAI;6073797962;Taip;9;0;0;9
5967;Medynėlis;ZUIKUČIAI;9355165862;Taip;3;1;0;4
5968;Medynėlis;ZUIKUČIAI;1901805808;Taip;4;0;0;4
5969;Medynėlis;ZUIKUČIAI;5784691118;Taip;4;0;0;4
5970;Medynėlis;KAČIUKAI;7740591575;Taip;11;0;0;11
5971;Medynėlis;KAČIUKAI;3761845905;Taip;0;8;2;10
5972;Medynėlis;KAČIUKAI;9825580191;Taip;15;0;0;15
5973;Medynėlis;KAČIUKAI;1475701065;Taip;0;14;0;14
5974;Medynėlis;KAČIUKAI;7638618099;Ne;19;0;0;19
5975;Medynėlis;KAČIUKAI;2627655353;Ne;0;0;10;10
5976;Medynėlis;KAČIUKAI;4100792567;Taip;7;0;0;7
5977;Medynėlis;KAČIUKAI;2086963376;Taip;11;0;0;11
5978;Medynėlis;KAČIUKAI;4217263449;Taip;0;0;2;2
5979;Medynėlis;KAČIUKAI;1056744101;Taip;0;4;8;12
5980;Medynėlis;KAČIUKAI;7455041214;Taip;5;0;6;11
5981;Medynėlis;KAČIUKAI;5267128750;Ne;0;9;0;9
5982;Medynėlis;KAČIUKAI;3554823424;Taip;4;0;0;4
5983;Medynėlis;KAČIUKAI;7272017225;Ne;10;2;0;12
5984;Medynėlis;KAČIUKAI;4092824377;Taip;0;5;0;5
5985;Medynėlis;KAČIUKAI;6826790492;Taip;0;0;2;2
5986;Medynėlis;KAČIUKAI;4488439037;Ne;17;0;4;21
5987;Medynėlis;KAČIUKAI;6485314750;Taip;0;0;4;4
5988;Medynėlis;KAČIUKAI;6101613567;Ne;0;5;4;9
5989;Medynėlis;KAČIUKAI;2234994999;Taip;0;7;0;7
5990;Medynėlis;PELIUKAI;9314893329;Taip;8;3;0;11
5991;Medynėlis;PELIUKAI;9764215406;Taip;10;0;1;11
5992;Medynėlis;PELIUKAI;3787172254;Taip;9;0;4;13
5993;Medynėlis;PELIUKAI;5051773825;Taip;16;0;0;16
5994;Medynėlis;PELIUKAI;1525185037;Ne;2;0;9;11
5995;Medynėlis;PELIUKAI;1344240019;Taip;2;0;2;4
5996;Medynėlis;PELIUKAI;6218943275;Taip;13;1;0;14
5997;Medynėlis;PELIUKAI;1406029765;Taip;0;4;2;6
5998;Medynėlis;PELIUKAI;1162859552;Taip;0;15;0;15
5999;Medynėlis;PELIUKAI;7232396755;Taip;16;0;0;16
6000;Medynėlis;PELIUKAI;9919108302;Taip;0;10;0;10
6001;Medynėlis;PELIUKAI;1463263793;Taip;0;9;0;9
6002;Medynėlis;PELIUKAI;1333848517;Taip;7;0;4;11
6003;Medynėlis;PELIUKAI;3270413614;Taip;9;4;0;13
6004;Medynėlis;PELIUKAI;5532880670;Taip;9;0;2;11
6005;Medynėlis;PELIUKAI;7651663404;Taip;0;4;2;6
6006;Medynėlis;PELIUKAI;5446430319;Taip;17;0;1;18
6007;Medynėlis;PELIUKAI;8271170887;Ne;13;0;0;13
6008;Medynėlis;PELIUKAI;4315717555;Taip;7;0;4;11
6009;Molinukas;NYKŠTUKAI;6353165459;Taip;2;0;0;2
6010;Molinukas;NYKŠTUKAI;5876669121;Taip;5;0;1;6
6011;Molinukas;NYKŠTUKAI;6087698882;Taip;10;4;0;14
6012;Molinukas;NYKŠTUKAI;2211909678;Taip;6;0;2;8
6013;Molinukas;NYKŠTUKAI;2348120316;Taip;4;1;2;7
6014;Molinukas;NYKŠTUKAI;8053608348;Taip;5;10;0;15
6015;Molinukas;NYKŠTUKAI;6014990150;Ne;4;0;1;5
6016;Molinukas;NYKŠTUKAI;7623051674;Ne;0;1;0;1
6017;Molinukas;NYKŠTUKAI;9448910819;Taip;5;5;0;10
6018;Molinukas;NYKŠTUKAI;1651650182;Taip;0;2;1;3
6019;Molinukas;NYKŠTUKAI;5580968328;Ne;18;0;0;18
6020;Molinukas;NYKŠTUKAI;8536615996;Ne;0;3;3;6
6021;Molinukas;NYKŠTUKAI;7602239077;Taip;5;0;0;5
6022;Molinukas;NYKŠTUKAI;1849018608;Taip;3;0;3;6
6023;Molinukas;NYKŠTUKAI;4171978721;Taip;3;4;2;9
6024;Molinukas;NYKŠTUKAI;7134802574;Taip;0;0;2;2
6025;Molinukas;NYKŠTUKAI;8260101075;Taip;0;0;3;3
6026;Molinukas;NYKŠTUKAI;9293819449;Taip;11;5;0;16
6027;Molinukas;NYKŠTUKAI;9244598883;Taip;11;0;0;11
6028;Molinukas;ZUIKUČIŲ;1469884686;Taip;2;5;0;7
6029;Molinukas;ZUIKUČIŲ;5387818175;Ne;0;0;6;6
6030;Molinukas;ZUIKUČIŲ;6326031969;Taip;0;6;0;6
6031;Molinukas;ZUIKUČIŲ;7398075402;Taip;5;0;1;6
6032;Molinukas;ZUIKUČIŲ;7377137582;Taip;6;0;3;9
6033;Molinukas;ZUIKUČIŲ;4534279257;Ne;2;13;0;15
6034;Molinukas;ZUIKUČIŲ;8688180482;Ne;12;4;0;16
6035;Molinukas;ZUIKUČIŲ;3917187380;Taip;0;5;2;7
6036;Molinukas;ZUIKUČIŲ;1686122652;Taip;0;8;0;8
6037;Molinukas;ZUIKUČIŲ;2324578741;Taip;0;0;7;7
6038;Molinukas;ZUIKUČIŲ;4918181437;Taip;15;0;0;15
6039;Molinukas;ZUIKUČIŲ;8604288346;Taip;4;4;1;9
6040;Molinukas;ZUIKUČIŲ;1856269656;Taip;0;4;0;4
6041;Molinukas;ZUIKUČIŲ;6636118069;Taip;0;12;0;12
6042;Molinukas;ZUIKUČIŲ;2774371800;Taip;5;10;0;15
6043;Molinukas;ZUIKUČIŲ;8913137310;Ne;6;2;1;9
6044;Molinukas;ZUIKUČIŲ;8416644024;Taip;0;3;8;11
6045;Molinukas;ZUIKUČIŲ;4766547534;Taip;0;0;1;1
6046;Molinukas;SRAIGIUKŲ;25761685637;Taip;0;6;3;9
6047;Molinukas;SRAIGIUKŲ;24664585525;Taip;0;5;2;7
6048;Molinukas;SRAIGIUKŲ;96140904528;Taip;0;13;0;13
6049;Molinukas;SRAIGIUKŲ;25402100091;Taip;0;4;2;6
6050;Molinukas;SRAIGIUKŲ;62719013867;Taip;0;2;1;3
6051;Molinukas;SRAIGIUKŲ;96366441416;Taip;0;1;0;1
6052;Molinukas;SRAIGIUKŲ;41890709428;Taip;9;0;0;9
6053;Molinukas;SRAIGIUKŲ;19007912410;Taip;0;4;3;7
6054;Molinukas;SRAIGIUKŲ;78219816965;Taip;0;0;1;1
6055;Molinukas;SRAIGIUKŲ;94725766823;Taip;0;4;0;4
6056;Molinukas;SRAIGIUKŲ;48613608109;Taip;0;7;0;7
6057;Molinukas;SRAIGIUKŲ;70883949824;Taip;0;4;1;5
6058;Molinukas;SRAIGIUKŲ;46887752521;Taip;0;5;8;13
6059;Molinukas;SRAIGIUKŲ;25562159395;Taip;2;4;0;6
6060;Molinukas;SRAIGIUKŲ;81952213381;Taip;7;5;0;12
6061;Molinukas;SRAIGIUKŲ;51421193001;Taip;0;6;0;6
6062;Molinukas;SRAIGIUKŲ;1388074160;Taip;0;5;0;5
6063;Molinukas;SRAIGIUKŲ;78355703743;Ne;6;1;0;7
6064;Molinukas;SRAIGIUKŲ;74040038141;Taip;0;4;0;4
6065;Molinukas;SRAIGIUKŲ;21462500359;Ne;2;5;0;7
6066;Molinukas;SRAIGIUKŲ;10647191823;Taip;0;4;2;6
6067;Molinukas;SRAIGIUKŲ;95409535650;Taip;0;4;0;4
6068;Molinukas;SRAIGIUKŲ;6155259547;Taip;0;3;0;3
6069;Molinukas;SRAIGIUKŲ;11787953136;Taip;0;16;0;16
6070;Molinukas;SRAIGIUKŲ;81983716075;Taip;0;10;0;10
6071;Molinukas;SRAIGIUKŲ;2048642721;Taip;0;8;0;8
6072;Molinukas;SRAIGIUKŲ;2041132581;Taip;0;5;3;8
6073;Molinukas;VOVERIUKAI;49733379099;Taip;0;5;0;5
6074;Molinukas;VOVERIUKAI;7991320348;Taip;0;4;0;4
6075;Molinukas;VOVERIUKAI;1293862946;Taip;0;0;3;3
6076;Molinukas;VOVERIUKAI;8674220663;Taip;0;4;0;4
6077;Molinukas;VOVERIUKAI;1151672597;Taip;0;6;0;6
6078;Molinukas;VOVERIUKAI;13856993048;Taip;0;0;2;2
6079;Molinukas;VOVERIUKAI;41153045448;Taip;8;0;2;10
6080;Molinukas;VOVERIUKAI;43651915331;Taip;16;0;5;21
6081;Molinukas;VOVERIUKAI;12208955611;Taip;4;6;0;10
6082;Molinukas;VOVERIUKAI;91913856999;Taip;0;0;4;4
6083;Molinukas;VOVERIUKAI;1241069188;Taip;0;3;0;3
6084;Molinukas;VOVERIUKAI;44399175317;Taip;9;0;1;10
6085;Molinukas;VOVERIUKAI;10482714545;Taip;2;10;0;12
6086;Molinukas;VOVERIUKAI;1880434477;Taip;7;4;4;15
6087;Molinukas;VOVERIUKAI;54948831792;Taip;0;1;1;2
6088;Molinukas;VOVERIUKAI;45801826827;Taip;17;0;1;18
6089;Molinukas;VOVERIUKAI;93528667925;Taip;0;0;1;1
6090;Molinukas;VOVERIUKAI;2931616290;Taip;2;0;1;3
6091;Molinukas;VOVERIUKAI;7987658567;Ne;0;2;1;3
6092;Molinukas;ŽVIRBLIUKŲ;3207373459;Taip;6;0;4;10
6093;Molinukas;ŽVIRBLIUKŲ;8247270556;Taip;2;11;0;13
6094;Molinukas;ŽVIRBLIUKŲ;9318837973;Taip;0;0;1;1
6095;Molinukas;ŽVIRBLIUKŲ;7378643086;Taip;6;5;5;16
6096;Molinukas;ŽVIRBLIUKŲ;4957226547;Taip;2;5;0;7
6097;Molinukas;ŽVIRBLIUKŲ;1865748733;Ne;5;0;0;5
6098;Molinukas;ŽVIRBLIUKŲ;3030169626;Taip;0;0;2;2
6099;Molinukas;ŽVIRBLIUKŲ;6832647220;Taip;5;0;10;15
6100;Molinukas;ŽVIRBLIUKŲ;4950808381;Taip;0;12;0;12
6101;Molinukas;ŽVIRBLIUKŲ;8865966572;Taip;8;0;1;9
6102;Molinukas;ŽVIRBLIUKŲ;6795839380;Taip;8;4;4;16
6103;Molinukas;ŽVIRBLIUKŲ;5597119459;Taip;11;0;1;12
6104;Molinukas;ŽVIRBLIUKŲ;4209143136;Taip;19;0;0;19
6105;Molinukas;ŽVIRBLIUKŲ;5648861702;Taip;19;0;0;19
6106;Molinukas;KAČIUKŲ;3516132254;Ne;0;0;2;2
6107;Molinukas;KAČIUKŲ;5685582215;Taip;10;6;2;18
6108;Molinukas;KAČIUKŲ;8541456847;Taip;7;0;0;7
6109;Molinukas;KAČIUKŲ;9379171183;Taip;5;0;2;7
6110;Molinukas;KAČIUKŲ;2356814145;Taip;9;0;0;9
6111;Molinukas;KAČIUKŲ;4000190261;Taip;7;0;0;7
6112;Molinukas;KAČIUKŲ;9667704959;Taip;19;0;0;19
6113;Molinukas;KAČIUKŲ;7446607510;Taip;15;4;0;19
6114;Molinukas;KAČIUKŲ;3469196411;Taip;8;4;2;14
6115;Molinukas;KAČIUKŲ;6638634402;Ne;16;0;0;16
6116;Molinukas;KAČIUKŲ;9413396859;Taip;4;0;0;4
6117;Molinukas;KAČIUKŲ;2286586693;Taip;13;0;1;14
6118;Molinukas;KAČIUKŲ;6898958282;Taip;9;0;0;9
6119;Molinukas;KAČIUKŲ;4583155940;Taip;0;0;4;4
6120;Molinukas;KAČIUKŲ;8516451290;Taip;8;0;2;10
6121;Naminukas;Drugeliai;6776805494;Taip;0;14;0;14
6122;Naminukas;Drugeliai;2395070574;Taip;0;5;0;5
6123;Naminukas;Drugeliai;5801695390;Taip;1;2;0;3
6124;Naminukas;Drugeliai;5534073614;Taip;2;6;0;8
6125;Naminukas;Drugeliai;7347998152;Taip;0;10;0;10
6126;Naminukas;Drugeliai;2606742144;Taip;0;4;0;4
6127;Naminukas;Drugeliai;9689866363;Taip;0;4;1;5
6128;Naminukas;Drugeliai;2132345627;Taip;9;0;0;9
6129;Naminukas;Drugeliai;3320805432;Taip;7;2;0;9
6130;Naminukas;Drugeliai;9312058190;Taip;9;0;1;10
6131;Naminukas;Drugeliai;1302119260;Taip;6;1;5;12
6132;Naminukas;Drugeliai;2864905392;Taip;0;8;4;12
6133;Naminukas;Drugeliai;7406775925;Taip;4;0;2;6
6134;Naminukas;Drugeliai;1333462200;Taip;3;0;4;7
6135;Naminukas;Drugeliai;5468218968;Taip;13;0;0;13
6136;Naminukas;Drugeliai;5713661641;Ne;10;0;0;10
6137;Naminukas;Drugeliai;8299305464;Taip;9;0;2;11
6138;Naminukas;Drugeliai;8929071623;Taip;10;1;0;11
6139;Naminukas;Bitutės;4419568254;Taip;0;5;0;5
6140;Naminukas;Bitutės;1956749138;Taip;7;6;0;13
6141;Naminukas;Bitutės;6503569633;Taip;5;3;0;8
6142;Naminukas;Bitutės;3192885665;Taip;15;5;0;20
6143;Naminukas;Bitutės;8131328042;Ne;0;18;0;18
6144;Naminukas;Bitutės;2769848640;Taip;0;0;1;1
6145;Naminukas;Bitutės;7176287699;Taip;0;10;1;11
6146;Naminukas;Bitutės;7888950723;Taip;0;0;4;4
6147;Naminukas;Bitutės;1710002948;Taip;10;4;0;14
6148;Naminukas;Bitutės;3994190066;Taip;0;9;2;11
6149;Naminukas;Bitutės;6526207235;Taip;0;7;0;7
6150;Naminukas;Bitutės;9600303816;Taip;11;2;0;13
6151;Naminukas;Bitutės;5244682030;Taip;11;2;0;13
6152;Naminukas;Bitutės;5195078101;Taip;0;7;0;7
6153;Naminukas;Bitutės;9501202207;Taip;10;6;0;16
6154;Naminukas;Bitutės;9541388086;Taip;0;5;0;5
6155;Naminukas;Bitutės;2424412518;Taip;0;12;0;12
6156;Naminukas;Bitutės;41538301616;Taip;0;5;0;5
6157;Naminukas;Bitutės;5493709688;Ne;0;0;2;2
6158;Naminukas;Paukšteliai;37525846039;Taip;5;4;1;10
6159;Naminukas;Paukšteliai;2126182508;Taip;5;12;0;17
6160;Naminukas;Paukšteliai;3603079488;Ne;0;4;2;6
6161;Naminukas;Paukšteliai;1870907311;Taip;7;4;2;13
6162;Naminukas;Paukšteliai;69952843049;Taip;0;6;0;6
6163;Naminukas;Paukšteliai;59473696226;Taip;6;4;2;12
6164;Naminukas;Paukšteliai;39747242234;Taip;12;1;0;13
6165;Naminukas;Paukšteliai;1946057668;Ne;12;4;0;16
6166;Naminukas;Paukšteliai;93648945843;Taip;0;0;4;4
6167;Naminukas;Paukšteliai;34168788672;Taip;6;4;0;10
6168;Naminukas;Paukšteliai;2100371376;Taip;5;3;1;9
6169;Naminukas;Paukšteliai;1439033627;Taip;0;4;0;4
6170;Naminukas;Paukšteliai;15748906161;Taip;0;4;1;5
6171;Naminukas;Paukšteliai;70836957729;Taip;0;5;0;5
6172;Naminukas;Paukšteliai;79166535343;Taip;0;4;3;7
6173;Naminukas;Paukšteliai;92882855386;Taip;1;4;1;6
6174;Naminukas;"NYKŠTUKAI ";1509433995;Ne;0;14;0;14
6175;Naminukas;"NYKŠTUKAI ";59020433000;Taip;8;5;0;13
6176;Naminukas;"NYKŠTUKAI ";2544422668;Taip;0;5;0;5
6177;Naminukas;"NYKŠTUKAI ";3029310084;Taip;0;4;2;6
6178;Naminukas;"NYKŠTUKAI ";16946991001;Taip;0;0;2;2
6179;Naminukas;"NYKŠTUKAI ";46665774314;Taip;9;9;0;18
6180;Naminukas;"NYKŠTUKAI ";1490712871;Taip;0;1;5;6
6181;Naminukas;"NYKŠTUKAI ";1252481328;Ne;11;0;0;11
6182;Naminukas;"NYKŠTUKAI ";5918430817;Taip;0;4;0;4
6183;Naminukas;"NYKŠTUKAI ";1499464511;Ne;0;5;0;5
6184;Naminukas;"NYKŠTUKAI ";3826149605;Ne;0;4;0;4
6185;Naminukas;"NYKŠTUKAI ";6501046678;Taip;10;0;0;10
6186;Naminukas;"NYKŠTUKAI ";6029194403;Taip;7;2;0;9
6187;Naminukas;"NYKŠTUKAI ";70281612245;Taip;11;0;1;12
6188;Naminukas;"NYKŠTUKAI ";74291965804;Taip;7;0;1;8
6189;Naminukas;"NYKŠTUKAI ";10563508139;Taip;0;0;2;2
6190;Naminukas;"NYKŠTUKAI ";90045007984;Taip;10;0;0;10
6191;Naminukas;"NYKŠTUKAI ";6273977588;Ne;14;3;0;17
6192;Nykštukas;AITVARIUKAI;1144228064;Ne;21;0;0;21
6193;Nykštukas;AITVARIUKAI;6787279403;Taip;0;7;0;7
6194;Nykštukas;AITVARIUKAI;3808695428;Taip;7;0;0;7
6195;Nykštukas;AITVARIUKAI;2002197530;Taip;19;0;0;19
6196;Nykštukas;AITVARIUKAI;2113361929;Taip;10;1;0;11
6197;Nykštukas;AITVARIUKAI;1555891900;Taip;0;2;0;2
6198;Nykštukas;AITVARIUKAI;4256675710;Taip;2;8;0;10
6199;Nykštukas;AITVARIUKAI;1209871301;Taip;13;4;0;17
6200;Nykštukas;AITVARIUKAI;93527297465;Ne;2;6;0;8
6201;Nykštukas;AITVARIUKAI;1642172676;Taip;13;4;0;17
6202;Nykštukas;AITVARIUKAI;1603960759;Ne;0;4;0;4
6203;Nykštukas;AITVARIUKAI;4487291454;Taip;0;5;0;5
6204;Nykštukas;AITVARIUKAI;6274009442;Taip;0;5;4;9
6205;Nykštukas;AITVARIUKAI;1760718866;Taip;0;4;3;7
6206;Nykštukas;AITVARIUKAI;9229795383;Ne;0;10;0;10
6207;Nykštukas;AITVARIUKAI;3479582264;Taip;0;9;0;9
6208;Nykštukas;AITVARIUKAI;1643843455;Taip;2;14;1;17
6209;Nykštukas;AITVARIUKAI;1965559069;Taip;0;6;0;6
6210;Nykštukas;AITVARIUKAI;6480026426;Taip;0;4;0;4
6211;Nykštukas;AITVARIUKAI;4556700510;Ne;12;5;0;17
6212;Nykštukas;DAINORĖLIAI;1505896987;Ne;6;0;1;7
6213;Nykštukas;DAINORĖLIAI;1070086244;Taip;0;9;0;9
6214;Nykštukas;DAINORĖLIAI;6105521992;Taip;0;6;0;6
6215;Nykštukas;DAINORĖLIAI;67968815055;Taip;0;7;0;7
6216;Nykštukas;DAINORĖLIAI;8027860617;Taip;10;0;0;10
6217;Nykštukas;DAINORĖLIAI;7498721887;Taip;0;1;0;1
6218;Nykštukas;DAINORĖLIAI;7660848578;Taip;3;5;0;8
6219;Nykštukas;DAINORĖLIAI;2284266953;Taip;0;0;3;3
6220;Nykštukas;DAINORĖLIAI;8370864547;Taip;0;0;3;3
6221;Nykštukas;DAINORĖLIAI;4720226790;Taip;0;0;8;8
6222;Nykštukas;DAINORĖLIAI;9778271272;Taip;0;0;6;6
6223;Nykštukas;DAINORĖLIAI;7150793310;Taip;12;4;0;16
6224;Nykštukas;DAINORĖLIAI;7584220414;Taip;0;7;0;7
6225;Nykštukas;DAINORĖLIAI;8323439041;Ne;14;1;0;15
6226;Nykštukas;DAINORĖLIAI;9567571526;Taip;10;0;4;14
6227;Nykštukas;DAINORĖLIAI;3970413055;Taip;9;4;0;13
6228;Nykštukas;DAINORĖLIAI;2657373608;Taip;0;1;0;1
6229;Nykštukas;DAINORĖLIAI;1755944368;Taip;2;2;3;7
6230;Nykštukas;DAINORĖLIAI;8781148130;Taip;0;5;1;6
6231;Nykštukas;DAINORĖLIAI;3904901392;Taip;3;13;0;16
6232;Nykštukas;KODĖLČIUKAI;1312775821;Taip;0;13;0;13
6233;Nykštukas;KODĖLČIUKAI;22907267392;Taip;5;4;0;9
6234;Nykštukas;KODĖLČIUKAI;51839683425;Taip;0;8;0;8
6235;Nykštukas;KODĖLČIUKAI;49403159088;Taip;5;4;1;10
6236;Nykštukas;KODĖLČIUKAI;279882740;Taip;0;6;3;9
6237;Nykštukas;KODĖLČIUKAI;94379087811;Taip;4;4;0;8
6238;Nykštukas;KODĖLČIUKAI;65431970524;Taip;12;4;0;16
6239;Nykštukas;KODĖLČIUKAI;74269403579;Taip;7;5;0;12
6240;Nykštukas;KODĖLČIUKAI;57158850838;Taip;0;14;0;14
6241;Nykštukas;KODĖLČIUKAI;67215878528;Taip;10;4;2;16
6242;Nykštukas;KODĖLČIUKAI;45998334166;Taip;0;5;0;5
6243;Nykštukas;KODĖLČIUKAI;21894285952;Taip;0;3;1;4
6244;Nykštukas;KODĖLČIUKAI;46457925178;Taip;15;6;0;21
6245;Nykštukas;KODĖLČIUKAI;40507821302;Taip;3;6;3;12
6246;Nykštukas;KODĖLČIUKAI;40791169410;Ne;7;4;0;11
6247;Nykštukas;KODĖLČIUKAI;21793281327;Taip;0;0;5;5
6248;Nykštukas;KODĖLČIUKAI;73015157334;Taip;3;4;1;8
6249;Nykštukas;KODĖLČIUKAI;87788435945;Taip;0;4;1;5
6250;Nykštukas;KODĖLČIUKAI;42662848704;Taip;0;4;0;4
6251;Nykštukas;GUDRUČIAI;90969634936;Taip;0;1;2;3
6252;Nykštukas;GUDRUČIAI;66071060125;Taip;20;0;0;20
6253;Nykštukas;GUDRUČIAI;53603222817;Taip;0;2;0;2
6254;Nykštukas;GUDRUČIAI;23684742279;Taip;9;6;0;15
6255;Nykštukas;GUDRUČIAI;84800943947;Taip;0;8;1;9
6256;Nykštukas;GUDRUČIAI;30508998297;Taip;0;10;0;10
6257;Nykštukas;GUDRUČIAI;25097193002;Taip;0;4;0;4
6258;Nykštukas;GUDRUČIAI;1448977214;Taip;2;1;0;3
6259;Nykštukas;GUDRUČIAI;2109799405;Ne;3;3;0;6
6260;Nykštukas;GUDRUČIAI;83322635443;Taip;0;4;0;4
6261;Nykštukas;GUDRUČIAI;9041364129;Ne;14;3;0;17
6262;Nykštukas;GUDRUČIAI;7098812765;Taip;19;0;0;19
6263;Nykštukas;GUDRUČIAI;48718365302;Taip;5;3;0;8
6264;Nykštukas;GUDRUČIAI;2121319324;Taip;0;4;0;4
6265;Nykštukas;GUDRUČIAI;40386182073;Taip;11;1;0;12
6266;Nykštukas;GUDRUČIAI;54607001703;Taip;0;4;0;4
6267;Nykštukas;GUDRUČIAI;7356168681;Taip;0;5;4;9
6268;Nykštukas;GUDRUČIAI;27701482167;Taip;2;4;0;6
6269;Nykštukas;GUDRUČIAI;56267408803;Taip;0;4;0;4
6270;Nykštukas;GUDRUČIAI;26154640888;Taip;0;4;6;10
6271;Nykštukas;GUDRUČIAI;92898851752;Taip;0;12;0;12
6272;Nykštukas;GUDRUČIAI;85663477778;Taip;17;1;0;18
6273;Nykštukas;GUDRUČIAI;52614843907;Taip;0;1;0;1
6274;Nykštukas;GUDRUČIAI;94426618018;Taip;0;5;0;5
6275;Nykštukas;GUDRUČIAI;7325852578;Taip;0;5;0;5
6276;Nykštukas;GUDRUČIAI;1055246536;Taip;10;1;0;11
6277;Nykštukas;NAMINUKAI;1856534241;Ne;0;5;0;5
6278;Nykštukas;NAMINUKAI;34930388032;Ne;0;1;0;1
6279;Nykštukas;NAMINUKAI;1178437485;Taip;0;12;0;12
6280;Nykštukas;NAMINUKAI;1608057875;Taip;0;4;0;4
6281;Nykštukas;NAMINUKAI;1285120987;Taip;0;1;0;1
6282;Nykštukas;NAMINUKAI;1994080785;Taip;0;5;0;5
6283;Nykštukas;NAMINUKAI;37253009284;Taip;2;6;0;8
6284;Nykštukas;NAMINUKAI;1630706629;Ne;0;2;0;2
6285;Nykštukas;NAMINUKAI;1350373348;Taip;0;6;0;6
6286;Nykštukas;NAMINUKAI;27896604498;Taip;0;5;0;5
6287;Nykštukas;NAMINUKAI;9422129964;Taip;0;4;1;5
6288;Nykštukas;NAMINUKAI;7836485289;Taip;0;0;1;1
6289;Nykštukas;NAMINUKAI;30762220262;Taip;2;4;0;6
6290;Nykštukas;NAMINUKAI;9184265280;Taip;0;5;0;5
6291;Nykštukas;NAMINUKAI;1687759661;Taip;0;5;0;5
6292;Nykštukas;NAMINUKAI;61896011340;Taip;0;1;0;1
6293;Nykštukas;NAMINUKAI;4191728865;Taip;6;10;0;16
6294;Nykštukas;NAMINUKAI;7645589206;Taip;5;4;0;9
6295;Nykštukas;NAMINUKAI;5270008748;Taip;0;8;0;8
6296;Nykštukas;NAMINUKAI;45693477409;Taip;5;1;2;8
6297;Nykštukas;NAMINUKAI;44921552171;Taip;0;13;0;13
6298;Nykštukas;NAMINUKAI;58741201573;Taip;5;3;0;8
6299;Nykštukas;KŪLVERSTUKAI;4064016871;Taip;0;9;0;9
6300;Nykštukas;KŪLVERSTUKAI;9575291096;Taip;0;4;0;4
6301;Nykštukas;KŪLVERSTUKAI;2205400512;Taip;9;5;0;14
6302;Nykštukas;KŪLVERSTUKAI;6106373554;Taip;0;4;0;4
6303;Nykštukas;KŪLVERSTUKAI;4925214655;Taip;0;10;0;10
6304;Nykštukas;KŪLVERSTUKAI;9686815141;Taip;21;0;0;21
6305;Nykštukas;KŪLVERSTUKAI;7976689381;Taip;0;3;1;4
6306;Nykštukas;KŪLVERSTUKAI;9054070492;Taip;0;4;0;4
6307;Nykštukas;KŪLVERSTUKAI;5439925385;Ne;21;0;0;21
6308;Nykštukas;KŪLVERSTUKAI;8625793820;Ne;20;0;0;20
6309;Nykštukas;KŪLVERSTUKAI;4503830456;Taip;0;6;0;6
6310;Nykštukas;KŪLVERSTUKAI;7176519994;Ne;21;0;0;21
6311;Nykštukas;KŪLVERSTUKAI;6338717583;Taip;8;0;0;8
6312;Nykštukas;KŪLVERSTUKAI;2440574056;Taip;21;0;0;21
6313;Nykštukas;KŪLVERSTUKAI;3925958632;Taip;21;0;0;21
6314;Nykštukas;KŪLVERSTUKAI;7494444468;Taip;21;0;0;21
6315;Nykštukas;KŪLVERSTUKAI;5032283848;Ne;0;6;0;6
6316;Nykštukas;KŪLVERSTUKAI;2988856911;Taip;17;0;0;17
6317;Nykštukas;KŪLVERSTUKAI;4992654449;Taip;4;0;3;7
6318;Nykštukas;KŪLVERSTUKAI;1579064341;Taip;9;0;0;9
6319;Nykštukas;KŪLVERSTUKAI;6519078450;Taip;11;0;0;11
6320;Ozas;Smalsučiai;2641398988;Taip;5;3;0;8
6321;Ozas;Smalsučiai;9227939420;Taip;3;1;0;4
6322;Ozas;Smalsučiai;7917100888;Taip;7;4;0;11
6323;Ozas;Smalsučiai;87218067796;Taip;2;8;1;11
6324;Ozas;Smalsučiai;4397034031;Taip;4;0;0;4
6325;Ozas;Smalsučiai;1974320330;Taip;0;6;0;6
6326;Ozas;Smalsučiai;1173284700;Ne;2;2;0;4
6327;Ozas;Smalsučiai;67987032400;Taip;0;4;0;4
6328;Ozas;Smalsučiai;71695973592;Taip;0;3;1;4
6329;Ozas;Smalsučiai;57069047630;Taip;6;4;0;10
6330;Ozas;Smalsučiai;3326395879;Taip;0;4;0;4
6331;Ozas;Smalsučiai;5150746885;Taip;0;7;0;7
6332;Ozas;Smalsučiai;9595277597;Taip;1;4;0;5
6333;Ozas;Smalsučiai;1893257809;Taip;2;3;0;5
6334;Ozas;Smalsučiai;6540803077;Taip;0;5;0;5
6335;Ozas;Smalsučiai;1248092034;Ne;0;5;0;5
6336;Ozas;Smalsučiai;43381497677;Ne;11;1;0;12
6337;Ozas;Smalsučiai;7351651916;Ne;2;3;0;5
6338;Ozas;Smalsučiai;3286170280;Taip;7;0;4;11
6339;Ozas;Smalsučiai;9521048381;Taip;9;1;0;10
6340;Ozas;Smalsučiai;2053832360;Taip;4;4;0;8
6341;Ozas;Smalsučiai;9905575489;Taip;5;4;0;9
6342;Ozas;Smalsučiai;5342394742;Taip;4;0;0;4
6343;Ozas;Drugeliai;1655808777;Taip;0;7;0;7
6344;Ozas;Drugeliai;7802699257;Taip;4;0;1;5
6345;Ozas;Drugeliai;8176840834;Ne;0;19;0;19
6346;Ozas;Drugeliai;6668470892;Taip;5;4;0;9
6347;Ozas;Drugeliai;2302999759;Taip;0;0;4;4
6348;Ozas;Drugeliai;8088330187;Taip;0;9;0;9
6349;Ozas;Drugeliai;9073973849;Taip;11;0;5;16
6350;Ozas;Drugeliai;9322806566;Taip;9;4;0;13
6351;Ozas;Drugeliai;2676747542;Taip;0;4;17;21
6352;Ozas;Drugeliai;2812687451;Taip;8;4;0;12
6353;Ozas;Drugeliai;8289643065;Taip;7;0;0;7
6354;Ozas;Drugeliai;4726019355;Taip;4;0;0;4
6355;Ozas;Drugeliai;9987863302;Ne;16;0;1;17
6356;Ozas;Drugeliai;5503766544;Taip;0;10;0;10
6357;Ozas;Drugeliai;2980799420;Taip;17;4;0;21
6358;Ozas;Drugeliai;4935698806;Taip;2;4;0;6
6359;Ozas;Drugeliai;1793692289;Taip;4;4;0;8
6360;Ozas;Drugeliai;8318380547;Taip;0;9;0;9
6361;Ozas;Drugeliai;4884054504;Taip;7;0;0;7
6362;Ozas;Drugeliai;2825614921;Taip;21;0;0;21
6363;Ozas;Drugeliai;43660054250;Taip;0;18;0;18
6364;Ozas;Drugeliai;7565002863;Ne;0;0;3;3
6365;Ozas;Drugeliai;1871542885;Taip;4;0;0;4
6366;Ozas;Drugeliai;15262583232;Taip;4;6;0;10
6367;Ozas;Boružėlės;1348960421;Taip;12;4;0;16
6368;Ozas;Boružėlės;1375643969;Ne;0;0;18;18
6369;Ozas;Boružėlės;63852147122;Taip;7;4;1;12
6370;Ozas;Boružėlės;8190314087;Taip;6;4;0;10
6371;Ozas;Boružėlės;3803998816;Taip;0;8;0;8
6372;Ozas;Boružėlės;1212358423;Taip;21;0;0;21
6373;Ozas;Boružėlės;7615907271;Taip;5;4;2;11
6374;Ozas;Boružėlės;1560342499;Taip;0;4;0;4
6375;Ozas;Boružėlės;8529654920;Taip;0;5;0;5
6376;Ozas;Boružėlės;60194872867;Taip;9;0;0;9
6377;Ozas;Boružėlės;7172573921;Taip;0;4;0;4
6378;Ozas;Boružėlės;2527574646;Taip;7;5;0;12
6379;Ozas;Boružėlės;9773251894;Taip;10;0;4;14
6380;Ozas;Boružėlės;36523514229;Taip;4;4;0;8
6381;Ozas;Boružėlės;1367050160;Taip;6;0;0;6
6382;Ozas;Boružėlės;68364031736;Taip;0;5;0;5
6383;Ozas;Boružėlės;2678629892;Taip;3;0;1;4
6384;Ozas;Boružėlės;1109113859;Ne;13;0;3;16
6385;Ozas;Boružėlės;1826499734;Taip;0;0;2;2
6386;Ozas;Boružėlės;6432357144;Taip;21;0;0;21
6387;Ozas;Boružėlės;1498656201;Taip;6;4;0;10
6388;Ozas;Boružėlės;8979747150;Taip;12;9;0;21
6389;Ozas;Boružėlės;1217496635;Taip;0;0;9;9
6390;Ozas;Boružėlės;1682529482;Taip;11;1;0;12
6391;Ozas;Boružėlės;9130645878;Taip;6;7;0;13
6392;Ozas;Žiogeliai;7461521320;Taip;8;2;0;10
6393;Ozas;Žiogeliai;3631049449;Taip;7;0;1;8
6394;Ozas;Žiogeliai;6257625501;Taip;0;5;0;5
6395;Ozas;Žiogeliai;7402290524;Taip;7;6;0;13
6396;Ozas;Žiogeliai;4571583671;Taip;6;5;2;13
6397;Ozas;Žiogeliai;1837947633;Taip;6;1;0;7
6398;Ozas;Žiogeliai;5682027094;Taip;19;2;0;21
6399;Ozas;Žiogeliai;4966355020;Taip;5;8;0;13
6400;Ozas;Žiogeliai;6950802941;Taip;21;0;0;21
6401;Ozas;Žiogeliai;3770045761;Taip;0;0;2;2
6402;Ozas;Žiogeliai;9324647606;Taip;9;0;2;11
6403;Ozas;Žiogeliai;9392526836;Taip;0;0;2;2
6404;Ozas;Žiogeliai;5850824864;Taip;0;5;0;5
6405;Ozas;Žiogeliai;4942550213;Ne;17;0;0;17
6406;Ozas;Žiogeliai;8676986286;Ne;3;1;12;16
6407;Ozas;Žiogeliai;2345112767;Taip;0;7;0;7
6408;Ozas;Žiogeliai;5420952391;Taip;0;10;2;12
6409;Ozas;Žiogeliai;5156383727;Taip;0;6;0;6
6410;Ozas;Žiogeliai;9929822317;Taip;4;0;2;6
6411;Ozas;Žiogeliai;6108049183;Taip;10;0;4;14
6412;Ozas;Žiogeliai;2837228320;Taip;0;11;0;11
6413;Ozas;Žiogeliai;7264789334;Taip;11;0;1;12
6414;Ozas;Žiogeliai;2617258206;Ne;8;0;2;10
6415;Ozas;Bitutės;4220780257;Taip;16;0;1;17
6416;Ozas;Bitutės;1161776624;Taip;6;0;4;10
6417;Ozas;Bitutės;4227555342;Taip;16;0;0;16
6418;Ozas;Bitutės;7499756171;Taip;5;12;0;17
6419;Ozas;Bitutės;7494307084;Taip;10;0;0;10
6420;Ozas;Bitutės;1475005204;Taip;5;0;0;5
6421;Ozas;Bitutės;2705294874;Taip;4;0;1;5
6422;Ozas;Bitutės;2369544599;Taip;0;1;1;2
6423;Ozas;Bitutės;3329391600;Taip;3;4;1;8
6424;Ozas;Bitutės;4207160323;Taip;3;4;1;8
6425;Ozas;Bitutės;8416839037;Taip;0;7;0;7
6426;Ozas;Bitutės;4254601638;Taip;5;0;6;11
6427;Ozas;Bitutės;4699369567;Taip;0;4;0;4
6428;Ozas;Bitutės;8304671844;Taip;0;0;1;1
6429;Ozas;Bitutės;5968428143;Taip;11;6;0;17
6430;Ozas;Bitutės;5381187291;Taip;18;1;0;19
6431;Ozas;Bitutės;1895519949;Taip;0;5;1;6
6432;Ozas;Bitutės;9772085405;Taip;7;0;2;9
6433;Ozas;Bitutės;7051699003;Taip;17;0;0;17
6434;Ozas;Bitutės;7817387800;Taip;14;0;0;14
6435;Ozas;Bitutės;5383877034;Taip;0;0;9;9
6436;Ozas;Bitutės;1117208248;Taip;0;5;0;5
6437;Ozas;Bitutės;9050174230;Taip;0;0;4;4
6438;Ozas;Bitutės;6811181735;Taip;7;9;0;16
6439;Ozas;Aitvarėliai;1653285671;Taip;5;9;0;14
6440;Ozas;Aitvarėliai;65979490151;Taip;9;0;0;9
6441;Ozas;Aitvarėliai;36897118363;Taip;0;6;0;6
6442;Ozas;Aitvarėliai;25660709486;Ne;0;10;0;10
6443;Ozas;Aitvarėliai;87500216376;Taip;0;4;3;7
6444;Ozas;Aitvarėliai;62542133064;Taip;0;5;0;5
6445;Ozas;Aitvarėliai;77935174855;Taip;0;2;7;9
6446;Ozas;Aitvarėliai;74709964983;Taip;0;2;0;2
6447;Ozas;Aitvarėliai;28736160618;Taip;0;8;0;8
6448;Ozas;Aitvarėliai;31810796132;Taip;0;3;0;3
6449;Ozas;Aitvarėliai;49556201469;Taip;0;6;1;7
6450;Ozas;Aitvarėliai;81692407050;Taip;0;4;0;4
6451;Ozas;Aitvarėliai;3222282556;Taip;0;9;1;10
6452;Ozas;Aitvarėliai;46679332069;Taip;0;6;0;6
6453;Ozas;Aitvarėliai;1556404162;Taip;0;4;0;4
6454;Ozas;Aitvarėliai;20944134865;Taip;0;4;0;4
6455;Ozas;Aitvarėliai;2087307495;Taip;0;2;3;5
6456;Ozas;Aitvarėliai;99211100553;Taip;0;4;0;4
6457;Ozas;Aitvarėliai;56927777775;Taip;6;4;5;15
6458;Ozas;Aitvarėliai;84378491220;Taip;0;4;6;10
6459;Ozas;Aitvarėliai;53609618421;Ne;0;3;0;3
6460;Ozas;Aitvarėliai;71286685759;Taip;0;4;2;6
6461;Ozas;Aitvarėliai;83249479846;Taip;0;1;0;1
6462;Ozas;Aitvarėliai;1182573257;Taip;4;5;1;10
6463;Ozas;Aitvarėliai;85075096111;Taip;0;4;0;4
6464;Ozas;Voveraitės;89115682092;Taip;3;6;5;14
6465;Ozas;Voveraitės;97875471586;Taip;0;4;4;8
6466;Ozas;Voveraitės;42030629149;Taip;0;4;3;7
6467;Ozas;Voveraitės;8817179462;Taip;0;5;0;5
6468;Ozas;Voveraitės;87683044622;Taip;0;4;17;21
6469;Ozas;Voveraitės;88443183082;Ne;2;5;0;7
6470;Ozas;Voveraitės;94576453630;Taip;7;7;0;14
6471;Ozas;Voveraitės;26834809068;Taip;0;4;0;4
6472;Ozas;Voveraitės;88508505247;Taip;2;4;0;6
6473;Ozas;Voveraitės;47574756201;Taip;0;6;0;6
6474;Ozas;Voveraitės;24088059514;Taip;4;6;1;11
6475;Ozas;Voveraitės;29411948493;Taip;0;9;0;9
6476;Ozas;Voveraitės;27655773887;Taip;0;4;0;4
6477;Ozas;Voveraitės;62608717700;Taip;0;4;0;4
6478;Ozas;Voveraitės;88837027397;Taip;7;5;0;12
6479;Ozas;Voveraitės;46431348128;Taip;0;5;0;5
6480;Ozas;Voveraitės;66463185196;Taip;2;6;1;9
6481;Ozas;Voveraitės;93882562685;Taip;0;10;0;10
6482;Ozas;Voveraitės;37505558259;Taip;0;2;0;2
6483;Ozas;Voveraitės;90020306864;Taip;0;5;1;6
6484;Ozas;Voveraitės;34723844399;Taip;0;5;0;5
6485;Ozas;Voveraitės;16101439010;Taip;0;4;9;13
6486;Ozas;Voveraitės;5637273299;Taip;0;4;3;7
6487;Ozas;Voveraitės;1637437696;Ne;2;5;0;7
6488;Ozas;Kodelčiukai;2808066733;Taip;0;18;0;18
6489;Ozas;Kodelčiukai;71351371644;Taip;0;5;0;5
6490;Ozas;Kodelčiukai;13077342836;Taip;0;8;0;8
6491;Ozas;Kodelčiukai;1746778441;Taip;8;6;0;14
6492;Ozas;Kodelčiukai;1110232715;Taip;0;13;0;13
6493;Ozas;Kodelčiukai;28273919775;Taip;0;5;0;5
6494;Ozas;Kodelčiukai;88618151766;Taip;0;10;0;10
6495;Ozas;Kodelčiukai;3637786952;Taip;2;5;0;7
6496;Ozas;Kodelčiukai;39003781970;Taip;0;8;0;8
6497;Ozas;Kodelčiukai;1243205832;Taip;0;21;0;21
6498;Ozas;Kodelčiukai;1235925750;Ne;0;7;0;7
6499;Ozas;Kodelčiukai;69756875821;Taip;0;3;0;3
6500;Ozas;Kodelčiukai;19065860134;Taip;0;3;0;3
6501;Ozas;Kodelčiukai;1230455881;Taip;0;12;0;12
6502;Ozas;Kodelčiukai;9664748034;Taip;0;5;0;5
6503;Ozas;Kodelčiukai;1684454071;Taip;3;4;0;7
6504;Ozas;Kodelčiukai;1008366446;Ne;0;1;0;1
6505;Ozas;Kodelčiukai;1995302672;Taip;0;9;0;9
6506;Ozas;Kodelčiukai;1288477637;Taip;0;5;0;5
6507;Ozas;Kodelčiukai;82373453244;Taip;14;1;0;15
6508;Ozas;Kodelčiukai;94673981368;Taip;17;4;0;21
6509;Ozas;Kodelčiukai;19284606277;Taip;8;4;0;12
6510;Ozas;Pelėdžiukai;1462541264;Ne;0;3;0;3
6511;Ozas;Pelėdžiukai;3439351594;Taip;5;6;2;13
6512;Ozas;Pelėdžiukai;41795363180;Taip;5;4;0;9
6513;Ozas;Pelėdžiukai;60743195418;Ne;0;9;0;9
6514;Ozas;Pelėdžiukai;64778552590;Taip;0;0;9;9
6515;Ozas;Pelėdžiukai;13375413701;Taip;0;1;0;1
6516;Ozas;Pelėdžiukai;16523707810;Taip;0;4;1;5
6517;Ozas;Pelėdžiukai;47291376629;Taip;0;7;0;7
6518;Ozas;Pelėdžiukai;34330362446;Taip;17;4;0;21
6519;Ozas;Pelėdžiukai;1450257399;Taip;0;5;0;5
6520;Ozas;Pelėdžiukai;56346624523;Taip;0;4;0;4
6521;Ozas;Pelėdžiukai;4765249675;Taip;0;4;2;6
6522;Ozas;Pelėdžiukai;1814400303;Taip;0;9;1;10
6523;Ozas;Pelėdžiukai;1889249743;Taip;0;1;1;2
6524;Ozas;Pelėdžiukai;1099026003;Taip;0;1;0;1
6525;Ozas;Pelėdžiukai;15885510365;Taip;0;4;0;4
6526;Ozas;Pelėdžiukai;2058548464;Taip;0;0;3;3
6527;Ozas;Pelėdžiukai;4590847831;Taip;0;4;0;4
6528;Ozas;Pelėdžiukai;1910114048;Taip;0;0;1;1
6529;Ozas;"Kačiukai ";75077443996;Taip;0;8;0;8
6530;Ozas;"Kačiukai ";95179927759;Taip;0;6;8;14
6531;Ozas;"Kačiukai ";6618249243;Taip;0;12;3;15
6532;Ozas;"Kačiukai ";1151213934;Taip;8;0;0;8
6533;Ozas;"Kačiukai ";2114612776;Taip;11;5;1;17
6534;Ozas;"Kačiukai ";60155732637;Taip;10;4;0;14
6535;Ozas;"Kačiukai ";37159754070;Taip;0;4;7;11
6536;Ozas;"Kačiukai ";61398533877;Taip;8;0;1;9
6537;Ozas;"Kačiukai ";1580501935;Ne;0;5;0;5
6538;Ozas;"Kačiukai ";1210902341;Taip;0;0;4;4
6539;Ozas;"Kačiukai ";1316758924;Ne;11;0;0;11
6540;Ozas;"Kačiukai ";2018398634;Taip;0;0;8;8
6541;Ozas;"Kačiukai ";34196440412;Taip;0;0;5;5
6542;Ozas;"Kačiukai ";84277015523;Taip;5;4;3;12
6543;Ozas;"Kačiukai ";1822377180;Taip;19;0;1;20
6544;Ozas;"Kačiukai ";1551028882;Taip;13;0;0;13
6545;Ozas;"Kačiukai ";14760258125;Taip;0;4;2;6
6546;Ozas;"Kačiukai ";4400619617;Taip;0;0;13;13
6547;Ozas;"Kačiukai ";9345447142;Taip;3;0;4;7
6548;Ozas;"Kačiukai ";1681367373;Taip;0;13;5;18
6549;Ozas;"Kačiukai ";8248732706;Taip;12;4;0;16
6550;Ozas;"Kačiukai ";84845624912;Ne;14;4;2;20
6551;Ozas;Ančiukų;2635045515;Taip;7;4;2;13
6552;Ozas;Ančiukų;9195536968;Taip;12;0;1;13
6553;Ozas;Ančiukų;5822871838;Taip;4;0;0;4
6554;Ozas;Ančiukų;1997125531;Taip;8;0;0;8
6555;Ozas;Ančiukų;1240233169;Taip;21;0;0;21
6556;Ozas;Ančiukų;6666591428;Taip;10;0;0;10
6557;Ozas;Ančiukų;8874823029;Taip;7;0;1;8
6558;Ozas;Ančiukų;8178298861;Taip;8;0;1;9
6559;Ozas;Ančiukų;1564826076;Taip;4;7;2;13
6560;Ozas;Ančiukų;5016547315;Ne;21;0;0;21
6561;Ozas;Ančiukų;6088757991;Taip;7;5;2;14
6562;Ozas;Ančiukų;2991511872;Taip;7;10;0;17
6563;Ozas;Ančiukų;6053885086;Taip;9;1;0;10
6564;Ozas;Ančiukų;2511477658;Taip;10;0;1;11
6565;Ozas;Ančiukų;6499549095;Taip;10;0;0;10
6566;Ozas;Ančiukų;7978092840;Taip;3;0;1;4
6567;Ozas;Ančiukų;2637531106;Taip;8;0;1;9
6568;Ozas;Ančiukų;8470832744;Taip;0;4;3;7
6569;Ozas;Ančiukų;6263062055;Ne;9;0;1;10
6570;Ozas;Nykškukų;5216695220;Taip;2;5;0;7
6571;Ozas;Nykškukų;2773182934;Taip;5;0;1;6
6572;Ozas;Nykškukų;5102704846;Taip;5;6;0;11
6573;Ozas;Nykškukų;5642468671;Taip;17;0;0;17
6574;Ozas;Nykškukų;4583818638;Taip;6;0;0;6
6575;Ozas;Nykškukų;1073755384;Taip;10;0;1;11
6576;Ozas;Nykškukų;7686706482;Taip;16;2;0;18
6577;Ozas;Nykškukų;5769870711;Taip;12;0;0;12
6578;Ozas;Nykškukų;1543683077;Taip;6;1;0;7
6579;Ozas;Nykškukų;2922370952;Taip;0;1;2;3
6580;Ozas;Nykškukų;2395567376;Taip;0;6;0;6
6581;Ozas;Nykškukų;6783755555;Taip;0;5;0;5
6582;Ozas;Nykškukų;8987796218;Taip;0;2;0;2
6583;Ozas;Nykškukų;4357737538;Taip;0;7;0;7
6584;Ozas;Nykškukų;5744027226;Ne;19;1;0;20
6585;Ozas;Nykškukų;2544858937;Taip;19;0;0;19
6586;Ozas;Nykškukų;1045890394;Taip;17;1;0;18
6587;Ozas;Nykškukų;1144679735;Taip;17;4;0;21
6588;Ozas;Nykškukų;5383739203;Taip;4;6;0;10
6589;Pabiručiai;Voveriukų;2349337471;Taip;0;6;0;6
6590;Pabiručiai;Voveriukų;4069564285;Taip;0;6;0;6
6591;Pabiručiai;Voveriukų;7278334800;Ne;16;0;0;16
6592;Pabiručiai;Voveriukų;9468698553;Taip;12;4;0;16
6593;Pabiručiai;Voveriukų;5232678556;Ne;0;4;0;4
6594;Pabiručiai;Voveriukų;7066037017;Taip;7;5;0;12
6595;Pabiručiai;Voveriukų;4040533883;Taip;0;0;6;6
6596;Pabiručiai;Voveriukų;2514312233;Taip;11;5;0;16
6597;Pabiručiai;Voveriukų;7606274875;Taip;11;5;0;16
6598;Pabiručiai;Voveriukų;9356327400;Taip;2;8;0;10
6599;Pabiručiai;Voveriukų;7846758352;Taip;0;8;0;8
6600;Pabiručiai;Voveriukų;1498738549;Taip;0;10;0;10
6601;Pabiručiai;Voveriukų;4312364951;Taip;10;4;0;14
6602;Pabiručiai;Voveriukų;2446697763;Taip;15;0;2;17
6603;Pabiručiai;Voveriukų;4813206044;Taip;10;7;0;17
6604;Pabiručiai;Voveriukų;3936426174;Taip;8;0;0;8
6605;Pabiručiai;Voveriukų;2989580886;Taip;19;0;0;19
6606;Pabiručiai;Voveriukų;7985360502;Taip;10;5;0;15
6607;Pabiručiai;Voveriukų;7403996266;Taip;17;0;0;17
6608;Pabiručiai;Voveriukų;6251432968;Taip;0;5;0;5
6609;Pabiručiai;Boružiukų;6401188653;Taip;0;4;3;7
6610;Pabiručiai;Boružiukų;1673473814;Taip;0;10;0;10
6611;Pabiručiai;Boružiukų;5686769648;Ne;12;2;0;14
6612;Pabiručiai;Boružiukų;7524993271;Taip;12;1;0;13
6613;Pabiručiai;Boružiukų;5708597471;Taip;7;0;0;7
6614;Pabiručiai;Boružiukų;7046122545;Taip;0;11;0;11
6615;Pabiručiai;Boružiukų;3096466200;Taip;0;10;0;10
6616;Pabiručiai;Boružiukų;8175565139;Ne;5;0;0;5
6617;Pabiručiai;Boružiukų;8106446562;Taip;10;5;0;15
6618;Pabiručiai;Boružiukų;8236964683;Taip;0;7;0;7
6619;Pabiručiai;Boružiukų;1240057541;Taip;0;3;0;3
6620;Pabiručiai;Boružiukų;1671027282;Ne;7;6;0;13
6621;Pabiručiai;Boružiukų;3759350345;Taip;0;6;0;6
6622;Pabiručiai;Boružiukų;3151360288;Taip;0;8;0;8
6623;Pabiručiai;Boružiukų;9299393363;Taip;0;10;0;10
6624;Pabiručiai;Boružiukų;1484291546;Ne;0;4;7;11
6625;Pabiručiai;Boružiukų;2771769336;Taip;10;2;0;12
6626;Pabiručiai;Boružiukų;2853659708;Ne;7;0;2;9
6627;Pabiručiai;Katinėlių;1670938208;Ne;18;0;0;18
6628;Pabiručiai;Katinėlių;1224986101;Ne;15;0;4;19
6629;Pabiručiai;Katinėlių;3756365293;Taip;14;0;1;15
6630;Pabiručiai;Katinėlių;6283372742;Taip;14;0;0;14
6631;Pabiručiai;Katinėlių;1749155319;Ne;14;1;2;17
6632;Pabiručiai;Katinėlių;34883375155;Taip;7;4;0;11
6633;Pabiručiai;Katinėlių;1705085006;Taip;10;4;0;14
6634;Pabiručiai;Katinėlių;58112415466;Taip;12;3;0;15
6635;Pabiručiai;Katinėlių;42877891797;Taip;0;9;0;9
6636;Pabiručiai;Katinėlių;6285940478;Taip;0;4;0;4
6637;Pabiručiai;Katinėlių;8284711578;Taip;13;0;0;13
6638;Pabiručiai;Katinėlių;8710389714;Taip;10;4;0;14
6639;Pabiručiai;Katinėlių;4501176225;Taip;0;11;0;11
6640;Pabiručiai;Katinėlių;8503177793;Taip;21;0;0;21
6641;Pabiručiai;Katinėlių;95695057362;Taip;4;12;0;16
6642;Pabiručiai;Katinėlių;4339607826;Taip;0;10;0;10
6643;Pabiručiai;Katinėlių;8306688649;Taip;10;0;3;13
6644;Pabiručiai;Katinėlių;2572570925;Taip;14;0;1;15
6645;Pabiručiai;Katinėlių;6994301415;Ne;5;0;13;18
6646;Pabiručiai;Katinėlių;4205107384;Taip;9;0;1;10
6647;Pabiručiai;Katinėlių;5513311280;Ne;9;0;0;9
6648;Pabiručiai;Žiogelių;3272576627;Taip;10;0;1;11
6649;Pabiručiai;Žiogelių;5522447437;Taip;4;4;1;9
6650;Pabiručiai;Žiogelių;7974345478;Taip;0;8;0;8
6651;Pabiručiai;Žiogelių;8367889753;Taip;0;3;0;3
6652;Pabiručiai;Žiogelių;8421025940;Taip;0;4;0;4
6653;Pabiručiai;Žiogelių;3028063887;Taip;0;4;0;4
6654;Pabiručiai;Žiogelių;1642658060;Ne;0;4;2;6
6655;Pabiručiai;Žiogelių;3206962828;Taip;6;6;0;12
6656;Pabiručiai;Žiogelių;3355875364;Taip;0;10;0;10
6657;Pabiručiai;Žiogelių;7085036701;Ne;0;10;0;10
6658;Pabiručiai;Žiogelių;8736658575;Taip;0;1;2;3
6659;Pabiručiai;Žiogelių;5480714322;Taip;2;0;0;2
6660;Pabiručiai;Žiogelių;3585198013;Taip;4;1;0;5
6661;Pabiručiai;Žiogelių;2356833740;Taip;7;6;2;15
6662;Pabiručiai;Žiogelių;5311762824;Taip;11;9;0;20
6663;Pabiručiai;Žiogelių;1587905929;Taip;0;0;4;4
6664;Pabiručiai;Žiogelių;5761888906;Taip;5;10;0;15
6665;Pabiručiai;Žiogelių;4667769378;Taip;5;5;0;10
6666;Pabiručiai;Smalsiukai;26744711510;Taip;0;2;0;2
6667;Pabiručiai;Smalsiukai;77665506359;Taip;0;4;0;4
6668;Pabiručiai;Smalsiukai;25404048436;Taip;1;1;1;3
6669;Pabiručiai;Smalsiukai;99245902550;Ne;0;4;0;4
6670;Pabiručiai;Smalsiukai;72030186300;Taip;0;11;0;11
6671;Pabiručiai;Smalsiukai;1461544209;Taip;0;4;0;4
6672;Pabiručiai;Smalsiukai;1749795353;Taip;8;4;3;15
6673;Pabiručiai;Smalsiukai;83758151778;Ne;4;5;0;9
6674;Pabiručiai;Smalsiukai;46891762701;Taip;0;8;0;8
6675;Pabiručiai;Smalsiukai;88469372129;Taip;0;5;0;5
6676;Pabiručiai;Smalsiukai;1052844376;Taip;0;9;0;9
6677;Pabiručiai;Smalsiukai;55812858767;Taip;0;4;0;4
6678;Pabiručiai;Smalsiukai;97516241743;Taip;9;4;2;15
6679;Pabiručiai;Smalsiukai;37299891873;Taip;0;4;0;4
6680;Pabiručiai;Smalsiukai;99612002248;Taip;0;3;2;5
6681;Pabiručiai;Smalsiukai;67029008630;Taip;0;6;0;6
6682;Pabiručiai;Smalsiukai;84458450123;Taip;0;6;0;6
6683;Pabiručiai;Smalsiukai;8690290547;Taip;0;13;0;13
6684;Pabiručiai;Smalsiukai;1961336031;Ne;7;6;0;13
6685;Pabiručiai;Kiškučiai;23334247840;Ne;7;7;0;14
6686;Pabiručiai;Kiškučiai;78055744911;Taip;2;4;0;6
6687;Pabiručiai;Kiškučiai;9756328087;Ne;6;9;0;15
6688;Pabiručiai;Kiškučiai;16153916925;Ne;0;6;0;6
6689;Pabiručiai;Kiškučiai;69948274186;Taip;0;5;0;5
6690;Pabiručiai;Kiškučiai;62817645726;Taip;0;11;0;11
6691;Pabiručiai;Kiškučiai;25986912111;Taip;0;1;0;1
6692;Pabiručiai;Kiškučiai;99405892035;Taip;0;14;0;14
6693;Pabiručiai;Kiškučiai;31043795418;Taip;0;12;0;12
6694;Pabiručiai;Kiškučiai;1189209435;Taip;2;5;0;7
6695;Pabiručiai;Kiškučiai;58410416452;Taip;0;15;0;15
6696;Pabiručiai;Kiškučiai;1457799587;Taip;0;4;0;4
6697;Pabiručiai;Kiškučiai;93595653770;Taip;2;8;0;10
6698;Pabiručiai;Kiškučiai;4463663862;Taip;13;4;0;17
6699;Pabiručiai;Kiškučiai;1780827082;Taip;2;6;0;8
6700;Pabiručiai;Kiškučiai;3767061583;Taip;3;5;0;8
6701;Pabiručiai;Kiškučiai;37991862437;Taip;0;7;0;7
6702;Pabiručiai;Kiškučiai;5327687404;Taip;0;4;0;4
6703;Pabiručiai;Kiškučiai;52281960273;Taip;0;4;0;4
6704;Pabiručiai;"Pėledžiukai ";7457099536;Taip;0;2;0;2
6705;Pabiručiai;"Pėledžiukai ";77273870334;Taip;13;1;0;14
6706;Pabiručiai;"Pėledžiukai ";80756439543;Taip;4;0;1;5
6707;Pabiručiai;"Pėledžiukai ";75098378597;Taip;0;4;3;7
6708;Pabiručiai;"Pėledžiukai ";90849312010;Taip;16;0;0;16
6709;Pabiručiai;"Pėledžiukai ";6112244077;Ne;0;6;0;6
6710;Pabiručiai;"Pėledžiukai ";18356992277;Taip;0;11;0;11
6711;Pabiručiai;"Pėledžiukai ";55197056543;Taip;3;2;0;5
6712;Pabiručiai;"Pėledžiukai ";28121667845;Taip;5;0;5;10
6713;Pabiručiai;"Pėledžiukai ";1591342751;Taip;0;7;0;7
6714;Pabiručiai;"Pėledžiukai ";1701727758;Taip;0;2;7;9
6715;Pabiručiai;"Pėledžiukai ";3733576400;Taip;0;5;0;5
6716;Pabiručiai;"Pėledžiukai ";4568554097;Taip;6;0;0;6
6717;Pabiručiai;"Pėledžiukai ";34215100257;Taip;11;0;0;11
6718;Pabiručiai;"Pėledžiukai ";26940925728;Taip;0;0;12;12
6719;Pabiručiai;"Pėledžiukai ";2944433375;Taip;13;0;0;13
6720;Pabiručiai;"Kodelčiūkai ";1819457592;Ne;0;5;0;5
6721;Pabiručiai;"Kodelčiūkai ";38142737487;Taip;0;5;0;5
6722;Pabiručiai;"Kodelčiūkai ";62923769489;Taip;0;10;0;10
6723;Pabiručiai;"Kodelčiūkai ";65267728282;Taip;0;4;2;6
6724;Pabiručiai;"Kodelčiūkai ";81307674221;Taip;1;0;2;3
6725;Pabiručiai;"Kodelčiūkai ";15948930587;Taip;21;0;0;21
6726;Pabiručiai;"Kodelčiūkai ";61144974706;Taip;0;7;0;7
6727;Pabiručiai;"Kodelčiūkai ";78798062773;Taip;0;7;0;7
6728;Pabiručiai;"Kodelčiūkai ";66085180057;Ne;0;10;0;10
6729;Pabiručiai;"Kodelčiūkai ";7468072633;Ne;0;5;0;5
6730;Pabiručiai;"Kodelčiūkai ";1901455947;Taip;4;0;0;4
6731;Pabiručiai;"Kodelčiūkai ";1718014001;Taip;0;6;0;6
6732;Pabiručiai;"Kodelčiūkai ";2143676810;Taip;0;13;0;13
6733;Pabiručiai;"Kodelčiūkai ";1029743585;Taip;6;4;0;10
6734;Pabiručiai;"Kodelčiūkai ";1236499374;Taip;11;0;5;16
6735;Pabiručiai;"Kodelčiūkai ";8344476830;Taip;0;14;0;14
6736;Pabiručiai;"Kodelčiūkai ";8359296058;Ne;10;0;0;10
6737;Pabiručiai;"Kodelčiūkai ";4634305371;Taip;0;9;0;9
6738;Pabiručiai;"Kodelčiūkai ";4901977623;Taip;9;0;0;9
6739;Pabiručiai;"Peliukų ";8775727677;Taip;0;2;0;2
6740;Pabiručiai;"Peliukų ";1028312285;Taip;7;0;3;10
6741;Pabiručiai;"Peliukų ";9417138573;Taip;7;0;1;8
6742;Pabiručiai;"Peliukų ";1515270273;Taip;5;0;3;8
6743;Pabiručiai;"Peliukų ";4317656984;Taip;5;0;1;6
6744;Pabiručiai;"Peliukų ";2688728915;Taip;15;0;2;17
6745;Pabiručiai;"Peliukų ";5166525832;Taip;20;0;0;20
6746;Pabiručiai;"Peliukų ";5209535192;Taip;15;0;0;15
6747;Pabiručiai;"Peliukų ";2147165934;Taip;18;0;0;18
6748;Pabiručiai;"Peliukų ";7639362434;Ne;8;0;7;15
6749;Pabiručiai;"Peliukų ";8409455566;Taip;7;6;0;13
6750;Pabiručiai;"Peliukų ";4913415466;Taip;21;0;0;21
6751;Pabiručiai;"Viščiukų ";7090116276;Taip;16;0;0;16
6752;Pabiručiai;"Viščiukų ";8897462614;Taip;0;4;0;4
6753;Pabiručiai;"Viščiukų ";1663953648;Taip;0;5;0;5
6754;Pabiručiai;"Viščiukų ";2869383175;Taip;11;0;0;11
6755;Pabiručiai;"Viščiukų ";5790737929;Taip;8;4;0;12
6756;Pabiručiai;"Viščiukų ";7677235214;Taip;13;0;0;13
6757;Pabiručiai;"Viščiukų ";9676561758;Taip;0;11;0;11
6758;Pabiručiai;"Viščiukų ";7632969321;Ne;16;2;0;18
6759;Pabiručiai;"Viščiukų ";3700401383;Taip;0;21;0;21
6760;Pabiručiai;"Viščiukų ";9093137227;Taip;10;0;0;10
6761;Pabiručiai;"Viščiukų ";6935913132;Ne;12;0;1;13
6762;Pabiručiai;"Viščiukų ";7663581089;Taip;7;4;0;11
6763;Pabiručiai;"Viščiukų ";7248314871;Taip;9;0;0;9
6764;Pabiručiai;"Viščiukų ";9610623364;Taip;8;3;0;11
6765;Pabiručiai;"Viščiukų ";1344711015;Ne;0;10;0;10
6766;Pabiručiai;"Drugelių ";4462744848;Taip;7;3;0;10
6767;Pabiručiai;"Drugelių ";9589005897;Taip;0;0;4;4
6768;Pabiručiai;"Drugelių ";1582754284;Taip;7;5;0;12
6769;Pabiručiai;"Drugelių ";5497318373;Taip;0;1;1;2
6770;Pabiručiai;"Drugelių ";8179285338;Taip;0;6;0;6
6771;Pabiručiai;"Drugelių ";4408666547;Taip;0;5;0;5
6772;Pabiručiai;"Drugelių ";4080298620;Taip;7;10;0;17
6773;Pabiručiai;"Drugelių ";6697518151;Taip;7;8;0;15
6774;Pabiručiai;"Drugelių ";3497466298;Taip;0;14;0;14
6775;Pabiručiai;"Drugelių ";3368607302;Taip;3;0;4;7
6776;Pabiručiai;"Drugelių ";9353062804;Taip;21;0;0;21
6777;Pabiručiai;"Drugelių ";6421623010;Taip;19;2;0;21
6778;Pagrandukas;Saulytės;56985738094;Taip;0;7;0;7
6779;Pagrandukas;Saulytės;73747309137;Ne;0;5;0;5
6780;Pagrandukas;Saulytės;81225644879;Taip;0;2;0;2
6781;Pagrandukas;Saulytės;73094500140;Taip;0;6;0;6
6782;Pagrandukas;Saulytės;25042144265;Taip;0;5;0;5
6783;Pagrandukas;Saulytės;17860708643;Taip;0;4;0;4
6784;Pagrandukas;Saulytės;10275994267;Taip;12;1;0;13
6785;Pagrandukas;Saulytės;53442283517;Ne;0;11;0;11
6786;Pagrandukas;Saulytės;85893187794;Taip;0;6;0;6
6787;Pagrandukas;Saulytės;2240690677;Taip;2;6;0;8
6788;Pagrandukas;Saulytės;23836053268;Taip;0;10;0;10
6789;Pagrandukas;Saulytės;82076379343;Taip;0;10;0;10
6790;Pagrandukas;Saulytės;90244057040;Ne;0;14;0;14
6791;Pagrandukas;Saulytės;5179694773;Taip;0;2;0;2
6792;Pagrandukas;Saulytės;1432860651;Taip;0;6;0;6
6793;Pagrandukas;Saulytės;4550081974;Taip;0;19;0;19
6794;Pagrandukas;Saulytės;61332904191;Taip;0;9;0;9
6795;Pagrandukas;Zuikučiai;7834436515;Taip;0;6;0;6
6796;Pagrandukas;Zuikučiai;8417942459;Taip;0;2;2;4
6797;Pagrandukas;Zuikučiai;7435609306;Taip;17;0;0;17
6798;Pagrandukas;Zuikučiai;5903416384;Taip;6;4;1;11
6799;Pagrandukas;Zuikučiai;2439891231;Taip;6;0;0;6
6800;Pagrandukas;Zuikučiai;6710887776;Taip;6;0;0;6
6801;Pagrandukas;Zuikučiai;5649084353;Taip;21;0;0;21
6802;Pagrandukas;Zuikučiai;7665811353;Taip;10;0;9;19
6803;Pagrandukas;Zuikučiai;2212787835;Taip;9;1;1;11
6804;Pagrandukas;Zuikučiai;2711590019;Taip;0;3;1;4
6805;Pagrandukas;Zuikučiai;6449029299;Taip;8;0;4;12
6806;Pagrandukas;Zuikučiai;1405820070;Taip;20;0;0;20
6807;Pagrandukas;Zuikučiai;1054107640;Ne;6;0;0;6
6808;Pagrandukas;Zuikučiai;1885539883;Taip;4;1;0;5
6809;Pagrandukas;Zuikučiai;1795582354;Taip;9;5;0;14
6810;Pagrandukas;Zuikučiai;2822538227;Taip;6;0;3;9
6811;Pagrandukas;Boružėlių;3398225200;Taip;0;6;0;6
6812;Pagrandukas;Boružėlių;5752454925;Taip;3;8;0;11
6813;Pagrandukas;Boružėlių;3587941684;Ne;0;8;0;8
6814;Pagrandukas;Boružėlių;5946007985;Taip;0;3;3;6
6815;Pagrandukas;Boružėlių;7770852445;Taip;0;3;1;4
6816;Pagrandukas;Boružėlių;6304701617;Taip;8;0;0;8
6817;Pagrandukas;Boružėlių;3953844737;Taip;0;7;0;7
6818;Pagrandukas;Boružėlių;7271589727;Taip;3;4;0;7
6819;Pagrandukas;Boružėlių;7064391685;Taip;0;0;2;2
6820;Pagrandukas;Boružėlių;5640182548;Taip;8;3;0;11
6821;Pagrandukas;Boružėlių;1403569615;Ne;4;5;0;9
6822;Pagrandukas;Boružėlių;1998073387;Taip;5;4;0;9
6823;Pagrandukas;Boružėlių;5511396314;Taip;2;9;0;11
6824;Pagrandukas;Boružėlių;5648658237;Taip;6;1;0;7
6825;Pagrandukas;Boružėlių;9651789217;Taip;0;5;0;5
6826;Pagrandukas;Boružėlių;6911951786;Taip;0;10;0;10
6827;Pagrandukas;Boružėlių;2926077771;Taip;7;4;0;11
6828;Pagrandukas;Boružėlių;5741021524;Taip;0;0;7;7
6829;Pagrandukas;Boružėlių;2361829423;Taip;11;0;0;11
6830;Pagrandukas;Bitutės;22146063631;Taip;0;6;0;6
6831;Pagrandukas;Bitutės;1654566158;Taip;0;4;2;6
6832;Pagrandukas;Bitutės;44029972943;Taip;0;6;0;6
6833;Pagrandukas;Bitutės;47836927832;Taip;5;2;0;7
6834;Pagrandukas;Bitutės;1707429884;Taip;6;1;1;8
6835;Pagrandukas;Bitutės;91591094393;Taip;3;1;0;4
6836;Pagrandukas;Bitutės;6585880191;Taip;0;2;1;3
6837;Pagrandukas;Bitutės;1503479321;Taip;3;6;2;11
6838;Pagrandukas;Bitutės;9313380552;Taip;3;1;3;7
6839;Pagrandukas;Bitutės;51982253355;Taip;0;12;0;12
6840;Pagrandukas;Bitutės;73259512452;Taip;0;10;0;10
6841;Pagrandukas;Bitutės;80939233319;Taip;0;10;0;10
6842;Pagrandukas;Bitutės;6044667668;Taip;8;0;0;8
6843;Pagrandukas;Bitutės;3227066520;Taip;3;5;2;10
6844;Pagrandukas;Bitutės;1813676320;Taip;0;4;5;9
6845;Pagrandukas;Bitutės;57471531440;Taip;0;14;0;14
6846;Pagrandukas;Bitutės;6315627367;Taip;1;0;0;1
6847;Pagrandukas;Bitutės;8529974367;Taip;4;1;0;5
6848;Pagrandukas;Bitutės;1938604743;Taip;3;0;0;3
6849;Pagrandukas;Bitutės;4079711515;Ne;15;0;0;15
6850;Pagrandukas;Pelėdžiukai;21409116617;Taip;0;2;0;2
6851;Pagrandukas;Pelėdžiukai;82163714693;Taip;5;4;2;11
6852;Pagrandukas;Pelėdžiukai;1590309916;Taip;0;2;0;2
6853;Pagrandukas;Pelėdžiukai;1964310988;Taip;0;2;0;2
6854;Pagrandukas;Pelėdžiukai;44044284874;Taip;0;9;0;9
6855;Pagrandukas;Pelėdžiukai;33750135077;Taip;9;2;0;11
6856;Pagrandukas;Pelėdžiukai;2066377478;Taip;7;1;1;9
6857;Pagrandukas;Pelėdžiukai;1189453012;Taip;0;6;0;6
6858;Pagrandukas;Pelėdžiukai;43539883053;Taip;3;1;0;4
6859;Pagrandukas;Pelėdžiukai;4391887554;Taip;8;1;0;9
6860;Pagrandukas;Pelėdžiukai;33909593470;Taip;0;7;0;7
6861;Pagrandukas;Pelėdžiukai;2068155037;Taip;0;4;0;4
6862;Pagrandukas;Pelėdžiukai;7751376696;Taip;1;5;0;6
6863;Pagrandukas;Pelėdžiukai;5818020587;Taip;4;4;0;8
6864;Pagrandukas;Pelėdžiukai;21544489661;Taip;7;4;0;11
6865;Pagrandukas;Pelėdžiukai;93036151205;Ne;0;2;0;2
6866;Pagrandukas;Pelėdžiukai;1232460221;Taip;13;1;0;14
6867;Pagrandukas;Pelėdžiukai;7611916563;Taip;0;4;0;4
6868;Pagrandukas;Pelėdžiukai;1451503127;Ne;21;0;0;21
6869;Pagrandukas;Žvaigždutė;1904462840;Taip;0;4;0;4
6870;Pagrandukas;Žvaigždutė;9329518124;Taip;5;4;0;9
6871;Pagrandukas;Žvaigždutė;75080308291;Taip;0;17;0;17
6872;Pagrandukas;Žvaigždutė;7876029445;Ne;0;14;0;14
6873;Pagrandukas;Žvaigždutė;1313716840;Taip;0;4;0;4
6874;Pagrandukas;Žvaigždutė;14043704729;Taip;9;1;0;10
6875;Pagrandukas;Žvaigždutė;51692261484;Ne;0;7;0;7
6876;Pagrandukas;Žvaigždutė;35830862363;Ne;11;1;0;12
6877;Pagrandukas;Žvaigždutė;2079943643;Taip;11;0;0;11
6878;Pagrandukas;Žvaigždutė;2923517578;Taip;0;17;0;17
6879;Pagrandukas;Žvaigždutė;4724383814;Taip;0;8;0;8
6880;Pagrandukas;Žvaigždutė;7782678159;Ne;9;1;2;12
6881;Pagrandukas;Žvaigždutė;8879549409;Taip;0;4;0;4
6882;Pagrandukas;Žvaigždutė;6299298199;Taip;0;17;0;17
6883;Pagrandukas;Žvaigždutė;7543795007;Taip;0;9;0;9
6884;Pagrandukas;Žvaigždutė;3860781857;Taip;0;6;0;6
6885;Pagrandukas;Žvaigždutė;24287759126;Taip;0;4;0;4
6886;Pagrandukas;Žvaigždutė;2461803626;Taip;5;1;0;6
6887;Pagrandukas;Žvaigždutė;1376514473;Taip;0;6;0;6
6888;Pakalnutė;Pagrandukai;22735454739;Taip;0;5;6;11
6889;Pakalnutė;Pagrandukai;1621947670;Ne;15;0;0;15
6890;Pakalnutė;Pagrandukai;2930341121;Taip;0;4;0;4
6891;Pakalnutė;Pagrandukai;18927141423;Taip;0;4;0;4
6892;Pakalnutė;Pagrandukai;70476217309;Ne;6;6;0;12
6893;Pakalnutė;Pagrandukai;39181323005;Taip;0;5;0;5
6894;Pakalnutė;Pagrandukai;86458592440;Taip;5;4;0;9
6895;Pakalnutė;Pagrandukai;46144634381;Taip;0;3;0;3
6896;Pakalnutė;Pagrandukai;85764245101;Taip;0;9;0;9
6897;Pakalnutė;Pagrandukai;57463392902;Taip;0;5;0;5
6898;Pakalnutė;Pagrandukai;97346486902;Taip;0;7;0;7
6899;Pakalnutė;Pagrandukai;24840895951;Taip;0;4;1;5
6900;Pakalnutė;Pagrandukai;89329905839;Taip;0;5;0;5
6901;Pakalnutė;Pagrandukai;7535589010;Taip;0;4;0;4
6902;Pakalnutė;Pagrandukai;1210432627;Taip;0;8;0;8
6903;Pakalnutė;Pagrandukai;3987920952;Ne;0;3;0;3
6904;Pakalnutė;Pagrandukai;34357752735;Ne;0;4;0;4
6905;Pakalnutė;Pagrandukai;28398386463;Taip;0;5;0;5
6906;Pakalnutė;Pagrandukai;1970792910;Taip;3;0;0;3
6907;Pakalnutė;"Pelėdžiukų ";7110858765;Taip;16;0;0;16
6908;Pakalnutė;"Pelėdžiukų ";8553182620;Ne;2;0;1;3
6909;Pakalnutė;"Pelėdžiukų ";3840499737;Taip;0;12;0;12
6910;Pakalnutė;"Pelėdžiukų ";4523766424;Taip;0;0;5;5
6911;Pakalnutė;"Pelėdžiukų ";6577255841;Taip;20;0;0;20
6912;Pakalnutė;"Pelėdžiukų ";7151877991;Taip;17;0;0;17
6913;Pakalnutė;"Pelėdžiukų ";3919560072;Ne;21;0;0;21
6914;Pakalnutė;"Pelėdžiukų ";2992768162;Taip;0;3;0;3
6915;Pakalnutė;"Pelėdžiukų ";9505524183;Taip;14;0;0;14
6916;Pakalnutė;"Pelėdžiukų ";3792697409;Taip;2;4;0;6
6917;Pakalnutė;"Pelėdžiukų ";8823232039;Taip;17;0;0;17
6918;Pakalnutė;"Pelėdžiukų ";8900756351;Taip;0;0;5;5
6919;Pakalnutė;"Pelėdžiukų ";2035060922;Ne;0;0;2;2
6920;Pakalnutė;"Pelėdžiukų ";7325137583;Taip;0;0;3;3
6921;Pakalnutė;"Pelėdžiukų ";4220368864;Ne;10;0;0;10
6922;Pakalnutė;"Pelėdžiukų ";1330092247;Taip;0;12;0;12
6923;Pakalnutė;"Pelėdžiukų ";3267680599;Ne;5;8;0;13
6924;Pakalnutė;"Pelėdžiukų ";3365726271;Ne;10;0;1;11
6925;Pakalnutė;Ežiukai;2714905466;Taip;0;0;2;2
6926;Pakalnutė;Ežiukai;4052166895;Taip;5;0;1;6
6927;Pakalnutė;Ežiukai;3650483589;Taip;7;0;0;7
6928;Pakalnutė;Ežiukai;7962849592;Taip;12;4;0;16
6929;Pakalnutė;Ežiukai;1070172991;Taip;11;0;0;11
6930;Pakalnutė;Ežiukai;3660195990;Taip;21;0;0;21
6931;Pakalnutė;Ežiukai;9323200833;Taip;15;1;0;16
6932;Pakalnutė;Ežiukai;4153294595;Taip;2;0;0;2
6933;Pakalnutė;Ežiukai;8155327668;Taip;9;1;0;10
6934;Pakalnutė;Ežiukai;9781993614;Taip;21;0;0;21
6935;Pakalnutė;Ežiukai;9256219647;Taip;0;6;0;6
6936;Pakalnutė;Ežiukai;7853479591;Ne;9;4;0;13
6937;Pakalnutė;Ežiukai;4747688220;Taip;7;0;0;7
6938;Pakalnutė;Skruzdėliukų;3583094831;Taip;3;2;0;5
6939;Pakalnutė;Skruzdėliukų;4033813807;Taip;21;0;0;21
6940;Pakalnutė;Skruzdėliukų;9382160515;Taip;0;10;0;10
6941;Pakalnutė;Skruzdėliukų;7503936754;Taip;3;0;0;3
6942;Pakalnutė;Skruzdėliukų;5409476517;Taip;9;9;0;18
6943;Pakalnutė;Skruzdėliukų;2670302354;Taip;16;0;0;16
6944;Pakalnutė;Skruzdėliukų;7105369111;Taip;13;0;0;13
6945;Pakalnutė;Skruzdėliukų;6944726166;Ne;5;0;0;5
6946;Pakalnutė;Skruzdėliukų;1195872320;Taip;16;0;0;16
6947;Pakalnutė;Skruzdėliukų;3211633472;Taip;6;0;0;6
6948;Pakalnutė;Skruzdėliukų;4423348418;Taip;9;0;0;9
6949;Pakalnutė;Skruzdėliukų;6934760468;Taip;18;0;0;18
6950;Pakalnutė;Skruzdėliukų;5911381706;Taip;16;0;0;16
6951;Pakalnutė;Skruzdėliukų;8797870379;Taip;13;5;0;18
6952;Pakalnutė;Skruzdėliukų;6055727963;Taip;13;0;0;13
6953;Pakalnutė;Bitučių;2993145079;Taip;6;4;0;10
6954;Pakalnutė;Bitučių;2367683002;Taip;4;1;0;5
6955;Pakalnutė;Bitučių;2765220889;Taip;0;10;0;10
6956;Pakalnutė;Bitučių;9445909071;Ne;0;4;0;4
6957;Pakalnutė;Bitučių;5532458706;Taip;0;8;0;8
6958;Pakalnutė;Bitučių;7526989580;Taip;0;4;1;5
6959;Pakalnutė;Bitučių;5941955322;Taip;2;5;0;7
6960;Pakalnutė;Bitučių;3306334576;Taip;0;7;0;7
6961;Pakalnutė;Bitučių;2095540372;Ne;7;4;0;11
6962;Pakalnutė;Bitučių;5342592825;Taip;15;0;0;15
6963;Pakalnutė;Bitučių;1238121406;Taip;0;9;0;9
6964;Pakalnutė;Bitučių;6117542654;Ne;7;8;0;15
6965;Pakalnutė;Bitučių;5464143742;Taip;14;4;0;18
6966;Pakalnutė;Bitučių;6351193702;Ne;2;8;0;10
6967;Pakalnutė;Bitučių;3965390135;Taip;3;5;0;8
6968;Pakalnutė;Bitučių;9365592664;Taip;0;5;0;5
6969;Pakalnutė;Bitučių;5355198213;Taip;0;5;0;5
6970;Pakalnutė;Boružiukų;5120176374;Taip;0;5;2;7
6971;Pakalnutė;Boružiukų;6798939288;Taip;0;4;0;4
6972;Pakalnutė;Boružiukų;7357431226;Taip;5;7;0;12
6973;Pakalnutė;Boružiukų;4934095931;Taip;6;4;0;10
6974;Pakalnutė;Boružiukų;5039000154;Taip;7;1;0;8
6975;Pakalnutė;Boružiukų;6575909478;Taip;0;0;1;1
6976;Pakalnutė;Boružiukų;2835611316;Taip;2;0;1;3
6977;Pakalnutė;Boružiukų;5134342817;Taip;4;3;0;7
6978;Pakalnutė;Boružiukų;7672252382;Ne;1;0;0;1
6979;Pakalnutė;Boružiukų;7439220341;Taip;3;4;5;12
6980;Pakalnutė;Boružiukų;4950195858;Taip;13;0;1;14
6981;Pakalnutė;Boružiukų;1870528568;Taip;7;4;0;11
6982;Pakalnutė;Boružiukų;6557165567;Ne;18;0;0;18
6983;Pakalnutė;Boružiukų;3677709759;Taip;7;0;0;7
6984;Pakalnutė;Boružiukų;2597900983;Taip;19;0;0;19
6985;Pakalnutė;Boružiukų;2062721289;Ne;6;1;0;7
6986;Pakalnutė;Boružiukų;1340022702;Ne;21;0;0;21
6987;Pakalnutė;Meškiukų;41008813511;Ne;17;3;0;20
6988;Pakalnutė;Meškiukų;64706392096;Ne;0;11;0;11
6989;Pakalnutė;Meškiukų;1411083263;Taip;0;4;0;4
6990;Pakalnutė;Meškiukų;2202341545;Taip;19;0;0;19
6991;Pakalnutė;Meškiukų;7180617984;Ne;0;11;0;11
6992;Pakalnutė;Meškiukų;7487278074;Taip;5;2;2;9
6993;Pakalnutė;Meškiukų;9355380341;Taip;14;0;0;14
6994;Pakalnutė;Meškiukų;7324846434;Taip;5;5;0;10
6995;Pakalnutė;Meškiukų;1396367371;Taip;0;4;0;4
6996;Pakalnutė;Meškiukų;2666441234;Taip;3;1;0;4
6997;Pakalnutė;Meškiukų;4256222944;Taip;19;0;0;19
6998;Pakalnutė;Meškiukų;6194464236;Taip;2;0;1;3
6999;Pakalnutė;Meškiukų;7659209862;Taip;21;0;0;21
7000;Pakalnutė;Meškiukų;2101821362;Taip;15;4;0;19
7001;Pakalnutė;Meškiukų;1532248269;Taip;19;0;0;19
7002;Pakalnutė;Meškiukų;3675401775;Taip;19;0;0;19
7003;Pakalnutė;Meškiukų;9001185744;Taip;2;0;0;2
7004;Pakalnutė;Meškiukų;4317305712;Taip;12;1;0;13
7005;Pakalnutė;Meškiukų;2755412687;Taip;10;10;0;20
7006;Pakalnutė;Meškiukų;4533467194;Ne;5;2;0;7
7007;Pakalnutė;Nykštukai;6769352325;Taip;0;11;0;11
7008;Pakalnutė;Nykštukai;72137985328;Taip;0;4;2;6
7009;Pakalnutė;Nykštukai;11183301096;Taip;10;5;0;15
7010;Pakalnutė;Nykštukai;19773872429;Taip;8;0;0;8
7011;Pakalnutė;Nykštukai;85900847069;Taip;0;9;0;9
7012;Pakalnutė;Nykštukai;16651154416;Taip;0;5;0;5
7013;Pakalnutė;Nykštukai;7452656662;Taip;2;6;0;8
7014;Pakalnutė;Nykštukai;7389600659;Taip;0;4;1;5
7015;Pakalnutė;Nykštukai;5309195407;Taip;14;2;0;16
7016;Pakalnutė;Nykštukai;1849396954;Taip;13;4;0;17
7017;Pakalnutė;Nykštukai;81963663668;Taip;0;1;0;1
7018;Pakalnutė;Nykštukai;99344331316;Taip;4;4;1;9
7019;Pakalnutė;Nykštukai;33667858388;Taip;0;2;0;2
7020;Pakalnutė;Nykštukai;2815093249;Ne;7;5;0;12
7021;Pakalnutė;Nykštukai;1372722843;Taip;7;0;0;7
7022;Pakalnutė;Nykštukai;61712002384;Taip;0;9;0;9
7023;Pakalnutė;Nykštukai;9647325689;Taip;0;0;1;1
7024;Pakalnutė;Nykštukai;2051737273;Taip;2;0;1;3
7025;Pakalnutė;"Zuikučių ";1198230323;Taip;0;4;3;7
7026;Pakalnutė;"Zuikučių ";6016791282;Taip;0;0;1;1
7027;Pakalnutė;"Zuikučių ";3609982613;Ne;7;6;0;13
7028;Pakalnutė;"Zuikučių ";5958653847;Taip;2;5;0;7
7029;Pakalnutė;"Zuikučių ";8513260520;Taip;5;5;0;10
7030;Pakalnutė;"Zuikučių ";2159430356;Taip;0;6;0;6
7031;Pakalnutė;"Zuikučių ";1147843795;Ne;6;4;1;11
7032;Pakalnutė;"Zuikučių ";6879558965;Taip;0;14;0;14
7033;Pakalnutė;"Zuikučių ";3555822605;Taip;0;4;7;11
7034;Pakalnutė;"Zuikučių ";7563201788;Taip;0;13;0;13
7035;Pakalnutė;"Zuikučių ";1583462733;Taip;5;0;0;5
7036;Pakalnutė;"Zuikučių ";6377564215;Taip;0;4;0;4
7037;Pakalnutė;"Zuikučių ";1610847242;Taip;0;9;0;9
7038;Pakalnutė;"Zuikučių ";8813262660;Ne;11;4;0;15
7039;Pakalnutė;"Zuikučių ";5102345686;Taip;3;3;1;7
7040;Pakalnutė;"Zuikučių ";7949588551;Ne;0;1;0;1
7041;Pakalnutė;"Zuikučių ";81578522887;Ne;0;7;0;7
7042;Pakalnutė;"Zuikučių ";5949298584;Taip;0;4;0;4
7043;Pakalnutė;"Drugelių ";4046820545;Taip;4;5;0;9
7044;Pakalnutė;"Drugelių ";5973972464;Taip;19;0;0;19
7045;Pakalnutė;"Drugelių ";4742424647;Taip;0;3;5;8
7046;Pakalnutė;"Drugelių ";2075865543;Taip;7;5;0;12
7047;Pakalnutė;"Drugelių ";9562957603;Taip;0;4;0;4
7048;Pakalnutė;"Drugelių ";5435336235;Taip;0;5;4;9
7049;Pakalnutė;"Drugelių ";2050880681;Taip;10;0;0;10
7050;Pakalnutė;"Drugelių ";4514642887;Taip;7;4;2;13
7051;Pakalnutė;"Drugelių ";9274456755;Taip;0;4;0;4
7052;Pakalnutė;"Drugelių ";2721810040;Taip;0;0;11;11
7053;Pakalnutė;"Drugelių ";80818670065;Taip;1;11;1;13
7054;Pakalnutė;"Drugelių ";2049079012;Taip;0;21;0;21
7055;Pakalnutė;"Drugelių ";4681267749;Taip;0;17;0;17
7056;Pakalnutė;"Drugelių ";85356812538;Taip;11;0;0;11
7057;Pakalnutė;"Drugelių ";6771510589;Taip;5;9;0;14
7058;Pakalnutė;"Drugelių ";4264260466;Taip;0;4;5;9
7059;Pakalnutė;"Drugelių ";58670351468;Ne;0;5;0;5
7060;Pakalnutė;"Drugelių ";2901031642;Taip;0;5;0;5
7061;Panerių;Rūtelė;21661667266;Taip;0;0;5;5
7062;Panerių;Rūtelė;7324873912;Taip;9;4;3;16
7063;Panerių;Rūtelė;8388744329;Taip;0;4;6;10
7064;Panerių;Rūtelė;68313730462;Taip;0;0;5;5
7065;Panerių;Rūtelė;84672957234;Taip;18;0;0;18
7066;Panerių;Rūtelė;60738239005;Taip;17;0;0;17
7067;Panerių;Rūtelė;1017100748;Taip;12;5;0;17
7068;Panerių;Rūtelė;68231938043;Ne;0;0;2;2
7069;Panerių;Rūtelė;78838685571;Taip;0;4;1;5
7070;Panerių;Rūtelė;53384267657;Taip;0;0;2;2
7071;Panerių;Rūtelė;8666159951;Taip;10;0;5;15
7072;Panerių;Rūtelė;7753488216;Taip;7;0;7;14
7073;Panerių;Rūtelė;6227583229;Taip;0;0;5;5
7074;Panerių;Rūtelė;1894521927;Ne;8;3;2;13
7075;Panerių;Rūtelė;1303873524;Taip;6;0;3;9
7076;Panerių;Rūtelė;75034220223;Ne;15;0;0;15
7077;Panerių;Rūtelė;2069150261;Taip;9;2;0;11
7078;Panerių;Rūtelė;1386277428;Taip;0;2;0;2
7079;Panerių;Rūtelė;4103412131;Taip;0;0;16;16
7080;Panerių;Rūtelė;2786775879;Taip;0;11;0;11
7081;Panerių;Rūtelė;9004468035;Taip;14;0;0;14
7082;Panerių;Gėlytės;9268558715;Taip;12;0;6;18
7083;Panerių;Gėlytės;9604335101;Taip;18;0;0;18
7084;Panerių;Gėlytės;2189532651;Taip;0;7;0;7
7085;Panerių;Gėlytės;1066011221;Taip;14;0;1;15
7086;Panerių;Gėlytės;3843500717;Taip;14;0;0;14
7087;Panerių;Gėlytės;9639587601;Taip;6;2;0;8
7088;Panerių;Gėlytės;3631150576;Ne;3;11;0;14
7089;Panerių;Gėlytės;5001921323;Taip;0;4;0;4
7090;Panerių;Gėlytės;2608386063;Taip;14;0;1;15
7091;Panerių;Gėlytės;2195332401;Taip;11;0;8;19
7092;Panerių;Gėlytės;4023257875;Taip;0;0;6;6
7093;Panerių;Gėlytės;4689913361;Taip;8;0;0;8
7094;Panerių;Gėlytės;6182126113;Ne;0;9;1;10
7095;Panerių;Gėlytės;2571561865;Taip;12;5;0;17
7096;Panerių;Gėlytės;6908487075;Taip;10;4;3;17
7097;Panerių;Gėlytės;8771264170;Ne;0;0;9;9
7098;Panerių;Gėlytės;7805429137;Taip;8;0;1;9
7099;Panerių;Gėlytės;9268618414;Taip;9;0;0;9
7100;Panerių;Gėlytės;6411372006;Taip;15;4;0;19
7101;Panerių;Gėlytės;1419817211;Ne;14;0;0;14
7102;Panerių;Gėlytės;3346395516;Taip;0;9;0;9
7103;Panerių;Boružė;3190117304;Taip;2;9;0;11
7104;Panerių;Boružė;6583134855;Taip;7;4;2;13
7105;Panerių;Boružė;6468190149;Taip;5;0;2;7
7106;Panerių;Boružė;3550194241;Taip;0;2;0;2
7107;Panerių;Boružė;4646173276;Taip;13;0;4;17
7108;Panerių;Boružė;3913395809;Taip;0;4;17;21
7109;Panerių;Boružė;8514805919;Taip;0;0;3;3
7110;Panerių;Boružė;4867297993;Taip;6;0;0;6
7111;Panerių;Boružė;9630302749;Taip;14;0;2;16
7112;Panerių;Boružė;2308739823;Taip;16;0;1;17
7113;Panerių;Boružė;3057714143;Taip;16;0;0;16
7114;Panerių;Boružė;9506008651;Taip;9;0;9;18
7115;Panerių;Boružė;9188471756;Taip;7;1;0;8
7116;Panerių;Boružė;8693113275;Ne;18;0;0;18
7117;Panerių;Boružė;2235123048;Taip;21;0;0;21
7118;Panerių;Boružė;5861312413;Taip;18;0;0;18
7119;Papartis;ZUIKUČIAI;1065234123;Taip;11;0;0;11
7120;Papartis;ZUIKUČIAI;27900855758;Taip;0;0;1;1
7121;Papartis;ZUIKUČIAI;1219140467;Taip;16;2;0;18
7122;Papartis;ZUIKUČIAI;1260151691;Taip;0;1;0;1
7123;Papartis;ZUIKUČIAI;2412700197;Taip;4;0;0;4
7124;Papartis;ZUIKUČIAI;1554777403;Taip;2;1;7;10
7125;Papartis;ZUIKUČIAI;7703070601;Taip;0;2;0;2
7126;Papartis;ZUIKUČIAI;7902130389;Taip;4;0;1;5
7127;Papartis;ZUIKUČIAI;4992305227;Taip;6;6;0;12
7128;Papartis;ZUIKUČIAI;4346817695;Taip;14;0;0;14
7129;Papartis;ZUIKUČIAI;2447926422;Taip;0;8;0;8
7130;Papartis;ZUIKUČIAI;3182457453;Taip;14;1;0;15
7131;Papartis;ZUIKUČIAI;3275123842;Taip;6;2;0;8
7132;Papartis;ZUIKUČIAI;8190458132;Taip;0;4;1;5
7133;Papartis;ZUIKUČIAI;8952917454;Taip;8;4;1;13
7134;Papartis;ZUIKUČIAI;5410369044;Taip;18;0;0;18
7135;Papartis;ZUIKUČIAI;6126912448;Taip;2;4;0;6
7136;Papartis;ZUIKUČIAI;5675537250;Ne;11;0;0;11
7137;Papartis;ZUIKUČIAI;3221250267;Taip;0;4;3;7
7138;Papartis;ZUIKUČIAI;1065128993;Ne;16;1;2;19
7139;Papartis;ZUIKUČIAI;3895487270;Taip;12;5;0;17
7140;Papartis;ZUIKUČIAI;1527263538;Taip;0;0;8;8
7141;Papartis;DRUGELIAI;4508053349;Taip;3;8;0;11
7142;Papartis;DRUGELIAI;7387281720;Taip;0;12;0;12
7143;Papartis;DRUGELIAI;2778629398;Taip;10;8;2;20
7144;Papartis;DRUGELIAI;3475745012;Ne;0;0;20;20
7145;Papartis;DRUGELIAI;2535412635;Taip;6;0;2;8
7146;Papartis;DRUGELIAI;6797687614;Taip;2;0;11;13
7147;Papartis;DRUGELIAI;7606939822;Taip;5;0;2;7
7148;Papartis;DRUGELIAI;9719465384;Ne;6;2;1;9
7149;Papartis;DRUGELIAI;8148483438;Taip;17;0;1;18
7150;Papartis;DRUGELIAI;5265293240;Taip;14;2;0;16
7151;Papartis;DRUGELIAI;7590170146;Taip;7;0;2;9
7152;Papartis;DRUGELIAI;9134335737;Taip;14;2;0;16
7153;Papartis;DRUGELIAI;1836914270;Taip;0;0;5;5
7154;Papartis;DRUGELIAI;4935694347;Ne;15;0;2;17
7155;Papartis;DRUGELIAI;1672028156;Taip;0;6;2;8
7156;Papartis;DRUGELIAI;4634683589;Taip;0;12;0;12
7157;Papartis;DRUGELIAI;3267416367;Taip;1;4;0;5
7158;Papartis;DRUGELIAI;3107106078;Taip;10;0;0;10
7159;Papartis;DRUGELIAI;1205854439;Ne;0;0;12;12
7160;Papartis;DRUGELIAI;7067369268;Taip;12;0;5;17
7161;Papartis;DRUGELIAI;6746279237;Taip;21;0;0;21
7162;Papartis;DRUGELIAI;42803013754;Taip;0;4;0;4
7163;Papartis;ŽVIRBLIUKAI;19544040390;Ne;5;4;1;10
7164;Papartis;ŽVIRBLIUKAI;19852567505;Taip;12;4;0;16
7165;Papartis;ŽVIRBLIUKAI;32352993438;Taip;7;4;0;11
7166;Papartis;ŽVIRBLIUKAI;67237428983;Taip;5;4;1;10
7167;Papartis;ŽVIRBLIUKAI;89486863055;Taip;0;1;0;1
7168;Papartis;ŽVIRBLIUKAI;20002349512;Taip;4;4;0;8
7169;Papartis;ŽVIRBLIUKAI;4139884005;Taip;2;4;1;7
7170;Papartis;ŽVIRBLIUKAI;81734271362;Taip;0;4;0;4
7171;Papartis;ŽVIRBLIUKAI;87519747220;Taip;0;4;7;11
7172;Papartis;ŽVIRBLIUKAI;87353511647;Taip;10;4;0;14
7173;Papartis;ŽVIRBLIUKAI;25990216006;Taip;4;4;0;8
7174;Papartis;ŽVIRBLIUKAI;26912851152;Taip;10;4;0;14
7175;Papartis;ŽVIRBLIUKAI;60706816641;Taip;6;4;3;13
7176;Papartis;ŽVIRBLIUKAI;77686722867;Taip;0;4;2;6
7177;Papartis;ŽVIRBLIUKAI;1403114386;Taip;0;4;0;4
7178;Papartis;ŽVIRBLIUKAI;2146286089;Taip;2;5;2;9
7179;Papartis;ŽVIRBLIUKAI;1876543445;Taip;4;3;0;7
7180;Papartis;ŽVIRBLIUKAI;1282377728;Taip;0;1;0;1
7181;Papartis;ŽVIRBLIUKAI;7308118576;Taip;6;4;1;11
7182;Papartis;ŽVIRBLIUKAI;45289621684;Taip;0;8;0;8
7183;Papartis;PELĖDŽIUKAI;37759125130;Taip;8;4;9;21
7184;Papartis;PELĖDŽIUKAI;20862839950;Taip;7;4;0;11
7185;Papartis;PELĖDŽIUKAI;20907751423;Ne;0;4;0;4
7186;Papartis;PELĖDŽIUKAI;8564913801;Taip;12;5;0;17
7187;Papartis;PELĖDŽIUKAI;47876153590;Taip;6;4;0;10
7188;Papartis;PELĖDŽIUKAI;84260015363;Taip;0;5;0;5
7189;Papartis;PELĖDŽIUKAI;67226404925;Taip;6;4;5;15
7190;Papartis;PELĖDŽIUKAI;41330436046;Taip;0;4;0;4
7191;Papartis;PELĖDŽIUKAI;83927324420;Taip;0;4;1;5
7192;Papartis;PELĖDŽIUKAI;51857496843;Taip;5;4;0;9
7193;Papartis;PELĖDŽIUKAI;21840378271;Taip;0;3;0;3
7194;Papartis;PELĖDŽIUKAI;93141801552;Taip;10;4;0;14
7195;Papartis;PELĖDŽIUKAI;81006952163;Taip;9;4;0;13
7196;Papartis;PELĖDŽIUKAI;46076659264;Ne;5;4;0;9
7197;Papartis;PELĖDŽIUKAI;8593823543;Taip;10;4;0;14
7198;Papartis;PELĖDŽIUKAI;31606112621;Taip;0;4;0;4
7199;Papartis;PELĖDŽIUKAI;1727771667;Taip;9;4;0;13
7200;Papartis;PELĖDŽIUKAI;18164175829;Taip;7;4;1;12
7201;Papartis;PELĖDŽIUKAI;1045629158;Taip;0;4;1;5
7202;Papartis;PELĖDŽIUKAI;1903219436;Ne;2;4;0;6
7203;Papartis;PELĖDŽIUKAI;8958062862;Taip;8;4;1;13
7204;Papartis;SAULUTĖS;2022533158;Taip;3;0;1;4
7205;Papartis;SAULUTĖS;1246604915;Taip;0;6;3;9
7206;Papartis;SAULUTĖS;48182233276;Taip;0;5;0;5
7207;Papartis;SAULUTĖS;23218268605;Ne;5;0;1;6
7208;Papartis;SAULUTĖS;18124337938;Taip;16;1;0;17
7209;Papartis;SAULUTĖS;22443998204;Taip;12;4;0;16
7210;Papartis;SAULUTĖS;30982681803;Taip;0;6;0;6
7211;Papartis;SAULUTĖS;95139517078;Taip;0;10;0;10
7212;Papartis;SAULUTĖS;14978429821;Taip;0;5;3;8
7213;Papartis;SAULUTĖS;55573140983;Taip;7;2;0;9
7214;Papartis;SAULUTĖS;50090482473;Taip;10;4;0;14
7215;Papartis;SAULUTĖS;10078570352;Taip;6;5;1;12
7216;Papartis;SAULUTĖS;88700503601;Taip;6;4;1;11
7217;Papartis;SAULUTĖS;21963930874;Taip;2;1;0;3
7218;Papartis;SAULUTĖS;15207322802;Taip;10;4;0;14
7219;Papartis;SAULUTĖS;2115718328;Ne;0;0;11;11
7220;Papartis;SAULUTĖS;67966766974;Taip;0;5;0;5
7221;Papartis;SAULUTĖS;50658624766;Ne;2;1;3;6
7222;Papartis;SAULUTĖS;79080758672;Taip;0;11;0;11
7223;Papartis;GANDRIUKAI;4878190663;Taip;0;0;4;4
7224;Papartis;GANDRIUKAI;9900023788;Taip;15;0;0;15
7225;Papartis;GANDRIUKAI;2783708905;Taip;6;0;0;6
7226;Papartis;GANDRIUKAI;6883101103;Taip;15;0;0;15
7227;Papartis;GANDRIUKAI;2868899342;Taip;6;0;0;6
7228;Papartis;GANDRIUKAI;7768672610;Ne;6;0;0;6
7229;Papartis;GANDRIUKAI;9384670351;Taip;0;7;0;7
7230;Papartis;GANDRIUKAI;9968072478;Ne;6;1;0;7
7231;Papartis;GANDRIUKAI;2215846642;Taip;21;0;0;21
7232;Papartis;GANDRIUKAI;3320524073;Taip;6;2;1;9
7233;Papartis;GANDRIUKAI;9704930584;Taip;6;4;0;10
7234;Papartis;GANDRIUKAI;9804863902;Taip;4;0;2;6
7235;Papartis;GANDRIUKAI;9072635586;Taip;5;5;1;11
7236;Papartis;GANDRIUKAI;1974159967;Taip;0;1;0;1
7237;Papartis;GANDRIUKAI;5732853976;Taip;5;0;3;8
7238;Papartis;GANDRIUKAI;7859096984;Taip;0;7;0;7
7239;Papartis;GANDRIUKAI;1442806517;Taip;4;0;2;6
7240;Papartis;GANDRIUKAI;7252265838;Taip;15;1;0;16
7241;Papartis;GANDRIUKAI;4279580382;Taip;10;0;0;10
7242;Papartis;GANDRIUKAI;9978625382;Ne;21;0;0;21
7243;Papartis;AITVARELIAI;82454730189;Taip;5;5;3;13
7244;Papartis;AITVARELIAI;2398385967;Taip;0;5;1;6
7245;Papartis;AITVARELIAI;2889259605;Taip;0;0;3;3
7246;Papartis;AITVARELIAI;89525856173;Taip;0;8;0;8
7247;Papartis;AITVARELIAI;4216398263;Taip;9;6;2;17
7248;Papartis;AITVARELIAI;72182866449;Taip;0;5;1;6
7249;Papartis;AITVARELIAI;3287617252;Taip;0;6;0;6
7250;Papartis;AITVARELIAI;4823666725;Taip;0;5;0;5
7251;Papartis;AITVARELIAI;1406820323;Taip;0;13;0;13
7252;Papartis;AITVARELIAI;2092191603;Taip;0;5;0;5
7253;Papartis;AITVARELIAI;10659508171;Taip;6;1;3;10
7254;Papartis;AITVARELIAI;2067304804;Taip;3;3;0;6
7255;Papartis;AITVARELIAI;88418552221;Taip;16;1;0;17
7256;Papartis;AITVARELIAI;51899025231;Ne;0;5;0;5
7257;Papartis;AITVARELIAI;74972133115;Taip;14;0;1;15
7258;Papartis;AITVARELIAI;1322826573;Taip;0;7;1;8
7259;Papartis;AITVARELIAI;88722771438;Taip;7;2;1;10
7260;Papartis;AITVARELIAI;74734443304;Taip;0;8;2;10
7261;Papartis;AITVARELIAI;63087155760;Ne;13;1;0;14
7262;Papartis;AITVARELIAI;26193472997;Taip;1;2;4;7
7263;Papartis;AITVARELIAI;68478260102;Ne;3;4;0;7
7264;Papartis;SMALSUČIAI;6266095782;Taip;8;0;0;8
7265;Papartis;SMALSUČIAI;3054883426;Taip;5;0;0;5
7266;Papartis;SMALSUČIAI;1191546794;Taip;15;0;1;16
7267;Papartis;SMALSUČIAI;6073970691;Taip;21;0;0;21
7268;Papartis;SMALSUČIAI;8447326505;Taip;13;0;0;13
7269;Papartis;SMALSUČIAI;1919362027;Taip;8;0;0;8
7270;Papartis;SMALSUČIAI;9375751990;Taip;9;0;0;9
7271;Papartis;SMALSUČIAI;5786648402;Ne;7;5;1;13
7272;Papartis;SMALSUČIAI;5776038830;Taip;9;0;1;10
7273;Papartis;SMALSUČIAI;8808902528;Taip;4;4;0;8
7274;Papartis;SMALSUČIAI;5361925390;Taip;5;0;1;6
7275;Papartis;SMALSUČIAI;4906248064;Taip;12;0;0;12
7276;Papartis;SMALSUČIAI;4640068595;Taip;18;0;0;18
7277;Papartis;SMALSUČIAI;5579899922;Taip;10;0;0;10
7278;Papartis;"ŽIRNIUKAI ";44833872631;Ne;5;1;4;10
7279;Papartis;"ŽIRNIUKAI ";12406782910;Taip;0;11;0;11
7280;Papartis;"ŽIRNIUKAI ";1271303103;Taip;12;0;9;21
7281;Papartis;"ŽIRNIUKAI ";7845277151;Taip;0;1;0;1
7282;Papartis;"ŽIRNIUKAI ";30041894006;Taip;6;0;0;6
7283;Papartis;"ŽIRNIUKAI ";3630377970;Taip;6;4;6;16
7284;Papartis;"ŽIRNIUKAI ";38896771062;Taip;0;0;4;4
7285;Papartis;"ŽIRNIUKAI ";86735273559;Taip;0;5;1;6
7286;Papartis;"ŽIRNIUKAI ";29789530287;Taip;0;4;2;6
7287;Papartis;"ŽIRNIUKAI ";22570313128;Taip;4;4;3;11
7288;Papartis;"ŽIRNIUKAI ";51588027659;Taip;2;2;0;4
7289;Papartis;"ŽIRNIUKAI ";1703232380;Taip;7;8;4;19
7290;Papartis;"ŽIRNIUKAI ";64345875780;Ne;4;3;0;7
7291;Papartis;"ŽIRNIUKAI ";2598688561;Taip;9;0;1;10
7292;Papartis;"ŽIRNIUKAI ";53040207725;Taip;0;6;1;7
7293;Papartis;"ŽIRNIUKAI ";3991709974;Taip;0;5;0;5
7294;Papartis;"ŽIRNIUKAI ";3367009621;Taip;0;4;0;4
7295;Papartis;"ŽIRNIUKAI ";7102350653;Taip;0;4;0;4
7296;Papartis;"ŽIRNIUKAI ";3408756311;Taip;6;0;4;10
7297;Papartis;BORUŽĖLĖS;7018190169;Taip;4;0;0;4
7298;Papartis;BORUŽĖLĖS;4918854899;Taip;0;7;0;7
7299;Papartis;BORUŽĖLĖS;6889782462;Taip;9;4;0;13
7300;Papartis;BORUŽĖLĖS;5252947502;Taip;7;5;0;12
7301;Papartis;BORUŽĖLĖS;4261270064;Taip;7;0;0;7
7302;Papartis;BORUŽĖLĖS;6136213985;Taip;7;0;4;11
7303;Papartis;BORUŽĖLĖS;7107692314;Taip;7;0;4;11
7304;Papartis;BORUŽĖLĖS;5736456872;Taip;2;6;0;8
7305;Papartis;BORUŽĖLĖS;3040269026;Taip;2;6;0;8
7306;Papartis;BORUŽĖLĖS;8891856856;Taip;4;1;0;5
7307;Papartis;BORUŽĖLĖS;8532558577;Taip;18;3;0;21
7308;Papartis;BORUŽĖLĖS;1916222143;Taip;7;5;0;12
7309;Papartis;BORUŽĖLĖS;3100013570;Taip;0;4;0;4
7310;Papartis;BORUŽĖLĖS;6416605464;Taip;8;0;0;8
7311;Papartis;BORUŽĖLĖS;7803854703;Taip;8;4;0;12
7312;Papartis;VARPELIAI;6585372451;Taip;11;0;4;15
7313;Papartis;VARPELIAI;6977513472;Taip;6;0;0;6
7314;Papartis;VARPELIAI;5070767260;Taip;7;4;0;11
7315;Papartis;VARPELIAI;3595627659;Taip;12;4;0;16
7316;Papartis;VARPELIAI;1231594320;Taip;7;0;0;7
7317;Papartis;VARPELIAI;6734567714;Taip;7;0;0;7
7318;Papartis;VARPELIAI;4570512336;Taip;1;7;0;8
7319;Papartis;VARPELIAI;5538433120;Taip;5;0;0;5
7320;Papartis;VARPELIAI;7619963429;Taip;3;4;0;7
7321;Papartis;VARPELIAI;2669085057;Taip;15;6;0;21
7322;Papartis;VARPELIAI;3209491491;Taip;5;0;0;5
7323;Papartis;VARPELIAI;6931780900;Taip;5;0;0;5
7324;Papartis;VARPELIAI;6346776139;Taip;5;0;0;5
7325;Papartis;VARPELIAI;8420752169;Taip;0;0;10;10
7326;Papartis;VARPELIAI;3539507686;Taip;9;4;0;13
7327;Papartis;NYKŠTUKAI;5652769035;Taip;11;5;0;16
7328;Papartis;NYKŠTUKAI;5942160584;Taip;10;0;0;10
7329;Papartis;NYKŠTUKAI;9922091482;Ne;17;4;0;21
7330;Papartis;NYKŠTUKAI;1680412204;Taip;13;0;0;13
7331;Papartis;NYKŠTUKAI;6903057774;Ne;5;0;3;8
7332;Papartis;NYKŠTUKAI;9285319899;Taip;5;0;1;6
7333;Papartis;NYKŠTUKAI;9502229005;Taip;10;4;0;14
7334;Papartis;NYKŠTUKAI;6949120693;Taip;7;1;0;8
7335;Papartis;NYKŠTUKAI;6794076631;Taip;21;0;0;21
7336;Papartis;NYKŠTUKAI;5957889361;Taip;8;2;0;10
7337;Papartis;NYKŠTUKAI;5608868738;Ne;0;7;0;7
7338;Papartis;NYKŠTUKAI;4203241118;Taip;7;4;0;11
7339;Papartis;NYKŠTUKAI;4806652727;Taip;9;1;0;10
7340;Papartis;NYKŠTUKAI;9939850340;Taip;0;6;1;7
7341;Papartis;NYKŠTUKAI;3324647852;Taip;6;4;0;10
7342;Papartis;NYKŠTUKAI;5218101579;Taip;0;2;4;6
7343;Papartis;NYKŠTUKAI;6423401656;Taip;0;8;0;8
7344;Papartis;NYKŠTUKAI;8932290803;Taip;7;0;3;10
7345;Papartis;NYKŠTUKAI;5652560002;Taip;7;4;0;11
7346;Papartis;NYKŠTUKAI;1559196767;Taip;21;0;0;21
7347;Pasaka;Drugelių;19053961847;Ne;9;0;1;10
7348;Pasaka;Drugelių;60248064750;Taip;0;0;8;8
7349;Pasaka;Drugelių;18135410695;Taip;21;0;0;21
7350;Pasaka;Drugelių;1237568934;Taip;0;4;0;4
7351;Pasaka;Drugelių;37149227316;Taip;0;5;2;7
7352;Pasaka;Drugelių;57075224058;Taip;0;2;0;2
7353;Pasaka;Drugelių;66315088164;Ne;0;1;4;5
7354;Pasaka;Drugelių;2063660647;Taip;5;1;0;6
7355;Pasaka;Drugelių;44488699090;Taip;0;5;0;5
7356;Pasaka;Drugelių;5459272292;Taip;0;5;2;7
7357;Pasaka;Drugelių;93130495054;Taip;0;4;0;4
7358;Pasaka;Drugelių;27770796692;Taip;12;4;0;16
7359;Pasaka;Drugelių;53151161817;Taip;0;2;0;2
7360;Pasaka;Drugelių;55254934245;Taip;7;4;3;14
7361;Pasaka;Drugelių;91499940063;Taip;0;5;0;5
7362;Pasaka;Drugelių;40182594961;Taip;0;4;0;4
7363;Pasaka;Drugelių;2332865106;Taip;7;1;6;14
7364;Pasaka;Drugelių;6794437566;Taip;0;0;14;14
7365;Pasaka;Drugelių;5901704055;Ne;0;1;4;5
7366;Pasaka;Nykštukų;5665758011;Taip;0;1;0;1
7367;Pasaka;Nykštukų;8166051272;Taip;0;6;0;6
7368;Pasaka;Nykštukų;91546084785;Taip;0;8;3;11
7369;Pasaka;Nykštukų;7040953491;Taip;0;4;0;4
7370;Pasaka;Nykštukų;7546205285;Taip;7;9;0;16
7371;Pasaka;Nykštukų;5687494160;Taip;17;4;0;21
7372;Pasaka;Nykštukų;1333499160;Taip;0;1;0;1
7373;Pasaka;Nykštukų;3088081091;Ne;0;1;0;1
7374;Pasaka;Nykštukų;6893044575;Taip;0;2;1;3
7375;Pasaka;Nykštukų;4071643754;Taip;0;2;2;4
7376;Pasaka;Nykštukų;3151916774;Taip;0;1;0;1
7377;Pasaka;Nykštukų;4773893970;Taip;9;2;0;11
7378;Pasaka;Nykštukų;5438303030;Taip;10;1;0;11
7379;Pasaka;Nykštukų;1300996831;Ne;0;8;0;8
7380;Pasaka;Nykštukų;1313576071;Taip;7;0;0;7
7381;Pasaka;Nykštukų;7455544922;Ne;12;0;0;12
7382;Pasaka;Nykštukų;1630083619;Taip;4;0;0;4
7383;Pasaka;Nykštukų;7290184771;Taip;0;4;0;4
7384;Pasaka;Nykštukų;5027755073;Taip;0;4;0;4
7385;Pasaka;Nykštukų;2874308781;Taip;0;4;2;6
7386;Pasaka;Nykštukų;4082752808;Taip;21;0;0;21
7387;Pasaka;Montesori;31094198532;Taip;0;4;0;4
7388;Pasaka;Montesori;47000824102;Taip;0;4;1;5
7389;Pasaka;Montesori;42973327518;Taip;9;4;1;14
7390;Pasaka;Montesori;1450566193;Taip;0;0;2;2
7391;Pasaka;Montesori;31880975983;Taip;0;4;0;4
7392;Pasaka;Montesori;79583667868;Taip;0;4;0;4
7393;Pasaka;Montesori;90472847444;Taip;7;4;0;11
7394;Pasaka;Montesori;17311912868;Taip;5;4;0;9
7395;Pasaka;Montesori;69250064506;Taip;0;4;1;5
7396;Pasaka;Montesori;81598865451;Taip;0;0;1;1
7397;Pasaka;Montesori;1564467627;Taip;0;4;5;9
7398;Pasaka;Montesori;16974081144;Taip;0;4;0;4
7399;Pasaka;Montesori;1514381003;Taip;2;4;0;6
7400;Pasaka;Montesori;8996941733;Taip;7;0;0;7
7401;Pasaka;Montesori;4608655313;Ne;9;0;1;10
7402;Pasaka;Montesori;93994995081;Taip;12;4;0;16
7403;Pasaka;Montesori;1961712475;Taip;0;1;1;2
7404;Pasaka;Montesori;5812041166;Taip;0;0;1;1
7405;Pasaka;Montesori;4305485747;Ne;6;0;0;6
7406;Pasaka;Montesori;79460661793;Taip;2;4;3;9
7407;Pasaka;Montesori;8635400672;Taip;4;0;0;4
7408;Pasaka;Montesori;47140322803;Taip;14;0;0;14
7409;Pasaka;Montesori;7837662446;Taip;0;0;3;3
7410;Pasaka;Montesori;3047931231;Ne;0;0;9;9
7411;Pasaka;Montesori;71026394541;Taip;0;0;2;2
7412;Pasaka;Žirniukų;17931259433;Ne;3;5;0;8
7413;Pasaka;Žirniukų;9722435751;Taip;0;4;0;4
7414;Pasaka;Žirniukų;7648503006;Taip;4;0;6;10
7415;Pasaka;Žirniukų;2697014098;Taip;2;0;0;2
7416;Pasaka;Žirniukų;73703706115;Taip;0;4;0;4
7417;Pasaka;Žirniukų;2018620389;Taip;0;2;2;4
7418;Pasaka;Žirniukų;6441884677;Taip;5;6;0;11
7419;Pasaka;Žirniukų;5651452381;Taip;5;6;0;11
7420;Pasaka;Žirniukų;1720511696;Taip;18;0;0;18
7421;Pasaka;Žirniukų;1836826810;Ne;0;4;0;4
7422;Pasaka;Žirniukų;1826743229;Ne;0;8;0;8
7423;Pasaka;Žirniukų;9560190761;Ne;0;8;0;8
7424;Pasaka;Žirniukų;2788679885;Taip;10;4;0;14
7425;Pasaka;Žirniukų;1565873178;Ne;0;4;2;6
7426;Pasaka;Žirniukų;7445696309;Taip;5;4;0;9
7427;Pasaka;Žirniukų;2400455036;Ne;10;1;0;11
7428;Pasaka;Žirniukų;79170702319;Taip;8;0;2;10
7429;Pasaka;Žirniukų;5965121999;Taip;5;4;0;9
7430;Pasaka;Žirniukų;5973028582;Taip;5;4;0;9
7431;Pasaka;"Voveriukų ";15051078156;Taip;0;4;0;4
7432;Pasaka;"Voveriukų ";50319234551;Taip;0;0;12;12
7433;Pasaka;"Voveriukų ";15500820772;Taip;13;0;0;13
7434;Pasaka;"Voveriukų ";12951124853;Taip;3;4;1;8
7435;Pasaka;"Voveriukų ";53523660848;Taip;0;5;0;5
7436;Pasaka;"Voveriukų ";89376142045;Taip;5;4;0;9
7437;Pasaka;"Voveriukų ";1188769609;Taip;0;4;0;4
7438;Pasaka;"Voveriukų ";13944030346;Taip;0;4;0;4
7439;Pasaka;"Voveriukų ";52135673503;Taip;0;8;1;9
7440;Pasaka;"Voveriukų ";59491538033;Taip;0;6;3;9
7441;Pasaka;"Voveriukų ";20358771509;Taip;0;5;1;6
7442;Pasaka;"Voveriukų ";94514447596;Taip;2;4;0;6
7443;Pasaka;"Voveriukų ";35718732394;Taip;2;4;0;6
7444;Pasaka;"Voveriukų ";71316589358;Taip;0;0;4;4
7445;Pasaka;"Voveriukų ";61091610394;Taip;0;0;2;2
7446;Pasaka;"Voveriukų ";4344243194;Taip;5;5;0;10
7447;Pasaka;"Voveriukų ";8122815158;Ne;0;4;4;8
7448;Pasaka;"Voveriukų ";1719236931;Taip;0;2;8;10
7449;Pasaka;"Voveriukų ";1257775317;Taip;7;4;2;13
7450;Pasaka;"Voveriukų ";1268530885;Taip;7;0;3;10
7451;Pasaka;"VALDOFRO 12";7865658875;Taip;0;4;2;6
7452;Pasaka;"VALDOFRO 12";2141354232;Taip;0;4;1;5
7453;Pasaka;"VALDOFRO 12";4271029223;Taip;0;4;4;8
7454;Pasaka;"VALDOFRO 12";49627576872;Taip;2;4;0;6
7455;Pasaka;"VALDOFRO 12";75591036061;Taip;0;9;1;10
7456;Pasaka;"VALDOFRO 12";8042135600;Taip;4;4;0;8
7457;Pasaka;"VALDOFRO 12";20521208273;Taip;0;4;1;5
7458;Pasaka;"VALDOFRO 12";73057603223;Taip;0;4;0;4
7459;Pasaka;"VALDOFRO 12";95288167171;Taip;0;4;0;4
7460;Pasaka;"VALDOFRO 12";3367120837;Ne;0;4;5;9
7461;Pasaka;"VALDOFRO 12";7010681103;Taip;0;16;0;16
7462;Pasaka;"VALDOFRO 12";1155273197;Taip;0;7;0;7
7463;Pasaka;"VALDOFRO 12";56766427323;Ne;0;4;1;5
7464;Pasaka;"VALDOFRO 12";4680456848;Taip;0;4;3;7
7465;Pasaka;"VALDOFRO 12";5141156728;Taip;21;0;0;21
7466;Pasaka;"VALDOFRO 12";2268625523;Taip;9;0;1;10
7467;Pasaka;"VALDOFRO 12";3195380938;Taip;0;0;4;4
7468;Pasaka;"VALDOFRO 12";8976424908;Taip;0;4;1;5
7469;Pasaka;"VALDORFO 2";48295303497;Taip;7;5;0;12
7470;Pasaka;"VALDORFO 2";27035873367;Ne;0;11;0;11
7471;Pasaka;"VALDORFO 2";27496232796;Ne;5;4;0;9
7472;Pasaka;"VALDORFO 2";95494862542;Taip;0;5;4;9
7473;Pasaka;"VALDORFO 2";25283698668;Taip;0;4;0;4
7474;Pasaka;"VALDORFO 2";61077353229;Taip;8;4;0;12
7475;Pasaka;"VALDORFO 2";2077818693;Taip;5;5;0;10
7476;Pasaka;"VALDORFO 2";71365777764;Taip;2;5;2;9
7477;Pasaka;"VALDORFO 2";1741935840;Taip;21;0;0;21
7478;Pasaka;"VALDORFO 2";77904202630;Taip;0;5;0;5
7479;Pasaka;"VALDORFO 2";4752117533;Taip;0;10;0;10
7480;Pasaka;"VALDORFO 2";7432241898;Taip;0;5;1;6
7481;Pasaka;"VALDORFO 2";10616073718;Ne;4;0;4;8
7482;Pasaka;"VALDORFO 2";7950962252;Taip;7;4;2;13
7483;Pasaka;"VALDORFO 2";1480107348;Taip;7;4;2;13
7484;Pasaka;"VALDORFO 2";8590385693;Taip;2;0;4;6
7485;Pasaka;"VALDORFO 2";4620573687;Ne;0;11;0;11
7486;Pasaka;"VALDORFO 2";4825373152;Taip;5;4;0;9
7487;Pasaka;"VALDORFO 2";9462745431;Taip;2;0;4;6
7488;Pasaka;"VALDORFO 2";5399148997;Taip;7;5;0;12
7489;Pasaka;Gudručiai;8821776109;Taip;11;1;0;12
7490;Pasaka;Gudručiai;4895994309;Taip;0;0;6;6
7491;Pasaka;Gudručiai;62051806386;Taip;0;6;0;6
7492;Pasaka;Gudručiai;96080851386;Taip;0;2;0;2
7493;Pasaka;Gudručiai;76560015870;Taip;5;1;0;6
7494;Pasaka;Gudručiai;72878659455;Taip;0;7;0;7
7495;Pasaka;Gudručiai;78517147252;Taip;13;0;0;13
7496;Pasaka;Gudručiai;76899232405;Taip;0;4;0;4
7497;Pasaka;Gudručiai;45850914548;Ne;0;2;0;2
7498;Pasaka;Gudručiai;97012371435;Ne;0;3;0;3
7499;Pasaka;Gudručiai;52667398476;Taip;2;0;0;2
7500;Pasaka;Gudručiai;17537343699;Taip;2;6;0;8
7501;Pasaka;Gudručiai;1979028353;Taip;0;4;5;9
7502;Pasaka;Gudručiai;5265653044;Ne;18;0;0;18
7503;Pasaka;Gudručiai;1920564803;Ne;21;0;0;21
7504;Pasaka;Bitelių;8651165520;Taip;15;0;0;15
7505;Pasaka;Bitelių;8132829016;Taip;15;0;0;15
7506;Pasaka;Bitelių;5351364328;Taip;21;0;0;21
7507;Pasaka;Bitelių;4635912654;Taip;21;0;0;21
7508;Pasaka;Bitelių;4137222204;Taip;10;3;0;13
7509;Pasaka;Bitelių;7248640367;Taip;5;0;4;9
7510;Pasaka;Bitelių;8277245475;Taip;5;0;3;8
7511;Pasaka;Bitelių;7103485358;Taip;11;0;0;11
7512;Pasaka;Bitelių;6868519179;Taip;0;1;8;9
7513;Pasaka;Bitelių;6759415053;Taip;0;1;8;9
7514;Pasaka;Bitelių;5723970763;Taip;14;0;3;17
7515;Pasaka;Bitelių;9136521759;Taip;6;4;0;10
7516;Pasaka;Bitelių;7685589423;Taip;0;5;0;5
7517;Pasaka;Bitelių;9737445077;Taip;6;0;0;6
7518;Pasaka;Bitelių;2638182985;Taip;5;1;1;7
7519;Pasaka;Bitelių;2293613528;Taip;0;8;0;8
7520;Pasaka;Bitelių;3367346582;Taip;10;4;0;14
7521;Pasaka;Bitelių;3351338617;Taip;2;0;0;2
7522;Pasaka;Bitelių;5371046207;Taip;8;3;0;11
7523;Pasaka;Bitelių;1335408890;Ne;7;4;1;12
7524;Pasaka;"Pabiručių ";2854919649;Taip;5;0;1;6
7525;Pasaka;"Pabiručių ";7176272684;Taip;12;7;0;19
7526;Pasaka;"Pabiručių ";4466963221;Taip;6;0;0;6
7527;Pasaka;"Pabiručių ";9588247759;Ne;5;0;1;6
7528;Pasaka;"Pabiručių ";1950145441;Taip;0;4;0;4
7529;Pasaka;"Pabiručių ";3709664132;Taip;2;0;3;5
7530;Pasaka;"Pabiručių ";1512874567;Taip;0;4;4;8
7531;Pasaka;"Pabiručių ";3606141216;Taip;11;6;0;17
7532;Pasaka;"Pabiručių ";5217688848;Taip;11;6;0;17
7533;Pasaka;"Pabiručių ";3536862796;Taip;14;0;0;14
7534;Pasaka;"Pabiručių ";8899289832;Taip;14;0;0;14
7535;Pasaka;"Pabiručių ";4171004263;Taip;17;0;0;17
7536;Pasaka;"Pabiručių ";4915357646;Taip;9;0;0;9
7537;Pasaka;"Pabiručių ";1488711275;Taip;0;0;1;1
7538;Pasaka;"Pabiručių ";8504575043;Taip;5;5;0;10
7539;Pasaka;Šnekučių;31896116591;Taip;4;0;3;7
7540;Pasaka;Šnekučių;36716138833;Ne;6;1;0;7
7541;Pasaka;Šnekučių;49626651411;Taip;14;1;0;15
7542;Pasaka;Šnekučių;9549799936;Taip;4;7;0;11
7543;Pasaka;Šnekučių;34897359060;Taip;0;6;1;7
7544;Pasaka;Šnekučių;52912333520;Ne;0;1;7;8
7545;Pasaka;Šnekučių;8744626237;Ne;0;1;0;1
7546;Pasaka;Šnekučių;9973758979;Taip;0;0;3;3
7547;Pasaka;Šnekučių;1693530160;Taip;0;4;0;4
7548;Pasaka;Šnekučių;62303770229;Taip;0;0;4;4
7549;Pasaka;Šnekučių;23132755276;Taip;0;4;3;7
7550;Pasaka;Šnekučių;7082166681;Ne;8;0;0;8
7551;Pasaka;Šnekučių;8615661704;Ne;8;1;0;9
7552;Pasaka;Šnekučių;4178679491;Ne;8;2;0;10
7553;Pasaka;Šnekučių;56983167265;Taip;6;0;9;15
7554;Pasaka;Šnekučių;5021568651;Taip;0;4;0;4
7555;Pasaka;Šnekučių;50456063454;Taip;0;4;0;4
7556;Pasaka;Šnekučių;10055061537;Ne;6;1;5;12
7557;Pasaka;Šnekučių;51500606207;Taip;4;7;0;11
7558;Paslaptis;Priešmokyklinė;1259942408;Taip;0;1;3;4
7559;Paslaptis;Priešmokyklinė;36229769543;Taip;0;5;4;9
7560;Paslaptis;Priešmokyklinė;87862241593;Taip;0;13;8;21
7561;Paslaptis;Priešmokyklinė;1982955007;Ne;0;4;0;4
7562;Paslaptis;Priešmokyklinė;99228588629;Ne;0;1;2;3
7563;Paslaptis;Priešmokyklinė;57773958059;Taip;0;11;1;12
7564;Paslaptis;Priešmokyklinė;73547132372;Ne;0;1;0;1
7565;Paslaptis;Priešmokyklinė;1950287365;Taip;4;4;2;10
7566;Paslaptis;Priešmokyklinė;1094068061;Taip;0;2;0;2
7567;Paslaptis;Priešmokyklinė;1195616749;Taip;7;1;0;8
7568;Paslaptis;Priešmokyklinė;8522925854;Taip;0;3;10;13
7569;Paslaptis;Priešmokyklinė;1445974659;Taip;0;5;0;5
7570;Paslaptis;Priešmokyklinė;2578713065;Ne;0;5;0;5
7571;Paslaptis;Priešmokyklinė;1868248793;Taip;0;1;4;5
7572;Paslaptis;Priešmokyklinė;1938288335;Taip;0;3;0;3
7573;Paslaptis;Priešmokyklinė;1530380043;Taip;0;3;0;3
7574;Paslaptis;Priešmokyklinė;4674623065;Taip;0;2;0;2
7575;Paslaptis;Priešmokyklinė;4731417201;Taip;4;5;0;9
7576;Paslaptis;Priešmokyklinė;3461773781;Taip;0;4;9;13
7577;Paslaptis;Priešmokyklinė;6638769261;Ne;11;0;0;11
7578;Paslaptis;Priešmokyklinė;3798754778;Ne;4;6;0;10
7579;Paslaptis;"Darželio mišraus amžiaus grupė";6375966771;Taip;7;4;0;11
7580;Paslaptis;"Darželio mišraus amžiaus grupė";2474900044;Taip;0;0;1;1
7581;Paslaptis;"Darželio mišraus amžiaus grupė";3170216428;Taip;1;1;1;3
7582;Paslaptis;"Darželio mišraus amžiaus grupė";3093280943;Taip;0;4;0;4
7583;Paslaptis;"Darželio mišraus amžiaus grupė";9559318660;Taip;7;0;0;7
7584;Paslaptis;"Darželio mišraus amžiaus grupė";2705751628;Taip;0;0;2;2
7585;Paslaptis;"Darželio mišraus amžiaus grupė";8280740387;Taip;12;0;2;14
7586;Paslaptis;"Darželio mišraus amžiaus grupė";2891547963;Taip;0;1;1;2
7587;Paslaptis;"Darželio mišraus amžiaus grupė";3415869190;Taip;13;1;0;14
7588;Paslaptis;"Darželio mišraus amžiaus grupė";5557019619;Taip;0;1;0;1
7589;Paslaptis;"Darželio mišraus amžiaus grupė";1782398974;Taip;11;2;0;13
7590;Paslaptis;"Darželio mišraus amžiaus grupė";4109288950;Taip;0;3;0;3
7591;Paslaptis;"Darželio mišraus amžiaus grupė";8083478190;Taip;10;6;0;16
7592;Paslaptis;"Darželio mišraus amžiaus grupė";2089780119;Taip;6;13;0;19
7593;Paslaptis;"Darželio mišraus amžiaus grupė";1029321312;Taip;0;2;0;2
7594;Paslaptis;"Darželio mišraus amžiaus grupė";9941731250;Taip;8;3;0;11
7595;Paslaptis;"Darželio mišraus amžiaus grupė";6131831325;Taip;15;4;0;19
7596;Paslaptis;"Darželio mišraus amžiaus grupė";2879752620;Taip;0;11;0;11
7597;Paslaptis;"Darželio mišraus amžiaus grupė";3243226933;Taip;7;2;3;12
7598;Paslaptis;"Darželio mišraus amžiaus grupė";5852939221;Taip;8;1;0;9
7599;Paslaptis;"Darželio mišraus amžiaus grupė";2693910134;Taip;0;4;0;4
7600;Paslaptis;"Darželio mišraus amžiaus grupė";3104525540;Taip;7;0;0;7
7601;Paslaptis;"Darželio mišraus amžiaus grupė";8895770223;Ne;17;0;0;17
7602;Paslaptis;"Darželio mišraus amžiaus grupė";5206529350;Taip;7;9;0;16
7603;Paslaptis;"Darželio mišraus amžiaus grupė";8239855620;Taip;7;0;0;7
7604;Paslaptis;"Darželio mišraus amžiaus grupė";8146824196;Taip;0;1;0;1
7605;Paslaptis;"Darželio mišraus amžiaus grupė";3398729758;Taip;7;3;0;10
7606;Paslaptis;"Darželio mišraus amžiaus grupė";1033910097;Taip;6;0;0;6
7607;Paslaptis;"NAUJA (LOPŠELIS)";3984799090;Taip;0;2;3;5
7608;Paslaptis;"NAUJA (LOPŠELIS)";5406800599;Taip;16;0;0;16
7609;Paslaptis;"NAUJA (LOPŠELIS)";3624299098;Taip;0;0;4;4
7610;Paslaptis;"NAUJA (LOPŠELIS)";4810686225;Taip;6;1;0;7
7611;Paslaptis;"NAUJA (LOPŠELIS)";1754621741;Taip;21;0;0;21
7612;Paslaptis;"NAUJA (LOPŠELIS)";6098345982;Taip;0;0;2;2
7613;Paslaptis;"NAUJA (LOPŠELIS)";9066462355;Ne;16;0;0;16
7614;Paslaptis;"NAUJA (LOPŠELIS)";6686352764;Taip;17;0;0;17
7615;Paslaptis;"NAUJA (LOPŠELIS)";1557783684;Taip;13;1;0;14
7616;Paslaptis;"NAUJA (LOPŠELIS)";5646806136;Taip;4;1;0;5
7617;Paslaptis;"NAUJA (LOPŠELIS)";9540612585;Taip;5;5;0;10
7618;Paslaptis;"NAUJA (LOPŠELIS)";9100003209;Ne;0;4;0;4
7619;Paslaptis;"NAUJA (LOPŠELIS)";5456011928;Taip;7;3;0;10
7620;Paslaptis;"NAUJA (LOPŠELIS)";5756338103;Taip;0;1;0;1
7621;Paslaptis;"NAUJA (LOPŠELIS)";5886364670;Taip;0;0;3;3
7622;Paslaptis;"NAUJA (LOPŠELIS)";3844066232;Taip;0;5;4;9
7623;Paslaptis;"NAUJA (LOPŠELIS)";2675089401;Taip;0;1;1;2
7624;Paslaptis;"NAUJA (LOPŠELIS)";4130010071;Taip;7;2;0;9
7625;Paslaptis;"NAUJA (LOPŠELIS)";4591318991;Taip;11;0;0;11
7626;Pasakaitė;Vieversėlių;7685647972;Taip;0;3;1;4
7627;Pasakaitė;Vieversėlių;6459145539;Taip;2;0;9;11
7628;Pasakaitė;Vieversėlių;2194313054;Taip;0;6;0;6
7629;Pasakaitė;Vieversėlių;9587489514;Taip;2;0;3;5
7630;Pasakaitė;Vieversėlių;3444442287;Taip;7;0;1;8
7631;Pasakaitė;Vieversėlių;5485965486;Taip;4;0;0;4
7632;Pasakaitė;Vieversėlių;2563725297;Taip;3;2;0;5
7633;Pasakaitė;Vieversėlių;2849753418;Taip;0;4;2;6
7634;Pasakaitė;Vieversėlių;8043493934;Taip;0;4;1;5
7635;Pasakaitė;Vieversėlių;7963057831;Taip;0;5;0;5
7636;Pasakaitė;Vieversėlių;9543991684;Taip;4;4;0;8
7637;Pasakaitė;Vieversėlių;7020773169;Taip;8;0;7;15
7638;Pasakaitė;Vieversėlių;3680596008;Taip;5;0;1;6
7639;Pasakaitė;Vieversėlių;4882856664;Taip;11;0;0;11
7640;Pasakaitė;Vieversėlių;5953162958;Taip;7;0;0;7
7641;Pasakaitė;Vieversėlių;5948958906;Taip;0;1;9;10
7642;Pasakaitė;Vieversėlių;1060914693;Taip;13;0;0;13
7643;Pasakaitė;Vieversėlių;7761162338;Taip;5;6;0;11
7644;Pasakaitė;Vieversėlių;8463220257;Taip;7;0;1;8
7645;Pasakaitė;Vieversėlių;9018830962;Taip;6;0;1;7
7646;Pasakaitė;Spindulėlių;8638071584;Ne;0;4;0;4
7647;Pasakaitė;Spindulėlių;99890448836;Taip;0;4;0;4
7648;Pasakaitė;Spindulėlių;4680949976;Taip;5;3;0;8
7649;Pasakaitė;Spindulėlių;3734935229;Ne;5;6;0;11
7650;Pasakaitė;Spindulėlių;2523842161;Taip;9;0;0;9
7651;Pasakaitė;Spindulėlių;4267488049;Taip;0;4;1;5
7652;Pasakaitė;Spindulėlių;1523034176;Taip;0;4;1;5
7653;Pasakaitė;Spindulėlių;7152349570;Taip;0;14;0;14
7654;Pasakaitė;Spindulėlių;1220619991;Taip;8;0;0;8
7655;Pasakaitė;Spindulėlių;7526264241;Taip;0;0;2;2
7656;Pasakaitė;Spindulėlių;3606601644;Taip;0;3;1;4
7657;Pasakaitė;Spindulėlių;3541877287;Taip;5;0;1;6
7658;Pasakaitė;Spindulėlių;5628746801;Taip;0;2;0;2
7659;Pasakaitė;Spindulėlių;3579498202;Taip;0;7;0;7
7660;Pasakaitė;Spindulėlių;3231283338;Taip;0;4;1;5
7661;Pasakaitė;Spindulėlių;7790937149;Taip;9;0;0;9
7662;Pasakaitė;Spindulėlių;5313360864;Ne;2;0;2;4
7663;Pasakaitė;Spindulėlių;3400305768;Taip;4;0;0;4
7664;Pasakaitė;Spindulėlių;6568538767;Ne;2;8;0;10
7665;Pasakaitė;Pasagėlių;3165658822;Taip;0;13;0;13
7666;Pasakaitė;Pasagėlių;61230317080;Ne;0;8;0;8
7667;Pasakaitė;Pasagėlių;1740419218;Taip;0;14;0;14
7668;Pasakaitė;Pasagėlių;5378855541;Taip;0;10;0;10
7669;Pasakaitė;Pasagėlių;9680682204;Taip;10;0;0;10
7670;Pasakaitė;Pasagėlių;8466086339;Taip;0;4;0;4
7671;Pasakaitė;Pasagėlių;4959175420;Taip;0;6;0;6
7672;Pasakaitė;Pasagėlių;3259688782;Taip;0;0;1;1
7673;Pasakaitė;Pasagėlių;1144813356;Taip;5;0;0;5
7674;Pasakaitė;Pasagėlių;83018133588;Ne;0;0;5;5
7675;Pasakaitė;Pasagėlių;4013900094;Taip;9;0;3;12
7676;Pasakaitė;Pasagėlių;5605619860;Ne;0;0;2;2
7677;Pasakaitė;Pasagėlių;1791015854;Taip;7;4;0;11
7678;Pasakaitė;Pasagėlių;39853246609;Taip;0;3;0;3
7679;Pasakaitė;Pasagėlių;4591161640;Ne;0;0;1;1
7680;Pasakaitė;Pasagėlių;1707428977;Taip;7;4;0;11
7681;Pasakaitė;Pasagėlių;5467179333;Taip;0;4;0;4
7682;Pasakaitė;Švyturėlių;24096031951;Taip;0;4;2;6
7683;Pasakaitė;Švyturėlių;11001677712;Taip;0;4;4;8
7684;Pasakaitė;Švyturėlių;9914689534;Taip;0;4;3;7
7685;Pasakaitė;Švyturėlių;75785125455;Taip;0;0;4;4
7686;Pasakaitė;Švyturėlių;88077831193;Taip;4;0;1;5
7687;Pasakaitė;Švyturėlių;8225188274;Ne;0;8;0;8
7688;Pasakaitė;Švyturėlių;73957497029;Taip;7;0;2;9
7689;Pasakaitė;Švyturėlių;1070409611;Taip;0;4;3;7
7690;Pasakaitė;Švyturėlių;2331486690;Taip;21;0;0;21
7691;Pasakaitė;Švyturėlių;8469043564;Taip;6;0;3;9
7692;Pasakaitė;Švyturėlių;5436985035;Ne;0;12;1;13
7693;Pasakaitė;Švyturėlių;4008826950;Taip;4;8;0;12
7694;Pasakaitė;Švyturėlių;2721048424;Taip;0;4;1;5
7695;Pasakaitė;Švyturėlių;1513903341;Taip;15;0;0;15
7696;Pasakaitė;Švyturėlių;8578521969;Taip;8;0;1;9
7697;Pasakaitė;Švyturėlių;8390366303;Ne;5;4;1;10
7698;Pasakaitė;Švyturėlių;3778906698;Taip;0;0;1;1
7699;Pasakaitė;Švyturėlių;1278198989;Taip;16;0;0;16
7700;Pasakaitė;Švyturėlių;1940545723;Ne;0;8;0;8
7701;Pasakaitė;Kodėlčiukų;82138492327;Taip;0;8;0;8
7702;Pasakaitė;Kodėlčiukų;94317654094;Taip;0;4;3;7
7703;Pasakaitė;Kodėlčiukų;1121139222;Ne;0;2;1;3
7704;Pasakaitė;Kodėlčiukų;2017823264;Taip;0;3;0;3
7705;Pasakaitė;Kodėlčiukų;72093762601;Taip;0;4;0;4
7706;Pasakaitė;Kodėlčiukų;11006810461;Taip;12;4;0;16
7707;Pasakaitė;Kodėlčiukų;1553678838;Taip;12;4;1;17
7708;Pasakaitė;Kodėlčiukų;92762645558;Taip;0;4;1;5
7709;Pasakaitė;Kodėlčiukų;1854100959;Taip;0;5;1;6
7710;Pasakaitė;Kodėlčiukų;93907096625;Taip;0;4;0;4
7711;Pasakaitė;Kodėlčiukų;4974486850;Ne;10;6;0;16
7712;Pasakaitė;Kodėlčiukų;9746401498;Ne;10;6;0;16
7713;Pasakaitė;Kodėlčiukų;6839399035;Ne;9;0;3;12
7714;Pasakaitė;Kodėlčiukų;99352468512;Taip;0;13;0;13
7715;Pasakaitė;Kodėlčiukų;1809383469;Taip;4;9;0;13
7716;Pasakaitė;Kodėlčiukų;2742595829;Taip;0;0;1;1
7717;Pasakaitė;Kodėlčiukų;1592521766;Taip;0;0;1;1
7718;Pasakaitė;Kodėlčiukų;9506178305;Taip;2;0;14;16
7719;Pasakaitė;Kodėlčiukų;4583679144;Taip;0;4;1;5
7720;Pasakaitė;Gudručių;70802215290;Taip;0;11;0;11
7721;Pasakaitė;Gudručių;48421643700;Taip;2;5;0;7
7722;Pasakaitė;Gudručių;6909280007;Taip;0;4;0;4
7723;Pasakaitė;Gudručių;82272856075;Taip;0;9;0;9
7724;Pasakaitė;Gudručių;1537944476;Taip;5;4;1;10
7725;Pasakaitė;Gudručių;1631919806;Ne;0;4;5;9
7726;Pasakaitė;Gudručių;1696228992;Ne;0;4;5;9
7727;Pasakaitė;Gudručių;41359431347;Taip;9;4;0;13
7728;Pasakaitė;Gudručių;18419655194;Taip;0;11;0;11
7729;Pasakaitė;Gudručių;1917342472;Ne;5;2;0;7
7730;Pasakaitė;Gudručių;91751201397;Taip;3;4;1;8
7731;Pasakaitė;Gudručių;23103636206;Taip;8;5;0;13
7732;Pasakaitė;Gudručių;94906317709;Taip;5;4;0;9
7733;Pasakaitė;Gudručių;47661428412;Taip;2;11;0;13
7734;Pasakaitė;Gudručių;35147041377;Taip;0;6;2;8
7735;Pasakaitė;Gudručių;725988513;Taip;0;9;0;9
7736;Pasakaitė;Gudručių;91109909258;Taip;0;4;1;5
7737;Pasakaitė;Gudručių;39926553926;Taip;0;4;2;6
7738;Pasakaitė;Gudručių;1139554564;Taip;10;7;0;17
7739;Pasakaitė;Gudručių;1627102470;Taip;0;1;0;1
7740;Pasakaitė;Čiulbonėlių;19151459055;Taip;0;1;0;1
7741;Pasakaitė;Čiulbonėlių;24235494284;Taip;0;3;0;3
7742;Pasakaitė;Čiulbonėlių;39762990812;Taip;2;4;3;9
7743;Pasakaitė;Čiulbonėlių;30460033968;Taip;0;13;0;13
7744;Pasakaitė;Čiulbonėlių;32235101944;Taip;5;1;0;6
7745;Pasakaitė;Čiulbonėlių;1159523006;Taip;2;4;8;14
7746;Pasakaitė;Čiulbonėlių;83737263199;Taip;0;4;4;8
7747;Pasakaitė;Čiulbonėlių;26826144324;Taip;0;4;0;4
7748;Pasakaitė;Čiulbonėlių;74338375162;Taip;2;9;2;13
7749;Pasakaitė;Čiulbonėlių;26485770641;Taip;0;2;2;4
7750;Pasakaitė;Čiulbonėlių;72232008007;Taip;12;4;0;16
7751;Pasakaitė;Čiulbonėlių;21872672491;Taip;0;4;2;6
7752;Pasakaitė;Čiulbonėlių;21284070194;Taip;0;5;0;5
7753;Pasakaitė;Čiulbonėlių;13787417933;Ne;7;4;1;12
7754;Pasakaitė;Čiulbonėlių;45451715428;Taip;1;4;0;5
7755;Pasakaitė;Čiulbonėlių;20667371334;Taip;0;4;14;18
7756;Pasakaitė;Čiulbonėlių;52127092749;Taip;0;4;0;4
7757;Pasakaitė;Čiulbonėlių;15644259897;Taip;0;4;1;5
7758;Pasakaitė;Čiulbonėlių;88951595986;Ne;0;4;1;5
7759;Pasakaitė;Čiulbonėlių;1381307997;Taip;5;8;0;13
7760;Pasakaitė;"Verpstelių ";12092268542;Taip;0;8;0;8
7761;Pasakaitė;"Verpstelių ";62677241195;Taip;0;4;0;4
7762;Pasakaitė;"Verpstelių ";600641021;Taip;0;6;0;6
7763;Pasakaitė;"Verpstelių ";26031226748;Taip;0;0;1;1
7764;Pasakaitė;"Verpstelių ";1407277414;Ne;5;0;3;8
7765;Pasakaitė;"Verpstelių ";17218793370;Taip;5;5;0;10
7766;Pasakaitė;"Verpstelių ";33418184802;Ne;3;0;0;3
7767;Pasakaitė;"Verpstelių ";46873849992;Taip;0;6;0;6
7768;Pasakaitė;"Verpstelių ";96648719544;Taip;10;7;0;17
7769;Pasakaitė;"Verpstelių ";82475369612;Taip;1;5;0;6
7770;Pasakaitė;"Verpstelių ";51040024089;Taip;4;0;1;5
7771;Pasakaitė;"Verpstelių ";88885227604;Taip;0;11;0;11
7772;Pasakaitė;"Verpstelių ";5954676615;Taip;0;4;2;6
7773;Pasakaitė;"Verpstelių ";1270179754;Taip;0;4;1;5
7774;Pasakaitė;"Verpstelių ";2210519019;Taip;4;0;3;7
7775;Pasakaitė;"Verpstelių ";18105216772;Taip;0;6;0;6
7776;Pasakaitė;"Verpstelių ";50537059387;Taip;0;0;4;4
7777;Pasakaitė;"Verpstelių ";29699532850;Taip;9;10;0;19
7778;Pasakaitė;"Verpstelių ";46074425530;Taip;4;7;0;11
7779;Pasakaitė;"Verpstelių ";45157801238;Taip;0;4;0;4
7780;Pasakaitė;Smalsučiai;7451624229;Taip;4;0;0;4
7781;Pasakaitė;Smalsučiai;6847782430;Taip;0;19;0;19
7782;Pasakaitė;Smalsučiai;5556362727;Taip;0;14;0;14
7783;Pasakaitė;Smalsučiai;7759051761;Taip;5;0;0;5
7784;Pasakaitė;Smalsučiai;2404448954;Taip;7;0;1;8
7785;Pasakaitė;Smalsučiai;4728731352;Taip;12;0;0;12
7786;Pasakaitė;Smalsučiai;3710143250;Taip;0;4;0;4
7787;Pasakaitė;Smalsučiai;7621306769;Taip;0;6;0;6
7788;Pasakaitė;Smalsučiai;1744216870;Taip;1;7;3;11
7789;Pasakaitė;Smalsučiai;1533259056;Ne;4;2;1;7
7790;Pasakaitė;Smalsučiai;1425166722;Taip;0;0;3;3
7791;Pasakaitė;Smalsučiai;8315840473;Taip;4;0;0;4
7792;Pasakaitė;Smalsučiai;9821617981;Taip;7;0;1;8
7793;Pasakaitė;"Čiauškučiai ";6714500298;Ne;5;0;0;5
7794;Pasakaitė;"Čiauškučiai ";1962693480;Taip;6;0;0;6
7795;Pasakaitė;"Čiauškučiai ";1963102227;Taip;5;0;2;7
7796;Pasakaitė;"Čiauškučiai ";4758073190;Taip;13;0;1;14
7797;Pasakaitė;"Čiauškučiai ";7813221735;Taip;9;0;3;12
7798;Pasakaitė;"Čiauškučiai ";4864779439;Taip;0;5;2;7
7799;Pasakaitė;"Čiauškučiai ";4246461594;Taip;4;0;12;16
7800;Pasakaitė;"Čiauškučiai ";5617173998;Taip;0;4;2;6
7801;Pasakaitė;"Čiauškučiai ";8267725352;Taip;9;1;0;10
7802;Pasakaitė;"Čiauškučiai ";1184513606;Taip;0;0;1;1
7803;Pasakaitė;"Čiauškučiai ";9166649594;Taip;7;1;1;9
7804;Pasakaitė;"Čiauškučiai ";2751828639;Taip;0;0;1;1
7805;Pasakaitė;"Čiauškučiai ";8223662339;Taip;12;0;1;13
7806;Pasakaitė;"Čiauškučiai ";6858356868;Taip;5;9;0;14
7807;Pasakaitė;Pabiručiai;1827070201;Taip;5;1;2;8
7808;Pasakaitė;Pabiručiai;9175612991;Taip;10;0;1;11
7809;Pasakaitė;Pabiručiai;26714845001;Taip;2;0;1;3
7810;Pasakaitė;Pabiručiai;46891856500;Taip;5;3;0;8
7811;Pasakaitė;Pabiručiai;3397132786;Ne;0;10;0;10
7812;Pasakaitė;Pabiručiai;1769070351;Taip;0;4;0;4
7813;Pasakaitė;Pabiručiai;49117693773;Taip;7;5;0;12
7814;Pasakaitė;Pabiručiai;1320898756;Taip;7;4;5;16
7815;Pasakaitė;Pabiručiai;1027136050;Taip;6;0;1;7
7816;Pasakaitė;Pabiručiai;1198248619;Taip;0;6;0;6
7817;Pasakaitė;Pabiručiai;1032113089;Taip;0;3;0;3
7818;Pasakaitė;Pabiručiai;21252086256;Taip;18;0;0;18
7819;Pasakaitė;Pabiručiai;6134483994;Taip;0;5;0;5
7820;Pasakaitė;Pabiručiai;1673576868;Taip;0;13;0;13
7821;Pasakaitė;Pabiručiai;2017275984;Taip;4;0;0;4
7822;Pasakaitė;Pabiručiai;27702516199;Taip;0;0;5;5
7823;Pasakaitė;Pabiručiai;6346678827;Ne;0;0;18;18
7824;Pelenė;Varpelis;93009343319;Taip;4;0;0;4
7825;Pelenė;Varpelis;25108428891;Taip;4;4;0;8
7826;Pelenė;Varpelis;59795549508;Taip;0;5;0;5
7827;Pelenė;Varpelis;83359560510;Taip;7;5;0;12
7828;Pelenė;Varpelis;70335326964;Taip;0;8;0;8
7829;Pelenė;Varpelis;75264382003;Taip;0;0;1;1
7830;Pelenė;Varpelis;3245982902;Taip;3;4;1;8
7831;Pelenė;Varpelis;534670514;Taip;5;0;0;5
7832;Pelenė;Varpelis;32716320977;Taip;0;5;0;5
7833;Pelenė;Varpelis;1733433768;Ne;3;4;3;10
7834;Pelenė;Varpelis;40968963343;Taip;0;4;0;4
7835;Pelenė;Varpelis;29587640966;Taip;0;7;0;7
7836;Pelenė;Varpelis;55350714718;Taip;0;2;0;2
7837;Pelenė;Varpelis;120966603;Taip;12;4;0;16
7838;Pelenė;Varpelis;30625065081;Taip;0;4;1;5
7839;Pelenė;Varpelis;33408520827;Taip;3;0;0;3
7840;Pelenė;Varpelis;62615483649;Taip;8;4;1;13
7841;Pelenė;Varpelis;35657264407;Ne;0;1;1;2
7842;Pelenė;Varpelis;12400151337;Taip;8;4;0;12
7843;Pelenė;Saulutės;99849461351;Taip;0;2;0;2
7844;Pelenė;Saulutės;93982153559;Taip;8;2;0;10
7845;Pelenė;Saulutės;93692312117;Taip;0;8;0;8
7846;Pelenė;Saulutės;12170216844;Taip;0;4;0;4
7847;Pelenė;Saulutės;1321060587;Taip;0;4;5;9
7848;Pelenė;Saulutės;11671895181;Taip;0;1;0;1
7849;Pelenė;Saulutės;72216942887;Taip;2;0;0;2
7850;Pelenė;Saulutės;55937499558;Taip;4;4;1;9
7851;Pelenė;Saulutės;96121315210;Ne;4;1;0;5
7852;Pelenė;Saulutės;1289416312;Taip;0;4;0;4
7853;Pelenė;Saulutės;29900302904;Taip;0;0;1;1
7854;Pelenė;Saulutės;59244146880;Taip;2;0;0;2
7855;Pelenė;Saulutės;96840961754;Taip;0;4;0;4
7856;Pelenė;Saulutės;52690820;Taip;0;4;0;4
7857;Pelenė;Saulutės;78648474464;Ne;2;4;0;6
7858;Pelenė;Saulutės;4178071578;Taip;0;2;0;2
7859;Pelenė;Saulutės;8813044848;Taip;2;8;0;10
7860;Pelenė;Saulutės;1807037374;Taip;10;0;0;10
7861;Pelenė;Saulutės;6559830470;Taip;0;4;0;4
7862;Pelenė;Saulutės;6937587856;Taip;0;2;0;2
7863;Pelenė;Raktelis;3465518545;Taip;4;0;0;4
7864;Pelenė;Raktelis;4386060612;Ne;2;0;8;10
7865;Pelenė;Raktelis;1568123491;Taip;0;4;0;4
7866;Pelenė;Raktelis;14200374671;Taip;2;4;1;7
7867;Pelenė;Raktelis;1418000665;Taip;4;0;5;9
7868;Pelenė;Raktelis;1127657620;Taip;0;14;0;14
7869;Pelenė;Raktelis;42431378466;Taip;0;4;8;12
7870;Pelenė;Raktelis;17572291941;Taip;0;5;0;5
7871;Pelenė;Raktelis;1183026351;Taip;7;0;2;9
7872;Pelenė;Raktelis;2072863178;Taip;6;1;0;7
7873;Pelenė;Raktelis;1050272821;Taip;0;6;0;6
7874;Pelenė;Raktelis;51979406888;Taip;7;0;0;7
7875;Pelenė;Raktelis;89920419797;Taip;3;4;0;7
7876;Pelenė;Raktelis;45589326259;Ne;5;0;0;5
7877;Pelenė;Raktelis;26010775076;Taip;0;8;0;8
7878;Pelenė;Raktelis;1483843416;Taip;20;0;0;20
7879;Pelenė;Raktelis;2677995903;Ne;0;0;2;2
7880;Pelenė;Raktelis;6289619123;Taip;0;4;0;4
7881;Pelenė;Žvaigždutės;8404317146;Taip;0;4;0;4
7882;Pelenė;Žvaigždutės;8466974910;Taip;0;0;1;1
7883;Pelenė;Žvaigždutės;1336431888;Taip;8;0;0;8
7884;Pelenė;Žvaigždutės;1114786936;Taip;4;7;0;11
7885;Pelenė;Žvaigždutės;1140030742;Taip;10;1;0;11
7886;Pelenė;Žvaigždutės;3497915398;Taip;0;5;0;5
7887;Pelenė;Žvaigždutės;2154553741;Taip;0;5;0;5
7888;Pelenė;Žvaigždutės;8598498275;Taip;0;16;0;16
7889;Pelenė;Žvaigždutės;39705461573;Ne;0;13;0;13
7890;Pelenė;Žvaigždutės;3131930907;Taip;12;0;0;12
7891;Pelenė;Žvaigždutės;5804848640;Taip;0;0;2;2
7892;Pelenė;Žvaigždutės;1710249888;Taip;0;3;0;3
7893;Pelenė;Žvaigždutės;33009702783;Taip;0;1;1;2
7894;Pelenė;Žvaigždutės;61012202440;Taip;0;8;0;8
7895;Pelenė;Žvaigždutės;45410683361;Taip;0;4;1;5
7896;Pelenė;Žvaigždutės;62484999314;Taip;2;7;2;11
7897;Pelenė;Žvaigždutės;5081903157;Taip;0;7;0;7
7898;Pelenė;Nykštukas;9621197758;Taip;12;0;0;12
7899;Pelenė;Nykštukas;7144616734;Ne;4;3;0;7
7900;Pelenė;Nykštukas;3296147024;Taip;20;0;0;20
7901;Pelenė;Nykštukas;3189305906;Taip;5;1;0;6
7902;Pelenė;Nykštukas;8607110629;Taip;3;7;0;10
7903;Pelenė;Nykštukas;9584503078;Taip;0;2;0;2
7904;Pelenė;Nykštukas;8770771520;Taip;0;0;1;1
7905;Pelenė;Nykštukas;10457480694;Taip;4;0;0;4
7906;Pelenė;Nykštukas;6181604926;Ne;0;5;0;5
7907;Pelenė;Nykštukas;1750366978;Taip;12;0;3;15
7908;Pelenė;Nykštukas;2092775878;Taip;0;12;0;12
7909;Pelenė;Nykštukas;8675348688;Ne;6;0;2;8
7910;Pelenė;Nykštukas;7254981715;Ne;2;9;0;11
7911;Pelenė;Nykštukas;7836778389;Taip;3;1;0;4
7912;Pelenė;Nykštukas;8721423900;Taip;8;2;0;10
7913;Pelenė;Nykštukas;6579504852;Taip;10;0;2;12
7914;Pelenė;Nykštukas;6021833025;Taip;0;11;0;11
7915;Pelenė;Nykštukas;1978481168;Taip;0;4;0;4
7916;Pelenė;Nykštukas;3596386480;Taip;0;8;0;8
7917;Pelenė;Nykštukas;7205437280;Taip;5;2;0;7
7918;Pelenė;Nykštukas;3385568839;Taip;0;12;0;12
7919;Pelenė;Nykštukas;7589978427;Taip;0;8;0;8
7920;Pelenė;Žirniukai;4315677064;Taip;0;0;3;3
7921;Pelenė;Žirniukai;4624325473;Taip;0;4;0;4
7922;Pelenė;Žirniukai;1775717256;Ne;14;4;0;18
7923;Pelenė;Žirniukai;6632188229;Taip;0;14;0;14
7924;Pelenė;Žirniukai;5356756237;Ne;4;5;0;9
7925;Pelenė;Žirniukai;7587887488;Taip;0;5;0;5
7926;Pelenė;Žirniukai;6191899254;Taip;3;0;4;7
7927;Pelenė;Žirniukai;2737277656;Taip;11;4;0;15
7928;Pelenė;Žirniukai;6481466282;Taip;0;3;1;4
7929;Pelenė;Žirniukai;5389865440;Ne;0;4;0;4
7930;Pelenė;Žirniukai;1902314385;Taip;0;4;3;7
7931;Pelenė;Žirniukai;6707167720;Taip;12;4;0;16
7932;Pelenė;Žirniukai;9009271610;Taip;0;13;0;13
7933;Pelenė;Žirniukai;5325176433;Taip;0;7;0;7
7934;Pelenė;Žirniukai;9186679454;Taip;0;5;0;5
7935;Pelenė;Žirniukai;8414727016;Taip;17;0;0;17
7936;Pelenė;Žirniukai;6221703608;Taip;8;0;1;9
7937;Pelenė;Lašeliai;4591637887;Taip;15;0;1;16
7938;Pelenė;Lašeliai;1067737206;Taip;8;6;0;14
7939;Pelenė;Lašeliai;6038229659;Taip;0;6;0;6
7940;Pelenė;Lašeliai;4090532624;Ne;9;0;2;11
7941;Pelenė;Lašeliai;9075193730;Ne;14;0;0;14
7942;Pelenė;Lašeliai;6419661741;Taip;6;0;1;7
7943;Pelenė;Lašeliai;8123162647;Taip;0;9;0;9
7944;Pelenė;Lašeliai;4366940539;Taip;3;10;0;13
7945;Pelenė;Lašeliai;7114993398;Ne;7;0;0;7
7946;Pelenė;Lašeliai;7659625628;Taip;6;0;2;8
7947;Pelenė;Lašeliai;2210314952;Taip;9;0;0;9
7948;Pelenė;Lašeliai;9063588699;Taip;0;8;0;8
7949;Pelenė;Lašeliai;7088493729;Taip;8;0;1;9
7950;Pelenė;Lašeliai;3573543545;Taip;7;4;0;11
7951;Pelenė;Lašeliai;4089199552;Taip;11;0;1;12
7952;Pelenė;Lašeliai;4541391191;Taip;10;0;0;10
7953;Pelenė;Lašeliai;9195113444;Taip;0;15;0;15
7954;Pelenė;Lašeliai;7880284433;Taip;4;6;1;11
7955;Pelenė;Lašeliai;3238807604;Ne;0;5;2;7
7956;Pelenė;Lašeliai;6375060159;Taip;8;9;0;17
7957;Pelenė;Lašeliai;5063098703;Taip;8;6;0;14
7958;Pelenė;Lašeliai;5780697554;Taip;0;5;0;5
7959;Pelenė;Grūdelis;34209230034;Taip;0;1;2;3
7960;Pelenė;Grūdelis;55160554683;Taip;2;0;0;2
7961;Pelenė;Grūdelis;1283843474;Taip;1;0;0;1
7962;Pelenė;Grūdelis;66474157416;Taip;2;4;0;6
7963;Pelenė;Grūdelis;77504082241;Taip;0;14;0;14
7964;Pelenė;Grūdelis;1599336930;Taip;9;4;0;13
7965;Pelenė;Grūdelis;93234992958;Taip;1;3;0;4
7966;Pelenė;Grūdelis;2393068606;Taip;0;1;0;1
7967;Pelenė;Grūdelis;62544766703;Taip;0;5;0;5
7968;Pelenė;Grūdelis;43686344645;Ne;0;6;0;6
7969;Pelenė;Grūdelis;1157718969;Taip;0;4;0;4
7970;Pelenė;Grūdelis;39850314417;Taip;0;4;0;4
7971;Pelenė;Grūdelis;71274664713;Taip;0;3;0;3
7972;Pelenė;Grūdelis;1542958753;Taip;3;4;3;10
7973;Pelenė;Grūdelis;1516249890;Taip;0;7;0;7
7974;Pelenė;Grūdelis;1846536895;Taip;0;12;0;12
7975;Pelenė;Grūdelis;1045206373;Taip;0;9;0;9
7976;Pelenė;Braškytė;8038559319;Taip;11;0;0;11
7977;Pelenė;Braškytė;6864263698;Taip;18;0;0;18
7978;Pelenė;Braškytė;9447223913;Taip;5;0;1;6
7979;Pelenė;Braškytė;4004975235;Taip;20;0;0;20
7980;Pelenė;Braškytė;8790613872;Taip;20;0;0;20
7981;Pelenė;Braškytė;2647876561;Taip;3;0;0;3
7982;Pelenė;Braškytė;8194354176;Taip;7;1;0;8
7983;Pelenė;Braškytė;8239650471;Taip;8;0;0;8
7984;Pelenė;Braškytė;5228983908;Taip;4;0;2;6
7985;Pelenė;Braškytė;3174009848;Taip;14;4;0;18
7986;Pelenė;Braškytė;6524101295;Taip;7;4;0;11
7987;Pelenė;Braškytė;4376033711;Taip;8;6;0;14
7988;Pelenė;Braškytė;6894978459;Taip;9;0;0;9
7989;Pelenė;Braškytė;4321705575;Taip;0;7;0;7
7990;Pelenė;Braškytė;2103177773;Taip;1;0;2;3
7991;Pelenė;Braškytė;1632490481;Taip;13;0;0;13
7992;Pelenė;Boružėlės;5031778158;Taip;0;9;0;9
7993;Pelenė;Boružėlės;9218868317;Taip;7;3;0;10
7994;Pelenė;Boružėlės;2163737781;Taip;0;4;0;4
7995;Pelenė;Boružėlės;7565331966;Taip;7;0;6;13
7996;Pelenė;Boružėlės;9810123679;Taip;0;8;0;8
7997;Pelenė;Boružėlės;1048899958;Taip;20;0;0;20
7998;Pelenė;Boružėlės;4056676361;Taip;5;5;0;10
7999;Pelenė;Boružėlės;1278011268;Taip;0;3;0;3
8000;Pelenė;Boružėlės;2540405047;Taip;2;0;5;7
8001;Pelenė;Boružėlės;6469409776;Taip;20;0;0;20
8002;Pelenė;Boružėlės;4870187198;Taip;11;1;0;12
8003;Pelenė;Boružėlės;1274729537;Taip;2;4;2;8
8004;Pelenė;Boružėlės;3205331614;Taip;2;4;0;6
8005;Pelenė;Boružėlės;2322908067;Taip;0;20;0;20
8006;Pelenė;Boružėlės;5084452088;Taip;0;15;0;15
8007;Pelenė;Boružėlės;5074054534;Taip;0;6;0;6
8008;Pelenė;Boružėlės;2476080951;Taip;14;0;0;14
8009;Pelenė;Saldainiukai;2040256240;Taip;15;0;0;15
8010;Pelenė;Saldainiukai;8623480143;Ne;4;0;1;5
8011;Pelenė;Saldainiukai;3662919521;Taip;20;0;0;20
8012;Pelenė;Saldainiukai;4856039707;Taip;17;0;0;17
8013;Pelenė;Saldainiukai;2765650058;Taip;20;0;0;20
8014;Pelenė;Saldainiukai;8841183816;Taip;4;0;0;4
8015;Pelenė;Saldainiukai;4695104609;Taip;10;3;0;13
8016;Pelenė;Saldainiukai;1852964349;Taip;7;0;0;7
8017;Pelenė;Saldainiukai;7578318198;Ne;7;11;0;18
8018;Pelenė;Saldainiukai;4102147352;Taip;4;0;0;4
8019;Pelenė;Saldainiukai;1080017906;Taip;2;0;0;2
8020;Pelenė;Saldainiukai;7714061272;Taip;5;3;0;8
8021;Pipiras;EŽIUKAI;12489971559;Taip;0;2;0;2
8022;Pipiras;EŽIUKAI;56241147614;Taip;0;5;0;5
8023;Pipiras;EŽIUKAI;1112327896;Taip;3;6;0;9
8024;Pipiras;EŽIUKAI;52968399382;Taip;0;6;0;6
8025;Pipiras;EŽIUKAI;76685499613;Taip;0;4;0;4
8026;Pipiras;EŽIUKAI;24414917430;Taip;0;10;0;10
8027;Pipiras;EŽIUKAI;71881026465;Taip;2;4;0;6
8028;Pipiras;EŽIUKAI;32958963027;Taip;5;6;0;11
8029;Pipiras;EŽIUKAI;95904922548;Taip;0;14;0;14
8030;Pipiras;EŽIUKAI;55466909230;Taip;0;2;2;4
8031;Pipiras;EŽIUKAI;53468621826;Taip;0;4;0;4
8032;Pipiras;EŽIUKAI;9858798452;Taip;0;5;0;5
8033;Pipiras;EŽIUKAI;1213972436;Taip;0;3;0;3
8034;Pipiras;EŽIUKAI;4564046164;Ne;0;9;0;9
8035;Pipiras;EŽIUKAI;35225328018;Ne;4;1;0;5
8036;Pipiras;EŽIUKAI;1129409620;Taip;0;5;2;7
8037;Pipiras;EŽIUKAI;1061415778;Taip;0;4;5;9
8038;Pipiras;EŽIUKAI;1095731795;Taip;21;0;0;21
8039;Pipiras;EŽIUKAI;24106575180;Ne;0;12;3;15
8040;Pipiras;EŽIUKAI;2874546969;Taip;0;10;0;10
8041;Pipiras;BITUTĖS;3554786173;Taip;7;4;0;11
8042;Pipiras;BITUTĖS;5725956659;Taip;16;0;0;16
8043;Pipiras;BITUTĖS;7934365114;Ne;15;0;0;15
8044;Pipiras;BITUTĖS;2075041950;Taip;12;4;0;16
8045;Pipiras;BITUTĖS;9840040112;Taip;17;0;0;17
8046;Pipiras;BITUTĖS;3852848863;Taip;9;0;0;9
8047;Pipiras;BITUTĖS;5235868332;Taip;16;0;0;16
8048;Pipiras;BITUTĖS;7350131214;Taip;18;0;0;18
8049;Pipiras;BITUTĖS;7161727352;Taip;13;0;0;13
8050;Pipiras;BITUTĖS;5225533488;Taip;0;1;0;1
8051;Pipiras;BITUTĖS;5622119207;Taip;0;4;0;4
8052;Pipiras;BITUTĖS;6792777396;Taip;0;5;0;5
8053;Pipiras;BITUTĖS;1784839485;Taip;0;8;0;8
8054;Pipiras;BITUTĖS;3775916247;Taip;7;0;0;7
8055;Pipiras;BITUTĖS;5845498558;Taip;13;5;0;18
8056;Pipiras;BITUTĖS;4177166475;Taip;0;11;0;11
8057;Pipiras;BITUTĖS;3882437376;Taip;5;0;0;5
8058;Pipiras;BITUTĖS;9770780973;Taip;2;17;0;19
8059;Pipiras;NYKŠTUKAI;1045583136;Taip;21;0;0;21
8060;Pipiras;NYKŠTUKAI;4811029230;Taip;8;1;0;9
8061;Pipiras;NYKŠTUKAI;8895028305;Taip;5;6;0;11
8062;Pipiras;NYKŠTUKAI;8140314304;Taip;0;3;0;3
8063;Pipiras;NYKŠTUKAI;6791495556;Taip;0;2;0;2
8064;Pipiras;NYKŠTUKAI;5422547144;Taip;19;0;0;19
8065;Pipiras;NYKŠTUKAI;6363349541;Taip;0;4;0;4
8066;Pipiras;NYKŠTUKAI;6340323302;Taip;0;13;0;13
8067;Pipiras;NYKŠTUKAI;4266424785;Taip;0;6;0;6
8068;Pipiras;NYKŠTUKAI;6748400056;Taip;0;11;0;11
8069;Pipiras;NYKŠTUKAI;2315614501;Taip;10;0;0;10
8070;Pipiras;NYKŠTUKAI;1242260242;Taip;0;1;0;1
8071;Pipiras;NYKŠTUKAI;6685567970;Taip;11;1;0;12
8072;Pipiras;NYKŠTUKAI;8520454289;Taip;0;5;0;5
8073;Pipiras;NYKŠTUKAI;4426479971;Taip;0;4;0;4
8074;Pipiras;NYKŠTUKAI;2267192782;Taip;7;7;0;14
8075;Pipiras;NYKŠTUKAI;3421769229;Taip;10;0;0;10
8076;Pipiras;NYKŠTUKAI;5445858240;Taip;0;10;0;10
8077;Pipiras;NYKŠTUKAI;4725221169;Taip;21;0;0;21
8078;Pipiras;PELĖDŽIUKAI;4428216634;Taip;7;0;0;7
8079;Pipiras;PELĖDŽIUKAI;6694920607;Taip;14;0;0;14
8080;Pipiras;PELĖDŽIUKAI;3325511140;Taip;4;6;0;10
8081;Pipiras;PELĖDŽIUKAI;3341850450;Taip;2;0;1;3
8082;Pipiras;PELĖDŽIUKAI;7870521230;Taip;5;6;0;11
8083;Pipiras;PELĖDŽIUKAI;5778300856;Taip;0;4;0;4
8084;Pipiras;PELĖDŽIUKAI;3888552150;Taip;0;1;0;1
8085;Pipiras;PELĖDŽIUKAI;7026118693;Taip;0;5;0;5
8086;Pipiras;PELĖDŽIUKAI;1391682850;Taip;0;4;0;4
8087;Pipiras;PELĖDŽIUKAI;87924002679;Taip;11;2;0;13
8088;Pipiras;PELĖDŽIUKAI;6136423200;Taip;9;0;0;9
8089;Pipiras;PELĖDŽIUKAI;6805620664;Taip;9;0;2;11
8090;Pipiras;PELĖDŽIUKAI;7912217889;Ne;11;0;0;11
8091;Pipiras;PELĖDŽIUKAI;5502001191;Taip;0;7;0;7
8092;Pipiras;PELĖDŽIUKAI;9275905384;Taip;7;0;0;7
8093;Pipiras;PELĖDŽIUKAI;4496076326;Taip;0;0;3;3
8094;Pipiras;PELĖDŽIUKAI;3141822820;Taip;0;11;0;11
8095;Pipiras;PELĖDŽIUKAI;2044498561;Taip;7;0;0;7
8096;Pipiras;PELĖDŽIUKAI;2240865490;Taip;3;0;0;3
8097;Pipiras;PELĖDŽIUKAI;3357866319;Ne;12;0;0;12
8098;Pipiras;DRUGELIAI;41585818819;Taip;3;13;0;16
8099;Pipiras;DRUGELIAI;5577759167;Taip;2;6;0;8
8100;Pipiras;DRUGELIAI;7799786844;Ne;8;7;0;15
8101;Pipiras;DRUGELIAI;5014457985;Ne;13;0;0;13
8102;Pipiras;DRUGELIAI;4927845000;Ne;5;1;0;6
8103;Pipiras;DRUGELIAI;1904376366;Taip;0;13;0;13
8104;Pipiras;DRUGELIAI;1128674099;Taip;0;2;0;2
8105;Pipiras;DRUGELIAI;3422170541;Taip;0;4;0;4
8106;Pipiras;DRUGELIAI;1391958633;Taip;9;1;3;13
8107;Pipiras;DRUGELIAI;7784343130;Taip;5;0;0;5
8108;Pipiras;DRUGELIAI;3622164823;Taip;0;11;0;11
8109;Pipiras;DRUGELIAI;3008358842;Taip;10;9;0;19
8110;Pipiras;DRUGELIAI;2024777430;Taip;7;7;0;14
8111;Pipiras;DRUGELIAI;4959823035;Taip;0;3;0;3
8112;Pipiras;DRUGELIAI;6339186940;Taip;0;7;0;7
8113;Pipiras;DRUGELIAI;3314276870;Taip;6;8;0;14
8114;Pipiras;DRUGELIAI;5637557921;Taip;0;9;0;9
8115;Pipiras;DRUGELIAI;1050430252;Ne;7;1;0;8
8116;Pipiras;DRUGELIAI;2914156353;Taip;21;0;0;21
8117;Pipiras;GĖLYTĖS;56325056631;Taip;0;2;0;2
8118;Pipiras;GĖLYTĖS;48059975861;Taip;2;0;1;3
8119;Pipiras;GĖLYTĖS;81335131932;Taip;7;1;0;8
8120;Pipiras;GĖLYTĖS;23377947863;Taip;0;15;0;15
8121;Pipiras;GĖLYTĖS;87831792882;Taip;0;9;0;9
8122;Pipiras;GĖLYTĖS;1417855241;Taip;0;6;0;6
8123;Pipiras;GĖLYTĖS;1791226869;Taip;21;0;0;21
8124;Pipiras;GĖLYTĖS;1077104941;Taip;0;4;0;4
8125;Pipiras;GĖLYTĖS;60652954862;Taip;0;4;0;4
8126;Pipiras;GĖLYTĖS;27808576289;Taip;0;4;0;4
8127;Pipiras;GĖLYTĖS;5114553619;Taip;0;8;0;8
8128;Pipiras;GĖLYTĖS;1780531222;Taip;0;8;0;8
8129;Pipiras;GĖLYTĖS;18211174874;Taip;0;8;0;8
8130;Pipiras;GĖLYTĖS;4246712256;Taip;12;5;0;17
8131;Pipiras;GĖLYTĖS;25000181631;Taip;7;0;0;7
8132;Pipiras;GĖLYTĖS;2473644942;Taip;0;9;0;9
8133;Pipiras;GĖLYTĖS;1650661825;Taip;0;1;0;1
8134;Pipiras;GĖLYTĖS;56822466210;Taip;2;5;0;7
8135;Pipiras;GĖLYTĖS;23663823688;Taip;7;9;0;16
8136;Pipiras;GĖLYTĖS;6481320053;Ne;0;4;0;4
8137;Pipiras;BORUŽĖLĖS;54633757340;Taip;4;0;0;4
8138;Pipiras;BORUŽĖLĖS;68636458010;Taip;0;6;2;8
8139;Pipiras;BORUŽĖLĖS;31533878253;Taip;0;3;0;3
8140;Pipiras;BORUŽĖLĖS;20456702162;Taip;11;0;0;11
8141;Pipiras;BORUŽĖLĖS;57459408180;Taip;0;12;0;12
8142;Pipiras;BORUŽĖLĖS;7354253729;Ne;0;2;0;2
8143;Pipiras;BORUŽĖLĖS;99551392640;Taip;0;4;0;4
8144;Pipiras;BORUŽĖLĖS;9423015002;Taip;0;12;0;12
8145;Pipiras;BORUŽĖLĖS;68235713574;Taip;0;5;0;5
8146;Pipiras;BORUŽĖLĖS;63605758339;Taip;0;13;0;13
8147;Pipiras;BORUŽĖLĖS;23794561369;Taip;3;9;0;12
8148;Pipiras;BORUŽĖLĖS;46165404909;Taip;0;9;0;9
8149;Pipiras;BORUŽĖLĖS;92764472620;Taip;0;8;0;8
8150;Pipiras;BORUŽĖLĖS;6804964469;Taip;10;0;1;11
8151;Pipiras;BORUŽĖLĖS;81817710888;Taip;0;8;4;12
8152;Pipiras;BORUŽĖLĖS;7448924569;Taip;0;6;0;6
8153;Pipiras;BORUŽĖLĖS;1676986127;Taip;3;1;0;4
8154;Pipiras;BORUŽĖLĖS;1334584865;Taip;6;2;0;8
8155;Pipiras;BORUŽĖLĖS;9673674008;Taip;0;0;1;1
8156;Pipiras;BORUŽĖLĖS;1657721144;Taip;2;5;0;7
8157;Pipiras;BORUŽĖLĖS;6766596656;Taip;0;10;1;11
8158;Pipiras;SKRUZDĖLIUKAI;1975780209;Taip;0;5;2;7
8159;Pipiras;SKRUZDĖLIUKAI;50739918812;Ne;0;5;0;5
8160;Pipiras;SKRUZDĖLIUKAI;75153377410;Taip;0;7;0;7
8161;Pipiras;SKRUZDĖLIUKAI;53426269440;Taip;0;1;0;1
8162;Pipiras;SKRUZDĖLIUKAI;7196519583;Taip;5;5;0;10
8163;Pipiras;SKRUZDĖLIUKAI;53180156021;Taip;0;2;1;3
8164;Pipiras;SKRUZDĖLIUKAI;96711811784;Taip;0;13;0;13
8165;Pipiras;SKRUZDĖLIUKAI;85339674885;Taip;5;7;0;12
8166;Pipiras;SKRUZDĖLIUKAI;61166497338;Taip;0;6;0;6
8167;Pipiras;SKRUZDĖLIUKAI;90202583208;Taip;0;5;0;5
8168;Pipiras;SKRUZDĖLIUKAI;84791674090;Ne;6;6;0;12
8169;Pipiras;SKRUZDĖLIUKAI;49361002482;Taip;0;3;0;3
8170;Pipiras;SKRUZDĖLIUKAI;53377928276;Taip;0;5;0;5
8171;Pipiras;SKRUZDĖLIUKAI;57731282074;Taip;0;5;0;5
8172;Pipiras;SKRUZDĖLIUKAI;1450882528;Taip;8;4;0;12
8173;Pipiras;SKRUZDĖLIUKAI;65132324180;Taip;0;4;0;4
8174;Pipiras;SKRUZDĖLIUKAI;71790101454;Taip;0;5;0;5
8175;Pipiras;SKRUZDĖLIUKAI;73564428514;Ne;0;19;0;19
8176;Pipiras;ŽVIRBLIUKŲ;70940029154;Taip;0;10;0;10
8177;Pipiras;ŽVIRBLIUKŲ;1232620336;Taip;0;11;0;11
8178;Pipiras;ŽVIRBLIUKŲ;1549121029;Ne;1;7;0;8
8179;Pipiras;ŽVIRBLIUKŲ;37087220885;Taip;0;2;0;2
8180;Pipiras;ŽVIRBLIUKŲ;1700856741;Taip;5;5;0;10
8181;Pipiras;ŽVIRBLIUKŲ;1319863476;Ne;0;6;0;6
8182;Pipiras;ŽVIRBLIUKŲ;1757192919;Taip;0;10;0;10
8183;Pipiras;ŽVIRBLIUKŲ;1417086043;Taip;0;14;0;14
8184;Pipiras;ŽVIRBLIUKŲ;1441590033;Taip;5;3;0;8
8185;Pipiras;ŽVIRBLIUKŲ;1008228932;Taip;0;6;0;6
8186;Pipiras;ŽVIRBLIUKŲ;2030665851;Taip;4;6;0;10
8187;Pipiras;ŽVIRBLIUKŲ;1182415963;Taip;0;14;0;14
8188;Pipiras;ŽVIRBLIUKŲ;8657924258;Taip;0;7;0;7
8189;Pipiras;ŽVIRBLIUKŲ;10750695428;Taip;0;11;0;11
8190;Pipiras;ŽVIRBLIUKŲ;66816368717;Ne;0;6;0;6
8191;Pipiras;ŽVIRBLIUKŲ;22190236403;Ne;0;8;0;8
8192;Pipiras;ŽVIRBLIUKŲ;2402351134;Taip;7;5;0;12
8193;Pipiras;ZUIKUČIŲ;2016718354;Taip;0;6;4;10
8194;Pipiras;ZUIKUČIŲ;4017042461;Taip;0;6;0;6
8195;Pipiras;ZUIKUČIŲ;5141447649;Taip;1;3;0;4
8196;Pipiras;ZUIKUČIŲ;5908707752;Taip;7;10;0;17
8197;Pipiras;ZUIKUČIŲ;8422419380;Taip;15;0;0;15
8198;Pipiras;ZUIKUČIŲ;9892201598;Taip;0;4;0;4
8199;Pipiras;ZUIKUČIŲ;6775489564;Taip;0;9;4;13
8200;Pipiras;ZUIKUČIŲ;9499869533;Taip;0;1;0;1
8201;Pipiras;ZUIKUČIŲ;3980950261;Taip;12;4;0;16
8202;Pipiras;ZUIKUČIŲ;6696824728;Ne;2;4;0;6
8203;Pipiras;ZUIKUČIŲ;9372109848;Taip;8;1;0;9
8204;Pipiras;ZUIKUČIŲ;6310054093;Taip;0;4;0;4
8205;Pipiras;ZUIKUČIŲ;5137132420;Ne;21;0;0;21
8206;Pipiras;ZUIKUČIŲ;1019753152;Taip;0;3;0;3
8207;Pipiras;VARLIUKŲ;6810906239;Taip;20;0;0;20
8208;Pipiras;VARLIUKŲ;3465024013;Taip;20;0;0;20
8209;Pipiras;VARLIUKŲ;5214984111;Taip;6;4;0;10
8210;Pipiras;VARLIUKŲ;7969837759;Taip;0;19;0;19
8211;Pipiras;VARLIUKŲ;9625933545;Taip;2;1;0;3
8212;Pipiras;VARLIUKŲ;8819018248;Taip;0;11;0;11
8213;Pipiras;VARLIUKŲ;5888429623;Taip;5;2;0;7
8214;Pipiras;VARLIUKŲ;3768825314;Taip;13;0;0;13
8215;Pipiras;VARLIUKŲ;2296702730;Taip;11;5;0;16
8216;Pipiras;VARLIUKŲ;4510888337;Taip;16;0;0;16
8217;Pipiras;VARLIUKŲ;1711168196;Taip;13;1;0;14
8218;Pipiras;VARLIUKŲ;9968182443;Taip;7;0;0;7
8219;Pipiras;VARLIUKŲ;4309096743;Taip;10;0;1;11
8220;Pipiras;VARLIUKŲ;2483867901;Taip;2;1;0;3
8221;Pipiras;VARLIUKŲ;8296425777;Taip;7;2;0;9
8222;Pipiras;VARLIUKŲ;1315372873;Taip;7;2;0;9
8223;Pipiras;ŽIOGELIŲ;2096009051;Taip;0;19;0;19
8224;Pipiras;ŽIOGELIŲ;71283505646;Ne;8;2;0;10
8225;Pipiras;ŽIOGELIŲ;1485565125;Taip;12;0;0;12
8226;Pipiras;ŽIOGELIŲ;2061168407;Taip;0;9;0;9
8227;Pipiras;ŽIOGELIŲ;2030170020;Ne;2;10;0;12
8228;Pipiras;ŽIOGELIŲ;2637950013;Taip;21;0;0;21
8229;Pipiras;ŽIOGELIŲ;3652741639;Taip;21;0;0;21
8230;Pipiras;ŽIOGELIŲ;1658491279;Taip;0;6;0;6
8231;Pipiras;ŽIOGELIŲ;1082396096;Taip;5;3;0;8
8232;Pipiras;ŽIOGELIŲ;1371141047;Taip;5;2;0;7
8233;Pipiras;ŽIOGELIŲ;1420510354;Taip;0;5;0;5
8234;Pipiras;ŽIOGELIŲ;1293250996;Taip;8;1;0;9
8235;Pipiras;ŽIOGELIŲ;1751427121;Taip;0;10;0;10
8236;Pipiras;ŽIOGELIŲ;1114377378;Taip;0;8;0;8
8237;Pipiras;ŽIOGELIŲ;1694848410;Taip;0;4;0;4
8238;Pipiras;ŽIOGELIŲ;8088285579;Ne;10;7;0;17
8239;"Prie pasakų parko";ZUIKUČIAI;7776961789;Taip;0;10;0;10
8240;"Prie pasakų parko";ZUIKUČIAI;6963058612;Taip;17;0;1;18
8241;"Prie pasakų parko";ZUIKUČIAI;8451877584;Taip;9;0;0;9
8242;"Prie pasakų parko";ZUIKUČIAI;7858530013;Taip;5;7;0;12
8243;"Prie pasakų parko";ZUIKUČIAI;1558093905;Taip;5;5;0;10
8244;"Prie pasakų parko";ZUIKUČIAI;1738732866;Taip;12;1;0;13
8245;"Prie pasakų parko";ZUIKUČIAI;7320049068;Taip;18;0;0;18
8246;"Prie pasakų parko";ZUIKUČIAI;6606867989;Taip;9;0;0;9
8247;"Prie pasakų parko";ZUIKUČIAI;9750688419;Taip;0;12;0;12
8248;"Prie pasakų parko";ZUIKUČIAI;3120671593;Taip;5;0;0;5
8249;"Prie pasakų parko";ZUIKUČIAI;5901884512;Taip;13;0;0;13
8250;"Prie pasakų parko";ZUIKUČIAI;2641473764;Taip;12;0;0;12
8251;"Prie pasakų parko";ZUIKUČIAI;2217627240;Ne;11;0;0;11
8252;"Prie pasakų parko";PAUKŠČIUKŲ;7548653053;Taip;2;3;0;5
8253;"Prie pasakų parko";PAUKŠČIUKŲ;2168919559;Taip;0;3;0;3
8254;"Prie pasakų parko";PAUKŠČIUKŲ;8899375521;Ne;21;0;0;21
8255;"Prie pasakų parko";PAUKŠČIUKŲ;5186675623;Taip;7;0;2;9
8256;"Prie pasakų parko";PAUKŠČIUKŲ;6710735721;Taip;21;0;0;21
8257;"Prie pasakų parko";PAUKŠČIUKŲ;8715851643;Taip;8;9;0;17
8258;"Prie pasakų parko";PAUKŠČIUKŲ;1228384088;Ne;4;0;0;4
8259;"Prie pasakų parko";PAUKŠČIUKŲ;9476448601;Taip;2;0;1;3
8260;"Prie pasakų parko";PAUKŠČIUKŲ;6446562388;Taip;0;5;0;5
8261;"Prie pasakų parko";PAUKŠČIUKŲ;1445359221;Ne;3;0;1;4
8262;"Prie pasakų parko";PAUKŠČIUKŲ;6561145380;Taip;10;0;0;10
8263;"Prie pasakų parko";PAUKŠČIUKŲ;2160081492;Taip;0;5;0;5
8264;"Prie pasakų parko";PAUKŠČIUKŲ;3795705735;Taip;0;10;0;10
8265;"Prie pasakų parko";"LINKSMOJI ŠEIMYNĖLĖ (SPEC)";1598526615;Taip;4;0;6;10
8266;"Prie pasakų parko";"LINKSMOJI ŠEIMYNĖLĖ (SPEC)";4908579339;Taip;0;9;4;13
8267;"Prie pasakų parko";"LINKSMOJI ŠEIMYNĖLĖ (SPEC)";1508800551;Taip;15;4;2;21
8268;"Prie pasakų parko";"LINKSMOJI ŠEIMYNĖLĖ (SPEC)";1730134670;Ne;15;0;1;16
8269;"Prie pasakų parko";"LINKSMOJI ŠEIMYNĖLĖ (SPEC)";1658448860;Taip;0;7;0;7
8270;"Prie pasakų parko";"LINKSMOJI ŠEIMYNĖLĖ (SPEC)";78012776060;Taip;17;0;0;17
8271;"Prie pasakų parko";NYKŠTUKŲ;6992830082;Taip;5;0;0;5
8272;"Prie pasakų parko";NYKŠTUKŲ;1588062393;Taip;18;0;0;18
8273;"Prie pasakų parko";NYKŠTUKŲ;1278065349;Taip;6;3;1;10
8274;"Prie pasakų parko";NYKŠTUKŲ;2781262009;Taip;0;2;1;3
8275;"Prie pasakų parko";NYKŠTUKŲ;3356307067;Ne;7;0;2;9
8276;"Prie pasakų parko";NYKŠTUKŲ;8574432191;Taip;3;0;0;3
8277;"Prie pasakų parko";NYKŠTUKŲ;4181676762;Taip;0;1;0;1
8278;"Prie pasakų parko";NYKŠTUKŲ;8318567916;Taip;7;1;0;8
8279;"Prie pasakų parko";NYKŠTUKŲ;5982019255;Ne;8;4;0;12
8280;"Prie pasakų parko";NYKŠTUKŲ;2160440145;Taip;11;0;0;11
8281;"Prie pasakų parko";NYKŠTUKŲ;8189217660;Taip;11;6;0;17
8282;"Prie pasakų parko";NYKŠTUKŲ;8215830508;Ne;3;10;0;13
8283;"Prie pasakų parko";NYKŠTUKŲ;2216634402;Taip;12;0;5;17
8284;"Prie pasakų parko";NYKŠTUKŲ;5862570666;Taip;7;0;1;8
8285;"Prie pasakų parko";NYKŠTUKŲ;4548803933;Taip;0;7;0;7
8286;"Prie pasakų parko";NYKŠTUKŲ;4443834766;Taip;7;0;1;8
8287;"Prie pasakų parko";NYKŠTUKŲ;9926991259;Taip;8;5;0;13
8288;"Prie pasakų parko";NYKŠTUKŲ;5304082676;Taip;10;4;0;14
8289;"Prie pasakų parko";NYKŠTUKŲ;6250610187;Taip;9;2;0;11
8290;"Prie pasakų parko";LAŠELIŲ;1410161486;Ne;0;4;1;5
8291;"Prie pasakų parko";LAŠELIŲ;79438946697;Taip;0;4;7;11
8292;"Prie pasakų parko";LAŠELIŲ;72936036464;Taip;7;4;0;11
8293;"Prie pasakų parko";LAŠELIŲ;21605684303;Taip;4;0;1;5
8294;"Prie pasakų parko";LAŠELIŲ;6577763037;Taip;2;0;0;2
8295;"Prie pasakų parko";LAŠELIŲ;70510594589;Taip;6;0;1;7
8296;"Prie pasakų parko";LAŠELIŲ;9511739352;Taip;0;4;1;5
8297;"Prie pasakų parko";LAŠELIŲ;9384410578;Taip;0;1;1;2
8298;"Prie pasakų parko";LAŠELIŲ;2241142980;Taip;12;0;0;12
8299;"Prie pasakų parko";"KAČIUKAI (SPEC)";8949507250;Taip;8;0;0;8
8300;"Prie pasakų parko";"KAČIUKAI (SPEC)";1057427744;Ne;0;2;1;3
8301;"Prie pasakų parko";"KAČIUKAI (SPEC)";2058795331;Taip;3;0;0;3
8302;"Prie pasakų parko";"KAČIUKAI (SPEC)";1783727978;Taip;9;0;2;11
8303;"Prie pasakų parko";"KAČIUKAI (SPEC)";3397410463;Ne;15;0;1;16
8304;"Prie pasakų parko";"KAČIUKAI (SPEC)";4574965127;Ne;0;1;1;2
8305;"Prie pasakų parko";"ŽVAIGŽDUTĖS  (SPEC)";2224744461;Taip;9;0;7;16
8306;"Prie pasakų parko";"ŽVAIGŽDUTĖS  (SPEC)";3045247119;Ne;0;0;5;5
8307;"Prie pasakų parko";"ŽVAIGŽDUTĖS  (SPEC)";7341054382;Ne;15;0;1;16
8308;"Prie pasakų parko";"ŽVAIGŽDUTĖS  (SPEC)";1118596267;Taip;14;0;0;14
8309;"Prie pasakų parko";"ŽVAIGŽDUTĖS  (SPEC)";89327404290;Taip;0;0;1;1
8310;"Prie pasakų parko";"ŽVAIGŽDUTĖS  (SPEC)";1828638638;Taip;16;0;0;16
8311;"Prie pasakų parko";"ŽVAIGŽDUTĖS  (SPEC)";5356005675;Taip;17;2;0;19
8312;"Prie pasakų parko";"ŽVAIGŽDUTĖS  (SPEC)";4715171946;Taip;9;0;4;13
8313;"Prie pasakų parko";"ŽVAIGŽDUTĖS  (SPEC)";5641148690;Taip;0;6;0;6
8314;"Prie pasakų parko";"ŽVAIGŽDUTĖS  (SPEC)";7216751216;Taip;11;0;0;11
8315;"Prie pasakų parko";"ANČIUKAI (SPEC)";9327121033;Ne;14;0;0;14
8316;"Prie pasakų parko";"ANČIUKAI (SPEC)";1182188784;Taip;13;0;1;14
8317;"Prie pasakų parko";"ANČIUKAI (SPEC)";7710346116;Ne;19;0;0;19
8318;"Prie pasakų parko";"ANČIUKAI (SPEC)";3825101647;Ne;18;0;1;19
8319;"Prie pasakų parko";"ANČIUKAI (SPEC)";9847622676;Ne;21;0;0;21
8320;"Prie pasakų parko";"ANČIUKAI (SPEC)";9469871636;Ne;16;0;0;16
8321;"Prie pasakų parko";"ANČIUKAI (SPEC)";8323172347;Taip;4;0;0;4
8322;"Prie pasakų parko";"ANČIUKAI (SPEC)";2133790263;Ne;9;0;2;11
8323;"Prie pasakų parko";"ANČIUKAI (SPEC)";1212865434;Ne;0;8;0;8
8324;"Prie pasakų parko";TIGRIUKAI;1425859956;Taip;0;6;0;6
8325;"Prie pasakų parko";TIGRIUKAI;2601881804;Taip;7;1;0;8
8326;"Prie pasakų parko";TIGRIUKAI;34800098950;Taip;0;4;3;7
8327;"Prie pasakų parko";TIGRIUKAI;4365489653;Ne;0;9;0;9
8328;"Prie pasakų parko";TIGRIUKAI;6273733995;Taip;0;10;0;10
8329;"Prie pasakų parko";TIGRIUKAI;1204812495;Taip;0;1;0;1
8330;"Prie pasakų parko";TIGRIUKAI;5699852944;Taip;16;0;0;16
8331;"Prie pasakų parko";TIGRIUKAI;4900757614;Taip;1;0;4;5
8332;"Prie pasakų parko";TIGRIUKAI;8205731591;Taip;19;0;0;19
8333;"Prie pasakų parko";TIGRIUKAI;1357074461;Taip;0;10;0;10
8334;"Prie pasakų parko";TIGRIUKAI;5357989556;Ne;5;0;0;5
8335;"Prie pasakų parko";TIGRIUKAI;8618280811;Ne;0;0;17;17
8336;"Prie pasakų parko";TIGRIUKAI;8182873487;Taip;0;0;4;4
8337;"Prie pasakų parko";TIGRIUKAI;1369637618;Taip;0;0;2;2
8338;"Prie pasakų parko";TIGRIUKAI;6236051765;Taip;4;6;0;10
8339;"Prie pasakų parko";TIGRIUKAI;7844351275;Taip;0;0;8;8
8340;"Prie pasakų parko";"EŽIUKŲ (SPEC)";7851357992;Taip;11;0;8;19
8341;"Prie pasakų parko";"EŽIUKŲ (SPEC)";2820889357;Ne;12;4;0;16
8342;"Prie pasakų parko";"EŽIUKŲ (SPEC)";1549137154;Taip;0;4;1;5
8343;"Prie pasakų parko";"EŽIUKŲ (SPEC)";7545372781;Ne;12;0;0;12
8344;"Prie pasakų parko";"EŽIUKŲ (SPEC)";29445903073;Taip;0;11;0;11
8345;"Prie pasakų parko";"EŽIUKŲ (SPEC)";8849417734;Taip;7;0;5;12
8346;"Prie pasakų parko";"EŽIUKŲ (SPEC)";9190379838;Taip;10;0;3;13
8347;"Prie pasakų parko";"EŽIUKŲ (SPEC)";7327208141;Ne;17;0;0;17
8348;"Prie pasakų parko";"EŽIUKŲ (SPEC)";7115825217;Taip;16;0;1;17
8349;"Prie pasakų parko";"EŽIUKŲ (SPEC)";2952868428;Taip;8;0;5;13
8350;"Prie pasakų parko";"BORUŽIUKŲ (SPEC)";2080597774;Taip;0;0;1;1
8351;"Prie pasakų parko";"BORUŽIUKŲ (SPEC)";28574450739;Taip;5;4;0;9
8352;"Prie pasakų parko";"BORUŽIUKŲ (SPEC)";8817950372;Taip;0;6;0;6
8353;"Prie pasakų parko";"BORUŽIUKŲ (SPEC)";4203385836;Ne;9;1;0;10
8354;"Prie pasakų parko";"BORUŽIUKŲ (SPEC)";92307951922;Taip;0;0;1;1
8355;"Prie pasakų parko";"BORUŽIUKŲ (SPEC)";6215345468;Ne;0;0;2;2
8356;"Prie pasakų parko";"BORUŽIUKŲ (SPEC)";9139322116;Taip;0;4;2;6
8357;"Prie pasakų parko";"BORUŽIUKŲ (SPEC)";6937555692;Taip;0;5;0;5
8358;"Prie pasakų parko";"BORUŽIUKŲ (SPEC)";3579974049;Taip;0;0;1;1
8359;"Prie pasakų parko";SAULYTĖS;4501408366;Taip;12;3;0;15
8360;"Prie pasakų parko";SAULYTĖS;5593546668;Taip;3;3;0;6
8361;"Prie pasakų parko";SAULYTĖS;6361878877;Taip;11;0;2;13
8362;"Prie pasakų parko";SAULYTĖS;6762267582;Taip;16;0;0;16
8363;"Prie pasakų parko";SAULYTĖS;3453119286;Taip;9;0;0;9
8364;"Prie pasakų parko";SAULYTĖS;5494350183;Taip;10;1;0;11
8365;"Prie pasakų parko";SAULYTĖS;5102718403;Taip;13;0;1;14
8366;"Prie pasakų parko";SAULYTĖS;8285260113;Taip;11;4;2;17
8367;"Prie pasakų parko";SAULYTĖS;5438716880;Taip;12;4;0;16
8368;"Prie pasakų parko";SAULYTĖS;7459673719;Taip;11;5;0;16
8369;"Prie pasakų parko";SAULYTĖS;2023309512;Ne;15;0;0;15
8370;"Prie pasakų parko";SAULYTĖS;8324750958;Ne;19;1;0;20
8371;"Prie pasakų parko";SAULYTĖS;1371318901;Taip;4;9;0;13
8372;"Prie pasakų parko";SAULYTĖS;4351705573;Taip;15;0;1;16
8373;"Prie pasakų parko";SAULYTĖS;7390391804;Taip;14;0;0;14
8374;"Prie pasakų parko";SAULYTĖS;8942118356;Taip;10;0;0;10
8375;"Prie pasakų parko";SAULYTĖS;3042409414;Taip;19;0;0;19
8376;Pumpurėlis;RAMUNĖLIŲ;7610949816;Taip;0;2;0;2
8377;Pumpurėlis;RAMUNĖLIŲ;6165833101;Taip;4;0;1;5
8378;Pumpurėlis;RAMUNĖLIŲ;6977710645;Taip;5;0;5;10
8379;Pumpurėlis;RAMUNĖLIŲ;9431295796;Taip;0;0;14;14
8380;Pumpurėlis;RAMUNĖLIŲ;1395380236;Taip;2;1;4;7
8381;Pumpurėlis;RAMUNĖLIŲ;9424449290;Ne;8;8;0;16
8382;Pumpurėlis;RAMUNĖLIŲ;6955168163;Taip;16;0;0;16
8383;Pumpurėlis;RAMUNĖLIŲ;5171198109;Taip;7;4;2;13
8384;Pumpurėlis;RAMUNĖLIŲ;9726028397;Taip;13;0;0;13
8385;Pumpurėlis;RAMUNĖLIŲ;7229289985;Taip;15;0;6;21
8386;Pumpurėlis;RAMUNĖLIŲ;2969734731;Ne;4;0;2;6
8387;Pumpurėlis;RAMUNĖLIŲ;5663147778;Taip;0;4;0;4
8388;Pumpurėlis;RAMUNĖLIŲ;7559071945;Taip;7;2;0;9
8389;Pumpurėlis;RAMUNĖLIŲ;8373105196;Taip;2;7;3;12
8390;Pumpurėlis;RAMUNĖLIŲ;6574415196;Taip;0;2;2;4
8391;Pumpurėlis;RAMUNĖLIŲ;3953103488;Taip;8;0;0;8
8392;Pumpurėlis;RAMUNĖLIŲ;6511527480;Taip;3;5;0;8
8393;Pumpurėlis;RAMUNĖLIŲ;3838705973;Taip;6;0;4;10
8394;Pumpurėlis;RAMUNĖLIŲ;6726875853;Taip;0;5;0;5
8395;Pumpurėlis;RAMUNĖLIŲ;7996736781;Taip;0;0;4;4
8396;Pumpurėlis;VARPELIŲ;7160091629;Taip;19;0;2;21
8397;Pumpurėlis;VARPELIŲ;3101133244;Ne;7;9;0;16
8398;Pumpurėlis;VARPELIŲ;3893768713;Taip;6;2;0;8
8399;Pumpurėlis;VARPELIŲ;5023658988;Ne;0;6;2;8
8400;Pumpurėlis;VARPELIŲ;2668855786;Taip;4;5;4;13
8401;Pumpurėlis;VARPELIŲ;8258560345;Taip;18;0;0;18
8402;Pumpurėlis;VARPELIŲ;9612924972;Taip;6;4;0;10
8403;Pumpurėlis;VARPELIŲ;9884099545;Taip;12;0;0;12
8404;Pumpurėlis;VARPELIŲ;1687770779;Ne;0;21;0;21
8405;Pumpurėlis;VARPELIŲ;4451898302;Taip;0;19;1;20
8406;Pumpurėlis;VARPELIŲ;3733509497;Taip;8;1;0;9
8407;Pumpurėlis;VARPELIŲ;4508966729;Taip;5;0;4;9
8408;Pumpurėlis;VARPELIŲ;9552913910;Taip;1;5;4;10
8409;Pumpurėlis;VARPELIŲ;5196733185;Taip;5;5;0;10
8410;Pumpurėlis;VARPELIŲ;4928495108;Taip;0;0;1;1
8411;Pumpurėlis;VARPELIŲ;8886730333;Taip;0;5;0;5
8412;Pumpurėlis;VARPELIŲ;2247300456;Taip;0;8;0;8
8413;Pumpurėlis;VARPELIŲ;5564680653;Taip;0;0;9;9
8414;Pumpurėlis;VARPELIŲ;1411232443;Taip;0;0;5;5
8415;Pumpurėlis;VARPELIŲ;6726772655;Taip;0;6;2;8
8416;Pumpurėlis;DRUGELIŲ;25029630023;Taip;8;0;0;8
8417;Pumpurėlis;DRUGELIŲ;1230058211;Taip;0;2;0;2
8418;Pumpurėlis;DRUGELIŲ;1053338730;Taip;7;0;5;12
8419;Pumpurėlis;DRUGELIŲ;1261919194;Taip;0;0;6;6
8420;Pumpurėlis;DRUGELIŲ;1397924008;Taip;2;0;8;10
8421;Pumpurėlis;DRUGELIŲ;6230500803;Ne;0;8;0;8
8422;Pumpurėlis;DRUGELIŲ;2129779614;Taip;2;3;4;9
8423;Pumpurėlis;DRUGELIŲ;2102427499;Taip;0;9;0;9
8424;Pumpurėlis;DRUGELIŲ;9724549899;Taip;0;0;6;6
8425;Pumpurėlis;DRUGELIŲ;9317495169;Taip;0;14;0;14
8426;Pumpurėlis;DRUGELIŲ;8262886949;Ne;0;3;0;3
8427;Pumpurėlis;DRUGELIŲ;6535398274;Taip;16;0;0;16
8428;Pumpurėlis;DRUGELIŲ;9078991043;Taip;8;4;0;12
8429;Pumpurėlis;DRUGELIŲ;9733380187;Taip;12;0;3;15
8430;Pumpurėlis;DRUGELIŲ;83388662869;Ne;0;9;0;9
8431;Pumpurėlis;DRUGELIŲ;7123915287;Taip;3;0;2;5
8432;Pumpurėlis;DRUGELIŲ;1690424790;Ne;2;13;0;15
8433;Pumpurėlis;DRUGELIŲ;4192641015;Ne;4;0;5;9
8434;Pumpurėlis;DRUGELIŲ;1248017244;Ne;10;0;5;15
8435;Pumpurėlis;KODĖLČIUKŲ;18928851032;Taip;0;7;0;7
8436;Pumpurėlis;KODĖLČIUKŲ;9224879966;Taip;2;7;0;9
8437;Pumpurėlis;KODĖLČIUKŲ;1188314397;Taip;0;1;0;1
8438;Pumpurėlis;KODĖLČIUKŲ;2468796972;Taip;0;5;0;5
8439;Pumpurėlis;KODĖLČIUKŲ;8830261792;Taip;5;0;0;5
8440;Pumpurėlis;KODĖLČIUKŲ;9583257172;Taip;0;7;0;7
8441;Pumpurėlis;KODĖLČIUKŲ;9138883172;Taip;4;0;0;4
8442;Pumpurėlis;KODĖLČIUKŲ;7533555059;Taip;8;7;0;15
8443;Pumpurėlis;KODĖLČIUKŲ;6669327226;Taip;0;6;0;6
8444;Pumpurėlis;KODĖLČIUKŲ;13952236905;Taip;0;4;1;5
8445;Pumpurėlis;KODĖLČIUKŲ;87061817106;Taip;7;5;0;12
8446;Pumpurėlis;KODĖLČIUKŲ;30267173981;Taip;0;0;2;2
8447;Pumpurėlis;KODĖLČIUKŲ;1835168438;Ne;4;12;0;16
8448;Pumpurėlis;KODĖLČIUKŲ;5615260965;Taip;0;3;0;3
8449;Pumpurėlis;KODĖLČIUKŲ;4344595328;Taip;0;7;0;7
8450;Pumpurėlis;KODĖLČIUKŲ;3298821054;Ne;14;0;0;14
8451;Pumpurėlis;KODĖLČIUKŲ;8806961007;Taip;7;1;3;11
8452;Pumpurėlis;KODĖLČIUKŲ;9439363363;Taip;8;0;0;8
8453;Pumpurėlis;KODĖLČIUKŲ;5964953923;Taip;0;5;1;6
8454;Pumpurėlis;KODĖLČIUKŲ;1492810528;Taip;0;6;0;6
8455;Pumpurėlis;KODĖLČIUKŲ;7566451857;Taip;4;0;0;4
8456;Pumpurėlis;LINELIS;44982629856;Taip;0;4;0;4
8457;Pumpurėlis;LINELIS;1754102092;Taip;0;5;0;5
8458;Pumpurėlis;LINELIS;5901659879;Taip;7;6;0;13
8459;Pumpurėlis;LINELIS;11052382671;Taip;0;4;0;4
8460;Pumpurėlis;LINELIS;46386981131;Taip;0;4;0;4
8461;Pumpurėlis;LINELIS;77110003421;Taip;2;7;1;10
8462;Pumpurėlis;LINELIS;56351492623;Taip;0;5;0;5
8463;Pumpurėlis;LINELIS;70522541316;Taip;0;5;0;5
8464;Pumpurėlis;LINELIS;465606233;Taip;0;6;2;8
8465;Pumpurėlis;LINELIS;40808677022;Taip;0;4;0;4
8466;Pumpurėlis;LINELIS;57426850391;Ne;0;8;0;8
8467;Pumpurėlis;LINELIS;28759758744;Taip;0;4;0;4
8468;Pumpurėlis;LINELIS;36645787745;Taip;0;10;0;10
8469;Pumpurėlis;LINELIS;15256433275;Taip;0;4;0;4
8470;Pumpurėlis;LINELIS;47596248180;Taip;0;6;0;6
8471;Pumpurėlis;LINELIS;97145389284;Ne;12;4;0;16
8472;Pumpurėlis;LINELIS;1645287832;Ne;7;6;2;15
8473;Pumpurėlis;LINELIS;6025998706;Taip;0;5;0;5
8474;Pumpurėlis;LINELIS;89695456583;Taip;4;7;0;11
8475;Pumpurėlis;SAULUTĖS;6215273976;Taip;0;7;0;7
8476;Pumpurėlis;SAULUTĖS;1366801299;Ne;12;5;0;17
8477;Pumpurėlis;SAULUTĖS;1524688901;Ne;12;5;0;17
8478;Pumpurėlis;SAULUTĖS;1021043951;Taip;13;0;0;13
8479;Pumpurėlis;SAULUTĖS;1631951556;Taip;7;4;1;12
8480;Pumpurėlis;SAULUTĖS;9041599264;Taip;3;5;0;8
8481;Pumpurėlis;SAULUTĖS;45279361421;Taip;0;1;0;1
8482;Pumpurėlis;SAULUTĖS;1085633311;Taip;6;4;0;10
8483;Pumpurėlis;SAULUTĖS;66672997420;Taip;0;2;2;4
8484;Pumpurėlis;SAULUTĖS;27361939846;Taip;7;5;0;12
8485;Pumpurėlis;SAULUTĖS;2671657094;Taip;13;8;0;21
8486;Pumpurėlis;SAULUTĖS;61297074638;Taip;0;4;0;4
8487;Pumpurėlis;SAULUTĖS;24681852477;Taip;4;5;0;9
8488;Pumpurėlis;SAULUTĖS;33847164571;Taip;5;5;0;10
8489;Pumpurėlis;SAULUTĖS;20093100251;Taip;0;5;0;5
8490;Pumpurėlis;SAULUTĖS;87813594933;Taip;8;7;0;15
8491;Pumpurėlis;SAULUTĖS;15096075268;Taip;0;9;0;9
8492;Pumpurėlis;SAULUTĖS;72455192748;Taip;5;4;0;9
8493;Pumpurėlis;SAULUTĖS;7015779224;Taip;7;3;0;10
8494;Pumpurėlis;SAULUTĖS;1685401053;Taip;0;4;0;4
8495;Pumpurėlis;SAULUTĖS;16656067942;Taip;9;5;0;14
8496;Pumpurėlis;SAULUTĖS;91612536967;Taip;0;9;0;9
8497;Pumpurėlis;BITUTĖS;2028515310;Ne;4;2;0;6
8498;Pumpurėlis;BITUTĖS;1333429949;Taip;14;0;0;14
8499;Pumpurėlis;BITUTĖS;8747439652;Taip;6;0;0;6
8500;Pumpurėlis;BITUTĖS;92238719397;Taip;8;4;0;12
8501;Pumpurėlis;BITUTĖS;1400057487;Taip;6;1;0;7
8502;Pumpurėlis;BITUTĖS;1274293175;Ne;0;10;0;10
8503;Pumpurėlis;BITUTĖS;93809482039;Taip;0;4;0;4
8504;Pumpurėlis;BITUTĖS;7786926187;Taip;5;5;0;10
8505;Pumpurėlis;BITUTĖS;74144468541;Taip;0;6;0;6
8506;Pumpurėlis;BITUTĖS;1640573725;Taip;1;7;0;8
8507;Pumpurėlis;BITUTĖS;1473237607;Taip;0;4;2;6
8508;Pumpurėlis;BITUTĖS;71979455611;Ne;0;5;0;5
8509;Pumpurėlis;BITUTĖS;1001114367;Taip;0;5;0;5
8510;Pumpurėlis;BITUTĖS;26859673794;Taip;0;4;0;4
8511;Pumpurėlis;BITUTĖS;72719147901;Taip;0;0;1;1
8512;Pumpurėlis;BITUTĖS;1527144198;Ne;11;0;0;11
8513;Pumpurėlis;BITUTĖS;57949968899;Taip;0;0;9;9
8514;Pumpurėlis;BITUTĖS;1298302188;Taip;5;4;1;10
8515;Pumpurėlis;BITUTĖS;1255753542;Ne;10;4;1;15
8516;Pumpurėlis;BITUTĖS;3231167303;Taip;6;1;0;7
8517;Pumpurėlis;DOBILIUKAI;1273831078;Taip;8;3;0;11
8518;Pumpurėlis;DOBILIUKAI;1264017142;Ne;0;0;2;2
8519;Pumpurėlis;DOBILIUKAI;98061041685;Taip;7;0;3;10
8520;Pumpurėlis;DOBILIUKAI;1439043505;Taip;0;4;0;4
8521;Pumpurėlis;DOBILIUKAI;1287902351;Taip;0;4;0;4
8522;Pumpurėlis;DOBILIUKAI;13358453137;Taip;3;4;1;8
8523;Pumpurėlis;DOBILIUKAI;1209654095;Taip;0;5;1;6
8524;Pumpurėlis;DOBILIUKAI;40267078306;Taip;3;5;1;9
8525;Pumpurėlis;DOBILIUKAI;51793437519;Taip;6;4;0;10
8526;Pumpurėlis;DOBILIUKAI;1921332565;Taip;8;4;0;12
8527;Pumpurėlis;DOBILIUKAI;1055683170;Taip;0;4;0;4
8528;Pumpurėlis;DOBILIUKAI;1620037477;Taip;0;5;0;5
8529;Pumpurėlis;DOBILIUKAI;1307929787;Taip;0;3;0;3
8530;Pumpurėlis;DOBILIUKAI;1511761574;Taip;0;7;0;7
8531;Pumpurėlis;DOBILIUKAI;1346602122;Taip;4;4;0;8
8532;Pumpurėlis;DOBILIUKAI;88732170322;Taip;0;4;3;7
8533;Pumpurėlis;DOBILIUKAI;94636926281;Ne;0;4;0;4
8534;Pumpurėlis;DOBILIUKAI;1027125361;Taip;4;4;2;10
8535;Pumpurėlis;PUPYČIŲ;3214652626;Taip;8;0;1;9
8536;Pumpurėlis;PUPYČIŲ;2028068230;Taip;7;0;6;13
8537;Pumpurėlis;PUPYČIŲ;5587118874;Taip;3;0;2;5
8538;Pumpurėlis;PUPYČIŲ;7825190756;Taip;14;0;2;16
8539;Pumpurėlis;PUPYČIŲ;9058493247;Taip;5;0;3;8
8540;Pumpurėlis;PUPYČIŲ;3374174445;Taip;6;1;0;7
8541;Pumpurėlis;PUPYČIŲ;6307988067;Taip;5;4;1;10
8542;Pumpurėlis;PUPYČIŲ;1961282282;Taip;4;0;0;4
8543;Pumpurėlis;PUPYČIŲ;9509051946;Taip;0;11;0;11
8544;Pumpurėlis;PUPYČIŲ;5444879430;Taip;10;5;3;18
8545;Pumpurėlis;PUPYČIŲ;8242086461;Taip;0;0;19;19
8546;Pumpurėlis;PUPYČIŲ;6511802399;Taip;0;0;19;19
8547;Pumpurėlis;PUPYČIŲ;7276322999;Taip;13;0;0;13
8548;Pumpurėlis;PUPYČIŲ;1438740562;Taip;13;0;0;13
8549;Pumpurėlis;PUPYČIŲ;5438584331;Taip;6;0;0;6
8550;Pumpurėlis;ŽIRNIUKŲ;1768239820;Taip;4;0;0;4
8551;Pumpurėlis;ŽIRNIUKŲ;7363814444;Taip;0;6;0;6
8552;Pumpurėlis;ŽIRNIUKŲ;4426697956;Taip;7;0;0;7
8553;Pumpurėlis;ŽIRNIUKŲ;1714440337;Taip;0;4;0;4
8554;Pumpurėlis;ŽIRNIUKŲ;1130280140;Taip;11;0;2;13
8555;Pumpurėlis;ŽIRNIUKŲ;3951445693;Taip;9;0;4;13
8556;Pumpurėlis;ŽIRNIUKŲ;9612924316;Taip;0;8;0;8
8557;Pumpurėlis;ŽIRNIUKŲ;8655389224;Taip;19;0;0;19
8558;Pumpurėlis;ŽIRNIUKŲ;4985045047;Taip;9;0;0;9
8559;Pumpurėlis;ŽIRNIUKŲ;3405169131;Taip;3;4;1;8
8560;Pumpurėlis;ŽIRNIUKŲ;1674341906;Taip;0;9;0;9
8561;Pumpurėlis;ŽIRNIUKŲ;2566557351;Taip;0;4;1;5
8562;Pumpurėlis;ŽIRNIUKŲ;5559833356;Taip;9;0;4;13
8563;Pumpurėlis;ŽIRNIUKŲ;2651037375;Taip;12;0;0;12
8564;Pumpurėlis;BORUŽĖLIŲ;49767198843;Taip;11;0;0;11
8565;Pumpurėlis;BORUŽĖLIŲ;42611228425;Ne;1;2;3;6
8566;Pumpurėlis;BORUŽĖLIŲ;68035717481;Taip;13;0;0;13
8567;Pumpurėlis;BORUŽĖLIŲ;1594436797;Taip;0;4;0;4
8568;Pumpurėlis;BORUŽĖLIŲ;1568701327;Ne;0;4;0;4
8569;Pumpurėlis;BORUŽĖLIŲ;1842097360;Ne;0;0;5;5
8570;Pumpurėlis;BORUŽĖLIŲ;82659096039;Taip;1;3;0;4
8571;Pumpurėlis;BORUŽĖLIŲ;1098875585;Ne;0;13;1;14
8572;Pumpurėlis;BORUŽĖLIŲ;1034745510;Taip;2;4;2;8
8573;Pumpurėlis;BORUŽĖLIŲ;5364345261;Taip;0;0;1;1
8574;Pumpurėlis;BORUŽĖLIŲ;1617303626;Taip;10;0;0;10
8575;Pumpurėlis;BORUŽĖLIŲ;1306102772;Taip;8;4;3;15
8576;Pumpurėlis;BORUŽĖLIŲ;1436627913;Taip;0;2;0;2
8577;Pumpurėlis;BORUŽĖLIŲ;1075914140;Ne;2;4;1;7
8578;Pumpurėlis;BORUŽĖLIŲ;2345116167;Taip;0;10;0;10
8579;Pumpurėlis;BORUŽĖLIŲ;63610860077;Taip;11;4;0;15
8580;Pumpurėlis;BORUŽĖLIŲ;1257222112;Ne;0;0;10;10
8581;Pumpurėlis;BORUŽĖLIŲ;1508245418;Ne;2;0;0;2
8582;Pumpurėlis;BORUŽĖLIŲ;81595634697;Taip;0;4;1;5
8583;Pumpurėlis;BORUŽĖLIŲ;1061975374;Taip;0;9;0;9
8584;Puriena;Ančiukų;5026857195;Taip;0;6;0;6
8585;Puriena;Ančiukų;88588968229;Taip;0;6;0;6
8586;Puriena;Ančiukų;1758690169;Taip;9;3;0;12
8587;Puriena;Ančiukų;25112307864;Taip;0;4;0;4
8588;Puriena;Ančiukų;1240190350;Taip;5;4;0;9
8589;Puriena;Ančiukų;19157486407;Taip;5;5;0;10
8590;Puriena;Ančiukų;1557814435;Taip;0;5;0;5
8591;Puriena;Ančiukų;87523460146;Taip;0;6;0;6
8592;Puriena;Ančiukų;61241768982;Taip;12;4;0;16
8593;Puriena;Ančiukų;26980342372;Taip;7;3;0;10
8594;Puriena;Ančiukų;4260334053;Taip;12;6;0;18
8595;Puriena;Ančiukų;71778035373;Taip;14;4;0;18
8596;Puriena;Ančiukų;1184946421;Taip;9;2;1;12
8597;Puriena;Ančiukų;59193676476;Taip;7;9;0;16
8598;Puriena;Ančiukų;61117212576;Taip;7;6;0;13
8599;Puriena;Ančiukų;91069175088;Taip;15;0;0;15
8600;Puriena;Ančiukų;16572830524;Taip;6;0;0;6
8601;Puriena;Ančiukų;18592085188;Taip;8;2;3;13
8602;Puriena;Ančiukų;1418776789;Ne;11;0;0;11
8603;Puriena;Ančiukų;3327714361;Taip;1;0;1;2
8604;Puriena;Ančiukų;41863686552;Taip;0;8;0;8
8605;Puriena;Drugeliai;83821680276;Taip;0;10;0;10
8606;Puriena;Drugeliai;7337038503;Taip;6;1;0;7
8607;Puriena;Drugeliai;47316276655;Taip;1;2;12;15
8608;Puriena;Drugeliai;48468411549;Taip;10;0;0;10
8609;Puriena;Drugeliai;20286870431;Ne;9;5;0;14
8610;Puriena;Drugeliai;63196502622;Taip;13;0;1;14
8611;Puriena;Drugeliai;11497629767;Taip;8;5;0;13
8612;Puriena;Drugeliai;2146036332;Taip;0;0;10;10
8613;Puriena;Drugeliai;1443945321;Taip;0;0;10;10
8614;Puriena;Drugeliai;1703078658;Taip;2;4;0;6
8615;Puriena;Drugeliai;2083071198;Taip;11;0;0;11
8616;Puriena;Drugeliai;8213725698;Taip;9;0;8;17
8617;Puriena;Drugeliai;2378865002;Taip;16;0;0;16
8618;Puriena;Drugeliai;5891404983;Ne;4;2;6;12
8619;Puriena;Drugeliai;9239618299;Taip;0;16;0;16
8620;Puriena;Drugeliai;2089174669;Taip;6;6;0;12
8621;Puriena;Drugeliai;2131343339;Taip;5;1;0;6
8622;Puriena;Drugeliai;1748337587;Taip;0;16;0;16
8623;Puriena;Drugeliai;8618298134;Taip;0;0;12;12
8624;Puriena;Drugeliai;8707076857;Taip;4;0;10;14
8625;Puriena;Drugeliai;1820719083;Taip;15;0;0;15
8626;Puriena;Pelėdžiukai;11431481909;Taip;7;6;0;13
8627;Puriena;Pelėdžiukai;53451774513;Taip;7;3;0;10
8628;Puriena;Pelėdžiukai;12499791115;Taip;0;5;0;5
8629;Puriena;Pelėdžiukai;54048579160;Taip;0;9;0;9
8630;Puriena;Pelėdžiukai;43490363874;Taip;0;10;0;10
8631;Puriena;Pelėdžiukai;34689084311;Taip;5;4;0;9
8632;Puriena;Pelėdžiukai;21611180390;Taip;12;5;0;17
8633;Puriena;Pelėdžiukai;15016729899;Taip;5;9;0;14
8634;Puriena;Pelėdžiukai;11677252767;Taip;0;7;0;7
8635;Puriena;Pelėdžiukai;16437608299;Taip;0;16;0;16
8636;Puriena;Pelėdžiukai;69494886505;Taip;0;5;0;5
8637;Puriena;Pelėdžiukai;95972862152;Ne;5;2;0;7
8638;Puriena;Pelėdžiukai;58791977007;Taip;0;5;0;5
8639;Puriena;Pelėdžiukai;53286108187;Taip;5;4;0;9
8640;Puriena;Pelėdžiukai;81806945761;Taip;8;7;0;15
8641;Puriena;Pelėdžiukai;43963341624;Ne;8;4;0;12
8642;Puriena;Pelėdžiukai;26040866189;Taip;3;5;0;8
8643;Puriena;Pelėdžiukai;90508354565;Ne;0;11;0;11
8644;Puriena;Pelėdžiukai;95822432988;Taip;0;7;0;7
8645;Puriena;Pelėdžiukai;45627148409;Taip;0;6;0;6
8646;Puriena;Pelėdžiukai;2011809589;Taip;0;8;0;8
8647;Puriena;Voveriukai;23746358787;Taip;7;2;0;9
8648;Puriena;Voveriukai;6285846517;Taip;0;2;0;2
8649;Puriena;Voveriukai;5501308683;Ne;6;4;0;10
8650;Puriena;Voveriukai;92604925140;Taip;0;6;0;6
8651;Puriena;Voveriukai;1263637124;Taip;5;5;0;10
8652;Puriena;Voveriukai;1290933817;Taip;8;2;0;10
8653;Puriena;Voveriukai;7429832136;Taip;4;9;0;13
8654;Puriena;Voveriukai;2663832596;Taip;0;9;0;9
8655;Puriena;Voveriukai;4966293604;Taip;0;2;0;2
8656;Puriena;Voveriukai;2203259310;Taip;0;0;2;2
8657;Puriena;Voveriukai;40573980976;Taip;6;6;0;12
8658;Puriena;Voveriukai;1381379515;Taip;12;1;0;13
8659;Puriena;Voveriukai;6057477307;Taip;7;5;0;12
8660;Puriena;Voveriukai;1290962809;Taip;10;4;0;14
8661;Puriena;Voveriukai;11242620566;Ne;8;2;1;11
8662;Puriena;Voveriukai;9139110598;Ne;0;8;0;8
8663;Puriena;Voveriukai;8112003551;Taip;8;0;1;9
8664;Puriena;Voveriukai;9106525954;Taip;0;4;0;4
8665;Puriena;Voveriukai;5999564879;Ne;4;1;0;5
8666;Puriena;Voveriukai;6053657231;Taip;0;2;0;2
8667;Puriena;Voveriukai;9146447088;Taip;14;0;1;15
8668;Puriena;Voveriukai;8478901457;Taip;7;0;2;9
8669;Puriena;Voveriukai;5257713434;Taip;0;2;0;2
8670;Puriena;Voveriukai;4647433927;Taip;0;2;0;2
8671;Puriena;Bitučių;71773966341;Taip;0;0;12;12
8672;Puriena;Bitučių;1945542034;Taip;0;6;0;6
8673;Puriena;Bitučių;79194353091;Taip;10;2;1;13
8674;Puriena;Bitučių;1629458651;Taip;12;6;0;18
8675;Puriena;Bitučių;91735621242;Taip;7;1;0;8
8676;Puriena;Bitučių;1116529845;Taip;0;0;9;9
8677;Puriena;Bitučių;98967026878;Taip;4;0;0;4
8678;Puriena;Bitučių;5284316470;Taip;9;1;0;10
8679;Puriena;Bitučių;84527348236;Ne;4;4;0;8
8680;Puriena;Bitučių;24572685191;Taip;6;1;4;11
8681;Puriena;Bitučių;8719239663;Taip;9;1;0;10
8682;Puriena;Bitučių;63944407195;Ne;5;0;0;5
8683;Puriena;Bitučių;95153406240;Ne;11;0;0;11
8684;Puriena;Bitučių;1125102675;Ne;5;10;0;15
8685;Puriena;Bitučių;29217326976;Taip;17;4;0;21
8686;Puriena;Bitučių;9666714143;Taip;0;6;2;8
8687;Puriena;Bitučių;1376708741;Taip;10;2;2;14
8688;Puriena;Bitučių;1507059980;Ne;10;3;1;14
8689;Puriena;Bitučių;5807510456;Taip;10;4;1;15
8690;Puriena;Bitučių;85334594528;Taip;15;0;0;15
8691;Puriena;Bitučių;1206969296;Ne;6;10;1;17
8692;Puriena;Zylutės;1892751625;Taip;8;5;1;14
8693;Puriena;Zylutės;37213422962;Ne;5;4;0;9
8694;Puriena;Zylutės;29931607789;Ne;10;4;0;14
8695;Puriena;Zylutės;14052847763;Taip;5;6;0;11
8696;Puriena;Zylutės;46510003255;Taip;9;4;0;13
8697;Puriena;Zylutės;64733952400;Ne;0;8;0;8
8698;Puriena;Zylutės;1993142891;Ne;8;5;0;13
8699;Puriena;Zylutės;6539425730;Taip;4;5;0;9
8700;Puriena;Zylutės;88483773966;Taip;0;4;0;4
8701;Puriena;Zylutės;61706928693;Taip;0;9;0;9
8702;Puriena;Zylutės;45128021817;Ne;2;6;0;8
8703;Puriena;Zylutės;7285127722;Ne;3;4;0;7
8704;Puriena;Zylutės;87711542948;Taip;0;5;0;5
8705;Puriena;Zylutės;50199557129;Taip;15;4;0;19
8706;Puriena;Zylutės;88595039240;Ne;10;4;0;14
8707;Puriena;Zylutės;65137815385;Taip;4;5;0;9
8708;Puriena;Zylutės;14780389529;Taip;0;9;0;9
8709;Puriena;Zylutės;54604607448;Taip;3;4;0;7
8710;Puriena;Zylutės;1994224209;Taip;0;3;0;3
8711;Puriena;Zylutės;27546501673;Taip;0;8;1;9
8712;Puriena;Meškučių;9251058353;Ne;17;1;0;18
8713;Puriena;Meškučių;1030958414;Taip;17;4;0;21
8714;Puriena;Meškučių;7967288875;Taip;0;0;11;11
8715;Puriena;Meškučių;6158842119;Taip;21;0;0;21
8716;Puriena;Meškučių;3681811493;Ne;0;1;0;1
8717;Puriena;Meškučių;4060087185;Taip;0;4;10;14
8718;Puriena;Meškučių;3033562627;Taip;9;0;3;12
8719;Puriena;Meškučių;5777076971;Taip;9;0;3;12
8720;Puriena;Meškučių;8310231540;Taip;9;2;0;11
8721;Puriena;Meškučių;4460575818;Taip;5;7;0;12
8722;Puriena;Meškučių;8120597514;Taip;0;4;0;4
8723;Puriena;Meškučių;5336923102;Taip;0;4;0;4
8724;Puriena;Meškučių;4605662701;Taip;21;0;0;21
8725;Puriena;Meškučių;1819876614;Taip;0;2;2;4
8726;Puriena;Meškučių;4776745276;Ne;21;0;0;21
8727;Puriena;Meškučių;7769252165;Taip;0;2;0;2
8728;Puriena;Meškučių;2170025682;Taip;0;4;1;5
8729;Puriena;Meškučių;3772941726;Taip;7;12;0;19
8730;Puriena;Meškučių;1428098802;Taip;7;12;0;19
8731;Puriena;Nykštukų;8237149969;Taip;0;0;3;3
8732;Puriena;Nykštukų;1295692895;Taip;4;0;0;4
8733;Puriena;Nykštukų;8416003733;Taip;0;2;6;8
8734;Puriena;Nykštukų;5224135638;Taip;13;2;1;16
8735;Puriena;Nykštukų;9543884311;Taip;0;13;8;21
8736;Puriena;Nykštukų;9209209113;Taip;20;0;0;20
8737;Puriena;Nykštukų;4017644414;Ne;0;2;4;6
8738;Puriena;Nykštukų;6780164845;Taip;11;0;6;17
8739;Puriena;Nykštukų;1398572100;Taip;11;0;1;12
8740;Puriena;Nykštukų;9962011647;Taip;2;13;1;16
8741;Puriena;Nykštukų;1339162214;Taip;12;1;0;13
8742;Puriena;Nykštukų;6656013805;Taip;6;2;1;9
8743;Puriena;Nykštukų;7573536525;Taip;0;6;1;7
8744;Puriena;Nykštukų;8022809059;Taip;19;0;0;19
8745;Puriena;Nykštukų;5395382717;Taip;15;1;0;16
8746;Puriena;Nykštukų;4444523140;Taip;1;2;12;15
8747;Puriena;Nykštukų;7622407056;Taip;0;11;0;11
8748;Puriena;Nykštukų;6813480086;Taip;15;2;0;17
8749;Puriena;Nykštukų;9854244405;Taip;9;0;0;9
8750;Puriena;Nykštukų;4498919764;Taip;0;14;0;14
8751;Puriena;Nykštukų;1175665781;Taip;7;0;2;9
8752;Puriena;Ežiukai;1900570261;Taip;5;0;0;5
8753;Puriena;Ežiukai;1704296685;Taip;5;2;0;7
8754;Puriena;Ežiukai;1174355613;Taip;0;6;1;7
8755;Puriena;Ežiukai;2255508780;Taip;12;1;0;13
8756;Puriena;Ežiukai;35226601932;Taip;0;10;0;10
8757;Puriena;Ežiukai;2072874096;Taip;4;2;3;9
8758;Puriena;Ežiukai;11011727269;Taip;0;3;0;3
8759;Puriena;Ežiukai;87416314075;Taip;16;0;0;16
8760;Puriena;Ežiukai;1175577834;Taip;0;2;3;5
8761;Puriena;Ežiukai;1134539790;Taip;5;1;0;6
8762;Puriena;Ežiukai;8852985927;Taip;2;0;1;3
8763;Puriena;Ežiukai;9471669903;Taip;12;0;0;12
8764;Puriena;Ežiukai;1707413291;Taip;4;1;0;5
8765;Puriena;Ežiukai;1773431155;Taip;10;4;0;14
8766;Puriena;Ežiukai;1379084331;Taip;3;0;1;4
8767;Puriena;Ežiukai;1710087159;Taip;4;2;0;6
8768;Puriena;Ežiukai;21180207545;Taip;0;9;3;12
8769;Puriena;Ežiukai;1762395617;Taip;0;5;0;5
8770;Puriena;Ežiukai;2560477213;Taip;0;4;0;4
8771;Puriena;Ežiukai;1786569222;Taip;2;2;10;14
8772;Puriena;Ežiukai;4792538031;Taip;0;5;0;5
8773;Puriena;Ežiukai;6208885352;Taip;4;0;0;4
8774;Puriena;"Boružiukų ";8061605125;Taip;8;9;0;17
8775;Puriena;"Boružiukų ";5619637663;Taip;6;2;0;8
8776;Puriena;"Boružiukų ";4858971990;Taip;5;1;0;6
8777;Puriena;"Boružiukų ";2701942325;Taip;0;7;0;7
8778;Puriena;"Boružiukų ";4608801156;Taip;4;0;0;4
8779;Puriena;"Boružiukų ";6463129806;Taip;12;5;0;17
8780;Puriena;"Boružiukų ";4501239330;Taip;5;0;0;5
8781;Puriena;"Boružiukų ";6197840105;Taip;13;2;1;16
8782;Puriena;"Boružiukų ";3175917649;Taip;6;0;0;6
8783;Puriena;"Boružiukų ";6786694796;Taip;16;0;0;16
8784;Puriena;"Boružiukų ";1417566073;Taip;18;0;0;18
8785;Puriena;"Boružiukų ";3671297035;Taip;11;0;4;15
8786;Puriena;"Boružiukų ";6352605894;Ne;7;0;0;7
8787;Puriena;"Boružiukų ";2579402981;Taip;12;4;2;18
8788;Puriena;"Boružiukų ";2267225709;Taip;0;5;2;7
8789;Puriena;"Boružiukų ";6413337915;Taip;4;5;1;10
8790;Puriena;"Boružiukų ";5341228269;Taip;18;0;0;18
8791;Puriena;"Zuikučių ";6883573289;Taip;5;0;12;17
8792;Puriena;"Zuikučių ";7120683581;Taip;11;0;0;11
8793;Puriena;"Zuikučių ";8144488922;Taip;18;0;1;19
8794;Puriena;"Zuikučių ";4283608124;Taip;0;6;1;7
8795;Puriena;"Zuikučių ";8130975863;Taip;0;6;0;6
8796;Puriena;"Zuikučių ";2813562677;Taip;3;1;1;5
8797;Puriena;"Zuikučių ";3542374463;Taip;12;0;0;12
8798;Puriena;"Zuikučių ";1933733714;Taip;10;4;0;14
8799;Puriena;"Zuikučių ";6150437624;Taip;17;0;0;17
8800;Puriena;"Zuikučių ";3627403517;Taip;0;0;5;5
8801;Puriena;"Zuikučių ";4070825932;Taip;8;0;6;14
8802;Puriena;"Zuikučių ";4653085762;Taip;9;5;0;14
8803;Puriena;"Zuikučių ";8952508230;Taip;16;0;0;16
8804;Puriena;"Zuikučių ";7169054113;Ne;5;2;0;7
8805;Puriena;"Zuikučių ";8476986855;Taip;5;5;0;10
8806;Puriena;"Zuikučių ";3309219271;Taip;17;0;1;18
8807;Puriena;"Zuikučių ";2624283930;Taip;14;3;0;17
8808;Pušaitė;Kodėlčiukai;62054870153;Taip;4;1;0;5
8809;Pušaitė;Kodėlčiukai;44525744411;Taip;4;2;0;6
8810;Pušaitė;Kodėlčiukai;1434600898;Ne;0;7;2;9
8811;Pušaitė;Kodėlčiukai;92087943993;Ne;0;5;6;11
8812;Pušaitė;Kodėlčiukai;10391045958;Taip;0;4;0;4
8813;Pušaitė;Kodėlčiukai;79462284429;Taip;0;4;0;4
8814;Pušaitė;Kodėlčiukai;51875651426;Taip;5;2;0;7
8815;Pušaitė;Kodėlčiukai;35587797387;Taip;0;4;2;6
8816;Pušaitė;Kodėlčiukai;12300222260;Ne;4;1;0;5
8817;Pušaitė;Kodėlčiukai;37480908997;Taip;3;3;2;8
8818;Pušaitė;Kodėlčiukai;81773729142;Taip;0;0;4;4
8819;Pušaitė;Kodėlčiukai;15593642938;Taip;0;9;0;9
8820;Pušaitė;Kodėlčiukai;10955132610;Taip;0;1;7;8
8821;Pušaitė;Kodėlčiukai;7680945149;Taip;4;2;0;6
8822;Pušaitė;Kodėlčiukai;89687717250;Taip;5;5;6;16
8823;Pušaitė;Kodėlčiukai;36677285052;Taip;0;5;0;5
8824;Pušaitė;Kodėlčiukai;3554790718;Taip;0;1;3;4
8825;Pušaitė;Kodėlčiukai;1912176781;Taip;0;6;0;6
8826;Pušaitė;Kodėlčiukai;20960105409;Taip;7;9;0;16
8827;Pušaitė;Kodėlčiukai;95522616207;Taip;0;0;2;2
8828;Pušaitė;Kodėlčiukai;66025911973;Taip;10;6;1;17
8829;Pušaitė;Saulutės;1918948738;Taip;2;4;0;6
8830;Pušaitė;Saulutės;58885325641;Taip;5;2;0;7
8831;Pušaitė;Saulutės;29899199427;Taip;0;3;1;4
8832;Pušaitė;Saulutės;20174084726;Ne;0;1;0;1
8833;Pušaitė;Saulutės;36646217833;Taip;0;7;8;15
8834;Pušaitė;Saulutės;40449072854;Taip;0;5;0;5
8835;Pušaitė;Saulutės;46097491628;Taip;0;6;1;7
8836;Pušaitė;Saulutės;2066639203;Taip;0;6;0;6
8837;Pušaitė;Saulutės;99740435577;Ne;5;4;0;9
8838;Pušaitė;Saulutės;34324686486;Taip;0;7;0;7
8839;Pušaitė;Saulutės;88286687854;Taip;0;8;0;8
8840;Pušaitė;Saulutės;1302087452;Taip;0;5;6;11
8841;Pušaitė;Saulutės;12326544543;Taip;0;1;0;1
8842;Pušaitė;Saulutės;61624123734;Taip;0;5;0;5
8843;Pušaitė;Saulutės;10115195053;Taip;0;1;7;8
8844;Pušaitė;Saulutės;22491605433;Taip;0;4;0;4
8845;Pušaitė;Saulutės;1389123203;Taip;18;0;0;18
8846;Pušaitė;Saulutės;2030939996;Ne;0;9;3;12
8847;Pušaitė;Saulutės;1444313482;Taip;0;3;3;6
8848;Pušaitė;Zuikučiai;2115591523;Taip;8;0;6;14
8849;Pušaitė;Zuikučiai;8738827821;Taip;0;0;5;5
8850;Pušaitė;Zuikučiai;2181510181;Taip;2;8;0;10
8851;Pušaitė;Zuikučiai;7477429922;Taip;4;2;0;6
8852;Pušaitė;Zuikučiai;6306133416;Taip;6;0;0;6
8853;Pušaitė;Zuikučiai;2099169654;Taip;3;0;1;4
8854;Pušaitė;Zuikučiai;6355379926;Ne;6;0;6;12
8855;Pušaitė;Zuikučiai;9389544351;Taip;0;21;0;21
8856;Pušaitė;Zuikučiai;80743691769;Taip;8;0;0;8
8857;Pušaitė;Zuikučiai;1296700534;Taip;5;4;3;12
8858;Pušaitė;Zuikučiai;51500717235;Taip;14;0;0;14
8859;Pušaitė;Zuikučiai;5398532705;Taip;0;7;0;7
8860;Pušaitė;Zuikučiai;8309000712;Taip;5;5;0;10
8861;Pušaitė;Zuikučiai;4881689337;Taip;12;0;0;12
8862;Pušaitė;Zuikučiai;3718196299;Taip;4;0;1;5
8863;Pušaitė;Zuikučiai;1295203136;Taip;0;3;0;3
8864;Pušaitė;Zuikučiai;6259961070;Taip;0;3;0;3
8865;Pušaitė;Zuikučiai;2944418714;Taip;7;0;2;9
8866;Pušaitė;Zuikučiai;3813761666;Ne;19;0;1;20
8867;Pušaitė;Zuikučiai;4762094720;Taip;10;5;0;15
8868;Pušaitė;Zuikučiai;6600314608;Taip;7;0;8;15
8869;Pušaitė;Zuikučiai;2130767942;Taip;0;21;0;21
8870;Pušaitė;Vėžliukai;1386420328;Taip;0;4;1;5
8871;Pušaitė;Vėžliukai;1863885754;Taip;9;0;5;14
8872;Pušaitė;Vėžliukai;4050198577;Taip;7;4;0;11
8873;Pušaitė;Vėžliukai;1412632976;Taip;0;21;0;21
8874;Pušaitė;Vėžliukai;8361761447;Taip;3;4;2;9
8875;Pušaitė;Vėžliukai;97738851561;Taip;0;4;3;7
8876;Pušaitė;Vėžliukai;1502634518;Taip;7;4;0;11
8877;Pušaitė;Vėžliukai;57025420993;Taip;0;21;0;21
8878;Pušaitė;Vėžliukai;73291156409;Taip;0;0;8;8
8879;Pušaitė;Vėžliukai;5262505407;Ne;9;4;0;13
8880;Pušaitė;Vėžliukai;1569413876;Taip;9;4;0;13
8881;Pušaitė;Vėžliukai;2892138891;Taip;0;4;0;4
8882;Pušaitė;Vėžliukai;3745881982;Taip;14;0;0;14
8883;Pušaitė;Vėžliukai;3577616212;Taip;7;4;1;12
8884;Pušaitė;Vėžliukai;71218084687;Taip;9;0;1;10
8885;Pušaitė;Vėžliukai;8155746120;Taip;0;4;2;6
8886;Pušaitė;Vėžliukai;8592426606;Taip;3;4;0;7
8887;Pušaitė;Vėžliukai;6752676513;Taip;6;0;0;6
8888;Pušaitė;Vėžliukai;1972872969;Taip;0;21;0;21
8889;Pušaitė;Vėžliukai;2856902024;Taip;0;21;0;21
8890;Pušaitė;Vėžliukai;1878172874;Ne;3;0;2;5
8891;Pušaitė;"Linksmieji nykštukai";9265357004;Taip;5;4;0;9
8892;Pušaitė;"Linksmieji nykštukai";3150144924;Taip;12;0;0;12
8893;Pušaitė;"Linksmieji nykštukai";7520393710;Taip;5;2;0;7
8894;Pušaitė;"Linksmieji nykštukai";4517181474;Ne;8;5;0;13
8895;Pušaitė;"Linksmieji nykštukai";9033615485;Taip;7;0;4;11
8896;Pušaitė;"Linksmieji nykštukai";3130824742;Taip;6;2;0;8
8897;Pušaitė;"Linksmieji nykštukai";4605161267;Taip;11;5;0;16
8898;Pušaitė;"Linksmieji nykštukai";6160825713;Taip;4;6;0;10
8899;Pušaitė;"Linksmieji nykštukai";1781601521;Taip;0;2;0;2
8900;Pušaitė;"Linksmieji nykštukai";1024996364;Taip;8;5;0;13
8901;Pušaitė;"Linksmieji nykštukai";4662871524;Taip;0;9;0;9
8902;Pušaitė;"Linksmieji nykštukai";8438652029;Taip;0;2;1;3
8903;Pušaitė;"Linksmieji nykštukai";6578483902;Taip;11;2;0;13
8904;Pušaitė;"Linksmieji nykštukai";3350461304;Ne;0;7;1;8
8905;Pušaitė;"Linksmieji nykštukai";9327636862;Taip;7;0;0;7
8906;Pušaitė;"Linksmieji nykštukai";4175909754;Taip;11;4;4;19
8907;Pušaitė;"Linksmieji nykštukai";3788392895;Taip;0;4;5;9
8908;Pušaitė;"Linksmieji nykštukai";3195191374;Taip;0;3;0;3
8909;Pušaitė;"Linksmieji nykštukai";9127444013;Taip;12;4;0;16
8910;Pušaitė;"Linksmieji nykštukai";5422784898;Taip;0;4;8;12
8911;Pušaitė;"Linksmieji nykštukai";5104111840;Taip;12;0;1;13
8912;Pušaitė;"Linksmieji nykštukai";9866431097;Taip;9;4;0;13
8913;Pušaitė;"Linksmieji nykštukai";4564478833;Taip;5;4;0;9
8914;Pušaitė;"Kačiukų trobelė";3695016765;Taip;0;0;10;10
8915;Pušaitė;"Kačiukų trobelė";5415680731;Taip;3;5;0;8
8916;Pušaitė;"Kačiukų trobelė";7983115812;Taip;10;1;0;11
8917;Pušaitė;"Kačiukų trobelė";7614475216;Taip;0;4;1;5
8918;Pušaitė;"Kačiukų trobelė";1122112207;Taip;11;2;6;19
8919;Pušaitė;"Kačiukų trobelė";1635528919;Taip;6;0;0;6
8920;Pušaitė;"Kačiukų trobelė";2837439334;Taip;7;0;0;7
8921;Pušaitė;"Kačiukų trobelė";7014914682;Ne;12;0;0;12
8922;Pušaitė;"Kačiukų trobelė";1624587173;Taip;0;4;4;8
8923;Pušaitė;"Kačiukų trobelė";8793102437;Ne;13;8;0;21
8924;Pušaitė;"Kačiukų trobelė";9056933586;Taip;9;3;0;12
8925;Pušaitė;"Kačiukų trobelė";7898355721;Taip;10;0;7;17
8926;Pušaitė;"Kačiukų trobelė";4374232593;Ne;9;0;1;10
8927;Pušaitė;"Kačiukų trobelė";6323180798;Taip;4;0;3;7
8928;Pušaitė;"Kačiukų trobelė";5191894075;Taip;2;9;2;13
8929;Pušaitė;"Kačiukų trobelė";1161519408;Taip;0;21;0;21
8930;Pušaitė;"Kačiukų trobelė";8822285103;Taip;6;1;0;7
8931;Pušaitė;"Kačiukų trobelė";9313564235;Taip;0;13;0;13
8932;Pušaitė;"Kačiukų trobelė";5564338170;Taip;11;0;0;11
8933;Pušaitė;"Kačiukų trobelė";9291306449;Taip;2;0;2;4
8934;Pušaitė;Ežiukai;2090143259;Taip;4;0;2;6
8935;Pušaitė;Ežiukai;2951618391;Taip;0;5;2;7
8936;Pušaitė;Ežiukai;9524002395;Taip;0;3;1;4
8937;Pušaitė;Ežiukai;7305350540;Ne;0;21;0;21
8938;Pušaitė;Ežiukai;1111143593;Taip;15;4;0;19
8939;Pušaitė;Ežiukai;5394378197;Taip;0;1;0;1
8940;Pušaitė;Ežiukai;15270671089;Taip;4;6;0;10
8941;Pušaitė;Ežiukai;69869396094;Taip;0;6;2;8
8942;Pušaitė;Ežiukai;3359574190;Taip;0;5;1;6
8943;Pušaitė;Ežiukai;1143122778;Taip;0;1;2;3
8944;Pušaitė;Ežiukai;9461292576;Taip;5;5;0;10
8945;Pušaitė;Ežiukai;5185787803;Taip;2;0;0;2
8946;Pušaitė;Ežiukai;4671293211;Taip;0;2;0;2
8947;Pušaitė;Ežiukai;4101326122;Taip;7;0;0;7
8948;Pušaitė;Ežiukai;8958364766;Taip;3;4;0;7
8949;Pušaitė;Ežiukai;2983890410;Taip;0;5;0;5
8950;Pušaitė;Ežiukai;7575143890;Taip;0;5;0;5
8951;Pušaitė;Ežiukai;7808186865;Taip;0;12;0;12
8952;Pušaitė;Ežiukai;4842783897;Taip;8;1;0;9
8953;Pušaitė;Ežiukai;5436168234;Taip;16;0;0;16
8954;Pušaitė;Ežiukai;6472169278;Ne;3;5;0;8
8955;Pušaitė;Ežiukai;8021494509;Taip;0;21;0;21
8956;Pušaitė;Ežiukai;2172342063;Taip;16;2;0;18
8957;Pušaitė;"Gudručių šalis";6470721291;Taip;0;4;2;6
8958;Pušaitė;"Gudručių šalis";24768657107;Taip;9;0;0;9
8959;Pušaitė;"Gudručių šalis";55304000825;Taip;7;6;0;13
8960;Pušaitė;"Gudručių šalis";15550007793;Taip;0;6;2;8
8961;Pušaitė;"Gudručių šalis";4386242143;Taip;9;5;3;17
8962;Pušaitė;"Gudručių šalis";15546035138;Taip;7;7;4;18
8963;Pušaitė;"Gudručių šalis";79097991060;Taip;0;1;0;1
8964;Pušaitė;"Gudručių šalis";1275885492;Taip;4;1;2;7
8965;Pušaitė;"Gudručių šalis";40886746431;Taip;0;0;3;3
8966;Pušaitė;"Gudručių šalis";90178990466;Taip;7;0;1;8
8967;Pušaitė;"Gudručių šalis";89985930634;Taip;0;5;6;11
8968;Pušaitė;"Gudručių šalis";4266368627;Ne;0;5;3;8
8969;Pušaitė;"Gudručių šalis";49973513385;Taip;9;5;0;14
8970;Pušaitė;"Gudručių šalis";66238819356;Taip;1;0;2;3
8971;Pušaitė;"Gudručių šalis";89212112638;Taip;3;6;5;14
8972;Pušaitė;"Gudručių šalis";11297426946;Taip;3;1;0;4
8973;Pušaitė;"Gudručių šalis";67365323950;Taip;0;1;0;1
8974;Pušaitė;"Gudručių šalis";35947321028;Taip;0;21;0;21
8975;Pušaitė;"Gudručių šalis";1459628106;Taip;2;4;0;6
8976;Pušaitė;"Gudručių šalis";87504481892;Ne;16;0;0;16
8977;Pušaitė;"Gudručių šalis";6915619931;Ne;10;7;0;17
8978;Pušaitė;"Gudručių šalis";41026183089;Taip;2;7;0;9
8979;Pušaitė;"Lapučių mokyklėlė";1102988768;Taip;4;5;0;9
8980;Pušaitė;"Lapučių mokyklėlė";53211427399;Taip;0;13;3;16
8981;Pušaitė;"Lapučių mokyklėlė";40417586835;Taip;9;3;0;12
8982;Pušaitė;"Lapučių mokyklėlė";91960884985;Taip;0;0;7;7
8983;Pušaitė;"Lapučių mokyklėlė";60394388920;Taip;0;5;0;5
8984;Pušaitė;"Lapučių mokyklėlė";2044213583;Taip;0;21;0;21
8985;Pušaitė;"Lapučių mokyklėlė";7408224942;Taip;2;2;0;4
8986;Pušaitė;"Lapučių mokyklėlė";1394847204;Ne;0;4;0;4
8987;Pušaitė;"Lapučių mokyklėlė";97778827111;Ne;0;5;0;5
8988;Pušaitė;"Lapučių mokyklėlė";21992678312;Taip;4;0;3;7
8989;Pušaitė;"Lapučių mokyklėlė";6667124375;Taip;0;6;0;6
8990;Pušaitė;"Lapučių mokyklėlė";77082825248;Taip;2;4;0;6
8991;Pušaitė;"Lapučių mokyklėlė";1487637695;Taip;8;0;0;8
8992;Pušaitė;"Lapučių mokyklėlė";53766202712;Taip;19;0;0;19
8993;Pušaitė;"Lapučių mokyklėlė";3231637165;Taip;0;6;0;6
8994;Pušaitė;"Lapučių mokyklėlė";6542917863;Taip;3;8;0;11
8995;Pušaitė;"Lapučių mokyklėlė";9179757395;Taip;13;0;0;13
8996;Pušaitė;"Lapučių mokyklėlė";8470059012;Ne;0;7;0;7
8997;Pušaitė;"Lapučių mokyklėlė";1798044901;Ne;0;2;0;2
8998;Pušaitė;"Lapučių mokyklėlė";7251064118;Taip;0;9;0;9
8999;Pušaitė;"Lapučių mokyklėlė";1108868901;Taip;0;2;0;2
9000;Pušaitė;"VOVERIUKAI ";8135552679;Taip;9;0;0;9
9001;Pušaitė;"VOVERIUKAI ";1978339054;Taip;0;4;1;5
9002;Pušaitė;"VOVERIUKAI ";9414554800;Taip;0;7;2;9
9003;Pušaitė;"VOVERIUKAI ";1326581025;Taip;0;8;0;8
9004;Pušaitė;"VOVERIUKAI ";5161142520;Taip;12;2;1;15
9005;Pušaitė;"VOVERIUKAI ";3014867515;Taip;5;1;0;6
9006;Pušaitė;"VOVERIUKAI ";9527253696;Taip;17;0;0;17
9007;Pušaitė;"VOVERIUKAI ";5922053969;Taip;0;1;0;1
9008;Pušaitė;"VOVERIUKAI ";3485234259;Taip;7;0;2;9
9009;Pušaitė;"VOVERIUKAI ";4473930703;Taip;0;4;4;8
9010;Pušaitė;"VOVERIUKAI ";1996544496;Taip;7;9;0;16
9011;Pušaitė;"VOVERIUKAI ";6739253961;Taip;16;0;0;16
9012;Pušaitė;"VOVERIUKAI ";8412276797;Taip;0;3;2;5
9013;Pušaitė;"VOVERIUKAI ";9470667227;Taip;9;0;2;11
9014;Pušaitė;"VOVERIUKAI ";7936991925;Taip;3;4;2;9
9015;Pušaitė;"VOVERIUKAI ";4326967247;Taip;8;7;2;17
9016;Pušaitė;MEŠKUČIAI;8702361596;Ne;7;0;1;8
9017;Pušaitė;MEŠKUČIAI;3014180020;Taip;10;0;0;10
9018;Pušaitė;MEŠKUČIAI;7890577174;Taip;11;5;0;16
9019;Pušaitė;MEŠKUČIAI;2253477550;Taip;3;12;0;15
9020;Pušaitė;MEŠKUČIAI;4103149433;Taip;0;21;0;21
9021;Pušaitė;MEŠKUČIAI;6186545163;Taip;9;5;0;14
9022;Pušaitė;MEŠKUČIAI;4198571222;Taip;7;0;1;8
9023;Pušaitė;MEŠKUČIAI;4838345510;Taip;5;2;1;8
9024;Pušaitė;MEŠKUČIAI;7068451014;Ne;8;0;0;8
9025;Pušaitė;MEŠKUČIAI;5281161835;Taip;0;0;1;1
9026;Pušaitė;MEŠKUČIAI;6275090953;Taip;0;4;0;4
9027;Pušaitė;MEŠKUČIAI;7117784038;Taip;0;21;0;21
9028;Pušaitė;MEŠKUČIAI;4747611989;Taip;14;0;0;14
9029;Pušaitė;MEŠKUČIAI;8750774616;Taip;7;9;0;16
9030;Pušaitė;MEŠKUČIAI;6576647982;Taip;5;0;1;6
9031;Pušaitė;MEŠKUČIAI;3832434608;Taip;0;0;4;4
9032;Pušaitė;PELIUKAI;3698808100;Ne;8;0;0;8
9033;Pušaitė;PELIUKAI;2793941689;Taip;0;21;0;21
9034;Pušaitė;PELIUKAI;6445790780;Taip;7;0;0;7
9035;Pušaitė;PELIUKAI;2004615252;Taip;0;21;0;21
9036;Pušaitė;PELIUKAI;6794867560;Taip;8;4;0;12
9037;Pušaitė;PELIUKAI;8399589954;Taip;13;6;0;19
9038;Pušaitė;PELIUKAI;4615270419;Taip;21;0;0;21
9039;Pušaitė;PELIUKAI;7652706756;Taip;11;4;0;15
9040;Pušaitė;PELIUKAI;4743105731;Taip;8;0;1;9
9041;Pušaitė;PELIUKAI;5318602924;Taip;4;0;9;13
9042;Pušaitė;PELIUKAI;7945713337;Taip;10;1;0;11
9043;Pušaitė;PELIUKAI;1935059739;Taip;0;0;21;21
9044;Pušaitė;PELIUKAI;9364887123;Taip;17;0;0;17
9045;Pušaitė;PELIUKAI;6180888008;Taip;12;0;0;12
9046;Pušaitė;PELIUKAI;9391350218;Taip;10;2;0;12
9047;Pušaitė;"LAIKINAI PERKELIAMI VAIKAI (iš l/d Žolynėlis)";25487230804;Taip;0;21;0;21
9048;Pušaitė;"LAIKINAI PERKELIAMI VAIKAI (iš l/d Žolynėlis)";6695872204;Taip;0;21;0;21
9049;Pušaitė;"LAIKINAI PERKELIAMI VAIKAI (iš l/d Žolynėlis)";7510951079;Taip;0;21;0;21
9050;Pušaitė;"LAIKINAI PERKELIAMI VAIKAI (iš l/d Žolynėlis)";1590210772;Taip;4;0;0;4
9051;Pušaitė;"LAIKINAI PERKELIAMI VAIKAI (iš l/d Žolynėlis)";3422605135;Taip;0;1;4;5
9052;Pušaitė;"LAIKINAI PERKELIAMI VAIKAI (iš l/d Žolynėlis)";1473516753;Taip;0;13;4;17
9053;Pušaitė;"LAIKINAI PERKELIAMI VAIKAI (iš l/d Žolynėlis)";1223126521;Ne;0;21;0;21
9054;Pušaitė;"LAIKINAI PERKELIAMI VAIKAI (iš l/d Žolynėlis)";8378313810;Taip;0;21;0;21
9055;Pušaitė;"LAIKINAI PERKELIAMI VAIKAI (iš l/d Žolynėlis)";7870236961;Taip;0;7;6;13
9056;Pušaitė;"LAIKINAI PERKELIAMI VAIKAI (iš l/d Žolynėlis)";9997358375;Taip;15;0;1;16
9057;Pušaitė;"LAIKINAI PERKELIAMI VAIKAI (iš l/d Žolynėlis)";3984024179;Taip;0;21;0;21
9058;Pušaitė;"LAIKINAI PERKELIAMI VAIKAI (iš l/d Žolynėlis)";9207088786;Taip;0;1;1;2
9059;Pušaitė;"LAIKINAI PERKELIAMI VAIKAI (iš l/d Žolynėlis)";1189484802;Taip;10;5;1;16
9060;Pušynėlis;PUMPURĖLIAI;7177725663;Taip;0;12;0;12
9061;Pušynėlis;PUMPURĖLIAI;1891728904;Ne;0;4;5;9
9062;Pušynėlis;PUMPURĖLIAI;3100230874;Taip;0;20;0;20
9063;Pušynėlis;PUMPURĖLIAI;1102029570;Taip;5;0;0;5
9064;Pušynėlis;PUMPURĖLIAI;4030500100;Taip;6;1;1;8
9065;Pušynėlis;PUMPURĖLIAI;8172450090;Taip;6;1;1;8
9066;Pušynėlis;PUMPURĖLIAI;9039274775;Taip;13;4;0;17
9067;Pušynėlis;PUMPURĖLIAI;6077698697;Taip;2;2;0;4
9068;Pušynėlis;PUMPURĖLIAI;7046421581;Taip;9;5;0;14
9069;Pušynėlis;PUMPURĖLIAI;7729392498;Taip;14;0;0;14
9070;Pušynėlis;PUMPURĖLIAI;4380948433;Ne;14;0;0;14
9071;Pušynėlis;PUMPURĖLIAI;4668634909;Ne;16;4;0;20
9072;Pušynėlis;PUMPURĖLIAI;1610132076;Taip;0;8;0;8
9073;Pušynėlis;PUMPURĖLIAI;3192818461;Taip;2;1;0;3
9074;Pušynėlis;PUMPURĖLIAI;2793982816;Ne;12;0;0;12
9075;Pušynėlis;PUMPURĖLIAI;4920818548;Taip;21;0;0;21
9076;Pušynėlis;PUMPURĖLIAI;2508640229;Taip;13;0;0;13
9077;Pušynėlis;PUMPURĖLIAI;5236219294;Taip;14;0;0;14
9078;Pušynėlis;PUMPURĖLIAI;4052132379;Taip;0;3;1;4
9079;Pušynėlis;PUMPURĖLIAI;8451160808;Ne;2;0;0;2
9080;Pušynėlis;PUMPURĖLIAI;2141785580;Ne;0;14;0;14
9081;Pušynėlis;PUMPURĖLIAI;6560054869;Taip;0;4;9;13
9082;Pušynėlis;SAULUTĖS;1118012248;Ne;0;0;2;2
9083;Pušynėlis;SAULUTĖS;48050606382;Taip;0;4;3;7
9084;Pušynėlis;SAULUTĖS;74952593070;Taip;5;4;0;9
9085;Pušynėlis;SAULUTĖS;1610449906;Taip;5;5;0;10
9086;Pušynėlis;SAULUTĖS;51835639636;Ne;0;3;0;3
9087;Pušynėlis;SAULUTĖS;1811758590;Taip;0;3;4;7
9088;Pušynėlis;SAULUTĖS;8742287326;Taip;0;4;3;7
9089;Pušynėlis;SAULUTĖS;9192206804;Taip;0;2;0;2
9090;Pušynėlis;SAULUTĖS;3037031809;Taip;0;4;0;4
9091;Pušynėlis;SAULUTĖS;25261143142;Taip;0;7;0;7
9092;Pušynėlis;SAULUTĖS;6549217377;Taip;8;4;0;12
9093;Pušynėlis;SAULUTĖS;2048377076;Taip;0;13;0;13
9094;Pušynėlis;SAULUTĖS;9466109315;Taip;0;4;2;6
9095;Pušynėlis;SAULUTĖS;23816147491;Ne;0;6;0;6
9096;Pušynėlis;SAULUTĖS;9154108688;Taip;7;3;2;12
9097;Pušynėlis;SAULUTĖS;2012089695;Taip;0;4;0;4
9098;Pušynėlis;SAULUTĖS;1284674882;Taip;0;16;0;16
9099;Pušynėlis;SAULUTĖS;35538053975;Taip;3;4;0;7
9100;Pušynėlis;SAULUTĖS;1573574250;Taip;0;4;0;4
9101;Pušynėlis;SAULUTĖS;76597184985;Taip;0;2;0;2
9102;Pušynėlis;SAULUTĖS;3510202379;Ne;0;0;6;6
9103;Pušynėlis;SAULUTĖS;1817179601;Taip;0;5;2;7
9104;Pušynėlis;SAULUTĖS;6716726918;Taip;0;0;5;5
9105;Pušynėlis;SAULUTĖS;9665845150;Ne;0;14;0;14
9106;Pušynėlis;SAULUTĖS;2765869141;Taip;3;0;0;3
9107;Pušynėlis;PRIEŠMOKYKLINĖ;3527543120;Ne;0;2;2;4
9108;Pušynėlis;PRIEŠMOKYKLINĖ;6862900911;Taip;0;4;3;7
9109;Pušynėlis;PRIEŠMOKYKLINĖ;4291894982;Taip;0;4;5;9
9110;Pušynėlis;PRIEŠMOKYKLINĖ;16192036601;Taip;10;0;0;10
9111;Pušynėlis;PRIEŠMOKYKLINĖ;93484950406;Ne;5;0;2;7
9112;Pušynėlis;PRIEŠMOKYKLINĖ;1955967062;Taip;10;4;0;14
9113;Pušynėlis;PRIEŠMOKYKLINĖ;79386112020;Taip;0;4;1;5
9114;Pušynėlis;PRIEŠMOKYKLINĖ;1253953853;Ne;0;1;1;2
9115;Pušynėlis;PRIEŠMOKYKLINĖ;2042833795;Taip;0;1;0;1
9116;Pušynėlis;PRIEŠMOKYKLINĖ;58252435610;Taip;0;2;1;3
9117;Pušynėlis;PRIEŠMOKYKLINĖ;51866074822;Taip;0;4;4;8
9118;Pušynėlis;PRIEŠMOKYKLINĖ;75716791245;Taip;0;11;0;11
9119;Pušynėlis;PRIEŠMOKYKLINĖ;39796631884;Taip;0;13;0;13
9120;Pušynėlis;PRIEŠMOKYKLINĖ;1863758087;Taip;2;4;0;6
9121;Pušynėlis;PRIEŠMOKYKLINĖ;91759717760;Taip;0;10;0;10
9122;Pušynėlis;PRIEŠMOKYKLINĖ;2431940444;Taip;0;8;0;8
9123;Pušynėlis;PRIEŠMOKYKLINĖ;40478713455;Taip;4;3;0;7
9124;Pušynėlis;PRIEŠMOKYKLINĖ;1415916851;Taip;6;4;0;10
9125;Pušynėlis;PRIEŠMOKYKLINĖ;1367922475;Taip;0;2;4;6
9126;Pušynėlis;PRIEŠMOKYKLINĖ;1585572669;Taip;0;4;0;4
9127;Pušynėlis;LOPŠELIS;2718421498;Taip;0;14;0;14
9128;Pušynėlis;LOPŠELIS;8218331977;Taip;7;10;0;17
9129;Pušynėlis;LOPŠELIS;1818077465;Taip;6;15;0;21
9130;Pušynėlis;LOPŠELIS;4526807309;Taip;0;21;0;21
9131;Pušynėlis;LOPŠELIS;1251787066;Taip;7;5;5;17
9132;Pušynėlis;LOPŠELIS;4052365035;Taip;0;0;2;2
9133;Pušynėlis;LOPŠELIS;7896617995;Taip;6;4;0;10
9134;Pušynėlis;LOPŠELIS;9483417104;Taip;0;0;6;6
9135;Pušynėlis;LOPŠELIS;9081582524;Taip;15;0;1;16
9136;Pušynėlis;LOPŠELIS;3882064516;Taip;14;0;1;15
9137;Pušynėlis;LOPŠELIS;1034336110;Taip;0;10;1;11
9138;Pušynėlis;LOPŠELIS;1164201286;Taip;11;0;0;11
9139;Pušynėlis;LOPŠELIS;6709692748;Taip;13;0;0;13
9140;Pušynėlis;LOPŠELIS;8799095053;Taip;8;4;0;12
9141;Pušynėlis;LOPŠELIS;5318223378;Taip;11;0;0;11
9142;Pušynėlis;LOPŠELIS;5897839636;Taip;0;13;0;13
9143;Pušynėlis;LOPŠELIS;7401066252;Taip;0;0;10;10
9144;Pušynėlis;LOPŠELIS;7787646910;Taip;0;2;3;5
9145;Raktelis;LAŠIUKAI;55504358470;Ne;0;8;0;8
9146;Raktelis;LAŠIUKAI;61367764807;Ne;0;6;0;6
9147;Raktelis;LAŠIUKAI;1453259901;Taip;0;4;1;5
9148;Raktelis;LAŠIUKAI;6935703343;Taip;9;4;0;13
9149;Raktelis;LAŠIUKAI;30483797110;Taip;0;4;3;7
9150;Raktelis;LAŠIUKAI;5430563880;Taip;0;10;0;10
9151;Raktelis;LAŠIUKAI;874585350;Taip;0;7;0;7
9152;Raktelis;LAŠIUKAI;25504804011;Ne;8;6;0;14
9153;Raktelis;LAŠIUKAI;79301972646;Taip;0;6;5;11
9154;Raktelis;LAŠIUKAI;54361317676;Taip;0;12;0;12
9155;Raktelis;LAŠIUKAI;12333424396;Taip;0;4;0;4
9156;Raktelis;LAŠIUKAI;34960672068;Taip;0;2;0;2
9157;Raktelis;LAŠIUKAI;61636842808;Taip;0;4;2;6
9158;Raktelis;LAŠIUKAI;69445577844;Ne;0;5;0;5
9159;Raktelis;LAŠIUKAI;1224477393;Ne;4;1;0;5
9160;Raktelis;LAŠIUKAI;76758476679;Taip;10;4;0;14
9161;Raktelis;LAŠIUKAI;83366206408;Taip;6;5;0;11
9162;Raktelis;LAŠIUKAI;38068336379;Taip;0;1;5;6
9163;Raktelis;LAŠIUKAI;68578915107;Taip;0;5;0;5
9164;Raktelis;LAŠIUKAI;49216690763;Taip;3;7;0;10
9165;Raktelis;LAŠIUKAI;1586157196;Taip;0;8;0;8
9166;Raktelis;LAŠIUKAI;62754553467;Ne;5;5;0;10
9167;Raktelis;LAŠIUKAI;78841101231;Taip;0;4;8;12
9168;Raktelis;BITUTĖS;37587869107;Taip;10;6;1;17
9169;Raktelis;BITUTĖS;1544882634;Taip;7;7;0;14
9170;Raktelis;BITUTĖS;63051817818;Taip;0;2;9;11
9171;Raktelis;BITUTĖS;5663304735;Ne;4;2;1;7
9172;Raktelis;BITUTĖS;8559758812;Taip;7;2;1;10
9173;Raktelis;BITUTĖS;7265543701;Taip;18;0;0;18
9174;Raktelis;BITUTĖS;5627179884;Taip;0;5;0;5
9175;Raktelis;BITUTĖS;5405322552;Taip;8;0;5;13
9176;Raktelis;BITUTĖS;5492437864;Taip;6;2;1;9
9177;Raktelis;BITUTĖS;3880578523;Taip;7;2;0;9
9178;Raktelis;BITUTĖS;8796557675;Taip;16;0;0;16
9179;Raktelis;BITUTĖS;24323703041;Ne;0;1;2;3
9180;Raktelis;BITUTĖS;53034039807;Taip;15;2;0;17
9181;Raktelis;BITUTĖS;5711863758;Ne;6;1;1;8
9182;Raktelis;BITUTĖS;1747834520;Taip;9;0;5;14
9183;Raktelis;BITUTĖS;5000264125;Taip;11;2;2;15
9184;Raktelis;BITUTĖS;1820583792;Taip;21;0;0;21
9185;Raktelis;BITUTĖS;5802689482;Taip;10;6;0;16
9186;Raktelis;BITUTĖS;17270742947;Taip;0;12;0;12
9187;Raktelis;BITUTĖS;5392514118;Taip;12;6;0;18
9188;Raktelis;BITUTĖS;7048022562;Taip;5;4;0;9
9189;Raktelis;BITUTĖS;9774706725;Taip;11;8;0;19
9190;Raktelis;BITUTĖS;1455550617;Taip;0;0;9;9
9191;Raktelis;BITUTĖS;5218387088;Taip;9;0;0;9
9192;Raktelis;BORUŽĖLĖS;8117871963;Taip;9;0;8;17
9193;Raktelis;BORUŽĖLĖS;5031703240;Taip;0;6;0;6
9194;Raktelis;BORUŽĖLĖS;95104355224;Taip;6;0;0;6
9195;Raktelis;BORUŽĖLĖS;6049420030;Ne;8;0;0;8
9196;Raktelis;BORUŽĖLĖS;9313156299;Taip;5;5;0;10
9197;Raktelis;BORUŽĖLĖS;54221331553;Taip;21;0;0;21
9198;Raktelis;BORUŽĖLĖS;2070196225;Taip;15;0;0;15
9199;Raktelis;BORUŽĖLĖS;2303286473;Taip;0;4;0;4
9200;Raktelis;BORUŽĖLĖS;1192775994;Ne;7;5;0;12
9201;Raktelis;BORUŽĖLĖS;3609939325;Taip;8;0;0;8
9202;Raktelis;BORUŽĖLĖS;3345708690;Taip;0;4;0;4
9203;Raktelis;BORUŽĖLĖS;8245310502;Ne;12;5;0;17
9204;Raktelis;BORUŽĖLĖS;7487507324;Ne;8;2;0;10
9205;Raktelis;BORUŽĖLĖS;93271260871;Taip;18;0;0;18
9206;Raktelis;BORUŽĖLĖS;6779413882;Taip;17;0;0;17
9207;Raktelis;BORUŽĖLĖS;9584164290;Taip;6;6;0;12
9208;Raktelis;BORUŽĖLĖS;2055530718;Taip;4;0;0;4
9209;Raktelis;BORUŽĖLĖS;6854111162;Ne;11;1;0;12
9210;Raktelis;BORUŽĖLĖS;5818899732;Taip;11;0;0;11
9211;Raktelis;BORUŽĖLĖS;9348898875;Taip;0;4;0;4
9212;Raktelis;BORUŽĖLĖS;3762141936;Taip;9;0;0;9
9213;Raktelis;BORUŽĖLĖS;3713386556;Taip;4;9;0;13
9214;Raktelis;BORUŽĖLĖS;9230053040;Taip;13;5;0;18
9215;Raktelis;BORUŽĖLĖS;4671391106;Taip;9;0;0;9
9216;Raktelis;KAČIUKAI;8579864696;Ne;0;4;0;4
9217;Raktelis;KAČIUKAI;1393351147;Taip;0;5;0;5
9218;Raktelis;KAČIUKAI;27084497916;Taip;0;4;0;4
9219;Raktelis;KAČIUKAI;1063413424;Ne;6;8;0;14
9220;Raktelis;KAČIUKAI;4449411816;Taip;12;4;0;16
9221;Raktelis;KAČIUKAI;89139880068;Taip;0;2;0;2
9222;Raktelis;KAČIUKAI;1623046697;Taip;3;0;2;5
9223;Raktelis;KAČIUKAI;1468915955;Ne;0;4;0;4
9224;Raktelis;KAČIUKAI;87211875672;Taip;0;7;0;7
9225;Raktelis;KAČIUKAI;21063882404;Ne;12;0;0;12
9226;Raktelis;KAČIUKAI;78145437124;Taip;9;0;0;9
9227;Raktelis;KAČIUKAI;2143998936;Ne;0;7;0;7
9228;Raktelis;KAČIUKAI;1957572199;Taip;3;6;0;9
9229;Raktelis;KAČIUKAI;4906678347;Ne;6;4;0;10
9230;Raktelis;KAČIUKAI;1567546511;Taip;0;13;0;13
9231;Raktelis;KAČIUKAI;86883305675;Taip;0;6;0;6
9232;Raktelis;KAČIUKAI;9380332489;Taip;0;7;0;7
9233;Raktelis;KAČIUKAI;26727657814;Taip;2;2;0;4
9234;Raktelis;KAČIUKAI;30092089456;Ne;0;8;0;8
9235;Raktelis;KAČIUKAI;50372098009;Taip;0;8;0;8
9236;Raktelis;KAČIUKAI;1378192491;Taip;4;5;0;9
9237;Raktelis;KAČIUKAI;3180109604;Taip;15;0;0;15
9238;Raktelis;KAČIUKAI;1046075234;Taip;0;8;0;8
9239;Raktelis;KAČIUKAI;1457880868;Taip;17;1;0;18
9240;Raktelis;KAČIUKAI;4071338645;Ne;0;5;0;5
9241;Raktelis;PELIUKAI;2967941870;Taip;12;4;3;19
9242;Raktelis;PELIUKAI;8146076115;Taip;4;0;0;4
9243;Raktelis;PELIUKAI;2731096860;Taip;17;0;0;17
9244;Raktelis;PELIUKAI;2809458453;Taip;18;0;0;18
9245;Raktelis;PELIUKAI;6892006495;Taip;21;0;0;21
9246;Raktelis;PELIUKAI;3884068578;Taip;0;5;0;5
9247;Raktelis;PELIUKAI;1322912585;Taip;5;2;0;7
9248;Raktelis;PELIUKAI;4228614834;Taip;14;0;0;14
9249;Raktelis;PELIUKAI;4755892641;Taip;13;1;0;14
9250;Raktelis;PELIUKAI;8353427144;Taip;7;9;0;16
9251;Raktelis;PELIUKAI;7869495911;Taip;10;6;0;16
9252;Raktelis;PELIUKAI;4167194960;Taip;4;0;0;4
9253;Raktelis;PELIUKAI;3395720463;Taip;11;3;0;14
9254;Raktelis;PELIUKAI;9151796053;Taip;9;0;0;9
9255;Raktelis;PELIUKAI;5487606214;Taip;3;0;0;3
9256;Raktelis;PELIUKAI;7055894770;Taip;11;0;0;11
9257;Raktelis;LAPIUKŲ;7962509432;Taip;17;0;0;17
9258;Raktelis;LAPIUKŲ;9501202273;Taip;9;2;0;11
9259;Raktelis;LAPIUKŲ;98616285680;Taip;0;8;0;8
9260;Raktelis;LAPIUKŲ;67972824332;Taip;9;0;0;9
9261;Raktelis;LAPIUKŲ;54341630847;Taip;3;5;0;8
9262;Raktelis;LAPIUKŲ;4569798381;Taip;21;0;0;21
9263;Raktelis;LAPIUKŲ;67304194087;Taip;10;4;0;14
9264;Raktelis;LAPIUKŲ;15583558585;Taip;11;4;0;15
9265;Raktelis;LAPIUKŲ;2753402906;Taip;5;6;0;11
9266;Raktelis;LAPIUKŲ;4583377785;Taip;14;0;0;14
9267;Raktelis;LAPIUKŲ;8869030487;Taip;15;0;0;15
9268;Raktelis;LAPIUKŲ;5082785025;Taip;8;4;0;12
9269;Raktelis;LAPIUKŲ;8320696048;Taip;6;0;0;6
9270;Raktelis;LAPIUKŲ;9130613710;Taip;0;7;0;7
9271;Raktelis;LAPIUKŲ;1453677708;Taip;14;0;0;14
9272;Raktelis;LAPIUKŲ;9072312203;Taip;0;4;0;4
9273;Raktelis;LAPIUKŲ;2282754345;Taip;2;2;0;4
9274;Raktelis;LAPIUKŲ;1109105359;Ne;9;5;0;14
9275;Raktelis;LAPIUKŲ;5768653399;Taip;21;0;0;21
9276;Raktelis;LAPIUKŲ;5595087767;Taip;0;6;0;6
9277;Raktelis;LAPIUKŲ;6385127914;Taip;0;10;0;10
9278;Raktelis;LAPIUKŲ;3423529085;Taip;0;4;0;4
9279;Raktelis;LAPIUKŲ;5925441742;Taip;9;9;0;18
9280;Raktelis;LAPIUKŲ;9053427316;Taip;0;3;0;3
9281;Raktelis;LAPIUKŲ;8207675881;Taip;0;8;0;8
9282;Rasa;Nykštukai;3664125930;Ne;17;3;0;20
9283;Rasa;Nykštukai;5176175108;Taip;12;7;1;20
9284;Rasa;Nykštukai;3979273111;Taip;0;10;0;10
9285;Rasa;Nykštukai;4847544355;Taip;2;8;0;10
9286;Rasa;Nykštukai;9723040721;Taip;11;0;0;11
9287;Rasa;Nykštukai;7004232909;Taip;0;8;0;8
9288;Rasa;Nykštukai;1223962374;Taip;0;10;0;10
9289;Rasa;Nykštukai;3200377629;Ne;9;1;4;14
9290;Rasa;Nykštukai;1336291828;Taip;10;10;0;20
9291;Rasa;Nykštukai;5861229664;Taip;2;4;2;8
9292;Rasa;Nykštukai;1386880644;Taip;0;5;3;8
9293;Rasa;Nykštukai;2093263887;Taip;12;0;0;12
9294;Rasa;Nykštukai;2540124793;Taip;0;8;2;10
9295;Rasa;Nykštukai;5363748728;Taip;7;4;0;11
9296;Rasa;Nykštukai;2977737634;Taip;11;8;0;19
9297;Rasa;Nykštukai;8310400946;Taip;0;8;0;8
9298;Rasa;Nykštukai;7520665472;Taip;0;18;0;18
9299;Rasa;Nykštukai;7534306402;Taip;9;5;1;15
9300;Rasa;Nykštukai;3508648715;Ne;0;8;13;21
9301;Rasa;Meškiukai;8278928396;Taip;17;7;0;24
9302;Rasa;Meškiukai;8052120247;Taip;5;0;8;13
9303;Rasa;Meškiukai;1013865195;Taip;0;9;0;9
9304;Rasa;Meškiukai;2110008545;Ne;13;0;1;14
9305;Rasa;Meškiukai;72772661373;Taip;4;1;0;5
9306;Rasa;Meškiukai;63673920646;Taip;6;0;1;7
9307;Rasa;Meškiukai;52913880917;Taip;0;9;0;9
9308;Rasa;Meškiukai;5932187584;Ne;5;0;7;12
9309;Rasa;Meškiukai;5145978804;Ne;23;2;0;25
9310;Rasa;Meškiukai;8438563545;Taip;0;0;2;2
9311;Rasa;Meškiukai;6356448094;Taip;0;0;21;21
9312;Rasa;Meškiukai;2683897055;Taip;5;18;0;23
9313;Rasa;Meškiukai;4790859112;Taip;0;0;15;15
9314;Rasa;Meškiukai;7534548604;Taip;6;0;2;8
9315;Rasa;Meškiukai;5606722133;Taip;6;8;3;17
9316;Rasa;Meškiukai;7565880116;Taip;0;0;8;8
9317;Rasa;Meškiukai;7544963724;Taip;0;12;0;12
9318;Rasa;Meškiukai;3567565920;Ne;0;0;11;11
9319;Rasa;Meškiukai;6734478649;Taip;0;6;2;8
9320;Rasa;Meškiukai;4837280374;Ne;9;0;1;10
9321;Rasa;Sauliukai;3001023535;Ne;0;3;0;3
9322;Rasa;Sauliukai;95625598016;Taip;0;5;0;5
9323;Rasa;Sauliukai;1067614202;Ne;3;9;0;12
9324;Rasa;Sauliukai;29141190550;Taip;0;8;0;8
9325;Rasa;Sauliukai;59695217278;Taip;0;3;0;3
9326;Rasa;Sauliukai;87310376118;Taip;1;6;0;7
9327;Rasa;Sauliukai;32724807082;Taip;10;5;0;15
9328;Rasa;Sauliukai;69640669835;Taip;0;9;0;9
9329;Rasa;Sauliukai;36336738780;Taip;1;6;0;7
9330;Rasa;Sauliukai;1549153022;Taip;11;7;0;18
9331;Rasa;Sauliukai;59339333069;Taip;0;7;0;7
9332;Rasa;Sauliukai;1846631921;Taip;2;7;0;9
9333;Rasa;Sauliukai;96518910021;Taip;4;6;0;10
9334;Rasa;Sauliukai;59127440556;Taip;2;4;0;6
9335;Rasa;Sauliukai;99521832856;Taip;0;5;0;5
9336;Rasa;Sauliukai;26384431360;Taip;6;6;0;12
9337;Rasa;Sauliukai;1004116597;Taip;0;6;0;6
9338;Rasa;Sauliukai;1560278351;Taip;7;5;0;12
9339;Rasa;Sauliukai;1916783052;Ne;13;6;0;19
9340;Rasa;Sauliukai;6795591746;Ne;15;6;0;21
9341;Rasa;Smalsučiai;3281315532;Taip;0;5;0;5
9342;Rasa;Smalsučiai;13135367451;Taip;0;5;4;9
9343;Rasa;Smalsučiai;91941960564;Taip;6;4;0;10
9344;Rasa;Smalsučiai;1883458628;Taip;0;4;2;6
9345;Rasa;Smalsučiai;4601657045;Taip;8;5;3;16
9346;Rasa;Smalsučiai;1339376048;Taip;6;4;1;11
9347;Rasa;Smalsučiai;5201341227;Taip;0;4;0;4
9348;Rasa;Smalsučiai;2879767810;Taip;0;4;2;6
9349;Rasa;Smalsučiai;1267340581;Taip;0;4;1;5
9350;Rasa;Smalsučiai;88779978297;Taip;0;8;0;8
9351;Rasa;Smalsučiai;13286984288;Taip;2;4;0;6
9352;Rasa;Smalsučiai;1558712079;Taip;13;4;0;17
9353;Rasa;Smalsučiai;99911904705;Taip;0;3;0;3
9354;Rasa;Smalsučiai;79439306932;Taip;0;4;0;4
9355;Rasa;Smalsučiai;9890493148;Taip;7;6;0;13
9356;Rasa;Smalsučiai;25918582395;Ne;7;6;0;13
9357;Rasa;Smalsučiai;1311346161;Taip;9;5;0;14
9358;Rasa;Smalsučiai;77589878141;Taip;0;4;0;4
9359;Rasa;Smalsučiai;1581241275;Taip;7;4;2;13
9360;Rasa;Smalsučiai;1658948426;Taip;0;4;0;4
9361;Rasa;Smalsučiai;1803769089;Taip;0;9;1;10
9362;Rasa;"Pelėdžiukai ";1176606744;Taip;8;0;0;8
9363;Rasa;"Pelėdžiukai ";2121070882;Taip;0;15;0;15
9364;Rasa;"Pelėdžiukai ";1457384318;Taip;13;0;1;14
9365;Rasa;"Pelėdžiukai ";3884105235;Taip;16;8;0;24
9366;Rasa;"Pelėdžiukai ";1726266997;Ne;6;0;1;7
9367;Rasa;"Pelėdžiukai ";6704162447;Taip;0;7;0;7
9368;Rasa;"Pelėdžiukai ";7558966891;Taip;2;0;6;8
9369;Rasa;"Pelėdžiukai ";6773004268;Ne;14;0;8;22
9370;Rasa;"Pelėdžiukai ";3023088027;Taip;0;8;0;8
9371;Rasa;"Pelėdžiukai ";8953448462;Ne;11;0;0;11
9372;Rasa;"Pelėdžiukai ";5325275053;Taip;15;7;0;22
9373;Rasa;"Pelėdžiukai ";4758605343;Taip;0;0;15;15
9374;Rasa;"Pelėdžiukai ";3848448401;Ne;0;6;0;6
9375;Rasa;"Pelėdžiukai ";4542122478;Taip;14;0;3;17
9376;Rasa;"Pelėdžiukai ";2962815301;Taip;12;0;2;14
9377;Rasa;"Pelėdžiukai ";4084236196;Taip;5;0;2;7
9378;Rasa;"Pelėdžiukai ";8912031554;Taip;7;0;2;9
9379;Rasa;"Pelėdžiukai ";3091012313;Ne;11;0;0;11
9380;Rasa;Katinėliai;5885520521;Taip;10;1;1;12
9381;Rasa;Katinėliai;7730322729;Taip;0;5;1;6
9382;Rasa;Katinėliai;2170134084;Taip;0;4;0;4
9383;Rasa;Katinėliai;3657956842;Ne;3;0;2;5
9384;Rasa;Katinėliai;6891623055;Taip;5;0;1;6
9385;Rasa;Katinėliai;9010812748;Taip;7;8;0;15
9386;Rasa;Katinėliai;7220007488;Taip;0;15;0;15
9387;Rasa;Katinėliai;8235869241;Taip;14;0;0;14
9388;Rasa;Katinėliai;3135828190;Ne;3;5;4;12
9389;Rasa;Katinėliai;2984661168;Taip;13;0;4;17
9390;Rasa;Katinėliai;4913483444;Taip;14;4;0;18
9391;Rasa;Katinėliai;7142481458;Taip;2;6;0;8
9392;Rasa;Katinėliai;7314537168;Taip;11;0;3;14
9393;Rasa;Katinėliai;4734775151;Taip;17;0;4;21
9394;Rasa;Katinėliai;4758138905;Taip;9;6;0;15
9395;Rasa;Katinėliai;9447346901;Taip;6;0;2;8
9396;Rasa;Ančiukai;7185331699;Taip;9;0;0;9
9397;Rasa;Ančiukai;1060810039;Taip;9;0;0;9
9398;Rasa;Ančiukai;9599510902;Taip;9;0;3;12
9399;Rasa;Ančiukai;7037958994;Taip;11;9;0;20
9400;Rasa;Ančiukai;9668538340;Taip;7;11;0;18
9401;Rasa;Ančiukai;4795339259;Taip;0;10;0;10
9402;Rasa;Ančiukai;6019853365;Ne;0;16;0;16
9403;Rasa;Ančiukai;4694111253;Taip;0;8;0;8
9404;Rasa;Ančiukai;7028605422;Taip;7;18;0;25
9405;Rasa;Ančiukai;2711923397;Taip;18;0;1;19
9406;Rasa;Ančiukai;2800420481;Taip;9;0;4;13
9407;Rasa;Ančiukai;5869253167;Taip;6;0;3;9
9408;Rasa;Ančiukai;3475601049;Taip;11;0;3;14
9409;Rasa;Ančiukai;6887471189;Taip;9;0;1;10
9410;Rasa;Ančiukai;6011243039;Taip;0;0;3;3
9411;Rasa;Ančiukai;8236785255;Taip;9;6;0;15
9412;Rasa;"Vyturiukai ";1210203141;Taip;2;8;3;13
9413;Rasa;"Vyturiukai ";7575833127;Taip;0;0;13;13
9414;Rasa;"Vyturiukai ";27131705540;Taip;0;11;0;11
9415;Rasa;"Vyturiukai ";1823276800;Taip;11;6;4;21
9416;Rasa;"Vyturiukai ";1651905746;Taip;5;6;0;11
9417;Rasa;"Vyturiukai ";1940633287;Taip;0;8;2;10
9418;Rasa;"Vyturiukai ";66103644564;Taip;0;4;1;5
9419;Rasa;"Vyturiukai ";73115061371;Taip;0;14;0;14
9420;Rasa;"Vyturiukai ";1049242346;Taip;0;0;11;11
9421;Rasa;"Vyturiukai ";1179402963;Taip;0;10;0;10
9422;Rasa;"Vyturiukai ";1210340955;Taip;0;14;0;14
9423;Rasa;"Vyturiukai ";83227920971;Ne;0;9;0;9
9424;Rasa;"Vyturiukai ";34934099958;Taip;0;10;0;10
9425;Rasa;"Vyturiukai ";84161884493;Taip;0;2;1;3
9426;Rasa;"Vyturiukai ";1214055260;Taip;6;7;0;13
9427;Rasa;"Vyturiukai ";2041098301;Taip;0;9;0;9
9428;Rasa;"Vyturiukai ";71420694152;Ne;2;0;12;14
9429;Rasa;"Vyturiukai ";1477555365;Taip;0;19;0;19
9430;Rasa;"Vyturiukai ";6344169010;Taip;0;8;1;9
9431;Rasa;"Vyturiukai ";9438727789;Taip;5;8;2;15
9432;Rasa;Voveriukai;1728275988;Taip;16;4;0;20
9433;Rasa;Voveriukai;74744565967;Taip;9;1;0;10
9434;Rasa;Voveriukai;2158444381;Taip;0;8;0;8
9435;Rasa;Voveriukai;5589971159;Taip;0;0;1;1
9436;Rasa;Voveriukai;2980868154;Ne;0;15;0;15
9437;Rasa;Voveriukai;8749177123;Ne;0;12;0;12
9438;Rasa;Voveriukai;4065614217;Taip;19;4;0;23
9439;Rasa;Voveriukai;15257986685;Taip;0;18;0;18
9440;Rasa;Voveriukai;6198612392;Taip;6;6;0;12
9441;Rasa;Voveriukai;1900027524;Ne;0;10;2;12
9442;Rasa;Voveriukai;5108279813;Ne;0;13;0;13
9443;Rasa;Voveriukai;2349860704;Taip;0;6;2;8
9444;Rasa;Voveriukai;1704518157;Taip;3;0;0;3
9445;Rasa;Voveriukai;8983800071;Ne;0;4;1;5
9446;Rasa;Voveriukai;9086339064;Taip;12;0;0;12
9447;Rasa;"DRUGELIAI ";9140875020;Ne;13;7;0;20
9448;Rasa;"DRUGELIAI ";9229817861;Taip;18;0;2;20
9449;Rasa;"DRUGELIAI ";6535561634;Taip;5;0;2;7
9450;Rasa;"DRUGELIAI ";1206005039;Taip;11;0;0;11
9451;Rasa;"DRUGELIAI ";9788282861;Taip;17;7;0;24
9452;Rasa;"DRUGELIAI ";6311322617;Taip;7;1;0;8
9453;Rasa;"DRUGELIAI ";8595804874;Taip;9;0;0;9
9454;Rasa;"DRUGELIAI ";3073804713;Taip;5;8;0;13
9455;Rasa;"DRUGELIAI ";9677810607;Taip;21;0;3;24
9456;Rasa;"DRUGELIAI ";1466616814;Taip;24;0;0;24
9457;Rasa;"DRUGELIAI ";6632875947;Taip;5;0;1;6
9458;Rasa;"DRUGELIAI ";5165588335;Taip;19;0;0;19
9459;Rasa;"DRUGELIAI ";1796573723;Taip;2;10;0;12
9460;Rasa;"DRUGELIAI ";5719253028;Taip;11;0;0;11
9461;Rasa;"DRUGELIAI ";5710220699;Taip;0;10;0;10
9462;Rasa;Zuikučiai;4554377449;Taip;0;2;0;2
9463;Rasa;Zuikučiai;2137321989;Taip;0;15;0;15
9464;Rasa;Zuikučiai;1432856662;Taip;0;4;0;4
9465;Rasa;Zuikučiai;1993471951;Taip;14;1;0;15
9466;Rasa;Zuikučiai;1860462451;Taip;18;0;0;18
9467;Rasa;Zuikučiai;42609897431;Taip;0;0;1;1
9468;Rasa;Zuikučiai;55374082940;Taip;0;16;0;16
9469;Rasa;Zuikučiai;2114613635;Taip;11;1;0;12
9470;Rasa;Zuikučiai;56016538926;Taip;9;0;0;9
9471;Rasa;Zuikučiai;7397794681;Taip;7;5;0;12
9472;Rasa;Zuikučiai;13297122928;Taip;10;2;0;12
9473;Rasa;Zuikučiai;6108187043;Taip;0;11;0;11
9474;Rasa;Zuikučiai;1690518970;Taip;0;9;0;9
9475;Rasa;Zuikučiai;1131418692;Taip;0;6;0;6
9476;Rasa;Zuikučiai;7065597550;Ne;12;3;0;15
9477;Rasa;Zuikučiai;72152762554;Taip;0;7;0;7
9478;Rasa;Zuikučiai;68980971096;Ne;0;10;0;10
9479;Rasa;Zuikučiai;9432880035;Taip;0;16;0;16
9480;Rasa;Širdelė;56168039878;Taip;8;5;0;13
9481;Rasa;Širdelė;8424049317;Ne;15;1;0;16
9482;Rasa;Širdelė;5599182715;Taip;0;18;0;18
9483;Rasa;Širdelė;9648034081;Ne;2;11;0;13
9484;Rasa;Širdelė;33479419656;Taip;0;12;0;12
9485;Rasa;Širdelė;8236464670;Ne;0;17;0;17
9486;Rasa;Širdelė;1271820053;Ne;8;1;2;11
9487;Rasa;Širdelė;2626361958;Taip;8;0;1;9
9488;Rasa;Širdelė;5426981046;Taip;0;13;0;13
9489;Rasa;Širdelė;2840872613;Taip;0;12;0;12
9490;Rasa;Širdelė;23600769349;Taip;0;10;0;10
9491;Rasa;Širdelė;6976298054;Taip;17;0;0;17
9492;Rasa;Širdelė;91931863004;Taip;13;6;0;19
9493;Rasa;Širdelė;3668598028;Taip;13;6;0;19
9494;Rasa;Širdelė;58858081077;Taip;0;14;0;14
9495;Rasa;Širdelė;2132535297;Taip;15;1;0;16
9496;Rasa;Širdelė;2133989183;Taip;0;8;1;9
9497;Rasa;Širdelė;8866896989;Taip;0;24;0;24
9498;Rasa;Širdelė;9938280570;Taip;19;4;0;23
9499;Rasa;Širdelė;2333938367;Taip;7;10;0;17
9500;Riešutėlis;Viščiukų;1782544949;Taip;0;13;0;13
9501;Riešutėlis;Viščiukų;91799192513;Taip;7;10;0;17
9502;Riešutėlis;Viščiukų;50427986973;Taip;13;2;0;15
9503;Riešutėlis;Viščiukų;4098825502;Taip;11;2;0;13
9504;Riešutėlis;Viščiukų;28855582790;Taip;5;5;0;10
9505;Riešutėlis;Viščiukų;41275727334;Taip;5;0;0;5
9506;Riešutėlis;Viščiukų;98456292572;Taip;0;8;0;8
9507;Riešutėlis;Viščiukų;63919369801;Taip;8;2;0;10
9508;Riešutėlis;Viščiukų;2146831972;Taip;0;1;0;1
9509;Riešutėlis;Viščiukų;61571638960;Taip;5;7;1;13
9510;Riešutėlis;Viščiukų;8857939937;Taip;0;4;0;4
9511;Riešutėlis;Viščiukų;1957794151;Taip;10;3;0;13
9512;Riešutėlis;Viščiukų;5520818573;Taip;0;4;0;4
9513;Riešutėlis;Viščiukų;1743324657;Taip;7;2;0;9
9514;Riešutėlis;Viščiukų;1792212841;Taip;2;7;2;11
9515;Riešutėlis;Viščiukų;86455801201;Taip;9;0;1;10
9516;Riešutėlis;Viščiukų;93958381534;Taip;0;6;0;6
9517;Riešutėlis;Viščiukų;1532275496;Taip;2;5;0;7
9518;Riešutėlis;Viščiukų;4311016578;Taip;19;0;0;19
9519;Riešutėlis;Viščiukų;8927730307;Ne;16;0;1;17
9520;Riešutėlis;Viščiukų;6855553238;Taip;6;6;4;16
9521;Riešutėlis;Viščiukų;1930481567;Taip;7;3;0;10
9522;Riešutėlis;Viščiukų;4229384438;Taip;0;12;0;12
9523;Riešutėlis;"Riešutėliai ";8077135868;Ne;11;1;1;13
9524;Riešutėlis;"Riešutėliai ";84116863778;Taip;0;4;1;5
9525;Riešutėlis;"Riešutėliai ";1077680441;Ne;0;1;6;7
9526;Riešutėlis;"Riešutėliai ";6097581240;Taip;5;3;0;8
9527;Riešutėlis;"Riešutėliai ";55620350407;Taip;3;0;0;3
9528;Riešutėlis;"Riešutėliai ";57437627642;Ne;0;5;0;5
9529;Riešutėlis;"Riešutėliai ";1105598415;Taip;0;0;6;6
9530;Riešutėlis;"Riešutėliai ";11913461630;Taip;17;4;0;21
9531;Riešutėlis;"Riešutėliai ";1674871670;Taip;0;10;1;11
9532;Riešutėlis;"Riešutėliai ";1853283967;Taip;2;4;1;7
9533;Riešutėlis;"Riešutėliai ";49061075792;Taip;15;0;0;15
9534;Riešutėlis;"Riešutėliai ";1858221034;Ne;5;7;0;12
9535;Riešutėlis;"Riešutėliai ";3806836220;Taip;0;6;2;8
9536;Riešutėlis;"Riešutėliai ";16308059025;Taip;14;0;1;15
9537;Riešutėlis;"Riešutėliai ";9023304543;Taip;7;2;0;9
9538;Riešutėlis;"Riešutėliai ";4404544549;Taip;1;2;13;16
9539;Riešutėlis;"Riešutėliai ";85356230208;Taip;7;1;0;8
9540;Riešutėlis;"Riešutėliai ";85066293475;Taip;0;2;0;2
9541;Riešutėlis;Ežiukai;7030346495;Taip;9;5;0;14
9542;Riešutėlis;Ežiukai;9750713954;Taip;8;7;0;15
9543;Riešutėlis;Ežiukai;9476688736;Taip;2;19;0;21
9544;Riešutėlis;Ežiukai;7601776182;Taip;0;6;0;6
9545;Riešutėlis;Ežiukai;7381623086;Taip;10;3;0;13
9546;Riešutėlis;Ežiukai;9964688413;Taip;18;0;0;18
9547;Riešutėlis;Ežiukai;1548585448;Taip;10;0;1;11
9548;Riešutėlis;Ežiukai;9088123796;Taip;0;0;21;21
9549;Riešutėlis;Ežiukai;8954127616;Taip;10;0;1;11
9550;Riešutėlis;Ežiukai;2092933906;Taip;12;6;0;18
9551;Riešutėlis;Ežiukai;6813024366;Taip;5;2;0;7
9552;Riešutėlis;Ežiukai;7913381005;Taip;8;5;0;13
9553;Riešutėlis;Ežiukai;3460145784;Ne;4;0;0;4
9554;Riešutėlis;Ežiukai;8480059272;Ne;17;0;1;18
9555;Riešutėlis;Ežiukai;5728858361;Ne;4;2;3;9
9556;Riešutėlis;Ežiukai;8721736343;Taip;10;9;0;19
9557;Riešutėlis;Ežiukai;5327627748;Taip;13;2;0;15
9558;Riešutėlis;Ežiukai;2397854323;Taip;17;0;0;17
9559;Riešutėlis;Ežiukai;6259158270;Taip;5;0;12;17
9560;Riešutėlis;Ežiukai;6194259707;Taip;4;3;0;7
9561;Riešutėlis;Pelėdžiukai;6303767779;Taip;0;0;4;4
9562;Riešutėlis;Pelėdžiukai;7198434243;Taip;0;4;0;4
9563;Riešutėlis;Pelėdžiukai;8018914251;Taip;0;1;4;5
9564;Riešutėlis;Pelėdžiukai;8012201566;Taip;17;0;0;17
9565;Riešutėlis;Pelėdžiukai;8751571852;Taip;16;0;1;17
9566;Riešutėlis;Pelėdžiukai;5479780116;Taip;10;0;0;10
9567;Riešutėlis;Pelėdžiukai;7225365172;Ne;4;1;0;5
9568;Riešutėlis;Pelėdžiukai;9839084885;Taip;2;4;0;6
9569;Riešutėlis;Pelėdžiukai;6928558714;Ne;21;0;0;21
9570;Riešutėlis;Pelėdžiukai;9040123535;Ne;8;5;0;13
9571;Riešutėlis;Pelėdžiukai;6405116059;Taip;13;0;1;14
9572;Riešutėlis;Pelėdžiukai;5995176001;Taip;0;4;0;4
9573;Riešutėlis;Pelėdžiukai;2430518637;Taip;18;0;0;18
9574;Riešutėlis;Pelėdžiukai;3970874098;Taip;10;0;0;10
9575;Riešutėlis;Pelėdžiukai;4451419273;Taip;21;0;0;21
9576;Riešutėlis;Pelėdžiukai;1638021880;Taip;13;0;1;14
9577;Riešutėlis;Pelėdžiukai;4581184004;Taip;4;0;1;5
9578;Riešutėlis;Pelėdžiukai;5598052531;Taip;14;0;1;15
9579;Riešutėlis;Pelėdžiukai;5282039544;Ne;5;0;0;5
9580;Riešutėlis;Meškiukai;4004669930;Taip;8;0;0;8
9581;Riešutėlis;Meškiukai;3920525584;Taip;4;0;1;5
9582;Riešutėlis;Meškiukai;6721758785;Taip;0;6;1;7
9583;Riešutėlis;Meškiukai;5753609922;Taip;21;0;0;21
9584;Riešutėlis;Meškiukai;3694146893;Taip;4;0;2;6
9585;Riešutėlis;Meškiukai;1748151109;Ne;13;6;0;19
9586;Riešutėlis;Meškiukai;4233170371;Taip;0;0;21;21
9587;Riešutėlis;Meškiukai;8738716660;Taip;6;0;2;8
9588;Riešutėlis;Meškiukai;1528972517;Taip;0;8;0;8
9589;Riešutėlis;Meškiukai;7177632315;Taip;0;2;3;5
9590;Riešutėlis;Meškiukai;6292679662;Taip;14;0;0;14
9591;Riešutėlis;Meškiukai;3077468722;Taip;10;8;0;18
9592;Riešutėlis;Meškiukai;4293402095;Taip;0;21;0;21
9593;Riešutėlis;Meškiukai;4828635362;Taip;7;0;0;7
9594;Riešutėlis;Meškiukai;8504832383;Taip;9;0;1;10
9595;Riešutėlis;Kiškučiai;90088217854;Ne;0;2;0;2
9596;Riešutėlis;Kiškučiai;49061132665;Taip;0;5;0;5
9597;Riešutėlis;Kiškučiai;92159110899;Taip;8;0;2;10
9598;Riešutėlis;Kiškučiai;1623455993;Taip;6;1;0;7
9599;Riešutėlis;Kiškučiai;4464545735;Taip;0;11;0;11
9600;Riešutėlis;Kiškučiai;96066602684;Ne;3;4;3;10
9601;Riešutėlis;Kiškučiai;55715445788;Taip;9;1;0;10
9602;Riešutėlis;Kiškučiai;1747328573;Taip;10;2;1;13
9603;Riešutėlis;Kiškučiai;1250209796;Ne;2;7;0;9
9604;Riešutėlis;Kiškučiai;1526573984;Taip;4;2;2;8
9605;Riešutėlis;Kiškučiai;50338275044;Taip;0;6;0;6
9606;Riešutėlis;Kiškučiai;18310744085;Taip;0;8;0;8
9607;Riešutėlis;Kiškučiai;35876952602;Taip;2;2;4;8
9608;Riešutėlis;Kiškučiai;1748738558;Taip;5;5;0;10
9609;Riešutėlis;Kiškučiai;93192056557;Taip;0;8;0;8
9610;Riešutėlis;Kiškučiai;9205961122;Taip;7;0;1;8
9611;Riešutėlis;Kiškučiai;2163433983;Taip;5;2;4;11
9612;Riešutėlis;Kiškučiai;4916885450;Taip;0;0;21;21
9613;Riešutėlis;Kiškučiai;8864100655;Taip;6;0;0;6
9614;Riešutėlis;Kiškučiai;6149891188;Taip;6;0;0;6
9615;Riešutėlis;Voveriukų;6130980726;Ne;9;5;0;14
9616;Riešutėlis;Voveriukų;6500567162;Taip;0;12;0;12
9617;Riešutėlis;Voveriukų;9081486438;Taip;0;7;0;7
9618;Riešutėlis;Voveriukų;1212829190;Taip;0;8;0;8
9619;Riešutėlis;Voveriukų;59279444190;Taip;6;4;0;10
9620;Riešutėlis;Voveriukų;31417468379;Taip;0;3;0;3
9621;Riešutėlis;Voveriukų;1065105725;Ne;0;5;0;5
9622;Riešutėlis;Voveriukų;36176126840;Taip;7;4;0;11
9623;Riešutėlis;Voveriukų;26053212952;Taip;0;5;0;5
9624;Riešutėlis;Voveriukų;51840071269;Taip;0;5;0;5
9625;Riešutėlis;Voveriukų;70549617521;Taip;5;3;0;8
9626;Riešutėlis;Voveriukų;36161702165;Ne;18;0;0;18
9627;Riešutėlis;Voveriukų;46444683383;Taip;0;3;0;3
9628;Riešutėlis;Voveriukų;92166220283;Taip;0;4;0;4
9629;Riešutėlis;Voveriukų;2163248156;Taip;7;0;0;7
9630;Riešutėlis;Voveriukų;43038393551;Taip;7;4;0;11
9631;Riešutėlis;Voveriukų;56426084480;Taip;0;10;0;10
9632;Riešutėlis;Voveriukų;65629075580;Taip;0;7;0;7
9633;Riešutėlis;Voveriukų;50971787753;Taip;0;4;0;4
9634;Riešutėlis;Voveriukų;89384403521;Taip;0;9;0;9
9635;Riešutėlis;Voveriukų;6701821406;Taip;0;4;0;4
9636;Riešutėlis;Voveriukų;64736615832;Ne;0;4;0;4
9637;Riešutėlis;Voveriukų;29751938918;Taip;10;4;0;14
9638;Riešutėlis;Saulutės;9198963882;Ne;0;2;1;3
9639;Riešutėlis;Saulutės;2111280879;Taip;5;0;1;6
9640;Riešutėlis;Saulutės;1190403952;Taip;8;0;1;9
9641;Riešutėlis;Saulutės;1160573638;Taip;0;7;0;7
9642;Riešutėlis;Saulutės;1056034480;Ne;5;4;5;14
9643;Riešutėlis;Saulutės;2097580659;Taip;4;0;0;4
9644;Riešutėlis;Saulutės;2112179980;Ne;7;5;0;12
9645;Riešutėlis;Saulutės;2851186469;Taip;10;0;1;11
9646;Riešutėlis;Saulutės;7207507008;Ne;0;2;3;5
9647;Riešutėlis;Saulutės;8749505821;Taip;0;7;0;7
9648;Riešutėlis;Saulutės;1169051233;Taip;0;2;0;2
9649;Riešutėlis;Saulutės;1091941952;Taip;0;6;0;6
9650;Riešutėlis;Saulutės;24776322315;Taip;4;0;1;5
9651;Riešutėlis;Saulutės;7912773569;Taip;9;0;0;9
9652;Riešutėlis;Saulutės;2655848313;Taip;7;4;2;13
9653;Riešutėlis;Saulutės;4898775561;Taip;0;1;0;1
9654;Riešutėlis;Saulutės;6402032861;Taip;12;0;1;13
9655;Riešutėlis;Saulutės;5717194707;Taip;0;2;0;2
9656;Riešutėlis;Saulutės;5537309549;Ne;0;2;4;6
9657;Riešutėlis;Saulutės;8271632629;Taip;0;1;0;1
9658;Riešutėlis;"Boruželės ";16561622902;Taip;0;7;0;7
9659;Riešutėlis;"Boruželės ";56117509354;Taip;9;6;0;15
9660;Riešutėlis;"Boruželės ";1936519033;Taip;0;8;1;9
9661;Riešutėlis;"Boruželės ";2611705234;Taip;3;0;0;3
9662;Riešutėlis;"Boruželės ";4131218911;Taip;2;6;0;8
9663;Riešutėlis;"Boruželės ";1455509576;Taip;9;0;0;9
9664;Riešutėlis;"Boruželės ";4701887030;Taip;7;2;1;10
9665;Riešutėlis;"Boruželės ";3577669231;Taip;9;1;0;10
9666;Riešutėlis;"Boruželės ";9670912357;Taip;9;3;0;12
9667;Riešutėlis;"Boruželės ";26781529460;Taip;10;0;0;10
9668;Riešutėlis;"Boruželės ";5097410462;Taip;9;0;0;9
9669;Riešutėlis;"Boruželės ";4344185375;Taip;0;3;2;5
9670;Riešutėlis;"Boruželės ";4041498684;Taip;0;8;0;8
9671;Riešutėlis;"Boruželės ";8087180983;Taip;3;0;11;14
9672;Riešutėlis;"Boruželės ";4276034784;Taip;0;4;2;6
9673;Riešutėlis;"Boruželės ";2566084613;Taip;0;10;4;14
9674;Riešutėlis;"Boruželės ";1640383686;Taip;7;4;1;12
9675;Riešutėlis;"Boruželės ";3851000866;Taip;9;2;2;13
9676;Riešutėlis;"Boruželės ";1623681835;Ne;7;1;0;8
9677;Riešutėlis;"Boruželės ";1818130297;Taip;7;10;0;17
9678;Riešutėlis;"Bitutės ";1000408690;Taip;17;1;0;18
9679;Riešutėlis;"Bitutės ";3149710709;Taip;0;1;0;1
9680;Riešutėlis;"Bitutės ";1918857028;Taip;0;1;0;1
9681;Riešutėlis;"Bitutės ";1686215195;Taip;0;1;0;1
9682;Riešutėlis;"Bitutės ";54011982803;Taip;0;5;0;5
9683;Riešutėlis;"Bitutės ";2395648260;Taip;16;5;0;21
9684;Riešutėlis;"Bitutės ";86647499063;Ne;0;1;0;1
9685;Riešutėlis;"Bitutės ";4188823834;Taip;6;0;0;6
9686;Riešutėlis;"Bitutės ";59796628656;Taip;11;0;0;11
9687;Riešutėlis;"Bitutės ";6852846350;Taip;6;1;0;7
9688;Riešutėlis;"Bitutės ";13815744901;Taip;7;2;0;9
9689;Riešutėlis;"Bitutės ";91430094368;Taip;0;6;0;6
9690;Riešutėlis;"Bitutės ";65873300738;Taip;0;6;0;6
9691;Riešutėlis;"Bitutės ";8313605541;Taip;5;0;1;6
9692;Riešutėlis;"Bitutės ";1921241349;Taip;4;1;3;8
9693;Riešutėlis;"Bitutės ";7987368969;Taip;0;12;0;12
9694;Riešutėlis;"Bitutės ";85564700996;Taip;5;0;1;6
9695;Riešutėlis;"Bitutės ";9092861254;Ne;18;0;0;18
9696;Riešutėlis;Drugelių;8266735624;Taip;0;2;0;2
9697;Riešutėlis;Drugelių;4776231497;Taip;0;2;0;2
9698;Riešutėlis;Drugelių;8578903763;Taip;13;7;0;20
9699;Riešutėlis;Drugelių;7769079730;Taip;0;1;5;6
9700;Riešutėlis;Drugelių;5811657782;Taip;6;0;1;7
9701;Riešutėlis;Drugelių;4221375847;Taip;0;4;0;4
9702;Riešutėlis;Drugelių;1075842434;Taip;4;0;2;6
9703;Riešutėlis;Drugelių;1942944625;Taip;5;5;0;10
9704;Riešutėlis;Drugelių;8845709386;Taip;0;7;1;8
9705;Riešutėlis;Drugelių;8352146446;Taip;0;4;0;4
9706;Riešutėlis;Drugelių;8180618419;Ne;0;4;0;4
9707;Riešutėlis;Drugelių;5412882446;Taip;4;0;1;5
9708;Riešutėlis;Drugelių;8020533200;Taip;0;10;1;11
9709;Riešutėlis;Drugelių;1164273595;Ne;21;0;0;21
9710;Riešutėlis;Drugelių;8918753084;Taip;2;0;0;2
9711;Riešutėlis;Drugelių;3836374000;Taip;11;0;0;11
9712;Riešutėlis;Drugelių;8016820352;Taip;7;1;1;9
9713;Riešutėlis;Drugelių;3975091711;Taip;0;1;4;5
9714;Riešutėlis;Drugelių;3071643137;Taip;3;8;1;12
9715;Riešutėlis;Drugelių;2599147931;Taip;5;7;0;12
9716;Ramunėlė;SAULUTĖS;19664665864;Ne;0;10;0;10
9717;Ramunėlė;SAULUTĖS;44016905818;Taip;0;6;0;6
9718;Ramunėlė;SAULUTĖS;19784681244;Ne;0;10;0;10
9719;Ramunėlė;SAULUTĖS;9266024764;Taip;0;9;0;9
9720;Ramunėlė;SAULUTĖS;94707638226;Taip;0;5;0;5
9721;Ramunėlė;SAULUTĖS;69367849602;Taip;0;8;0;8
9722;Ramunėlė;SAULUTĖS;27163734018;Ne;0;11;0;11
9723;Ramunėlė;SAULUTĖS;2089805114;Taip;2;3;2;7
9724;Ramunėlė;SAULUTĖS;1079295964;Taip;6;1;0;7
9725;Ramunėlė;SAULUTĖS;26568396284;Ne;0;6;2;8
9726;Ramunėlė;SAULUTĖS;1982905923;Taip;0;7;1;8
9727;Ramunėlė;SAULUTĖS;16577268434;Taip;0;5;0;5
9728;Ramunėlė;SAULUTĖS;3599929268;Taip;0;3;0;3
9729;Ramunėlė;SAULUTĖS;80319760551;Taip;0;6;0;6
9730;Ramunėlė;SAULUTĖS;43737882488;Taip;0;5;0;5
9731;Ramunėlė;SAULUTĖS;72681762872;Taip;0;2;0;2
9732;Ramunėlė;SAULUTĖS;37338389480;Taip;0;2;0;2
9733;Ramunėlė;SAULUTĖS;7736649569;Taip;0;2;0;2
9734;Ramunėlė;SAULUTĖS;97944093065;Taip;0;5;0;5
9735;Ramunėlė;SAULUTĖS;85972695257;Taip;0;1;0;1
9736;Ramunėlė;SAULUTĖS;99807372989;Taip;0;8;0;8
9737;Ramunėlė;SAULUTĖS;42746084302;Taip;2;7;0;9
9738;Ramunėlė;SAULUTĖS;18362159086;Taip;13;5;0;18
9739;Ramunėlė;ŽIBUTĖ;2127262855;Taip;0;4;0;4
9740;Ramunėlė;ŽIBUTĖ;71451001033;Taip;2;3;1;6
9741;Ramunėlė;ŽIBUTĖ;8943746426;Taip;0;10;0;10
9742;Ramunėlė;ŽIBUTĖ;57697488265;Taip;12;7;0;19
9743;Ramunėlė;ŽIBUTĖ;4103951942;Taip;0;5;0;5
9744;Ramunėlė;ŽIBUTĖ;37227575121;Ne;0;11;0;11
9745;Ramunėlė;ŽIBUTĖ;9615607625;Taip;0;10;0;10
9746;Ramunėlė;ŽIBUTĖ;24395304267;Ne;11;2;0;13
9747;Ramunėlė;ŽIBUTĖ;41210974793;Taip;2;2;9;13
9748;Ramunėlė;ŽIBUTĖ;78632810141;Taip;8;4;0;12
9749;Ramunėlė;ŽIBUTĖ;8826277893;Ne;0;3;0;3
9750;Ramunėlė;ŽIBUTĖ;1686559920;Taip;10;7;0;17
9751;Ramunėlė;ŽIBUTĖ;1383896021;Taip;0;2;4;6
9752;Ramunėlė;ŽIBUTĖ;1898089064;Taip;7;6;0;13
9753;Ramunėlė;ŽIBUTĖ;6126971384;Taip;4;3;0;7
9754;Ramunėlė;ŽIBUTĖ;21178777924;Taip;10;2;0;12
9755;Ramunėlė;ŽIBUTĖ;1845973626;Taip;0;17;0;17
9756;Ramunėlė;ŽIBUTĖ;1575204445;Taip;2;0;0;2
9757;Ramunėlė;ŽIBUTĖ;2069380818;Taip;8;4;0;12
9758;Ramunėlė;ŽIBUTĖ;1511271386;Ne;0;5;0;5
9759;Ramunėlė;ŽIRNIUKAI;11512621396;Taip;0;6;0;6
9760;Ramunėlė;ŽIRNIUKAI;3973083939;Taip;0;6;0;6
9761;Ramunėlė;ŽIRNIUKAI;53748116108;Taip;0;1;0;1
9762;Ramunėlė;ŽIRNIUKAI;1028730863;Taip;0;4;0;4
9763;Ramunėlė;ŽIRNIUKAI;1085668968;Taip;0;2;0;2
9764;Ramunėlė;ŽIRNIUKAI;2075485387;Taip;0;6;0;6
9765;Ramunėlė;ŽIRNIUKAI;2036562086;Taip;0;3;0;3
9766;Ramunėlė;ŽIRNIUKAI;85179822339;Taip;0;2;0;2
9767;Ramunėlė;ŽIRNIUKAI;57963557951;Taip;0;4;0;4
9768;Ramunėlė;ŽIRNIUKAI;9924675250;Taip;0;2;0;2
9769;Ramunėlė;ŽIRNIUKAI;1386186515;Taip;0;0;10;10
9770;Ramunėlė;ŽIRNIUKAI;1364997950;Taip;0;9;0;9
9771;Ramunėlė;ŽIRNIUKAI;1171170929;Taip;0;2;4;6
9772;Ramunėlė;ŽIRNIUKAI;10677635919;Taip;0;7;0;7
9773;Ramunėlė;ŽIRNIUKAI;1157861595;Taip;0;4;2;6
9774;Ramunėlė;ŽIRNIUKAI;1397784717;Taip;4;0;0;4
9775;Ramunėlė;ŽIRNIUKAI;17292085814;Taip;0;6;0;6
9776;Ramunėlė;ŽIRNIUKAI;1500685962;Ne;0;13;0;13
9777;Ramunėlė;ŽIRNIUKAI;4814208279;Ne;7;1;0;8
9778;Ramunėlė;ŽIRNIUKAI;8254302108;Taip;2;0;0;2
9779;Ramunėlė;ŽIRNIUKAI;60610765717;Taip;0;9;2;11
9780;Ramunėlė;BITUTĖS;23095478847;Taip;2;10;0;12
9781;Ramunėlė;BITUTĖS;1866642357;Ne;0;7;0;7
9782;Ramunėlė;BITUTĖS;1343249939;Taip;0;5;5;10
9783;Ramunėlė;BITUTĖS;95100104105;Ne;0;4;0;4
9784;Ramunėlė;BITUTĖS;32249506035;Taip;17;0;0;17
9785;Ramunėlė;BITUTĖS;42582811243;Taip;0;8;0;8
9786;Ramunėlė;BITUTĖS;3683430430;Taip;4;8;0;12
9787;Ramunėlė;BITUTĖS;4101387438;Taip;5;2;2;9
9788;Ramunėlė;BITUTĖS;16357824257;Taip;0;9;0;9
9789;Ramunėlė;BITUTĖS;1012658900;Taip;7;9;0;16
9790;Ramunėlė;BITUTĖS;1485483496;Taip;0;6;0;6
9791;Ramunėlė;BITUTĖS;9961229084;Taip;0;2;0;2
9792;Ramunėlė;BITUTĖS;8098492540;Taip;0;17;0;17
9793;Ramunėlė;BITUTĖS;17201639406;Taip;14;0;5;19
9794;Ramunėlė;BITUTĖS;3065727741;Taip;5;0;4;9
9795;Ramunėlė;BITUTĖS;19420482998;Ne;9;1;0;10
9796;Ramunėlė;BITUTĖS;9130637883;Taip;0;15;0;15
9797;Ramunėlė;BITUTĖS;8016643568;Taip;0;4;0;4
9798;Ramunėlė;BITUTĖS;6217540064;Ne;5;2;3;10
9799;Ramunėlė;BITUTĖS;4990982790;Taip;0;6;0;6
9800;Ramunėlė;BITUTĖS;9171690612;Taip;4;6;0;10
9801;Ramunėlė;BITUTĖS;3271832822;Ne;2;7;1;10
9802;Ramunėlė;DRUGELIAI;15310034187;Taip;8;7;0;15
9803;Ramunėlė;DRUGELIAI;25346770513;Ne;0;5;3;8
9804;Ramunėlė;DRUGELIAI;28838673166;Ne;0;1;0;1
9805;Ramunėlė;DRUGELIAI;1253351354;Taip;0;4;2;6
9806;Ramunėlė;DRUGELIAI;13195968349;Taip;0;6;0;6
9807;Ramunėlė;DRUGELIAI;84319432445;Ne;3;3;1;7
9808;Ramunėlė;DRUGELIAI;26152001976;Ne;0;8;0;8
9809;Ramunėlė;DRUGELIAI;22306706669;Taip;0;1;0;1
9810;Ramunėlė;DRUGELIAI;76947701645;Taip;0;4;0;4
9811;Ramunėlė;DRUGELIAI;1175561112;Taip;0;7;0;7
9812;Ramunėlė;DRUGELIAI;1478538572;Taip;0;3;0;3
9813;Ramunėlė;DRUGELIAI;72620475723;Ne;0;7;0;7
9814;Ramunėlė;DRUGELIAI;92929314036;Taip;5;5;0;10
9815;Ramunėlė;DRUGELIAI;67836032797;Taip;0;9;0;9
9816;Ramunėlė;DRUGELIAI;9017349382;Taip;0;0;5;5
9817;Ramunėlė;DRUGELIAI;1376538015;Ne;0;4;0;4
9818;Ramunėlė;DRUGELIAI;1783572058;Taip;0;12;0;12
9819;Ramunėlė;DRUGELIAI;30907738272;Taip;0;2;1;3
9820;Ramunėlė;DRUGELIAI;1083479451;Taip;0;0;1;1
9821;Ramunėlė;DRUGELIAI;1891454355;Ne;0;9;0;9
9822;Ramunėlė;DRUGELIAI;1814199950;Taip;0;7;0;7
9823;Ramunėlė;DRUGELIAI;1199690327;Taip;0;3;0;3
9824;Ramunėlė;DRUGELIAI;1988109236;Taip;0;6;0;6
9825;Ramunėlė;DRUGELIAI;52168460247;Taip;10;5;0;15
9826;Ramunėlė;DRUGELIAI;66630134164;Taip;5;0;0;5
9827;Ramunėlė;NEUŽMIRŠTUOLĖS;2383861394;Taip;0;2;0;2
9828;Ramunėlė;NEUŽMIRŠTUOLĖS;7220407572;Taip;4;5;0;9
9829;Ramunėlė;NEUŽMIRŠTUOLĖS;5847625697;Taip;6;0;3;9
9830;Ramunėlė;NEUŽMIRŠTUOLĖS;6342801407;Taip;13;0;0;13
9831;Ramunėlė;NEUŽMIRŠTUOLĖS;7307307882;Taip;9;0;0;9
9832;Ramunėlė;NEUŽMIRŠTUOLĖS;1916520056;Taip;14;1;0;15
9833;Ramunėlė;NEUŽMIRŠTUOLĖS;7692958269;Taip;4;0;0;4
9834;Ramunėlė;NEUŽMIRŠTUOLĖS;5865482869;Taip;0;0;2;2
9835;Ramunėlė;NEUŽMIRŠTUOLĖS;6843262303;Taip;7;0;0;7
9836;Ramunėlė;NEUŽMIRŠTUOLĖS;6870110390;Taip;6;2;0;8
9837;Ramunėlė;NEUŽMIRŠTUOLĖS;2245564567;Taip;6;2;0;8
9838;Ramunėlė;NEUŽMIRŠTUOLĖS;8940763540;Taip;11;0;0;11
9839;Ramunėlė;NEUŽMIRŠTUOLĖS;2225787182;Taip;0;14;0;14
9840;Ramunėlė;NEUŽMIRŠTUOLĖS;6329943991;Taip;0;9;2;11
9841;Ramunėlė;NEUŽMIRŠTUOLĖS;8086994543;Taip;12;9;0;21
9842;Ramunėlė;NEUŽMIRŠTUOLĖS;6165754839;Taip;0;6;0;6
9843;Ramunėlė;OBUOLIUKAI;2555810841;Taip;4;0;11;15
9844;Ramunėlė;OBUOLIUKAI;7228065409;Taip;10;6;0;16
9845;Ramunėlė;OBUOLIUKAI;8402889872;Taip;5;2;3;10
9846;Ramunėlė;OBUOLIUKAI;1745170057;Taip;0;5;0;5
9847;Ramunėlė;OBUOLIUKAI;8768539595;Taip;13;4;0;17
9848;Ramunėlė;OBUOLIUKAI;2055332353;Taip;7;7;0;14
9849;Ramunėlė;OBUOLIUKAI;2567264851;Taip;0;0;17;17
9850;Ramunėlė;OBUOLIUKAI;9584620339;Taip;0;3;0;3
9851;Ramunėlė;OBUOLIUKAI;6930505887;Taip;0;3;0;3
9852;Ramunėlė;OBUOLIUKAI;1199673371;Taip;2;0;5;7
9853;Ramunėlė;OBUOLIUKAI;3617897977;Taip;0;2;0;2
9854;Ramunėlė;OBUOLIUKAI;7955507702;Taip;15;0;0;15
9855;Ramunėlė;OBUOLIUKAI;1078618047;Taip;0;18;0;18
9856;Ramunėlė;OBUOLIUKAI;5049415445;Taip;10;0;0;10
9857;Ramunėlė;OBUOLIUKAI;1800967823;Taip;1;0;0;1
9858;Ramunėlė;OBUOLIUKAI;8656417794;Taip;20;0;0;20
9859;Ramunėlė;OBUOLIUKAI;8205893352;Taip;4;6;0;10
9860;Ramunėlė;SAULĖGRĄŽA;5465647281;Taip;0;15;0;15
9861;Ramunėlė;SAULĖGRĄŽA;9927068798;Taip;10;2;0;12
9862;Ramunėlė;SAULĖGRĄŽA;3852734401;Taip;0;4;0;4
9863;Ramunėlė;SAULĖGRĄŽA;1483391590;Taip;6;3;0;9
9864;Ramunėlė;SAULĖGRĄŽA;8929122197;Taip;0;1;0;1
9865;Ramunėlė;SAULĖGRĄŽA;5605444408;Taip;2;7;1;10
9866;Ramunėlė;SAULĖGRĄŽA;4575123456;Taip;11;1;0;12
9867;Ramunėlė;SAULĖGRĄŽA;1192743154;Taip;4;6;0;10
9868;Ramunėlė;SAULĖGRĄŽA;5562960498;Taip;0;19;0;19
9869;Ramunėlė;SAULĖGRĄŽA;6134554678;Ne;0;17;0;17
9870;Ramunėlė;SAULĖGRĄŽA;8726443989;Taip;7;8;0;15
9871;Ramunėlė;SAULĖGRĄŽA;1599595174;Taip;21;0;0;21
9872;Ramunėlė;SAULĖGRĄŽA;3779769727;Taip;5;2;0;7
9873;Ramunėlė;SAULĖGRĄŽA;8323020864;Taip;7;0;0;7
9874;Ramunėlė;SAULĖGRĄŽA;8912978935;Taip;2;0;0;2
9875;Ramunėlė;SAULĖGRĄŽA;5420360864;Taip;3;7;0;10
9876;Ramunėlė;SAULĖGRĄŽA;4209191105;Taip;2;1;0;3
9877;Ramunėlė;SAULĖGRĄŽA;7902931560;Taip;4;3;0;7
9878;Ramunėlė;SAULĖGRĄŽA;5714771643;Taip;0;8;2;10
9879;Ramunėlė;BORUŽĖLĖS;82024687579;Taip;0;13;0;13
9880;Ramunėlė;BORUŽĖLĖS;1563618796;Taip;0;4;0;4
9881;Ramunėlė;BORUŽĖLĖS;1946639898;Taip;3;6;1;10
9882;Ramunėlė;BORUŽĖLĖS;63470398650;Taip;2;2;0;4
9883;Ramunėlė;BORUŽĖLĖS;1642082135;Taip;14;4;0;18
9884;Ramunėlė;BORUŽĖLĖS;1176835101;Taip;0;5;0;5
9885;Ramunėlė;BORUŽĖLĖS;1341351994;Taip;0;10;0;10
9886;Ramunėlė;BORUŽĖLĖS;1041998279;Taip;0;4;0;4
9887;Ramunėlė;BORUŽĖLĖS;2859202237;Taip;0;6;0;6
9888;Ramunėlė;BORUŽĖLĖS;1709795078;Taip;0;14;0;14
9889;Ramunėlė;BORUŽĖLĖS;1077068878;Taip;5;8;0;13
9890;Ramunėlė;BORUŽĖLĖS;1207455851;Taip;4;0;3;7
9891;Ramunėlė;BORUŽĖLĖS;76195144469;Taip;0;5;7;12
9892;Ramunėlė;BORUŽĖLĖS;1690224857;Taip;0;4;3;7
9893;Ramunėlė;BORUŽĖLĖS;1058243928;Taip;0;4;0;4
9894;Ramunėlė;BORUŽĖLĖS;93125217886;Taip;0;5;0;5
9895;Ramunėlė;BORUŽĖLĖS;17273267465;Taip;4;5;0;9
9896;Ramunėlė;BORUŽĖLĖS;1033548164;Taip;0;2;0;2
9897;Ramunėlė;BORUŽĖLĖS;1439962940;Taip;10;2;0;12
9898;Ramunėlė;NYKŠTUKAS;7250951221;Taip;9;2;2;13
9899;Ramunėlė;NYKŠTUKAS;2427399083;Taip;6;2;0;8
9900;Ramunėlė;NYKŠTUKAS;5316468106;Taip;0;1;0;1
9901;Ramunėlė;NYKŠTUKAS;4233978236;Taip;12;0;1;13
9902;Ramunėlė;NYKŠTUKAS;7622952406;Taip;3;0;12;15
9903;Ramunėlė;NYKŠTUKAS;2983986428;Taip;7;12;0;19
9904;Ramunėlė;NYKŠTUKAS;6156792400;Taip;0;10;1;11
9905;Ramunėlė;NYKŠTUKAS;5117135860;Taip;0;6;0;6
9906;Ramunėlė;NYKŠTUKAS;5548358138;Taip;9;0;0;9
9907;Ramunėlė;NYKŠTUKAS;3683181174;Taip;5;0;0;5
9908;Ramunėlė;NYKŠTUKAS;2422656007;Taip;4;0;1;5
9909;Ramunėlė;NYKŠTUKAS;6809164145;Taip;11;2;1;14
9910;Ramunėlė;NYKŠTUKAS;9984243153;Taip;2;4;0;6
9911;Ramunėlė;NYKŠTUKAS;6184872126;Taip;9;0;0;9
9912;Ramunėlė;NYKŠTUKAS;7829765488;Taip;6;2;2;10
9913;Ramunėlė;NYKŠTUKAS;7364976547;Taip;7;0;0;7
9914;Ramunėlė;NYKŠTUKAS;9217815657;Taip;2;17;0;19
9915;Ramunėlė;UOGELĖ;3996453947;Taip;15;2;0;17
9916;Ramunėlė;UOGELĖ;2591052434;Taip;0;11;0;11
9917;Ramunėlė;UOGELĖ;5304803880;Taip;0;11;0;11
9918;Ramunėlė;UOGELĖ;6389008823;Taip;0;16;0;16
9919;Ramunėlė;UOGELĖ;1671759939;Taip;16;2;0;18
9920;Ramunėlė;UOGELĖ;6347164708;Taip;16;0;0;16
9921;Ramunėlė;UOGELĖ;5315953299;Taip;9;1;0;10
9922;Ramunėlė;UOGELĖ;9136437288;Taip;8;9;0;17
9923;Ramunėlė;UOGELĖ;2446375037;Taip;0;8;1;9
9924;Ramunėlė;UOGELĖ;5801760033;Taip;7;1;0;8
9925;Ramunėlė;UOGELĖ;6627399830;Taip;8;0;2;10
9926;Ramunėlė;UOGELĖ;2605941371;Taip;3;2;0;5
9927;Ramunėlė;UOGELĖ;3525444906;Taip;0;1;0;1
9928;Ramunėlė;UOGELĖ;8055844166;Taip;3;12;0;15
9929;Ramunėlė;UOGELĖ;2686455030;Taip;10;2;1;13
9930;Ramunėlė;UOGELĖ;2173425836;Taip;10;2;1;13
9931;Ramunėlė;UOGELĖ;5650659504;Taip;9;11;0;20
9932;Ramunėlė;UOGELĖ;4715809064;Taip;8;3;0;11
9933;Ramunėlė;VARPELIAI;1534723406;Taip;7;0;1;8
9934;Ramunėlė;VARPELIAI;6837072361;Taip;0;7;0;7
9935;Ramunėlė;VARPELIAI;3566074517;Taip;0;5;0;5
9936;Ramunėlė;VARPELIAI;3685786758;Taip;0;7;0;7
9937;Ramunėlė;VARPELIAI;2007790746;Taip;0;1;0;1
9938;Ramunėlė;VARPELIAI;6310921755;Taip;0;5;0;5
9939;Ramunėlė;VARPELIAI;1303053333;Taip;6;2;0;8
9940;Ramunėlė;VARPELIAI;4349250416;Taip;0;7;0;7
9941;Ramunėlė;VARPELIAI;4677819736;Taip;8;0;2;10
9942;Ramunėlė;VARPELIAI;2499280049;Taip;4;0;0;4
9943;Ramunėlė;VARPELIAI;9448369796;Taip;0;4;3;7
9944;Ramunėlė;VARPELIAI;7750405604;Taip;3;2;1;6
9945;Ramunėlė;VARPELIAI;7295041630;Taip;5;11;0;16
9946;Ramunėlė;VARPELIAI;6695672297;Taip;0;4;0;4
9947;Ramunėlė;VARPELIAI;7825538259;Taip;5;0;3;8
9948;Ramunėlė;VARPELIAI;58028743912;Taip;21;0;0;21
9949;Ramunėlė;VARPELIAI;6612728883;Taip;2;8;0;10
9950;Ramunėlė;VARPELIAI;1567537525;Taip;0;6;0;6
9951;Ramunėlė;VARPELIAI;1216101539;Taip;0;15;0;15
9952;Ramunėlė;VARPELIAI;7638038269;Taip;5;2;0;7
9953;Ramunėlė;VARPELIAI;3554787356;Taip;11;0;4;15
9954;Ramunėlė;VARPELIAI;8496322672;Taip;0;0;5;5
9955;Rūta;SMALSUČIAI;14391882157;Taip;2;3;0;5
9956;Rūta;SMALSUČIAI;18117978189;Taip;3;4;0;7
9957;Rūta;SMALSUČIAI;77285178781;Taip;0;4;1;5
9958;Rūta;SMALSUČIAI;78953568121;Taip;0;8;0;8
9959;Rūta;SMALSUČIAI;26152518052;Taip;21;0;0;21
9960;Rūta;SMALSUČIAI;68107516536;Ne;0;6;0;6
9961;Rūta;SMALSUČIAI;87692898919;Taip;0;4;1;5
9962;Rūta;SMALSUČIAI;1937805277;Taip;0;4;0;4
9963;Rūta;SMALSUČIAI;3874247966;Taip;4;7;0;11
9964;Rūta;SMALSUČIAI;1323253379;Taip;3;4;0;7
9965;Rūta;SMALSUČIAI;8604212304;Taip;7;8;0;15
9966;Rūta;SMALSUČIAI;38837808144;Taip;0;0;3;3
9967;Rūta;SMALSUČIAI;50814418724;Ne;7;4;0;11
9968;Rūta;SMALSUČIAI;1364470800;Taip;0;0;3;3
9969;Rūta;SMALSUČIAI;1996690514;Taip;0;6;0;6
9970;Rūta;SMALSUČIAI;59694891781;Taip;8;11;0;19
9971;Rūta;SMALSUČIAI;83473072263;Taip;10;4;0;14
9972;Rūta;SMALSUČIAI;2986201324;Taip;0;0;6;6
9973;Rūta;KŪLVERSTUKAI;1080628212;Taip;5;0;0;5
9974;Rūta;KŪLVERSTUKAI;80410156050;Taip;0;3;0;3
9975;Rūta;KŪLVERSTUKAI;1150292834;Taip;9;4;0;13
9976;Rūta;KŪLVERSTUKAI;56171468735;Taip;0;9;0;9
9977;Rūta;KŪLVERSTUKAI;88159609117;Taip;0;6;0;6
9978;Rūta;KŪLVERSTUKAI;2084379688;Taip;0;8;0;8
9979;Rūta;KŪLVERSTUKAI;1807332522;Taip;0;9;0;9
9980;Rūta;KŪLVERSTUKAI;1674584707;Taip;0;10;0;10
9981;Rūta;KŪLVERSTUKAI;2079429418;Taip;0;5;0;5
9982;Rūta;KŪLVERSTUKAI;1972150300;Taip;0;9;0;9
9983;Rūta;KŪLVERSTUKAI;99777522247;Taip;0;4;0;4
9984;Rūta;KŪLVERSTUKAI;1971925569;Taip;0;8;0;8
9985;Rūta;KŪLVERSTUKAI;56470874552;Taip;9;0;0;9
9986;Rūta;KŪLVERSTUKAI;1363296753;Taip;0;5;0;5
9987;Rūta;KŪLVERSTUKAI;17349566042;Ne;0;12;0;12
9988;Rūta;KŪLVERSTUKAI;10059496231;Taip;0;1;0;1
9989;Rūta;KŪLVERSTUKAI;1043614414;Taip;11;0;0;11
9990;Rūta;KŪLVERSTUKAI;1703148668;Taip;16;0;0;16
9991;Rūta;KODĖLČIUKAI;2546023973;Taip;0;0;8;8
9992;Rūta;KODĖLČIUKAI;5007973484;Taip;16;4;0;20
9993;Rūta;KODĖLČIUKAI;6814051598;Taip;0;0;6;6
9994;Rūta;KODĖLČIUKAI;1775029025;Taip;0;0;1;1
9995;Rūta;KODĖLČIUKAI;8958880558;Taip;14;1;0;15
9996;Rūta;KODĖLČIUKAI;2263820829;Taip;14;0;1;15
9997;Rūta;KODĖLČIUKAI;5109138407;Taip;0;2;0;2
9998;Rūta;KODĖLČIUKAI;2286358230;Taip;0;0;21;21
9999;Rūta;KODĖLČIUKAI;8599313527;Taip;0;11;0;11
10000;Rūta;KODĖLČIUKAI;6186413364;Taip;0;13;0;13
10001;Rūta;KODĖLČIUKAI;6458458913;Taip;0;7;0;7
10002;Rūta;KODĖLČIUKAI;6585842434;Taip;8;0;2;10
10003;Rūta;KODĖLČIUKAI;4473591998;Taip;7;4;2;13
10004;Rūta;BORUŽĖLĖS;1623968580;Taip;0;3;6;9
10005;Rūta;BORUŽĖLĖS;3043164521;Taip;0;5;0;5
10006;Rūta;BORUŽĖLĖS;3044976169;Taip;0;0;7;7
10007;Rūta;BORUŽĖLĖS;8273644943;Taip;8;6;1;15
10008;Rūta;BORUŽĖLĖS;4293920701;Taip;8;0;1;9
10009;Rūta;BORUŽĖLĖS;9419809946;Taip;0;5;0;5
10010;Rūta;BORUŽĖLĖS;3454881685;Taip;7;0;0;7
10011;Rūta;BORUŽĖLĖS;1811055786;Taip;0;4;8;12
10012;Rūta;BORUŽĖLĖS;1510268514;Taip;9;0;0;9
10013;Rūta;BORUŽĖLĖS;2702537976;Taip;0;4;0;4
10014;Rūta;BORUŽĖLĖS;4044349935;Taip;14;0;0;14
10015;Rūta;BORUŽĖLĖS;7936198171;Taip;15;4;0;19
10016;Rūta;BORUŽĖLĖS;9243332756;Taip;9;5;0;14
10017;Rūta;BORUŽĖLĖS;8963959004;Taip;0;0;6;6
10018;Rūta;BORUŽĖLĖS;2772130413;Taip;0;5;0;5
10019;Rūta;VYTURĖLIAI;78925728976;Ne;0;4;2;6
10020;Rūta;VYTURĖLIAI;44365150696;Taip;10;4;0;14
10021;Rūta;VYTURĖLIAI;10957816153;Ne;0;6;0;6
10022;Rūta;VYTURĖLIAI;35843737071;Taip;12;4;0;16
10023;Rūta;VYTURĖLIAI;13023764979;Ne;0;4;0;4
10024;Rūta;VYTURĖLIAI;4409524323;Taip;0;2;0;2
10025;Rūta;VYTURĖLIAI;2033577529;Taip;0;5;2;7
10026;Rūta;VYTURĖLIAI;28332403249;Taip;5;6;0;11
10027;Rūta;VYTURĖLIAI;79762491266;Taip;0;8;0;8
10028;Rūta;VYTURĖLIAI;76831234529;Taip;0;9;0;9
10029;Rūta;VYTURĖLIAI;24211514845;Taip;0;6;1;7
10030;Rūta;VYTURĖLIAI;48213220767;Ne;5;2;0;7
10031;Rūta;VYTURĖLIAI;28158130932;Taip;9;0;0;9
10032;Rūta;VYTURĖLIAI;50266063379;Ne;0;12;0;12
10033;Rūta;VYTURĖLIAI;28676981495;Taip;0;3;3;6
10034;Rūta;VYTURĖLIAI;91072621203;Taip;4;4;8;16
10035;Rūta;VYTURĖLIAI;81049938466;Taip;0;4;1;5
10036;Rūta;VYTURĖLIAI;34935546673;Taip;0;2;0;2
10037;Rūta;VYTURĖLIAI;47869128534;Taip;0;2;0;2
10038;Rūta;VYTURĖLIAI;67740925555;Taip;0;11;0;11
10039;Rūta;"PABIRUČIAI (LOGOPEDINĖ)";1489564914;Taip;0;13;0;13
10040;Rūta;"PABIRUČIAI (LOGOPEDINĖ)";5009619812;Ne;2;4;0;6
10041;Rūta;"PABIRUČIAI (LOGOPEDINĖ)";6891385410;Ne;0;4;0;4
10042;Rūta;"PABIRUČIAI (LOGOPEDINĖ)";3055294324;Ne;21;0;0;21
10043;Rūta;"PABIRUČIAI (LOGOPEDINĖ)";3247709788;Taip;0;10;0;10
10044;Rūta;"PABIRUČIAI (LOGOPEDINĖ)";1035527190;Taip;0;0;9;9
10045;Rūta;"PABIRUČIAI (LOGOPEDINĖ)";6136733410;Taip;0;5;0;5
10046;Rūta;GUDRUČIAI;1967141665;Ne;0;4;0;4
10047;Rūta;GUDRUČIAI;3873876608;Taip;0;2;0;2
10048;Rūta;GUDRUČIAI;8851591109;Taip;9;0;3;12
10049;Rūta;GUDRUČIAI;1180144866;Taip;9;4;1;14
10050;Rūta;GUDRUČIAI;3478456813;Taip;2;4;0;6
10051;Rūta;GUDRUČIAI;8889388348;Taip;0;0;7;7
10052;Rūta;GUDRUČIAI;1346367896;Taip;0;3;0;3
10053;Rūta;GUDRUČIAI;2116581815;Taip;2;0;1;3
10054;Rūta;GUDRUČIAI;4363571135;Taip;0;8;0;8
10055;Rūta;GUDRUČIAI;6006094035;Taip;0;0;1;1
10056;Rūta;GUDRUČIAI;1521231573;Ne;5;4;4;13
10057;Rūta;GUDRUČIAI;7552644990;Taip;17;0;1;18
10058;Rūta;GUDRUČIAI;1092908255;Taip;3;5;0;8
10059;Rūta;GUDRUČIAI;8673942478;Taip;0;4;7;11
10060;Rūta;GUDRUČIAI;4078957924;Taip;7;4;0;11
10061;Rūta;GUDRUČIAI;4754142240;Taip;0;4;0;4
10062;Rūta;GUDRUČIAI;1565896222;Ne;0;4;7;11
10063;Rūta;GUDRUČIAI;8704594038;Taip;0;0;6;6
10064;Rūta;GUDRUČIAI;7631229177;Taip;3;0;3;6
10065;Rūta;GUDRUČIAI;8026402652;Ne;13;0;1;14
10066;Rūta;SEKLYTĖLĖ;1800198849;Taip;0;5;0;5
10067;Rūta;SEKLYTĖLĖ;54140704807;Taip;4;2;3;9
10068;Rūta;SEKLYTĖLĖ;26830853793;Taip;0;1;0;1
10069;Rūta;SEKLYTĖLĖ;75322385068;Taip;0;4;0;4
10070;Rūta;SEKLYTĖLĖ;76518034714;Taip;0;4;0;4
10071;Rūta;SEKLYTĖLĖ;79192262053;Ne;0;4;0;4
10072;Rūta;SEKLYTĖLĖ;42791864630;Taip;0;5;0;5
10073;Rūta;SEKLYTĖLĖ;20967345257;Taip;8;4;0;12
10074;Rūta;SEKLYTĖLĖ;50734030014;Taip;0;4;0;4
10075;Rūta;SEKLYTĖLĖ;29240858006;Taip;0;4;0;4
10076;Rūta;SEKLYTĖLĖ;75730421646;Ne;0;12;0;12
10077;Rūta;SEKLYTĖLĖ;2711671531;Taip;11;10;0;21
10078;Rūta;SEKLYTĖLĖ;9994442882;Taip;0;1;0;1
10079;Rūta;SEKLYTĖLĖ;29483136582;Taip;3;4;3;10
10080;Rūta;SEKLYTĖLĖ;1545183162;Ne;0;2;1;3
10081;Rūta;SEKLYTĖLĖ;5733023163;Taip;17;4;0;21
10082;Rūta;SEKLYTĖLĖ;7061384784;Taip;10;4;0;14
10083;Rūta;SEKLYTĖLĖ;2145422728;Taip;0;4;0;4
10084;Rūta;SEKLYTĖLĖ;63972399637;Taip;0;6;0;6
10085;Rūta;"VARPELIAI (LOGOPEDINĖ)";38269797498;Ne;0;3;1;4
10086;Rūta;"VARPELIAI (LOGOPEDINĖ)";1863889584;Taip;0;6;0;6
10087;Rūta;"VARPELIAI (LOGOPEDINĖ)";8657192724;Taip;0;4;0;4
10088;Rūta;"VARPELIAI (LOGOPEDINĖ)";70608720189;Taip;0;4;0;4
10089;Rūta;"VARPELIAI (LOGOPEDINĖ)";57805651069;Taip;0;3;0;3
10090;Rūta;"VARPELIAI (LOGOPEDINĖ)";58313529531;Taip;0;1;1;2
10091;Rūta;"VARPELIAI (LOGOPEDINĖ)";1831410058;Taip;4;1;0;5
10092;Rūta;KIŠKUČIŲ;4297300799;Taip;0;10;0;10
10093;Rūta;KIŠKUČIŲ;6207902435;Taip;0;8;0;8
10094;Rūta;KIŠKUČIŲ;9791861646;Taip;0;4;1;5
10095;Rūta;KIŠKUČIŲ;8182243701;Taip;0;5;0;5
10096;Rūta;KIŠKUČIŲ;4728904136;Taip;0;15;0;15
10097;Rūta;KIŠKUČIŲ;6316768460;Taip;9;0;0;9
10098;Rūta;KIŠKUČIŲ;2928803089;Taip;5;10;0;15
10099;Rūta;KIŠKUČIŲ;5899860543;Taip;0;8;0;8
10100;Rūta;KIŠKUČIŲ;8378318357;Ne;7;11;0;18
10101;Rūta;KIŠKUČIŲ;9603105651;Taip;0;18;0;18
10102;Rūta;KIŠKUČIŲ;1951202550;Taip;3;0;1;4
10103;Rūta;KIŠKUČIŲ;9911151238;Taip;0;0;1;1
10104;Rūta;KIŠKUČIŲ;1346124133;Taip;4;0;1;5
10105;Rūta;KIŠKUČIŲ;3843325181;Taip;0;0;3;3
10106;Rūta;KIŠKUČIŲ;7649756034;Taip;4;0;1;5
10107;Rūta;ŽVIRBLIUKAI;3499727608;Taip;2;6;3;11
10108;Rūta;ŽVIRBLIUKAI;9765301038;Taip;2;6;3;11
10109;Rūta;ŽVIRBLIUKAI;8277677952;Taip;7;0;0;7
10110;Rūta;ŽVIRBLIUKAI;9638495757;Taip;6;3;1;10
10111;Rūta;ŽVIRBLIUKAI;3956912957;Ne;3;5;3;11
10112;Rūta;ŽVIRBLIUKAI;3055345528;Taip;0;5;0;5
10113;Rūta;ŽVIRBLIUKAI;4423305209;Taip;0;7;0;7
10114;Rūta;ŽVIRBLIUKAI;2890569107;Taip;11;0;4;15
10115;Rūta;ŽVIRBLIUKAI;3964922552;Taip;14;0;2;16
10116;Rūta;ŽVIRBLIUKAI;1216786487;Ne;0;12;0;12
10117;Rūta;ŽVIRBLIUKAI;9736567509;Taip;3;0;6;9
10118;Rūta;ŽVIRBLIUKAI;2474991135;Taip;9;2;2;13
10119;Rūta;ŽVIRBLIUKAI;7519931138;Taip;0;4;2;6
10120;Rūta;ŽVIRBLIUKAI;9400586178;Taip;2;10;0;12
10121;Rūta;ŽVIRBLIUKAI;8395765508;Taip;4;0;2;6
10122;Rūta;ŽVIRBLIUKAI;7222494215;Taip;4;0;3;7
10123;Rūta;ŽVIRBLIUKAI;5264690055;Taip;4;0;7;11
10124;Rūta;ŽVIRBLIUKAI;1962172243;Taip;5;4;3;12
10125;Rūta;ŽVIRBLIUKAI;7553844890;Taip;0;0;4;4
10126;Rūta;ŽVIRBLIUKAI;8605070655;Taip;0;4;4;8
10127;Rūta;SAULUTĖS;1671913833;Taip;9;0;2;11
10128;Rūta;SAULUTĖS;1186493111;Taip;0;8;0;8
10129;Rūta;SAULUTĖS;9675482322;Ne;21;0;0;21
10130;Rūta;SAULUTĖS;1415664888;Taip;0;0;6;6
10131;Rūta;SAULUTĖS;4426456302;Taip;5;0;0;5
10132;Rūta;SAULUTĖS;5114985659;Taip;0;0;3;3
10133;Rūta;SAULUTĖS;6982618655;Ne;0;7;0;7
10134;Rūta;SAULUTĖS;4282074540;Taip;7;0;5;12
10135;Rūta;SAULUTĖS;8607455403;Taip;0;10;0;10
10136;Rūta;SAULUTĖS;4168356825;Taip;4;0;3;7
10137;Rūta;SAULUTĖS;9569447586;Taip;0;2;0;2
10138;Rūta;SAULUTĖS;1579573872;Taip;0;4;0;4
10139;Rūta;SAULUTĖS;2677062861;Taip;7;0;0;7
10140;Rūta;SAULUTĖS;1390207547;Taip;2;4;0;6
10141;Rūta;SAULUTĖS;32004750783;Taip;0;0;4;4
10142;Rūta;SAULUTĖS;5866619097;Taip;4;0;0;4
10143;Rūta;SAULUTĖS;2912054049;Taip;0;4;1;5
10144;Rūta;SAULUTĖS;3567273206;Ne;0;0;3;3
10145;Rūta;SAULUTĖS;3820689725;Taip;0;4;0;4
10146;Sadutė;Kiškučiai;38918375280;Taip;0;4;2;6
10147;Sadutė;Kiškučiai;42447771280;Taip;0;1;0;1
10148;Sadutė;Kiškučiai;62408324442;Taip;0;7;0;7
10149;Sadutė;Kiškučiai;3253659165;Taip;0;2;0;2
10150;Sadutė;Kiškučiai;67439547513;Taip;0;4;0;4
10151;Sadutė;Kiškučiai;98527988102;Taip;0;8;0;8
10152;Sadutė;Kiškučiai;62077575922;Ne;4;0;4;8
10153;Sadutė;Kiškučiai;48298497;Taip;8;0;2;10
10154;Sadutė;Kiškučiai;69988140413;Taip;0;2;1;3
10155;Sadutė;Kiškučiai;61357382189;Taip;0;4;7;11
10156;Sadutė;Kiškučiai;1433422421;Taip;7;0;3;10
10157;Sadutė;Kiškučiai;73649870571;Taip;12;0;9;21
10158;Sadutė;Kiškučiai;1092421263;Taip;5;1;0;6
10159;Sadutė;Kiškučiai;1291782232;Taip;0;0;1;1
10160;Sadutė;Kiškučiai;5586949339;Ne;0;0;9;9
10161;Sadutė;Kiškučiai;64959385010;Taip;0;2;0;2
10162;Sadutė;Kiškučiai;9883685724;Taip;0;2;9;11
10163;Sadutė;Kiškučiai;4525909977;Taip;5;2;0;7
10164;Sadutė;Kiškučiai;1533081218;Taip;12;4;0;16
10165;Sadutė;Kiškučiai;3400524440;Taip;0;0;4;4
10166;Sadutė;Kiškučiai;1084400276;Taip;6;4;4;14
10167;Sadutė;Boružėlės;31020557647;Taip;0;1;8;9
10168;Sadutė;Boružėlės;99171108375;Taip;0;4;2;6
10169;Sadutė;Boružėlės;30046732620;Taip;6;4;0;10
10170;Sadutė;Boružėlės;91943880567;Taip;0;1;3;4
10171;Sadutė;Boružėlės;70505797915;Ne;5;4;1;10
10172;Sadutė;Boružėlės;48817619537;Taip;5;3;0;8
10173;Sadutė;Boružėlės;76464399248;Taip;0;4;3;7
10174;Sadutė;Boružėlės;47883796567;Taip;0;4;0;4
10175;Sadutė;Boružėlės;93561298785;Ne;6;4;0;10
10176;Sadutė;Boružėlės;48327367042;Taip;0;4;1;5
10177;Sadutė;Boružėlės;4064111008;Taip;0;4;1;5
10178;Sadutė;Boružėlės;35237170892;Taip;9;2;0;11
10179;Sadutė;Boružėlės;45569403734;Taip;10;0;0;10
10180;Sadutė;Boružėlės;15950584691;Taip;0;4;3;7
10181;Sadutė;Boružėlės;84758378727;Taip;0;2;0;2
10182;Sadutė;Boružėlės;38373089101;Taip;3;0;1;4
10183;Sadutė;Boružėlės;13779484979;Taip;0;4;0;4
10184;Sadutė;Boružėlės;12989960431;Taip;0;4;1;5
10185;Sadutė;Boružėlės;2414632774;Taip;4;4;0;8
10186;Sadutė;Boružėlės;16493384211;Taip;7;4;3;14
10187;Sadutė;Boružėlės;71576294118;Ne;0;1;0;1
10188;Sadutė;Boružėlės;21011440269;Ne;0;1;1;2
10189;Sadutė;Boružėlės;39222963335;Ne;8;4;0;12
10190;Sadutė;Boružėlės;4695479762;Taip;10;4;4;18
10191;Sadutė;Boružėlės;1920496059;Taip;9;3;0;12
10192;Sadutė;Bitutės;1759479328;Taip;0;6;1;7
10193;Sadutė;Bitutės;1975767401;Taip;2;0;0;2
10194;Sadutė;Bitutės;4245873513;Taip;10;1;0;11
10195;Sadutė;Bitutės;1873928395;Taip;0;21;0;21
10196;Sadutė;Bitutės;8140354445;Taip;5;1;0;6
10197;Sadutė;Bitutės;5866461096;Taip;7;0;6;13
10198;Sadutė;Bitutės;4883934480;Ne;21;0;0;21
10199;Sadutė;Bitutės;9107727583;Ne;11;0;0;11
10200;Sadutė;Bitutės;7097653016;Ne;11;0;0;11
10201;Sadutė;Bitutės;4479315578;Taip;10;0;0;10
10202;Sadutė;Bitutės;2020766695;Taip;3;6;0;9
10203;Sadutė;Bitutės;5011320850;Taip;2;0;6;8
10204;Sadutė;Bitutės;4161502667;Taip;15;0;0;15
10205;Sadutė;Bitutės;5973513916;Taip;0;7;0;7
10206;Sadutė;Bitutės;5169694660;Taip;8;1;0;9
10207;Sadutė;Bitutės;3361904803;Taip;0;21;0;21
10208;Sadutė;Bitutės;1231048342;Taip;6;6;0;12
10209;Sadutė;Drugeliai;9090754149;Taip;0;1;0;1
10210;Sadutė;Drugeliai;1552350084;Taip;9;1;0;10
10211;Sadutė;Drugeliai;7910380894;Taip;13;4;0;17
10212;Sadutė;Drugeliai;2467800545;Taip;12;1;0;13
10213;Sadutė;Drugeliai;4402558234;Taip;0;9;0;9
10214;Sadutė;Drugeliai;6994547344;Taip;0;7;3;10
10215;Sadutė;Drugeliai;1782594187;Ne;9;5;0;14
10216;Sadutė;Drugeliai;5816844295;Taip;14;4;0;18
10217;Sadutė;Drugeliai;2095914442;Ne;3;1;0;4
10218;Sadutė;Drugeliai;8803249656;Ne;17;4;0;21
10219;Sadutė;Drugeliai;4901634532;Taip;0;5;0;5
10220;Sadutė;Drugeliai;6196282159;Taip;15;4;0;19
10221;Sadutė;Drugeliai;8953107298;Taip;21;0;0;21
10222;Sadutė;Drugeliai;1735450955;Taip;2;2;0;4
10223;Sadutė;Drugeliai;2064784580;Taip;2;2;0;4
10224;Sadutė;Drugeliai;2883991326;Taip;9;0;1;10
10225;Sadutė;Drugeliai;7731164484;Taip;9;0;0;9
10226;Sadutė;Drugeliai;2014660237;Taip;21;0;0;21
10227;Sadutė;Drugeliai;6124376554;Taip;5;0;2;7
10228;Sadutė;Drugeliai;8322941607;Taip;16;0;0;16
10229;Sadutė;Pėledžiukai;50662732693;Taip;0;5;4;9
10230;Sadutė;Pėledžiukai;26761581977;Taip;20;0;0;20
10231;Sadutė;Pėledžiukai;1885941594;Taip;0;8;0;8
10232;Sadutė;Pėledžiukai;4933574100;Taip;4;12;1;17
10233;Sadutė;Pėledžiukai;6105924871;Taip;4;0;0;4
10234;Sadutė;Pėledžiukai;8870465478;Ne;0;5;2;7
10235;Sadutė;Pėledžiukai;64835095908;Taip;16;0;0;16
10236;Sadutė;Pėledžiukai;3619323573;Taip;0;19;2;21
10237;Sadutė;Pėledžiukai;14962142857;Taip;0;3;0;3
10238;Sadutė;Pėledžiukai;92111253012;Taip;0;4;0;4
10239;Sadutė;Pėledžiukai;1594844154;Ne;9;7;0;16
10240;Sadutė;Pėledžiukai;1005751811;Taip;9;0;0;9
10241;Sadutė;Pėledžiukai;61450959987;Taip;0;0;1;1
10242;Sadutė;Pėledžiukai;45981672295;Taip;10;4;2;16
10243;Sadutė;Pėledžiukai;8667620186;Taip;0;3;0;3
10244;Sadutė;Pėledžiukai;9946417453;Ne;0;9;0;9
10245;Sadutė;Pėledžiukai;48818906299;Ne;15;0;0;15
10246;Sadutė;Pėledžiukai;1003580436;Taip;5;0;1;6
10247;Sadutė;Pėledžiukai;1190667513;Taip;9;3;0;12
10248;Sadutė;Pėledžiukai;1988169256;Taip;0;8;0;8
10249;Sadutė;Pėledžiukai;1985946393;Taip;0;11;0;11
10250;Sadutė;Kačiukų;1507052440;Taip;0;14;2;16
10251;Sadutė;Kačiukų;1903961488;Taip;0;4;3;7
10252;Sadutė;Kačiukų;2890916313;Taip;14;0;1;15
10253;Sadutė;Kačiukų;3993181500;Taip;0;7;0;7
10254;Sadutė;Kačiukų;1871236869;Taip;0;1;0;1
10255;Sadutė;Kačiukų;8835627470;Taip;7;2;0;9
10256;Sadutė;Kačiukų;2532626934;Taip;0;2;0;2
10257;Sadutė;Kačiukų;2466024649;Taip;3;2;1;6
10258;Sadutė;Kačiukų;6253351299;Taip;0;4;1;5
10259;Sadutė;Kačiukų;2426974464;Taip;3;4;0;7
10260;Sadutė;Kačiukų;5438448926;Taip;3;0;3;6
10261;Sadutė;Kačiukų;8974374101;Taip;10;4;3;17
10262;Sadutė;Kačiukų;4401870028;Taip;0;0;2;2
10263;Sadutė;Kačiukų;8714168144;Taip;4;0;1;5
10264;Sadutė;Kačiukų;3927044011;Taip;9;0;0;9
10265;Sadutė;Kačiukų;8974225608;Taip;0;0;5;5
10266;Sadutė;Kačiukų;8770727233;Taip;4;0;5;9
10267;Sakalėlis;GIRINUKŲ;9566176151;Ne;21;0;0;21
10268;Sakalėlis;GIRINUKŲ;8606714134;Ne;0;6;0;6
10269;Sakalėlis;GIRINUKŲ;2895663259;Taip;9;0;0;9
10270;Sakalėlis;GIRINUKŲ;5405669698;Ne;5;0;5;10
10271;Sakalėlis;GIRINUKŲ;2474164013;Ne;17;0;0;17
10272;Sakalėlis;GIRINUKŲ;9493905856;Taip;6;0;2;8
10273;Sakalėlis;GIRINUKŲ;5496044442;Taip;18;0;0;18
10274;Sakalėlis;GIRINUKŲ;6603105354;Ne;7;0;2;9
10275;Sakalėlis;GIRINUKŲ;3418702674;Taip;5;2;0;7
10276;Sakalėlis;GIRINUKŲ;6700169944;Taip;3;0;0;3
10277;Sakalėlis;GIRINUKŲ;3333037807;Taip;5;5;0;10
10278;Sakalėlis;GIRINUKŲ;8667155756;Ne;11;0;2;13
10279;Sakalėlis;GIRINUKŲ;4596727938;Taip;6;4;0;10
10280;Sakalėlis;GIRINUKŲ;6706466627;Taip;6;6;0;12
10281;Sakalėlis;GIRINUKŲ;8790189865;Taip;4;0;0;4
10282;Sakalėlis;GIRINUKŲ;4458071075;Taip;15;0;1;16
10283;Sakalėlis;GIRINUKŲ;2780141413;Taip;0;9;0;9
10284;Sakalėlis;GIRINUKŲ;1347171934;Taip;2;0;0;2
10285;Sakalėlis;GIRINUKŲ;9823633774;Taip;0;4;1;5
10286;Sakalėlis;VYTURIUKŲ;330571735;Taip;3;2;0;5
10287;Sakalėlis;VYTURIUKŲ;21726291811;Taip;6;0;0;6
10288;Sakalėlis;VYTURIUKŲ;7852180045;Taip;0;2;0;2
10289;Sakalėlis;VYTURIUKŲ;27291131963;Taip;8;0;0;8
10290;Sakalėlis;VYTURIUKŲ;1822130260;Taip;5;4;2;11
10291;Sakalėlis;VYTURIUKŲ;25558438129;Taip;6;0;0;6
10292;Sakalėlis;VYTURIUKŲ;33360718659;Taip;0;4;0;4
10293;Sakalėlis;VYTURIUKŲ;59440026693;Taip;0;4;0;4
10294;Sakalėlis;VYTURIUKŲ;99937511623;Taip;0;4;0;4
10295;Sakalėlis;VYTURIUKŲ;14495611614;Taip;0;4;0;4
10296;Sakalėlis;VYTURIUKŲ;32956243898;Taip;0;4;3;7
10297;Sakalėlis;VYTURIUKŲ;87806505145;Taip;6;0;0;6
10298;Sakalėlis;VYTURIUKŲ;59067963901;Taip;20;1;0;21
10299;Sakalėlis;VYTURIUKŲ;1371469574;Taip;0;9;0;9
10300;Sakalėlis;VYTURIUKŲ;52975188309;Taip;0;4;0;4
10301;Sakalėlis;VYTURIUKŲ;74622921410;Taip;0;5;1;6
10302;Sakalėlis;VYTURIUKŲ;13953070987;Taip;0;4;4;8
10303;Sakalėlis;VYTURIUKŲ;12474715312;Taip;0;4;0;4
10304;Sakalėlis;VYTURIUKŲ;80747256105;Taip;0;4;8;12
10305;Sakalėlis;VYTURIUKŲ;77801416034;Taip;17;0;1;18
10306;Sakalėlis;VYTURIUKŲ;31051837141;Taip;0;3;3;6
10307;Sakalėlis;VYTURIUKŲ;12601081196;Taip;7;4;3;14
10308;Sakalėlis;VYTURIUKŲ;60747121226;Taip;0;6;1;7
10309;Sakalėlis;DRUGELIŲ;18298832212;Taip;0;4;0;4
10310;Sakalėlis;DRUGELIŲ;97259304899;Taip;5;1;0;6
10311;Sakalėlis;DRUGELIŲ;1605682818;Taip;0;9;0;9
10312;Sakalėlis;DRUGELIŲ;68379930730;Taip;0;10;0;10
10313;Sakalėlis;DRUGELIŲ;57477662126;Taip;0;4;2;6
10314;Sakalėlis;DRUGELIŲ;78050507580;Taip;7;4;1;12
10315;Sakalėlis;DRUGELIŲ;19456041826;Taip;7;4;1;12
10316;Sakalėlis;DRUGELIŲ;28930740067;Taip;0;4;2;6
10317;Sakalėlis;DRUGELIŲ;88344653299;Taip;0;5;1;6
10318;Sakalėlis;DRUGELIŲ;15950016412;Ne;2;4;0;6
10319;Sakalėlis;DRUGELIŲ;87950904971;Taip;0;7;0;7
10320;Sakalėlis;DRUGELIŲ;44702801581;Taip;0;4;0;4
10321;Sakalėlis;DRUGELIŲ;1075787529;Taip;13;4;0;17
10322;Sakalėlis;DRUGELIŲ;1421038685;Taip;5;0;0;5
10323;Sakalėlis;DRUGELIŲ;2124748537;Ne;0;7;0;7
10324;Sakalėlis;DRUGELIŲ;1538847469;Taip;0;0;1;1
10325;Sakalėlis;DRUGELIŲ;9634589602;Taip;3;4;2;9
10326;Sakalėlis;DRUGELIŲ;4583569438;Taip;0;4;3;7
10327;Sakalėlis;DRUGELIŲ;23064985127;Taip;14;0;1;15
10328;Sakalėlis;DRUGELIŲ;1139467130;Taip;0;4;0;4
10329;Sakalėlis;GENIUKŲ;1526540031;Ne;11;4;0;15
10330;Sakalėlis;GENIUKŲ;4763858893;Taip;0;4;14;18
10331;Sakalėlis;GENIUKŲ;3337299648;Taip;18;0;0;18
10332;Sakalėlis;GENIUKŲ;43677485606;Taip;0;12;0;12
10333;Sakalėlis;GENIUKŲ;5717022080;Taip;0;4;2;6
10334;Sakalėlis;GENIUKŲ;4515180509;Taip;7;3;3;13
10335;Sakalėlis;GENIUKŲ;1027765680;Ne;0;6;0;6
10336;Sakalėlis;GENIUKŲ;96053733139;Taip;0;4;0;4
10337;Sakalėlis;GENIUKŲ;4612388683;Taip;0;5;0;5
10338;Sakalėlis;GENIUKŲ;7159705304;Taip;0;1;0;1
10339;Sakalėlis;GENIUKŲ;4775685174;Taip;5;1;0;6
10340;Sakalėlis;GENIUKŲ;69916351348;Taip;0;4;3;7
10341;Sakalėlis;GENIUKŲ;6727251397;Taip;11;7;0;18
10342;Sakalėlis;GENIUKŲ;1552929452;Taip;11;4;0;15
10343;Sakalėlis;GENIUKŲ;8936933971;Taip;0;0;10;10
10344;Sakalėlis;GENIUKŲ;2829386777;Taip;4;4;0;8
10345;Sakalėlis;GENIUKŲ;3371763993;Taip;7;4;0;11
10346;Sakalėlis;GENIUKŲ;7085108710;Taip;7;0;2;9
10347;Sakalėlis;GENIUKŲ;2902195855;Taip;0;4;0;4
10348;Sakalėlis;VOVERIUKŲ;4430763418;Taip;13;1;0;14
10349;Sakalėlis;VOVERIUKŲ;6190741162;Ne;0;5;1;6
10350;Sakalėlis;VOVERIUKŲ;1702964714;Ne;19;0;0;19
10351;Sakalėlis;VOVERIUKŲ;1946531018;Taip;6;0;4;10
10352;Sakalėlis;VOVERIUKŲ;2796230671;Taip;0;10;1;11
10353;Sakalėlis;VOVERIUKŲ;1210451022;Taip;0;4;4;8
10354;Sakalėlis;VOVERIUKŲ;1912068116;Taip;0;4;0;4
10355;Sakalėlis;VOVERIUKŲ;8662137531;Taip;0;4;0;4
10356;Sakalėlis;VOVERIUKŲ;1104881142;Taip;0;3;0;3
10357;Sakalėlis;VOVERIUKŲ;46629941288;Taip;0;5;2;7
10358;Sakalėlis;VOVERIUKŲ;3678172501;Taip;14;1;0;15
10359;Sakalėlis;VOVERIUKŲ;1133377117;Taip;9;0;0;9
10360;Sakalėlis;VOVERIUKŲ;5782214279;Taip;18;0;0;18
10361;Sakalėlis;VOVERIUKŲ;22614338778;Taip;0;0;4;4
10362;Sakalėlis;VOVERIUKŲ;34464485043;Taip;6;2;7;15
10363;Sakalėlis;VOVERIUKŲ;30987215315;Taip;0;4;0;4
10364;Sakalėlis;VOVERIUKŲ;7567476424;Taip;0;4;2;6
10365;Sakalėlis;VOVERIUKŲ;6180987643;Taip;16;0;0;16
10366;Sakalėlis;VOVERIUKŲ;9693949103;Taip;7;0;0;7
10367;Sakalėlis;VOVERIUKŲ;8852001037;Taip;15;4;0;19
10368;Sakalėlis;PĖLEDŽIUKŲ;1974955778;Taip;0;4;0;4
10369;Sakalėlis;PĖLEDŽIUKŲ;69254656227;Ne;12;0;1;13
10370;Sakalėlis;PĖLEDŽIUKŲ;4573623341;Taip;0;4;4;8
10371;Sakalėlis;PĖLEDŽIUKŲ;60463584826;Taip;0;4;1;5
10372;Sakalėlis;PĖLEDŽIUKŲ;1359444361;Taip;0;4;2;6
10373;Sakalėlis;PĖLEDŽIUKŲ;3781188811;Taip;1;3;2;6
10374;Sakalėlis;PĖLEDŽIUKŲ;32890764904;Taip;0;0;1;1
10375;Sakalėlis;PĖLEDŽIUKŲ;89579043958;Taip;0;4;0;4
10376;Sakalėlis;PĖLEDŽIUKŲ;54902207576;Taip;0;2;0;2
10377;Sakalėlis;PĖLEDŽIUKŲ;33825546706;Taip;0;6;0;6
10378;Sakalėlis;PĖLEDŽIUKŲ;1790571847;Taip;0;0;1;1
10379;Sakalėlis;PĖLEDŽIUKŲ;81361557297;Taip;12;4;0;16
10380;Sakalėlis;PĖLEDŽIUKŲ;39504139934;Taip;0;4;1;5
10381;Sakalėlis;PĖLEDŽIUKŲ;2134118895;Taip;0;4;0;4
10382;Sakalėlis;PĖLEDŽIUKŲ;67193921335;Taip;15;4;0;19
10383;Sakalėlis;PĖLEDŽIUKŲ;6301366135;Taip;0;4;0;4
10384;Sakalėlis;PĖLEDŽIUKŲ;2055710873;Taip;0;0;1;1
10385;Sakalėlis;PĖLEDŽIUKŲ;37201848270;Taip;0;0;3;3
10386;Sakalėlis;PĖLEDŽIUKŲ;49947049847;Taip;9;0;2;11
10387;Sakalėlis;PĖLEDŽIUKŲ;4364341933;Taip;5;0;3;8
10388;Sakalėlis;PĖLEDŽIUKŲ;79413947806;Taip;0;4;0;4
10389;Sakalėlis;"BITUČIŲ (LOGOPEDINĖ)";4649447372;Taip;3;0;7;10
10390;Sakalėlis;"BITUČIŲ (LOGOPEDINĖ)";16884257622;Taip;4;0;0;4
10391;Sakalėlis;"BITUČIŲ (LOGOPEDINĖ)";4086981816;Ne;5;2;7;14
10392;Sakalėlis;"BITUČIŲ (LOGOPEDINĖ)";4716949191;Taip;0;0;1;1
10393;Sakalėlis;"BITUČIŲ (LOGOPEDINĖ)";7241416465;Ne;0;0;3;3
10394;Sakalėlis;"BITUČIŲ (LOGOPEDINĖ)";6321575268;Ne;0;0;3;3
10395;Sakalėlis;"BITUČIŲ (LOGOPEDINĖ)";4857211754;Taip;0;9;0;9
10396;Sakalėlis;"BITUČIŲ (LOGOPEDINĖ)";8610668395;Taip;0;4;3;7
10397;Sakalėlis;"BITUČIŲ (LOGOPEDINĖ)";5377250664;Ne;0;0;4;4
10398;Sakalėlis;"BITUČIŲ (LOGOPEDINĖ)";46481555688;Taip;12;0;5;17
10399;Sakalėlis;"BORUŽIUKŲ (LOGOPEDINĖ)";68146506860;Taip;6;4;4;14
10400;Sakalėlis;"BORUŽIUKŲ (LOGOPEDINĖ)";92557587855;Ne;4;3;2;9
10401;Sakalėlis;"BORUŽIUKŲ (LOGOPEDINĖ)";1765370689;Ne;0;1;0;1
10402;Sakalėlis;"BORUŽIUKŲ (LOGOPEDINĖ)";22863239773;Taip;0;2;1;3
10403;Sakalėlis;"BORUŽIUKŲ (LOGOPEDINĖ)";70791762492;Taip;0;4;0;4
10404;Sakalėlis;"BORUŽIUKŲ (LOGOPEDINĖ)";9452901338;Taip;3;1;0;4
10405;Sakalėlis;"BORUŽIUKŲ (LOGOPEDINĖ)";1288160341;Ne;0;2;0;2
10406;Sakalėlis;"BORUŽIUKŲ (LOGOPEDINĖ)";4514546151;Ne;7;6;2;15
10407;Sakalėlis;"BORUŽIUKŲ (LOGOPEDINĖ)";50037388220;Taip;0;5;0;5
10408;Sakalėlis;"BORUŽIUKŲ (LOGOPEDINĖ)";9740003273;Taip;0;4;1;5
10409;Sakalėlis;"BORUŽIUKŲ (LOGOPEDINĖ)";2074868084;Taip;8;0;3;11
10410;Sakalėlis;"BORUŽIUKŲ (LOGOPEDINĖ)";4495453007;Taip;2;4;3;9
10411;Sakalėlis;MEŠKUČIŲ;4136266629;Taip;9;0;1;10
10412;Sakalėlis;MEŠKUČIŲ;6840368824;Taip;7;0;0;7
10413;Sakalėlis;MEŠKUČIŲ;6250400609;Taip;3;0;6;9
10414;Sakalėlis;MEŠKUČIŲ;1742362136;Taip;0;4;1;5
10415;Sakalėlis;MEŠKUČIŲ;9322351120;Ne;15;0;0;15
10416;Sakalėlis;MEŠKUČIŲ;7672947538;Taip;10;0;0;10
10417;Sakalėlis;MEŠKUČIŲ;5233697077;Taip;4;2;2;8
10418;Sakalėlis;MEŠKUČIŲ;3680732318;Ne;10;6;0;16
10419;Sakalėlis;MEŠKUČIŲ;4862004373;Ne;8;2;0;10
10420;Sakalėlis;MEŠKUČIŲ;6579827280;Taip;0;8;0;8
10421;Sakalėlis;MEŠKUČIŲ;6806170544;Taip;3;0;0;3
10422;Sakalėlis;MEŠKUČIŲ;8381310908;Taip;5;0;9;14
10423;Sakalėlis;MEŠKUČIŲ;7285833058;Taip;7;0;0;7
10424;Sakalėlis;MEŠKUČIŲ;5795250727;Taip;5;7;0;12
10425;Sakalėlis;MEŠKUČIŲ;2985239904;Taip;4;4;0;8
10426;Sakalėlis;MEŠKUČIŲ;3351218789;Ne;7;0;6;13
10427;Sakalėlis;MEŠKUČIŲ;4986131090;Taip;9;0;0;9
10428;Sakalėlis;MEŠKUČIŲ;3927363997;Taip;0;1;0;1
10429;Sakalėlis;MEŠKUČIŲ;9120873899;Ne;10;0;0;10
10430;Sakalėlis;MEŠKUČIŲ;2352118061;Taip;0;0;1;1
10431;Sakalėlis;KIŠKUČIŲ;1806698668;Taip;3;0;4;7
10432;Sakalėlis;KIŠKUČIŲ;2898006208;Taip;11;0;4;15
10433;Sakalėlis;KIŠKUČIŲ;1201086815;Ne;21;0;0;21
10434;Sakalėlis;KIŠKUČIŲ;9416737436;Taip;0;0;10;10
10435;Sakalėlis;KIŠKUČIŲ;4918228191;Taip;11;0;0;11
10436;Sakalėlis;KIŠKUČIŲ;7706606275;Taip;4;1;0;5
10437;Sakalėlis;KIŠKUČIŲ;9272347788;Taip;0;2;0;2
10438;Sakalėlis;KIŠKUČIŲ;1117800518;Taip;19;0;0;19
10439;Sakalėlis;KIŠKUČIŲ;6515519140;Taip;0;5;5;10
10440;Sakalėlis;KIŠKUČIŲ;6586215199;Taip;0;10;0;10
10441;Sakalėlis;KIŠKUČIŲ;8095359035;Taip;9;5;4;18
10442;Sakalėlis;KIŠKUČIŲ;5911341542;Taip;8;0;1;9
10443;Sakalėlis;KIŠKUČIŲ;8331612396;Taip;0;0;7;7
10444;Sakalėlis;KIŠKUČIŲ;7542322748;Taip;19;0;0;19
10445;Sakalėlis;KIŠKUČIŲ;3934295338;Taip;2;3;2;7
10446;Sakalėlis;SVIRPLIUKŲ;3574956316;Taip;4;0;3;7
10447;Sakalėlis;SVIRPLIUKŲ;7602249339;Taip;7;4;0;11
10448;Sakalėlis;SVIRPLIUKŲ;1403384561;Taip;6;0;1;7
10449;Sakalėlis;SVIRPLIUKŲ;1953356983;Taip;14;0;2;16
10450;Sakalėlis;SVIRPLIUKŲ;4358313171;Taip;8;0;0;8
10451;Sakalėlis;SVIRPLIUKŲ;6414564366;Taip;21;0;0;21
10452;Sakalėlis;SVIRPLIUKŲ;1833573491;Taip;5;0;0;5
10453;Sakalėlis;SVIRPLIUKŲ;1736303381;Taip;7;0;1;8
10454;Sakalėlis;SVIRPLIUKŲ;1200252225;Taip;0;1;0;1
10455;Sakalėlis;SVIRPLIUKŲ;2531146677;Ne;16;0;0;16
10456;Sakalėlis;SVIRPLIUKŲ;8133985842;Taip;7;0;0;7
10457;Sakalėlis;SVIRPLIUKŲ;7280513854;Taip;5;0;1;6
10458;Sakalėlis;SVIRPLIUKŲ;6778987483;Taip;2;4;4;10
10459;Sakalėlis;SVIRPLIUKŲ;2575873447;Taip;14;0;1;15
10460;Sakalėlis;SVIRPLIUKŲ;2699844937;Taip;14;4;0;18
10461;Salininkų;BORUŽIUKAI;2467926286;Taip;2;15;0;17
10462;Salininkų;BORUŽIUKAI;8774984357;Taip;0;8;1;9
10463;Salininkų;BORUŽIUKAI;6125152143;Taip;0;4;2;6
10464;Salininkų;BORUŽIUKAI;2095952937;Taip;0;4;1;5
10465;Salininkų;BORUŽIUKAI;6551489987;Taip;0;6;0;6
10466;Salininkų;BORUŽIUKAI;6979816464;Taip;0;2;0;2
10467;Salininkų;BORUŽIUKAI;1928897962;Taip;16;0;0;16
10468;Salininkų;BORUŽIUKAI;3527495230;Taip;0;4;0;4
10469;Salininkų;BORUŽIUKAI;9996809930;Taip;7;0;4;11
10470;Salininkų;BORUŽIUKAI;8992580214;Taip;9;12;0;21
10471;Salininkų;BORUŽIUKAI;4480303856;Taip;2;0;9;11
10472;Salininkų;BORUŽIUKAI;3915336062;Taip;21;0;0;21
10473;Salininkų;BORUŽIUKAI;2073939432;Ne;7;0;0;7
10474;Salininkų;BORUŽIUKAI;9902751686;Taip;18;0;0;18
10475;Salininkų;BORUŽIUKAI;3252151974;Taip;19;0;0;19
10476;Salininkų;GĖLYTĖS;3015863723;Taip;21;0;0;21
10477;Salininkų;GĖLYTĖS;3323233525;Taip;21;0;0;21
10478;Salininkų;GĖLYTĖS;1832393272;Taip;2;2;0;4
10479;Salininkų;GĖLYTĖS;7665409499;Taip;12;0;2;14
10480;Salininkų;GĖLYTĖS;9890660815;Taip;0;0;2;2
10481;Salininkų;GĖLYTĖS;6850925495;Taip;0;9;0;9
10482;Salininkų;GĖLYTĖS;3585435095;Taip;7;0;4;11
10483;Salininkų;GĖLYTĖS;2760231414;Taip;21;0;0;21
10484;Salininkų;GĖLYTĖS;9724367035;Taip;8;4;0;12
10485;Salininkų;GĖLYTĖS;1658695150;Taip;9;4;1;14
10486;Salininkų;GĖLYTĖS;7383557807;Taip;11;6;0;17
10487;Salininkų;GĖLYTĖS;9344614003;Taip;5;8;0;13
10488;Salininkų;GĖLYTĖS;2808778763;Taip;0;15;0;15
10489;Salininkų;GĖLYTĖS;6656578271;Ne;5;5;0;10
10490;Salininkų;GĖLYTĖS;8995565864;Taip;16;2;0;18
10491;Salininkų;GĖLYTĖS;8394582546;Taip;0;10;0;10
10492;Salininkų;GĖLYTĖS;6327046935;Taip;2;1;1;4
10493;Salininkų;GĖLYTĖS;4323257798;Taip;9;1;0;10
10494;Salininkų;GĖLYTĖS;5427013789;Taip;3;4;0;7
10495;Salininkų;GĖLYTĖS;3100499807;Taip;0;6;0;6
10496;Salininkų;GĖLYTĖS;7782972361;Taip;0;11;0;11
10497;Salininkų;GĖLYTĖS;5867676844;Taip;6;0;5;11
10498;Salininkų;GĖLYTĖS;7737045952;Taip;11;0;0;11
10499;Salininkų;DRUGELIAI;1641123436;Taip;21;0;0;21
10500;Salininkų;DRUGELIAI;1910467994;Taip;9;3;0;12
10501;Salininkų;DRUGELIAI;2812554783;Taip;0;4;0;4
10502;Salininkų;DRUGELIAI;14626363996;Taip;5;4;3;12
10503;Salininkų;DRUGELIAI;1883307260;Taip;0;4;0;4
10504;Salininkų;DRUGELIAI;1948988168;Taip;4;4;3;11
10505;Salininkų;DRUGELIAI;1868857584;Ne;4;0;3;7
10506;Salininkų;DRUGELIAI;5434294777;Taip;0;3;0;3
10507;Salininkų;DRUGELIAI;1815368137;Taip;3;1;1;5
10508;Salininkų;DRUGELIAI;8157811781;Taip;0;12;0;12
10509;Salininkų;DRUGELIAI;1963139815;Ne;7;0;5;12
10510;Salininkų;DRUGELIAI;45194646218;Taip;0;5;0;5
10511;Salininkų;DRUGELIAI;6125334614;Taip;4;0;4;8
10512;Salininkų;DRUGELIAI;15199054558;Ne;0;11;0;11
10513;Salininkų;DRUGELIAI;1568780329;Taip;12;6;0;18
10514;Salininkų;DRUGELIAI;30123603107;Ne;9;0;1;10
10515;Salininkų;DRUGELIAI;8659656902;Ne;1;0;2;3
10516;Salininkų;DRUGELIAI;9074440999;Taip;4;0;3;7
10517;Salininkų;DRUGELIAI;8410624264;Taip;0;8;0;8
10518;Salininkų;ŽIRNIUKAI;5063792784;Taip;7;0;4;11
10519;Salininkų;ŽIRNIUKAI;73016259669;Ne;5;4;0;9
10520;Salininkų;ŽIRNIUKAI;41023354439;Taip;0;4;1;5
10521;Salininkų;ŽIRNIUKAI;76449285846;Ne;0;4;1;5
10522;Salininkų;ŽIRNIUKAI;1355032282;Taip;0;6;0;6
10523;Salininkų;ŽIRNIUKAI;35611320012;Taip;4;3;0;7
10524;Salininkų;ŽIRNIUKAI;1180792335;Taip;0;6;1;7
10525;Salininkų;ŽIRNIUKAI;22167560908;Taip;0;8;0;8
10526;Salininkų;ŽIRNIUKAI;9513785510;Taip;14;4;1;19
10527;Salininkų;ŽIRNIUKAI;5689344488;Taip;5;0;3;8
10528;Salininkų;ŽIRNIUKAI;2292919406;Taip;15;2;0;17
10529;Salininkų;ŽIRNIUKAI;8683841956;Taip;0;4;3;7
10530;Salininkų;ŽIRNIUKAI;10335028421;Taip;19;0;0;19
10531;Salininkų;ŽIRNIUKAI;8488127476;Taip;7;0;7;14
10532;Salininkų;ŽIRNIUKAI;1723241116;Taip;3;4;1;8
10533;Salininkų;ŽIRNIUKAI;46867660097;Taip;9;8;0;17
10534;Salininkų;ŽIRNIUKAI;4269202761;Taip;17;0;0;17
10535;Salininkų;ŽIRNIUKAI;3692008687;Taip;2;14;0;16
10536;Salininkų;ŽIRNIUKAI;91859774311;Taip;21;0;0;21
10537;Salininkų;ŽIRNIUKAI;1065549119;Taip;7;0;5;12
10538;Salininkų;ŽIRNIUKAI;8288199783;Taip;3;0;1;4
10539;Salininkų;ŽIRNIUKAI;1460694577;Taip;0;6;0;6
10540;Salininkų;PAUKŠČIUKAI;1202154135;Taip;0;4;0;4
10541;Salininkų;PAUKŠČIUKAI;1521333219;Taip;0;5;0;5
10542;Salininkų;PAUKŠČIUKAI;95919160139;Taip;0;4;1;5
10543;Salininkų;PAUKŠČIUKAI;25941514634;Ne;5;0;0;5
10544;Salininkų;PAUKŠČIUKAI;23990693770;Taip;0;4;0;4
10545;Salininkų;PAUKŠČIUKAI;67593920224;Ne;0;14;0;14
10546;Salininkų;PAUKŠČIUKAI;81888649482;Taip;5;0;0;5
10547;Salininkų;PAUKŠČIUKAI;1153455356;Taip;0;8;0;8
10548;Salininkų;PAUKŠČIUKAI;1470744233;Taip;0;11;0;11
10549;Salininkų;PAUKŠČIUKAI;2031724954;Taip;16;1;0;17
10550;Salininkų;PAUKŠČIUKAI;52499970010;Taip;17;0;0;17
10551;Salininkų;PAUKŠČIUKAI;18178857793;Taip;0;6;0;6
10552;Salininkų;PAUKŠČIUKAI;1439852031;Taip;0;9;0;9
10553;Salininkų;PAUKŠČIUKAI;20609963605;Taip;7;0;0;7
10554;Salininkų;PAUKŠČIUKAI;1918440067;Taip;5;0;0;5
10555;Salininkų;PAUKŠČIUKAI;52194170807;Ne;0;1;0;1
10556;Salininkų;PAUKŠČIUKAI;86019335524;Ne;0;1;0;1
10557;Salininkų;PAUKŠČIUKAI;1586012117;Taip;0;4;0;4
10558;Salininkų;PAUKŠČIUKAI;2415539904;Taip;0;4;0;4
10559;Salininkų;PAUKŠČIUKAI;29341671329;Taip;0;9;0;9
10560;Salininkų;PAUKŠČIUKAI;16967442608;Taip;0;10;0;10
10561;Salininkų;PAUKŠČIUKAI;7918995181;Taip;6;4;3;13
10562;Salvija;Daigelis(šatil);1261005294;Taip;0;2;2;4
10563;Salvija;Daigelis(šatil);3424917706;Ne;0;10;0;10
10564;Salvija;Daigelis(šatil);4152602039;Taip;5;0;0;5
10565;Salvija;Daigelis(šatil);7546216874;Taip;0;3;0;3
10566;Salvija;Daigelis(šatil);9456556523;Taip;0;4;0;4
10567;Salvija;Daigelis(šatil);3856351749;Taip;2;0;2;4
10568;Salvija;Daigelis(šatil);1653831148;Taip;0;5;0;5
10569;Salvija;Daigelis(šatil);8013023311;Taip;0;4;2;6
10570;Salvija;Daigelis(šatil);8023422294;Taip;19;0;0;19
10571;Salvija;Daigelis(šatil);8981331532;Taip;10;4;1;15
10572;Salvija;Daigelis(šatil);8306404275;Taip;15;0;0;15
10573;Salvija;Daigelis(šatil);8158680641;Taip;0;7;0;7
10574;Salvija;Daigelis(šatil);3487446998;Taip;10;0;0;10
10575;Salvija;Daigelis(šatil);6706565915;Taip;12;0;0;12
10576;Salvija;Daigelis(šatil);5723168506;Ne;0;8;0;8
10577;Salvija;Daigelis(šatil);4373711097;Taip;13;0;0;13
10578;Salvija;Daigelis(šatil);7477171133;Taip;21;0;0;21
10579;Salvija;Daigelis(šatil);8853389268;Taip;15;1;0;16
10580;Salvija;Daigelis(šatil);7862619996;Taip;0;0;5;5
10581;Salvija;Daigelis(šatil);7455466649;Taip;0;4;0;4
10582;Salvija;Daigelis(šatil);8214932544;Ne;0;4;0;4
10583;Salvija;"Pienė (savjon)";9168718017;Taip;7;4;0;11
10584;Salvija;"Pienė (savjon)";1641242817;Taip;6;0;1;7
10585;Salvija;"Pienė (savjon)";58888784609;Taip;0;10;2;12
10586;Salvija;"Pienė (savjon)";3331501534;Taip;0;4;2;6
10587;Salvija;"Pienė (savjon)";4845744417;Taip;10;8;0;18
10588;Salvija;"Pienė (savjon)";5494438837;Taip;0;4;0;4
10589;Salvija;"Pienė (savjon)";8798739147;Taip;16;4;0;20
10590;Salvija;"Pienė (savjon)";62121799666;Taip;0;1;0;1
10591;Salvija;"Pienė (savjon)";95774147903;Taip;0;4;2;6
10592;Salvija;"Pienė (savjon)";41158937437;Taip;0;0;2;2
10593;Salvija;"Pienė (savjon)";7361435128;Taip;0;0;5;5
10594;Salvija;"Pienė (savjon)";1396698456;Ne;0;4;1;5
10595;Salvija;"Pienė (savjon)";1478775998;Taip;0;4;1;5
10596;Salvija;"Pienė (savjon)";8802891478;Ne;0;0;6;6
10597;Salvija;"Pienė (savjon)";24038366791;Taip;6;2;2;10
10598;Salvija;"Pienė (savjon)";12326049516;Taip;0;4;0;4
10599;Salvija;"Pienė (savjon)";5784594015;Taip;0;4;0;4
10600;Salvija;"Pienė (savjon)";1517130961;Ne;0;1;0;1
10601;Salvija;"Pienė (savjon)";8725965215;Taip;0;4;4;8
10602;Salvija;"Pienė (savjon)";9908473681;Taip;0;1;5;6
10603;Saulėtekis;BERŽELIS;37001834066;Taip;15;0;0;15
10604;Saulėtekis;BERŽELIS;29935189464;Ne;6;2;0;8
10605;Saulėtekis;BERŽELIS;95214907923;Taip;0;2;0;2
10606;Saulėtekis;BERŽELIS;49102885577;Taip;0;1;0;1
10607;Saulėtekis;BERŽELIS;18801492293;Taip;0;1;2;3
10608;Saulėtekis;BERŽELIS;43809213927;Taip;0;2;0;2
10609;Saulėtekis;BERŽELIS;17046444483;Taip;0;0;3;3
10610;Saulėtekis;BERŽELIS;14357681543;Taip;0;4;1;5
10611;Saulėtekis;BERŽELIS;27109020149;Taip;0;1;0;1
10612;Saulėtekis;BERŽELIS;42952333477;Taip;0;6;0;6
10613;Saulėtekis;BERŽELIS;88165168902;Taip;0;5;0;5
10614;Saulėtekis;BERŽELIS;19786161536;Taip;0;7;0;7
10615;Saulėtekis;BERŽELIS;55975992548;Taip;0;4;4;8
10616;Saulėtekis;BERŽELIS;49746307178;Taip;0;3;0;3
10617;Saulėtekis;BERŽELIS;9632257866;Taip;10;4;2;16
10618;Saulėtekis;BERŽELIS;24403133622;Taip;0;9;0;9
10619;Saulėtekis;BERŽELIS;7440287746;Taip;0;6;0;6
10620;Saulėtekis;BERŽELIS;1502304241;Ne;0;5;4;9
10621;Saulėtekis;BERŽELIS;19209281962;Taip;0;1;0;1
10622;Saulėtekis;BERŽELIS;2096996257;Taip;10;4;2;16
10623;Saulėtekis;ŠYPSENA;1720125332;Taip;5;1;5;11
10624;Saulėtekis;ŠYPSENA;9972687066;Taip;13;4;0;17
10625;Saulėtekis;ŠYPSENA;7346852524;Ne;21;0;0;21
10626;Saulėtekis;ŠYPSENA;1902333363;Taip;5;7;0;12
10627;Saulėtekis;ŠYPSENA;6072030240;Taip;0;8;0;8
10628;Saulėtekis;ŠYPSENA;7893982893;Taip;7;1;3;11
10629;Saulėtekis;ŠYPSENA;7505040675;Taip;7;2;0;9
10630;Saulėtekis;ŠYPSENA;6501250875;Taip;17;0;0;17
10631;Saulėtekis;ŠYPSENA;9791926936;Taip;13;2;0;15
10632;Saulėtekis;ŠYPSENA;8620689981;Taip;10;1;0;11
10633;Saulėtekis;ŠYPSENA;8143793642;Taip;5;6;0;11
10634;Saulėtekis;ŠYPSENA;9783450998;Taip;0;5;0;5
10635;Saulėtekis;ŠYPSENA;4909850069;Taip;11;3;0;14
10636;Saulėtekis;ŠYPSENA;7673965242;Taip;21;0;0;21
10637;Saulėtekis;ŠYPSENA;3166959569;Taip;12;4;0;16
10638;Saulėtekis;ŠYPSENA;9661075465;Taip;4;1;0;5
10639;Saulėtekis;ŠYPSENA;2154590089;Ne;14;0;0;14
10640;Saulėtekis;ŠYPSENA;9383567339;Taip;15;2;0;17
10641;Saulėtekis;ŠYPSENA;4610536784;Ne;10;2;0;12
10642;Saulėtekis;NYKŠTUKAI;81074197598;Taip;0;6;0;6
10643;Saulėtekis;NYKŠTUKAI;87539304992;Taip;3;7;0;10
10644;Saulėtekis;NYKŠTUKAI;75818502835;Taip;4;1;0;5
10645;Saulėtekis;NYKŠTUKAI;1623791240;Taip;10;5;0;15
10646;Saulėtekis;NYKŠTUKAI;46936348504;Taip;2;3;0;5
10647;Saulėtekis;NYKŠTUKAI;47570401883;Taip;0;6;0;6
10648;Saulėtekis;NYKŠTUKAI;40443812162;Taip;4;1;2;7
10649;Saulėtekis;NYKŠTUKAI;1288313734;Taip;13;0;0;13
10650;Saulėtekis;NYKŠTUKAI;9333073549;Taip;11;4;0;15
10651;Saulėtekis;NYKŠTUKAI;75785868657;Taip;2;6;0;8
10652;Saulėtekis;NYKŠTUKAI;45284061866;Taip;0;2;0;2
10653;Saulėtekis;NYKŠTUKAI;1445753431;Ne;0;4;0;4
10654;Saulėtekis;NYKŠTUKAI;1064355395;Taip;0;7;0;7
10655;Saulėtekis;NYKŠTUKAI;1691667254;Taip;0;12;0;12
10656;Saulėtekis;NYKŠTUKAI;6736441901;Taip;0;8;0;8
10657;Saulėtekis;NYKŠTUKAI;1466627555;Taip;0;8;0;8
10658;Saulėtekis;NYKŠTUKAI;29552225924;Taip;0;5;0;5
10659;Saulėtekis;NYKŠTUKAI;1111323783;Taip;5;7;0;12
10660;Saulėtekis;NYKŠTUKAI;21569877958;Taip;10;4;0;14
10661;Saulėtekis;NYKŠTUKAI;1673236492;Taip;10;4;0;14
10662;Saulėtekis;NYKŠTUKAI;5104259667;Taip;6;4;0;10
10663;Saulėtekis;PAGRANDUKAS;8102360466;Taip;11;2;0;13
10664;Saulėtekis;PAGRANDUKAS;2371396923;Taip;10;0;2;12
10665;Saulėtekis;PAGRANDUKAS;4152255439;Taip;0;8;0;8
10666;Saulėtekis;PAGRANDUKAS;2209156661;Taip;2;10;0;12
10667;Saulėtekis;PAGRANDUKAS;3220993253;Taip;4;4;1;9
10668;Saulėtekis;PAGRANDUKAS;5552614092;Taip;8;3;0;11
10669;Saulėtekis;PAGRANDUKAS;9497129509;Taip;7;7;0;14
10670;Saulėtekis;PAGRANDUKAS;9918219913;Taip;5;5;0;10
10671;Saulėtekis;PAGRANDUKAS;8517049464;Taip;11;4;0;15
10672;Saulėtekis;PAGRANDUKAS;7186085219;Taip;4;2;0;6
10673;Saulėtekis;PAGRANDUKAS;1020209414;Taip;8;4;0;12
10674;Saulėtekis;PAGRANDUKAS;8745921541;Taip;0;6;0;6
10675;Saulėtekis;PAGRANDUKAS;2728836108;Taip;0;5;0;5
10676;Saulėtekis;PAGRANDUKAS;8390615573;Ne;9;0;0;9
10677;Saulėtekis;PAGRANDUKAS;2698535938;Taip;0;7;0;7
10678;Saulėtekis;PAGRANDUKAS;2656659133;Taip;10;8;0;18
10679;Saulėtekis;PAGRANDUKAS;7164579375;Taip;0;6;0;6
10680;Saulėtekis;PAGRANDUKAS;5678858566;Taip;8;5;0;13
10681;Saulėtekis;PAGRANDUKAS;4101644021;Taip;0;11;0;11
10682;Saulėtekis;PAGRANDUKAS;3366064429;Taip;7;4;0;11
10683;Saulėtekis;PAGRANDUKAS;8574702901;Ne;4;0;0;4
10684;Saulėtekis;RAMUNĖLIŲ;70948000188;Taip;4;5;0;9
10685;Saulėtekis;RAMUNĖLIŲ;21299038354;Taip;0;5;1;6
10686;Saulėtekis;RAMUNĖLIŲ;23797246535;Taip;5;4;0;9
10687;Saulėtekis;RAMUNĖLIŲ;16450627896;Ne;0;4;1;5
10688;Saulėtekis;RAMUNĖLIŲ;60662699125;Taip;0;4;0;4
10689;Saulėtekis;RAMUNĖLIŲ;77630031851;Taip;0;4;2;6
10690;Saulėtekis;RAMUNĖLIŲ;31291807930;Ne;2;11;0;13
10691;Saulėtekis;RAMUNĖLIŲ;42485505048;Ne;0;11;0;11
10692;Saulėtekis;RAMUNĖLIŲ;86593254070;Taip;0;5;3;8
10693;Saulėtekis;RAMUNĖLIŲ;40093795729;Taip;0;4;2;6
10694;Saulėtekis;RAMUNĖLIŲ;10524532865;Taip;0;6;0;6
10695;Saulėtekis;RAMUNĖLIŲ;80037388013;Taip;13;0;0;13
10696;Saulėtekis;RAMUNĖLIŲ;1219435678;Taip;2;7;0;9
10697;Saulėtekis;RAMUNĖLIŲ;29662148323;Taip;0;4;0;4
10698;Saulėtekis;RAMUNĖLIŲ;3394231244;Taip;7;5;1;13
10699;Saulėtekis;RAMUNĖLIŲ;7544912614;Taip;0;6;0;6
10700;Saulėtekis;RAMUNĖLIŲ;1349303787;Ne;7;5;0;12
10701;Saulėtekis;RAMUNĖLIŲ;1103824875;Taip;2;5;0;7
10702;Saulėtekis;RAMUNĖLIŲ;9611990012;Taip;0;5;0;5
10703;Saulėtekis;PASAKAITĖ;8033763960;Taip;14;2;0;16
10704;Saulėtekis;PASAKAITĖ;5086871001;Taip;17;1;0;18
10705;Saulėtekis;PASAKAITĖ;4681031693;Taip;0;3;0;3
10706;Saulėtekis;PASAKAITĖ;2446282019;Taip;12;4;0;16
10707;Saulėtekis;PASAKAITĖ;8572701238;Taip;12;4;0;16
10708;Saulėtekis;PASAKAITĖ;6979741482;Taip;14;0;0;14
10709;Saulėtekis;PASAKAITĖ;6063956790;Taip;0;5;0;5
10710;Saulėtekis;PASAKAITĖ;4437540996;Taip;16;2;0;18
10711;Saulėtekis;PASAKAITĖ;7407451018;Taip;9;0;0;9
10712;Saulėtekis;PASAKAITĖ;9226317303;Taip;0;4;0;4
10713;Saulėtekis;PASAKAITĖ;9267790598;Ne;14;0;0;14
10714;Saulėtekis;PASAKAITĖ;6670590135;Taip;11;0;0;11
10715;Saulėtekis;PASAKAITĖ;7966714585;Taip;15;0;0;15
10716;Saulėtekis;PASAKAITĖ;6784471792;Taip;0;8;0;8
10717;Saulėtekis;VARPELIAI;94326821425;Taip;7;7;0;14
10718;Saulėtekis;VARPELIAI;6984530386;Taip;0;3;0;3
10719;Saulėtekis;VARPELIAI;1069782559;Taip;0;4;0;4
10720;Saulėtekis;VARPELIAI;1339984127;Taip;4;6;0;10
10721;Saulėtekis;VARPELIAI;68563453302;Taip;12;4;0;16
10722;Saulėtekis;VARPELIAI;77901730057;Taip;0;11;0;11
10723;Saulėtekis;VARPELIAI;74713390994;Taip;11;0;0;11
10724;Saulėtekis;VARPELIAI;43127755042;Taip;0;7;0;7
10725;Saulėtekis;VARPELIAI;1154284625;Taip;0;1;0;1
10726;Saulėtekis;VARPELIAI;1335149249;Taip;0;6;0;6
10727;Saulėtekis;VARPELIAI;1108321396;Taip;0;4;2;6
10728;Saulėtekis;VARPELIAI;891603633;Taip;0;5;0;5
10729;Saulėtekis;VARPELIAI;36605502570;Taip;0;5;1;6
10730;Saulėtekis;VARPELIAI;2075281680;Taip;0;4;1;5
10731;Saulėtekis;VARPELIAI;1213567219;Ne;0;0;2;2
10732;Saulėtekis;VARPELIAI;61118132521;Ne;0;9;0;9
10733;Saulėtekis;VARPELIAI;7464965841;Taip;0;2;0;2
10734;Saulėtekis;VARPELIAI;6671771491;Taip;0;6;0;6
10735;Saulėtekis;VARPELIAI;2641849320;Ne;3;5;1;9
10736;Saulėtekis;GRŪDELIS;20794781914;Taip;9;0;2;11
10737;Saulėtekis;GRŪDELIS;9132383069;Taip;6;0;0;6
10738;Saulėtekis;GRŪDELIS;67951758325;Ne;8;0;0;8
10739;Saulėtekis;GRŪDELIS;70230805151;Taip;0;0;1;1
10740;Saulėtekis;GRŪDELIS;41775536104;Taip;8;7;0;15
10741;Saulėtekis;GRŪDELIS;12954283491;Taip;7;5;0;12
10742;Saulėtekis;GRŪDELIS;21376960952;Ne;4;5;0;9
10743;Saulėtekis;GRŪDELIS;86804497954;Taip;0;9;0;9
10744;Saulėtekis;GRŪDELIS;1180197203;Taip;7;5;1;13
10745;Saulėtekis;GRŪDELIS;1066191639;Taip;0;2;0;2
10746;Saulėtekis;GRŪDELIS;98936544904;Taip;6;0;0;6
10747;Saulėtekis;GRŪDELIS;22570044589;Taip;6;0;2;8
10748;Saulėtekis;GRŪDELIS;1865278537;Taip;0;6;0;6
10749;Saulėtekis;GRŪDELIS;1220962473;Taip;0;6;0;6
10750;Saulėtekis;GRŪDELIS;20534872540;Taip;12;0;3;15
10751;Saulėtekis;GRŪDELIS;53906058088;Taip;2;0;1;3
10752;Saulėtekis;GRŪDELIS;1646943569;Taip;20;0;0;20
10753;Saulėtekis;GRŪDELIS;1456140823;Taip;4;0;2;6
10754;Saulėtekis;GRŪDELIS;49053923177;Taip;0;0;3;3
10755;Saulėtekis;JONVABALIS;5003645081;Ne;11;2;0;13
10756;Saulėtekis;JONVABALIS;1715634399;Ne;2;10;0;12
10757;Saulėtekis;JONVABALIS;1897872021;Taip;6;4;0;10
10758;Saulėtekis;JONVABALIS;1010906684;Taip;11;1;0;12
10759;Saulėtekis;JONVABALIS;97037457833;Taip;0;2;0;2
10760;Saulėtekis;JONVABALIS;7227802003;Taip;0;2;0;2
10761;Saulėtekis;JONVABALIS;84492261206;Taip;0;8;0;8
10762;Saulėtekis;JONVABALIS;72559769416;Taip;0;5;0;5
10763;Saulėtekis;JONVABALIS;1611009868;Taip;15;0;0;15
10764;Saulėtekis;JONVABALIS;4613040294;Taip;12;1;0;13
10765;Saulėtekis;JONVABALIS;1655720839;Taip;14;2;0;16
10766;Saulėtekis;JONVABALIS;5249014111;Taip;18;0;0;18
10767;Saulėtekis;JONVABALIS;2101902207;Taip;4;10;0;14
10768;Saulėtekis;JONVABALIS;3166181835;Taip;12;2;0;14
10769;Saulėtekis;JONVABALIS;2335031800;Taip;0;7;0;7
10770;Saulėtekis;JONVABALIS;6599452886;Taip;10;3;0;13
10771;Saulėtekis;JONVABALIS;8896065807;Taip;0;8;0;8
10772;Saulėtekis;JONVABALIS;1702638461;Taip;11;5;0;16
10773;Saulėtekis;JONVABALIS;3207128776;Ne;5;1;0;6
10774;Saulėtekis;JONVABALIS;2311184444;Taip;0;9;0;9
10775;Saulėtekis;JONVABALIS;1267706132;Taip;19;0;0;19
10776;Saulėtekis;SMALSUČIAI;40877542045;Taip;7;8;0;15
10777;Saulėtekis;SMALSUČIAI;9095968376;Taip;0;14;0;14
10778;Saulėtekis;SMALSUČIAI;86524549051;Taip;6;0;0;6
10779;Saulėtekis;SMALSUČIAI;7030227903;Taip;2;7;0;9
10780;Saulėtekis;SMALSUČIAI;81118611780;Taip;0;9;0;9
10781;Saulėtekis;SMALSUČIAI;32771808648;Taip;0;4;0;4
10782;Saulėtekis;SMALSUČIAI;38762730531;Ne;0;6;0;6
10783;Saulėtekis;SMALSUČIAI;1808644850;Taip;14;6;0;20
10784;Saulėtekis;SMALSUČIAI;1642031589;Taip;12;5;0;17
10785;Saulėtekis;SMALSUČIAI;1568300232;Ne;11;0;0;11
10786;Saulėtekis;SMALSUČIAI;97771948184;Taip;12;5;0;17
10787;Saulėtekis;SMALSUČIAI;7621094096;Taip;0;10;0;10
10788;Saulėtekis;SMALSUČIAI;13451381485;Taip;0;7;0;7
10789;Saulėtekis;SMALSUČIAI;19605249139;Taip;0;6;0;6
10790;Saulėtekis;SMALSUČIAI;1619134034;Taip;0;7;0;7
10791;Saulėtekis;SMALSUČIAI;8673024996;Taip;6;3;1;10
10792;Saulėtekis;SMALSUČIAI;1456865685;Taip;0;8;0;8
10793;Saulėtekis;SMALSUČIAI;32658647272;Taip;7;1;0;8
10794;Saulėtekis;SMALSUČIAI;92060861583;Taip;3;4;0;7
10795;Saulėtekis;BITUTĖS;7766084857;Taip;8;0;1;9
10796;Saulėtekis;BITUTĖS;4537254306;Taip;0;6;0;6
10797;Saulėtekis;BITUTĖS;60462712074;Taip;0;0;4;4
10798;Saulėtekis;BITUTĖS;1699576940;Taip;6;0;0;6
10799;Saulėtekis;BITUTĖS;9945647968;Taip;18;0;0;18
10800;Saulėtekis;BITUTĖS;1962914764;Taip;5;4;7;16
10801;Saulėtekis;BITUTĖS;1481503733;Taip;8;0;0;8
10802;Saulėtekis;BITUTĖS;8302260087;Taip;0;0;3;3
10803;Saulėtekis;BITUTĖS;2593106154;Taip;11;0;1;12
10804;Saulėtekis;BITUTĖS;2813949848;Taip;17;1;0;18
10805;Saulėtekis;BITUTĖS;6643388548;Taip;5;2;0;7
10806;Saulėtekis;BITUTĖS;3058991890;Taip;10;6;0;16
10807;Saulėtekis;BITUTĖS;9983577817;Taip;10;3;0;13
10808;Saulėtekis;BITUTĖS;7986712728;Taip;7;0;4;11
10809;Saulėtekis;BITUTĖS;6087170055;Taip;8;1;0;9
10810;Saulėtekis;BITUTĖS;7027103276;Taip;13;1;0;14
10811;Saulėtekis;BITUTĖS;7758268674;Taip;16;0;0;16
10812;Saulėtekis;BITUTĖS;2077976415;Taip;9;6;1;16
10813;Saulėtekis;BITUTĖS;9605052795;Taip;8;0;0;8
10814;Saulėtekis;BITUTĖS;7075757274;Taip;7;7;0;14
10815;Saulėtekis;BITUTĖS;2639872637;Taip;7;0;0;7
10816;Saulėtekis;RIEŠUTĖLIAI;3337160930;Taip;5;3;0;8
10817;Saulėtekis;RIEŠUTĖLIAI;2021901593;Taip;0;6;0;6
10818;Saulėtekis;RIEŠUTĖLIAI;7842280836;Taip;21;0;0;21
10819;Saulėtekis;RIEŠUTĖLIAI;2407911405;Taip;6;3;0;9
10820;Saulėtekis;RIEŠUTĖLIAI;5954194843;Taip;6;5;0;11
10821;Saulėtekis;RIEŠUTĖLIAI;6102064617;Taip;0;3;0;3
10822;Saulėtekis;RIEŠUTĖLIAI;2238947856;Taip;0;9;0;9
10823;Saulėtekis;RIEŠUTĖLIAI;84982517658;Taip;0;6;0;6
10824;Saulėtekis;RIEŠUTĖLIAI;3541535891;Taip;0;8;0;8
10825;Saulėtekis;RIEŠUTĖLIAI;8231869593;Taip;15;0;1;16
10826;Saulėtekis;RIEŠUTĖLIAI;36003078842;Taip;0;6;0;6
10827;Saulėtekis;RIEŠUTĖLIAI;4663268649;Taip;0;6;0;6
10828;Saulėtekis;RIEŠUTĖLIAI;25199011812;Taip;10;0;2;12
10829;Saulėtekis;RIEŠUTĖLIAI;81153273188;Taip;11;2;0;13
10830;Saulėtekis;RIEŠUTĖLIAI;7051608858;Taip;9;0;0;9
10831;Saulėtekis;RIEŠUTĖLIAI;9634949452;Taip;13;0;0;13
10832;Saulėtekis;RIEŠUTĖLIAI;4338502152;Taip;2;2;0;4
10833;Saulėtekis;RIEŠUTĖLIAI;8002806189;Taip;11;0;0;11
10834;Saulėtekis;RIEŠUTĖLIAI;9657195627;Taip;0;8;0;8
10835;Saulėtekis;RIEŠUTĖLIAI;1290215067;Taip;3;4;0;7
10836;Saulėtekis;RIEŠUTĖLIAI;1209960122;Taip;4;0;0;4
10837;Skroblinukas;SVIRPLIUKŲ;56496090956;Ne;0;2;4;6
10838;Skroblinukas;SVIRPLIUKŲ;70884771171;Taip;0;2;4;6
10839;Skroblinukas;SVIRPLIUKŲ;27948464942;Taip;0;4;5;9
10840;Skroblinukas;SVIRPLIUKŲ;92096423589;Taip;0;5;0;5
10841;Skroblinukas;SVIRPLIUKŲ;5992090518;Taip;7;4;0;11
10842;Skroblinukas;SVIRPLIUKŲ;69303322030;Taip;5;4;0;9
10843;Skroblinukas;SVIRPLIUKŲ;2034869306;Taip;3;4;0;7
10844;Skroblinukas;SVIRPLIUKŲ;2020866728;Taip;0;4;2;6
10845;Skroblinukas;SVIRPLIUKŲ;1059137398;Taip;0;2;1;3
10846;Skroblinukas;SVIRPLIUKŲ;91070212533;Taip;2;9;0;11
10847;Skroblinukas;SVIRPLIUKŲ;60291417607;Taip;0;8;0;8
10848;Skroblinukas;SVIRPLIUKŲ;31484348317;Taip;5;4;1;10
10849;Skroblinukas;SVIRPLIUKŲ;88601994922;Taip;3;6;0;9
10850;Skroblinukas;SVIRPLIUKŲ;72829437831;Taip;7;0;0;7
10851;Skroblinukas;SVIRPLIUKŲ;1364608720;Taip;0;8;0;8
10852;Skroblinukas;SVIRPLIUKŲ;31670763980;Taip;0;4;3;7
10853;Skroblinukas;SVIRPLIUKŲ;89356084678;Ne;5;6;1;12
10854;Skroblinukas;SVIRPLIUKŲ;93644867290;Ne;9;4;0;13
10855;Skroblinukas;SVIRPLIUKŲ;30925721180;Taip;0;5;1;6
10856;Skroblinukas;SVIRPLIUKŲ;87902801288;Taip;5;4;0;9
10857;Skroblinukas;SVIRPLIUKŲ;1462404838;Ne;0;8;0;8
10858;Skroblinukas;SVIRPLIUKŲ;23551272822;Ne;0;4;0;4
10859;Skroblinukas;SVIRPLIUKŲ;2105394649;Taip;0;0;2;2
10860;Skroblinukas;GANDRIUKŲ;2197158518;Taip;7;0;3;10
10861;Skroblinukas;GANDRIUKŲ;2097758483;Taip;21;0;0;21
10862;Skroblinukas;GANDRIUKŲ;7921251819;Taip;0;5;0;5
10863;Skroblinukas;GANDRIUKŲ;9045708140;Taip;7;0;6;13
10864;Skroblinukas;GANDRIUKŲ;2406619611;Taip;10;4;0;14
10865;Skroblinukas;GANDRIUKŲ;9572912046;Taip;0;20;1;21
10866;Skroblinukas;GANDRIUKŲ;5646847921;Taip;7;4;0;11
10867;Skroblinukas;GANDRIUKŲ;1851920334;Ne;11;0;0;11
10868;Skroblinukas;GANDRIUKŲ;9377215921;Taip;10;3;1;14
10869;Skroblinukas;GANDRIUKŲ;6266609965;Ne;0;9;0;9
10870;Skroblinukas;GANDRIUKŲ;6235844690;Taip;0;0;3;3
10871;Skroblinukas;GANDRIUKŲ;6489976163;Taip;8;0;3;11
10872;Skroblinukas;GANDRIUKŲ;1159546580;Taip;7;2;0;9
10873;Skroblinukas;GANDRIUKŲ;2630699296;Taip;0;9;3;12
10874;Skroblinukas;GANDRIUKŲ;4571530482;Taip;0;3;1;4
10875;Skroblinukas;GANDRIUKŲ;2310750833;Taip;4;5;0;9
10876;Skroblinukas;GANDRIUKŲ;9888115079;Taip;0;12;1;13
10877;Skroblinukas;GANDRIUKŲ;9475514959;Ne;5;6;0;11
10878;Skroblinukas;GANDRIUKŲ;8862488358;Taip;12;0;0;12
10879;Skroblinukas;VYTURIUKŲ;40320573258;Taip;7;4;1;12
10880;Skroblinukas;VYTURIUKŲ;94897926442;Ne;10;1;0;11
10881;Skroblinukas;VYTURIUKŲ;7416993749;Taip;12;4;0;16
10882;Skroblinukas;VYTURIUKŲ;30982591733;Taip;0;4;0;4
10883;Skroblinukas;VYTURIUKŲ;82802300680;Taip;4;0;5;9
10884;Skroblinukas;VYTURIUKŲ;1935381164;Taip;0;4;1;5
10885;Skroblinukas;VYTURIUKŲ;58000101216;Taip;0;4;3;7
10886;Skroblinukas;VYTURIUKŲ;85704624097;Taip;0;2;0;2
10887;Skroblinukas;VYTURIUKŲ;72528180087;Ne;0;3;0;3
10888;Skroblinukas;VYTURIUKŲ;1096323930;Taip;11;4;0;15
10889;Skroblinukas;VYTURIUKŲ;60597534140;Ne;0;4;1;5
10890;Skroblinukas;VYTURIUKŲ;40602768192;Taip;0;7;2;9
10891;Skroblinukas;VYTURIUKŲ;3226377926;Ne;17;4;0;21
10892;Skroblinukas;VYTURIUKŲ;1175660577;Taip;0;4;6;10
10893;Skroblinukas;VYTURIUKŲ;1446835893;Taip;5;10;0;15
10894;Skroblinukas;VYTURIUKŲ;1710559060;Taip;10;5;0;15
10895;Skroblinukas;VYTURIUKŲ;21862553841;Taip;15;6;0;21
10896;Skroblinukas;VYTURIUKŲ;1611685585;Taip;15;6;0;21
10897;Skroblinukas;VYTURIUKŲ;1631945330;Taip;0;3;3;6
10898;Skroblinukas;VYTURIUKŲ;42252673755;Taip;4;5;0;9
10899;Skroblinukas;VYTURIUKŲ;7896922448;Taip;0;5;0;5
10900;Skroblinukas;VYTURIUKŲ;91409992058;Taip;0;2;0;2
10901;Skroblinukas;GENIUKŲ;48655837755;Taip;0;5;0;5
10902;Skroblinukas;GENIUKŲ;4393041946;Taip;0;7;0;7
10903;Skroblinukas;GENIUKŲ;2323980730;Taip;2;0;1;3
10904;Skroblinukas;GENIUKŲ;1325903217;Taip;0;9;0;9
10905;Skroblinukas;GENIUKŲ;8380073853;Taip;21;0;0;21
10906;Skroblinukas;GENIUKŲ;5766702969;Ne;7;3;4;14
10907;Skroblinukas;GENIUKŲ;4436698905;Taip;0;4;1;5
10908;Skroblinukas;GENIUKŲ;1905085978;Taip;0;0;2;2
10909;Skroblinukas;GENIUKŲ;1557733803;Taip;2;6;0;8
10910;Skroblinukas;GENIUKŲ;9433465007;Taip;0;4;0;4
10911;Skroblinukas;GENIUKŲ;1395950886;Ne;4;0;0;4
10912;Skroblinukas;GENIUKŲ;9777300890;Taip;6;0;1;7
10913;Skroblinukas;GENIUKŲ;1696303051;Taip;0;4;1;5
10914;Skroblinukas;GENIUKŲ;9846569195;Taip;7;1;1;9
10915;Skroblinukas;GENIUKŲ;3746278003;Taip;7;4;4;15
10916;Skroblinukas;GENIUKŲ;4773576465;Taip;0;4;6;10
10917;Skroblinukas;GENIUKŲ;2704157855;Taip;0;0;5;5
10918;Skroblinukas;GENIUKŲ;6129591146;Taip;0;4;0;4
10919;Skroblinukas;GENIUKŲ;3128337104;Ne;10;0;1;11
10920;Skroblinukas;GENIUKŲ;4272941994;Taip;6;4;1;11
10921;Skroblinukas;BITUČIŲ;1255323441;Taip;0;4;0;4
10922;Skroblinukas;BITUČIŲ;1934804499;Taip;0;7;0;7
10923;Skroblinukas;BITUČIŲ;2134821488;Taip;5;0;0;5
10924;Skroblinukas;BITUČIŲ;2071447940;Taip;17;0;0;17
10925;Skroblinukas;BITUČIŲ;1659335142;Taip;0;9;0;9
10926;Skroblinukas;BITUČIŲ;6604496585;Ne;0;7;0;7
10927;Skroblinukas;BITUČIŲ;3736883850;Taip;0;4;0;4
10928;Skroblinukas;BITUČIŲ;7191689856;Taip;12;6;0;18
10929;Skroblinukas;BITUČIŲ;8778072326;Taip;0;4;0;4
10930;Skroblinukas;BITUČIŲ;2032621707;Taip;8;0;2;10
10931;Skroblinukas;BITUČIŲ;8277152812;Taip;0;1;0;1
10932;Skroblinukas;BITUČIŲ;8374103872;Taip;0;5;0;5
10933;Skroblinukas;BITUČIŲ;8618587013;Taip;17;0;0;17
10934;Skroblinukas;BITUČIŲ;9594078223;Ne;0;9;0;9
10935;Skroblinukas;BITUČIŲ;9075266818;Ne;9;4;0;13
10936;Skroblinukas;BITUČIŲ;1432694920;Taip;6;9;0;15
10937;Skroblinukas;BITUČIŲ;1967305501;Taip;4;1;2;7
10938;Skroblinukas;BITUČIŲ;1688990637;Taip;10;0;1;11
10939;Skroblinukas;BITUČIŲ;1957488412;Taip;0;4;0;4
10940;Skroblinukas;BITUČIŲ;1000804920;Taip;0;4;0;4
10941;Skroblinukas;BITUČIŲ;1544346282;Ne;9;1;0;10
10942;Skroblinukas;BITUČIŲ;1711568129;Taip;0;4;2;6
10943;Skroblinukas;BORUŽĖLIŲ;5665463557;Taip;15;0;0;15
10944;Skroblinukas;BORUŽĖLIŲ;3292517112;Taip;0;4;0;4
10945;Skroblinukas;BORUŽĖLIŲ;2481980627;Taip;0;15;0;15
10946;Skroblinukas;BORUŽĖLIŲ;3512297435;Taip;0;1;3;4
10947;Skroblinukas;BORUŽĖLIŲ;3594000419;Taip;0;1;3;4
10948;Skroblinukas;BORUŽĖLIŲ;2978284436;Taip;4;0;1;5
10949;Skroblinukas;BORUŽĖLIŲ;9725125130;Taip;0;4;0;4
10950;Skroblinukas;BORUŽĖLIŲ;8946940285;Taip;0;9;1;10
10951;Skroblinukas;BORUŽĖLIŲ;3461165182;Taip;0;0;4;4
10952;Skroblinukas;BORUŽĖLIŲ;6433636135;Taip;0;15;3;18
10953;Skroblinukas;BORUŽĖLIŲ;9985033530;Taip;0;0;6;6
10954;Skroblinukas;BORUŽĖLIŲ;2887161771;Taip;6;4;1;11
10955;Skroblinukas;SKRUZDĖLIUKŲ;9634311146;Taip;4;2;0;6
10956;Skroblinukas;SKRUZDĖLIUKŲ;5688453546;Taip;0;6;3;9
10957;Skroblinukas;SKRUZDĖLIUKŲ;6890306112;Taip;0;7;0;7
10958;Skroblinukas;SKRUZDĖLIUKŲ;6445065388;Ne;0;7;0;7
10959;Skroblinukas;SKRUZDĖLIUKŲ;3006521657;Taip;0;5;0;5
10960;Skroblinukas;SKRUZDĖLIUKŲ;9448253468;Taip;7;0;0;7
10961;Skroblinukas;SKRUZDĖLIUKŲ;3771045336;Ne;0;4;0;4
10962;Skroblinukas;SKRUZDĖLIUKŲ;4424763028;Taip;8;1;0;9
10963;Skroblinukas;SKRUZDĖLIUKŲ;9353353289;Taip;12;6;0;18
10964;Skroblinukas;SKRUZDĖLIUKŲ;1970738675;Taip;0;0;21;21
10965;Skroblinukas;SKRUZDĖLIUKŲ;2883593274;Ne;5;1;0;6
10966;Skroblinukas;SKRUZDĖLIUKŲ;7493915017;Taip;0;4;0;4
10967;Skroblinukas;SKRUZDĖLIUKŲ;5157913924;Taip;11;4;0;15
10968;Skroblinukas;SKRUZDĖLIUKŲ;9368764758;Taip;10;4;0;14
10969;Skroblinukas;SKRUZDĖLIUKŲ;9958188318;Taip;11;4;0;15
10970;Skroblinukas;SKRUZDĖLIUKŲ;8576448571;Taip;4;0;0;4
10971;Skroblinukas;SKRUZDĖLIUKŲ;1002570367;Taip;0;2;4;6
10972;Skroblinukas;SKRUZDĖLIUKŲ;3290115134;Taip;7;4;1;12
10973;Skroblinukas;SKRUZDĖLIUKŲ;9813249677;Taip;11;0;0;11
10974;Skroblinukas;SKRUZDĖLIUKŲ;2101748012;Taip;2;0;0;2
10975;Skroblinukas;SKRUZDĖLIUKŲ;5915278745;Taip;8;1;0;9
10976;Skroblinukas;SKRUZDĖLIUKŲ;6640062847;Taip;9;5;0;14
10977;Skroblinukas;ŽVIRBLIUKŲ;3271736540;Taip;0;10;0;10
10978;Skroblinukas;ŽVIRBLIUKŲ;3065235192;Taip;7;0;0;7
10979;Skroblinukas;ŽVIRBLIUKŲ;5902713448;Taip;8;3;0;11
10980;Skroblinukas;ŽVIRBLIUKŲ;2330232287;Taip;0;0;2;2
10981;Skroblinukas;ŽVIRBLIUKŲ;7480611069;Taip;17;0;0;17
10982;Skroblinukas;ŽVIRBLIUKŲ;2071093890;Taip;10;0;0;10
10983;Skroblinukas;ŽVIRBLIUKŲ;9629502585;Taip;3;0;0;3
10984;Skroblinukas;ŽVIRBLIUKŲ;6879979868;Taip;0;0;2;2
10985;Skroblinukas;ŽVIRBLIUKŲ;3954228349;Taip;5;0;0;5
10986;Skroblinukas;ŽVIRBLIUKŲ;4560580022;Taip;2;4;2;8
10987;Skroblinukas;ŽVIRBLIUKŲ;8206063106;Taip;7;0;0;7
10988;Skroblinukas;ŽVIRBLIUKŲ;9553242594;Taip;7;7;0;14
10989;Skroblinukas;ŽVIRBLIUKŲ;2948231687;Taip;0;0;17;17
10990;Skroblinukas;ŽIOGELIŲ;8283516422;Taip;2;0;4;6
10991;Skroblinukas;ŽIOGELIŲ;1449037968;Taip;7;10;0;17
10992;Skroblinukas;ŽIOGELIŲ;9828486832;Taip;0;0;1;1
10993;Skroblinukas;ŽIOGELIŲ;1924714755;Taip;12;0;6;18
10994;Skroblinukas;ŽIOGELIŲ;8064713969;Taip;7;0;1;8
10995;Skroblinukas;ŽIOGELIŲ;8622930871;Taip;21;0;0;21
10996;Skroblinukas;ŽIOGELIŲ;4266945644;Taip;4;0;2;6
10997;Skroblinukas;ŽIOGELIŲ;7675772872;Taip;0;0;1;1
10998;Skroblinukas;ŽIOGELIŲ;7761972818;Taip;3;7;0;10
10999;Skroblinukas;ŽIOGELIŲ;8286842648;Taip;21;0;0;21
11000;Skroblinukas;ŽIOGELIŲ;6461678336;Taip;3;0;9;12
11001;Skroblinukas;ŽIOGELIŲ;7216760382;Taip;8;0;4;12
11002;Skroblinukas;ŽIOGELIŲ;5154111867;Taip;0;11;0;11
11003;Skroblinukas;ŽIOGELIŲ;4861971439;Taip;2;0;5;7
11004;Skroblinukas;ŽIOGELIŲ;9003855190;Taip;2;9;0;11
11005;Skroblinukas;STRAZDELIŲ;5433647187;Taip;8;0;1;9
11006;Skroblinukas;STRAZDELIŲ;9915130747;Taip;15;6;0;21
11007;Skroblinukas;STRAZDELIŲ;1669610397;Taip;7;0;3;10
11008;Skroblinukas;STRAZDELIŲ;5566457656;Ne;14;3;2;19
11009;Skroblinukas;STRAZDELIŲ;8312341293;Taip;21;0;0;21
11010;Skroblinukas;STRAZDELIŲ;6254811026;Taip;9;0;1;10
11011;Skroblinukas;STRAZDELIŲ;4960825597;Taip;6;0;0;6
11012;Skroblinukas;STRAZDELIŲ;2195112297;Taip;7;0;0;7
11013;Skroblinukas;STRAZDELIŲ;8958893525;Taip;13;0;2;15
11014;Skroblinukas;STRAZDELIŲ;7750501815;Taip;9;0;0;9
11015;Skroblinukas;STRAZDELIŲ;6574558658;Taip;21;0;0;21
11016;Skroblinukas;STRAZDELIŲ;4198512202;Taip;21;0;0;21
11017;Skroblinukas;STRAZDELIŲ;1544598440;Taip;12;2;0;14
11018;Skroblinukas;STRAZDELIŲ;4168542339;Taip;10;2;3;15
11019;Skroblinukas;DRUGELIŲ;1792672886;Taip;0;0;13;13
11020;Skroblinukas;DRUGELIŲ;1979723351;Ne;0;3;0;3
11021;Skroblinukas;DRUGELIŲ;1964529755;Taip;0;20;0;20
11022;Skroblinukas;DRUGELIŲ;86231564690;Taip;0;4;4;8
11023;Skroblinukas;DRUGELIŲ;23687553212;Taip;5;9;0;14
11024;Skroblinukas;DRUGELIŲ;4532268875;Taip;0;5;0;5
11025;Skroblinukas;DRUGELIŲ;86542450905;Taip;0;0;7;7
11026;Skroblinukas;DRUGELIŲ;54750454175;Taip;0;4;6;10
11027;Skroblinukas;DRUGELIŲ;2019575002;Taip;0;0;3;3
11028;Skroblinukas;DRUGELIŲ;3636028890;Taip;11;0;8;19
11029;Skroblinukas;DRUGELIŲ;2079452635;Taip;7;0;0;7
11030;Skroblinukas;DRUGELIŲ;1510927547;Taip;0;0;4;4
11031;Skroblinukas;DRUGELIŲ;2325940694;Taip;0;12;0;12
11032;Skroblinukas;DRUGELIŲ;15977832913;Taip;0;5;0;5
11033;Skroblinukas;DRUGELIŲ;5068339590;Taip;21;0;0;21
11034;Skroblinukas;DRUGELIŲ;3580045988;Taip;5;3;0;8
11035;Skroblinukas;DRUGELIŲ;1005726705;Taip;5;0;8;13
11036;Skroblinukas;DRUGELIŲ;1388763405;Taip;9;0;0;9
11037;Skroblinukas;DRUGELIŲ;1791669956;Taip;4;0;4;8
11038;Skroblinukas;DRUGELIŲ;7184817010;Taip;10;4;0;14
11039;Skroblinukas;DRUGELIŲ;1109895463;Ne;0;7;1;8
11040;Skroblinukas;DRUGELIŲ;60061213883;Taip;16;0;0;16
11041;Skroblinukas;DRUGELIŲ;2116630768;Taip;0;4;0;4
11042;Skroblinukas;DRUGELIŲ;18955401411;Taip;11;0;1;12
11043;Skroblinukas;PELĖDŽIUKŲ;5975039463;Taip;19;0;0;19
11044;Skroblinukas;PELĖDŽIUKŲ;63514584063;Taip;0;18;0;18
11045;Skroblinukas;PELĖDŽIUKŲ;1000422430;Ne;0;10;0;10
11046;Skroblinukas;PELĖDŽIUKŲ;1556675902;Taip;0;4;4;8
11047;Skroblinukas;PELĖDŽIUKŲ;7666122737;Taip;0;0;2;2
11048;Skroblinukas;PELĖDŽIUKŲ;3864043251;Taip;0;4;0;4
11049;Skroblinukas;PELĖDŽIUKŲ;1759830058;Taip;0;7;0;7
11050;Skroblinukas;PELĖDŽIUKŲ;1471842192;Taip;0;10;0;10
11051;Skroblinukas;PELĖDŽIUKŲ;1382981497;Taip;0;3;0;3
11052;Skroblinukas;PELĖDŽIUKŲ;29908502973;Taip;0;6;0;6
11053;Skroblinukas;PELĖDŽIUKŲ;1220311458;Taip;0;6;0;6
11054;Skroblinukas;PELĖDŽIUKŲ;1599112927;Taip;0;5;1;6
11055;Skroblinukas;PELĖDŽIUKŲ;95946607624;Ne;0;8;0;8
11056;Skroblinukas;PELĖDŽIUKŲ;8150037173;Taip;0;5;0;5
11057;Skroblinukas;PELĖDŽIUKŲ;1898486832;Taip;12;0;0;12
11058;Skroblinukas;PELĖDŽIUKŲ;4221501092;Taip;0;0;1;1
11059;Skroblinukas;PELĖDŽIUKŲ;1515227489;Ne;0;0;5;5
11060;Skroblinukas;PELĖDŽIUKŲ;76523308405;Taip;12;6;0;18
11061;Skroblinukas;PELĖDŽIUKŲ;1602978649;Taip;0;9;0;9
11062;Skroblinukas;PELĖDŽIUKŲ;1258044022;Taip;0;4;3;7
11063;Skroblinukas;PELĖDŽIUKŲ;39209870512;Taip;0;11;0;11
11064;Skroblinukas;PELĖDŽIUKŲ;4914479407;Taip;0;0;5;5
11065;Skroblinukas;PELĖDŽIUKŲ;1847074960;Taip;2;0;6;8
11066;Skroblinukas;PELĖDŽIUKŲ;87741312158;Taip;3;2;0;5
11067;Skroblinukas;PELĖDŽIUKŲ;3858891097;Taip;4;4;0;8
11068;Smalsučiai;Žibuoklės;46376560575;Taip;0;7;0;7
11069;Smalsučiai;Žibuoklės;27034024515;Ne;0;4;1;5
11070;Smalsučiai;Žibuoklės;68726523946;Ne;2;4;0;6
11071;Smalsučiai;Žibuoklės;50803234873;Taip;0;1;1;2
11072;Smalsučiai;Žibuoklės;85358131888;Taip;7;5;0;12
11073;Smalsučiai;Žibuoklės;51861969442;Taip;0;4;0;4
11074;Smalsučiai;Žibuoklės;82746324948;Ne;0;4;0;4
11075;Smalsučiai;Žibuoklės;51889095612;Taip;0;8;2;10
11076;Smalsučiai;Žibuoklės;4258713607;Taip;0;9;0;9
11077;Smalsučiai;Žibuoklės;68097436766;Taip;0;6;0;6
11078;Smalsučiai;Žibuoklės;40922293471;Taip;0;2;0;2
11079;Smalsučiai;Žibuoklės;85342418658;Taip;0;4;0;4
11080;Smalsučiai;Žibuoklės;1023262986;Taip;0;3;0;3
11081;Smalsučiai;Žibuoklės;83033796468;Taip;4;4;0;8
11082;Smalsučiai;Žibuoklės;62767756842;Taip;0;4;1;5
11083;Smalsučiai;Žibuoklės;2099765750;Taip;7;4;0;11
11084;Smalsučiai;Žibuoklės;9512217842;Taip;0;3;0;3
11085;Smalsučiai;Žibuoklės;56779125767;Taip;0;6;1;7
11086;Smalsučiai;Žibuoklės;97809921080;Taip;0;1;0;1
11087;Smalsučiai;Žibuoklės;2021640036;Taip;0;9;0;9
11088;Smalsučiai;Aitvarų;2638709634;Taip;5;4;0;9
11089;Smalsučiai;Aitvarų;5441966713;Taip;13;2;0;15
11090;Smalsučiai;Aitvarų;9632022271;Taip;0;0;4;4
11091;Smalsučiai;Aitvarų;8306946163;Taip;0;6;0;6
11092;Smalsučiai;Aitvarų;6469044880;Taip;15;1;0;16
11093;Smalsučiai;Aitvarų;8193410963;Ne;2;1;0;3
11094;Smalsučiai;Aitvarų;99467576480;Ne;7;1;0;8
11095;Smalsučiai;Aitvarų;2136420967;Taip;5;0;1;6
11096;Smalsučiai;Aitvarų;2059832436;Taip;0;2;1;3
11097;Smalsučiai;Aitvarų;4795138729;Taip;7;4;0;11
11098;Smalsučiai;Aitvarų;1316590100;Taip;0;2;0;2
11099;Smalsučiai;Aitvarų;1997966082;Taip;0;7;0;7
11100;Smalsučiai;Aitvarų;1372591510;Taip;6;4;1;11
11101;Smalsučiai;Aitvarų;4585930202;Taip;10;0;1;11
11102;Smalsučiai;Aitvarų;8810690546;Taip;6;8;0;14
11103;Smalsučiai;Aitvarų;2365835087;Taip;8;0;2;10
11104;Smalsučiai;Aitvarų;1775539505;Taip;0;14;0;14
11105;Smalsučiai;Aitvarų;5761169841;Taip;7;1;1;9
11106;Smalsučiai;Aitvarų;4909226602;Taip;4;0;0;4
11107;Smalsučiai;Aitvarų;6536165801;Taip;7;0;1;8
11108;Smalsučiai;Aitvarų;3644256220;Taip;0;0;4;4
11109;Smalsučiai;Sraigiukų;1156210876;Taip;7;4;0;11
11110;Smalsučiai;Sraigiukų;37375504483;Taip;0;3;0;3
11111;Smalsučiai;Sraigiukų;5631758578;Taip;0;8;0;8
11112;Smalsučiai;Sraigiukų;76405732236;Taip;0;4;0;4
11113;Smalsučiai;Sraigiukų;48426272721;Taip;7;4;0;11
11114;Smalsučiai;Sraigiukų;26007606072;Taip;0;6;0;6
11115;Smalsučiai;Sraigiukų;31748074403;Taip;9;4;0;13
11116;Smalsučiai;Sraigiukų;55212746834;Taip;7;0;0;7
11117;Smalsučiai;Sraigiukų;67243805772;Taip;0;5;2;7
11118;Smalsučiai;Sraigiukų;68897306811;Taip;0;7;0;7
11119;Smalsučiai;Sraigiukų;1417945043;Taip;0;8;0;8
11120;Smalsučiai;Sraigiukų;12446167265;Taip;0;6;0;6
11121;Smalsučiai;Sraigiukų;45731306499;Ne;7;7;0;14
11122;Smalsučiai;Sraigiukų;70181610962;Ne;4;3;0;7
11123;Smalsučiai;Sraigiukų;71839472863;Taip;0;3;0;3
11124;Smalsučiai;Sraigiukų;97665693700;Taip;0;6;0;6
11125;Smalsučiai;Sraigiukų;95501158334;Taip;0;4;0;4
11126;Smalsučiai;Sraigiukų;1095159887;Taip;0;8;0;8
11127;Smalsučiai;Sraigiukų;1424532027;Ne;4;4;2;10
11128;Smalsučiai;Saulučių;4655599359;Taip;0;0;3;3
11129;Smalsučiai;Saulučių;1504060488;Taip;0;1;2;3
11130;Smalsučiai;Saulučių;2112871055;Taip;8;1;0;9
11131;Smalsučiai;Saulučių;50085798686;Taip;2;4;4;10
11132;Smalsučiai;Saulučių;1025164832;Taip;0;0;20;20
11133;Smalsučiai;Saulučių;4903800388;Taip;0;0;8;8
11134;Smalsučiai;Saulučių;52829213579;Taip;10;9;0;19
11135;Smalsučiai;Saulučių;1594035039;Taip;0;19;0;19
11136;Smalsučiai;Saulučių;8542926346;Taip;8;0;7;15
11137;Smalsučiai;Saulučių;4042979105;Taip;6;0;0;6
11138;Smalsučiai;Saulučių;1760728524;Taip;7;4;0;11
11139;Smalsučiai;Saulučių;28055409190;Taip;0;4;1;5
11140;Smalsučiai;Saulučių;44888860122;Ne;0;0;3;3
11141;Smalsučiai;Saulučių;1567576834;Ne;11;1;0;12
11142;Smalsučiai;Saulučių;1965194010;Taip;7;4;1;12
11143;Smalsučiai;Saulučių;1673246147;Taip;7;10;0;17
11144;Smalsučiai;Saulučių;62387945180;Taip;13;0;1;14
11145;Smalsučiai;Saulučių;1257427271;Taip;5;4;0;9
11146;Smalsučiai;Viščiukų;13763655324;Taip;0;0;1;1
11147;Smalsučiai;Viščiukų;2802867649;Taip;0;4;0;4
11148;Smalsučiai;Viščiukų;66281706978;Taip;4;0;0;4
11149;Smalsučiai;Viščiukų;30592434971;Taip;5;4;1;10
11150;Smalsučiai;Viščiukų;18717627431;Taip;5;4;0;9
11151;Smalsučiai;Viščiukų;26787916874;Taip;6;4;0;10
11152;Smalsučiai;Viščiukų;63575906792;Taip;9;8;0;17
11153;Smalsučiai;Viščiukų;27727844778;Taip;0;7;0;7
11154;Smalsučiai;Viščiukų;1514166474;Taip;0;11;0;11
11155;Smalsučiai;Viščiukų;37702522563;Taip;0;3;0;3
11156;Smalsučiai;Viščiukų;95945382872;Taip;0;2;0;2
11157;Smalsučiai;Viščiukų;96002139110;Taip;9;1;0;10
11158;Smalsučiai;Viščiukų;1893910089;Taip;0;2;0;2
11159;Smalsučiai;Viščiukų;1786097164;Ne;0;6;0;6
11160;Smalsučiai;Viščiukų;78496301809;Taip;2;14;0;16
11161;Smalsučiai;Viščiukų;92961881271;Taip;0;10;0;10
11162;Smalsučiai;Viščiukų;66603023493;Taip;10;0;0;10
11163;Smalsučiai;Viščiukų;6264082741;Taip;0;9;0;9
11164;Smalsučiai;Viščiukų;30464130912;Taip;0;0;4;4
11165;Smalsučiai;Viščiukų;4732277124;Taip;3;5;0;8
11166;Smalsučiai;Boružėlių;9426629964;Ne;0;0;1;1
11167;Smalsučiai;Boružėlių;1703679877;Taip;3;0;3;6
11168;Smalsučiai;Boružėlių;2208462326;Taip;0;12;0;12
11169;Smalsučiai;Boružėlių;6643253926;Taip;0;7;0;7
11170;Smalsučiai;Boružėlių;1473016908;Ne;0;0;3;3
11171;Smalsučiai;Boružėlių;7226242747;Taip;0;5;2;7
11172;Smalsučiai;Boružėlių;6085020049;Taip;14;2;0;16
11173;Smalsučiai;Boružėlių;8340768848;Ne;0;0;4;4
11174;Smalsučiai;Boružėlių;6578328053;Taip;0;4;0;4
11175;Smalsučiai;Boružėlių;69450514879;Ne;0;0;7;7
11176;Smalsučiai;Boružėlių;4740303929;Taip;0;5;0;5
11177;Smalsučiai;Boružėlių;2694575252;Ne;3;0;0;3
11178;Smalsučiai;Boružėlių;2671403814;Taip;0;9;1;10
11179;Smalsučiai;Boružėlių;2737886714;Taip;0;12;0;12
11180;Smalsučiai;Boružėlių;4858914868;Taip;12;4;2;18
11181;Smalsučiai;Boružėlių;8523742213;Taip;0;12;0;12
11182;Smalsučiai;Zuikių;3792738445;Taip;15;4;0;19
11183;Smalsučiai;Zuikių;1453463899;Taip;0;0;3;3
11184;Smalsučiai;Zuikių;92129554371;Taip;0;9;0;9
11185;Smalsučiai;Zuikių;1830368274;Taip;5;5;5;15
11186;Smalsučiai;Zuikių;8604112256;Taip;0;4;0;4
11187;Smalsučiai;Zuikių;92460059853;Taip;7;4;0;11
11188;Smalsučiai;Zuikių;8572292571;Taip;0;2;2;4
11189;Smalsučiai;Zuikių;1968415573;Taip;0;2;0;2
11190;Smalsučiai;Zuikių;36701180571;Taip;0;4;0;4
11191;Smalsučiai;Zuikių;87920436781;Taip;3;4;0;7
11192;Smalsučiai;Zuikių;1597721199;Taip;0;5;0;5
11193;Smalsučiai;Zuikių;2036701320;Ne;0;7;1;8
11194;Smalsučiai;Zuikių;18980466605;Taip;8;3;0;11
11195;Smalsučiai;Zuikių;7243102874;Ne;9;4;0;13
11196;Smalsučiai;Zuikių;2057177596;Taip;1;5;0;6
11197;Smalsučiai;Zuikių;1788190385;Taip;0;4;4;8
11198;Smalsučiai;Nykštukų;2327930850;Taip;0;8;0;8
11199;Smalsučiai;Nykštukų;3787937467;Taip;5;12;0;17
11200;Smalsučiai;Nykštukų;4134975456;Taip;8;0;0;8
11201;Smalsučiai;Nykštukų;9155011285;Taip;5;6;0;11
11202;Smalsučiai;Nykštukų;9582225178;Ne;10;4;0;14
11203;Smalsučiai;Nykštukų;4566816316;Taip;3;11;0;14
11204;Smalsučiai;Nykštukų;1471941426;Taip;11;3;0;14
11205;Smalsučiai;Nykštukų;1458544456;Taip;6;4;0;10
11206;Smalsučiai;Nykštukų;4364810458;Taip;14;0;0;14
11207;Smalsučiai;Nykštukų;6469604093;Taip;4;5;0;9
11208;Smalsučiai;Nykštukų;6358800570;Taip;10;4;0;14
11209;Smalsučiai;Nykštukų;5184903287;Taip;4;2;0;6
11210;Smalsučiai;Nykštukų;7933302912;Taip;15;0;0;15
11211;Smalsučiai;Nykštukų;3757955200;Taip;17;4;0;21
11212;Smalsučiai;Nykštukų;5406430393;Taip;9;0;0;9
11213;Smalsučiai;Nykštukų;6899040199;Taip;17;1;0;18
11214;Smalsučiai;Nykštukų;4824786207;Taip;7;0;0;7
11215;Smalsučiai;Nykštukų;4629526320;Taip;8;2;0;10
11216;Smalsučiai;Nykštukų;9604182559;Taip;5;1;0;6
11217;Smalsučiai;Nykštukų;7396172351;Taip;6;7;0;13
11218;Smalsučiai;Katinėlių;8259056296;Taip;12;0;0;12
11219;Smalsučiai;Katinėlių;9864518144;Taip;2;5;0;7
11220;Smalsučiai;Katinėlių;2958335372;Taip;10;4;0;14
11221;Smalsučiai;Katinėlių;7137550663;Taip;15;0;0;15
11222;Smalsučiai;Katinėlių;6090391818;Taip;19;0;0;19
11223;Smalsučiai;Katinėlių;6577214344;Taip;9;5;3;17
11224;Smalsučiai;Katinėlių;6478152041;Ne;13;5;0;18
11225;Smalsučiai;Katinėlių;6006832443;Ne;2;5;0;7
11226;Smalsučiai;Katinėlių;8128348060;Taip;17;0;0;17
11227;Smalsučiai;Katinėlių;9637877396;Taip;2;0;1;3
11228;Smalsučiai;Katinėlių;4847584492;Taip;7;4;0;11
11229;Smalsučiai;Katinėlių;6415906523;Taip;6;0;0;6
11230;Smalsučiai;Katinėlių;8763382361;Taip;2;4;5;11
11231;Smalsučiai;Katinėlių;4425714802;Taip;6;1;0;7
11232;Smalsučiai;Katinėlių;9732075162;Taip;5;0;1;6
11233;Smalsučiai;Katinėlių;7023531176;Taip;5;5;0;10
11234;Smalsučiai;Katinėlių;4565479092;Taip;7;0;0;7
11235;Smalsučiai;Katinėlių;7256557310;Ne;0;10;0;10
11236;Smalsučiai;PELĖDŽIUKAI;94734585174;Taip;0;5;0;5
11237;Smalsučiai;PELĖDŽIUKAI;63886240982;Taip;7;11;0;18
11238;Smalsučiai;PELĖDŽIUKAI;98196404299;Taip;4;5;0;9
11239;Smalsučiai;PELĖDŽIUKAI;25838645404;Taip;0;1;0;1
11240;Smalsučiai;PELĖDŽIUKAI;66154228179;Taip;0;4;0;4
11241;Smalsučiai;PELĖDŽIUKAI;16418705168;Taip;0;4;0;4
11242;Smalsučiai;PELĖDŽIUKAI;96461087926;Taip;9;5;0;14
11243;Smalsučiai;PELĖDŽIUKAI;99471280741;Taip;2;1;0;3
11244;Smalsučiai;PELĖDŽIUKAI;55812291804;Taip;12;6;0;18
11245;Smalsučiai;PELĖDŽIUKAI;1276659532;Taip;4;1;0;5
11246;Smalsučiai;PELĖDŽIUKAI;81834985961;Taip;7;4;0;11
11247;Smalsučiai;PELĖDŽIUKAI;513516143;Taip;5;4;0;9
11248;Smalsučiai;PELĖDŽIUKAI;47452987441;Taip;0;4;0;4
11249;Smalsučiai;PELĖDŽIUKAI;54610929862;Taip;0;10;0;10
11250;Smalsučiai;PELĖDŽIUKAI;32382108578;Taip;0;5;0;5
11251;Smalsučiai;PELĖDŽIUKAI;73783991852;Taip;2;5;0;7
11252;Smalsučiai;PELĖDŽIUKAI;57622458673;Ne;14;4;0;18
11253;Smalsučiai;PELĖDŽIUKAI;73899364649;Taip;0;4;8;12
11254;Smalsučiai;PELĖDŽIUKAI;1575017231;Taip;0;3;0;3
11255;Smalsučiai;PELĖDŽIUKAI;6857124432;Taip;5;1;0;6
11256;Smalsučiai;PELĖDŽIUKAI;1653798728;Taip;9;2;0;11
11257;Smalsučiai;PELĖDŽIUKAI;59594678142;Taip;0;5;0;5
11258;Smalsučiai;Pingvinukai;4288788194;Taip;6;0;1;7
11259;Smalsučiai;Pingvinukai;6535494814;Taip;13;0;0;13
11260;Smalsučiai;Pingvinukai;3309134310;Taip;0;9;0;9
11261;Smalsučiai;Pingvinukai;5402027714;Taip;12;6;0;18
11262;Smalsučiai;Pingvinukai;2326167599;Taip;8;1;2;11
11263;Smalsučiai;Pingvinukai;4094037708;Taip;5;4;0;9
11264;Smalsučiai;Pingvinukai;5893045664;Taip;10;4;0;14
11265;Smalsučiai;Pingvinukai;5482692473;Taip;0;11;0;11
11266;Smalsučiai;Pingvinukai;4379372200;Taip;0;7;1;8
11267;Smalsučiai;Pingvinukai;7070240693;Ne;7;5;0;12
11268;Smalsučiai;Pingvinukai;7726086066;Taip;7;2;5;14
11269;Smalsučiai;Pingvinukai;1380214235;Taip;7;0;2;9
11270;Smalsučiai;Pingvinukai;8644849194;Ne;0;0;11;11
11271;Smalsučiai;Pingvinukai;3071594259;Taip;11;0;1;12
11272;Smalsučiai;Pingvinukai;7107126092;Taip;11;0;1;12
11273;Smalsučiai;Pingvinukai;3877274360;Taip;19;0;0;19
11274;Smalsučiai;Voverikų;2618753095;Taip;10;0;0;10
11275;Smalsučiai;Voverikų;7713078413;Taip;0;8;0;8
11276;Smalsučiai;Voverikų;3607226859;Taip;0;7;0;7
11277;Smalsučiai;Voverikų;22791221635;Taip;0;8;1;9
11278;Smalsučiai;Voverikų;7794541741;Taip;4;4;4;12
11279;Smalsučiai;Voverikų;1467603676;Ne;0;14;0;14
11280;Smalsučiai;Voverikų;1982046497;Taip;0;2;0;2
11281;Smalsučiai;Voverikų;1181574676;Taip;9;7;0;16
11282;Smalsučiai;Voverikų;1599488035;Taip;7;8;0;15
11283;Smalsučiai;Voverikų;6207026048;Taip;0;10;0;10
11284;Smalsučiai;Voverikų;19592364606;Taip;7;0;0;7
11285;Smalsučiai;Voverikų;1668692281;Taip;5;0;0;5
11286;Smalsučiai;Voverikų;5730866119;Taip;6;3;0;9
11287;Smalsučiai;Voverikų;1824321380;Taip;10;4;1;15
11288;Smalsučiai;Voverikų;5611487967;Taip;6;5;0;11
11289;Smalsučiai;Voverikų;8520753848;Ne;0;7;0;7
11290;Smalsučiai;Voverikų;4145769042;Taip;0;1;4;5
11291;Smalsučiai;Voverikų;4727475042;Taip;4;0;2;6
11292;Smalsučiai;Voverikų;6529889121;Taip;14;0;0;14
11293;Smalsučiai;Voverikų;3627324317;Taip;0;19;0;19
11294;Spindulėlis;SAULUTĖS;6449284856;Ne;4;0;17;21
11295;Spindulėlis;SAULUTĖS;1180176295;Taip;5;1;6;12
11296;Spindulėlis;SAULUTĖS;1730248631;Taip;0;0;8;8
11297;Spindulėlis;SAULUTĖS;2234877411;Taip;0;0;2;2
11298;Spindulėlis;SAULUTĖS;4353031174;Ne;12;0;1;13
11299;Spindulėlis;SAULUTĖS;1424288192;Taip;0;4;0;4
11300;Spindulėlis;SAULUTĖS;1346035733;Taip;0;4;0;4
11301;Spindulėlis;SAULUTĖS;9903990297;Taip;4;0;1;5
11302;Spindulėlis;SAULUTĖS;4077985773;Taip;14;0;0;14
11303;Spindulėlis;SAULUTĖS;6592057292;Taip;6;4;5;15
11304;Spindulėlis;SAULUTĖS;2890377876;Taip;0;0;3;3
11305;Spindulėlis;SAULUTĖS;9511051386;Taip;0;0;4;4
11306;Spindulėlis;SAULUTĖS;5578151523;Taip;5;0;0;5
11307;Spindulėlis;SAULUTĖS;8141324449;Taip;10;0;11;21
11308;Spindulėlis;SAULUTĖS;9244494109;Taip;12;0;7;19
11309;Spindulėlis;SAULUTĖS;8923393066;Taip;4;0;1;5
11310;Spindulėlis;SAULUTĖS;5288557629;Taip;12;0;1;13
11311;Spindulėlis;SAULUTĖS;7099787230;Taip;11;0;1;12
11312;Spindulėlis;SAULUTĖS;4929866385;Taip;9;0;6;15
11313;Spindulėlis;SAULUTĖS;5233044803;Taip;0;0;6;6
11314;Spindulėlis;DRUGELIAI;1528496272;Taip;0;6;0;6
11315;Spindulėlis;DRUGELIAI;2988630379;Taip;2;4;0;6
11316;Spindulėlis;DRUGELIAI;55250330957;Taip;2;4;2;8
11317;Spindulėlis;DRUGELIAI;80331157814;Taip;5;4;0;9
11318;Spindulėlis;DRUGELIAI;60956380679;Taip;7;1;1;9
11319;Spindulėlis;DRUGELIAI;2131409282;Taip;0;0;3;3
11320;Spindulėlis;DRUGELIAI;9348576749;Taip;0;4;5;9
11321;Spindulėlis;DRUGELIAI;63344816879;Taip;8;0;5;13
11322;Spindulėlis;DRUGELIAI;9145337789;Taip;2;0;10;12
11323;Spindulėlis;DRUGELIAI;96365393879;Taip;0;11;0;11
11324;Spindulėlis;DRUGELIAI;7757264510;Taip;0;0;1;1
11325;Spindulėlis;DRUGELIAI;5050019035;Taip;0;6;0;6
11326;Spindulėlis;DRUGELIAI;1821231102;Taip;9;0;0;9
11327;Spindulėlis;DRUGELIAI;21152690883;Taip;0;2;7;9
11328;Spindulėlis;DRUGELIAI;1514479696;Taip;7;0;2;9
11329;Spindulėlis;DRUGELIAI;1391226466;Taip;0;5;0;5
11330;Spindulėlis;DRUGELIAI;27408123487;Taip;0;16;0;16
11331;Spindulėlis;DRUGELIAI;1694423628;Taip;0;6;0;6
11332;Spindulėlis;DRUGELIAI;1679106754;Taip;0;3;0;3
11333;Spindulėlis;DRUGELIAI;72997461686;Taip;3;0;0;3
11334;Spindulėlis;DRUGELIAI;4194714698;Taip;0;0;7;7
11335;Spindulėlis;DRUGELIAI;9977569249;Ne;4;0;2;6
11336;Spindulėlis;DRUGELIAI;6435045068;Taip;0;4;0;4
11337;Spindulėlis;BITUTĖS;54387249420;Taip;0;1;0;1
11338;Spindulėlis;BITUTĖS;83785970474;Taip;0;4;0;4
11339;Spindulėlis;BITUTĖS;92803008887;Taip;1;5;0;6
11340;Spindulėlis;BITUTĖS;4539792030;Ne;0;4;0;4
11341;Spindulėlis;BITUTĖS;16045001090;Taip;0;3;0;3
11342;Spindulėlis;BITUTĖS;1399847362;Ne;0;4;0;4
11343;Spindulėlis;BITUTĖS;3986191435;Taip;0;5;1;6
11344;Spindulėlis;BITUTĖS;97661389553;Taip;0;4;0;4
11345;Spindulėlis;BITUTĖS;64339072411;Taip;5;1;0;6
11346;Spindulėlis;BITUTĖS;2137229669;Ne;7;3;0;10
11347;Spindulėlis;BITUTĖS;19541905006;Taip;0;5;0;5
11348;Spindulėlis;BITUTĖS;503164673;Taip;0;6;0;6
11349;Spindulėlis;BITUTĖS;27928352319;Taip;5;4;0;9
11350;Spindulėlis;BITUTĖS;18443825776;Taip;0;2;1;3
11351;Spindulėlis;BITUTĖS;1033202443;Taip;0;4;1;5
11352;Spindulėlis;BITUTĖS;30036722764;Ne;0;4;17;21
11353;Spindulėlis;BITUTĖS;1763306358;Taip;0;4;1;5
11354;Spindulėlis;BITUTĖS;29747353664;Taip;0;4;2;6
11355;Spindulėlis;BITUTĖS;1939526832;Taip;0;5;0;5
11356;Spindulėlis;VARPELIAI;7184471307;Taip;5;0;0;5
11357;Spindulėlis;VARPELIAI;4116151797;Ne;4;0;2;6
11358;Spindulėlis;VARPELIAI;3276656641;Taip;16;0;0;16
11359;Spindulėlis;VARPELIAI;8039086094;Taip;17;0;0;17
11360;Spindulėlis;VARPELIAI;3329587401;Taip;7;0;0;7
11361;Spindulėlis;VARPELIAI;6633031473;Taip;2;0;2;4
11362;Spindulėlis;VARPELIAI;6880075874;Taip;11;0;0;11
11363;Spindulėlis;VARPELIAI;4152722583;Taip;2;0;3;5
11364;Spindulėlis;VARPELIAI;8793327541;Taip;0;1;3;4
11365;Spindulėlis;VARPELIAI;6949857110;Taip;4;0;0;4
11366;Spindulėlis;VARPELIAI;2511267939;Ne;0;0;6;6
11367;Spindulėlis;VARPELIAI;4171789569;Taip;7;5;4;16
11368;Spindulėlis;VARPELIAI;1454039572;Taip;9;0;0;9
11369;Spindulėlis;VARPELIAI;9740815635;Taip;11;0;0;11
11370;Spindulėlis;VARPELIAI;4308169582;Taip;9;0;3;12
11371;Spragtukas;NYKŠTUKAI;4809829190;Taip;19;0;0;19
11372;Spragtukas;NYKŠTUKAI;4527798635;Taip;11;0;0;11
11373;Spragtukas;NYKŠTUKAI;8551195766;Taip;13;0;0;13
11374;Spragtukas;NYKŠTUKAI;8623311748;Taip;13;1;0;14
11375;Spragtukas;NYKŠTUKAI;9805841777;Ne;2;8;0;10
11376;Spragtukas;NYKŠTUKAI;2943832694;Taip;0;5;0;5
11377;Spragtukas;NYKŠTUKAI;8460527225;Taip;4;1;0;5
11378;Spragtukas;NYKŠTUKAI;8297700739;Taip;9;1;0;10
11379;Spragtukas;NYKŠTUKAI;9595221494;Ne;2;5;0;7
11380;Spragtukas;NYKŠTUKAI;6185016824;Taip;4;6;0;10
11381;Spragtukas;NYKŠTUKAI;8715073512;Taip;9;0;0;9
11382;Spragtukas;NYKŠTUKAI;6162830167;Taip;17;0;0;17
11383;Spragtukas;NYKŠTUKAI;1710184531;Taip;5;0;0;5
11384;Spragtukas;NYKŠTUKAI;2076126173;Taip;7;8;0;15
11385;Spragtukas;NYKŠTUKAI;3012345413;Taip;14;0;0;14
11386;Spragtukas;NYKŠTUKAI;8698492694;Taip;12;4;0;16
11387;Spragtukas;NYKŠTUKAI;1150002524;Taip;15;0;0;15
11388;Spragtukas;NYKŠTUKAI;4493810276;Taip;0;2;0;2
11389;Spragtukas;NYKŠTUKAI;8288793522;Taip;15;2;0;17
11390;Spragtukas;SAULUTĖ;89749837388;Ne;0;10;1;11
11391;Spragtukas;SAULUTĖ;92289435393;Taip;0;3;0;3
11392;Spragtukas;SAULUTĖ;3392224465;Taip;0;4;0;4
11393;Spragtukas;SAULUTĖ;1174566363;Taip;3;0;0;3
11394;Spragtukas;SAULUTĖ;10998123453;Taip;0;5;2;7
11395;Spragtukas;SAULUTĖ;48934106998;Ne;5;1;0;6
11396;Spragtukas;SAULUTĖ;34989165939;Ne;0;11;0;11
11397;Spragtukas;SAULUTĖ;1527719937;Taip;0;1;0;1
11398;Spragtukas;SAULUTĖ;1889153590;Taip;0;2;1;3
11399;Spragtukas;SAULUTĖ;53375921406;Ne;0;4;0;4
11400;Spragtukas;SAULUTĖ;50653432030;Taip;0;5;0;5
11401;Spragtukas;SAULUTĖ;63252513820;Taip;0;2;0;2
11402;Spragtukas;SAULUTĖ;4321780080;Taip;4;2;0;6
11403;Spragtukas;SAULUTĖ;51889437335;Taip;3;4;0;7
11404;Spragtukas;SAULUTĖ;94483480424;Taip;0;5;1;6
11405;Spragtukas;SAULUTĖ;7234682005;Taip;0;7;0;7
11406;Spragtukas;SAULUTĖ;80790750169;Taip;4;8;0;12
11407;Spragtukas;SAULUTĖ;96435499947;Taip;0;9;0;9
11408;Spragtukas;SAULUTĖ;91767288727;Taip;0;6;0;6
11409;Spragtukas;SAULUTĖ;94418271961;Taip;0;5;1;6
11410;Spragtukas;SAULUTĖ;5377198769;Taip;9;1;0;10
11411;Spragtukas;SAULUTĖ;14001343134;Taip;0;6;1;7
11412;Spragtukas;SPINDULĖLIAI;94650801877;Ne;0;4;0;4
11413;Spragtukas;SPINDULĖLIAI;4675031453;Taip;8;0;0;8
11414;Spragtukas;SPINDULĖLIAI;4004275398;Taip;2;8;0;10
11415;Spragtukas;SPINDULĖLIAI;9781727236;Taip;6;0;0;6
11416;Spragtukas;SPINDULĖLIAI;1029392579;Taip;9;0;0;9
11417;Spragtukas;SPINDULĖLIAI;6417098461;Taip;0;13;0;13
11418;Spragtukas;SPINDULĖLIAI;1336973131;Taip;4;0;0;4
11419;Spragtukas;SPINDULĖLIAI;70413855110;Taip;7;0;2;9
11420;Spragtukas;SPINDULĖLIAI;47393966396;Ne;0;4;0;4
11421;Spragtukas;SPINDULĖLIAI;65692358082;Taip;4;0;2;6
11422;Spragtukas;SPINDULĖLIAI;1945068716;Taip;0;4;0;4
11423;Spragtukas;SPINDULĖLIAI;6052538605;Taip;7;6;0;13
11424;Spragtukas;SPINDULĖLIAI;2138152514;Taip;0;7;0;7
11425;Spragtukas;SPINDULĖLIAI;1305123801;Taip;0;4;0;4
11426;Spragtukas;SPINDULĖLIAI;4485715299;Taip;2;7;3;12
11427;Spragtukas;SPINDULĖLIAI;4224693184;Taip;6;0;0;6
11428;Spragtukas;SPINDULĖLIAI;81928765016;Taip;9;0;0;9
11429;Spragtukas;SPINDULĖLIAI;8415429693;Ne;16;0;0;16
11430;Spragtukas;GINTARĖLIAI;1437794402;Taip;2;4;0;6
11431;Spragtukas;GINTARĖLIAI;37209001618;Taip;14;2;0;16
11432;Spragtukas;GINTARĖLIAI;15208696709;Taip;8;2;0;10
11433;Spragtukas;GINTARĖLIAI;82498261158;Taip;0;2;0;2
11434;Spragtukas;GINTARĖLIAI;32290835176;Taip;0;4;0;4
11435;Spragtukas;GINTARĖLIAI;68059396649;Ne;6;4;0;10
11436;Spragtukas;GINTARĖLIAI;39962240237;Taip;0;1;0;1
11437;Spragtukas;GINTARĖLIAI;1035579583;Taip;0;1;0;1
11438;Spragtukas;GINTARĖLIAI;95645593385;Taip;2;0;0;2
11439;Spragtukas;GINTARĖLIAI;8554047390;Taip;4;7;0;11
11440;Spragtukas;GINTARĖLIAI;69086864157;Ne;2;13;0;15
11441;Spragtukas;ČIPOLINO;2371848091;Taip;10;2;0;12
11442;Spragtukas;ČIPOLINO;6582680700;Taip;13;1;0;14
11443;Spragtukas;ČIPOLINO;1599958343;Taip;7;0;0;7
11444;Spragtukas;ČIPOLINO;1547670082;Taip;0;7;0;7
11445;Spragtukas;ČIPOLINO;7504632314;Taip;0;4;0;4
11446;Spragtukas;ČIPOLINO;1597988501;Taip;0;6;0;6
11447;Spragtukas;ČIPOLINO;6526633051;Taip;0;3;0;3
11448;Spragtukas;ČIPOLINO;1058970799;Taip;9;5;0;14
11449;Spragtukas;ČIPOLINO;45661532130;Taip;4;1;0;5
11450;Spragtukas;ČIPOLINO;3045382299;Taip;0;4;0;4
11451;Spragtukas;ČIPOLINO;7640805299;Taip;0;4;0;4
11452;Spragtukas;ČIPOLINO;2493749424;Taip;2;5;0;7
11453;Spragtukas;ČIPOLINO;1365907314;Taip;17;0;0;17
11454;Spragtukas;ČIPOLINO;4941531443;Taip;16;0;0;16
11455;Spragtukas;ČIPOLINO;3566797064;Taip;4;8;0;12
11456;Spragtukas;ČIPOLINO;2902550587;Taip;19;0;0;19
11457;Spragtukas;ČIPOLINO;1827458781;Taip;0;10;0;10
11458;Spragtukas;ČIPOLINO;3798118695;Taip;4;10;0;14
11459;Spragtukas;ČIPOLINO;69114720307;Taip;0;5;0;5
11460;Spragtukas;ČIPOLINO;9789977863;Taip;0;3;7;10
11461;Spragtukas;ČIPOLINO;1044112039;Ne;12;7;0;19
11462;Spragtukas;ČIPOLINO;5707084920;Taip;16;0;0;16
11463;Spragtukas;BORUŽĖLĖS;2356476212;Taip;11;0;0;11
11464;Spragtukas;BORUŽĖLĖS;8429135626;Taip;14;3;0;17
11465;Spragtukas;BORUŽĖLĖS;8287102733;Taip;19;1;0;20
11466;Spragtukas;BORUŽĖLĖS;5844437769;Ne;15;0;0;15
11467;Spragtukas;BORUŽĖLĖS;6584145176;Taip;0;6;0;6
11468;Spragtukas;BORUŽĖLĖS;8226921630;Ne;4;7;0;11
11469;Spragtukas;BORUŽĖLĖS;2946297529;Ne;15;2;0;17
11470;Spragtukas;BORUŽĖLĖS;9860876807;Taip;11;1;0;12
11471;Spragtukas;BORUŽĖLĖS;5633883897;Ne;12;2;0;14
11472;Spragtukas;BORUŽĖLĖS;1570206034;Taip;16;1;0;17
11473;Spragtukas;BORUŽĖLĖS;9965087132;Taip;5;8;0;13
11474;Spragtukas;BORUŽĖLĖS;6031408197;Taip;21;0;0;21
11475;Spragtukas;BORUŽĖLĖS;7806145224;Taip;9;4;0;13
11476;Spragtukas;BORUŽĖLĖS;2909322678;Taip;4;2;0;6
11477;Spragtukas;BORUŽĖLĖS;5236797574;Ne;7;3;0;10
11478;Spragtukas;BORUŽĖLĖS;1306663967;Taip;5;9;0;14
11479;Spragtukas;BORUŽĖLĖS;4069044269;Taip;0;9;0;9
11480;Spragtukas;BORUŽĖLĖS;5150028968;Taip;9;0;0;9
11481;Spragtukas;BORUŽĖLĖS;9754594384;Ne;19;1;0;20
11482;Spragtukas;BORUŽĖLĖS;1756340613;Taip;5;2;0;7
11483;Spragtukas;DRUGELIAI;41147623084;Taip;7;5;0;12
11484;Spragtukas;DRUGELIAI;1138975383;Taip;1;6;0;7
11485;Spragtukas;DRUGELIAI;32858776091;Taip;0;2;1;3
11486;Spragtukas;DRUGELIAI;91794949460;Taip;2;4;0;6
11487;Spragtukas;DRUGELIAI;2118272247;Taip;9;5;0;14
11488;Spragtukas;DRUGELIAI;46794033116;Taip;5;4;0;9
11489;Spragtukas;DRUGELIAI;1418494757;Taip;3;4;0;7
11490;Spragtukas;DRUGELIAI;60980580078;Taip;12;2;0;14
11491;Spragtukas;DRUGELIAI;82801263312;Taip;13;0;0;13
11492;Spragtukas;DRUGELIAI;56384144331;Taip;0;5;2;7
11493;Spragtukas;DRUGELIAI;2032107153;Ne;0;5;0;5
11494;Spragtukas;DRUGELIAI;19580966465;Taip;6;1;0;7
11495;Spragtukas;DRUGELIAI;1731215395;Taip;6;5;1;12
11496;Spragtukas;DRUGELIAI;67679737675;Taip;1;1;0;2
11497;Spragtukas;DRUGELIAI;1953368351;Taip;8;5;0;13
11498;Spragtukas;DRUGELIAI;271958429;Taip;4;1;0;5
11499;Spragtukas;DRUGELIAI;1030688447;Taip;12;1;0;13
11500;Spragtukas;DRUGELIAI;99915428485;Taip;5;0;0;5
11501;Spragtukas;DRUGELIAI;22025568463;Ne;1;5;0;6
11502;Spragtukas;DRUGELIAI;1491147348;Taip;0;4;1;5
11503;Spragtukas;DRUGELIAI;38120721944;Taip;0;4;0;4
11504;Spragtukas;DRUGELIAI;20279570129;Ne;3;9;0;12
11505;Spragtukas;GAIDELIAI;7569802487;Taip;0;5;0;5
11506;Spragtukas;GAIDELIAI;71081903240;Taip;2;5;0;7
11507;Spragtukas;GAIDELIAI;79237309377;Taip;0;10;0;10
11508;Spragtukas;GAIDELIAI;54099559107;Taip;14;0;0;14
11509;Spragtukas;GAIDELIAI;19453957982;Taip;0;5;0;5
11510;Spragtukas;GAIDELIAI;1203266608;Taip;12;0;0;12
11511;Spragtukas;GAIDELIAI;11849369985;Taip;2;6;0;8
11512;Spragtukas;GAIDELIAI;2042294168;Taip;0;5;0;5
11513;Spragtukas;GAIDELIAI;1030566027;Taip;20;0;0;20
11514;Spragtukas;GAIDELIAI;8150653485;Taip;16;1;0;17
11515;Spragtukas;GAIDELIAI;1247838976;Taip;4;4;0;8
11516;Spragtukas;GAIDELIAI;2061441977;Taip;14;0;0;14
11517;Spragtukas;GAIDELIAI;9644808747;Taip;5;7;0;12
11518;Spragtukas;GAIDELIAI;78296815539;Taip;0;1;0;1
11519;Spragtukas;GAIDELIAI;4209118353;Taip;21;0;0;21
11520;Spragtukas;GAIDELIAI;6501930436;Taip;16;1;0;17
11521;Spragtukas;GAIDELIAI;2848207417;Taip;5;5;0;10
11522;Spragtukas;GAIDELIAI;1210698072;Taip;10;1;0;11
11523;Spragtukas;GAIDELIAI;1070119148;Taip;7;8;0;15
11524;Spragtukas;GAIDELIAI;9235972927;Taip;8;5;0;13
11525;Spragtukas;ŽUVELĖS;8762832644;Ne;14;0;0;14
11526;Spragtukas;ŽUVELĖS;8652973900;Taip;6;5;0;11
11527;Spragtukas;ŽUVELĖS;3261213140;Taip;0;4;0;4
11528;Spragtukas;ŽUVELĖS;5689392663;Taip;10;0;0;10
11529;Spragtukas;ŽUVELĖS;9592271053;Taip;0;5;0;5
11530;Spragtukas;ŽUVELĖS;1272075883;Taip;0;5;0;5
11531;Spragtukas;ŽUVELĖS;6465991136;Taip;4;4;0;8
11532;Spragtukas;ŽUVELĖS;9282940430;Taip;13;0;0;13
11533;Spragtukas;ŽUVELĖS;6503842956;Taip;0;1;0;1
11534;Spragtukas;ŽUVELĖS;2578400770;Taip;0;2;0;2
11535;Spragtukas;ŽUVELĖS;6757604305;Taip;12;0;1;13
11536;Spragtukas;ŽUVELĖS;3139748724;Taip;18;0;0;18
11537;Spragtukas;ŽUVELĖS;8640877497;Taip;9;0;1;10
11538;Spragtukas;ŽUVELĖS;2025314314;Taip;16;0;0;16
11539;Spragtukas;ŽUVELĖS;4848647219;Taip;5;2;0;7
11540;Spragtukas;ŽUVELĖS;3491418162;Taip;13;0;1;14
11541;Spragtukas;ŽUVELĖS;5836788916;Taip;10;6;0;16
11542;Spragtukas;ŽUVELĖS;5704941595;Taip;7;8;0;15
11543;Spragtukas;ŽUVELĖS;3286456855;Taip;7;5;0;12
11544;Spragtukas;ŽUVELĖS;9662188102;Taip;5;4;0;9
11545;Spragtukas;ŽUVELĖS;2539660577;Ne;0;5;1;6
11546;Spragtukas;RIEŠUTĖLIAI;8444759709;Taip;6;7;0;13
11547;Spragtukas;RIEŠUTĖLIAI;1384812263;Taip;0;3;0;3
11548;Spragtukas;RIEŠUTĖLIAI;8463747761;Taip;0;5;0;5
11549;Spragtukas;RIEŠUTĖLIAI;6800727630;Taip;0;4;1;5
11550;Spragtukas;RIEŠUTĖLIAI;4131998934;Taip;6;2;0;8
11551;Spragtukas;RIEŠUTĖLIAI;1690400583;Taip;7;9;0;16
11552;Spragtukas;RIEŠUTĖLIAI;6419503965;Taip;9;7;0;16
11553;Spragtukas;RIEŠUTĖLIAI;8246512283;Ne;0;11;0;11
11554;Spragtukas;RIEŠUTĖLIAI;1627243902;Taip;15;0;0;15
11555;Spragtukas;RIEŠUTĖLIAI;1326603216;Taip;14;1;0;15
11556;Spragtukas;RIEŠUTĖLIAI;72636559695;Taip;4;5;0;9
11557;Spragtukas;RIEŠUTĖLIAI;6573750143;Taip;17;0;0;17
11558;Spragtukas;RIEŠUTĖLIAI;5306883933;Ne;13;1;0;14
11559;Spragtukas;RIEŠUTĖLIAI;3654640843;Taip;0;3;0;3
11560;Spragtukas;RIEŠUTĖLIAI;1849644444;Taip;0;4;0;4
11561;Spragtukas;RIEŠUTĖLIAI;9045185920;Taip;9;8;0;17
11562;Spragtukas;RIEŠUTĖLIAI;1800927281;Taip;0;7;0;7
11563;Spragtukas;RIEŠUTĖLIAI;1514277186;Taip;0;5;0;5
11564;Spragtukas;RIEŠUTĖLIAI;4427123314;Taip;16;1;0;17
11565;Spragtukas;RIEŠUTĖLIAI;6322121173;Taip;0;9;0;9
11566;Spragtukas;RIEŠUTĖLIAI;3113106252;Taip;0;3;0;3
11567;Spragtukas;RIEŠUTĖLIAI;9314811354;Taip;8;6;0;14
11568;Spragtukas;VIŠČIUKAI;6493380877;Taip;4;5;0;9
11569;Spragtukas;VIŠČIUKAI;5556920140;Taip;14;7;0;21
11570;Spragtukas;VIŠČIUKAI;2316071393;Taip;3;0;1;4
11571;Spragtukas;VIŠČIUKAI;2255007161;Taip;9;1;0;10
11572;Spragtukas;VIŠČIUKAI;3471355267;Taip;0;6;4;10
11573;Spragtukas;VIŠČIUKAI;5427116799;Taip;12;4;0;16
11574;Spragtukas;VIŠČIUKAI;6121388208;Taip;6;3;0;9
11575;Spragtukas;VIŠČIUKAI;1747417905;Taip;0;8;7;15
11576;Spragtukas;VIŠČIUKAI;8339926929;Taip;0;5;0;5
11577;Spragtukas;VIŠČIUKAI;5724874569;Taip;10;2;0;12
11578;Spragtukas;VIŠČIUKAI;8698469979;Taip;0;15;0;15
11579;Spragtukas;VIŠČIUKAI;8625143071;Taip;15;5;0;20
11580;Spragtukas;VIŠČIUKAI;9664130733;Taip;4;2;0;6
11581;Spragtukas;VIŠČIUKAI;1525489137;Taip;7;1;0;8
11582;Spragtukas;VIŠČIUKAI;5697451914;Taip;4;2;0;6
11583;Spragtukas;MEŠKIUKAI;6192381779;Taip;0;10;0;10
11584;Spragtukas;MEŠKIUKAI;4586034709;Taip;12;4;0;16
11585;Spragtukas;MEŠKIUKAI;8235791891;Taip;7;2;0;9
11586;Spragtukas;MEŠKIUKAI;3948232692;Taip;0;8;0;8
11587;Spragtukas;MEŠKIUKAI;2879077913;Ne;7;4;0;11
11588;Spragtukas;MEŠKIUKAI;4669257062;Taip;8;0;0;8
11589;Spragtukas;MEŠKIUKAI;3968434618;Taip;0;4;0;4
11590;Spragtukas;MEŠKIUKAI;1150727381;Taip;12;3;0;15
11591;Spragtukas;MEŠKIUKAI;9191831532;Taip;0;5;2;7
11592;Spragtukas;MEŠKIUKAI;3189741449;Taip;0;4;0;4
11593;Spragtukas;MEŠKIUKAI;4344537391;Taip;9;5;0;14
11594;Spragtukas;MEŠKIUKAI;7859959104;Taip;2;9;0;11
11595;Spragtukas;MEŠKIUKAI;1865253659;Taip;7;4;0;11
11596;Spragtukas;MEŠKIUKAI;3692960591;Taip;8;1;1;10
11597;Spragtukas;MEŠKIUKAI;3337355440;Taip;10;1;0;11
11598;Spragtukas;MEŠKIUKAI;2987638580;Taip;0;19;0;19
11599;Spragtukas;MEŠKIUKAI;7511680722;Taip;10;2;0;12
11600;Spragtukas;MEŠKIUKAI;9149954373;Taip;2;6;0;8
11601;Spragtukas;MEŠKIUKAI;6679886985;Taip;15;2;0;17
11602;Strazdelis;Žiogelių;59969322783;Taip;0;4;0;4
11603;Strazdelis;Žiogelių;48052363003;Taip;0;6;0;6
11604;Strazdelis;Žiogelių;12739940649;Taip;12;2;0;14
11605;Strazdelis;Žiogelių;79443961061;Taip;0;7;0;7
11606;Strazdelis;Žiogelių;84548133061;Taip;5;8;0;13
11607;Strazdelis;Žiogelių;4013389618;Ne;0;5;0;5
11608;Strazdelis;Žiogelių;5449465531;Taip;0;3;0;3
11609;Strazdelis;Žiogelių;57514782479;Taip;17;4;0;21
11610;Strazdelis;Žiogelių;50984917126;Taip;0;6;0;6
11611;Strazdelis;Žiogelių;1058210612;Taip;4;1;1;6
11612;Strazdelis;Žiogelių;2110092578;Taip;0;5;0;5
11613;Strazdelis;Žiogelių;1858519255;Ne;10;2;0;12
11614;Strazdelis;Žiogelių;20845810823;Taip;0;2;0;2
11615;Strazdelis;Žiogelių;2086723106;Taip;7;2;0;9
11616;Strazdelis;Žiogelių;20510560289;Taip;8;0;0;8
11617;Strazdelis;Žiogelių;64076729200;Taip;3;7;0;10
11618;Strazdelis;Žiogelių;98433672584;Taip;0;2;4;6
11619;Strazdelis;Žiogelių;90936509570;Taip;0;4;0;4
11620;Strazdelis;Žiogelių;43128715501;Taip;0;4;0;4
11621;Strazdelis;Šeimynėlės;3662217925;Taip;4;3;0;7
11622;Strazdelis;Šeimynėlės;8274897977;Taip;13;4;1;18
11623;Strazdelis;Šeimynėlės;29586826889;Ne;4;4;0;8
11624;Strazdelis;Šeimynėlės;43314069648;Taip;0;5;0;5
11625;Strazdelis;Šeimynėlės;4697537943;Taip;8;10;0;18
11626;Strazdelis;Šeimynėlės;3943578036;Ne;5;4;0;9
11627;Strazdelis;Šeimynėlės;2802486859;Ne;5;5;0;10
11628;Strazdelis;Šeimynėlės;4791752179;Taip;7;13;0;20
11629;Strazdelis;Šeimynėlės;7215063033;Taip;5;3;0;8
11630;Strazdelis;Šeimynėlės;1665134387;Taip;5;4;0;9
11631;Strazdelis;Šeimynėlės;1481671624;Taip;7;10;0;17
11632;Strazdelis;Šeimynėlės;6014213362;Taip;0;10;0;10
11633;Strazdelis;Šeimynėlės;45083023033;Taip;0;6;0;6
11634;Strazdelis;Šeimynėlės;4454199703;Ne;21;0;0;21
11635;Strazdelis;Šeimynėlės;4698566091;Ne;0;5;4;9
11636;Strazdelis;Šeimynėlės;5698472204;Taip;19;0;0;19
11637;Strazdelis;Šeimynėlės;6528024720;Taip;7;6;0;13
11638;Strazdelis;Šeimynėlės;9835716116;Ne;4;1;0;5
11639;Strazdelis;Šeimynėlės;7149827850;Taip;0;11;0;11
11640;Strazdelis;Šeimynėlės;4633366779;Taip;0;6;0;6
11641;Strazdelis;Šeimynėlės;5749300013;Ne;5;6;0;11
11642;Strazdelis;Šeimynėlės;4929828091;Taip;4;2;0;6
11643;Strazdelis;Genelio;8038163444;Taip;0;2;0;2
11644;Strazdelis;Genelio;8754275576;Ne;10;5;0;15
11645;Strazdelis;Genelio;7216768880;Taip;5;5;0;10
11646;Strazdelis;Genelio;1540973269;Taip;2;2;0;4
11647;Strazdelis;Genelio;7120717682;Taip;7;6;0;13
11648;Strazdelis;Genelio;50350281905;Taip;8;8;0;16
11649;Strazdelis;Genelio;9198429790;Taip;6;6;0;12
11650;Strazdelis;Genelio;2871673641;Taip;9;4;0;13
11651;Strazdelis;Genelio;6147183190;Taip;11;4;0;15
11652;Strazdelis;Genelio;2078150337;Taip;0;5;0;5
11653;Strazdelis;Genelio;18461074207;Taip;12;4;0;16
11654;Strazdelis;Genelio;8801420992;Taip;5;0;0;5
11655;Strazdelis;Genelio;8634815556;Taip;5;0;0;5
11656;Strazdelis;Genelio;9904719582;Taip;2;9;0;11
11657;Strazdelis;Genelio;7308925265;Taip;15;2;0;17
11658;Strazdelis;Genelio;4655931716;Taip;4;5;0;9
11659;Strazdelis;Genelio;8182994112;Ne;8;5;0;13
11660;Strazdelis;Genelio;5371939820;Taip;0;4;0;4
11661;Strazdelis;Genelio;1362428967;Taip;0;10;0;10
11662;Strazdelis;Genelio;5981747175;Taip;21;0;0;21
11663;Strazdelis;Genelio;1847733888;Taip;7;5;0;12
11664;Strazdelis;Vikruolių;91962766970;Taip;0;4;0;4
11665;Strazdelis;Vikruolių;23376659452;Taip;0;7;0;7
11666;Strazdelis;Vikruolių;86783302100;Taip;0;4;0;4
11667;Strazdelis;Vikruolių;13220421668;Taip;5;5;0;10
11668;Strazdelis;Vikruolių;54050062292;Taip;0;4;0;4
11669;Strazdelis;Vikruolių;16453584376;Taip;0;6;0;6
11670;Strazdelis;Vikruolių;63720428545;Taip;2;7;0;9
11671;Strazdelis;Vikruolių;52790577750;Taip;0;5;0;5
11672;Strazdelis;Vikruolių;66197587093;Taip;0;9;0;9
11673;Strazdelis;Vikruolių;77589342371;Taip;0;6;0;6
11674;Strazdelis;Vikruolių;56012252629;Taip;5;4;0;9
11675;Strazdelis;Vikruolių;87689168341;Taip;0;7;0;7
11676;Strazdelis;Vikruolių;44566447637;Taip;0;5;0;5
11677;Strazdelis;Vikruolių;9065275674;Taip;10;4;0;14
11678;Strazdelis;Vikruolių;66254701944;Taip;0;15;0;15
11679;Strazdelis;Vikruolių;24001445236;Taip;11;5;0;16
11680;Strazdelis;Vikruolių;47547568043;Ne;3;6;0;9
11681;Strazdelis;Vikruolių;6523307315;Taip;3;12;0;15
11682;Strazdelis;Vikruolių;15920566059;Taip;0;9;0;9
11683;Strazdelis;Vikruolių;92799934389;Taip;5;5;0;10
11684;Strazdelis;Vikruolių;33123804487;Ne;0;5;0;5
11685;Strazdelis;Vyturėlių;13625184061;Taip;0;13;0;13
11686;Strazdelis;Vyturėlių;72069723016;Taip;0;13;0;13
11687;Strazdelis;Vyturėlių;64675347442;Taip;0;5;0;5
11688;Strazdelis;Vyturėlių;18595696353;Taip;0;4;0;4
11689;Strazdelis;Vyturėlių;1426195737;Taip;0;4;0;4
11690;Strazdelis;Vyturėlių;2502465398;Taip;4;4;0;8
11691;Strazdelis;Vyturėlių;86957187003;Ne;0;12;0;12
11692;Strazdelis;Vyturėlių;1707225898;Ne;2;7;0;9
11693;Strazdelis;Vyturėlių;39502125227;Taip;0;6;0;6
11694;Strazdelis;Vyturėlių;52211473547;Taip;0;8;0;8
11695;Strazdelis;Vyturėlių;98553857685;Taip;2;2;0;4
11696;Strazdelis;Vyturėlių;43722400626;Taip;0;7;0;7
11697;Strazdelis;Vyturėlių;54646720821;Taip;0;6;0;6
11698;Strazdelis;Vyturėlių;47899514138;Taip;0;9;0;9
11699;Strazdelis;Vyturėlių;95260832237;Taip;0;6;0;6
11700;Strazdelis;Vyturėlių;17045991832;Taip;0;5;0;5
11701;Strazdelis;Vyturėlių;49277241025;Taip;6;6;0;12
11702;Strazdelis;Vyturėlių;1535288878;Taip;0;4;0;4
11703;Strazdelis;Vyturėlių;58143176237;Taip;0;3;0;3
11704;Strazdelis;Vyturėlių;58440671129;Taip;10;4;0;14
11705;Strazdelis;Vyturėlių;62063592887;Taip;0;6;0;6
11706;Strazdelis;Vyturėlių;83919699672;Taip;0;5;0;5
11707;Strazdelis;Vyturėlių;96062922228;Taip;0;5;0;5
11708;Strazdelis;Varpelio;98818869900;Taip;0;4;0;4
11709;Strazdelis;Varpelio;8415383526;Taip;11;3;0;14
11710;Strazdelis;Varpelio;2580733127;Taip;5;4;0;9
11711;Strazdelis;Varpelio;2662549392;Taip;7;2;0;9
11712;Strazdelis;Varpelio;9502341478;Taip;0;6;0;6
11713;Strazdelis;Varpelio;2251157025;Taip;13;1;0;14
11714;Strazdelis;Varpelio;6931726275;Ne;2;7;0;9
11715;Strazdelis;Varpelio;6311710825;Taip;0;5;0;5
11716;Strazdelis;Varpelio;9401101407;Ne;0;4;0;4
11717;Strazdelis;Varpelio;1955166372;Taip;0;1;0;1
11718;Strazdelis;Varpelio;4873707286;Ne;8;5;0;13
11719;Strazdelis;Varpelio;6527855940;Taip;16;2;0;18
11720;Strazdelis;Varpelio;4076266466;Taip;17;0;0;17
11721;Strazdelis;Varpelio;2824416350;Taip;0;8;0;8
11722;Strazdelis;Varpelio;3610250359;Taip;16;3;0;19
11723;Strazdelis;Varpelio;2766970956;Taip;6;2;0;8
11724;Strazdelis;Varpelio;2329522074;Taip;11;8;0;19
11725;Strazdelis;Varpelio;1173067724;Taip;14;4;0;18
11726;Strazdelis;Varpelio;7393083827;Taip;0;1;0;1
11727;Strazdelis;Varpelio;6555803164;Taip;0;3;0;3
11728;Strazdelis;Varpelio;1021364759;Taip;11;5;0;16
11729;Strazdelis;Varpelio;1706026100;Ne;5;1;0;6
11730;Strazdelis;Pelėdžiukų;5892430004;Taip;10;4;0;14
11731;Strazdelis;Pelėdžiukų;1901641517;Taip;12;3;0;15
11732;Strazdelis;Pelėdžiukų;8637386316;Taip;0;4;0;4
11733;Strazdelis;Pelėdžiukų;1704292727;Taip;10;4;0;14
11734;Strazdelis;Pelėdžiukų;4617237063;Taip;0;10;0;10
11735;Strazdelis;Pelėdžiukų;3036380561;Taip;0;10;0;10
11736;Strazdelis;Pelėdžiukų;8371999002;Taip;7;4;0;11
11737;Strazdelis;Pelėdžiukų;6046139859;Taip;1;2;0;3
11738;Strazdelis;Pelėdžiukų;8287554571;Ne;5;8;0;13
11739;Strazdelis;Pelėdžiukų;5580738386;Taip;0;3;0;3
11740;Strazdelis;Pelėdžiukų;4448556404;Taip;11;0;0;11
11741;Strazdelis;Pelėdžiukų;8854150040;Taip;2;4;0;6
11742;Strazdelis;Pelėdžiukų;2238875354;Ne;4;1;0;5
11743;Strazdelis;Pelėdžiukų;4004930488;Taip;15;4;0;19
11744;Strazdelis;Pelėdžiukų;5768674837;Taip;0;6;0;6
11745;Strazdelis;Pelėdžiukų;7349106795;Taip;3;3;0;6
11746;Strazdelis;Pelėdžiukų;9761595867;Taip;7;4;0;11
11747;Strazdelis;Pelėdžiukų;8089585177;Taip;7;5;0;12
11748;Strazdelis;Pelėdžiukų;7876385010;Taip;0;6;0;6
11749;Strazdelis;Pelėdžiukų;2848984531;Taip;7;5;0;12
11750;Strazdelis;Pelėdžiukų;7471890377;Taip;5;7;0;12
11751;Strazdelis;Saulutės;1474503932;Taip;0;5;0;5
11752;Strazdelis;Saulutės;27177757900;Taip;0;5;2;7
11753;Strazdelis;Saulutės;40932140069;Taip;0;8;0;8
11754;Strazdelis;Saulutės;1523471662;Taip;8;9;0;17
11755;Strazdelis;Saulutės;2854642875;Taip;12;0;1;13
11756;Strazdelis;Saulutės;7578229276;Taip;0;6;0;6
11757;Strazdelis;Saulutės;8710848483;Taip;0;4;0;4
11758;Strazdelis;Saulutės;6614184499;Taip;5;2;0;7
11759;Strazdelis;Saulutės;4129957131;Taip;2;5;0;7
11760;Strazdelis;Saulutės;3425430317;Taip;0;6;0;6
11761;Strazdelis;Saulutės;7081517417;Taip;0;5;0;5
11762;Strazdelis;Saulutės;67641340859;Taip;4;2;0;6
11763;Strazdelis;Saulutės;15298412755;Ne;3;6;0;9
11764;Strazdelis;Saulutės;1802092125;Taip;0;5;0;5
11765;Strazdelis;Saulutės;1391009140;Taip;3;10;0;13
11766;Strazdelis;Saulutės;6779352728;Taip;12;4;0;16
11767;Strazdelis;Saulutės;12713270671;Taip;6;0;0;6
11768;Strazdelis;Saulutės;1886601605;Taip;0;6;1;7
11769;Strazdelis;Saulutės;6113491562;Taip;2;2;0;4
11770;Strazdelis;Saulutės;8808299050;Taip;0;6;1;7
11771;Strazdelis;Saulutės;1693309238;Taip;0;4;0;4
11772;Strazdelis;Bitutės;99973904527;Ne;0;5;0;5
11773;Strazdelis;Bitutės;1111310766;Taip;0;3;0;3
11774;Strazdelis;Bitutės;24669852216;Taip;2;11;0;13
11775;Strazdelis;Bitutės;51702469375;Taip;0;3;0;3
11776;Strazdelis;Bitutės;59837435595;Ne;8;7;0;15
11777;Strazdelis;Bitutės;90089166514;Taip;5;10;0;15
11778;Strazdelis;Bitutės;96077591556;Taip;3;4;0;7
11779;Strazdelis;Bitutės;14459771394;Taip;3;4;0;7
11780;Strazdelis;Bitutės;34644143572;Taip;5;0;0;5
11781;Strazdelis;Bitutės;1847755442;Taip;0;3;2;5
11782;Strazdelis;Bitutės;1073814440;Taip;0;1;0;1
11783;Strazdelis;Bitutės;61820727992;Taip;0;3;0;3
11784;Strazdelis;Bitutės;7812253305;Taip;0;6;0;6
11785;Strazdelis;Bitutės;1140100663;Taip;0;6;0;6
11786;Strazdelis;Bitutės;60128913543;Taip;0;10;0;10
11787;Strazdelis;Bitutės;2090154632;Taip;0;4;0;4
11788;Strazdelis;Bitutės;76361365558;Ne;5;4;0;9
11789;Strazdelis;Bitutės;1735868807;Taip;0;5;0;5
11790;Strazdelis;Bitutės;2350690409;Taip;0;2;0;2
11791;Strazdelis;Bitutės;29225108934;Taip;17;0;0;17
11792;Strazdelis;Bitutės;68605763183;Taip;17;0;0;17
11793;Strazdelis;Bitutės;1785962711;Taip;10;6;0;16
11794;Strazdelis;Mažylių;8753316532;Taip;12;0;0;12
11795;Strazdelis;Mažylių;2081538505;Taip;5;0;2;7
11796;Strazdelis;Mažylių;2589303722;Taip;0;6;0;6
11797;Strazdelis;Mažylių;3043580835;Taip;6;3;0;9
11798;Strazdelis;Mažylių;4369569609;Taip;0;1;5;6
11799;Strazdelis;Mažylių;1005082012;Ne;0;6;2;8
11800;Strazdelis;Mažylių;5232064496;Ne;7;2;0;9
11801;Strazdelis;Mažylių;4784401449;Ne;5;0;0;5
11802;Strazdelis;Mažylių;4020547762;Taip;0;7;0;7
11803;Strazdelis;Mažylių;3149930355;Taip;15;0;0;15
11804;Strazdelis;Mažylių;9435593972;Ne;0;7;0;7
11805;Strazdelis;Mažylių;8485509145;Taip;0;10;0;10
11806;Strazdelis;Mažylių;1539984888;Taip;5;3;0;8
11807;Strazdelis;Mažylių;4400849922;Taip;0;5;0;5
11808;Strazdelis;Mažylių;2963535523;Taip;7;2;0;9
11809;Strazdelis;Mažylių;9555240419;Taip;14;6;0;20
11810;Strazdelis;Mažylių;6508933324;Taip;4;2;0;6
11811;Strazdelis;Pabiručių;7913526787;Taip;17;0;0;17
11812;Strazdelis;Pabiručių;8277333786;Taip;3;4;0;7
11813;Strazdelis;Pabiručių;8686828982;Taip;2;5;0;7
11814;Strazdelis;Pabiručių;8581533423;Taip;16;0;0;16
11815;Strazdelis;Pabiručių;7425818775;Taip;5;0;0;5
11816;Strazdelis;Pabiručių;8111541739;Taip;4;2;0;6
11817;Strazdelis;Pabiručių;1194918926;Taip;0;8;0;8
11818;Strazdelis;Pabiručių;9933042249;Taip;0;14;0;14
11819;Strazdelis;Pabiručių;1141752802;Taip;19;0;0;19
11820;Strazdelis;Pabiručių;2753635198;Taip;0;4;3;7
11821;Strazdelis;Pabiručių;9567476872;Ne;5;2;0;7
11822;Strazdelis;Pabiručių;1683900907;Taip;1;1;0;2
11823;Strazdelis;Pabiručių;5346485534;Taip;8;0;0;8
11824;Strazdelis;Pabiručių;1228651165;Taip;0;7;2;9
11825;Strazdelis;Pabiručių;8209625399;Taip;0;1;0;1
11826;Strazdelis;Pabiručių;6651360492;Taip;0;9;0;9
11827;Šermukšnėlė;MOLINUKAI;68060386099;Taip;0;4;0;4
11828;Šermukšnėlė;MOLINUKAI;42211665091;Taip;2;4;0;6
11829;Šermukšnėlė;MOLINUKAI;61809452162;Taip;0;4;0;4
11830;Šermukšnėlė;MOLINUKAI;60863269031;Taip;0;3;0;3
11831;Šermukšnėlė;MOLINUKAI;39534021804;Taip;0;4;0;4
11832;Šermukšnėlė;MOLINUKAI;54312555311;Taip;4;0;3;7
11833;Šermukšnėlė;MOLINUKAI;3873114056;Taip;2;4;1;7
11834;Šermukšnėlė;MOLINUKAI;1561527473;Taip;0;0;4;4
11835;Šermukšnėlė;MOLINUKAI;83487643143;Taip;3;6;2;11
11836;Šermukšnėlė;MOLINUKAI;2012112541;Ne;0;1;9;10
11837;Šermukšnėlė;MOLINUKAI;1411650732;Ne;15;0;0;15
11838;Šermukšnėlė;MOLINUKAI;7830792252;Ne;0;0;5;5
11839;Šermukšnėlė;MOLINUKAI;1756161106;Taip;0;0;4;4
11840;Šermukšnėlė;MOLINUKAI;1105249315;Ne;21;0;0;21
11841;Šermukšnėlė;MOLINUKAI;1543336828;Ne;0;0;8;8
11842;Šermukšnėlė;MOLINUKAI;2050855662;Ne;3;0;4;7
11843;Šermukšnėlė;MOLINUKAI;2561033248;Taip;0;8;0;8
11844;Šermukšnėlė;ŠIAUDINUKAI;85959255744;Taip;5;4;1;10
11845;Šermukšnėlė;ŠIAUDINUKAI;95999386401;Taip;2;4;3;9
11846;Šermukšnėlė;ŠIAUDINUKAI;2734502079;Taip;0;11;1;12
11847;Šermukšnėlė;ŠIAUDINUKAI;16859553972;Taip;7;4;1;12
11848;Šermukšnėlė;ŠIAUDINUKAI;32403224788;Taip;0;4;0;4
11849;Šermukšnėlė;ŠIAUDINUKAI;99444734331;Taip;0;4;0;4
11850;Šermukšnėlė;ŠIAUDINUKAI;3851927973;Taip;2;4;4;10
11851;Šermukšnėlė;ŠIAUDINUKAI;87587621833;Taip;0;4;1;5
11852;Šermukšnėlė;ŠIAUDINUKAI;1738008915;Taip;2;4;5;11
11853;Šermukšnėlė;ŠIAUDINUKAI;28087351377;Taip;4;4;0;8
11854;Šermukšnėlė;ŠIAUDINUKAI;28007013244;Taip;4;12;0;16
11855;Šermukšnėlė;ŠIAUDINUKAI;87315703379;Taip;0;2;5;7
11856;Šermukšnėlė;ŠIAUDINUKAI;77238595800;Taip;8;0;0;8
11857;Šermukšnėlė;ŠIAUDINUKAI;82928987881;Taip;0;6;1;7
11858;Šermukšnėlė;ŠIAUDINUKAI;1189930137;Taip;15;1;0;16
11859;Šermukšnėlė;ŠIAUDINUKAI;1367964100;Taip;5;12;0;17
11860;Šermukšnėlė;ŠIAUDINUKAI;2100740973;Taip;8;4;1;13
11861;Šermukšnėlė;ŠIAUDINUKAI;63858537394;Taip;4;12;0;16
11862;Šermukšnėlė;TOŠINUKAI;1290319484;Taip;0;5;0;5
11863;Šermukšnėlė;TOŠINUKAI;1636627303;Ne;0;4;1;5
11864;Šermukšnėlė;TOŠINUKAI;1846720859;Taip;3;4;0;7
11865;Šermukšnėlė;TOŠINUKAI;51058072005;Taip;11;3;0;14
11866;Šermukšnėlė;TOŠINUKAI;1559325175;Taip;3;10;0;13
11867;Šermukšnėlė;TOŠINUKAI;1755108527;Taip;0;4;0;4
11868;Šermukšnėlė;TOŠINUKAI;2137141949;Taip;0;4;1;5
11869;Šermukšnėlė;TOŠINUKAI;1858862320;Taip;17;4;0;21
11870;Šermukšnėlė;TOŠINUKAI;1016403317;Taip;0;4;0;4
11871;Šermukšnėlė;TOŠINUKAI;42127117636;Taip;4;4;0;8
11872;Šermukšnėlė;TOŠINUKAI;85018940292;Ne;4;1;2;7
11873;Šermukšnėlė;TOŠINUKAI;92414041480;Taip;0;4;0;4
11874;Šermukšnėlė;TOŠINUKAI;288807384;Taip;0;4;0;4
11875;Šermukšnėlė;TOŠINUKAI;1138272220;Ne;2;4;0;6
11876;Šermukšnėlė;TOŠINUKAI;1112022308;Taip;10;4;2;16
11877;Šermukšnėlė;TOŠINUKAI;83448986084;Taip;0;4;0;4
11878;Šermukšnėlė;TOŠINUKAI;2840045901;Ne;0;4;0;4
11879;Šermukšnėlė;TOŠINUKAI;1828510990;Taip;0;0;2;2
11880;Šermukšnėlė;ODINUKAI;5545018656;Taip;5;2;1;8
11881;Šermukšnėlė;ODINUKAI;2176788727;Taip;0;0;5;5
11882;Šermukšnėlė;ODINUKAI;3148857617;Taip;1;10;0;11
11883;Šermukšnėlė;ODINUKAI;5575518612;Taip;5;0;6;11
11884;Šermukšnėlė;ODINUKAI;3322053946;Taip;0;11;0;11
11885;Šermukšnėlė;ODINUKAI;5733540837;Taip;8;2;1;11
11886;Šermukšnėlė;ODINUKAI;7262199284;Taip;9;1;0;10
11887;Šermukšnėlė;ODINUKAI;5159461963;Taip;9;7;0;16
11888;Šermukšnėlė;ODINUKAI;5354978646;Taip;7;0;2;9
11889;Šermukšnėlė;ODINUKAI;1882432812;Taip;16;0;2;18
11890;Šermukšnėlė;ODINUKAI;5151843494;Taip;9;0;0;9
11891;Šermukšnėlė;ODINUKAI;5242187638;Ne;0;4;2;6
11892;Šermukšnėlė;ODINUKAI;1148559284;Taip;16;0;0;16
11893;Šermukšnėlė;ODINUKAI;3949629658;Taip;19;0;0;19
11894;Šermukšnėlė;ODINUKAI;4201283154;Ne;11;0;0;11
11895;Šermukšnėlė;ODINUKAI;6105915822;Taip;4;0;0;4
11896;Šermukšnėlė;ODINUKAI;9742208172;Taip;4;0;0;4
11897;Šermukšnėlė;ODINUKAI;7667114310;Taip;17;0;0;17
11898;Šermukšnėlė;ODINUKAI;7245206247;Taip;0;5;0;5
11899;Šermukšnėlė;ODINUKAI;5397385093;Taip;0;14;1;15
11900;Šermukšnėlė;ODINUKAI;4331948700;Taip;4;0;0;4
11901;Šermukšnėlė;KRIAUKLELĖS;8123096990;Taip;0;4;0;4
11902;Šermukšnėlė;KRIAUKLELĖS;1492328724;Taip;5;0;0;5
11903;Šermukšnėlė;KRIAUKLELĖS;1110375562;Taip;0;9;0;9
11904;Šermukšnėlė;KRIAUKLELĖS;8511421692;Taip;0;0;1;1
11905;Šermukšnėlė;KRIAUKLELĖS;6896990721;Taip;5;4;0;9
11906;Šermukšnėlė;KRIAUKLELĖS;3639954786;Taip;0;0;10;10
11907;Šermukšnėlė;KRIAUKLELĖS;5757405893;Taip;4;0;1;5
11908;Šermukšnėlė;KRIAUKLELĖS;1902848560;Taip;2;11;0;13
11909;Šermukšnėlė;KRIAUKLELĖS;8407947566;Ne;16;0;0;16
11910;Šermukšnėlė;KRIAUKLELĖS;7843128263;Ne;19;0;0;19
11911;Šermukšnėlė;KRIAUKLELĖS;8859731179;Taip;4;3;0;7
11912;Šermukšnėlė;KRIAUKLELĖS;3513568460;Taip;6;0;2;8
11913;Šermukšnėlė;KRIAUKLELĖS;6067298318;Taip;15;4;0;19
11914;Šermukšnėlė;KRIAUKLELĖS;5159105661;Taip;12;0;0;12
11915;Šermukšnėlė;KRIAUKLELĖS;5660238634;Taip;4;4;0;8
11916;Šermukšnėlė;KRIAUKLELĖS;4569484117;Taip;5;8;0;13
11917;Šermukšnėlė;KRIAUKLELĖS;8064473083;Taip;3;4;4;11
11918;Šermukšnėlė;KRIAUKLELĖS;2837099502;Taip;8;4;7;19
11919;Šermukšnėlė;KRIAUKLELĖS;7548637091;Ne;4;0;5;9
11920;Šermukšnėlė;VYTINUKAI;97906920174;Ne;7;0;1;8
11921;Šermukšnėlė;VYTINUKAI;1523361932;Taip;10;0;0;10
11922;Šermukšnėlė;VYTINUKAI;8531953934;Ne;3;4;1;8
11923;Šermukšnėlė;VYTINUKAI;25189813939;Taip;8;4;0;12
11924;Šermukšnėlė;VYTINUKAI;83123267733;Taip;0;11;0;11
11925;Šermukšnėlė;VYTINUKAI;20028832329;Taip;0;6;0;6
11926;Šermukšnėlė;VYTINUKAI;3959795064;Taip;2;1;0;3
11927;Šermukšnėlė;VYTINUKAI;8498288021;Taip;12;1;0;13
11928;Šermukšnėlė;VYTINUKAI;3751769136;Taip;6;4;1;11
11929;Šermukšnėlė;VYTINUKAI;5905000902;Taip;0;2;2;4
11930;Šermukšnėlė;VYTINUKAI;6291531570;Taip;10;0;0;10
11931;Šermukšnėlė;VYTINUKAI;1244964311;Ne;6;0;2;8
11932;Šermukšnėlė;VYTINUKAI;83882579952;Taip;4;2;0;6
11933;Šermukšnėlė;VYTINUKAI;60840526220;Taip;0;0;2;2
11934;Šermukšnėlė;VYTINUKAI;1025787925;Taip;0;2;6;8
11935;Šermukšnėlė;VYTINUKAI;1519623099;Taip;0;4;1;5
11936;Šermukšnėlė;VYTINUKAI;7106405983;Ne;9;0;0;9
11937;Šermukšnėlė;VYTINUKAI;9654198217;Ne;4;0;2;6
11938;Šermukšnėlė;VYTINUKAI;1670047548;Taip;4;0;3;7
11939;Šermukšnėlė;GINTARĖLIAI;3147809450;Taip;10;0;2;12
11940;Šermukšnėlė;GINTARĖLIAI;1167696952;Taip;4;4;3;11
11941;Šermukšnėlė;GINTARĖLIAI;85062380771;Taip;0;0;8;8
11942;Šermukšnėlė;GINTARĖLIAI;35389950541;Taip;3;9;2;14
11943;Šermukšnėlė;GINTARĖLIAI;1944687724;Taip;3;4;0;7
11944;Šermukšnėlė;GINTARĖLIAI;1013698297;Taip;8;0;0;8
11945;Šermukšnėlė;GINTARĖLIAI;2094932013;Ne;0;0;3;3
11946;Šermukšnėlė;GINTARĖLIAI;3697936074;Taip;11;4;0;15
11947;Šermukšnėlė;GINTARĖLIAI;2686950289;Ne;14;0;0;14
11948;Šermukšnėlė;GINTARĖLIAI;27183547828;Ne;12;0;0;12
11949;Šermukšnėlė;GINTARĖLIAI;10728235594;Ne;4;0;9;13
11950;Šermukšnėlė;GINTARĖLIAI;42477406335;Taip;9;0;0;9
11951;Šermukšnėlė;GINTARĖLIAI;61300763004;Taip;0;0;1;1
11952;Šermukšnėlė;GINTARĖLIAI;1425285365;Taip;0;4;3;7
11953;Šermukšnėlė;GINTARĖLIAI;6279210465;Taip;9;3;0;12
11954;Šermukšnėlė;GINTARĖLIAI;4601810772;Taip;14;0;0;14
11955;Šermukšnėlė;GINTARĖLIAI;1562494176;Taip;0;0;2;2
11956;Šermukšnėlė;AKMENUKAI;95089450234;Ne;0;4;1;5
11957;Šermukšnėlė;AKMENUKAI;80199267729;Taip;7;0;0;7
11958;Šermukšnėlė;AKMENUKAI;27139089487;Taip;0;7;0;7
11959;Šermukšnėlė;AKMENUKAI;42520543068;Taip;0;4;0;4
11960;Šermukšnėlė;AKMENUKAI;76682206033;Taip;4;4;0;8
11961;Šermukšnėlė;AKMENUKAI;42192131599;Taip;0;4;1;5
11962;Šermukšnėlė;AKMENUKAI;1316118025;Taip;4;4;0;8
11963;Šermukšnėlė;AKMENUKAI;3628734426;Taip;5;8;0;13
11964;Šermukšnėlė;AKMENUKAI;82161996761;Taip;3;4;1;8
11965;Šermukšnėlė;AKMENUKAI;98850511500;Taip;0;8;0;8
11966;Šermukšnėlė;AKMENUKAI;48653098796;Taip;0;10;0;10
11967;Šermukšnėlė;AKMENUKAI;26775257484;Taip;5;7;0;12
11968;Šermukšnėlė;AKMENUKAI;82028252228;Taip;5;0;2;7
11969;Šermukšnėlė;AKMENUKAI;23434568160;Taip;0;7;0;7
11970;Šermukšnėlė;AKMENUKAI;3543061360;Taip;5;7;0;12
11971;Šermukšnėlė;AKMENUKAI;80349025945;Taip;10;0;0;10
11972;Šermukšnėlė;AKMENUKAI;6255671190;Taip;4;0;7;11
11973;Šermukšnėlė;AKMENUKAI;7564745299;Taip;0;12;0;12
11974;Šermukšnėlė;AKMENUKAI;9617044855;Ne;0;8;0;8
11975;Šermukšnėlė;AKMENUKAI;1856012121;Taip;14;0;1;15
11976;Šermukšnėlė;SIŪLINUKAI;32417473492;Taip;2;6;1;9
11977;Šermukšnėlė;SIŪLINUKAI;35508499818;Taip;2;6;1;9
11978;Šermukšnėlė;SIŪLINUKAI;1054907277;Ne;0;1;1;2
11979;Šermukšnėlė;SIŪLINUKAI;30853722796;Taip;0;4;1;5
11980;Šermukšnėlė;SIŪLINUKAI;41661711151;Taip;4;4;0;8
11981;Šermukšnėlė;SIŪLINUKAI;62420710883;Taip;5;4;1;10
11982;Šermukšnėlė;SIŪLINUKAI;87646529363;Taip;0;5;0;5
11983;Šermukšnėlė;SIŪLINUKAI;25663713043;Taip;0;6;0;6
11984;Šermukšnėlė;SIŪLINUKAI;57211490716;Taip;0;4;0;4
11985;Šermukšnėlė;SIŪLINUKAI;88123535614;Taip;0;4;0;4
11986;Šermukšnėlė;SIŪLINUKAI;61911120798;Taip;0;2;3;5
11987;Šermukšnėlė;SIŪLINUKAI;3089008915;Taip;0;2;3;5
11988;Šermukšnėlė;SIŪLINUKAI;20160146304;Taip;0;4;0;4
11989;Šermukšnėlė;SIŪLINUKAI;1330471614;Taip;0;4;2;6
11990;Šermukšnėlė;SIŪLINUKAI;1127786451;Taip;0;3;5;8
11991;Šermukšnėlė;SIŪLINUKAI;18799838453;Taip;0;4;0;4
11992;Šermukšnėlė;SIŪLINUKAI;78916223877;Taip;0;1;1;2
11993;Šermukšnėlė;SIŪLINUKAI;45632551657;Taip;0;4;0;4
11994;Šermukšnėlė;SIŪLINUKAI;7766292005;Taip;0;4;0;4
11995;Šermukšnėlė;MEDINUKAi;2380988728;Ne;0;6;1;7
11996;Šermukšnėlė;MEDINUKAi;2529526401;Taip;6;4;2;12
11997;Šermukšnėlė;MEDINUKAi;8956573129;Taip;6;0;1;7
11998;Šermukšnėlė;MEDINUKAi;3222466449;Taip;13;0;0;13
11999;Šermukšnėlė;MEDINUKAi;5096946133;Taip;0;8;0;8
12000;Šermukšnėlė;MEDINUKAi;8279692394;Taip;4;0;1;5
12001;Šermukšnėlė;MEDINUKAi;2160616078;Taip;4;0;0;4
12002;Šermukšnėlė;MEDINUKAi;78341448188;Taip;5;2;1;8
12003;Šermukšnėlė;MEDINUKAi;1661977128;Ne;13;0;2;15
12004;Šermukšnėlė;MEDINUKAi;6430627501;Taip;5;0;4;9
12005;Šermukšnėlė;MEDINUKAi;5832072195;Taip;12;6;0;18
12006;Šermukšnėlė;MEDINUKAi;9035625467;Taip;7;5;0;12
12007;Šermukšnėlė;MEDINUKAi;7038705221;Ne;5;0;0;5
12008;Šermukšnėlė;MEDINUKAi;3081548524;Ne;6;4;0;10
12009;Šermukšnėlė;MEDINUKAi;3994316729;Taip;0;4;1;5
12010;Šermukšnėlė;MEDINUKAi;6413821285;Taip;4;0;1;5
12011;Šermukšnėlė;MEDINUKAi;4981204674;Taip;0;11;0;11
12012;Šermukšnėlė;MEDINUKAi;7229632099;Ne;0;4;0;4
12013;Šermukšnėlė;SKUDURINUKAI;6351841889;Taip;21;0;0;21
12014;Šermukšnėlė;SKUDURINUKAI;2989011150;Taip;0;2;1;3
12015;Šermukšnėlė;SKUDURINUKAI;1636944853;Taip;5;0;1;6
12016;Šermukšnėlė;SKUDURINUKAI;3747531232;Taip;0;6;1;7
12017;Šermukšnėlė;SKUDURINUKAI;1994737857;Taip;0;2;0;2
12018;Šermukšnėlė;SKUDURINUKAI;4619811264;Taip;0;1;0;1
12019;Šermukšnėlė;SKUDURINUKAI;4805637096;Taip;2;4;1;7
12020;Šermukšnėlė;SKUDURINUKAI;6249700552;Taip;4;4;1;9
12021;Šermukšnėlė;SKUDURINUKAI;4783726095;Taip;10;3;0;13
12022;Šermukšnėlė;SKUDURINUKAI;7053319091;Taip;6;0;0;6
12023;Šermukšnėlė;SKUDURINUKAI;9714566919;Taip;0;4;1;5
12024;Šermukšnėlė;SKUDURINUKAI;1437314920;Taip;0;2;0;2
12025;Šermukšnėlė;SKUDURINUKAI;7305013368;Taip;0;5;0;5
12026;Šermukšnėlė;PAGRANDUKAI;2447547509;Taip;8;0;6;14
12027;Šermukšnėlė;PAGRANDUKAI;9876533442;Taip;0;0;2;2
12028;Šermukšnėlė;PAGRANDUKAI;3613456202;Taip;6;0;5;11
12029;Šermukšnėlė;PAGRANDUKAI;3002999054;Taip;4;0;0;4
12030;Šermukšnėlė;PAGRANDUKAI;8709426669;Taip;4;8;0;12
12031;Šermukšnėlė;PAGRANDUKAI;3170388518;Ne;0;4;7;11
12032;Šermukšnėlė;PAGRANDUKAI;5905330617;Taip;4;0;0;4
12033;Šermukšnėlė;PAGRANDUKAI;6585484701;Ne;10;0;1;11
12034;Šermukšnėlė;PAGRANDUKAI;3653792683;Taip;0;4;0;4
12035;Šermukšnėlė;PAGRANDUKAI;9783673534;Taip;5;0;1;6
12036;Šermukšnėlė;PAGRANDUKAI;6599779539;Taip;0;11;0;11
12037;Šermukšnėlė;PAGRANDUKAI;8541743148;Ne;4;0;0;4
12038;Šermukšnėlė;PAGRANDUKAI;8201447350;Taip;8;0;2;10
12039;Šermukšnėlė;PAGRANDUKAI;5678559268;Taip;7;9;0;16
12040;Šermukšnėlė;PAGRANDUKAI;2784732759;Taip;14;0;1;15
12041;Šermukšnėlė;PAGRANDUKAI;8639470631;Taip;2;0;0;2
12042;Šypsena;NYKŠTUKAI;3809171499;Taip;5;2;0;7
12043;Šypsena;NYKŠTUKAI;1114341518;Taip;0;1;3;4
12044;Šypsena;NYKŠTUKAI;1558614852;Taip;19;0;0;19
12045;Šypsena;NYKŠTUKAI;1897176871;Taip;0;6;0;6
12046;Šypsena;NYKŠTUKAI;8715718525;Taip;4;0;0;4
12047;Šypsena;NYKŠTUKAI;2312828770;Ne;4;4;0;8
12048;Šypsena;NYKŠTUKAI;1181590127;Taip;0;13;0;13
12049;Šypsena;NYKŠTUKAI;4808041625;Taip;9;0;0;9
12050;Šypsena;NYKŠTUKAI;1422418997;Taip;0;8;0;8
12051;Šypsena;NYKŠTUKAI;5834057370;Ne;0;10;0;10
12052;Šypsena;NYKŠTUKAI;1515803985;Ne;4;6;0;10
12053;Šypsena;NYKŠTUKAI;5928432220;Taip;0;4;0;4
12054;Šypsena;NYKŠTUKAI;5504570516;Taip;5;4;4;13
12055;Šypsena;NYKŠTUKAI;1063834589;Taip;8;5;0;13
12056;Šypsena;NYKŠTUKAI;2798819321;Taip;0;5;0;5
12057;Šypsena;NYKŠTUKAI;4038279267;Taip;15;4;0;19
12058;Šypsena;NYKŠTUKAI;8950694484;Taip;4;2;1;7
12059;Šypsena;NYKŠTUKAI;4344780723;Taip;9;0;6;15
12060;Šypsena;NYKŠTUKAI;1893123775;Taip;12;0;0;12
12061;Šypsena;NYKŠTUKAI;6237208661;Taip;14;0;0;14
12062;Šypsena;NYKŠTUKAI;3506046076;Ne;6;1;0;7
12063;Šypsena;NYKŠTUKAI;7519967594;Taip;17;0;0;17
12064;Šypsena;SPINDULIUKAI;5568502083;Ne;11;4;0;15
12065;Šypsena;SPINDULIUKAI;1795366502;Taip;0;16;1;17
12066;Šypsena;SPINDULIUKAI;2706678026;Ne;18;0;0;18
12067;Šypsena;SPINDULIUKAI;3063226692;Ne;8;0;1;9
12068;Šypsena;SPINDULIUKAI;4766170132;Ne;0;0;3;3
12069;Šypsena;SPINDULIUKAI;4936775366;Taip;12;0;0;12
12070;Šypsena;SPINDULIUKAI;7569495879;Taip;0;8;0;8
12071;Šypsena;SPINDULIUKAI;6832433711;Taip;0;9;1;10
12072;Šypsena;SPINDULIUKAI;2248628927;Taip;8;7;0;15
12073;Šypsena;SPINDULIUKAI;2995753269;Taip;12;0;0;12
12074;Šypsena;SPINDULIUKAI;4635232236;Taip;6;1;5;12
12075;Šypsena;SPINDULIUKAI;4677405885;Taip;7;2;0;9
12076;Šypsena;SPINDULIUKAI;6590285866;Taip;0;1;2;3
12077;Šypsena;SPINDULIUKAI;5985974927;Taip;0;7;0;7
12078;Šypsena;SPINDULIUKAI;1387130727;Taip;7;0;0;7
12079;Šypsena;SPINDULIUKAI;3025437080;Taip;0;7;4;11
12080;Šypsena;SPINDULIUKAI;1669768648;Ne;17;4;0;21
12081;Šypsena;SPINDULIUKAI;1575413188;Taip;17;0;0;17
12082;Šypsena;SPINDULIUKAI;2005543016;Ne;7;0;2;9
12083;Šypsena;SKRUZDELIUKAI;5642959574;Ne;0;10;0;10
12084;Šypsena;SKRUZDELIUKAI;7538681006;Taip;8;4;0;12
12085;Šypsena;SKRUZDELIUKAI;1967590536;Taip;9;0;1;10
12086;Šypsena;SKRUZDELIUKAI;1659390234;Ne;0;5;0;5
12087;Šypsena;SKRUZDELIUKAI;1272973534;Ne;0;2;3;5
12088;Šypsena;SKRUZDELIUKAI;1917246860;Ne;9;8;0;17
12089;Šypsena;SKRUZDELIUKAI;46569341613;Ne;13;0;0;13
12090;Šypsena;SKRUZDELIUKAI;42130115068;Taip;0;11;0;11
12091;Šypsena;SKRUZDELIUKAI;6444616846;Ne;0;8;0;8
12092;Šypsena;SKRUZDELIUKAI;1712017606;Ne;0;6;0;6
12093;Šypsena;SKRUZDELIUKAI;3541189470;Ne;0;6;0;6
12094;Šypsena;SKRUZDELIUKAI;1996746426;Taip;0;8;0;8
12095;Šypsena;SKRUZDELIUKAI;4017777389;Taip;0;10;0;10
12096;Šypsena;SKRUZDELIUKAI;70188972463;Taip;7;4;1;12
12097;Šypsena;SKRUZDELIUKAI;76332370575;Taip;2;2;0;4
12098;Šypsena;SKRUZDELIUKAI;1906529989;Taip;5;7;0;12
12099;Šypsena;SKRUZDELIUKAI;2099216049;Taip;11;0;0;11
12100;Šypsena;SKRUZDELIUKAI;89503728819;Ne;0;7;0;7
12101;Šypsena;SKRUZDELIUKAI;38995939952;Taip;0;4;0;4
12102;Šypsena;SKRUZDELIUKAI;93678429536;Taip;0;3;0;3
12103;Šypsena;SKRUZDELIUKAI;8197460768;Taip;0;6;0;6
12104;Šypsena;SKRUZDELIUKAI;1133113196;Ne;2;2;0;4
12105;Šypsena;Bitutės;1702152247;Taip;0;14;0;14
12106;Šypsena;Bitutės;5971488796;Taip;1;4;0;5
12107;Šypsena;Bitutės;5680397153;Taip;8;5;6;19
12108;Šypsena;Bitutės;25175991441;Taip;0;5;0;5
12109;Šypsena;Bitutės;2117865969;Taip;0;7;0;7
12110;Šypsena;Bitutės;1329170686;Taip;0;6;0;6
12111;Šypsena;Bitutės;1369664461;Ne;0;7;0;7
12112;Šypsena;Bitutės;2368339278;Taip;7;2;0;9
12113;Šypsena;Bitutės;91846404526;Ne;4;4;0;8
12114;Šypsena;Bitutės;84526597847;Taip;0;6;0;6
12115;Šypsena;Bitutės;39296351965;Taip;0;5;0;5
12116;Šypsena;Bitutės;17041968817;Taip;0;5;0;5
12117;Šypsena;Bitutės;1972212253;Taip;0;9;0;9
12118;Šypsena;Bitutės;79177095462;Taip;0;4;0;4
12119;Šypsena;Bitutės;39495782526;Taip;0;8;0;8
12120;Šypsena;MEŠKIUKAI;1656674673;Taip;12;0;1;13
12121;Šypsena;MEŠKIUKAI;1369906621;Taip;4;0;0;4
12122;Šypsena;MEŠKIUKAI;7877396588;Taip;15;1;0;16
12123;Šypsena;MEŠKIUKAI;1287205292;Taip;13;0;0;13
12124;Šypsena;MEŠKIUKAI;1324902555;Taip;19;0;0;19
12125;Šypsena;MEŠKIUKAI;7946379086;Ne;1;0;5;6
12126;Šypsena;MEŠKIUKAI;5611440056;Ne;4;1;0;5
12127;Šypsena;MEŠKIUKAI;7160466766;Taip;0;0;10;10
12128;Šypsena;MEŠKIUKAI;3823623458;Ne;0;6;0;6
12129;Šypsena;MEŠKIUKAI;4695547847;Taip;9;0;0;9
12130;Šypsena;MEŠKIUKAI;6713182218;Taip;16;1;0;17
12131;Šypsena;MEŠKIUKAI;7537442618;Taip;0;7;0;7
12132;Šypsena;MEŠKIUKAI;3968514430;Taip;0;7;0;7
12133;Šypsena;MEŠKIUKAI;6716558946;Taip;17;0;0;17
12134;Šypsena;BORUŽĖLĖS;6377979434;Taip;17;4;0;21
12135;Šypsena;BORUŽĖLĖS;2179657619;Taip;9;4;0;13
12136;Šypsena;BORUŽĖLĖS;8215278033;Taip;7;5;0;12
12137;Šypsena;BORUŽĖLĖS;3733757483;Taip;1;4;2;7
12138;Šypsena;BORUŽĖLĖS;2372820133;Taip;8;0;0;8
12139;Šypsena;BORUŽĖLĖS;5879506651;Taip;2;8;0;10
12140;Šypsena;BORUŽĖLĖS;8164410749;Ne;0;0;2;2
12141;Šypsena;BORUŽĖLĖS;7898387398;Taip;9;7;0;16
12142;Šypsena;BORUŽĖLĖS;1623728091;Taip;7;0;0;7
12143;Šypsena;BORUŽĖLĖS;2584574423;Taip;17;0;0;17
12144;Šypsena;BORUŽĖLĖS;6951845385;Taip;12;0;2;14
12145;Šypsena;BORUŽĖLĖS;5906001927;Taip;2;0;2;4
12146;Šypsena;BORUŽĖLĖS;6229905007;Taip;10;4;0;14
12147;Šypsena;BORUŽĖLĖS;7120597034;Taip;6;7;0;13
12148;Šypsena;BORUŽĖLĖS;4520148322;Taip;7;8;0;15
12149;Šnekutis;DRUGELIŲ;1430790285;Taip;4;0;4;8
12150;Šnekutis;DRUGELIŲ;70663269171;Taip;0;1;1;2
12151;Šnekutis;DRUGELIŲ;65711574140;Taip;0;1;0;1
12152;Šnekutis;DRUGELIŲ;1723901018;Taip;7;0;5;12
12153;Šnekutis;DRUGELIŲ;81648325534;Taip;0;4;2;6
12154;Šnekutis;DRUGELIŲ;2000728679;Taip;0;0;2;2
12155;Šnekutis;DRUGELIŲ;50017415248;Taip;12;0;0;12
12156;Šnekutis;DRUGELIŲ;1956224017;Taip;6;0;4;10
12157;Šnekutis;DRUGELIŲ;2049447215;Taip;0;0;9;9
12158;Šnekutis;DRUGELIŲ;1159232792;Taip;0;0;11;11
12159;Šnekutis;DRUGELIŲ;2092637040;Taip;0;0;7;7
12160;Šnekutis;DRUGELIŲ;94289379983;Taip;6;4;0;10
12161;Šnekutis;DRUGELIŲ;13209811505;Taip;21;0;0;21
12162;Šnekutis;DRUGELIŲ;5962885680;Ne;0;6;4;10
12163;Šnekutis;DRUGELIŲ;4743885834;Taip;0;0;9;9
12164;Šnekutis;DRUGELIŲ;18354631454;Taip;0;0;1;1
12165;Šnekutis;DRUGELIŲ;5029631107;Taip;4;3;0;7
12166;Šnekutis;DRUGELIŲ;2102893949;Ne;8;0;2;10
12167;Šnekutis;Kačiukų;3281475303;Taip;12;0;0;12
12168;Šnekutis;Kačiukų;5052137859;Ne;3;4;2;9
12169;Šnekutis;Kačiukų;8531521901;Taip;7;1;1;9
12170;Šnekutis;Kačiukų;7615716438;Taip;4;0;0;4
12171;Šnekutis;Kačiukų;9780684867;Ne;5;1;0;6
12172;Šnekutis;Kačiukų;3271262071;Taip;15;0;0;15
12173;Šnekutis;Kačiukų;4405567649;Taip;0;1;0;1
12174;Šnekutis;Kačiukų;3166309530;Taip;0;5;3;8
12175;Šnekutis;Kačiukų;5049964996;Taip;0;8;0;8
12176;Šnekutis;Kačiukų;4143844589;Taip;6;1;0;7
12177;Šnekutis;Kačiukų;9312935803;Taip;10;4;2;16
12178;Šnekutis;Kačiukų;7236658561;Ne;2;0;0;2
12179;Šnekutis;Kačiukų;4992188525;Ne;15;1;0;16
12180;Šnekutis;Kačiukų;7638626055;Taip;10;0;4;14
12181;Šnekutis;Kačiukų;9896249776;Ne;4;0;7;11
12182;Šnekutis;Kačiukų;9157136735;Taip;5;5;0;10
12183;Šnekutis;Kačiukų;9790803767;Taip;0;1;0;1
12184;Šnekutis;Kačiukų;7434438142;Taip;0;4;0;4
12185;Šnekutis;Kačiukų;4920263429;Taip;6;11;0;17
12186;Šnekutis;Kačiukų;5909584565;Taip;21;0;0;21
12187;Šnekutis;Kačiukų;6234943180;Taip;21;0;0;21
12188;Šnekutis;Pėlėdžiukų;5188035949;Taip;0;11;0;11
12189;Šnekutis;Pėlėdžiukų;3068754741;Taip;0;0;4;4
12190;Šnekutis;Pėlėdžiukų;4334155280;Taip;0;1;0;1
12191;Šnekutis;Pėlėdžiukų;77534335117;Taip;0;0;10;10
12192;Šnekutis;Pėlėdžiukų;3312928478;Taip;5;7;0;12
12193;Šnekutis;Pėlėdžiukų;42697936562;Ne;20;0;0;20
12194;Šnekutis;Pėlėdžiukų;7507857415;Taip;10;0;1;11
12195;Šnekutis;Pėlėdžiukų;8866360301;Taip;16;0;0;16
12196;Šnekutis;Pėlėdžiukų;8745465796;Taip;0;15;0;15
12197;Šnekutis;Pėlėdžiukų;3170928052;Taip;5;0;0;5
12198;Šnekutis;Pėlėdžiukų;5321817615;Taip;6;0;6;12
12199;Šnekutis;Pėlėdžiukų;2233161242;Taip;13;0;0;13
12200;Šnekutis;Pėlėdžiukų;3578045341;Taip;0;0;6;6
12201;Šnekutis;Pėlėdžiukų;5117544317;Taip;0;0;5;5
12202;Šnekutis;Pėlėdžiukų;6754580614;Ne;0;1;0;1
12203;Šnekutis;Pėlėdžiukų;1507200600;Ne;9;0;1;10
12204;Šnekutis;Pėlėdžiukų;5615869149;Ne;3;5;0;8
12205;Šnekutis;Pėlėdžiukų;1329958641;Taip;0;0;4;4
12206;Šnekutis;Pėlėdžiukų;9511116249;Taip;7;0;0;7
12207;Šnekutis;Pėlėdžiukų;1369660223;Taip;0;0;10;10
12208;Šnekutis;Pėlėdžiukų;1682748852;Taip;2;4;1;7
12209;Šnekutis;Pėlėdžiukų;1447824885;Taip;0;11;0;11
12210;Šnekutis;Boružėlių;1818789769;Taip;0;1;0;1
12211;Šnekutis;Boružėlių;4557629310;Taip;0;11;0;11
12212;Šnekutis;Boružėlių;84241751923;Taip;0;5;3;8
12213;Šnekutis;Boružėlių;79174984189;Taip;0;0;3;3
12214;Šnekutis;Boružėlių;1666811336;Taip;4;0;0;4
12215;Šnekutis;Boružėlių;1249451765;Taip;0;13;0;13
12216;Šnekutis;Boružėlių;1936021189;Taip;0;5;3;8
12217;Šnekutis;Boružėlių;1031911012;Taip;0;0;1;1
12218;Šnekutis;Boružėlių;1985052072;Taip;3;4;1;8
12219;Šnekutis;Boružėlių;1738802158;Taip;0;11;0;11
12220;Šnekutis;Boružėlių;1744313172;Taip;0;4;1;5
12221;Šnekutis;Boružėlių;1620268693;Taip;9;0;0;9
12222;Šnekutis;Boružėlių;54532738133;Taip;21;0;0;21
12223;Šnekutis;Boružėlių;1370696345;Taip;0;2;0;2
12224;Šnekutis;Boružėlių;7514753023;Taip;0;0;4;4
12225;Šnekutis;Boružėlių;1881531513;Taip;0;0;1;1
12226;Šnekutis;Boružėlių;6828079735;Taip;2;4;0;6
12227;Šnekutis;Meškučių;4835202527;Ne;6;4;0;10
12228;Šnekutis;Meškučių;8440160819;Taip;0;10;0;10
12229;Šnekutis;Meškučių;2144568225;Taip;0;0;1;1
12230;Šnekutis;Meškučių;9862362744;Taip;0;0;2;2
12231;Šnekutis;Meškučių;8486136697;Taip;0;0;1;1
12232;Šnekutis;Meškučių;5970951526;Taip;0;4;0;4
12233;Šnekutis;Meškučių;9326455786;Taip;12;0;0;12
12234;Šnekutis;Meškučių;7680962037;Taip;10;0;0;10
12235;Šnekutis;Meškučių;6081100604;Taip;5;2;0;7
12236;Šnekutis;Meškučių;3937465849;Taip;8;4;0;12
12237;Šnekutis;Meškučių;3344425033;Taip;0;13;0;13
12238;Šnekutis;Viščiukų;5906320006;Taip;3;0;4;7
12239;Šnekutis;Viščiukų;5519015388;Taip;11;4;0;15
12240;Šnekutis;Viščiukų;3628210526;Taip;0;0;5;5
12241;Šnekutis;Viščiukų;3889176018;Taip;0;8;2;10
12242;Šnekutis;Viščiukų;6544973632;Taip;6;6;0;12
12243;Šnekutis;Viščiukų;2843483435;Taip;13;1;0;14
12244;Šnekutis;Viščiukų;7344776758;Taip;0;0;8;8
12245;Šnekutis;Viščiukų;1504945841;Taip;12;4;0;16
12246;Šnekutis;Viščiukų;6405894763;Taip;0;4;0;4
12247;Šnekutis;Viščiukų;7089000987;Taip;2;0;1;3
12248;Šnekutis;Viščiukų;3644413861;Taip;9;0;0;9
12249;Šnekutis;Viščiukų;6578568418;Taip;0;0;6;6
12250;Šnekutis;Viščiukų;6749848086;Taip;0;5;0;5
12251;Šnekutis;Viščiukų;6146988521;Taip;0;4;0;4
12252;Užupiukas;VYTURĖLIŲ;2922487622;Ne;3;6;2;11
12253;Užupiukas;VYTURĖLIŲ;5116564840;Taip;0;1;0;1
12254;Užupiukas;VYTURĖLIŲ;3861173268;Taip;9;5;0;14
12255;Užupiukas;VYTURĖLIŲ;7443013255;Ne;0;0;6;6
12256;Užupiukas;VYTURĖLIŲ;3656400244;Taip;0;12;9;21
12257;Užupiukas;VYTURĖLIŲ;5960025613;Taip;3;0;5;8
12258;Užupiukas;VYTURĖLIŲ;3829013911;Taip;4;0;7;11
12259;Užupiukas;VYTURĖLIŲ;9212428150;Taip;8;4;1;13
12260;Užupiukas;VYTURĖLIŲ;8549733697;Taip;2;0;4;6
12261;Užupiukas;VYTURĖLIŲ;8001099421;Ne;9;0;0;9
12262;Užupiukas;VYTURĖLIŲ;4198148927;Taip;5;0;1;6
12263;Užupiukas;VYTURĖLIŲ;4401569800;Taip;17;0;0;17
12264;Užupiukas;VYTURĖLIŲ;1391826582;Taip;3;5;1;9
12265;Užupiukas;VYTURĖLIŲ;5021163099;Taip;0;0;8;8
12266;Užupiukas;VYTURĖLIŲ;6699322898;Taip;21;0;0;21
12267;Užupiukas;VYTURĖLIŲ;8960813016;Ne;5;4;2;11
12268;Užupiukas;VYTURĖLIŲ;9132605734;Taip;20;0;0;20
12269;Užupiukas;VYTURĖLIŲ;8245876832;Taip;6;4;0;10
12270;Užupiukas;VYTURĖLIŲ;6406285034;Taip;0;4;1;5
12271;Užupiukas;VYTURĖLIŲ;8114761925;Ne;11;4;1;16
12272;Užupiukas;VYTURĖLIŲ;7532497390;Taip;11;0;0;11
12273;Užupiukas;VYTURĖLIŲ;5168946019;Taip;0;0;6;6
12274;Užupiukas;KAČIUKŲ;3224193396;Taip;4;4;0;8
12275;Užupiukas;KAČIUKŲ;3905448176;Taip;7;0;1;8
12276;Užupiukas;KAČIUKŲ;3567963511;Taip;0;4;13;17
12277;Užupiukas;KAČIUKŲ;9991552624;Ne;0;4;2;6
12278;Užupiukas;KAČIUKŲ;3048959458;Taip;5;5;0;10
12279;Užupiukas;KAČIUKŲ;3080668107;Taip;17;0;0;17
12280;Užupiukas;KAČIUKŲ;1809036046;Taip;8;2;3;13
12281;Užupiukas;KAČIUKŲ;1102468034;Taip;2;4;4;10
12282;Užupiukas;KAČIUKŲ;4460047281;Ne;6;0;6;12
12283;Užupiukas;KAČIUKŲ;1464016943;Taip;7;4;0;11
12284;Užupiukas;KAČIUKŲ;4485435274;Taip;7;0;5;12
12285;Užupiukas;KAČIUKŲ;2931958829;Taip;0;4;9;13
12286;Užupiukas;KAČIUKŲ;1102293237;Taip;6;0;14;20
12287;Užupiukas;KAČIUKŲ;9386211193;Taip;0;4;6;10
12288;Užupiukas;KAČIUKŲ;7048114101;Taip;6;0;0;6
12289;Užupiukas;KAČIUKŲ;8510764089;Ne;0;4;0;4
12290;Užupiukas;KAČIUKŲ;1388346927;Taip;7;8;2;17
12291;Užupiukas;KAČIUKŲ;9333587467;Taip;11;3;0;14
12292;Užupiukas;KAČIUKŲ;7574528186;Ne;0;0;2;2
12293;Užupiukas;KAČIUKŲ;7092857844;Taip;0;4;1;5
12294;Užupiukas;DRUGELIŲ;3579499796;Taip;10;0;4;14
12295;Užupiukas;DRUGELIŲ;7140606152;Taip;0;0;3;3
12296;Užupiukas;DRUGELIŲ;5406866873;Taip;15;0;1;16
12297;Užupiukas;DRUGELIŲ;9655636851;Taip;9;0;0;9
12298;Užupiukas;DRUGELIŲ;1662564735;Taip;0;0;8;8
12299;Užupiukas;DRUGELIŲ;9863097416;Taip;10;4;0;14
12300;Užupiukas;DRUGELIŲ;7298322865;Taip;16;0;0;16
12301;Užupiukas;DRUGELIŲ;8734960045;Ne;14;0;1;15
12302;Užupiukas;DRUGELIŲ;8724566014;Taip;8;4;1;13
12303;Užupiukas;DRUGELIŲ;3298267311;Taip;16;0;0;16
12304;Užupiukas;DRUGELIŲ;8341598147;Taip;10;4;1;15
12305;Užupiukas;DRUGELIŲ;9782972949;Ne;10;0;0;10
12306;Užupiukas;DRUGELIŲ;2348243399;Ne;21;0;0;21
12307;Užupiukas;DRUGELIŲ;8870229834;Taip;7;4;2;13
12308;Užupiukas;DRUGELIŲ;1679324943;Taip;0;13;0;13
12309;Užupiukas;DRUGELIŲ;1772019951;Taip;13;0;0;13
12310;Užupiukas;DRUGELIŲ;9617597828;Taip;9;0;0;9
12311;Užupiukas;DRUGELIŲ;1554333137;Taip;11;0;1;12
12312;Užupiukas;DRUGELIŲ;14139543365;Ne;0;4;2;6
12313;Užupiukas;DRUGELIŲ;9096157655;Ne;2;0;4;6
12314;Užupiukas;DRUGELIŲ;3231001225;Taip;15;0;1;16
12315;Užupiukas;DRUGELIŲ;3958071677;Taip;19;0;0;19
12316;Užupiukas;EŽIUKŲ;1526296386;Taip;9;0;1;10
12317;Užupiukas;EŽIUKŲ;9774124589;Taip;13;8;0;21
12318;Užupiukas;EŽIUKŲ;1718518621;Taip;6;0;3;9
12319;Užupiukas;EŽIUKŲ;2724216446;Taip;11;8;1;20
12320;Užupiukas;EŽIUKŲ;9446562736;Taip;5;4;3;12
12321;Užupiukas;EŽIUKŲ;5072363435;Taip;0;4;8;12
12322;Užupiukas;EŽIUKŲ;1651249962;Taip;0;2;6;8
12323;Užupiukas;EŽIUKŲ;1100574872;Taip;11;0;0;11
12324;Užupiukas;EŽIUKŲ;6531734067;Ne;12;4;0;16
12325;Užupiukas;EŽIUKŲ;5204808398;Taip;0;0;8;8
12326;Užupiukas;EŽIUKŲ;3171528288;Taip;13;0;1;14
12327;Užupiukas;EŽIUKŲ;7860601571;Taip;17;4;0;21
12328;Užupiukas;EŽIUKŲ;3611922301;Taip;16;0;0;16
12329;Užupiukas;EŽIUKŲ;8020138690;Taip;16;0;0;16
12330;Užupiukas;EŽIUKŲ;1624805701;Taip;21;0;0;21
12331;Užupiukas;EŽIUKŲ;6823724962;Taip;5;0;0;5
12332;Užupiukas;EŽIUKŲ;5538327364;Taip;4;0;3;7
12333;Užupiukas;EŽIUKŲ;3057147440;Taip;10;0;2;12
12334;Užupiukas;EŽIUKŲ;6370918943;Taip;6;0;0;6
12335;Užupiukas;EŽIUKŲ;9357101972;Taip;5;4;2;11
12336;Užupiukas;EŽIUKŲ;6512355340;Taip;12;0;1;13
12337;Užupiukas;BORUŽĖLIŲ;12787288319;Ne;4;0;1;5
12338;Užupiukas;BORUŽĖLIŲ;6526550727;Ne;9;0;4;13
12339;Užupiukas;BORUŽĖLIŲ;9735462228;Taip;0;0;3;3
12340;Užupiukas;BORUŽĖLIŲ;1582921323;Taip;0;0;1;1
12341;Užupiukas;BORUŽĖLIŲ;6828175620;Taip;12;9;0;21
12342;Užupiukas;BORUŽĖLIŲ;9791681813;Taip;20;0;0;20
12343;Užupiukas;BORUŽĖLIŲ;1503714343;Taip;0;4;1;5
12344;Užupiukas;BORUŽĖLIŲ;8313812681;Taip;0;0;5;5
12345;Užupiukas;BORUŽĖLIŲ;9906475253;Taip;0;0;21;21
12346;Užupiukas;BORUŽĖLIŲ;9677572224;Taip;17;0;0;17
12347;Užupiukas;BORUŽĖLIŲ;2445335267;Taip;10;0;0;10
12348;Užupiukas;BORUŽĖLIŲ;38066177076;Taip;0;3;0;3
12349;Užupiukas;BORUŽĖLIŲ;1514268763;Taip;0;4;1;5
12350;Užupiukas;BORUŽĖLIŲ;7555702944;Ne;0;4;2;6
12351;Užupiukas;BORUŽĖLIŲ;2307600884;Taip;4;6;0;10
12352;Užupiukas;BORUŽĖLIŲ;6073039842;Taip;0;10;0;10
12353;Užupiukas;BORUŽĖLIŲ;3038973312;Taip;11;0;0;11
12354;Užupiukas;BORUŽĖLIŲ;6601099182;Taip;0;21;0;21
12355;Užupiukas;BORUŽĖLIŲ;3940264504;Taip;0;0;3;3
12356;Užupiukas;SPINDULIUKŲ;25118968273;Taip;0;4;5;9
12357;Užupiukas;SPINDULIUKŲ;75976703580;Taip;0;4;0;4
12358;Užupiukas;SPINDULIUKŲ;37684526869;Taip;0;3;0;3
12359;Užupiukas;SPINDULIUKŲ;29207590902;Taip;0;4;1;5
12360;Užupiukas;SPINDULIUKŲ;67899352746;Taip;0;21;0;21
12361;Užupiukas;SPINDULIUKŲ;53974652901;Taip;0;2;0;2
12362;Užupiukas;SPINDULIUKŲ;39058613355;Taip;7;5;0;12
12363;Užupiukas;SPINDULIUKŲ;23371854830;Taip;0;4;0;4
12364;Užupiukas;SPINDULIUKŲ;31338755810;Taip;0;7;0;7
12365;Užupiukas;SPINDULIUKŲ;27588257764;Taip;0;4;1;5
12366;Užupiukas;SPINDULIUKŲ;12401560384;Taip;0;4;3;7
12367;Užupiukas;SPINDULIUKŲ;91115810366;Taip;2;4;0;6
12368;Užupiukas;SPINDULIUKŲ;77255831055;Taip;0;4;1;5
12369;Užupiukas;SPINDULIUKŲ;78184067796;Taip;0;8;0;8
12370;Užupiukas;SPINDULIUKŲ;85492444123;Taip;0;3;0;3
12371;Užupiukas;SPINDULIUKŲ;61670878339;Taip;0;3;1;4
12372;Užupiukas;SPINDULIUKŲ;7060019183;Taip;5;4;1;10
12373;Užupiukas;SPINDULIUKŲ;39079421361;Taip;0;4;4;8
12374;Užupiukas;SPINDULIUKŲ;33629222941;Taip;5;4;0;9
12375;Užupiukas;SPINDULIUKŲ;51802714332;Taip;0;4;0;4
12376;Užupiukas;SPINDULIUKŲ;266671806;Ne;0;12;0;12
12377;Užupiukas;SPINDULIUKŲ;3663596268;Taip;8;4;1;13
12378;Užupiukas;SPINDULIUKŲ;3613132636;Taip;5;4;1;10
12379;Užupiukas;ŽVIRBLIUKŲ;31668159620;Ne;11;4;0;15
12380;Užupiukas;ŽVIRBLIUKŲ;27226172373;Taip;0;4;2;6
12381;Užupiukas;ŽVIRBLIUKŲ;42772205412;Taip;10;4;1;15
12382;Užupiukas;ŽVIRBLIUKŲ;22839159539;Ne;5;4;1;10
12383;Užupiukas;ŽVIRBLIUKŲ;86504628397;Taip;0;4;1;5
12384;Užupiukas;ŽVIRBLIUKŲ;84367190618;Taip;0;4;0;4
12385;Užupiukas;ŽVIRBLIUKŲ;20407315;Taip;0;2;0;2
12386;Užupiukas;ŽVIRBLIUKŲ;68812682685;Taip;0;4;0;4
12387;Užupiukas;ŽVIRBLIUKŲ;74913928694;Taip;0;4;1;5
12388;Užupiukas;ŽVIRBLIUKŲ;31618737243;Taip;13;4;0;17
12389;Užupiukas;ŽVIRBLIUKŲ;30335529070;Taip;0;3;1;4
12390;Užupiukas;ŽVIRBLIUKŲ;9263601354;Taip;0;4;0;4
12391;Užupiukas;ŽVIRBLIUKŲ;68898413144;Taip;0;4;0;4
12392;Užupiukas;ŽVIRBLIUKŲ;97966482763;Taip;3;4;2;9
12393;Užupiukas;ŽVIRBLIUKŲ;12905151141;Taip;0;4;2;6
12394;Užupiukas;ŽVIRBLIUKŲ;95445743970;Ne;0;1;0;1
12395;Užupiukas;ŽVIRBLIUKŲ;7659981079;Taip;0;1;3;4
12396;Užupiukas;ŽVIRBLIUKŲ;61560152825;Taip;0;1;0;1
12397;Užupiukas;ŽVIRBLIUKŲ;19777635011;Taip;0;9;1;10
12398;Užupiukas;ŽVIRBLIUKŲ;1700750771;Taip;0;4;2;6
12399;Užupiukas;ŽVIRBLIUKŲ;32651983670;Taip;0;7;0;7
12400;Užupiukas;ŽVIRBLIUKŲ;10715755079;Ne;0;4;2;6
12401;Užupiukas;ŽVIRBLIUKŲ;42027395287;Taip;0;4;6;10
12402;Užupiukas;ŽVIRBLIUKŲ;1617969472;Taip;0;4;7;11
12403;Užupiukas;PELĖDŽIUKŲ;73657553075;Taip;7;0;4;11
12404;Užupiukas;PELĖDŽIUKŲ;12023740118;Taip;0;6;0;6
12405;Užupiukas;PELĖDŽIUKŲ;1102150432;Taip;0;4;5;9
12406;Užupiukas;PELĖDŽIUKŲ;1593878778;Taip;0;4;7;11
12407;Užupiukas;PELĖDŽIUKŲ;1850295450;Taip;10;4;5;19
12408;Užupiukas;PELĖDŽIUKŲ;1338561168;Taip;0;1;4;5
12409;Užupiukas;PELĖDŽIUKŲ;9843068906;Ne;3;6;1;10
12410;Užupiukas;PELĖDŽIUKŲ;94857555708;Taip;17;4;0;21
12411;Užupiukas;PELĖDŽIUKŲ;7616817709;Taip;0;4;1;5
12412;Užupiukas;PELĖDŽIUKŲ;3785893846;Taip;12;4;0;16
12413;Užupiukas;PELĖDŽIUKŲ;1159892685;Taip;17;4;0;21
12414;Užupiukas;PELĖDŽIUKŲ;6442996343;Taip;0;4;1;5
12415;Užupiukas;PELĖDŽIUKŲ;30379165882;Taip;0;4;1;5
12416;Užupiukas;PELĖDŽIUKŲ;27438104059;Taip;0;4;1;5
12417;Užupiukas;PELĖDŽIUKŲ;1535952427;Taip;3;4;4;11
12418;Užupiukas;PELĖDŽIUKŲ;95981297986;Taip;12;0;1;13
12419;Užupiukas;PELĖDŽIUKŲ;2419842168;Taip;0;4;8;12
12420;Užupiukas;PELĖDŽIUKŲ;1891595719;Taip;0;4;4;8
12421;Užupiukas;PELĖDŽIUKŲ;98209952363;Taip;0;0;5;5
12422;Užupiukas;PELĖDŽIUKŲ;79908666651;Taip;5;4;7;16
12423;Užupiukas;PELĖDŽIUKŲ;2924954048;Taip;3;6;0;9
12424;Užupiukas;PELĖDŽIUKŲ;9483673859;Taip;6;4;1;11
12425;Užupiukas;PELĖDŽIUKŲ;64962686221;Taip;0;1;1;2
12426;Užupiukas;PELĖDŽIUKŲ;1256526274;Ne;5;10;2;17
12427;Užupiukas;PELĖDŽIUKŲ;31833883832;Taip;0;4;0;4
12428;Užupiukas;VARPELIŲ;6790700398;Taip;0;9;0;9
12429;Užupiukas;VARPELIŲ;23723147269;Taip;3;5;0;8
12430;Užupiukas;VARPELIŲ;7874627355;Taip;10;4;1;15
12431;Užupiukas;VARPELIŲ;51243697666;Taip;0;3;0;3
12432;Užupiukas;VARPELIŲ;17651645880;Taip;7;4;1;12
12433;Užupiukas;VARPELIŲ;98428714407;Taip;4;4;3;11
12434;Užupiukas;VARPELIŲ;57439594934;Taip;0;3;1;4
12435;Užupiukas;VARPELIŲ;2137620968;Taip;0;4;3;7
12436;Užupiukas;VARPELIŲ;5079596604;Taip;0;4;1;5
12437;Užupiukas;VARPELIŲ;1294561841;Taip;6;3;2;11
12438;Užupiukas;VARPELIŲ;2031306814;Ne;0;4;1;5
12439;Užupiukas;VARPELIŲ;79092366287;Taip;4;0;6;10
12440;Užupiukas;VARPELIŲ;6188599930;Taip;0;5;0;5
12441;Užupiukas;VARPELIŲ;8358242714;Taip;7;4;4;15
12442;Užupiukas;VARPELIŲ;82632886488;Taip;5;0;5;10
12443;Užupiukas;VARPELIŲ;1103878937;Taip;2;2;0;4
12444;Užupiukas;VARPELIŲ;81986379983;Taip;9;4;1;14
12445;Užupiukas;VARPELIŲ;77950386276;Taip;0;0;8;8
12446;Užupiukas;VARPELIŲ;1483072450;Taip;12;0;1;13
12447;Užupiukas;VARPELIŲ;48032538853;Ne;10;0;2;12
12448;Užupiukas;SAULUČIŲ;2574149268;Ne;4;5;0;9
12449;Užupiukas;SAULUČIŲ;89338828452;Taip;0;0;1;1
12450;Užupiukas;SAULUČIŲ;10681040398;Taip;2;5;0;7
12451;Užupiukas;SAULUČIŲ;55683021710;Taip;0;5;0;5
12452;Užupiukas;SAULUČIŲ;64774033504;Taip;0;1;1;2
12453;Užupiukas;SAULUČIŲ;1656658765;Taip;0;4;0;4
12454;Užupiukas;SAULUČIŲ;1307564992;Taip;0;0;17;17
12455;Užupiukas;SAULUČIŲ;2740412091;Taip;12;0;0;12
12456;Užupiukas;SAULUČIŲ;1577630991;Taip;9;6;4;19
12457;Užupiukas;SAULUČIŲ;1158250810;Taip;0;11;0;11
12458;Užupiukas;SAULUČIŲ;48886679788;Taip;0;4;6;10
12459;Užupiukas;SAULUČIŲ;36820708170;Taip;4;0;1;5
12460;Užupiukas;SAULUČIŲ;52600923918;Taip;0;4;3;7
12461;Užupiukas;SAULUČIŲ;10522364665;Taip;0;4;0;4
12462;Užupiukas;SAULUČIŲ;31471265444;Taip;5;5;1;11
12463;Užupiukas;SAULUČIŲ;87017671664;Taip;0;5;4;9
12464;Užupiukas;SAULUČIŲ;15815468617;Taip;13;0;1;14
12465;Užupiukas;SAULUČIŲ;1592276956;Ne;2;5;3;10
12466;Užupiukas;SAULUČIŲ;6467238027;Taip;0;3;1;4
12467;Užupiukas;SAULUČIŲ;2499414724;Taip;0;2;3;5
12468;Užupiukas;SAULUČIŲ;53272114855;Taip;10;1;0;11
12469;Užupiukas;LAPIUKŲ;3309195572;Taip;14;4;0;18
12470;Užupiukas;LAPIUKŲ;7563497568;Taip;0;4;8;12
12471;Užupiukas;LAPIUKŲ;2821350355;Taip;7;4;0;11
12472;Užupiukas;LAPIUKŲ;5665323444;Taip;6;0;0;6
12473;Užupiukas;LAPIUKŲ;22401995674;Taip;7;4;1;12
12474;Užupiukas;LAPIUKŲ;3774364829;Taip;6;4;1;11
12475;Užupiukas;LAPIUKŲ;6236652118;Taip;8;4;0;12
12476;Užupiukas;LAPIUKŲ;4247280316;Taip;0;5;4;9
12477;Užupiukas;LAPIUKŲ;2938276316;Taip;5;4;0;9
12478;Užupiukas;LAPIUKŲ;6478702476;Taip;0;4;7;11
12479;Užupiukas;LAPIUKŲ;4132760111;Taip;4;4;0;8
12480;Užupiukas;LAPIUKŲ;53412835151;Taip;3;4;0;7
12481;Užupiukas;LAPIUKŲ;3205769002;Ne;15;0;2;17
12482;Užupiukas;LAPIUKŲ;5498369850;Taip;8;0;0;8
12483;Užupiukas;LAPIUKŲ;79442829922;Taip;0;4;0;4
12484;Užupiukas;LAPIUKŲ;4608233152;Ne;13;0;1;14
12485;Užupiukas;LAPIUKŲ;9197242545;Taip;0;0;4;4
12486;Užupiukas;LAPIUKŲ;5320544400;Ne;4;0;8;12
12487;Užupiukas;LAPIUKŲ;4880828482;Ne;11;0;0;11
12488;Užupiukas;LAPIUKŲ;40704768956;Taip;0;1;1;2
12489;Užupiukas;NYKŠTUKŲ;1355954767;Taip;0;0;2;2
12490;Užupiukas;NYKŠTUKŲ;6001766518;Taip;8;4;2;14
12491;Užupiukas;NYKŠTUKŲ;2273766308;Taip;12;0;0;12
12492;Užupiukas;NYKŠTUKŲ;9428884149;Taip;11;0;4;15
12493;Užupiukas;NYKŠTUKŲ;8301340579;Taip;16;0;1;17
12494;Užupiukas;NYKŠTUKŲ;5085660507;Taip;0;0;6;6
12495;Užupiukas;NYKŠTUKŲ;1496541880;Taip;6;0;13;19
12496;Užupiukas;NYKŠTUKŲ;3528581949;Taip;4;5;5;14
12497;Užupiukas;NYKŠTUKŲ;7345579721;Taip;0;0;6;6
12498;Užupiukas;NYKŠTUKŲ;7530856195;Taip;15;0;1;16
12499;Užupiukas;NYKŠTUKŲ;9925592494;Taip;12;0;0;12
12500;Užupiukas;NYKŠTUKŲ;4054724625;Taip;3;18;0;21
12501;Užupiukas;NYKŠTUKŲ;1995228207;Taip;7;0;5;12
12502;Užupiukas;NYKŠTUKŲ;4710910251;Taip;0;4;3;7
12503;Užupiukas;NYKŠTUKŲ;2390955083;Taip;7;4;1;12
12504;Užupiukas;NYKŠTUKŲ;3768945773;Ne;10;0;1;11
12505;Užupiukas;NYKŠTUKŲ;2210437775;Taip;8;4;1;13
12506;Užupiukas;NYKŠTUKŲ;8519118225;Taip;16;0;4;20
12507;Užupiukas;NYKŠTUKŲ;7549628277;Taip;16;0;4;20
12508;Užupiukas;NYKŠTUKŲ;1684901495;Taip;11;0;0;11
12509;Vaidilutė;Žiogelis;83446186815;Taip;0;4;6;10
12510;Vaidilutė;Žiogelis;51568574636;Taip;0;4;0;4
12511;Vaidilutė;Žiogelis;45619465634;Taip;9;0;0;9
12512;Vaidilutė;Žiogelis;1587658785;Taip;0;0;5;5
12513;Vaidilutė;Žiogelis;72508198771;Taip;0;9;0;9
12514;Vaidilutė;Žiogelis;36995673806;Taip;9;0;0;9
12515;Vaidilutė;Žiogelis;26144399724;Taip;0;4;1;5
12516;Vaidilutė;Žiogelis;76095903956;Ne;5;0;0;5
12517;Vaidilutė;Žiogelis;25736859991;Taip;0;4;0;4
12518;Vaidilutė;Žiogelis;37065810950;Taip;0;1;0;1
12519;Vaidilutė;Žiogelis;93941932893;Taip;0;0;4;4
12520;Vaidilutė;Žiogelis;11736298044;Taip;5;0;3;8
12521;Vaidilutė;Žiogelis;60118349568;Taip;9;0;0;9
12522;Vaidilutė;Žiogelis;9616432332;Taip;3;2;1;6
12523;Vaidilutė;Žiogelis;65596730863;Taip;0;4;4;8
12524;Vaidilutė;Žiogelis;69907222472;Taip;0;7;2;9
12525;Vaidilutė;Žiogelis;52281826464;Taip;0;1;1;2
12526;Vaidilutė;Žiogelis;98760023673;Taip;0;0;1;1
12527;Vaidilutė;Žiogelis;1254377446;Taip;7;4;1;12
12528;Vaidilutė;Žiogelis;80628141893;Taip;7;4;1;12
12529;Vaidilutė;Rūtelė;2131127298;Taip;5;4;0;9
12530;Vaidilutė;Rūtelė;8789527552;Taip;0;1;2;3
12531;Vaidilutė;Rūtelė;7319037375;Taip;0;11;0;11
12532;Vaidilutė;Rūtelė;6630603158;Taip;6;0;0;6
12533;Vaidilutė;Rūtelė;4838951446;Taip;11;0;1;12
12534;Vaidilutė;Rūtelė;7494818866;Taip;0;4;2;6
12535;Vaidilutė;Rūtelė;5500950179;Taip;5;4;2;11
12536;Vaidilutė;Rūtelė;1516903980;Taip;17;4;0;21
12537;Vaidilutė;Rūtelė;1140011879;Taip;8;0;0;8
12538;Vaidilutė;Rūtelė;9563257771;Taip;0;10;0;10
12539;Vaidilutė;Rūtelė;9652684068;Taip;4;0;5;9
12540;Vaidilutė;Rūtelė;2024078532;Taip;5;0;5;10
12541;Vaidilutė;Rūtelė;5482030284;Taip;0;4;0;4
12542;Vaidilutė;Rūtelė;8505156287;Taip;7;0;2;9
12543;Vaidilutė;Rūtelė;9568450630;Taip;15;0;0;15
12544;Vaidilutė;Rūtelė;7306768961;Taip;16;0;0;16
12545;Vaidilutė;Rūtelė;7532115462;Taip;8;0;0;8
12546;Vaidilutė;Rūtelė;6896047075;Taip;8;0;1;9
12547;Vaidilutė;Rūtelė;3059654988;Taip;20;0;0;20
12548;Vaidilutė;Rūtelė;1341696594;Ne;13;0;0;13
12549;Vaidilutė;Voveraitė;1993403692;Taip;0;8;0;8
12550;Vaidilutė;Voveraitė;42503303158;Taip;0;9;0;9
12551;Vaidilutė;Voveraitė;9948685221;Taip;9;0;0;9
12552;Vaidilutė;Voveraitė;9869134464;Taip;4;0;1;5
12553;Vaidilutė;Voveraitė;29153363263;Taip;3;0;3;6
12554;Vaidilutė;Voveraitė;3069613102;Ne;10;0;0;10
12555;Vaidilutė;Voveraitė;5177060346;Taip;0;5;0;5
12556;Vaidilutė;Voveraitė;19402768340;Taip;0;12;0;12
12557;Vaidilutė;Voveraitė;4671287016;Taip;5;0;0;5
12558;Vaidilutė;Voveraitė;7419525100;Taip;0;2;2;4
12559;Vaidilutė;Voveraitė;1363913645;Ne;9;9;0;18
12560;Vaidilutė;Voveraitė;5252637701;Taip;2;6;0;8
12561;Vaidilutė;Voveraitė;1320999237;Taip;0;0;2;2
12562;Vaidilutė;Voveraitė;1691407801;Taip;0;4;0;4
12563;Vaidilutė;Voveraitė;1704155743;Taip;6;0;0;6
12564;Vaidilutė;Voveraitė;1139332221;Taip;6;2;0;8
12565;Vaidilutė;Voveraitė;9124975928;Taip;2;9;1;12
12566;Vaidilutė;Voveraitė;3202508790;Taip;5;0;4;9
12567;Vaidilutė;Saulutė;8492055287;Taip;10;0;0;10
12568;Vaidilutė;Saulutė;6844372910;Taip;10;0;1;11
12569;Vaidilutė;Saulutė;4972645715;Taip;21;0;0;21
12570;Vaidilutė;Saulutė;1355005114;Taip;9;0;0;9
12571;Vaidilutė;Saulutė;4680645841;Taip;0;0;7;7
12572;Vaidilutė;Saulutė;2662468804;Taip;4;0;2;6
12573;Vaidilutė;Saulutė;5217609332;Taip;0;4;0;4
12574;Vaidilutė;Saulutė;2864731541;Ne;10;1;1;12
12575;Vaidilutė;Saulutė;1998872078;Taip;9;0;4;13
12576;Vaidilutė;Saulutė;2468220275;Taip;7;0;0;7
12577;Vaidilutė;Saulutė;1610262589;Taip;15;0;1;16
12578;Vaidilutė;Saulutė;2356037175;Taip;12;0;0;12
12579;Vaidilutė;Saulutė;5054640268;Taip;10;1;2;13
12580;Vaidilutė;Saulutė;6885473308;Taip;6;0;0;6
12581;Vaidilutė;Saulutė;7826111890;Taip;9;0;0;9
12582;Vaidilutė;Saulutė;1667275889;Taip;7;0;4;11
12583;Vaidilutė;Saulutė;9870763434;Taip;8;6;1;15
12584;Vaidilutė;Žibutė;5686463470;Taip;5;5;2;12
12585;Vaidilutė;Žibutė;1430802591;Taip;13;0;0;13
12586;Vaidilutė;Žibutė;7843388119;Taip;4;4;0;8
12587;Vaidilutė;Žibutė;2041126370;Taip;3;0;0;3
12588;Vaidilutė;Žibutė;16491592864;Taip;0;4;0;4
12589;Vaidilutė;Žibutė;45949026707;Taip;3;2;0;5
12590;Vaidilutė;Žibutė;4259585225;Taip;5;4;0;9
12591;Vaidilutė;Žibutė;4334934114;Taip;0;5;4;9
12592;Vaidilutė;Žibutė;3152118407;Taip;0;5;0;5
12593;Vaidilutė;Žibutė;5203062837;Taip;0;3;0;3
12594;Vaidilutė;Žibutė;1266927367;Taip;5;0;0;5
12595;Vaidilutė;Žibutė;2941550026;Taip;0;6;1;7
12596;Vaidilutė;Žibutė;4362797606;Taip;5;1;0;6
12597;Vaidilutė;Žibutė;6322986820;Taip;3;1;0;4
12598;Vaidilutė;Žibutė;5620009051;Taip;6;0;0;6
12599;Vaidilutė;Žibutė;1853463568;Taip;6;4;0;10
12600;Vaidilutė;Žibutė;9556632708;Taip;6;6;0;12
12601;Vaidilutė;Žibutė;3990013866;Taip;1;0;0;1
12602;Vaidilutė;Žibutė;7779630805;Taip;7;0;0;7
12603;Vaidilutė;Žibutė;5991149222;Taip;7;1;0;8
12604;Vaidilutė;"Ąžuoliukas ";95291858283;Taip;0;0;1;1
12605;Vaidilutė;"Ąžuoliukas ";38331934468;Taip;0;5;0;5
12606;Vaidilutė;"Ąžuoliukas ";92269487538;Taip;21;0;0;21
12607;Vaidilutė;"Ąžuoliukas ";83614804593;Taip;0;2;0;2
12608;Vaidilutė;"Ąžuoliukas ";2176694565;Taip;0;4;4;8
12609;Vaidilutė;"Ąžuoliukas ";15308595647;Taip;0;5;6;11
12610;Vaidilutė;"Ąžuoliukas ";70281031575;Taip;19;0;0;19
12611;Vaidilutė;"Ąžuoliukas ";57981568010;Taip;0;4;2;6
12612;Vaidilutė;"Ąžuoliukas ";36162605033;Taip;19;0;0;19
12613;Vaidilutė;"Ąžuoliukas ";29245907351;Taip;19;0;0;19
12614;Vaidilutė;"Ąžuoliukas ";12982620392;Taip;14;4;0;18
12615;Vaidilutė;"Ąžuoliukas ";13343473227;Taip;0;0;2;2
12616;Vaidilutė;"Ąžuoliukas ";87617273304;Taip;0;0;5;5
12617;Vaidilutė;"Ąžuoliukas ";5737042516;Taip;0;0;7;7
12618;Vaidilutė;"Ąžuoliukas ";5785964650;Taip;0;4;1;5
12619;Vaidilutė;"Ąžuoliukas ";7036490032;Taip;3;0;0;3
12620;Vaidilutė;"Žemuogėlė ";82558684054;Ne;0;0;7;7
12621;Vaidilutė;"Žemuogėlė ";1470597477;Taip;0;0;3;3
12622;Vaidilutė;"Žemuogėlė ";36556774940;Taip;9;4;0;13
12623;Vaidilutė;"Žemuogėlė ";84723450591;Taip;0;4;0;4
12624;Vaidilutė;"Žemuogėlė ";2852550471;Taip;0;4;1;5
12625;Vaidilutė;"Žemuogėlė ";1047235238;Taip;12;4;0;16
12626;Vaidilutė;"Žemuogėlė ";2033196214;Taip;0;5;2;7
12627;Vaidilutė;"Žemuogėlė ";98968425270;Taip;0;4;2;6
12628;Vaidilutė;"Žemuogėlė ";26241930203;Taip;0;1;0;1
12629;Vaidilutė;"Žemuogėlė ";37901356592;Taip;0;0;2;2
12630;Vaidilutė;"Žemuogėlė ";84467252313;Taip;0;0;1;1
12631;Vaidilutė;"Žemuogėlė ";1564429390;Ne;4;0;4;8
12632;Vaidilutė;"Žemuogėlė ";96794583279;Taip;5;1;1;7
12633;Vaidilutė;"Žemuogėlė ";1974967085;Taip;12;0;0;12
12634;Vaidilutė;"Žemuogėlė ";6758078068;Taip;0;0;1;1
12635;Vaidilutė;"Žemuogėlė ";48928174623;Taip;0;4;0;4
12636;Vaidilutė;"Žemuogėlė ";1556646493;Taip;3;0;3;6
12637;Vaidilutė;"Žemuogėlė ";55183164909;Taip;2;9;1;12
12638;Vaidilutė;"Žemuogėlė ";25071409492;Taip;0;4;6;10
12639;Vaidilutė;"Žemuogėlė ";1347860031;Taip;0;3;1;4
12640;Vaidilutė;"Žemuogėlė ";99220518506;Taip;5;4;2;11
12641;Vaidilutė;"Vyturėlis ";5821467408;Taip;13;2;0;15
12642;Vaidilutė;"Vyturėlis ";5116482125;Taip;0;4;0;4
12643;Vaidilutė;"Vyturėlis ";25654419755;Taip;0;4;1;5
12644;Vaidilutė;"Vyturėlis ";70384916008;Taip;5;4;0;9
12645;Vaidilutė;"Vyturėlis ";79061542327;Taip;6;4;0;10
12646;Vaidilutė;"Vyturėlis ";2099647381;Taip;4;4;0;8
12647;Vaidilutė;"Vyturėlis ";72248829784;Taip;0;3;1;4
12648;Vaidilutė;"Vyturėlis ";34492341585;Taip;12;4;0;16
12649;Vaidilutė;"Vyturėlis ";57463417019;Taip;0;2;0;2
12650;Vaidilutė;"Vyturėlis ";79694144428;Taip;6;0;2;8
12651;Vaidilutė;"Vyturėlis ";79964507480;Taip;0;4;1;5
12652;Vaidilutė;"Vyturėlis ";10737417556;Taip;0;5;0;5
12653;Vaidilutė;"Vyturėlis ";1416870651;Taip;0;4;0;4
12654;Vaidilutė;"Vyturėlis ";77020716708;Taip;2;4;1;7
12655;Vaidilutė;"Vyturėlis ";87401758633;Taip;7;5;0;12
12656;Vaidilutė;"Vyturėlis ";2067604305;Taip;0;4;0;4
12657;Vaidilutė;"Vyturėlis ";3220471656;Taip;4;2;0;6
12658;Vaidilutė;"Vyturėlis ";94210720777;Taip;0;5;0;5
12659;Vaidilutė;"Vyturėlis ";1315347184;Taip;5;6;0;11
12660;Vaidilutė;"Vyturėlis ";1692795486;Taip;0;10;1;11
12661;Vaidilutė;"Varpelis ";4159072583;Taip;0;0;9;9
12662;Vaidilutė;"Varpelis ";6250831269;Taip;0;0;1;1
12663;Vaidilutė;"Varpelis ";5276088687;Taip;0;2;2;4
12664;Vaidilutė;"Varpelis ";2763266518;Taip;8;4;0;12
12665;Vaidilutė;"Varpelis ";6037349527;Ne;6;0;4;10
12666;Vaidilutė;"Varpelis ";5867501558;Taip;0;4;0;4
12667;Vaidilutė;"Varpelis ";3832349858;Taip;0;7;2;9
12668;Vaidilutė;"Varpelis ";9317774960;Taip;0;4;0;4
12669;Vaidilutė;"Varpelis ";5448014291;Taip;10;0;2;12
12670;Vaidilutė;"Varpelis ";3497795848;Taip;3;0;0;3
12671;Vaidilutė;"Varpelis ";4280822951;Taip;4;0;0;4
12672;Vaidilutė;"Varpelis ";1385914020;Taip;0;0;10;10
12673;Vaidilutė;"Varpelis ";6107554047;Taip;0;0;1;1
12674;Vaidilutė;"Varpelis ";6022130248;Taip;0;0;5;5
12675;Vaidilutė;"Varpelis ";5101104226;Ne;5;0;5;10
12676;Vaidilutė;"Varpelis ";5594121340;Taip;0;3;5;8
12677;Vaidilutė;"Varpelis ";1882829340;Taip;0;1;7;8
12678;Vaidilutė;"Boružėlių ";5988376676;Taip;3;0;0;3
12679;Vaidilutė;"Boružėlių ";3381544575;Taip;9;0;0;9
12680;Vaidilutė;"Boružėlių ";1305478052;Taip;16;0;0;16
12681;Vaidilutė;"Boružėlių ";6586072228;Taip;14;0;0;14
12682;Vaidilutė;"Boružėlių ";9811981645;Taip;11;0;0;11
12683;Vaidilutė;"Boružėlių ";4761992071;Taip;21;0;0;21
12684;Vaidilutė;"Boružėlių ";5307486959;Taip;2;9;0;11
12685;Vaidilutė;"Boružėlių ";1653497170;Taip;2;9;0;11
12686;Vaidilutė;"Boružėlių ";5556351358;Taip;4;2;0;6
12687;Vaidilutė;"Boružėlių ";4954285515;Taip;5;3;0;8
12688;Vaidilutė;"Boružėlių ";5439973183;Taip;16;0;0;16
12689;Vaidilutė;"Boružėlių ";1440819171;Ne;5;13;0;18
12690;Vaidilutė;"Boružėlių ";2668758195;Taip;9;0;0;9
12691;Vaidilutė;"Boružėlių ";3730573432;Taip;13;0;0;13
12692;Vaidilutė;"Boružėlių ";4901387311;Taip;16;0;0;16
12693;Vaidilutė;"Malūnelis ";9558983004;Taip;4;1;1;6
12694;Vaidilutė;"Malūnelis ";9689388330;Taip;6;1;0;7
12695;Vaidilutė;"Malūnelis ";2081959307;Taip;3;4;2;9
12696;Vaidilutė;"Malūnelis ";2058071219;Taip;6;1;2;9
12697;Vaidilutė;"Malūnelis ";9577869269;Taip;4;0;0;4
12698;Vaidilutė;"Malūnelis ";1417828163;Taip;6;5;0;11
12699;Vaidilutė;"Malūnelis ";1401180999;Taip;4;0;0;4
12700;Vaidilutė;"Malūnelis ";5326935037;Taip;14;0;0;14
12701;Vaidilutė;"Malūnelis ";2189753894;Taip;0;9;0;9
12702;Vaidilutė;"Malūnelis ";8628545847;Taip;4;0;1;5
12703;Vaidilutė;"Malūnelis ";4230076320;Taip;16;0;0;16
12704;Vaidilutė;"Malūnelis ";2517524802;Taip;11;0;0;11
12705;Vaidilutė;"Malūnelis ";9584702487;Taip;10;0;0;10
12706;Vaidilutė;"Malūnelis ";8882402632;Taip;13;5;0;18
12707;Vaidilutė;"Malūnelis ";1539700521;Taip;5;0;0;5
12708;Vaidilutė;"Riešutėlis ";1986162951;Taip;9;0;3;12
12709;Vaidilutė;"Riešutėlis ";1941081703;Taip;0;0;1;1
12710;Vaidilutė;"Riešutėlis ";87621682081;Taip;0;0;1;1
12711;Vaidilutė;"Riešutėlis ";76613866916;Taip;12;0;0;12
12712;Vaidilutė;"Riešutėlis ";1942402815;Ne;0;1;0;1
12713;Vaidilutė;"Riešutėlis ";8543285470;Taip;6;0;5;11
12714;Vaidilutė;"Riešutėlis ";3962268551;Ne;0;7;6;13
12715;Vaidilutė;"Riešutėlis ";19413698194;Taip;3;0;0;3
12716;Vaidilutė;"Riešutėlis ";83887347923;Taip;2;4;1;7
12717;Vaidilutė;"Riešutėlis ";69452750985;Taip;9;0;1;10
12718;Vaidilutė;"Riešutėlis ";44867291232;Taip;5;0;0;5
12719;Vaidilutė;"Riešutėlis ";17497609539;Taip;0;0;2;2
12720;Vaidilutė;"Riešutėlis ";38698526742;Ne;5;0;0;5
12721;Vaidilutė;"Riešutėlis ";1664595920;Taip;11;9;0;20
12722;Vaidilutė;"Riešutėlis ";1608286003;Taip;0;4;6;10
12723;Vaidilutė;"Riešutėlis ";1083096707;Ne;8;0;0;8
12724;Vaidilutė;"Riešutėlis ";1405802722;Taip;5;0;0;5
12725;Vaidilutė;"Riešutėlis ";67830476121;Taip;10;0;3;13
12726;Vaidilutė;"Riešutėlis ";3243266869;Taip;18;0;0;18
12727;Vandenis;ŽUVĖDRŲ;91659985965;Taip;0;5;0;5
12728;Vandenis;ŽUVĖDRŲ;52063106839;Taip;0;4;0;4
12729;Vandenis;ŽUVĖDRŲ;83799061370;Taip;0;0;2;2
12730;Vandenis;ŽUVĖDRŲ;72923438583;Taip;0;4;0;4
12731;Vandenis;ŽUVĖDRŲ;86007123;Taip;2;10;0;12
12732;Vandenis;ŽUVĖDRŲ;96459201904;Taip;11;4;0;15
12733;Vandenis;ŽUVĖDRŲ;49204161380;Taip;0;7;0;7
12734;Vandenis;ŽUVĖDRŲ;67472126318;Taip;3;6;0;9
12735;Vandenis;ŽUVĖDRŲ;32749176064;Taip;6;5;0;11
12736;Vandenis;ŽUVĖDRŲ;80186166441;Taip;7;0;0;7
12737;Vandenis;ŽUVĖDRŲ;4045401354;Taip;0;6;2;8
12738;Vandenis;ŽUVĖDRŲ;41376432095;Taip;0;6;1;7
12739;Vandenis;ŽUVĖDRŲ;62877843868;Ne;0;8;2;10
12740;Vandenis;ŽUVĖDRŲ;85287618619;Taip;0;11;0;11
12741;Vandenis;ŽUVĖDRŲ;3639803910;Taip;0;5;0;5
12742;Vandenis;ŽUVĖDRŲ;35581230147;Ne;0;8;0;8
12743;Vandenis;ŽUVĖDRŲ;22764351701;Taip;0;8;0;8
12744;Vandenis;ŽUVĖDRŲ;92857304500;Taip;0;4;0;4
12745;Vandenis;ŽUVĖDRŲ;55952119623;Ne;4;4;0;8
12746;Vandenis;ŽUVĖDRŲ;58324898715;Taip;0;4;0;4
12747;Vandenis;ŽUVĖDRŲ;56648967396;Taip;0;11;0;11
12748;Vandenis;ŽUVĖDRŲ;87398241763;Taip;6;0;0;6
12749;Vandenis;ŽUVĖDRŲ;48908599635;Taip;0;6;1;7
12750;Vandenis;RUONIUKŲ;2422642232;Taip;6;0;10;16
12751;Vandenis;RUONIUKŲ;1051281257;Taip;12;0;6;18
12752;Vandenis;RUONIUKŲ;7565308536;Taip;0;8;0;8
12753;Vandenis;RUONIUKŲ;9518434896;Taip;0;3;0;3
12754;Vandenis;RUONIUKŲ;2638433939;Ne;0;5;0;5
12755;Vandenis;RUONIUKŲ;1120907086;Taip;0;4;3;7
12756;Vandenis;RUONIUKŲ;1563710105;Taip;0;0;1;1
12757;Vandenis;RUONIUKŲ;7702272913;Taip;7;0;0;7
12758;Vandenis;RUONIUKŲ;6476051751;Taip;0;9;0;9
12759;Vandenis;RUONIUKŲ;9162936403;Ne;7;5;1;13
12760;Vandenis;RUONIUKŲ;4713395766;Taip;0;4;0;4
12761;Vandenis;RUONIUKŲ;6986724058;Taip;0;7;0;7
12762;Vandenis;RUONIUKŲ;7754158588;Taip;0;0;2;2
12763;Vandenis;RUONIUKŲ;9731729915;Taip;13;0;0;13
12764;Vandenis;RUONIUKŲ;9527253920;Taip;11;0;0;11
12765;Vandenis;RUONIUKŲ;8971291182;Taip;13;0;1;14
12766;Vandenis;RUONIUKŲ;6330187732;Ne;17;4;0;21
12767;Vandenis;RUONIUKŲ;9688954631;Ne;0;6;0;6
12768;Vandenis;RUONIUKŲ;8729351613;Taip;6;4;0;10
12769;Vandenis;RUONIUKŲ;4971165639;Ne;15;0;0;15
12770;Vandenis;ŽUVYČIŲ;28286348996;Taip;0;4;0;4
12771;Vandenis;ŽUVYČIŲ;2494327284;Taip;6;4;0;10
12772;Vandenis;ŽUVYČIŲ;47333381244;Taip;0;9;2;11
12773;Vandenis;ŽUVYČIŲ;20458211098;Taip;0;5;0;5
12774;Vandenis;ŽUVYČIŲ;95498596116;Ne;0;5;0;5
12775;Vandenis;ŽUVYČIŲ;39662768043;Taip;0;4;4;8
12776;Vandenis;ŽUVYČIŲ;391453841;Ne;0;7;0;7
12777;Vandenis;ŽUVYČIŲ;32087433270;Taip;0;8;0;8
12778;Vandenis;ŽUVYČIŲ;50009330411;Taip;5;4;0;9
12779;Vandenis;ŽUVYČIŲ;18310147466;Taip;1;4;0;5
12780;Vandenis;ŽUVYČIŲ;318399174;Taip;0;4;0;4
12781;Vandenis;ŽUVYČIŲ;57251416305;Taip;5;5;0;10
12782;Vandenis;ŽUVYČIŲ;54659569326;Taip;6;5;0;11
12783;Vandenis;ŽUVYČIŲ;69485657846;Taip;0;3;0;3
12784;Vandenis;ŽUVYČIŲ;54762939917;Taip;0;4;3;7
12785;Vandenis;ŽUVYČIŲ;45362889638;Ne;5;4;0;9
12786;Vandenis;ŽUVYČIŲ;33177236893;Taip;0;3;0;3
12787;Vandenis;ŽUVYČIŲ;23752943243;Ne;15;4;0;19
12788;Vandenis;ŽUVYČIŲ;35977990277;Ne;0;6;0;6
12789;Vandenis;ŽUVYČIŲ;59487083886;Taip;0;3;0;3
12790;Vandenis;ŽUVYČIŲ;51472939588;Taip;10;4;0;14
12791;Vandenis;ŽUVYČIŲ;83480564066;Taip;0;5;0;5
12792;Vandenis;ŽUVYČIŲ;1493719754;Taip;10;6;0;16
12793;Vandenis;PERLIUKŲ;8678508812;Taip;12;5;0;17
12794;Vandenis;PERLIUKŲ;2645775090;Taip;0;5;0;5
12795;Vandenis;PERLIUKŲ;5844576485;Taip;0;0;4;4
12796;Vandenis;PERLIUKŲ;6295009202;Taip;4;7;0;11
12797;Vandenis;PERLIUKŲ;7598257845;Taip;5;4;0;9
12798;Vandenis;PERLIUKŲ;7473692892;Taip;9;0;0;9
12799;Vandenis;PERLIUKŲ;5323428164;Taip;17;1;0;18
12800;Vandenis;PERLIUKŲ;6073002418;Taip;7;1;0;8
12801;Vandenis;PERLIUKŲ;1511740350;Taip;5;0;3;8
12802;Vandenis;PERLIUKŲ;2690536940;Ne;11;0;0;11
12803;Vandenis;PERLIUKŲ;2576575249;Taip;12;4;0;16
12804;Vandenis;PERLIUKŲ;7832674282;Ne;9;0;0;9
12805;Vandenis;PERLIUKŲ;9798192239;Taip;9;0;0;9
12806;Vandenis;PERLIUKŲ;1975385430;Taip;0;5;0;5
12807;Vandenis;PERLIUKŲ;3061606138;Ne;0;8;0;8
12808;Vandenis;PERLIUKŲ;8117385209;Taip;7;0;0;7
12809;Vandenis;PERLIUKŲ;5613067534;Taip;12;2;0;14
12810;Vandenis;PERLIUKŲ;2321919298;Taip;13;2;0;15
12811;Vandenis;PERLIUKŲ;5963181638;Ne;9;0;0;9
12812;Vandenis;PERLIUKŲ;5609737826;Taip;0;4;3;7
12813;Vandenis;ANČIUKŲ;8233407105;Taip;0;13;0;13
12814;Vandenis;ANČIUKŲ;1282499654;Taip;2;5;0;7
12815;Vandenis;ANČIUKŲ;3578947540;Taip;0;3;0;3
12816;Vandenis;ANČIUKŲ;5395847317;Taip;10;4;0;14
12817;Vandenis;ANČIUKŲ;3243079651;Taip;10;0;1;11
12818;Vandenis;ANČIUKŲ;3938359901;Taip;0;4;0;4
12819;Vandenis;ANČIUKŲ;1314724267;Taip;11;0;0;11
12820;Vandenis;ANČIUKŲ;8251169901;Ne;11;5;0;16
12821;Vandenis;ANČIUKŲ;4750141780;Taip;3;2;0;5
12822;Vandenis;ANČIUKŲ;6181866272;Taip;0;10;0;10
12823;Vandenis;ANČIUKŲ;7522472652;Taip;12;0;0;12
12824;Vandenis;ANČIUKŲ;7630017843;Taip;7;0;0;7
12825;Vandenis;ANČIUKŲ;1222539247;Taip;9;0;0;9
12826;Vandenis;ANČIUKŲ;3067868099;Taip;4;2;0;6
12827;Vandenis;ANČIUKŲ;8511948282;Ne;15;0;0;15
12828;Vandenis;ANČIUKŲ;33317650043;Ne;10;5;0;15
12829;Vandenis;ANČIUKŲ;1739780612;Ne;10;2;0;12
12830;Vandenis;ANČIUKŲ;2489776665;Taip;18;3;0;21
12831;Vandenis;ANČIUKŲ;71786730314;Taip;10;4;0;14
12832;Vandenis;ANČIUKŲ;1621481561;Taip;13;1;0;14
12833;Vandenis;ANČIUKŲ;33782837791;Taip;0;5;0;5
12834;Vandenis;VĖŽLIUKŲ;2309166304;Taip;7;4;0;11
12835;Vandenis;VĖŽLIUKŲ;2872343656;Taip;0;9;0;9
12836;Vandenis;VĖŽLIUKŲ;5454049563;Taip;11;0;0;11
12837;Vandenis;VĖŽLIUKŲ;9805578141;Taip;11;0;0;11
12838;Vandenis;VĖŽLIUKŲ;8921666108;Taip;16;0;0;16
12839;Vandenis;VĖŽLIUKŲ;8116532445;Taip;4;10;0;14
12840;Vandenis;VĖŽLIUKŲ;7069369080;Taip;4;10;0;14
12841;Vandenis;VĖŽLIUKŲ;6011280420;Taip;21;0;0;21
12842;Vandenis;VĖŽLIUKŲ;7924399684;Taip;2;8;0;10
12843;Vandenis;VĖŽLIUKŲ;1187395353;Taip;0;9;0;9
12844;Vandenis;VĖŽLIUKŲ;7091356848;Taip;0;3;0;3
12845;Vandenis;VĖŽLIUKŲ;1081385111;Taip;5;0;2;7
12846;Vandenis;VĖŽLIUKŲ;5126732658;Taip;0;1;0;1
12847;Vandenis;VĖŽLIUKŲ;7059385610;Taip;7;8;0;15
12848;Vandenis;VĖŽLIUKŲ;9158541919;Taip;8;1;0;9
12849;Vandenis;VĖŽLIUKŲ;5959181898;Taip;8;1;0;9
12850;Vandenis;VĖŽLIUKŲ;1707354287;Taip;11;6;0;17
12851;Vandenis;VĖŽLIUKŲ;2061017760;Taip;15;0;0;15
12852;Vandenis;VĖŽLIUKŲ;6894180651;Taip;15;0;0;15
12853;Vandenis;VĖŽLIUKŲ;4413648496;Taip;16;0;0;16
12854;Vandenis;AŠTUNKOJŲ;69715525764;Taip;0;6;0;6
12855;Vandenis;AŠTUNKOJŲ;39832993343;Taip;0;9;0;9
12856;Vandenis;AŠTUNKOJŲ;70732367996;Ne;3;3;0;6
12857;Vandenis;AŠTUNKOJŲ;88097898349;Taip;8;4;0;12
12858;Vandenis;AŠTUNKOJŲ;20843785079;Taip;0;8;0;8
12859;Vandenis;AŠTUNKOJŲ;56883076424;Taip;4;4;0;8
12860;Vandenis;AŠTUNKOJŲ;2056980868;Ne;4;5;0;9
12861;Vandenis;AŠTUNKOJŲ;16402149104;Taip;10;4;0;14
12862;Vandenis;AŠTUNKOJŲ;17644420312;Taip;0;7;0;7
12863;Vandenis;AŠTUNKOJŲ;26057060619;Taip;0;5;0;5
12864;Vandenis;AŠTUNKOJŲ;55331810310;Taip;8;5;0;13
12865;Vandenis;AŠTUNKOJŲ;48194812760;Taip;0;6;0;6
12866;Vandenis;AŠTUNKOJŲ;84025519453;Taip;0;1;0;1
12867;Vandenis;AŠTUNKOJŲ;5363853315;Taip;0;8;0;8
12868;Vandenis;AŠTUNKOJŲ;85054617489;Taip;6;4;0;10
12869;Vandenis;AŠTUNKOJŲ;61521559336;Taip;0;5;0;5
12870;Vandenis;AŠTUNKOJŲ;87310831307;Taip;0;5;0;5
12871;Vandenis;AŠTUNKOJŲ;63629799884;Taip;8;2;0;10
12872;Vandenis;AŠTUNKOJŲ;92286914041;Taip;0;5;0;5
12873;Vandenis;AŠTUNKOJŲ;8447593747;Taip;0;1;0;1
12874;Vandenis;AŠTUNKOJŲ;2120420294;Taip;0;8;0;8
12875;Vandenis;AŠTUNKOJŲ;1646554203;Taip;6;4;0;10
12876;Vandenis;GANDRIUKŲ;8367599264;Taip;7;4;1;12
12877;Vandenis;GANDRIUKŲ;94471245079;Taip;0;4;1;5
12878;Vandenis;GANDRIUKŲ;53737587501;Taip;0;7;0;7
12879;Vandenis;GANDRIUKŲ;67409458110;Taip;1;1;0;2
12880;Vandenis;GANDRIUKŲ;1945164524;Taip;5;4;0;9
12881;Vandenis;GANDRIUKŲ;38894447952;Ne;0;9;0;9
12882;Vandenis;GANDRIUKŲ;2117594123;Ne;0;11;0;11
12883;Vandenis;GANDRIUKŲ;1924693472;Taip;7;4;2;13
12884;Vandenis;GANDRIUKŲ;61110317694;Taip;3;4;1;8
12885;Vandenis;GANDRIUKŲ;5716325525;Taip;10;7;0;17
12886;Vandenis;GANDRIUKŲ;1650529956;Taip;0;4;1;5
12887;Vandenis;GANDRIUKŲ;2447879418;Taip;0;4;0;4
12888;Vandenis;GANDRIUKŲ;7591129504;Taip;4;4;0;8
12889;Vandenis;GANDRIUKŲ;8144064189;Taip;5;4;2;11
12890;Vandenis;GANDRIUKŲ;94273730058;Ne;7;6;0;13
12891;Vandenis;GANDRIUKŲ;44800276421;Taip;0;6;3;9
12892;Vandenis;GANDRIUKŲ;91774614891;Taip;6;2;0;8
12893;Vandenis;GANDRIUKŲ;1944730492;Taip;0;4;3;7
12894;Vandenis;ŽĄSIUKAI;80643665990;Taip;0;7;0;7
12895;Vandenis;ŽĄSIUKAI;74138671368;Taip;0;4;0;4
12896;Vandenis;ŽĄSIUKAI;25459674313;Taip;8;5;0;13
12897;Vandenis;ŽĄSIUKAI;2812520834;Taip;0;7;0;7
12898;Vandenis;ŽĄSIUKAI;1286716632;Taip;11;6;0;17
12899;Vandenis;ŽĄSIUKAI;11527007102;Taip;0;3;0;3
12900;Vandenis;ŽĄSIUKAI;1373653402;Taip;3;4;0;7
12901;Vandenis;ŽĄSIUKAI;65840410497;Ne;4;7;0;11
12902;Vandenis;ŽĄSIUKAI;53658866238;Taip;12;9;0;21
12903;Vandenis;ŽĄSIUKAI;1217508516;Taip;17;4;0;21
12904;Vandenis;ŽĄSIUKAI;55238344586;Taip;4;7;3;14
12905;Vandenis;ŽĄSIUKAI;25934798454;Taip;8;5;0;13
12906;Vandenis;ŽĄSIUKAI;2029167786;Taip;0;4;0;4
12907;Vandenis;ŽĄSIUKAI;23439586487;Taip;0;5;1;6
12908;Vandenis;ŽĄSIUKAI;78917527699;Taip;17;4;0;21
12909;Vandenis;ŽĄSIUKAI;1397125827;Taip;5;5;0;10
12910;Vandenis;ŽĄSIUKAI;46916815441;Taip;7;6;1;14
12911;Vandenis;ŽĄSIUKAI;1155423158;Taip;0;16;0;16
12912;Vandenis;ŽĄSIUKAI;7333587583;Taip;8;7;0;15
12913;Vandenis;ŽĄSIUKAI;18417531508;Taip;0;6;0;6
12914;Vandenis;ŽĄSIUKAI;7801129545;Taip;0;3;2;5
12915;Vandenis;ŽĄSIUKAI;5797629313;Taip;2;3;2;7
12916;Vandenis;PURIENŲ;2114436962;Taip;0;8;0;8
12917;Vandenis;PURIENŲ;877974909;Taip;0;5;0;5
12918;Vandenis;PURIENŲ;3823382249;Taip;6;4;0;10
12919;Vandenis;PURIENŲ;43295720034;Ne;7;5;0;12
12920;Vandenis;PURIENŲ;84636435681;Taip;7;1;0;8
12921;Vandenis;PURIENŲ;1958929302;Taip;0;3;0;3
12922;Vandenis;PURIENŲ;39973189502;Taip;0;0;1;1
12923;Vandenis;PURIENŲ;2096950367;Taip;5;5;0;10
12924;Vandenis;PURIENŲ;1633589144;Ne;7;4;0;11
12925;Vandenis;PURIENŲ;1854498462;Taip;0;6;0;6
12926;Vandenis;PURIENŲ;7467699979;Taip;0;0;1;1
12927;Vandenis;PURIENŲ;6673346389;Ne;7;2;0;9
12928;Vandenis;PURIENŲ;7168910452;Taip;4;1;0;5
12929;Vandenis;PURIENŲ;58997790744;Taip;7;0;0;7
12930;Vandenis;PURIENŲ;2073785910;Taip;0;6;0;6
12931;Vandenis;PURIENŲ;1245031666;Taip;0;5;0;5
12932;Vandenis;PURIENŲ;61120985165;Taip;9;2;0;11
12933;Vandenis;PURIENŲ;38137368394;Taip;4;0;0;4
12934;Vandenis;PURIENŲ;81817138188;Taip;0;5;0;5
12935;Vandenis;PURIENŲ;86947904365;Taip;9;0;0;9
12936;Vandenis;PURIENŲ;1395272045;Taip;5;4;0;9
12937;Vandenis;PURIENŲ;3740778932;Taip;12;0;0;12
12938;Vandenis;VARLIUKAI;2960005490;Taip;11;0;0;11
12939;Vandenis;VARLIUKAI;1180322026;Taip;11;0;0;11
12940;Vandenis;VARLIUKAI;7959438279;Taip;14;0;0;14
12941;Vandenis;VARLIUKAI;1788652447;Taip;14;0;0;14
12942;Vandenis;VARLIUKAI;5540306590;Taip;7;1;0;8
12943;Vandenis;VARLIUKAI;2719678617;Taip;1;2;0;3
12944;Vandenis;VARLIUKAI;7171302906;Taip;19;0;0;19
12945;Vandenis;VARLIUKAI;8085633453;Taip;19;0;0;19
12946;Vandenis;VARLIUKAI;5764809162;Taip;0;7;0;7
12947;Vandenis;VARLIUKAI;2614561762;Taip;0;4;0;4
12948;Vandenis;VARLIUKAI;1244502945;Taip;0;7;0;7
12949;Vandenis;VARLIUKAI;2315167746;Ne;12;1;0;13
12950;Vandenis;VARLIUKAI;6332179750;Taip;4;0;0;4
12951;Vandenis;VARLIUKAI;6027680514;Taip;16;0;0;16
12952;Vandenis;PINGVINAI;9994373029;Taip;4;1;0;5
12953;Vandenis;PINGVINAI;3544717790;Taip;0;4;0;4
12954;Vandenis;PINGVINAI;4085256182;Taip;8;1;2;11
12955;Vandenis;PINGVINAI;1568158992;Taip;0;0;1;1
12956;Vandenis;PINGVINAI;18336904438;Taip;5;5;0;10
12957;Vandenis;PINGVINAI;8689134931;Taip;7;4;0;11
12958;Vandenis;PINGVINAI;9608871155;Taip;8;0;0;8
12959;Vandenis;PINGVINAI;64711327503;Taip;3;8;0;11
12960;Vandenis;PINGVINAI;7381695975;Taip;0;6;1;7
12961;Vandenis;PINGVINAI;43933878402;Taip;5;0;0;5
12962;Vandenis;PINGVINAI;71513217054;Ne;0;5;0;5
12963;Vandenis;PINGVINAI;24217366528;Taip;12;4;0;16
12964;Vandenis;PINGVINAI;5549292096;Taip;8;2;0;10
12965;Vandenis;PINGVINAI;7408758565;Taip;5;1;0;6
12966;Vandenis;PINGVINAI;4643267945;Taip;14;4;0;18
12967;Vandenis;PINGVINAI;8430706407;Ne;15;0;0;15
12968;Vandenis;PINGVINAI;1535450614;Taip;6;0;5;11
12969;Vandenis;PINGVINAI;35673258175;Taip;12;0;2;14
12970;Vandenis;PINGVINAI;27409922803;Taip;12;0;0;12
12971;Vandenis;PINGVINAI;1598122777;Ne;10;0;3;13
12972;Vandenis;PINGVINAI;1815765498;Taip;9;0;3;12
12973;Vėjelis;Pumpurėliai;8159557298;Taip;0;0;1;1
12974;Vėjelis;Pumpurėliai;89672883586;Taip;4;4;1;9
12975;Vėjelis;Pumpurėliai;2647629246;Taip;21;0;0;21
12976;Vėjelis;Pumpurėliai;1712263816;Taip;0;12;0;12
12977;Vėjelis;Pumpurėliai;49983865253;Taip;5;0;4;9
12978;Vėjelis;Pumpurėliai;90185075321;Taip;14;0;0;14
12979;Vėjelis;Pumpurėliai;1640356242;Taip;8;8;0;16
12980;Vėjelis;Pumpurėliai;86128256406;Taip;18;0;0;18
12981;Vėjelis;Pumpurėliai;77205958956;Taip;10;5;0;15
12982;Vėjelis;Pumpurėliai;2718251356;Ne;6;0;0;6
12983;Vėjelis;Pumpurėliai;1988459596;Taip;0;0;1;1
12984;Vėjelis;Pumpurėliai;75596757609;Taip;7;0;2;9
12985;Vėjelis;Pumpurėliai;1934426525;Taip;16;1;0;17
12986;Vėjelis;Pumpurėliai;44153389025;Taip;10;4;0;14
12987;Vėjelis;Pumpurėliai;1921039937;Taip;0;2;0;2
12988;Vėjelis;Pumpurėliai;57285479257;Taip;0;4;0;4
12989;Vėjelis;Pumpurėliai;93219773975;Taip;0;0;4;4
12990;Vėjelis;Pumpurėliai;8198463045;Taip;0;3;0;3
12991;Vėjelis;Drugeliai;4746932126;Taip;16;2;0;18
12992;Vėjelis;Drugeliai;1978952781;Taip;3;0;0;3
12993;Vėjelis;Drugeliai;8353084814;Taip;6;4;0;10
12994;Vėjelis;Drugeliai;1115802837;Ne;21;0;0;21
12995;Vėjelis;Drugeliai;2416832899;Taip;2;1;0;3
12996;Vėjelis;Drugeliai;4741154518;Taip;2;0;0;2
12997;Vėjelis;Drugeliai;1494531065;Taip;2;0;1;3
12998;Vėjelis;Drugeliai;9298789434;Taip;11;2;0;13
12999;Vėjelis;Drugeliai;2734024890;Taip;2;13;0;15
13000;Vėjelis;Drugeliai;7981032872;Taip;10;4;0;14
13001;Vėjelis;Drugeliai;2000277444;Taip;0;5;1;6
13002;Vėjelis;Drugeliai;7752923796;Taip;4;0;3;7
13003;Vėjelis;Drugeliai;7594586198;Taip;2;14;1;17
13004;Vėjelis;Drugeliai;7697394469;Taip;8;9;0;17
13005;Vėjelis;Drugeliai;4066956765;Taip;9;0;1;10
13006;Vėjelis;Drugeliai;1571064934;Taip;7;0;0;7
13007;Vėjelis;Drugeliai;2788205363;Taip;14;0;0;14
13008;Vėjelis;Drugeliai;1331334220;Taip;13;0;4;17
13009;Vėjelis;Drugeliai;2151737048;Taip;8;9;0;17
13010;Vėjelis;Drugeliai;3276062426;Taip;14;0;1;15
13011;Vėjelis;Malūnėlis;74207410750;Taip;0;4;1;5
13012;Vėjelis;Malūnėlis;20148908290;Taip;0;3;0;3
13013;Vėjelis;Malūnėlis;90926729186;Taip;0;8;0;8
13014;Vėjelis;Malūnėlis;1209526192;Taip;0;4;0;4
13015;Vėjelis;Malūnėlis;68958036563;Taip;4;5;0;9
13016;Vėjelis;Malūnėlis;20593684676;Taip;9;4;0;13
13017;Vėjelis;Malūnėlis;14502736200;Taip;3;1;0;4
13018;Vėjelis;Malūnėlis;98024305748;Taip;0;7;0;7
13019;Vėjelis;Malūnėlis;5468993286;Taip;0;7;0;7
13020;Vėjelis;Malūnėlis;46167493039;Taip;0;1;0;1
13021;Vėjelis;Malūnėlis;1267672356;Taip;11;1;0;12
13022;Vėjelis;Malūnėlis;2021887954;Taip;1;5;0;6
13023;Vėjelis;Malūnėlis;1284286578;Ne;3;2;0;5
13024;Vėjelis;Malūnėlis;1789982154;Taip;9;11;0;20
13025;Vėjelis;Malūnėlis;54924516732;Taip;0;6;0;6
13026;Vėjelis;Malūnėlis;1242928700;Taip;0;11;0;11
13027;Vėjelis;Malūnėlis;9826410933;Taip;0;12;0;12
13028;Vėjelis;Malūnėlis;4110537888;Taip;5;5;0;10
13029;Vėjelis;Malūnėlis;44482585723;Taip;5;5;0;10
13030;Vėjelis;Žvaigždutės;98588113289;Taip;0;9;0;9
13031;Vėjelis;Žvaigždutės;1612878387;Taip;0;8;0;8
13032;Vėjelis;Žvaigždutės;3485366651;Taip;0;3;0;3
13033;Vėjelis;Žvaigždutės;5139323880;Taip;10;4;0;14
13034;Vėjelis;Žvaigždutės;2363974247;Taip;2;0;2;4
13035;Vėjelis;Žvaigždutės;8379298947;Taip;2;0;2;4
13036;Vėjelis;Žvaigždutės;8973530484;Ne;0;8;0;8
13037;Vėjelis;Žvaigždutės;69341469387;Taip;0;9;0;9
13038;Vėjelis;Žvaigždutės;9190085358;Taip;0;13;0;13
13039;Vėjelis;Žvaigždutės;8949760376;Taip;4;0;0;4
13040;Vėjelis;Žvaigždutės;6002719498;Taip;0;14;0;14
13041;Vėjelis;Žvaigždutės;9000966115;Ne;0;5;0;5
13042;Vėjelis;Žvaigždutės;4230144743;Taip;14;0;0;14
13043;Vėjelis;Žvaigždutės;78490601352;Taip;5;0;1;6
13044;Vėjelis;Žvaigždutės;3255066035;Taip;14;0;1;15
13045;Vėjelis;Žvaigždutės;76305473353;Taip;3;4;1;8
13046;Vėjelis;Žvaigždutės;73287916371;Taip;9;4;0;13
13047;Vėjelis;Žvaigždutės;41673970488;Taip;7;7;0;14
13048;Vėjelis;Žvaigždutės;5396347620;Taip;10;1;0;11
13049;Vėjelis;Žvaigždutės;50124109589;Ne;0;15;0;15
13050;Vėjelis;Varpeliai;28696711850;Taip;0;8;0;8
13051;Vėjelis;Varpeliai;8787363287;Taip;0;13;0;13
13052;Vėjelis;Varpeliai;83608030842;Ne;7;4;1;12
13053;Vėjelis;Varpeliai;71456994638;Taip;0;11;0;11
13054;Vėjelis;Varpeliai;86680640521;Taip;0;12;0;12
13055;Vėjelis;Varpeliai;1944266562;Taip;0;2;4;6
13056;Vėjelis;Varpeliai;80942260332;Taip;0;9;0;9
13057;Vėjelis;Varpeliai;8389094301;Taip;12;0;0;12
13058;Vėjelis;Varpeliai;6745229012;Taip;0;4;0;4
13059;Vėjelis;Varpeliai;9538710614;Ne;8;4;0;12
13060;Vėjelis;Varpeliai;90103717718;Taip;0;5;0;5
13061;Vėjelis;Varpeliai;90647333398;Taip;0;7;0;7
13062;Vėjelis;Varpeliai;40744700561;Taip;0;16;0;16
13063;Vėjelis;Varpeliai;47143492836;Taip;6;4;0;10
13064;Vėjelis;Varpeliai;1295818672;Ne;0;2;4;6
13065;Vėjelis;Varpeliai;1930159743;Taip;0;9;0;9
13066;Vėjelis;Varpeliai;1540879634;Ne;11;0;1;12
13067;Vėjelis;Varpeliai;56520156825;Taip;21;0;0;21
13068;Vėjelis;Varpeliai;47986392996;Taip;0;8;0;8
13069;Vėjelis;Pelėdžiukų;1238171728;Taip;0;0;3;3
13070;Vėjelis;Pelėdžiukų;4024898537;Taip;4;6;0;10
13071;Vėjelis;Pelėdžiukų;24011371444;Taip;21;0;0;21
13072;Vėjelis;Pelėdžiukų;2819491961;Taip;5;0;2;7
13073;Vėjelis;Pelėdžiukų;1783878104;Taip;16;1;0;17
13074;Vėjelis;Pelėdžiukų;55075988807;Taip;2;0;0;2
13075;Vėjelis;Pelėdžiukų;1510415602;Taip;21;0;0;21
13076;Vėjelis;Pelėdžiukų;2042863944;Taip;0;8;0;8
13077;Vėjelis;Pelėdžiukų;5992665537;Taip;0;10;0;10
13078;Vėjelis;Pelėdžiukų;1347855869;Taip;8;1;0;9
13079;Vėjelis;Pelėdžiukų;1990674632;Taip;8;1;2;11
13080;Vėjelis;Pelėdžiukų;6618114389;Taip;0;8;0;8
13081;Vėjelis;Pelėdžiukų;1467023330;Taip;0;4;0;4
13082;Vėjelis;Pelėdžiukų;1518855620;Ne;0;10;0;10
13083;Vėjelis;Pelėdžiukų;4930807661;Taip;0;4;2;6
13084;Vėjelis;Pelėdžiukų;2128818222;Ne;0;0;9;9
13085;Vėjelis;Pelėdžiukų;1603377234;Taip;4;5;0;9
13086;Vėjelis;Pelėdžiukų;5001661462;Ne;5;0;0;5
13087;Vėjelis;Pelėdžiukų;8304310182;Ne;16;1;1;18
13088;Vėjelis;Pelėdžiukų;6856583336;Ne;16;1;1;18
13089;Vėjelis;Skruzdeliukų;3910688753;Ne;9;0;1;10
13090;Vėjelis;Skruzdeliukų;2167025998;Taip;0;0;4;4
13091;Vėjelis;Skruzdeliukų;7400967836;Taip;7;4;0;11
13092;Vėjelis;Skruzdeliukų;8470977526;Taip;0;8;0;8
13093;Vėjelis;Skruzdeliukų;9434737088;Taip;5;0;0;5
13094;Vėjelis;Skruzdeliukų;1952141664;Taip;0;0;7;7
13095;Vėjelis;Skruzdeliukų;3264153232;Taip;8;5;0;13
13096;Vėjelis;Skruzdeliukų;12087873516;Taip;0;11;0;11
13097;Vėjelis;Skruzdeliukų;7610485310;Taip;10;8;0;18
13098;Vėjelis;Skruzdeliukų;2282796452;Taip;0;7;0;7
13099;Vėjelis;Skruzdeliukų;1551143643;Taip;7;0;4;11
13100;Vėjelis;Skruzdeliukų;7794899167;Taip;0;7;0;7
13101;Vėjelis;Skruzdeliukų;8941647789;Taip;12;0;0;12
13102;Vėjelis;Skruzdeliukų;41268510292;Taip;0;5;1;6
13103;Vėjelis;Skruzdeliukų;1534169381;Taip;8;2;0;10
13104;Vėjelis;Skruzdeliukų;4508775250;Taip;15;4;0;19
13105;Vėjelis;Skruzdeliukų;4992783345;Taip;0;13;0;13
13106;Vėjelis;Skruzdeliukų;2957105835;Taip;0;7;0;7
13107;Vėjelis;Pieštukų;4868574574;Taip;7;0;0;7
13108;Vėjelis;Pieštukų;4853650350;Taip;0;4;0;4
13109;Vėjelis;Pieštukų;60890519853;Taip;5;3;0;8
13110;Vėjelis;Pieštukų;8386409466;Ne;21;0;0;21
13111;Vėjelis;Pieštukų;9492690970;Ne;0;4;0;4
13112;Vėjelis;Pieštukų;6386092350;Taip;0;14;0;14
13113;Vėjelis;Pieštukų;8684461171;Taip;0;15;0;15
13114;Vėjelis;Pieštukų;9395929106;Ne;21;0;0;21
13115;Vėjelis;Pieštukų;1205392813;Ne;14;0;0;14
13116;Vėjelis;Pieštukų;5031781196;Taip;15;0;0;15
13117;Vėjelis;Pieštukų;8866974952;Taip;10;1;0;11
13118;Vėjelis;Pieštukų;2117924725;Taip;7;0;1;8
13119;Vėjelis;Pieštukų;1436893015;Ne;10;0;2;12
13120;Vėjelis;Pieštukų;1549518622;Taip;16;0;0;16
13121;Vėjelis;Pieštukų;6844704326;Taip;0;0;4;4
13122;Vėjelis;Pieštukų;8300497094;Taip;15;0;1;16
13123;Vėjelis;Pieštukų;4219672982;Taip;13;0;1;14
13124;Vėjelis;Pieštukų;7255617408;Taip;9;5;0;14
13125;Vėjelis;Pieštukų;4829314007;Ne;0;0;5;5
13126;Vėjelis;Pieštukų;2132551615;Ne;0;0;10;10
13127;Vėjelis;Ramunėlių;5987294293;Taip;2;5;0;7
13128;Vėjelis;Ramunėlių;8047799576;Taip;19;0;0;19
13129;Vėjelis;Ramunėlių;4745262277;Ne;2;4;0;6
13130;Vėjelis;Ramunėlių;4353239658;Ne;0;1;5;6
13131;Vėjelis;Ramunėlių;7178844364;Taip;17;1;0;18
13132;Vėjelis;Ramunėlių;2386927970;Taip;21;0;0;21
13133;Vėjelis;Ramunėlių;2124857941;Taip;16;0;0;16
13134;Vėjelis;Ramunėlių;6455798848;Taip;0;4;2;6
13135;Vėjelis;Ramunėlių;6996900411;Taip;12;3;0;15
13136;Vėjelis;Ramunėlių;2289954824;Taip;8;6;0;14
13137;Vėjelis;Ramunėlių;6777528441;Taip;7;5;0;12
13138;Vėjelis;Ramunėlių;6891260701;Taip;0;4;0;4
13139;Vėjelis;Ramunėlių;7836199284;Ne;21;0;0;21
13140;Vėjelis;Ramunėlių;4733227215;Taip;11;0;0;11
13141;Vėjelis;Ramunėlių;5909697341;Taip;3;8;0;11
13142;Vėjelis;Ramunėlių;6451722893;Taip;21;0;0;21
13143;Vėjelis;Ramunėlių;8721116918;Ne;13;0;0;13
13144;Vėjelis;Ramunėlių;3584347608;Taip;0;5;0;5
13145;Vėjelis;Ramunėlių;1381191703;Taip;0;6;5;11
13146;Vėjelis;Ramunėlių;9042329808;Taip;0;4;1;5
13147;Vėjelis;Nykštukai;6660799519;Taip;15;4;0;19
13148;Vėjelis;Nykštukai;2522750651;Taip;0;0;18;18
13149;Vėjelis;Nykštukai;1235788079;Ne;6;0;0;6
13150;Vėjelis;Nykštukai;2371667380;Taip;4;6;0;10
13151;Vėjelis;Nykštukai;4988352741;Taip;6;0;1;7
13152;Vėjelis;Nykštukai;9625857378;Taip;14;1;1;16
13153;Vėjelis;Nykštukai;8054114720;Taip;10;0;0;10
13154;Vėjelis;Nykštukai;2866394056;Taip;6;5;0;11
13155;Vėjelis;Nykštukai;3524350131;Taip;9;1;0;10
13156;Vėjelis;Nykštukai;5516672613;Taip;12;0;0;12
13157;Vėjelis;Nykštukai;6061966626;Taip;21;0;0;21
13158;Vėjelis;Nykštukai;6772736175;Taip;21;0;0;21
13159;Vėjelis;Nykštukai;2917197418;Taip;18;1;0;19
13160;Vėjelis;BITUTĖS;5902455219;Taip;9;4;0;13
13161;Vėjelis;BITUTĖS;48694326383;Taip;7;2;1;10
13162;Vėjelis;BITUTĖS;4831426440;Taip;11;4;0;15
13163;Vėjelis;BITUTĖS;74475070018;Taip;0;8;0;8
13164;Vėjelis;BITUTĖS;6724813553;Taip;8;4;0;12
13165;Vėjelis;BITUTĖS;5508269515;Ne;6;7;0;13
13166;Vėjelis;BITUTĖS;8998452731;Taip;7;0;0;7
13167;Vėjelis;BITUTĖS;9672929606;Ne;15;0;0;15
13168;Vėjelis;BITUTĖS;9754373141;Taip;6;0;1;7
13169;Vėjelis;BITUTĖS;4906958328;Taip;0;9;0;9
13170;Vėjelis;BITUTĖS;43342043904;Ne;0;5;5;10
13171;Vėjelis;BITUTĖS;89943712210;Taip;0;9;0;9
13172;Vėjelis;BITUTĖS;64628040227;Taip;0;12;0;12
13173;Vėjelis;BITUTĖS;22865699640;Taip;11;4;0;15
13174;Vėjelis;BITUTĖS;1008705526;Ne;0;1;3;4
13175;Vėjelis;BITUTĖS;1251348150;Taip;0;5;0;5
13176;Vėjelis;BITUTĖS;5207473829;Ne;17;0;0;17
13177;Vėjelis;BITUTĖS;8226906949;Taip;15;2;0;17
13178;Vėjelis;BITUTĖS;4938939921;Taip;0;16;0;16
13179;Vėjelis;BITUTĖS;20492762368;Taip;2;5;0;7
13180;Vėjelis;Boruželės;2199680661;Taip;6;0;0;6
13181;Vėjelis;Boruželės;5325081841;Taip;5;1;0;6
13182;Vėjelis;Boruželės;1863210064;Taip;0;7;0;7
13183;Vėjelis;Boruželės;9037622738;Taip;15;0;0;15
13184;Vėjelis;Boruželės;8553966497;Taip;0;13;0;13
13185;Vėjelis;Boruželės;1588345134;Taip;0;0;7;7
13186;Vėjelis;Boruželės;1751533938;Ne;6;4;0;10
13187;Vėjelis;Boruželės;1429496839;Taip;0;0;7;7
13188;Vėjelis;Boruželės;1931659200;Taip;14;1;0;15
13189;Vėjelis;Boruželės;1076538028;Ne;2;3;0;5
13190;Vėjelis;Boruželės;8666759391;Ne;0;8;0;8
13191;Vėjelis;Boruželės;3844131154;Taip;8;0;1;9
13192;Vėjelis;Boruželės;4747466651;Taip;6;3;0;9
13193;Vėjelis;Boruželės;3473416323;Taip;9;0;0;9
13194;Vėjelis;Boruželės;8141198449;Taip;15;0;2;17
13195;Vėjelis;Boruželės;8121537795;Ne;0;16;0;16
13196;Vėjelis;Boruželės;7133454882;Taip;0;3;6;9
13197;Vėjelis;Boruželės;5517128872;Ne;4;6;0;10
13198;Vėjelis;Boruželės;8938491367;Taip;10;2;0;12
13199;Vėtrungė;Debesėlių;2825732654;Ne;16;0;0;16
13200;Vėtrungė;Debesėlių;5251308945;Ne;22;0;0;22
13201;Vėtrungė;Debesėlių;5446546214;Taip;9;0;4;13
13202;Vėtrungė;Debesėlių;8956375453;Taip;9;0;0;9
13203;Vėtrungė;Debesėlių;4339450816;Taip;23;0;0;23
13204;Vėtrungė;Debesėlių;7863176604;Taip;0;10;0;10
13205;Vėtrungė;Debesėlių;3179715496;Taip;0;10;0;10
13206;Vėtrungė;Debesėlių;8441629302;Ne;19;1;0;20
13207;Vėtrungė;Debesėlių;6439014588;Taip;16;0;2;18
13208;Vėtrungė;Debesėlių;9423361592;Taip;7;17;0;24
13209;Vėtrungė;Debesėlių;4269488000;Taip;0;0;6;6
13210;Vėtrungė;Debesėlių;1191007983;Taip;8;4;0;12
13211;Vėtrungė;Debesėlių;3745680607;Taip;14;9;0;23
13212;Vėtrungė;Debesėlių;9359012317;Taip;9;4;0;13
13213;Vėtrungė;Debesėlių;3887230224;Taip;6;10;0;16
13214;Vėtrungė;Zuikių;8493950205;Taip;2;3;0;5
13215;Vėtrungė;Zuikių;7585075881;Taip;20;0;0;20
13216;Vėtrungė;Zuikių;9332362038;Taip;9;0;1;10
13217;Vėtrungė;Zuikių;9407558097;Taip;7;4;0;11
13218;Vėtrungė;Zuikių;2985829593;Taip;0;5;0;5
13219;Vėtrungė;Zuikių;4121886031;Ne;7;7;0;14
13220;Vėtrungė;Zuikių;7573021445;Taip;0;7;0;7
13221;Vėtrungė;Zuikių;9742099165;Taip;4;3;0;7
13222;Vėtrungė;Zuikių;1215953192;Taip;18;0;0;18
13223;Vėtrungė;Zuikių;5017020616;Ne;9;4;0;13
13224;Vėtrungė;Zuikių;3908259010;Ne;18;0;0;18
13225;Vėtrungė;Zuikių;8421138967;Taip;19;0;1;20
13226;Vėtrungė;Zuikių;1729819557;Taip;9;0;0;9
13227;Vėtrungė;Drugelių;5622109033;Taip;12;0;0;12
13228;Vėtrungė;Drugelių;7936785905;Taip;7;1;0;8
13229;Vėtrungė;Drugelių;5539872851;Taip;14;0;2;16
13230;Vėtrungė;Drugelių;6457369177;Taip;0;0;3;3
13231;Vėtrungė;Drugelių;8744050633;Taip;0;0;3;3
13232;Vėtrungė;Drugelių;9444188699;Ne;9;0;0;9
13233;Vėtrungė;Drugelių;1462620951;Taip;0;3;0;3
13234;Vėtrungė;Drugelių;7943682529;Taip;14;2;0;16
13235;Vėtrungė;Drugelių;7476984763;Taip;14;0;2;16
13236;Vėtrungė;Drugelių;9090873546;Taip;13;3;0;16
13237;Vėtrungė;Do-re-mi;6978977383;Taip;14;0;1;15
13238;Vėtrungė;Do-re-mi;6449124019;Taip;0;5;0;5
13239;Vėtrungė;Do-re-mi;3278452234;Ne;7;10;0;17
13240;Vėtrungė;Do-re-mi;9324733839;Taip;5;0;1;6
13241;Vėtrungė;Do-re-mi;2287044278;Taip;8;0;0;8
13242;Vėtrungė;Do-re-mi;2928868412;Taip;0;2;6;8
13243;Vėtrungė;Do-re-mi;2883254822;Taip;11;0;0;11
13244;Vėtrungė;Do-re-mi;9518734260;Taip;11;2;0;13
13245;Vėtrungė;Do-re-mi;7496582551;Taip;10;0;0;10
13246;Vėtrungė;Do-re-mi;5430818470;Taip;18;3;0;21
13247;Vėtrungė;Do-re-mi;7895027909;Taip;10;1;0;11
13248;Vėtrungė;Do-re-mi;8538678373;Taip;0;13;0;13
13249;Vėtrungė;Do-re-mi;7749675589;Taip;9;4;0;13
13250;Vėtrungė;Do-re-mi;7483624989;Taip;12;0;0;12
13251;Vėtrungė;Do-re-mi;7807708310;Taip;9;1;2;12
13252;Vėtrungė;Do-re-mi;3369970611;Taip;4;13;0;17
13253;Vėtrungė;Do-re-mi;1808699695;Taip;10;8;0;18
13254;Vėtrungė;Do-re-mi;5217297849;Ne;14;0;0;14
13255;Vėtrungė;Smalsučių;5338119067;Taip;0;8;0;8
13256;Vėtrungė;Smalsučių;18747550179;Taip;0;8;0;8
13257;Vėtrungė;Smalsučių;8948342560;Taip;0;5;0;5
13258;Vėtrungė;Smalsučių;31644585040;Ne;0;4;0;4
13259;Vėtrungė;Smalsučių;9844783953;Taip;3;11;0;14
13260;Vėtrungė;Smalsučių;65861118217;Taip;0;3;1;4
13261;Vėtrungė;Smalsučių;96980344422;Taip;2;5;0;7
13262;Vėtrungė;Smalsučių;30792456956;Ne;7;6;0;13
13263;Vėtrungė;Smalsučių;684188851;Taip;5;8;0;13
13264;Vėtrungė;Smalsučių;22961558196;Taip;0;8;0;8
13265;Vėtrungė;Smalsučių;1833285759;Taip;0;4;0;4
13266;Vėtrungė;Smalsučių;92977432447;Ne;0;10;0;10
13267;Vėtrungė;Smalsučių;4547247726;Taip;11;8;4;23
13268;Vėtrungė;Smalsučių;63472451321;Taip;3;7;3;13
13269;Vėtrungė;Smalsučių;92266460791;Taip;0;8;4;12
13270;Vėtrungė;Smalsučių;68262180072;Taip;0;8;0;8
13271;Vėtrungė;Smalsučių;1452467682;Taip;0;8;2;10
13272;Vėtrungė;Gudručių;1128961321;Taip;0;3;0;3
13273;Vėtrungė;Gudručių;45715910769;Taip;0;1;0;1
13274;Vėtrungė;Gudručių;99423172685;Ne;0;9;0;9
13275;Vėtrungė;Gudručių;98795465390;Taip;0;8;2;10
13276;Vėtrungė;Gudručių;40200404538;Ne;7;8;0;15
13277;Vėtrungė;Gudručių;42353807206;Taip;10;8;0;18
13278;Vėtrungė;Gudručių;1019550327;Taip;0;2;0;2
13279;Vėtrungė;Gudručių;76967115688;Ne;0;7;0;7
13280;Vėtrungė;Gudručių;1111688152;Taip;12;8;0;20
13281;Vėtrungė;Gudručių;1533796435;Taip;6;8;1;15
13282;Vėtrungė;Gudručių;1752676956;Taip;0;9;0;9
13283;Vėtrungė;Gudručių;72462689908;Taip;5;10;0;15
13284;Vėtrungė;Gudručių;26126038013;Taip;0;9;0;9
13285;Vėtrungė;Gudručių;58224525427;Taip;0;2;0;2
13286;Vėtrungė;Gudručių;88062307371;Taip;5;5;2;12
13287;Vėtrungė;Gudručių;96815788666;Taip;0;3;0;3
13288;Vėtrungė;Gudručių;68938242748;Taip;9;9;0;18
13289;Vėtrungė;Gudručių;76708504248;Taip;0;6;6;12
13290;Vėtrungė;Gudručių;6520234687;Ne;0;11;0;11
13291;Vėtrungė;Kodėlčių;1366458234;Taip;0;3;10;13
13292;Vėtrungė;Kodėlčių;1021458176;Taip;5;14;0;19
13293;Vėtrungė;Kodėlčių;1267104594;Taip;0;9;0;9
13294;Vėtrungė;Kodėlčių;1022530443;Taip;0;6;0;6
13295;Vėtrungė;Kodėlčių;1283685496;Taip;0;8;0;8
13296;Vėtrungė;Kodėlčių;20608668180;Taip;0;4;0;4
13297;Vėtrungė;Kodėlčių;49220186521;Taip;0;11;0;11
13298;Vėtrungė;Kodėlčių;41508942219;Taip;0;13;0;13
13299;Vėtrungė;Kodėlčių;1662123237;Taip;0;5;0;5
13300;Vėtrungė;Kodėlčių;1456877681;Taip;23;0;0;23
13301;Vėtrungė;Kodėlčių;1487142899;Taip;0;0;5;5
13302;Vėtrungė;Kodėlčių;56266349747;Taip;0;1;0;1
13303;Vėtrungė;Kodėlčių;9395706055;Taip;7;17;0;24
13304;Vėtrungė;Kodėlčių;4291687553;Taip;5;1;0;6
13305;Vėtrungė;Kodėlčių;18426639118;Taip;0;15;0;15
13306;Vėtrungė;Kodėlčių;1383686133;Taip;1;7;0;8
13307;Vėtrungė;Kodėlčių;6563805572;Taip;0;8;0;8
13308;Vėtrungė;Kodėlčių;1395153496;Taip;3;15;0;18
13309;Vėtrungė;Kodėlčių;8857763201;Taip;25;0;0;25
13310;Vėtrungė;Kodėlčių;8080668755;Taip;21;0;0;21
13311;Vėtrungė;Paukštelių;63512524250;Ne;10;2;6;18
13312;Vėtrungė;Paukštelių;1769926207;Taip;0;1;2;3
13313;Vėtrungė;Paukštelių;1322617786;Taip;24;0;0;24
13314;Vėtrungė;Paukštelių;7921863675;Taip;0;13;0;13
13315;Vėtrungė;Paukštelių;4091719904;Taip;0;4;0;4
13316;Vėtrungė;Paukštelių;4347810256;Taip;0;2;5;7
13317;Vėtrungė;Paukštelių;8915159672;Taip;11;10;0;21
13318;Vėtrungė;Paukštelių;2482436192;Taip;0;4;0;4
13319;Vėtrungė;Paukštelių;6732632515;Ne;15;0;0;15
13320;Vėtrungė;Paukštelių;8897558066;Ne;7;0;1;8
13321;Vėtrungė;Paukštelių;3404120492;Taip;12;0;0;12
13322;Vėtrungė;Paukštelių;8154023892;Ne;13;0;3;16
13323;Vėtrungė;Paukštelių;3721504364;Taip;0;8;6;14
13324;Vėtrungė;Paukštelių;4115995882;Taip;0;5;0;5
13325;Vėtrungė;Paukštelių;1357603285;Taip;1;8;0;9
13326;Vėtrungė;Paukštelių;5994465833;Taip;10;2;0;12
13327;Vėtrungė;Paukštelių;8721035192;Ne;13;7;0;20
13328;Vėtrungė;Paukštelių;1970034012;Ne;8;4;0;12
13329;Vėtrungė;Paukštelių;40392900667;Ne;22;2;0;24
13330;Vėtrungė;Viščiukų;3744377479;Taip;5;1;1;7
13331;Vėtrungė;Viščiukų;4916692634;Taip;0;9;0;9
13332;Vėtrungė;Viščiukų;2447851565;Taip;13;0;2;15
13333;Vėtrungė;Viščiukų;2136966687;Taip;9;10;1;20
13334;Vėtrungė;Viščiukų;4197321604;Taip;7;0;0;7
13335;Vėtrungė;Viščiukų;6416245099;Ne;9;2;0;11
13336;Vėtrungė;Viščiukų;8742161467;Taip;9;1;0;10
13337;Vėtrungė;Viščiukų;7558548846;Taip;10;8;0;18
13338;Vėtrungė;Viščiukų;1007578933;Taip;7;10;0;17
13339;Vėtrungė;Viščiukų;9893842192;Taip;14;3;0;17
13340;Vėtrungė;Viščiukų;3433811829;Taip;19;3;0;22
13341;Vėtrungė;Viščiukų;3634995652;Taip;13;0;0;13
13342;Vėtrungė;Viščiukų;5508759323;Taip;0;6;0;6
13343;Vėtrungė;Viščiukų;1255147376;Ne;0;14;0;14
13344;Vėtrungė;Viščiukų;5950287989;Taip;2;2;0;4
13345;Vėtrungė;Nykštukų;29699317546;Taip;0;0;6;6
13346;Vėtrungė;Nykštukų;1474010989;Ne;0;13;0;13
13347;Vėtrungė;Nykštukų;47141854213;Taip;6;15;0;21
13348;Vėtrungė;Nykštukų;1754493671;Ne;5;4;0;9
13349;Vėtrungė;Nykštukų;1843306606;Taip;0;11;0;11
13350;Vėtrungė;Nykštukų;5198153485;Taip;0;8;0;8
13351;Vėtrungė;Nykštukų;1630866223;Taip;0;4;6;10
13352;Vėtrungė;Nykštukų;1529226569;Taip;0;7;0;7
13353;Vėtrungė;Nykštukų;1690268842;Taip;8;0;0;8
13354;Vėtrungė;Nykštukų;1279678980;Taip;0;1;0;1
13355;Vėtrungė;Nykštukų;1370336984;Taip;11;2;0;13
13356;Vėtrungė;Nykštukų;78016704795;Taip;0;3;0;3
13357;Vėtrungė;Nykštukų;68628872682;Taip;0;0;1;1
13358;Vėtrungė;Nykštukų;54494917364;Taip;0;1;1;2
13359;Vėtrungė;Nykštukų;87686013986;Taip;0;4;1;5
13360;Vėtrungė;Nykštukų;70610257897;Taip;3;6;0;9
13361;Vėtrungė;Nykštukų;2715736596;Taip;2;4;0;6
13362;Vėtrungė;Nykštukų;1744400765;Ne;11;0;1;12
13363;Vėtrungė;Nykštukų;1360031121;Taip;0;8;0;8
13364;Vėtrungė;Nykštukų;2145081325;Taip;2;4;5;11
13365;Vėtrungė;Nykštukų;2529102855;Taip;3;4;2;9
13366;Vėtrungė;Nykštukų;1611274573;Taip;9;6;0;15
13367;Vėtrungė;Nykštukų;7792694801;Ne;7;0;0;7
13368;Vėtrungė;Nykštukų;9606769599;Ne;15;0;0;15
13369;Vėtrungė;Meškiukų;2510763357;Taip;13;0;4;17
13370;Vėtrungė;Meškiukų;4713420194;Taip;13;0;4;17
13371;Vėtrungė;Meškiukų;2226654309;Taip;16;0;0;16
13372;Vėtrungė;Meškiukų;9543456295;Taip;4;0;0;4
13373;Vėtrungė;Meškiukų;9207846866;Taip;14;0;1;15
13374;Vėtrungė;Meškiukų;9065848425;Taip;0;7;0;7
13375;Vėtrungė;Meškiukų;3328447991;Taip;6;0;0;6
13376;Vėtrungė;Meškiukų;9685389270;Ne;0;20;0;20
13377;Vėtrungė;Meškiukų;9313438768;Taip;11;0;0;11
13378;Vėtrungė;Meškiukų;9070732925;Taip;18;1;0;19
13379;Vėtrungė;Meškiukų;3122948974;Taip;0;3;0;3
13380;Vėtrungė;Meškiukų;2880342138;Taip;9;0;0;9
13381;Vėtrungė;Meškiukų;2520926439;Taip;8;2;0;10
13382;Vėtrungė;Meškiukų;7704497739;Taip;2;5;0;7
13383;Vėtrungė;Meškiukų;7143997258;Taip;14;0;0;14
13384;Vėtrungė;Meškiukų;5123894802;Taip;11;3;0;14
13385;Vėtrungė;Meškiukų;8961791293;Taip;7;8;0;15
13386;Vėtrungė;Meškiukų;2809555356;Taip;5;0;0;5
13387;Vėtrungė;Ąžuoliukų;7813907852;Taip;7;0;0;7
13388;Vėtrungė;Ąžuoliukų;2471926240;Taip;0;7;0;7
13389;Vėtrungė;Ąžuoliukų;3249689008;Taip;0;15;0;15
13390;Vėtrungė;Ąžuoliukų;7295216791;Taip;0;3;0;3
13391;Vėtrungė;Ąžuoliukų;2440001662;Taip;9;0;0;9
13392;Vėtrungė;Ąžuoliukų;1636432189;Taip;7;8;1;16
13393;Vėtrungė;Ąžuoliukų;7803736567;Taip;4;14;0;18
13394;Vėtrungė;Ąžuoliukų;1042333710;Ne;9;0;0;9
13395;Vėtrungė;Ąžuoliukų;7129180154;Taip;4;0;0;4
13396;Vėtrungė;Ąžuoliukų;16216365941;Taip;0;5;0;5
13397;Vėtrungė;Ąžuoliukų;6356914122;Ne;7;15;0;22
13398;Vėtrungė;Ąžuoliukų;2636219826;Taip;0;9;0;9
13399;Vėtrungė;Ąžuoliukų;1934540281;Ne;4;0;0;4
13400;Vėtrungė;Ąžuoliukų;6479094819;Taip;18;1;0;19
13401;Vėtrungė;Ąžuoliukų;5367369908;Taip;9;0;0;9
13402;Vėtrungė;Ąžuoliukų;4000379945;Taip;0;14;0;14
13403;Vėtrungė;Ąžuoliukų;1789419548;Ne;9;4;0;13
13404;Vėtrungė;Ąžuoliukų;7363490503;Taip;0;2;0;2
13405;Vėtrungė;Ąžuoliukų;1082104060;Taip;0;22;0;22
13406;Vilnelė;Lakštutė;9657350714;Taip;0;4;0;4
13407;Vilnelė;Lakštutė;1720695615;Taip;0;4;0;4
13408;Vilnelė;Lakštutė;1065422209;Taip;0;5;0;5
13409;Vilnelė;Lakštutė;1607330769;Taip;0;5;0;5
13410;Vilnelė;Lakštutė;66992481918;Taip;0;1;0;1
13411;Vilnelė;Lakštutė;85074719873;Taip;0;1;1;2
13412;Vilnelė;Lakštutė;3316451889;Taip;3;1;0;4
13413;Vilnelė;Lakštutė;8820091584;Taip;6;4;0;10
13414;Vilnelė;Lakštutė;8270866998;Taip;0;12;0;12
13415;Vilnelė;Lakštutė;2990112955;Taip;0;6;0;6
13416;Vilnelė;Lakštutė;8593060923;Taip;6;0;13;19
13417;Vilnelė;Lakštutė;3454141069;Taip;0;0;1;1
13418;Vilnelė;Lakštutė;9618342480;Taip;0;8;0;8
13419;Vilnelė;Lakštutė;9369955153;Taip;0;4;0;4
13420;Vilnelė;Lakštutė;6318246517;Taip;11;0;2;13
13421;Vilnelė;Lakštutė;7387394504;Taip;4;0;0;4
13422;Vilnelė;Vyturėlis;5091272908;Taip;4;2;2;8
13423;Vilnelė;Vyturėlis;1133945467;Taip;6;2;0;8
13424;Vilnelė;Vyturėlis;6132739519;Ne;0;5;0;5
13425;Vilnelė;Vyturėlis;3009064105;Taip;0;6;0;6
13426;Vilnelė;Vyturėlis;1674551092;Taip;0;7;0;7
13427;Vilnelė;Vyturėlis;3743740372;Taip;4;1;0;5
13428;Vilnelė;Vyturėlis;2131599015;Taip;0;11;0;11
13429;Vilnelė;Vyturėlis;9460789751;Ne;6;2;0;8
13430;Vilnelė;Vyturėlis;18740103706;Taip;5;6;0;11
13431;Vilnelė;Vyturėlis;7057183482;Taip;21;0;0;21
13432;Vilnelė;Vyturėlis;8725191514;Taip;4;2;2;8
13433;Vilnelė;Vyturėlis;6308015852;Taip;9;4;0;13
13434;Vilnelė;Vyturėlis;7963783957;Taip;16;0;0;16
13435;Vilnelė;Vyturėlis;1545570307;Taip;0;9;0;9
13436;Vilnelė;Vyturėlis;5540359276;Taip;9;2;0;11
13437;Vilnelė;Vyturėlis;1966090625;Taip;0;6;0;6
13438;Vilnelė;Vyturėlis;8740717061;Taip;3;6;0;9
13439;Vilnelė;Vyturėlis;3772263873;Taip;8;5;0;13
13440;Vilnelė;Vyturėlis;9183391434;Taip;0;8;0;8
13441;Vilnelė;Vyturėlis;2159103903;Taip;0;4;0;4
13442;Vilnelė;Pagrandukas;6707161045;Taip;0;7;0;7
13443;Vilnelė;Pagrandukas;59579013512;Taip;0;17;0;17
13444;Vilnelė;Pagrandukas;5480363267;Taip;0;2;1;3
13445;Vilnelė;Pagrandukas;2812680090;Taip;13;1;1;15
13446;Vilnelė;Pagrandukas;95852926101;Taip;7;4;0;11
13447;Vilnelė;Pagrandukas;1594154669;Ne;2;2;2;6
13448;Vilnelė;Pagrandukas;32662933313;Ne;4;1;0;5
13449;Vilnelė;Pagrandukas;1410511913;Taip;0;7;0;7
13450;Vilnelė;Pagrandukas;48926369907;Taip;0;1;3;4
13451;Vilnelė;Pagrandukas;13646307629;Taip;0;8;0;8
13452;Vilnelė;Pagrandukas;1680411448;Ne;0;5;0;5
13453;Vilnelė;Pagrandukas;1294194561;Taip;0;5;0;5
13454;Vilnelė;Pagrandukas;1111397062;Taip;2;0;4;6
13455;Vilnelė;Pagrandukas;54871985655;Taip;0;4;0;4
13456;Vilnelė;Pagrandukas;1230072125;Taip;0;1;2;3
13457;Vilnelė;Pagrandukas;1733279710;Taip;0;4;0;4
13458;Vilnelė;Pagrandukas;91933747502;Taip;13;4;0;17
13459;Vilnelė;Pagrandukas;1498777674;Taip;13;1;0;14
13460;Vilnelė;Pagrandukas;1932829642;Ne;4;0;0;4
13461;Vilnelė;Bitutė;41258849574;Ne;3;0;1;4
13462;Vilnelė;Bitutė;77967081365;Taip;5;3;0;8
13463;Vilnelė;Bitutė;9643543101;Taip;9;3;0;12
13464;Vilnelė;Bitutė;78753442031;Taip;0;8;0;8
13465;Vilnelė;Bitutė;31701260922;Taip;0;13;0;13
13466;Vilnelė;Bitutė;95736417954;Taip;0;4;0;4
13467;Vilnelė;Bitutė;10333554439;Taip;0;11;0;11
13468;Vilnelė;Bitutė;2864763106;Taip;0;6;1;7
13469;Vilnelė;Bitutė;60707257606;Taip;0;6;0;6
13470;Vilnelė;Bitutė;96611892032;Taip;4;4;0;8
13471;Vilnelė;Bitutė;79700582010;Taip;0;6;0;6
13472;Vilnelė;Bitutė;985960052;Taip;1;10;0;11
13473;Vilnelė;Bitutė;624138880;Taip;0;4;0;4
13474;Vilnelė;Bitutė;1051858780;Taip;8;0;3;11
13475;Vilnelė;Bitutė;2138907190;Taip;0;8;0;8
13476;Vilnelė;Bitutė;5936699300;Taip;5;5;0;10
13477;Vilnelė;Bitutė;77572611171;Taip;0;5;0;5
13478;Vilnelė;Bitutė;7442249956;Ne;7;0;0;7
13479;Vilnelė;Bitutė;1061139491;Taip;0;6;0;6
13480;Vilnelė;Šaltinėlis;1783854203;Taip;0;12;0;12
13481;Vilnelė;Šaltinėlis;5013418313;Taip;0;7;0;7
13482;Vilnelė;Šaltinėlis;42835212158;Taip;5;0;4;9
13483;Vilnelė;Šaltinėlis;98028664140;Taip;0;6;0;6
13484;Vilnelė;Šaltinėlis;11430703629;Taip;0;6;0;6
13485;Vilnelė;Šaltinėlis;7292043157;Taip;7;6;0;13
13486;Vilnelė;Šaltinėlis;6327531229;Taip;4;0;0;4
13487;Vilnelė;Šaltinėlis;10345875729;Taip;0;0;2;2
13488;Vilnelė;Šaltinėlis;1572818047;Taip;14;0;0;14
13489;Vilnelė;Šaltinėlis;2130482375;Taip;0;5;0;5
13490;Vilnelė;Šaltinėlis;4480175299;Taip;0;7;0;7
13491;Vilnelė;Šaltinėlis;9058632601;Taip;3;5;0;8
13492;Vilnelė;Šaltinėlis;1507865281;Taip;12;3;0;15
13493;Vilnelė;Šaltinėlis;39494954188;Taip;0;10;0;10
13494;Vilnelė;Šaltinėlis;8615257084;Taip;0;2;0;2
13495;Vilnelė;Šaltinėlis;6146514112;Taip;0;12;0;12
13496;Vilnelė;Šaltinėlis;9016832316;Taip;2;3;0;5
13497;Vilnelė;Šaltinėlis;1281521052;Taip;5;10;0;15
13498;Vilnelė;Šaltinėlis;5790420711;Taip;0;3;0;3
13499;Vilnelė;Riešutėllis;55974182996;Taip;0;3;0;3
13500;Vilnelė;Riešutėllis;67561845041;Taip;0;4;0;4
13501;Vilnelė;Riešutėllis;85568332595;Taip;8;4;0;12
13502;Vilnelė;Riešutėllis;22516605873;Taip;0;9;0;9
13503;Vilnelė;Riešutėllis;64066480740;Taip;3;4;0;7
13504;Vilnelė;Riešutėllis;16272480270;Ne;9;2;0;11
13505;Vilnelė;Riešutėllis;1859757115;Taip;0;15;0;15
13506;Vilnelė;Riešutėllis;1450994872;Taip;0;1;0;1
13507;Vilnelė;Riešutėllis;9331404812;Taip;0;6;0;6
13508;Vilnelė;Riešutėllis;11702051319;Taip;0;9;0;9
13509;Vilnelė;Riešutėllis;41536662155;Ne;11;1;0;12
13510;Vilnelė;Riešutėllis;69413564937;Taip;0;8;0;8
13511;Vilnelė;Riešutėllis;71906228270;Taip;0;1;7;8
13512;Vilnelė;Riešutėllis;7916632244;Taip;0;1;0;1
13513;Vilnelė;Riešutėllis;73658263243;Ne;10;4;0;14
13514;Vilnelė;Riešutėllis;8889469645;Taip;0;15;0;15
13515;Vilnelė;Riešutėllis;1522056886;Taip;0;3;0;3
13516;Vilnelė;Riešutėllis;1321202650;Ne;0;6;6;12
13517;Vilnelė;Riešutėllis;2696565855;Taip;0;10;0;10
13518;Vilnelė;Nykštukas;1336497125;Taip;3;4;1;8
13519;Vilnelė;Nykštukas;34859308729;Taip;0;1;0;1
13520;Vilnelė;Nykštukas;32988468324;Taip;0;8;0;8
13521;Vilnelė;Nykštukas;89748262997;Taip;4;3;0;7
13522;Vilnelė;Nykštukas;87406093438;Taip;4;3;0;7
13523;Vilnelė;Nykštukas;13583637193;Taip;3;11;0;14
13524;Vilnelė;Nykštukas;23442711820;Taip;0;2;0;2
13525;Vilnelė;Nykštukas;47863474499;Taip;0;3;0;3
13526;Vilnelė;Nykštukas;13231410969;Taip;4;1;0;5
13527;Vilnelė;Nykštukas;1845336128;Taip;0;4;0;4
13528;Vilnelė;Nykštukas;87094375121;Taip;0;7;0;7
13529;Vilnelė;Nykštukas;42526993637;Taip;1;1;0;2
13530;Vilnelė;Nykštukas;58422521907;Taip;0;4;0;4
13531;Vilnelė;Nykštukas;15265621906;Taip;0;7;0;7
13532;Vilnelė;Nykštukas;5198859945;Taip;0;10;0;10
13533;Vilnelė;Nykštukas;2131603460;Taip;5;8;0;13
13534;Vilnelė;Nykštukas;2097945353;Ne;0;5;0;5
13535;Vilnelė;Nykštukas;1957418704;Taip;0;10;0;10
13536;Vilnelė;Pieštukas;9879688569;Taip;5;6;0;11
13537;Vilnelė;Pieštukas;5473379559;Taip;4;7;0;11
13538;Vilnelė;Pieštukas;1462397783;Taip;12;0;0;12
13539;Vilnelė;Pieštukas;1792586468;Taip;8;3;0;11
13540;Vilnelė;Pieštukas;3781595939;Taip;0;7;0;7
13541;Vilnelė;Pieštukas;9884955712;Taip;4;0;0;4
13542;Vilnelė;Pieštukas;2479090686;Taip;2;10;0;12
13543;Vilnelė;Pieštukas;3945921490;Taip;9;10;0;19
13544;Vilnelė;Pieštukas;1975954784;Taip;7;0;0;7
13545;Vilnelė;Pieštukas;7199490431;Taip;11;0;0;11
13546;Vilnelė;Pieštukas;6798728562;Taip;6;5;0;11
13547;Vilnelė;Pieštukas;2859160609;Taip;8;0;0;8
13548;Vilnelė;Pieštukas;1730149127;Taip;12;3;0;15
13549;Vilnelė;Pieštukas;5778176840;Taip;8;0;0;8
13550;Vilnelė;Pieštukas;6355912551;Taip;2;5;0;7
13551;Vilnelė;Pieštukas;7976798775;Taip;0;9;0;9
13552;Vilnelė;Pieštukas;3811289758;Taip;21;0;0;21
13553;Vilnelė;Pieštukas;5261402753;Taip;9;9;0;18
13554;Vilnelė;Pieštukas;3529718234;Ne;21;0;0;21
13555;Vilnelė;Voverytė;4838684336;Ne;21;0;0;21
13556;Vilnelė;Voverytė;7536603663;Taip;0;12;0;12
13557;Vilnelė;Voverytė;3503461211;Ne;21;0;0;21
13558;Vilnelė;Voverytė;3993826389;Taip;11;0;0;11
13559;Vilnelė;Voverytė;7388336851;Taip;7;4;0;11
13560;Vilnelė;Voverytė;8667403338;Taip;0;8;0;8
13561;Vilnelė;Voverytė;7883724600;Taip;0;8;0;8
13562;Vilnelė;Voverytė;4166351390;Taip;14;0;0;14
13563;Vilnelė;Voverytė;1351798589;Taip;5;4;0;9
13564;Vilnelė;Voverytė;9162681538;Taip;0;1;0;1
13565;Vilnelė;Voverytė;3075681823;Taip;0;1;0;1
13566;Vilnelė;Voverytė;6342242777;Taip;0;5;0;5
13567;Vilnelė;Voverytė;3843064564;Taip;7;5;0;12
13568;Vilnelė;Voverytė;3558073399;Taip;10;0;0;10
13569;Vilnelė;Voverytė;2923012145;Taip;17;0;0;17
13570;Vilnelė;Voverytė;2841315531;Taip;6;0;3;9
13571;Vilnelė;Voverytė;9804772168;Taip;0;6;1;7
13572;Vilnelė;Voverytė;1596625263;Taip;2;7;2;11
13573;Vilnelė;Voverytė;7338573817;Taip;6;0;3;9
13574;Vilnelė;Voverytė;8121075430;Ne;0;5;0;5
13575;Vilnelė;Kodėlčiukas;85452254846;Taip;2;2;0;4
13576;Vilnelė;Kodėlčiukas;53049214510;Taip;6;4;0;10
13577;Vilnelė;Kodėlčiukas;6289991945;Taip;0;4;0;4
13578;Vilnelė;Kodėlčiukas;95055148560;Ne;0;1;0;1
13579;Vilnelė;Kodėlčiukas;81657018187;Taip;7;0;0;7
13580;Vilnelė;Kodėlčiukas;1448257490;Taip;6;0;0;6
13581;Vilnelė;Kodėlčiukas;69532393507;Taip;5;9;0;14
13582;Vilnelė;Kodėlčiukas;1160794222;Taip;0;6;0;6
13583;Vilnelė;Kodėlčiukas;64950604083;Taip;0;11;0;11
13584;Vilnelė;Kodėlčiukas;99580393765;Taip;0;13;0;13
13585;Vilnelė;Kodėlčiukas;36561742487;Taip;0;3;0;3
13586;Vilnelė;Kodėlčiukas;96900970284;Taip;16;0;0;16
13587;Vilnelė;Kodėlčiukas;85391221236;Taip;0;10;0;10
13588;Vilnelė;Kodėlčiukas;39412868538;Taip;6;10;0;16
13589;Vilnelė;Kodėlčiukas;67110179640;Ne;5;5;0;10
13590;Vilnelė;Kodėlčiukas;35546482171;Taip;0;6;0;6
13591;Vilnelė;Kodėlčiukas;90980722090;Taip;0;4;0;4
13592;Vilnelė;Kodėlčiukas;32819254615;Ne;0;4;0;4
13593;Vilnelė;Kodėlčiukas;91413844614;Taip;4;6;0;10
13594;Vilnelė;Kodėlčiukas;24746064267;Taip;6;4;0;10
13595;Vilnelė;Žirniukas;6026600803;Taip;8;9;0;17
13596;Vilnelė;Žirniukas;1580287517;Taip;0;10;0;10
13597;Vilnelė;Žirniukas;4328263940;Taip;11;0;0;11
13598;Vilnelė;Žirniukas;8620789304;Taip;17;0;0;17
13599;Vilnelė;Žirniukas;8439505238;Taip;12;5;0;17
13600;Vilnelė;Žirniukas;6448119003;Taip;0;7;0;7
13601;Vilnelė;Žirniukas;1027463000;Ne;15;1;0;16
13602;Vilnelė;Žirniukas;5953205533;Taip;14;7;0;21
13603;Vilnelė;Žirniukas;4448413194;Taip;9;2;5;16
13604;Vilnelė;Žirniukas;6830433856;Ne;20;0;0;20
13605;Vilnelė;Žirniukas;7020707723;Taip;6;5;0;11
13606;Vilnelė;Žirniukas;5306723959;Taip;6;0;0;6
13607;Vilnelė;Žirniukas;5558378376;Taip;8;10;0;18
13608;Vilnelė;Žirniukas;4664946923;Taip;12;0;0;12
13609;Vilnelė;Žirniukas;1960860528;Taip;12;0;2;14
13610;Vilnelė;Žirniukas;3312254613;Taip;9;10;0;19
13611;Vilnelė;Pipiras;6659537454;Taip;10;3;0;13
13612;Vilnelė;Pipiras;9640330864;Taip;11;0;0;11
13613;Vilnelė;Pipiras;5961910077;Taip;0;3;0;3
13614;Vilnelė;Pipiras;4295816753;Taip;4;6;0;10
13615;Vilnelė;Pipiras;3848720970;Taip;8;0;0;8
13616;Vilnelė;Pipiras;6686896190;Taip;10;0;0;10
13617;Vilnelė;Pipiras;9537740492;Taip;15;0;0;15
13618;Vilnelė;Pipiras;3670613082;Taip;11;2;0;13
13619;Vilnelė;Pipiras;3211657057;Taip;0;5;0;5
13620;Vilnelė;Pipiras;6417545510;Taip;20;0;0;20
13621;Vilnelė;Pipiras;7833531435;Taip;9;5;0;14
13622;Vilnelė;Pipiras;8717111488;Taip;11;2;0;13
13623;Vilnelė;Pipiras;5756690199;Taip;16;0;0;16
13624;Vilnelė;Pipiras;3056845279;Taip;14;6;0;20
13625;Vilnelė;Pipiras;7085972543;Taip;18;0;0;18
13626;Vilnelė;Pipiras;2144925171;Ne;13;0;0;13
13627;Vėrinėlis;GAIDELIAI;2529641529;Taip;0;16;0;16
13628;Vėrinėlis;GAIDELIAI;3729926575;Taip;0;16;0;16
13629;Vėrinėlis;GAIDELIAI;4390098560;Ne;20;0;0;20
13630;Vėrinėlis;GAIDELIAI;4666918175;Taip;8;0;2;10
13631;Vėrinėlis;GAIDELIAI;2774618380;Taip;7;0;0;7
13632;Vėrinėlis;GAIDELIAI;5429955166;Taip;0;6;0;6
13633;Vėrinėlis;GAIDELIAI;5209398043;Taip;0;6;0;6
13634;Vėrinėlis;GAIDELIAI;1060619471;Ne;12;0;2;14
13635;Vėrinėlis;GAIDELIAI;8885866108;Taip;12;0;0;12
13636;Vėrinėlis;GAIDELIAI;8213498951;Taip;0;4;0;4
13637;Vėrinėlis;GAIDELIAI;6136232912;Taip;9;3;0;12
13638;Vėrinėlis;GAIDELIAI;7092421890;Taip;5;0;0;5
13639;Vėrinėlis;GAIDELIAI;6058712578;Taip;12;0;0;12
13640;Vėrinėlis;GAIDELIAI;6496291933;Taip;3;0;0;3
13641;Vėrinėlis;GAIDELIAI;1164396960;Taip;10;0;0;10
13642;Vėrinėlis;GAIDELIAI;8091400240;Taip;10;3;1;14
13643;Vėrinėlis;GAIDELIAI;8728166391;Taip;2;0;0;2
13644;Vėrinėlis;GAIDELIAI;4415030161;Taip;0;13;0;13
13645;Vėrinėlis;GAIDELIAI;6413701823;Ne;19;0;0;19
13646;Vėrinėlis;GAIDELIAI;8100283579;Taip;0;3;0;3
13647;Vėrinėlis;SAULUTĖ;8755941866;Taip;16;0;2;18
13648;Vėrinėlis;SAULUTĖ;5434506594;Taip;0;3;0;3
13649;Vėrinėlis;SAULUTĖ;9751494612;Taip;0;8;1;9
13650;Vėrinėlis;SAULUTĖ;1897451825;Ne;0;6;0;6
13651;Vėrinėlis;SAULUTĖ;4727265555;Taip;7;11;0;18
13652;Vėrinėlis;SAULUTĖ;1047139776;Taip;2;11;0;13
13653;Vėrinėlis;SAULUTĖ;1493604303;Taip;12;6;0;18
13654;Vėrinėlis;SAULUTĖ;9500715949;Taip;0;5;0;5
13655;Vėrinėlis;SAULUTĖ;8922728881;Taip;5;0;1;6
13656;Vėrinėlis;SAULUTĖ;84391578139;Taip;0;0;4;4
13657;Vėrinėlis;SAULUTĖ;9391697537;Taip;0;4;0;4
13658;Vėrinėlis;SAULUTĖ;7071043164;Taip;5;9;0;14
13659;Vėrinėlis;SAULUTĖ;8620836106;Taip;17;0;0;17
13660;Vėrinėlis;SAULUTĖ;5003344894;Ne;11;0;2;13
13661;Vėrinėlis;SAULUTĖ;6866592245;Ne;7;0;2;9
13662;Vėrinėlis;SAULUTĖ;4183077476;Taip;6;11;0;17
13663;Vėrinėlis;SAULUTĖ;6906865967;Taip;0;12;0;12
13664;Vėrinėlis;SAULUTĖ;4925983616;Taip;0;0;5;5
13665;Vėrinėlis;SAULUTĖ;2732572235;Taip;0;4;1;5
13666;Vėrinėlis;SAULUTĖ;2633143128;Taip;10;0;2;12
13667;Vėrinėlis;NYKŠTUKAI;1518907235;Taip;8;0;3;11
13668;Vėrinėlis;NYKŠTUKAI;6065348004;Taip;0;7;0;7
13669;Vėrinėlis;NYKŠTUKAI;3563944204;Taip;10;0;1;11
13670;Vėrinėlis;NYKŠTUKAI;7436873997;Ne;0;15;0;15
13671;Vėrinėlis;NYKŠTUKAI;63333257753;Taip;0;4;1;5
13672;Vėrinėlis;NYKŠTUKAI;1592544116;Taip;10;0;1;11
13673;Vėrinėlis;NYKŠTUKAI;1261337457;Taip;5;0;6;11
13674;Vėrinėlis;NYKŠTUKAI;11459693163;Ne;3;0;4;7
13675;Vėrinėlis;NYKŠTUKAI;47333446450;Taip;0;0;1;1
13676;Vėrinėlis;NYKŠTUKAI;38428514086;Ne;21;0;0;21
13677;Vėrinėlis;NYKŠTUKAI;27431479888;Taip;4;0;0;4
13678;Vėrinėlis;NYKŠTUKAI;4229867189;Taip;0;0;2;2
13679;Vėrinėlis;NYKŠTUKAI;41029899086;Ne;4;4;2;10
13680;Vėrinėlis;NYKŠTUKAI;2001903188;Ne;7;0;1;8
13681;Vėrinėlis;NYKŠTUKAI;1251822610;Ne;4;7;0;11
13682;Vėrinėlis;NYKŠTUKAI;8755231814;Taip;8;0;1;9
13683;Vėrinėlis;NYKŠTUKAI;9604483237;Taip;10;0;3;13
13684;Vėrinėlis;NYKŠTUKAI;9719933940;Ne;7;0;2;9
13685;Vėrinėlis;BURATINAS;65408541019;Ne;6;10;0;16
13686;Vėrinėlis;BURATINAS;3703886468;Ne;2;2;0;4
13687;Vėrinėlis;BURATINAS;57498275265;Ne;0;9;0;9
13688;Vėrinėlis;BURATINAS;54666417396;Taip;0;9;0;9
13689;Vėrinėlis;BURATINAS;4067153819;Taip;0;0;8;8
13690;Vėrinėlis;BURATINAS;1103951120;Ne;0;4;3;7
13691;Vėrinėlis;BURATINAS;1170817811;Taip;5;1;0;6
13692;Vėrinėlis;BURATINAS;73256255966;Taip;10;0;1;11
13693;Vėrinėlis;BURATINAS;22726982138;Taip;7;4;0;11
13694;Vėrinėlis;BURATINAS;30611731645;Taip;2;0;0;2
13695;Vėrinėlis;BURATINAS;89785057363;Taip;0;21;0;21
13696;Vėrinėlis;BURATINAS;25071096491;Taip;0;8;0;8
13697;Vėrinėlis;BURATINAS;90264493281;Ne;1;5;0;6
13698;Vėrinėlis;BURATINAS;90979069296;Ne;17;0;0;17
13699;Vėrinėlis;BURATINAS;1028568095;Taip;0;7;0;7
13700;Vėrinėlis;BURATINAS;7431541945;Ne;3;5;0;8
13701;Vėrinėlis;BURATINAS;67987598880;Taip;5;9;0;14
13702;Vėrinėlis;BURATINAS;9266953028;Taip;8;7;0;15
13703;Vėrinėlis;BURATINAS;4789626884;Taip;0;4;3;7
13704;Vėrinėlis;GINTARĖLIAI;79005449877;Taip;0;4;0;4
13705;Vėrinėlis;GINTARĖLIAI;3183131197;Taip;0;7;0;7
13706;Vėrinėlis;GINTARĖLIAI;2023475725;Taip;0;5;0;5
13707;Vėrinėlis;GINTARĖLIAI;1028694005;Taip;0;4;2;6
13708;Vėrinėlis;GINTARĖLIAI;1465052758;Taip;21;0;0;21
13709;Vėrinėlis;GINTARĖLIAI;97559214584;Taip;0;0;1;1
13710;Vėrinėlis;GINTARĖLIAI;7819933209;Taip;0;1;0;1
13711;Vėrinėlis;GINTARĖLIAI;762270610;Taip;0;4;0;4
13712;Vėrinėlis;GINTARĖLIAI;78121632796;Taip;0;5;0;5
13713;Vėrinėlis;GINTARĖLIAI;99325931907;Taip;8;5;0;13
13714;Vėrinėlis;GINTARĖLIAI;5238619411;Taip;0;1;0;1
13715;Vėrinėlis;GINTARĖLIAI;668239862;Taip;0;5;0;5
13716;Vėrinėlis;GINTARĖLIAI;8197177876;Taip;10;6;0;16
13717;Vėrinėlis;GINTARĖLIAI;22535431362;Taip;0;5;0;5
13718;Vėrinėlis;GINTARĖLIAI;1804757495;Taip;5;0;3;8
13719;Vėrinėlis;GINTARĖLIAI;1029210296;Taip;0;1;0;1
13720;Vėrinėlis;GINTARĖLIAI;1791124205;Taip;0;2;0;2
13721;Vėrinėlis;GINTARĖLIAI;92480758419;Ne;0;5;0;5
13722;Vėrinėlis;GINTARĖLIAI;7168682238;Taip;0;3;0;3
13723;Vėrinėlis;GINTARĖLIAI;8955109359;Ne;0;5;0;5
13724;Vėrinėlis;RAMUNĖLĖS;6738189242;Taip;4;4;1;9
13725;Vėrinėlis;RAMUNĖLĖS;1292880457;Ne;3;0;3;6
13726;Vėrinėlis;RAMUNĖLĖS;1398564881;Taip;9;0;0;9
13727;Vėrinėlis;RAMUNĖLĖS;68073702260;Taip;5;0;1;6
13728;Vėrinėlis;RAMUNĖLĖS;1133491927;Taip;10;4;0;14
13729;Vėrinėlis;RAMUNĖLĖS;1268710930;Taip;14;2;0;16
13730;Vėrinėlis;RAMUNĖLĖS;1477336890;Taip;9;6;0;15
13731;Vėrinėlis;RAMUNĖLĖS;25415760747;Taip;5;2;0;7
13732;Vėrinėlis;RAMUNĖLĖS;6004379115;Taip;0;2;0;2
13733;Vėrinėlis;RAMUNĖLĖS;1803838403;Taip;15;2;0;17
13734;Vėrinėlis;RAMUNĖLĖS;71830611159;Taip;7;0;0;7
13735;Vėrinėlis;RAMUNĖLĖS;39153716711;Taip;7;3;0;10
13736;Vėrinėlis;RAMUNĖLĖS;11343969028;Taip;11;3;0;14
13737;Vėrinėlis;RAMUNĖLĖS;1086306523;Ne;8;0;3;11
13738;Vėrinėlis;RAMUNĖLĖS;1408704528;Taip;6;0;0;6
13739;Vėrinėlis;RAMUNĖLĖS;1239744245;Taip;6;0;0;6
13740;Vėrinėlis;RAMUNĖLĖS;6148700823;Taip;11;1;0;12
13741;Vėrinėlis;RAMUNĖLĖS;4680688747;Ne;21;0;0;21
13742;Vėrinėlis;KODELČIUKŲ;95040879760;Ne;0;0;1;1
13743;Vėrinėlis;KODELČIUKŲ;1410929889;Taip;7;7;0;14
13744;Vėrinėlis;KODELČIUKŲ;1001125426;Taip;17;2;0;19
13745;Vėrinėlis;KODELČIUKŲ;42875958735;Ne;0;6;0;6
13746;Vėrinėlis;KODELČIUKŲ;25734061057;Taip;0;2;1;3
13747;Vėrinėlis;KODELČIUKŲ;68027880109;Taip;14;0;0;14
13748;Vėrinėlis;KODELČIUKŲ;2676104110;Taip;3;0;0;3
13749;Vėrinėlis;KODELČIUKŲ;1876456237;Taip;0;2;0;2
13750;Vėrinėlis;KODELČIUKŲ;12363691267;Taip;0;4;0;4
13751;Vėrinėlis;KODELČIUKŲ;3044373634;Taip;0;1;1;2
13752;Vėrinėlis;KODELČIUKŲ;24888549934;Taip;0;3;0;3
13753;Vėrinėlis;KODELČIUKŲ;38831165210;Taip;6;10;0;16
13754;Vėrinėlis;KODELČIUKŲ;37600982027;Ne;0;2;0;2
13755;Vėrinėlis;KODELČIUKŲ;79317384797;Taip;0;5;0;5
13756;Vėrinėlis;KODELČIUKŲ;1953362884;Taip;5;0;0;5
13757;Vėrinėlis;KODELČIUKŲ;58909000723;Taip;5;10;0;15
13758;Vėrinėlis;KODELČIUKŲ;1907101316;Taip;5;10;0;15
13759;Vėrinėlis;KODELČIUKŲ;8978798314;Taip;7;4;2;13
13760;Vėrinėlis;ŽIRNIUKAI;3074835599;Ne;7;0;11;18
13761;Vėrinėlis;ŽIRNIUKAI;1769852084;Taip;14;0;0;14
13762;Vėrinėlis;ŽIRNIUKAI;4718732261;Taip;0;2;0;2
13763;Vėrinėlis;ŽIRNIUKAI;9798993200;Taip;5;4;1;10
13764;Vėrinėlis;ŽIRNIUKAI;4981127515;Taip;4;0;0;4
13765;Vėrinėlis;ŽIRNIUKAI;7845985650;Ne;12;0;5;17
13766;Vėrinėlis;ŽIRNIUKAI;2815770695;Taip;5;0;3;8
13767;Vėrinėlis;ŽIRNIUKAI;9419245081;Taip;10;5;0;15
13768;Vėrinėlis;ŽIRNIUKAI;8329989952;Taip;16;0;0;16
13769;Vėrinėlis;ŽIRNIUKAI;3202518504;Taip;0;5;3;8
13770;Vėrinėlis;ŽIRNIUKAI;8824435889;Taip;6;0;2;8
13771;Vėrinėlis;ŽIRNIUKAI;4752902173;Taip;0;5;1;6
13772;Vėrinėlis;ŽIRNIUKAI;7237945125;Taip;0;0;3;3
13773;Vėrinėlis;ŽIRNIUKAI;5600815908;Taip;9;0;0;9
13774;Vėrinėlis;ŽIRNIUKAI;6779005350;Ne;0;0;1;1
13775;Vėrinėlis;ŽIRNIUKAI;7367485961;Ne;0;3;0;3
13776;Vėrinėlis;ŽIRNIUKAI;6576726481;Taip;7;0;1;8
13777;Vėrinėlis;ŽIRNIUKAI;8397025332;Taip;7;0;1;8
13778;Vėrinėlis;ŽIRNIUKAI;9340167973;Taip;0;0;11;11
13779;Vėrinėlis;ŽIRNIUKAI;1736733257;Ne;11;0;0;11
13780;Vėrinėlis;ŽIRNIUKAI;2687583764;Taip;6;0;4;10
13781;Vėrinėlis;VARPELIAI;3316897176;Taip;6;0;10;16
13782;Vėrinėlis;VARPELIAI;9009344779;Taip;5;7;0;12
13783;Vėrinėlis;VARPELIAI;7471147288;Taip;7;0;0;7
13784;Vėrinėlis;VARPELIAI;3810261864;Taip;8;0;1;9
13785;Vėrinėlis;VARPELIAI;9289003583;Taip;0;6;0;6
13786;Vėrinėlis;VARPELIAI;1684203955;Taip;0;6;0;6
13787;Vėrinėlis;VARPELIAI;3882915774;Taip;3;6;0;9
13788;Vėrinėlis;VARPELIAI;7273090217;Taip;7;0;0;7
13789;Vėrinėlis;VARPELIAI;7233139048;Taip;15;0;0;15
13790;Vėrinėlis;VARPELIAI;3130841241;Taip;12;0;0;12
13791;Vėrinėlis;VARPELIAI;6435612222;Taip;0;0;4;4
13792;Vėrinėlis;VARPELIAI;2337883071;Taip;20;0;0;20
13793;Vėrinėlis;VARPELIAI;6913001318;Ne;9;8;0;17
13794;Vėrinėlis;VARPELIAI;4728119881;Taip;11;0;1;12
13795;Vėrinėlis;VARPELIAI;7224418233;Taip;0;21;0;21
13796;Vėrinėlis;VARPELIAI;1894717954;Taip;11;0;0;11
13797;Vėrinėlis;VARPELIAI;3667953591;Taip;14;0;0;14
13798;Vėrinėlis;VARPELIAI;4191386053;Taip;0;12;0;12
13799;Vėrinėlis;VARPELIAI;2090334618;Taip;19;0;0;19
13800;Vėrinėlis;BORUŽĖLĖS;8759487574;Taip;7;6;0;13
13801;Vėrinėlis;BORUŽĖLĖS;4819016753;Ne;5;0;0;5
13802;Vėrinėlis;BORUŽĖLĖS;1910385020;Taip;5;0;1;6
13803;Vėrinėlis;BORUŽĖLĖS;2078857084;Taip;0;0;3;3
13804;Vėrinėlis;BORUŽĖLĖS;3934652683;Taip;13;0;2;15
13805;Vėrinėlis;BORUŽĖLĖS;6904733283;Taip;14;0;0;14
13806;Vėrinėlis;BORUŽĖLĖS;4446546335;Taip;6;5;1;12
13807;Vėrinėlis;BORUŽĖLĖS;3718510933;Taip;4;0;3;7
13808;Vėrinėlis;BORUŽĖLĖS;2501287529;Taip;0;8;0;8
13809;Vėrinėlis;BORUŽĖLĖS;8904833339;Taip;13;2;0;15
13810;Vėrinėlis;BORUŽĖLĖS;3312501759;Taip;13;2;0;15
13811;Vėrinėlis;BORUŽĖLĖS;9217188911;Taip;14;7;0;21
13812;Vėrinėlis;BORUŽĖLĖS;7414937335;Taip;17;4;0;21
13813;Vėrinėlis;BORUŽĖLĖS;2574507205;Taip;14;3;0;17
13814;Vėrinėlis;BORUŽĖLĖS;6671382987;Taip;5;0;4;9
13815;Vėrinėlis;SVEIKUOLIAI;87606501349;Taip;0;4;1;5
13816;Vėrinėlis;SVEIKUOLIAI;19865450007;Taip;4;0;7;11
13817;Vėrinėlis;SVEIKUOLIAI;6869951613;Taip;0;4;2;6
13818;Vėrinėlis;SVEIKUOLIAI;1395590011;Ne;4;8;0;12
13819;Vėrinėlis;SVEIKUOLIAI;3975934329;Taip;0;4;4;8
13820;Vėrinėlis;SVEIKUOLIAI;9751037428;Ne;0;9;0;9
13821;Vėrinėlis;SVEIKUOLIAI;1513856520;Taip;4;0;1;5
13822;Vėrinėlis;SVEIKUOLIAI;3562371502;Taip;9;0;0;9
13823;Vėrinėlis;SVEIKUOLIAI;4089567420;Ne;7;0;3;10
13824;Vėrinėlis;SVEIKUOLIAI;5960946826;Taip;0;5;0;5
13825;Vėrinėlis;SVEIKUOLIAI;5496928903;Ne;14;0;1;15
13826;Vėrinėlis;SVEIKUOLIAI;7865276052;Taip;0;0;5;5
13827;Vėrinėlis;SVEIKUOLIAI;7981261038;Taip;4;2;0;6
13828;Vėrinėlis;SVEIKUOLIAI;6278738058;Taip;0;0;2;2
13829;Vėrinėlis;SVEIKUOLIAI;5511584499;Taip;7;9;0;16
13830;Vėrinėlis;SVEIKUOLIAI;6644892686;Taip;4;0;0;4
13831;Vėrinėlis;SVEIKUOLIAI;4958359640;Taip;12;0;0;12
13832;Vėrinėlis;SVEIKUOLIAI;1338287524;Taip;8;2;0;10
13833;Vėrinėlis;SVEIKUOLIAI;8579819581;Taip;15;4;0;19
13834;Vėrinėlis;SVEIKUOLIAI;6220653152;Taip;3;7;0;10
13835;Vėrinėlis;ŠIRDELĖS;2944010445;Taip;0;15;0;15
13836;Vėrinėlis;ŠIRDELĖS;8195455092;Taip;0;0;2;2
13837;Vėrinėlis;ŠIRDELĖS;96779456411;Taip;0;5;0;5
13838;Vėrinėlis;ŠIRDELĖS;7167034587;Taip;0;4;0;4
13839;Vėrinėlis;ŠIRDELĖS;5712568063;Ne;0;0;2;2
13840;Vėrinėlis;ŠIRDELĖS;3049346950;Taip;16;0;0;16
13841;Vėrinėlis;ŠIRDELĖS;7070058961;Taip;7;2;0;9
13842;Vėrinėlis;ŠIRDELĖS;7130691686;Taip;0;0;14;14
13843;Vėrinėlis;ŠIRDELĖS;8709714647;Taip;0;0;14;14
13844;Vėrinėlis;ŠIRDELĖS;3308843618;Taip;0;6;0;6
13845;Vėrinėlis;ŠIRDELĖS;85262495209;Ne;6;8;0;14
13846;Vėrinėlis;ŠIRDELĖS;4039903678;Taip;9;0;0;9
13847;Vėrinėlis;ŠIRDELĖS;9119967823;Taip;0;2;3;5
13848;Vėrinėlis;ŠIRDELĖS;1467899937;Taip;0;0;4;4
13849;Vėrinėlis;ŠIRDELĖS;7634939364;Taip;0;1;0;1
13850;Vėrinėlis;ŠIRDELĖS;42298331453;Taip;0;3;0;3
13851;Vėrinėlis;ŠIRDELĖS;54361215161;Taip;0;0;2;2
13852;Vėrinėlis;ŠIRDELĖS;1535567719;Taip;7;8;0;15
13853;Vėrinėlis;ŠIRDELĖS;8652292752;Taip;0;12;0;12
13854;Vėrinėlis;ŠIRDELĖS;2231062782;Taip;0;2;0;2
13855;Viltenė;Drugeliai;79464006792;Taip;0;10;0;10
13856;Viltenė;Drugeliai;70813966825;Taip;0;8;0;8
13857;Viltenė;Drugeliai;1936464823;Taip;0;11;0;11
13858;Viltenė;Drugeliai;50489733849;Ne;0;2;0;2
13859;Viltenė;Drugeliai;69838945768;Ne;8;3;0;11
13860;Viltenė;Drugeliai;54422258148;Taip;0;11;0;11
13861;Viltenė;Drugeliai;4322306031;Taip;0;8;0;8
13862;Viltenė;Drugeliai;39676814294;Ne;0;8;0;8
13863;Viltenė;Drugeliai;47885567334;Taip;0;6;0;6
13864;Viltenė;Drugeliai;45275376273;Taip;0;6;0;6
13865;Viltenė;Drugeliai;1155378470;Taip;0;4;0;4
13866;Viltenė;Drugeliai;68110722913;Taip;9;1;0;10
13867;Viltenė;Drugeliai;21489308130;Taip;0;2;0;2
13868;Viltenė;Drugeliai;16461652415;Taip;0;17;0;17
13869;Viltenė;Drugeliai;91847807834;Taip;8;9;0;17
13870;Viltenė;Drugeliai;34691221253;Ne;6;6;0;12
13871;Viltenė;Drugeliai;75637599543;Taip;0;3;0;3
13872;Viltenė;Drugeliai;33159619580;Taip;5;5;0;10
13873;Viltenė;Drugeliai;4586042895;Taip;2;5;0;7
13874;Viltenė;Drugeliai;1739353382;Taip;0;4;0;4
13875;Viltenė;Bitučių;21665885641;Taip;0;1;0;1
13876;Viltenė;Bitučių;1747442313;Ne;0;6;0;6
13877;Viltenė;Bitučių;61093082990;Ne;0;5;0;5
13878;Viltenė;Bitučių;13157765051;Taip;2;3;0;5
13879;Viltenė;Bitučių;46245753187;Taip;5;4;0;9
13880;Viltenė;Bitučių;2046122804;Taip;0;4;0;4
13881;Viltenė;Bitučių;74464437862;Taip;0;7;0;7
13882;Viltenė;Bitučių;86055366818;Taip;6;3;0;9
13883;Viltenė;Bitučių;66587678111;Taip;2;5;0;7
13884;Viltenė;Bitučių;65252989761;Taip;7;6;0;13
13885;Viltenė;Bitučių;84451732377;Taip;0;10;0;10
13886;Viltenė;Bitučių;1702925444;Taip;0;7;0;7
13887;Viltenė;Bitučių;1165480440;Taip;6;0;0;6
13888;Viltenė;Bitučių;6006470515;Taip;0;4;0;4
13889;Viltenė;Bitučių;1798739406;Taip;0;3;0;3
13890;Viltenė;Bitučių;1656026241;Taip;0;4;0;4
13891;Viltenė;Bitučių;1291605426;Taip;7;9;0;16
13892;Viltenė;Bitučių;6322746293;Taip;0;11;0;11
13893;Viltenė;Bitučių;4334881910;Taip;0;16;0;16
13894;Viltenė;Bitučių;9068349987;Ne;0;8;0;8
13895;Viltenė;Boružėlių;3777544301;Taip;0;6;0;6
13896;Viltenė;Boružėlių;6642790962;Taip;15;0;0;15
13897;Viltenė;Boružėlių;9572407405;Taip;17;0;0;17
13898;Viltenė;Boružėlių;3738838707;Taip;0;2;0;2
13899;Viltenė;Boružėlių;8473588098;Taip;4;8;0;12
13900;Viltenė;Boružėlių;3995418079;Taip;20;0;0;20
13901;Viltenė;Boružėlių;1399653129;Taip;9;0;0;9
13902;Viltenė;Boružėlių;7526555727;Taip;0;9;0;9
13903;Viltenė;Boružėlių;5379804362;Taip;0;3;0;3
13904;Viltenė;Boružėlių;1936628249;Taip;2;6;0;8
13905;Viltenė;Boružėlių;4003018966;Taip;7;0;0;7
13906;Viltenė;Boružėlių;7912396297;Taip;0;9;0;9
13907;Viltenė;Boružėlių;4036109404;Taip;5;5;0;10
13908;Viltenė;Boružėlių;4604298036;Taip;4;6;0;10
13909;Viltenė;Boružėlių;9197007374;Taip;0;8;0;8
13910;Viltenė;Boružėlių;9242034622;Taip;5;4;0;9
13911;Viltenė;Boružėlių;5280690534;Taip;0;5;0;5
13912;Viltenė;Boružėlių;6621273812;Taip;13;0;0;13
13913;Viltenė;Boružėlių;2383607612;Taip;16;0;0;16
13914;Viltenė;Boružėlių;1496943250;Ne;0;6;0;6
13915;Viltenė;Gandriukų;6481491422;Taip;8;0;0;8
13916;Viltenė;Gandriukų;2452782594;Taip;0;0;2;2
13917;Viltenė;Gandriukų;9217178863;Ne;0;4;0;4
13918;Viltenė;Gandriukų;1126409020;Taip;0;9;0;9
13919;Viltenė;Gandriukų;2884698447;Taip;9;0;0;9
13920;Viltenė;Gandriukų;6060648988;Taip;6;2;0;8
13921;Viltenė;Gandriukų;1840626621;Taip;0;4;0;4
13922;Viltenė;Gandriukų;8549631247;Taip;0;3;0;3
13923;Viltenė;Gandriukų;7796422726;Taip;0;4;1;5
13924;Viltenė;Gandriukų;2815105107;Taip;0;4;0;4
13925;Viltenė;Gandriukų;6511850468;Taip;14;0;0;14
13926;Viltenė;Gandriukų;4945108189;Taip;0;4;0;4
13927;Viltenė;Gandriukų;5850652322;Taip;3;0;3;6
13928;Viltenė;Gandriukų;8110413064;Taip;0;8;0;8
13929;Viltenė;Gandriukų;1243595112;Taip;7;0;0;7
13930;Viltenė;Gandriukų;3073228245;Taip;11;0;3;14
13931;Viltenė;Gandriukų;4468743044;Ne;19;0;0;19
13932;Viltenė;Gandriukų;6355857716;Ne;0;0;6;6
13933;Viltenė;Gandriukų;7274368180;Ne;14;0;3;17
13934;Viltenė;Aitvariukai;51598096361;Taip;8;7;0;15
13935;Viltenė;Aitvariukai;15218988953;Taip;0;8;0;8
13936;Viltenė;Aitvariukai;9155192250;Taip;13;4;4;21
13937;Viltenė;Aitvariukai;9611851889;Ne;0;4;0;4
13938;Viltenė;Aitvariukai;5304966336;Taip;0;4;0;4
13939;Viltenė;Aitvariukai;3057761137;Ne;8;5;2;15
13940;Viltenė;Aitvariukai;6160715081;Taip;21;0;0;21
13941;Viltenė;Aitvariukai;5919786939;Taip;0;5;0;5
13942;Viltenė;Aitvariukai;17844870669;Taip;0;4;0;4
13943;Viltenė;Aitvariukai;56293220882;Taip;0;3;0;3
13944;Viltenė;Aitvariukai;96366849694;Taip;0;4;0;4
13945;Viltenė;Aitvariukai;8259812812;Taip;0;4;0;4
13946;Viltenė;Aitvariukai;23233966729;Taip;0;3;3;6
13947;Viltenė;Aitvariukai;44367763042;Taip;0;4;8;12
13948;Viltenė;Aitvariukai;99398043638;Taip;11;4;0;15
13949;Viltenė;Aitvariukai;1712349973;Taip;3;4;0;7
13950;Viltenė;Aitvariukai;55514676697;Taip;0;2;1;3
13951;Viltenė;Aitvariukai;14831307307;Taip;0;9;0;9
13952;Viltenė;Aitvariukai;5297513672;Taip;8;4;0;12
13953;Viltenė;Geniukų;5604263567;Taip;9;0;0;9
13954;Viltenė;Geniukų;1822220265;Ne;2;6;0;8
13955;Viltenė;Geniukų;9613791189;Taip;0;4;0;4
13956;Viltenė;Geniukų;6349032936;Taip;6;0;0;6
13957;Viltenė;Geniukų;1423254631;Ne;5;3;0;8
13958;Viltenė;Geniukų;3002690526;Taip;7;10;0;17
13959;Viltenė;Geniukų;6276349499;Taip;5;9;0;14
13960;Viltenė;Geniukų;1054469254;Taip;4;4;0;8
13961;Viltenė;Geniukų;4295285885;Taip;10;8;0;18
13962;Viltenė;Geniukų;6063181025;Taip;2;7;0;9
13963;Viltenė;Geniukų;1672091332;Taip;21;0;0;21
13964;Viltenė;Geniukų;3018271511;Taip;9;0;0;9
13965;Viltenė;Geniukų;49998813869;Taip;0;13;0;13
13966;Viltenė;Geniukų;3389110405;Taip;0;9;0;9
13967;Viltenė;Geniukų;4319685140;Taip;0;8;0;8
13968;Viltenė;Geniukų;8329611036;Ne;3;4;0;7
13969;Viltenė;Geniukų;8125023386;Taip;11;4;0;15
13970;Viltenė;Geniukų;9035687504;Ne;6;3;0;9
13971;Viltenė;Geniukų;1629377078;Taip;7;3;0;10
13972;Viltenė;Geniukų;4104052524;Ne;3;4;0;7
13973;Viltenė;Saulutės;2044754943;Taip;10;0;0;10
13974;Viltenė;Saulutės;6848403057;Taip;0;4;0;4
13975;Viltenė;Saulutės;1615415742;Taip;0;7;0;7
13976;Viltenė;Saulutės;7994367286;Ne;5;9;0;14
13977;Viltenė;Saulutės;9935236068;Taip;9;1;0;10
13978;Viltenė;Saulutės;6664059418;Taip;0;6;0;6
13979;Viltenė;Saulutės;2141002432;Taip;9;2;0;11
13980;Viltenė;Saulutės;1362308882;Taip;6;0;0;6
13981;Viltenė;Saulutės;8920533673;Taip;12;4;0;16
13982;Viltenė;Saulutės;5024192785;Taip;0;4;0;4
13983;Viltenė;Saulutės;92968672028;Ne;7;6;0;13
13984;Viltenė;Saulutės;1918867591;Ne;7;9;0;16
13985;Viltenė;Saulutės;7559243300;Taip;11;5;0;16
13986;Viltenė;Saulutės;8512665706;Taip;6;0;0;6
13987;Viltenė;Saulutės;3560474943;Taip;6;2;0;8
13988;Viltenė;Saulutės;2840208662;Taip;0;4;0;4
13989;Viltenė;Saulutės;1252657362;Taip;0;1;0;1
13990;Viltenė;Saulutės;2559945034;Taip;0;11;0;11
13991;Viltenė;Saulutės;2546789906;Taip;10;0;0;10
13992;Viltenė;Saulutės;9055821628;Taip;9;0;0;9
13993;Viltenė;Saulutės;9858998005;Taip;0;2;0;2
13994;Viltenė;Saulutės;7726650894;Taip;7;3;0;10
13995;Viltenė;Saulutės;3709362712;Taip;9;4;0;13
13996;Viltenė;Saulutės;1841732416;Taip;10;4;0;14
13997;Viltenė;Saulutės;3008272979;Taip;6;7;0;13
13998;Viltenė;Lapiukų;2016636764;Taip;0;3;0;3
13999;Viltenė;Lapiukų;1650304982;Taip;0;6;1;7
14000;Viltenė;Lapiukų;89844531860;Taip;0;5;0;5
14001;Viltenė;Lapiukų;8261531943;Taip;0;2;0;2
14002;Viltenė;Lapiukų;1884043126;Taip;0;2;2;4
14003;Viltenė;Lapiukų;60092202534;Taip;0;11;0;11
14004;Viltenė;Lapiukų;22318027000;Taip;0;4;0;4
14005;Viltenė;Lapiukų;1559623914;Taip;0;14;0;14
14006;Viltenė;Lapiukų;1042196397;Taip;0;6;0;6
14007;Viltenė;Lapiukų;1210824560;Taip;14;5;0;19
14008;Viltenė;Lapiukų;87698700338;Taip;0;6;0;6
14009;Viltenė;Lapiukų;3526237179;Taip;8;2;0;10
14010;Viltenė;Lapiukų;1662950901;Taip;0;4;2;6
14011;Viltenė;Lapiukų;1350487577;Taip;10;4;0;14
14012;Viltenė;Lapiukų;1592077335;Taip;0;19;0;19
14013;Viltenė;Lapiukų;1281808784;Ne;10;0;0;10
14014;Viltenė;Lapiukų;1726174128;Taip;0;10;1;11
14015;Viltenė;Lapiukų;4470172666;Taip;2;10;0;12
14016;Viltenė;Lapiukų;2527648089;Taip;0;4;1;5
14017;Viltenė;Lapiukų;93894985640;Ne;5;7;0;12
14018;Viltenė;Lapiukų;3259114583;Taip;0;9;0;9
14019;Viltenė;Voveriukai;8732323660;Taip;9;2;0;11
14020;Viltenė;Voveriukai;13795858727;Ne;0;8;0;8
14021;Viltenė;Voveriukai;1306624353;Taip;0;6;0;6
14022;Viltenė;Voveriukai;41763338811;Taip;0;6;0;6
14023;Viltenė;Voveriukai;46757944454;Ne;0;4;0;4
14024;Viltenė;Voveriukai;69918162258;Taip;0;8;0;8
14025;Viltenė;Voveriukai;76569470768;Taip;0;7;0;7
14026;Viltenė;Voveriukai;1262222404;Ne;6;0;1;7
14027;Viltenė;Voveriukai;7245395388;Ne;0;6;0;6
14028;Viltenė;Voveriukai;77847693433;Taip;6;0;1;7
14029;Viltenė;Voveriukai;46252876577;Taip;0;2;0;2
14030;Viltenė;Voveriukai;92175043385;Taip;9;0;2;11
14031;Viltenė;Voveriukai;35466181637;Ne;14;0;0;14
14032;Viltenė;Voveriukai;68243828276;Taip;3;0;2;5
14033;Viltenė;Voveriukai;1615151982;Taip;12;4;0;16
14034;Viltenė;Voveriukai;87296434240;Taip;0;6;0;6
14035;Viltenė;Voveriukai;51997485918;Ne;3;13;0;16
14036;Viltenė;Voveriukai;1872042290;Taip;5;1;0;6
14037;Viltenė;Voveriukai;1926586646;Ne;0;4;3;7
14038;Viltenė;Voveriukai;2008408325;Ne;0;10;0;10
14039;Viltenė;Voveriukai;4441280059;Taip;0;2;0;2
14040;Viltenė;Triušikai;3245284852;Taip;15;0;0;15
14041;Viltenė;Triušikai;9756519374;Taip;0;16;0;16
14042;Viltenė;Triušikai;9820462941;Taip;6;0;0;6
14043;Viltenė;Triušikai;7928894276;Taip;17;0;0;17
14044;Viltenė;Triušikai;8527270437;Taip;4;0;2;6
14045;Viltenė;Triušikai;2026654467;Taip;0;9;0;9
14046;Viltenė;Triušikai;4195708756;Taip;13;0;0;13
14047;Viltenė;Triušikai;5522245968;Taip;10;0;0;10
14048;Viltenė;Triušikai;8439859449;Taip;14;0;0;14
14049;Viltenė;Triušikai;2786572522;Taip;2;1;2;5
14050;Viltenė;Triušikai;7277455268;Taip;0;13;0;13
14051;Viltenė;Triušikai;2410868015;Taip;13;0;0;13
14052;Viltenė;Triušikai;7401460248;Taip;12;0;0;12
14053;Viltenė;Triušikai;2660622296;Taip;14;0;1;15
14054;Viltenė;Kiškučiai;6040634853;Taip;11;1;0;12
14055;Viltenė;Kiškučiai;9101795131;Taip;2;4;0;6
14056;Viltenė;Kiškučiai;6296509460;Taip;7;3;0;10
14057;Viltenė;Kiškučiai;2702489251;Taip;21;0;0;21
14058;Viltenė;Kiškučiai;6810811656;Taip;10;0;0;10
14059;Viltenė;Kiškučiai;1888167096;Taip;7;0;0;7
14060;Viltenė;Kiškučiai;2013415571;Taip;8;4;0;12
14061;Viltenė;Kiškučiai;8679787688;Taip;7;9;0;16
14062;Viltenė;Kiškučiai;3908574248;Taip;13;1;0;14
14063;Viltenė;Kiškučiai;9228677568;Taip;2;0;0;2
14064;Viltenė;Kiškučiai;8477241365;Taip;21;0;0;21
14065;Viltenė;Kiškučiai;8840885039;Taip;1;11;0;12
14066;Viltenė;Kiškučiai;4616047113;Taip;2;0;0;2
14067;Viltenė;Kiškučiai;2642080849;Taip;7;1;0;8
14068;Viltenė;Kiškučiai;3031790547;Taip;6;9;0;15
14069;Viltenė;Nykštukų;8122878153;Taip;0;13;0;13
14070;Viltenė;Nykštukų;2036902795;Taip;13;0;0;13
14071;Viltenė;Nykštukų;9476132305;Taip;18;0;0;18
14072;Viltenė;Nykštukų;5194925689;Ne;12;0;0;12
14073;Viltenė;Nykštukų;5818645490;Taip;10;1;1;12
14074;Viltenė;Nykštukų;3679704404;Taip;10;6;0;16
14075;Viltenė;Nykštukų;1507287948;Taip;13;1;0;14
14076;Viltenė;Nykštukų;4121448859;Taip;4;3;0;7
14077;Viltenė;Nykštukų;5599943846;Taip;21;0;0;21
14078;Viltenė;Nykštukų;6721689684;Taip;8;0;0;8
14079;Viltenė;Nykštukų;5552217000;Taip;4;3;0;7
14080;Viltenė;Nykštukų;4243501722;Taip;6;1;0;7
14081;Viltenė;Nykštukų;3905014810;Ne;5;8;0;13
14082;Viltenė;Nykštukų;9157616307;Taip;0;5;0;5
14083;Viltenė;Nykštukų;3052677157;Taip;8;1;0;9
14084;Voveraitė;ŽVIRBLIUKŲ;6690309946;Taip;5;0;0;5
14085;Voveraitė;ŽVIRBLIUKŲ;9491132884;Taip;0;8;0;8
14086;Voveraitė;ŽVIRBLIUKŲ;6684234832;Taip;0;5;0;5
14087;Voveraitė;ŽVIRBLIUKŲ;8119493388;Taip;0;11;0;11
14088;Voveraitė;ŽVIRBLIUKŲ;9715405072;Taip;4;1;0;5
14089;Voveraitė;ŽVIRBLIUKŲ;5804351872;Taip;4;0;0;4
14090;Voveraitė;ŽVIRBLIUKŲ;8925151080;Taip;0;1;0;1
14091;Voveraitė;ŽVIRBLIUKŲ;5510544648;Taip;0;4;0;4
14092;Voveraitė;ŽVIRBLIUKŲ;3582805599;Taip;4;7;0;11
14093;Voveraitė;ŽVIRBLIUKŲ;5705303891;Ne;0;13;0;13
14094;Voveraitė;ŽVIRBLIUKŲ;6959751328;Taip;15;5;0;20
14095;Voveraitė;ŽVIRBLIUKŲ;8803052781;Taip;0;9;0;9
14096;Voveraitė;ŽVIRBLIUKŲ;8257748589;Taip;0;13;0;13
14097;Voveraitė;ŽVIRBLIUKŲ;1522307865;Taip;0;10;0;10
14098;Voveraitė;ŽVIRBLIUKŲ;3258155215;Taip;3;10;0;13
14099;Voveraitė;ŽVIRBLIUKŲ;3811230983;Taip;6;6;0;12
14100;Voveraitė;VOVERIUKŲ;1515087924;Taip;0;4;0;4
14101;Voveraitė;VOVERIUKŲ;9195700962;Taip;10;9;0;19
14102;Voveraitė;VOVERIUKŲ;4324619869;Taip;2;9;0;11
14103;Voveraitė;VOVERIUKŲ;1340379090;Taip;11;3;0;14
14104;Voveraitė;VOVERIUKŲ;9912862474;Taip;17;2;0;19
14105;Voveraitė;VOVERIUKŲ;1960385335;Ne;9;1;0;10
14106;Voveraitė;VOVERIUKŲ;2594535017;Taip;6;4;0;10
14107;Voveraitė;VOVERIUKŲ;7746424196;Taip;6;3;0;9
14108;Voveraitė;VOVERIUKŲ;4563198733;Taip;9;5;0;14
14109;Voveraitė;VOVERIUKŲ;8373093305;Ne;7;1;0;8
14110;Voveraitė;VOVERIUKŲ;2662384275;Taip;0;5;0;5
14111;Voveraitė;VOVERIUKŲ;9514425475;Taip;7;4;0;11
14112;Voveraitė;VOVERIUKŲ;6017698476;Taip;11;4;0;15
14113;Voveraitė;VOVERIUKŲ;8580034134;Taip;21;0;0;21
14114;Voveraitė;VOVERIUKŲ;6891841301;Taip;2;6;0;8
14115;Voveraitė;VOVERIUKŲ;2627555750;Taip;20;0;0;20
14116;Voveraitė;VOVERIUKŲ;5935777154;Taip;3;4;0;7
14117;Voveraitė;VOVERIUKŲ;6113913885;Ne;3;2;0;5
14118;Voveraitė;VOVERIUKŲ;6007396459;Taip;7;5;0;12
14119;Voveraitė;KIŠKUČIŲ;3615729576;Ne;9;0;0;9
14120;Voveraitė;KIŠKUČIŲ;9231751171;Taip;1;4;3;8
14121;Voveraitė;KIŠKUČIŲ;4338861332;Taip;10;4;0;14
14122;Voveraitė;KIŠKUČIŲ;9933037872;Taip;4;3;0;7
14123;Voveraitė;KIŠKUČIŲ;3113780055;Taip;6;2;0;8
14124;Voveraitė;KIŠKUČIŲ;65926130735;Taip;4;1;0;5
14125;Voveraitė;KIŠKUČIŲ;7069780513;Taip;0;2;0;2
14126;Voveraitė;KIŠKUČIŲ;9997346812;Taip;11;0;4;15
14127;Voveraitė;KIŠKUČIŲ;9703726869;Taip;4;2;0;6
14128;Voveraitė;KIŠKUČIŲ;7314148938;Taip;15;1;0;16
14129;Voveraitė;KIŠKUČIŲ;4511771924;Taip;15;1;0;16
14130;Voveraitė;KIŠKUČIŲ;9007031372;Taip;11;5;0;16
14131;Voveraitė;KIŠKUČIŲ;6649068571;Taip;7;7;0;14
14132;Voveraitė;KIŠKUČIŲ;1775800865;Taip;0;6;0;6
14133;Voveraitė;KIŠKUČIŲ;6433760749;Ne;8;4;0;12
14134;Voveraitė;KIŠKUČIŲ;54408671673;Taip;13;1;1;15
14135;Voveraitė;KIŠKUČIŲ;72154318379;Taip;9;1;2;12
14136;Voveraitė;KIŠKUČIŲ;1959958256;Ne;7;4;2;13
14137;Voveraitė;KIŠKUČIŲ;2693544600;Taip;4;1;0;5
14138;Voveraitė;KIŠKUČIŲ;6460834118;Taip;7;8;0;15
14139;Voveraitė;KODĖLČIUKŲ;3469734853;Taip;4;0;5;9
14140;Voveraitė;KODĖLČIUKŲ;9117809080;Taip;0;5;0;5
14141;Voveraitė;KODĖLČIUKŲ;5467979968;Taip;9;0;0;9
14142;Voveraitė;KODĖLČIUKŲ;46205148458;Taip;0;4;0;4
14143;Voveraitė;KODĖLČIUKŲ;1772758517;Ne;0;2;8;10
14144;Voveraitė;KODĖLČIUKŲ;9431523085;Taip;0;4;0;4
14145;Voveraitė;KODĖLČIUKŲ;51213803814;Taip;0;4;0;4
14146;Voveraitė;KODĖLČIUKŲ;36749754999;Taip;0;4;0;4
14147;Voveraitė;KODĖLČIUKŲ;4045121781;Taip;7;7;0;14
14148;Voveraitė;KODĖLČIUKŲ;2208396431;Taip;5;6;1;12
14149;Voveraitė;KODĖLČIUKŲ;5296850349;Taip;2;3;0;5
14150;Voveraitė;KODĖLČIUKŲ;2763656717;Taip;2;0;14;16
14151;Voveraitė;KODĖLČIUKŲ;4468214107;Taip;6;4;0;10
14152;Voveraitė;KODĖLČIUKŲ;9921313716;Taip;0;8;0;8
14153;Voveraitė;KODĖLČIUKŲ;5449490074;Ne;7;6;7;20
14154;Voveraitė;KODĖLČIUKŲ;7786378018;Ne;10;4;0;14
14155;Voveraitė;MEŠKIUKŲ;4079618555;Taip;0;9;0;9
14156;Voveraitė;MEŠKIUKŲ;3381417855;Taip;3;1;0;4
14157;Voveraitė;MEŠKIUKŲ;3703062195;Taip;12;1;0;13
14158;Voveraitė;MEŠKIUKŲ;8438876806;Taip;0;9;0;9
14159;Voveraitė;MEŠKIUKŲ;1058273156;Taip;6;1;0;7
14160;Voveraitė;MEŠKIUKŲ;9149748841;Ne;0;9;0;9
14161;Voveraitė;MEŠKIUKŲ;5576058454;Taip;9;1;0;10
14162;Voveraitė;MEŠKIUKŲ;1629942114;Ne;3;7;3;13
14163;Voveraitė;MEŠKIUKŲ;6359983706;Taip;8;6;0;14
14164;Voveraitė;MEŠKIUKŲ;17534618616;Taip;6;2;0;8
14165;Voveraitė;MEŠKIUKŲ;1592633500;Taip;4;8;0;12
14166;Voveraitė;MEŠKIUKŲ;5437283673;Taip;3;10;0;13
14167;Voveraitė;MEŠKIUKŲ;7797966139;Taip;3;9;0;12
14168;Voveraitė;MEŠKIUKŲ;3029983180;Taip;7;3;0;10
14169;Voveraitė;MEŠKIUKŲ;9900940313;Taip;3;4;0;7
14170;Voveraitė;MEŠKIUKŲ;4680264973;Ne;5;4;2;11
14171;Voveraitė;MEŠKIUKŲ;5095849577;Taip;0;3;0;3
14172;Voveraitė;MEŠKIUKŲ;6886337758;Taip;10;7;0;17
14173;Voveraitė;MEŠKIUKŲ;6994680282;Taip;0;2;2;4
14174;Voveraitė;MEŠKIUKŲ;7861722125;Taip;7;12;0;19
14175;Voveraitė;BORUŽĖLIŲ;49205285378;Taip;0;10;0;10
14176;Voveraitė;BORUŽĖLIŲ;1587569563;Taip;0;4;0;4
14177;Voveraitė;BORUŽĖLIŲ;89216481616;Taip;0;3;0;3
14178;Voveraitė;BORUŽĖLIŲ;26080915874;Taip;0;6;0;6
14179;Voveraitė;BORUŽĖLIŲ;3818120898;Taip;0;8;0;8
14180;Voveraitė;BORUŽĖLIŲ;64724933885;Taip;3;1;0;4
14181;Voveraitė;BORUŽĖLIŲ;69797506996;Ne;0;6;0;6
14182;Voveraitė;BORUŽĖLIŲ;26264960973;Taip;4;6;0;10
14183;Voveraitė;BORUŽĖLIŲ;57033218205;Taip;0;8;0;8
14184;Voveraitė;BORUŽĖLIŲ;89873985894;Taip;5;4;0;9
14185;Voveraitė;BORUŽĖLIŲ;76074825733;Taip;0;2;0;2
14186;Voveraitė;BORUŽĖLIŲ;61376515242;Taip;0;6;0;6
14187;Voveraitė;BORUŽĖLIŲ;47111956594;Taip;6;6;0;12
14188;Voveraitė;BORUŽĖLIŲ;16514161872;Taip;0;1;0;1
14189;Voveraitė;BORUŽĖLIŲ;53801893219;Ne;6;2;0;8
14190;Voveraitė;BORUŽĖLIŲ;59442802443;Taip;0;6;0;6
14191;Voveraitė;BORUŽĖLIŲ;1398043988;Taip;0;1;0;1
14192;Voveraitė;BORUŽĖLIŲ;22913200509;Taip;0;3;1;4
14193;Voveraitė;PELĖDŽIUKŲ;1689261748;Taip;0;8;0;8
14194;Voveraitė;PELĖDŽIUKŲ;5944299310;Taip;0;1;0;1
14195;Voveraitė;PELĖDŽIUKŲ;4266535840;Taip;3;5;0;8
14196;Voveraitė;PELĖDŽIUKŲ;76432985710;Taip;0;5;1;6
14197;Voveraitė;PELĖDŽIUKŲ;74161507529;Ne;0;4;0;4
14198;Voveraitė;PELĖDŽIUKŲ;30591405375;Taip;5;11;0;16
14199;Voveraitė;PELĖDŽIUKŲ;42683378356;Taip;5;6;0;11
14200;Voveraitė;PELĖDŽIUKŲ;46665609670;Taip;0;4;3;7
14201;Voveraitė;PELĖDŽIUKŲ;68005956631;Taip;0;2;0;2
14202;Voveraitė;PELĖDŽIUKŲ;32030461873;Taip;0;3;0;3
14203;Voveraitė;PELĖDŽIUKŲ;5354784149;Taip;0;4;1;5
14204;Voveraitė;PELĖDŽIUKŲ;3292830298;Taip;5;4;4;13
14205;Voveraitė;PELĖDŽIUKŲ;3756080192;Taip;0;4;12;16
14206;Voveraitė;PELĖDŽIUKŲ;1018558040;Taip;0;4;0;4
14207;Voveraitė;PELĖDŽIUKŲ;5804909515;Taip;2;4;0;6
14208;Voveraitė;DRUGELIŲ;9623406874;Taip;9;0;2;11
14209;Voveraitė;DRUGELIŲ;1668695462;Taip;5;0;1;6
14210;Voveraitė;DRUGELIŲ;1753442884;Taip;9;5;0;14
14211;Voveraitė;DRUGELIŲ;63032690186;Taip;0;2;0;2
14212;Voveraitė;DRUGELIŲ;7974406524;Taip;11;3;0;14
14213;Voveraitė;DRUGELIŲ;2711136945;Taip;0;4;0;4
14214;Voveraitė;DRUGELIŲ;8538259157;Taip;0;6;0;6
14215;Voveraitė;DRUGELIŲ;81628846458;Taip;0;7;0;7
14216;Voveraitė;DRUGELIŲ;2044914624;Taip;12;3;0;15
14217;Voveraitė;DRUGELIŲ;5037713667;Taip;5;3;0;8
14218;Voveraitė;DRUGELIŲ;2031078156;Taip;0;1;0;1
14219;Voveraitė;DRUGELIŲ;80330740714;Taip;3;6;0;9
14220;Voveraitė;DRUGELIŲ;6729475469;Taip;0;11;0;11
14221;Voveraitė;DRUGELIŲ;1397274691;Ne;4;10;0;14
14222;Voveraitė;DRUGELIŲ;1612322367;Taip;0;5;0;5
14223;Voveraitė;DRUGELIŲ;6847620019;Taip;0;7;3;10
14224;Voveraitė;DRUGELIŲ;53507758884;Taip;3;5;0;8
14225;Voveraitė;DRUGELIŲ;1780573926;Taip;8;6;0;14
14226;Voveraitė;DRUGELIŲ;8443005812;Taip;15;0;0;15
14227;Voveraitė;DRUGELIŲ;1449122395;Ne;4;1;1;6
14228;Voveraitė;NYKŠTUKŲ;59346262217;Ne;0;8;0;8
14229;Voveraitė;NYKŠTUKŲ;44115826781;Taip;0;4;0;4
14230;Voveraitė;NYKŠTUKŲ;67851579200;Taip;0;12;0;12
14231;Voveraitė;NYKŠTUKŲ;2902148527;Taip;0;2;0;2
14232;Voveraitė;NYKŠTUKŲ;28656009009;Taip;5;5;0;10
14233;Voveraitė;NYKŠTUKŲ;1704834744;Taip;0;7;0;7
14234;Voveraitė;NYKŠTUKŲ;35549553867;Taip;3;7;0;10
14235;Voveraitė;NYKŠTUKŲ;49924157014;Taip;0;3;0;3
14236;Voveraitė;NYKŠTUKŲ;41182124889;Taip;0;7;0;7
14237;Voveraitė;NYKŠTUKŲ;13173711840;Taip;2;5;0;7
14238;Voveraitė;NYKŠTUKŲ;602726070;Taip;0;4;0;4
14239;Voveraitė;NYKŠTUKŲ;27132982320;Taip;0;4;2;6
14240;Voveraitė;NYKŠTUKŲ;107968318;Taip;5;7;0;12
14241;Voveraitė;NYKŠTUKŲ;2762066479;Taip;3;2;1;6
14242;Voveraitė;NYKŠTUKŲ;66612277823;Taip;0;4;0;4
14243;Voveraitė;NYKŠTUKŲ;82642244788;Taip;0;5;0;5
14244;Voveraitė;NYKŠTUKŲ;2051732666;Ne;9;7;0;16
14245;Voveraitė;NYKŠTUKŲ;4163635632;Taip;0;9;0;9
14246;Voveraitė;GENIUKŲ;6903776113;Taip;8;5;0;13
14247;Voveraitė;GENIUKŲ;46063615245;Taip;0;4;1;5
14248;Voveraitė;GENIUKŲ;63276868064;Taip;4;5;0;9
14249;Voveraitė;GENIUKŲ;3137529068;Taip;15;4;0;19
14250;Voveraitė;GENIUKŲ;34170702690;Taip;0;5;0;5
14251;Voveraitė;GENIUKŲ;12366200545;Taip;6;4;0;10
14252;Voveraitė;GENIUKŲ;90970378921;Taip;9;6;0;15
14253;Voveraitė;GENIUKŲ;15716865051;Ne;0;5;0;5
14254;Voveraitė;GENIUKŲ;14865004407;Taip;0;8;4;12
14255;Voveraitė;GENIUKŲ;37044398892;Taip;0;9;1;10
14256;Voveraitė;GENIUKŲ;65838266846;Taip;5;4;0;9
14257;Voveraitė;GENIUKŲ;39956224681;Taip;15;4;0;19
14258;Voveraitė;GENIUKŲ;74403080901;Taip;3;3;0;6
14259;Voveraitė;GENIUKŲ;1055423524;Ne;0;11;0;11
14260;Voveraitė;GENIUKŲ;1261834247;Taip;0;14;0;14
14261;Voveraitė;GENIUKŲ;6898251154;Ne;0;5;2;7
14262;Voveraitė;LAPIUKŲ;1141304286;Ne;7;4;0;11
14263;Voveraitė;LAPIUKŲ;1510853268;Taip;4;0;0;4
14264;Voveraitė;LAPIUKŲ;3388547792;Taip;21;0;0;21
14265;Voveraitė;LAPIUKŲ;8344323109;Taip;15;2;2;19
14266;Voveraitė;LAPIUKŲ;7099272964;Taip;6;0;6;12
14267;Voveraitė;LAPIUKŲ;2716400502;Taip;2;1;0;3
14268;Voveraitė;LAPIUKŲ;7008576999;Taip;2;1;0;3
14269;Voveraitė;LAPIUKŲ;4300235743;Taip;15;4;2;21
14270;Voveraitė;LAPIUKŲ;1441921029;Taip;5;1;3;9
14271;Voveraitė;LAPIUKŲ;2450726148;Taip;0;3;0;3
14272;Voveraitė;LAPIUKŲ;7531020548;Ne;4;11;0;15
14273;Voveraitė;LAPIUKŲ;7990479988;Taip;0;7;0;7
14274;Voveraitė;LAPIUKŲ;8421104790;Taip;21;0;0;21
14275;Voveraitė;LAPIUKŲ;6073270223;Taip;11;0;2;13
14276;Voveraitė;LAPIUKŲ;7640409923;Taip;11;8;0;19
14277;Voveraitė;EŽIUKŲ;1614180834;Taip;21;0;0;21
14278;Voveraitė;EŽIUKŲ;6572172779;Taip;14;0;4;18
14279;Voveraitė;EŽIUKŲ;8084986328;Taip;4;2;4;10
14280;Voveraitė;EŽIUKŲ;8746008166;Taip;8;0;1;9
14281;Voveraitė;EŽIUKŲ;8507818993;Taip;0;11;0;11
14282;Voveraitė;EŽIUKŲ;3736638759;Taip;0;13;0;13
14283;Voveraitė;EŽIUKŲ;6261152304;Taip;8;0;2;10
14284;Voveraitė;EŽIUKŲ;9537862791;Taip;8;4;2;14
14285;Voveraitė;EŽIUKŲ;9011096222;Taip;5;0;1;6
14286;Voveraitė;EŽIUKŲ;4478984171;Taip;0;11;0;11
14287;Voveraitė;EŽIUKŲ;3058377539;Taip;8;4;6;18
14288;Voveraitė;EŽIUKŲ;5114768009;Taip;8;6;0;14
14289;Voveraitė;EŽIUKŲ;4626178764;Taip;0;0;1;1
14290;Voveraitė;EŽIUKŲ;1550830434;Taip;5;10;0;15
14291;"Trakų Vokė";Voveriukų;2906508821;Ne;19;0;0;19
14292;"Trakų Vokė";Voveriukų;2389794233;Taip;21;0;0;21
14293;"Trakų Vokė";Voveriukų;9233090228;Taip;6;0;7;13
14294;"Trakų Vokė";Voveriukų;2880299812;Taip;9;0;1;10
14295;"Trakų Vokė";Voveriukų;4854440884;Taip;19;0;0;19
14296;"Trakų Vokė";Voveriukų;2761614687;Taip;19;0;0;19
14297;"Trakų Vokė";Voveriukų;2539647111;Taip;5;0;1;6
14298;"Trakų Vokė";Voveriukų;1360046096;Taip;21;0;0;21
14299;"Trakų Vokė";Voveriukų;3328527700;Taip;13;4;1;18
14300;"Trakų Vokė";Voveriukų;3278842582;Taip;15;0;0;15
14301;"Trakų Vokė";Voveriukų;1324720234;Taip;4;0;0;4
14302;"Trakų Vokė";Voveriukų;2869217654;Ne;20;0;0;20
14303;"Trakų Vokė";Voveriukų;6277305384;Taip;3;0;0;3
14304;"Trakų Vokė";Voveriukų;6369848950;Taip;0;0;2;2
14305;"Trakų Vokė";Voveriukų;6326568445;Taip;7;0;0;7
14306;"Trakų Vokė";Voveriukų;4040038648;Taip;14;0;0;14
14307;"Trakų Vokė";Voveriukų;7727246187;Ne;9;2;2;13
14308;"Trakų Vokė";Voveriukų;3611639112;Taip;21;0;0;21
14309;"Trakų Vokė";Voveriukų;5206616285;Taip;12;4;1;17
14310;"Trakų Vokė";Voveriukų;4535167417;Taip;5;3;0;8
14311;"Trakų Vokė";Boružėlių;3209594216;Taip;8;0;1;9
14312;"Trakų Vokė";Boružėlių;6732422645;Taip;6;0;3;9
14313;"Trakų Vokė";Boružėlių;5338798362;Taip;8;0;10;18
14314;"Trakų Vokė";Boružėlių;3319243283;Taip;2;0;2;4
14315;"Trakų Vokė";Boružėlių;1039690987;Taip;15;0;0;15
14316;"Trakų Vokė";Boružėlių;2516219363;Taip;7;0;4;11
14317;"Trakų Vokė";Boružėlių;7858812338;Ne;0;0;3;3
14318;"Trakų Vokė";Boružėlių;3913623741;Taip;0;4;6;10
14319;"Trakų Vokė";Boružėlių;2730385281;Taip;14;0;0;14
14320;"Trakų Vokė";Boružėlių;1088928094;Taip;3;0;5;8
14321;"Trakų Vokė";Boružėlių;7318458282;Taip;11;0;0;11
14322;"Trakų Vokė";Boružėlių;6908913934;Ne;2;0;4;6
14323;"Trakų Vokė";Boružėlių;7909596435;Taip;11;0;0;11
14324;"Trakų Vokė";Boružėlių;5251929660;Taip;4;3;0;7
14325;"Trakų Vokė";Boružėlių;6751625456;Taip;11;0;0;11
14326;"Trakų Vokė";Boružėlių;7752786907;Taip;15;0;0;15
14327;"Trakų Vokė";Boružėlių;2475068032;Taip;0;0;11;11
14328;"Trakų Vokė";Boružėlių;4601374629;Ne;10;0;0;10
14329;"Trakų Vokė";Boružėlių;4014027030;Taip;4;0;8;12
14330;"Trakų Vokė";Boružėlių;7660240598;Taip;0;16;3;19
14331;"Trakų Vokė";Boružėlių;4438127190;Ne;18;0;0;18
14332;"Trakų Vokė";Boružėlių;2388817616;Taip;14;0;0;14
14333;"Trakų Vokė";Boružėlių;9453317084;Taip;0;5;0;5
14334;"Trakų Vokė";Boružėlių;2469340933;Ne;2;0;7;9
14335;"Trakų Vokė";KIŠKUČIŲ;15897808544;Taip;0;4;0;4
14336;"Trakų Vokė";KIŠKUČIŲ;88989814775;Taip;0;4;2;6
14337;"Trakų Vokė";KIŠKUČIŲ;6675993703;Taip;0;5;4;9
14338;"Trakų Vokė";KIŠKUČIŲ;87781186373;Taip;0;4;0;4
14339;"Trakų Vokė";KIŠKUČIŲ;69866048102;Taip;10;0;2;12
14340;"Trakų Vokė";KIŠKUČIŲ;64083541565;Taip;0;4;0;4
14341;"Trakų Vokė";KIŠKUČIŲ;67434532111;Taip;0;12;0;12
14342;"Trakų Vokė";KIŠKUČIŲ;26598573711;Taip;2;4;0;6
14343;"Trakų Vokė";KIŠKUČIŲ;69311478204;Taip;3;0;2;5
14344;"Trakų Vokė";KIŠKUČIŲ;71417288063;Ne;0;0;10;10
14345;"Trakų Vokė";KIŠKUČIŲ;44023296535;Taip;7;5;0;12
14346;"Trakų Vokė";KIŠKUČIŲ;6418198934;Taip;14;0;0;14
14347;"Trakų Vokė";KIŠKUČIŲ;50697040061;Taip;0;0;17;17
14348;"Trakų Vokė";KIŠKUČIŲ;9135918587;Taip;0;4;0;4
14349;"Trakų Vokė";KIŠKUČIŲ;64019248229;Taip;0;0;3;3
14350;"Trakų Vokė";KIŠKUČIŲ;18796898215;Taip;5;0;4;9
14351;"Trakų Vokė";KIŠKUČIŲ;86504089176;Taip;0;4;5;9
14352;"Trakų Vokė";KIŠKUČIŲ;3210453801;Taip;2;4;0;6
14353;"Trakų Vokė";KIŠKUČIŲ;21329819892;Taip;0;4;1;5
14354;"Trakų Vokė";KIŠKUČIŲ;9705561511;Taip;17;0;1;18
14355;"Trakų Vokė";KIŠKUČIŲ;40200309769;Taip;0;0;1;1
14356;"Trakų Vokė";KIŠKUČIŲ;5109850366;Taip;0;9;0;9
14357;"Trakų Vokė";KIŠKUČIŲ;33984949164;Taip;0;5;0;5
14358;"Trakų Vokė";KIŠKUČIŲ;85293469079;Taip;9;0;1;10
14359;"Trakų Vokė";BITUČIŲ;2839396687;Taip;0;4;0;4
14360;"Trakų Vokė";BITUČIŲ;7792654474;Taip;3;10;0;13
14361;"Trakų Vokė";BITUČIŲ;3406479364;Taip;3;2;0;5
14362;"Trakų Vokė";BITUČIŲ;4914675622;Taip;0;4;0;4
14363;"Trakų Vokė";BITUČIŲ;1461337199;Taip;0;0;1;1
14364;"Trakų Vokė";BITUČIŲ;5526830430;Taip;4;0;0;4
14365;"Trakų Vokė";BITUČIŲ;2149804129;Taip;0;0;4;4
14366;"Trakų Vokė";BITUČIŲ;3373764541;Taip;18;0;0;18
14367;"Trakų Vokė";BITUČIŲ;4849992906;Taip;0;11;0;11
14368;"Trakų Vokė";BITUČIŲ;3098390989;Ne;17;0;1;18
14369;"Trakų Vokė";BITUČIŲ;50553766116;Taip;0;4;0;4
14370;"Trakų Vokė";BITUČIŲ;4903261568;Taip;3;4;1;8
14371;"Trakų Vokė";BITUČIŲ;8542147751;Taip;5;0;1;6
14372;"Trakų Vokė";BITUČIŲ;1590598232;Taip;12;0;0;12
14373;"Trakų Vokė";BITUČIŲ;8857529726;Taip;0;0;12;12
14374;"Trakų Vokė";BITUČIŲ;4846130117;Taip;0;2;0;2
14375;"Trakų Vokė";BITUČIŲ;1433982328;Taip;0;2;0;2
14376;"Trakų Vokė";BITUČIŲ;39255784762;Taip;0;0;1;1
14377;"Trakų Vokė";BITUČIŲ;7566567901;Taip;0;0;1;1
14378;"Trakų Vokė";BITUČIŲ;1623166260;Taip;0;0;3;3
14379;Zylutė;Katerok;8749296671;Taip;20;0;0;20
14380;Zylutė;Katerok;1621772702;Taip;13;0;0;13
14381;Zylutė;Katerok;4592825972;Taip;7;9;0;16
14382;Zylutė;Katerok;8747721198;Taip;19;0;0;19
14383;Zylutė;Katerok;8212030518;Taip;12;5;0;17
14384;Zylutė;Katerok;7706833089;Taip;0;13;0;13
14385;Zylutė;Katerok;1353114929;Taip;0;1;0;1
14386;Zylutė;Katerok;3115223229;Taip;3;1;0;4
14387;Zylutė;Katerok;2968625045;Taip;0;2;0;2
14388;Zylutė;Katerok;8618778936;Taip;5;0;0;5
14389;Zylutė;Katerok;1897871944;Taip;0;8;0;8
14390;Zylutė;Katerok;5687201052;Taip;3;1;0;4
14391;Zylutė;Katerok;3055559237;Taip;0;1;0;1
14392;Zylutė;Katerok;1797701777;Taip;11;0;0;11
14393;Zylutė;Katerok;2792217953;Taip;10;0;0;10
14394;Zylutė;Katerok;5948147748;Taip;0;1;0;1
14395;Zylutė;Katerok;5264930854;Taip;7;6;0;13
14396;Zylutė;Katerok;1452384017;Taip;0;0;5;5
14397;Zylutė;"Vesole misiaki";86301183281;Taip;0;10;0;10
14398;Zylutė;"Vesole misiaki";9262869284;Taip;0;11;0;11
14399;Zylutė;"Vesole misiaki";1256879956;Ne;0;9;0;9
14400;Zylutė;"Vesole misiaki";3126726854;Ne;0;5;0;5
14401;Zylutė;"Vesole misiaki";9484752315;Taip;0;8;0;8
14402;Zylutė;"Vesole misiaki";7140223126;Taip;0;7;0;7
14403;Zylutė;"Vesole misiaki";81796510706;Taip;2;9;0;11
14404;Zylutė;"Vesole misiaki";7606434084;Taip;3;9;0;12
14405;Zylutė;"Vesole misiaki";6299191475;Ne;0;4;0;4
14406;Zylutė;"Vesole misiaki";8802891670;Taip;0;1;0;1
14407;Zylutė;"Vesole misiaki";9953834483;Taip;0;4;0;4
14408;Zylutė;"Vesole misiaki";9664467134;Ne;0;6;0;6
14409;Zylutė;"Vesole misiaki";8336138549;Taip;20;0;0;20
14410;Zylutė;"Vesole misiaki";9457189905;Taip;0;1;0;1
14411;Zylutė;"Vesole misiaki";2445444641;Taip;0;7;0;7
14412;Zylutė;"Vesole misiaki";8638652914;Ne;0;5;0;5
14413;Zylutė;"Vesole misiaki";9908198854;Taip;10;5;0;15
14414;Zylutė;NYKŠTUKAI;19429820228;Taip;10;3;0;13
14415;Zylutė;NYKŠTUKAI;46013925783;Taip;5;0;0;5
14416;Zylutė;NYKŠTUKAI;53165044678;Taip;0;4;2;6
14417;Zylutė;NYKŠTUKAI;40369749025;Taip;0;4;0;4
14418;Zylutė;NYKŠTUKAI;42712894954;Taip;0;1;0;1
14419;Zylutė;NYKŠTUKAI;87231809477;Taip;0;8;0;8
14420;Zylutė;NYKŠTUKAI;1584743051;Taip;10;4;0;14
14421;Zylutė;NYKŠTUKAI;1187261223;Taip;0;4;4;8
14422;Zylutė;NYKŠTUKAI;2276463136;Taip;7;4;0;11
14423;Zylutė;NYKŠTUKAI;7042731356;Taip;5;2;0;7
14424;Zylutė;NYKŠTUKAI;27488840113;Taip;0;4;0;4
14425;Zylutė;NYKŠTUKAI;35300054087;Taip;0;7;0;7
14426;Zylutė;NYKŠTUKAI;1699222615;Taip;0;2;1;3
14427;Zylutė;NYKŠTUKAI;3246229837;Taip;12;1;1;14
14428;Zylutė;NYKŠTUKAI;6324036463;Taip;0;8;1;9
14429;Zylutė;NYKŠTUKAI;4394023057;Taip;8;1;0;9
14430;Zylutė;NYKŠTUKAI;2153133102;Taip;0;6;0;6
14431;Zylutė;NYKŠTUKAI;2910542367;Taip;0;9;1;10
14432;Zylutė;NYKŠTUKAI;8141884164;Taip;7;6;0;13
14433;Zylutė;NYKŠTUKAI;49606187547;Taip;0;2;7;9
14434;Zylutė;Ručijok;6112586092;Taip;0;7;0;7
14435;Zylutė;Ručijok;5045652581;Taip;9;8;0;17
14436;Zylutė;Ručijok;3547185618;Taip;12;0;0;12
14437;Zylutė;Ručijok;9913001904;Taip;7;2;0;9
14438;Zylutė;Ručijok;7241045507;Taip;3;0;1;4
14439;Zylutė;Ručijok;9381656201;Taip;12;0;0;12
14440;Zylutė;Ručijok;2654373943;Taip;20;0;0;20
14441;Zylutė;Ručijok;4497904128;Taip;8;10;0;18
14442;Zylutė;Ručijok;9586800176;Taip;15;2;0;17
14443;Zylutė;Ručijok;3355159275;Taip;13;1;0;14
14444;Zylutė;Ručijok;9995791665;Taip;6;2;0;8
14445;Zylutė;Ručijok;4916625058;Taip;17;0;0;17
14446;Zylutė;Ručijok;8178488164;Taip;10;4;0;14
14447;Zylutė;Ručijok;6848387941;Ne;21;0;0;21
14448;Zylutė;Ručijok;6962852787;Taip;11;4;0;15
14449;Zylutė;Ručijok;4548205666;Taip;11;4;0;15
14450;Zylutė;Ručijok;9220918504;Taip;11;4;0;15
14451;Zylutė;Raduga;9325387975;Taip;7;6;0;13
14452;Zylutė;Raduga;3363212754;Taip;5;7;0;12
14453;Zylutė;Raduga;6569135467;Taip;15;0;0;15
14454;Zylutė;Raduga;4415020772;Taip;9;0;0;9
14455;Zylutė;Raduga;3117948118;Taip;7;0;8;15
14456;Zylutė;Raduga;2654794460;Taip;12;0;0;12
14457;Zylutė;Raduga;1423890598;Taip;15;0;0;15
14458;Zylutė;Raduga;3826815202;Taip;7;0;0;7
14459;Zylutė;Raduga;3943002728;Taip;7;4;0;11
14460;Zylutė;Raduga;4043810535;Taip;16;3;0;19
14461;Zylutė;Raduga;2107123106;Ne;21;0;0;21
14462;Zylutė;Raduga;7482740111;Taip;0;0;8;8
14463;Zylutė;Raduga;6995285377;Ne;0;9;0;9
14464;Zylutė;Raduga;2559643556;Taip;12;1;0;13
14465;Zylutė;Raduga;7824348276;Ne;11;2;0;13
14466;Zylutė;Raduga;4811667497;Ne;17;4;0;21
14467;Zylutė;Raduga;5683151005;Taip;0;4;0;4
14468;Zylutė;Raduga;2681013154;Taip;10;0;0;10
14469;Zylutė;Raduga;6391999153;Taip;7;1;0;8
14470;Zylutė;Raduga;6833030749;Taip;7;9;0;16
14471;Zylutė;Raduga;4493469560;Taip;0;0;2;2
14472;Zylutė;Raduga;4416434150;Taip;0;0;3;3
14473;Zylutė;Raduga;3608920051;Taip;7;4;0;11
14474;Zylutė;"Miki Maus";5670953383;Taip;2;0;5;7
14475;Zylutė;"Miki Maus";5027134228;Taip;0;13;0;13
14476;Zylutė;"Miki Maus";4715704693;Taip;0;0;10;10
14477;Zylutė;"Miki Maus";4543822765;Taip;14;4;0;18
14478;Zylutė;"Miki Maus";4566817285;Ne;7;0;4;11
14479;Zylutė;"Miki Maus";9457457032;Taip;16;0;0;16
14480;Zylutė;"Miki Maus";1290248125;Ne;15;0;0;15
14481;Zylutė;"Miki Maus";1580781723;Taip;15;0;0;15
14482;Zylutė;"Miki Maus";3633983359;Taip;14;0;2;16
14483;Zylutė;"Miki Maus";6833822248;Taip;13;0;0;13
14484;Zylutė;"Miki Maus";5589330186;Taip;7;0;0;7
14485;Zylutė;"Miki Maus";9162232979;Taip;15;0;3;18
14486;Zylutė;"Miki Maus";3848401615;Taip;9;0;1;10
14487;Zylutė;"Miki Maus";5577339739;Taip;20;0;0;20
14488;Zylutė;"Miki Maus";1455822427;Taip;14;0;0;14
14489;Zylutė;"Miki Maus";3332865242;Taip;4;0;4;8
14490;Zylutė;"Miki Maus";2999425729;Ne;13;0;2;15
14491;Zylutė;Solnyško;52293061924;Taip;0;10;0;10
14492;Zylutė;Solnyško;50784859977;Taip;0;4;0;4
14493;Zylutė;Solnyško;1212526573;Taip;7;0;0;7
14494;Zylutė;Solnyško;2020113161;Taip;10;0;0;10
14495;Zylutė;Solnyško;2058827699;Taip;2;3;0;5
14496;Zylutė;Solnyško;16723015849;Taip;17;0;0;17
14497;Zylutė;Solnyško;53283282669;Taip;3;4;0;7
14498;Zylutė;Solnyško;98295398362;Taip;12;6;0;18
14499;Zylutė;Solnyško;63287117036;Ne;0;12;0;12
14500;Zylutė;Solnyško;1004049147;Taip;0;1;0;1
14501;Zylutė;Solnyško;8582483538;Taip;0;4;0;4
14502;Zylutė;Solnyško;1979823314;Taip;0;11;0;11
14503;Zylutė;Solnyško;9728065395;Taip;7;6;0;13
14504;Zylutė;Solnyško;36486637873;Ne;0;2;0;2
14505;Zylutė;Solnyško;91938227358;Ne;2;10;0;12
14506;Zylutė;Solnyško;55672880453;Ne;3;4;0;7
14507;Zylutė;Solnyško;63798640792;Taip;5;8;0;13
14508;Zylutė;Solnyško;1059365398;Taip;10;5;0;15
14509;Zylutė;Solnyško;91534371407;Taip;0;4;14;18
14510;Zylutė;Motyliok;45252076215;Ne;19;2;0;21
14511;Zylutė;Motyliok;45779928616;Taip;3;6;0;9
14512;Zylutė;Motyliok;31724596372;Taip;10;0;0;10
14513;Zylutė;Motyliok;1001570452;Taip;2;1;0;3
14514;Zylutė;Motyliok;1598044320;Taip;9;1;0;10
14515;Zylutė;Motyliok;20333534526;Taip;10;0;0;10
14516;Zylutė;Motyliok;1756267879;Taip;18;0;0;18
14517;Zylutė;Motyliok;1897162912;Taip;10;0;0;10
14518;Zylutė;Motyliok;1801436436;Taip;10;0;0;10
14519;Zylutė;Motyliok;1445891751;Taip;5;6;0;11
14520;Zylutė;Motyliok;1284845681;Taip;15;5;0;20
14521;Zylutė;Motyliok;1873200936;Taip;7;0;0;7
14522;Zylutė;Motyliok;86763862813;Taip;7;0;0;7
14523;Zylutė;Motyliok;8546942240;Taip;0;0;21;21
14524;Zylutė;Motyliok;7298260831;Taip;9;0;0;9
14525;Zylutė;Motyliok;2306517891;Taip;0;7;0;7
14526;Zylutė;Motyliok;23826981323;Taip;11;7;0;18
14527;Zylutė;Motyliok;1145364380;Taip;11;7;0;18
14528;Zylutė;Motyliok;7712651566;Ne;0;3;0;3
14529;Zylutė;Motyliok;42101273435;Taip;9;1;0;10
14530;Zylutė;Motyliok;35364823312;Taip;0;6;0;6
14531;Zylutė;ŽVIRBLIUKAI;20569748356;Ne;2;4;0;6
14532;Zylutė;ŽVIRBLIUKAI;8783866036;Taip;13;5;0;18
14533;Zylutė;ŽVIRBLIUKAI;2274290871;Taip;14;6;0;20
14534;Zylutė;ŽVIRBLIUKAI;9902286013;Taip;10;0;0;10
14535;Zylutė;ŽVIRBLIUKAI;4154010905;Taip;6;0;0;6
14536;Zylutė;ŽVIRBLIUKAI;1972826928;Taip;0;4;0;4
14537;Zylutė;ŽVIRBLIUKAI;3919565034;Taip;9;0;0;9
14538;Zylutė;ŽVIRBLIUKAI;6865973084;Ne;0;1;1;2
14539;Zylutė;ŽVIRBLIUKAI;2744516236;Taip;0;13;0;13
14540;Zylutė;ŽVIRBLIUKAI;1939618217;Taip;5;0;0;5
14541;Zylutė;ŽVIRBLIUKAI;8627523283;Taip;5;0;0;5
14542;Zylutė;ŽVIRBLIUKAI;3606566852;Taip;12;9;0;21
14543;Zylutė;ŽVIRBLIUKAI;8874692591;Taip;11;4;0;15
14544;Zylutė;ŽVIRBLIUKAI;5431521522;Taip;2;9;0;11
14545;Zylutė;ŽVIRBLIUKAI;6548786007;Ne;3;6;0;9
14546;Zylutė;ŽVIRBLIUKAI;3074954453;Taip;0;4;0;4
14547;Zylutė;ŽVIRBLIUKAI;6221528830;Ne;7;2;1;10
14548;Zylutė;"DRUŽNYJE REBIATA";12377363480;Taip;14;0;0;14
14549;Zylutė;"DRUŽNYJE REBIATA";1428614163;Taip;10;0;0;10
14550;Zylutė;"DRUŽNYJE REBIATA";1674095701;Taip;16;2;0;18
14551;Zylutė;"DRUŽNYJE REBIATA";3379725202;Taip;5;0;0;5
14552;Zylutė;"DRUŽNYJE REBIATA";67435726524;Taip;0;4;0;4
14553;Zylutė;"DRUŽNYJE REBIATA";3843999609;Taip;17;0;0;17
14554;Zylutė;"DRUŽNYJE REBIATA";3036582121;Ne;0;12;0;12
14555;Zylutė;"DRUŽNYJE REBIATA";9163527400;Ne;0;12;0;12
14556;Zylutė;"DRUŽNYJE REBIATA";2157398751;Taip;12;0;0;12
14557;Zylutė;"DRUŽNYJE REBIATA";4302751308;Taip;11;0;0;11
14558;Zylutė;"DRUŽNYJE REBIATA";8293541980;Taip;21;0;0;21
14559;Zylutė;"DRUŽNYJE REBIATA";5452659798;Ne;18;0;0;18
14560;Zylutė;"DRUŽNYJE REBIATA";9589810356;Taip;6;3;0;9
14561;Zylutė;"DRUŽNYJE REBIATA";5224781417;Ne;0;8;0;8
14562;Zylutė;"DRUŽNYJE REBIATA";5162635301;Taip;17;0;0;17
14563;Zylutė;"DRUŽNYJE REBIATA";7023565057;Taip;21;0;0;21
14564;Zylutė;"DRUŽNYJE REBIATA";7804533930;Taip;3;8;0;11
14565;Zylutė;"DRUŽNYJE REBIATA";3254847545;Ne;9;4;0;13
14566;Zylutė;"DRUŽNYJE REBIATA";5803032683;Taip;17;0;0;17
14567;Zylutė;"DRUŽNYJE REBIATA";3089235413;Taip;9;0;4;13
14568;Zylutė;"DRUŽNYJE REBIATA";8180889070;Taip;19;0;0;19
14569;Zylutė;VIEVERSĖLIAI;2125519672;Taip;5;3;0;8
14570;Zylutė;VIEVERSĖLIAI;4505081448;Taip;0;5;0;5
14571;Zylutė;VIEVERSĖLIAI;72716975865;Taip;0;4;0;4
14572;Zylutė;VIEVERSĖLIAI;6275164528;Taip;0;5;0;5
14573;Zylutė;VIEVERSĖLIAI;5172154642;Taip;13;2;0;15
14574;Zylutė;VIEVERSĖLIAI;2943888466;Taip;0;9;0;9
14575;Zylutė;VIEVERSĖLIAI;6907378757;Taip;7;8;0;15
14576;Zylutė;VIEVERSĖLIAI;6723650872;Taip;0;4;0;4
14577;Zylutė;VIEVERSĖLIAI;3810636967;Ne;11;1;0;12
14578;Zylutė;VIEVERSĖLIAI;6154352500;Taip;0;6;0;6
14579;Zylutė;VIEVERSĖLIAI;4016518230;Taip;10;5;0;15
14580;Zylutė;VIEVERSĖLIAI;9660898505;Taip;0;9;0;9
14581;Zylutė;VIEVERSĖLIAI;57138305703;Ne;5;6;0;11
14582;Zylutė;VIEVERSĖLIAI;5544338521;Taip;5;1;0;6
14583;Zylutė;VIEVERSĖLIAI;4764295850;Taip;0;11;0;11
14584;Zylutė;VIEVERSĖLIAI;4966816780;Taip;0;0;10;10
14585;Želmenėliai;Bitučių;4681686872;Taip;0;3;0;3
14586;Želmenėliai;Bitučių;3268310531;Taip;7;2;0;9
14587;Želmenėliai;Bitučių;5211426226;Taip;21;0;0;21
14588;Želmenėliai;Bitučių;2122665619;Taip;0;1;0;1
14589;Želmenėliai;Bitučių;2563117992;Taip;7;0;0;7
14590;Želmenėliai;Bitučių;6799702725;Ne;0;5;0;5
14591;Želmenėliai;Bitučių;8358780570;Taip;0;3;2;5
14592;Želmenėliai;Bitučių;9006406225;Taip;0;7;1;8
14593;Želmenėliai;Bitučių;7423900312;Taip;13;0;0;13
14594;Želmenėliai;Bitučių;2102401372;Taip;0;2;0;2
14595;Želmenėliai;Bitučių;4931835807;Taip;0;10;0;10
14596;Želmenėliai;Bitučių;5147895081;Taip;0;6;0;6
14597;Želmenėliai;Bitučių;6481952132;Taip;0;1;0;1
14598;Želmenėliai;Bitučių;9611741258;Taip;0;3;0;3
14599;Želmenėliai;Bitučių;1619143702;Taip;0;10;0;10
14600;Želmenėliai;Bitučių;2794274146;Taip;19;0;0;19
14601;Želmenėliai;Bitučių;9825545754;Ne;9;1;0;10
14602;Želmenėliai;Bitučių;5314438217;Taip;0;12;0;12
14603;Želmenėliai;Bitučių;4927030144;Taip;21;0;0;21
14604;Želmenėliai;Bitučių;1751328192;Taip;0;11;0;11
14605;Želmenėliai;Kačiukų;53611793303;Taip;0;1;0;1
14606;Želmenėliai;Kačiukų;25991128602;Ne;8;5;0;13
14607;Želmenėliai;Kačiukų;50204719384;Taip;0;12;0;12
14608;Želmenėliai;Kačiukų;84671486637;Taip;0;3;0;3
14609;Želmenėliai;Kačiukų;75215159489;Taip;0;11;0;11
14610;Želmenėliai;Kačiukų;68168210430;Ne;0;6;0;6
14611;Želmenėliai;Kačiukų;52474082386;Taip;7;4;0;11
14612;Želmenėliai;Kačiukų;32945118976;Taip;0;5;1;6
14613;Želmenėliai;Kačiukų;72091418618;Taip;10;4;0;14
14614;Želmenėliai;Kačiukų;72029098066;Taip;0;4;0;4
14615;Želmenėliai;Kačiukų;80129197524;Ne;0;1;0;1
14616;Želmenėliai;Kačiukų;93374623931;Ne;0;0;1;1
14617;Želmenėliai;Kačiukų;25744693727;Taip;2;2;0;4
14618;Želmenėliai;Kačiukų;41941728755;Taip;0;3;1;4
14619;Želmenėliai;Kačiukų;98487229210;Taip;0;4;0;4
14620;Želmenėliai;Kačiukų;39766114351;Taip;4;2;0;6
14621;Želmenėliai;Kačiukų;11316462529;Taip;0;2;4;6
14622;Želmenėliai;Kačiukų;1064518850;Taip;0;7;0;7
14623;Želmenėliai;Kačiukų;1868937175;Taip;9;4;2;15
14624;Želmenėliai;Voveriukų;2066711124;Taip;0;3;0;3
14625;Želmenėliai;Voveriukų;5696221669;Taip;0;5;4;9
14626;Želmenėliai;Voveriukų;1799477959;Taip;4;1;0;5
14627;Želmenėliai;Voveriukų;3258904017;Taip;2;7;0;9
14628;Želmenėliai;Voveriukų;6783113916;Taip;2;6;0;8
14629;Želmenėliai;Voveriukų;2044063398;Taip;4;10;0;14
14630;Želmenėliai;Voveriukų;2005437403;Taip;10;5;0;15
14631;Želmenėliai;Voveriukų;1744939559;Taip;0;6;0;6
14632;Želmenėliai;Voveriukų;27187464726;Taip;1;12;0;13
14633;Želmenėliai;Voveriukų;1952686295;Taip;15;1;0;16
14634;Želmenėliai;Voveriukų;2836206893;Ne;0;3;0;3
14635;Želmenėliai;Voveriukų;1342094235;Ne;11;6;0;17
14636;Želmenėliai;Voveriukų;5214021520;Ne;0;6;6;12
14637;Želmenėliai;Voveriukų;3490705425;Ne;6;2;0;8
14638;Želmenėliai;Voveriukų;6478525575;Taip;3;13;0;16
14639;Želmenėliai;Voveriukų;2231634495;Taip;3;13;0;16
14640;Želmenėliai;Ežiukų;34055134038;Taip;0;3;5;8
14641;Želmenėliai;Ežiukų;63879513374;Ne;0;5;0;5
14642;Želmenėliai;Ežiukų;12336777368;Ne;0;5;0;5
14643;Želmenėliai;Ežiukų;65633625929;Ne;0;5;0;5
14644;Želmenėliai;Ežiukų;5345737656;Taip;0;3;0;3
14645;Želmenėliai;Ežiukų;16400566719;Taip;0;12;0;12
14646;Želmenėliai;Ežiukų;22209426414;Taip;7;5;0;12
14647;Želmenėliai;Ežiukų;21636460884;Taip;0;8;0;8
14648;Želmenėliai;Ežiukų;90992236935;Taip;0;3;0;3
14649;Želmenėliai;Ežiukų;8394779853;Taip;3;4;0;7
14650;Želmenėliai;Ežiukų;1425695010;Taip;3;6;0;9
14651;Želmenėliai;Ežiukų;9234190447;Taip;0;2;0;2
14652;Želmenėliai;Ežiukų;10686783804;Ne;0;2;0;2
14653;Želmenėliai;Ežiukų;21263242044;Taip;0;3;0;3
14654;Želmenėliai;Ežiukų;77946540922;Taip;5;8;0;13
14655;Želmenėliai;Ežiukų;8218755050;Taip;0;5;0;5
14656;Želmenėliai;Ežiukų;68226657214;Taip;0;1;0;1
14657;Želmenėliai;Ežiukų;10990624964;Ne;7;9;0;16
14658;Želmenėliai;Peledžiukų;4206128805;Taip;6;5;0;11
14659;Želmenėliai;Peledžiukų;6816346946;Taip;0;11;0;11
14660;Želmenėliai;Peledžiukų;9359070885;Ne;4;4;0;8
14661;Želmenėliai;Peledžiukų;2727113833;Taip;3;0;0;3
14662;Želmenėliai;Peledžiukų;5787772212;Taip;0;5;0;5
14663;Želmenėliai;Peledžiukų;1239398642;Taip;0;4;0;4
14664;Želmenėliai;Peledžiukų;1248541555;Taip;0;4;0;4
14665;Želmenėliai;Peledžiukų;8995804360;Taip;0;14;0;14
14666;Želmenėliai;Peledžiukų;1522141057;Taip;12;4;2;18
14667;Želmenėliai;Peledžiukų;5616709457;Ne;11;0;0;11
14668;Želmenėliai;Peledžiukų;8300887366;Taip;7;0;0;7
14669;Želmenėliai;Peledžiukų;96660519820;Taip;5;6;0;11
14670;Želmenėliai;Peledžiukų;9375550172;Ne;6;1;0;7
14671;Želmenėliai;Peledžiukų;8478564831;Taip;0;3;0;3
14672;Želmenėliai;Peledžiukų;1941723687;Taip;5;8;0;13
14673;Želmenėliai;Peledžiukų;8590746750;Taip;10;6;0;16
14674;Želmenėliai;Peledžiukų;1343084840;Ne;0;8;0;8
14675;Želmenėliai;Drugelių;7664430346;Ne;7;0;3;10
14676;Želmenėliai;Drugelių;3417538909;Taip;0;4;0;4
14677;Želmenėliai;Drugelių;3295852546;Ne;11;6;0;17
14678;Želmenėliai;Drugelių;4739083871;Taip;6;0;0;6
14679;Želmenėliai;Drugelių;3379266015;Taip;2;4;0;6
14680;Želmenėliai;Drugelių;3737786832;Ne;5;5;0;10
14681;Želmenėliai;Drugelių;5633127620;Taip;2;10;0;12
14682;Želmenėliai;Drugelių;1984105453;Taip;17;4;0;21
14683;Želmenėliai;Drugelių;1920917916;Taip;18;0;0;18
14684;Želmenėliai;Drugelių;4652412483;Taip;0;11;0;11
14685;Želmenėliai;Drugelių;1652949383;Taip;0;3;0;3
14686;Želmenėliai;Drugelių;5046836398;Taip;9;3;0;12
14687;Želmenėliai;Drugelių;9237611484;Taip;0;0;2;2
14688;Želmenėliai;Drugelių;13558387807;Taip;0;5;0;5
14689;Želmenėliai;Drugelių;5143554665;Taip;9;5;0;14
14690;Želmenėliai;Drugelių;7585159351;Ne;0;10;0;10
14691;Želmenėliai;Drugelių;9207984505;Taip;0;5;0;5
14692;Želmenėliai;Drugelių;4634346755;Taip;2;6;2;10
14693;Želmenėliai;Drugelių;4916436238;Taip;0;8;0;8
14694;Želmenėliai;Drugelių;5558795651;Taip;0;12;0;12
14695;Želmenėliai;Voriukų;4264751761;Taip;9;0;0;9
14696;Želmenėliai;Voriukų;3184074698;Taip;0;1;0;1
14697;Želmenėliai;Voriukų;1203343580;Taip;10;6;0;16
14698;Želmenėliai;Voriukų;9351650342;Ne;0;10;0;10
14699;Želmenėliai;Voriukų;3014568232;Ne;0;3;0;3
14700;Želmenėliai;Voriukų;6916426436;Taip;0;2;0;2
14701;Želmenėliai;Voriukų;7563461821;Taip;0;7;0;7
14702;Želmenėliai;Voriukų;4534946646;Taip;3;1;0;4
14703;Želmenėliai;Voriukų;4075533071;Taip;0;8;0;8
14704;Želmenėliai;Voriukų;8504963337;Taip;0;8;0;8
14705;Želmenėliai;Voriukų;7505996978;Taip;14;1;0;15
14706;Želmenėliai;Voriukų;2846903449;Taip;21;0;0;21
14707;Želmenėliai;Voriukų;4473677352;Taip;10;1;0;11
14708;Želmenėliai;Voriukų;8973215240;Taip;0;9;0;9
14709;Želmenėliai;Voriukų;2722619508;Taip;0;8;0;8
14710;Želmenėliai;Voriukų;5025345647;Taip;0;8;0;8
14711;Želmenėliai;Voriukų;3043560150;Taip;9;0;1;10
14712;Želmenėliai;Voriukų;8892137326;Taip;0;15;0;15
14713;Želmenėliai;Boružėlių;51756630728;Taip;0;13;0;13
14714;Želmenėliai;Boružėlių;22539846993;Taip;0;1;0;1
14715;Želmenėliai;Boružėlių;5223588064;Ne;0;1;0;1
14716;Želmenėliai;Boružėlių;91372955120;Taip;0;3;0;3
14717;Želmenėliai;Boružėlių;2898358705;Taip;2;0;0;2
14718;Želmenėliai;Boružėlių;63043069680;Taip;0;4;0;4
14719;Želmenėliai;Boružėlių;10462964817;Taip;2;7;0;9
14720;Želmenėliai;Boružėlių;2103938312;Taip;0;5;0;5
14721;Želmenėliai;Boružėlių;35901929384;Taip;0;12;0;12
14722;Želmenėliai;Boružėlių;39675390598;Taip;0;9;0;9
14723;Želmenėliai;Boružėlių;1290780920;Taip;7;4;0;11
14724;Želmenėliai;Boružėlių;1699958696;Taip;0;10;0;10
14725;Želmenėliai;Boružėlių;98852944217;Ne;0;7;0;7
14726;Želmenėliai;Boružėlių;7502363323;Ne;7;7;0;14
14727;Želmenėliai;Boružėlių;1009164107;Taip;12;4;0;16
14728;Želmenėliai;Boružėlių;92486344928;Taip;0;10;0;10
14729;Želmenėliai;Boružėlių;1802714172;Taip;0;4;0;4
14730;Želmenėliai;Boružėlių;1933769076;Taip;0;7;0;7
14731;Želmenėliai;Boružėlių;1134743316;Taip;21;0;0;21
14732;Želmenėliai;Boružėlių;9414488405;Taip;21;0;0;21
14733;Želmenėliai;Pūkuotukų;73813829491;Taip;16;2;0;18
14734;Želmenėliai;Pūkuotukų;79879695958;Taip;13;0;0;13
14735;Želmenėliai;Pūkuotukų;54536849345;Taip;0;5;0;5
14736;Želmenėliai;Pūkuotukų;8936734213;Taip;3;1;0;4
14737;Želmenėliai;Pūkuotukų;1213403598;Taip;0;2;0;2
14738;Želmenėliai;Pūkuotukų;1803684569;Ne;0;4;0;4
14739;Želmenėliai;Pūkuotukų;1716801722;Taip;6;8;0;14
14740;Želmenėliai;Pūkuotukų;45440599686;Taip;0;14;0;14
14741;Želmenėliai;Pūkuotukų;50805473649;Taip;0;4;0;4
14742;Želmenėliai;Pūkuotukų;1405460015;Ne;0;7;0;7
14743;Želmenėliai;Pūkuotukų;85619767784;Taip;14;1;0;15
14744;Želmenėliai;Pūkuotukų;1800724034;Taip;0;1;11;12
14745;Želmenėliai;Pūkuotukų;74037118861;Taip;0;7;0;7
14746;Želmenėliai;Pūkuotukų;8706951420;Taip;0;4;0;4
14747;Želmenėliai;Pūkuotukų;1426827854;Taip;0;6;0;6
14748;Želmenėliai;Pūkuotukų;1619412305;Taip;4;2;0;6
14749;Želmenėliai;Pūkuotukų;75198661944;Taip;1;9;0;10
14750;Želmenėliai;Pūkuotukų;2036184590;Taip;0;6;0;6
14751;Želmenėliai;Pūkuotukų;72855365141;Taip;0;2;0;2
14752;Želmenėliai;Pūkuotukų;22138795060;Taip;0;2;0;2
14753;Želmenėliai;Pūkuotukų;37152467004;Taip;0;8;0;8
14754;Želmenėliai;Ančiukų;9493581034;Taip;19;0;0;19
14755;Želmenėliai;Ančiukų;6509783586;Taip;5;6;0;11
14756;Želmenėliai;Ančiukų;8987377791;Taip;0;7;0;7
14757;Želmenėliai;Ančiukų;4126499046;Taip;6;0;0;6
14758;Želmenėliai;Ančiukų;4758240577;Taip;11;1;0;12
14759;Želmenėliai;Ančiukų;7197717698;Taip;7;0;2;9
14760;Želmenėliai;Ančiukų;2570248893;Taip;9;6;0;15
14761;Želmenėliai;Ančiukų;2577850672;Taip;0;6;0;6
14762;Želmenėliai;Ančiukų;2111008869;Taip;16;1;0;17
14763;Želmenėliai;Ančiukų;4198085732;Taip;6;0;0;6
14764;Želmenėliai;Ančiukų;5929410363;Taip;11;8;0;19
14765;Želmenėliai;Ančiukų;7849682820;Taip;16;3;0;19
14766;Želmenėliai;Ančiukų;4589396143;Taip;12;4;1;17
14767;Želmenėliai;Ančiukų;7094853897;Taip;16;0;0;16
14768;Želmenėliai;Ančiukų;5281861477;Taip;8;0;0;8
14769;Želmenėliai;Nykštukų;1652131150;Ne;3;2;0;5
14770;Želmenėliai;Nykštukų;2350936740;Taip;12;4;0;16
14771;Želmenėliai;Nykštukų;4931664953;Taip;10;1;0;11
14772;Želmenėliai;Nykštukų;3063417708;Taip;0;3;0;3
14773;Želmenėliai;Nykštukų;6635909614;Taip;0;5;0;5
14774;Želmenėliai;Nykštukų;8954705816;Taip;21;0;0;21
14775;Želmenėliai;Nykštukų;5795735579;Taip;8;0;0;8
14776;Želmenėliai;Nykštukų;1292462938;Taip;11;0;0;11
14777;Želmenėliai;Nykštukų;3353793939;Taip;8;0;0;8
14778;Želmenėliai;Nykštukų;7495157523;Taip;8;0;0;8
14779;Želmenėliai;Nykštukų;8519608506;Ne;0;2;0;2
14780;Želmenėliai;Lašelių;8154713582;Taip;9;0;4;13
14781;Želmenėliai;Lašelių;5171736943;Taip;4;8;0;12
14782;Želmenėliai;Lašelių;6876147546;Taip;0;12;0;12
14783;Želmenėliai;Lašelių;9126715074;Taip;0;4;0;4
14784;Želmenėliai;Lašelių;6180553648;Taip;0;8;0;8
14785;Želmenėliai;Lašelių;1260607572;Taip;0;2;0;2
14786;Želmenėliai;Lašelių;4120125150;Taip;10;1;0;11
14787;Želmenėliai;Lašelių;3972980949;Taip;0;3;0;3
14788;Želmenėliai;Lašelių;2296870749;Taip;12;0;0;12
14789;Želmenėliai;Lašelių;2262009049;Taip;7;4;0;11
14790;Želmenėliai;Lašelių;6779746783;Taip;18;0;0;18
14791;Želmenėliai;Lašelių;5750337167;Taip;17;1;0;18
14792;Žemyna;Čiauškučiai;2003368811;Taip;9;0;0;9
14793;Žemyna;Čiauškučiai;9130965949;Taip;0;4;7;11
14794;Žemyna;Čiauškučiai;58578414067;Taip;10;4;0;14
14795;Žemyna;Čiauškučiai;1694969407;Ne;6;0;2;8
14796;Žemyna;Čiauškučiai;88775150201;Taip;6;4;0;10
14797;Žemyna;Čiauškučiai;1683299408;Taip;0;5;0;5
14798;Žemyna;Čiauškučiai;39175264243;Taip;0;3;0;3
14799;Žemyna;Čiauškučiai;35462796459;Taip;3;11;0;14
14800;Žemyna;Čiauškučiai;50543973728;Taip;17;0;0;17
14801;Žemyna;Čiauškučiai;1595030102;Ne;9;0;4;13
14802;Žemyna;Čiauškučiai;6448628301;Taip;12;4;0;16
14803;Žemyna;Čiauškučiai;1421842247;Taip;9;1;0;10
14804;Žemyna;Čiauškučiai;47562685723;Taip;2;4;1;7
14805;Žemyna;Čiauškučiai;32755929074;Taip;4;11;0;15
14806;Žemyna;Čiauškučiai;54253890981;Taip;6;4;1;11
14807;Žemyna;Čiauškučiai;54823974018;Taip;3;8;0;11
14808;Žemyna;Čiauškučiai;1049546597;Taip;6;4;2;12
14809;Žemyna;Čiauškučiai;99015221693;Taip;0;4;1;5
14810;Žemyna;Čiauškučiai;8096035110;Taip;0;0;7;7
14811;Žemyna;Čiauškučiai;38604851102;Taip;2;0;11;13
14812;Žemyna;Čiauškučiai;1305667359;Taip;9;1;6;16
14813;Žemyna;Čiauškučiai;6089122225;Taip;9;2;0;11
14814;Žemyna;Čiauškučiai;7343337032;Taip;0;4;7;11
14815;Žemyna;Nykštukai;5114094924;Taip;4;6;0;10
14816;Žemyna;Nykštukai;3874855308;Taip;0;0;1;1
14817;Žemyna;Nykštukai;2461700030;Taip;4;4;0;8
14818;Žemyna;Nykštukai;1725771976;Taip;0;0;1;1
14819;Žemyna;Nykštukai;8622780639;Taip;9;0;0;9
14820;Žemyna;Nykštukai;3643594001;Ne;5;3;0;8
14821;Žemyna;Nykštukai;9182709647;Taip;5;1;0;6
14822;Žemyna;Nykštukai;7121742098;Taip;12;0;1;13
14823;Žemyna;Nykštukai;3519840747;Ne;0;0;3;3
14824;Žemyna;Nykštukai;4265606762;Taip;7;0;0;7
14825;Žemyna;Nykštukai;4821941126;Taip;2;0;0;2
14826;Žemyna;Nykštukai;1468040559;Taip;21;0;0;21
14827;Žemyna;Nykštukai;4322192775;Taip;7;4;0;11
14828;Žemyna;Nykštukai;4444870782;Taip;0;6;3;9
14829;Žemyna;Nykštukai;7781924111;Taip;0;3;0;3
14830;Žemyna;Nykštukai;4257096808;Ne;0;5;0;5
14831;Žemyna;Nykštukai;1575505075;Taip;10;2;3;15
14832;Žemyna;Nykštukai;2860210906;Taip;5;0;0;5
14833;Žemyna;Nykštukai;7832066079;Ne;6;0;0;6
14834;Žemyna;Nykštukai;4759403487;Taip;0;6;0;6
14835;Žemyna;Nykštukai;9653530823;Taip;0;5;0;5
14836;Žemyna;Nykštukai;7508491119;Taip;0;1;2;3
14837;Žemyna;Nykštukai;2928125522;Ne;3;1;0;4
14838;Žemyna;Voveriukai;3135562485;Taip;5;4;3;12
14839;Žemyna;Voveriukai;2976467316;Taip;0;4;0;4
14840;Žemyna;Voveriukai;5940619734;Taip;3;4;0;7
14841;Žemyna;Voveriukai;6812823390;Taip;8;1;0;9
14842;Žemyna;Voveriukai;8500642069;Taip;0;6;0;6
14843;Žemyna;Voveriukai;6430348135;Taip;5;1;0;6
14844;Žemyna;Voveriukai;7925774308;Taip;8;0;2;10
14845;Žemyna;Voveriukai;2412956023;Taip;0;3;0;3
14846;Žemyna;Voveriukai;7341750699;Taip;0;0;1;1
14847;Žemyna;Voveriukai;9958040413;Ne;20;0;0;20
14848;Žemyna;Voveriukai;1531980297;Taip;5;0;4;9
14849;Žemyna;Voveriukai;1114714466;Taip;5;0;6;11
14850;Žemyna;Voveriukai;1807466584;Taip;19;0;0;19
14851;Žemyna;Voveriukai;1543415914;Taip;7;4;3;14
14852;Žemyna;Voveriukai;7125026803;Taip;0;4;7;11
14853;Žemyna;Voveriukai;9148594407;Taip;12;5;0;17
14854;Žemyna;Voveriukai;6701717634;Taip;0;4;0;4
14855;Žemyna;Voveriukai;9866110744;Taip;0;0;1;1
14856;Žemyna;Voveriukai;7693278353;Taip;0;4;3;7
14857;Žemyna;Voveriukai;1118997229;Taip;5;0;0;5
14858;Žemyna;Voveriukai;3357339710;Taip;8;0;7;15
14859;Žemyna;Kiškučiai;1566781183;Ne;1;2;1;4
14860;Žemyna;Kiškučiai;26124703883;Taip;6;3;0;9
14861;Žemyna;Kiškučiai;1688122673;Taip;0;7;0;7
14862;Žemyna;Kiškučiai;5635456615;Taip;7;4;5;16
14863;Žemyna;Kiškučiai;1947185865;Taip;0;4;3;7
14864;Žemyna;Kiškučiai;6647400698;Ne;0;3;0;3
14865;Žemyna;Kiškučiai;23371576969;Ne;0;4;1;5
14866;Žemyna;Kiškučiai;5830320758;Taip;7;10;0;17
14867;Žemyna;Kiškučiai;6148416514;Taip;0;21;0;21
14868;Žemyna;Kiškučiai;1380225362;Taip;8;4;0;12
14869;Žemyna;Kiškučiai;88687293547;Ne;0;5;0;5
14870;Žemyna;Kiškučiai;43607772302;Taip;0;4;0;4
14871;Žemyna;Kiškučiai;1265326169;Taip;0;4;4;8
14872;Žemyna;Kiškučiai;2032992299;Taip;0;3;1;4
14873;Žemyna;Kiškučiai;1210307182;Taip;0;4;0;4
14874;Žemyna;Kiškučiai;4570281722;Ne;5;4;2;11
14875;Žemyna;Kiškučiai;2073608501;Taip;0;4;0;4
14876;Žemyna;Kiškučiai;92534877861;Taip;0;4;0;4
14877;Žemyna;Kiškučiai;1716821186;Ne;0;4;1;5
14878;Žemyna;Kiškučiai;75681135185;Taip;0;4;2;6
14879;Žemyna;Kiškučiai;15573695823;Taip;0;1;0;1
14880;Žemyna;Kiškučiai;2072914123;Taip;0;4;0;4
14881;Žemyna;Kiškučiai;8292265369;Taip;0;0;1;1
14882;Žemyna;Vyturiukai;9232638767;Taip;6;0;0;6
14883;Žemyna;Vyturiukai;38769607968;Taip;0;4;3;7
14884;Žemyna;Vyturiukai;47470155594;Taip;2;0;5;7
14885;Žemyna;Vyturiukai;17098859260;Taip;11;5;0;16
14886;Žemyna;Vyturiukai;1687206394;Taip;9;0;0;9
14887;Žemyna;Vyturiukai;5508251792;Taip;5;4;0;9
14888;Žemyna;Vyturiukai;85135645557;Taip;9;1;0;10
14889;Žemyna;Vyturiukai;59506345859;Taip;0;4;1;5
14890;Žemyna;Vyturiukai;89787441782;Taip;0;5;0;5
14891;Žemyna;Vyturiukai;5506889213;Taip;0;2;0;2
14892;Žemyna;Vyturiukai;5306392307;Taip;9;4;2;15
14893;Žemyna;Vyturiukai;9018138289;Taip;0;3;3;6
14894;Žemyna;Vyturiukai;37570629861;Ne;5;12;0;17
14895;Žemyna;Vyturiukai;13242930752;Taip;3;5;0;8
14896;Žemyna;Vyturiukai;96473502730;Taip;14;0;0;14
14897;Žemyna;Vyturiukai;94548785045;Taip;8;0;0;8
14898;Žemyna;Vyturiukai;93423088394;Taip;0;4;0;4
14899;Žemyna;Vyturiukai;8040359407;Taip;10;4;2;16
14900;Žemyna;Vyturiukai;55161890341;Ne;12;4;0;16
14901;Žemyna;Vyturiukai;6618285685;Taip;0;4;0;4
14902;Žemyna;Vyturiukai;4524929331;Taip;14;0;0;14
14903;Žemyna;Vyturiukai;3622634119;Ne;9;0;1;10
14904;Žemyna;Vyturiukai;4235160760;Taip;14;0;0;14
14905;Žemyna;Pelėdžiukai;68982161758;Taip;0;4;0;4
14906;Žemyna;Pelėdžiukai;2972633401;Ne;0;4;0;4
14907;Žemyna;Pelėdžiukai;69634515292;Taip;0;2;0;2
14908;Žemyna;Pelėdžiukai;65677663175;Taip;0;2;1;3
14909;Žemyna;Pelėdžiukai;74969696164;Taip;0;3;3;6
14910;Žemyna;Pelėdžiukai;47974278492;Taip;0;6;1;7
14911;Žemyna;Pelėdžiukai;92159859248;Taip;0;4;1;5
14912;Žemyna;Pelėdžiukai;10344263960;Taip;0;4;6;10
14913;Žemyna;Pelėdžiukai;54029612806;Taip;0;9;0;9
14914;Žemyna;Pelėdžiukai;93378737171;Taip;0;6;0;6
14915;Žemyna;Pelėdžiukai;6546437872;Taip;0;4;1;5
14916;Žemyna;Pelėdžiukai;5204796908;Taip;0;3;1;4
14917;Žemyna;Pelėdžiukai;9556275322;Taip;0;4;3;7
14918;Žemyna;Pelėdžiukai;78280621543;Taip;8;8;0;16
14919;Žemyna;Pelėdžiukai;81683768388;Taip;4;0;0;4
14920;Žemyna;Pelėdžiukai;65117735882;Taip;2;4;1;7
14921;Žemyna;Pelėdžiukai;59441904717;Taip;12;4;1;17
14922;Žemyna;Pelėdžiukai;97712802830;Taip;0;5;0;5
14923;Žemyna;Pelėdžiukai;70694756261;Taip;5;4;2;11
14924;Žemyna;Pelėdžiukai;45269313606;Taip;5;4;0;9
14925;Žemyna;Pelėdžiukai;30518889603;Taip;2;0;0;2
14926;Žemyna;Pelėdžiukai;1674165765;Taip;0;4;0;4
14927;Žemyna;Pelėdžiukai;2033947862;Taip;0;3;1;4
14928;Žemyna;Pelėdžiukai;1337500221;Taip;0;4;2;6
14929;Žemyna;Vijurkai;96099047169;Taip;7;0;0;7
14930;Žemyna;Vijurkai;85617781303;Taip;9;0;0;9
14931;Žemyna;Vijurkai;62565967575;Taip;0;5;0;5
14932;Žemyna;Vijurkai;1535497308;Taip;0;2;1;3
14933;Žemyna;Vijurkai;1158352472;Ne;7;4;0;11
14934;Žemyna;Vijurkai;25099273803;Taip;0;1;1;2
14935;Žemyna;Vijurkai;10288969939;Taip;1;4;1;6
14936;Žemyna;Vijurkai;40843229500;Ne;5;4;3;12
14937;Žemyna;Vijurkai;69690099920;Taip;8;1;0;9
14938;Žemyna;Vijurkai;98477626952;Taip;5;0;1;6
14939;Žemyna;Vijurkai;71013970407;Taip;0;4;4;8
14940;Žemyna;Vijurkai;87939385151;Taip;8;4;0;12
14941;Žemyna;Vijurkai;56418377668;Taip;4;1;0;5
14942;Žemyna;Vijurkai;46550223916;Taip;7;0;0;7
14943;Žemyna;Vijurkai;98919412716;Taip;0;2;4;6
14944;Žemyna;Vijurkai;1866645242;Ne;6;4;0;10
14945;Žemyna;Vijurkai;83056273504;Taip;0;0;6;6
14946;Žemyna;Vijurkai;1609941314;Ne;10;4;0;14
14947;Žemyna;Vijurkai;1790109762;Taip;5;4;0;9
14948;Žemyna;Vijurkai;89754744294;Taip;5;2;0;7
14949;Žemyna;Vijurkai;1393006122;Taip;5;3;0;8
14950;Žemyna;Vijurkai;9409512255;Taip;0;11;0;11
14951;Žemyna;Vijurkai;55748223762;Taip;4;3;5;12
14952;Žemyna;Šnekučiai;9501126807;Taip;0;4;0;4
14953;Žemyna;Šnekučiai;6735720135;Taip;10;0;7;17
14954;Žemyna;Šnekučiai;9912869400;Taip;18;0;0;18
14955;Žemyna;Šnekučiai;2006173745;Taip;15;0;0;15
14956;Žemyna;Šnekučiai;6116581655;Taip;10;0;0;10
14957;Žemyna;Šnekučiai;5727308039;Taip;0;5;0;5
14958;Žemyna;Šnekučiai;7367602247;Taip;0;8;0;8
14959;Žemyna;Šnekučiai;7280740926;Taip;4;0;1;5
14960;Žemyna;Šnekučiai;6419974691;Taip;0;4;9;13
14961;Žemyna;Šnekučiai;9818711030;Taip;4;0;0;4
14962;Žemyna;Šnekučiai;9219519029;Ne;2;12;0;14
14963;Žemyna;Šnekučiai;6293560729;Taip;16;0;0;16
14964;Žemyna;Šnekučiai;7764615445;Taip;0;0;4;4
14965;Žemyna;Šnekučiai;5868208651;Ne;0;1;0;1
14966;Žemyna;Šnekučiai;3992383447;Taip;10;2;0;12
14967;Žemyna;Šnekučiai;9668975591;Taip;0;2;2;4
14968;Žemyna;Šnekučiai;6856737270;Ne;0;5;1;6
14969;Žemyna;Šnekučiai;5188496664;Taip;17;0;0;17
14970;Žemyna;Šnekučiai;4872348199;Taip;11;0;0;11
14971;Žemyna;Šnekučiai;6878669773;Taip;2;0;2;4
14972;Žemyna;Šnekučiai;4502958166;Ne;16;1;0;17
14973;Žemyna;Šnekučiai;5688714928;Taip;4;0;0;4
14974;Žemyna;Pabiručiai;3596822649;Taip;9;0;1;10
14975;Žemyna;Pabiručiai;86746604640;Taip;0;0;1;1
14976;Žemyna;Pabiručiai;6775880309;Taip;10;4;0;14
14977;Žemyna;Pabiručiai;82507236376;Taip;6;4;1;11
14978;Žemyna;Pabiručiai;84955588471;Taip;0;2;0;2
14979;Žemyna;Pabiručiai;80737839511;Taip;0;11;0;11
14980;Žemyna;Pabiručiai;82479499709;Ne;8;4;0;12
14981;Žemyna;Pabiručiai;14902924855;Taip;5;5;1;11
14982;Žemyna;Pabiručiai;1847882950;Taip;0;0;1;1
14983;Žemyna;Pabiručiai;50687988382;Ne;0;12;0;12
14984;Žemyna;Pabiručiai;1278096396;Taip;0;0;12;12
14985;Žemyna;Pabiručiai;8726346349;Taip;5;5;1;11
14986;Žemyna;Pabiručiai;2841526614;Taip;10;4;1;15
14987;Žemyna;Pabiručiai;8496195396;Taip;0;5;4;9
14988;Žemyna;Pabiručiai;4796265997;Taip;0;4;12;16
14989;Žemyna;Pabiručiai;8139714064;Taip;0;3;0;3
14990;Žemyna;Pabiručiai;3895238312;Taip;13;0;0;13
14991;Žemyna;Pabiručiai;2137718635;Ne;5;4;0;9
14992;Žemyna;Pabiručiai;1058705875;Taip;0;10;0;10
14993;Žemyna;Pabiručiai;7785889259;Taip;10;4;2;16
14994;Žemyna;Pabiručiai;7676796264;Taip;2;0;0;2
14995;Žemyna;Pabiručiai;2090395417;Taip;16;1;0;17
14996;Žemyna;Pabiručiai;15110117571;Taip;8;4;0;12
14997;Žemyna;Drugeliai;72801825176;Taip;0;9;0;9
14998;Žemyna;Drugeliai;32383247850;Taip;5;4;0;9
14999;Žemyna;Drugeliai;2100326039;Taip;5;1;2;8
15000;Žemyna;Drugeliai;84680481889;Taip;5;3;4;12
15001;Žemyna;Drugeliai;1571182096;Ne;5;0;3;8
15002;Žemyna;Drugeliai;1471204471;Taip;3;2;0;5
15003;Žemyna;Drugeliai;1882507954;Taip;16;0;0;16
15004;Žemyna;Drugeliai;1607110213;Taip;10;7;0;17
15005;Žemyna;Drugeliai;1623854426;Taip;9;0;0;9
15006;Žemyna;Drugeliai;50369667193;Taip;0;6;0;6
15007;Žemyna;Drugeliai;1705971732;Taip;15;0;0;15
15008;Žemyna;Drugeliai;17784132877;Taip;5;2;2;9
15009;Žemyna;Drugeliai;97625732866;Taip;6;0;0;6
15010;Žemyna;Drugeliai;45222048620;Taip;13;0;0;13
15011;Žemyna;Drugeliai;1654912072;Taip;3;2;0;5
15012;Žemyna;Drugeliai;1968337404;Taip;4;3;0;7
15013;Žemyna;Drugeliai;27867030470;Taip;0;4;0;4
15014;Žemyna;Drugeliai;51870099224;Taip;11;0;2;13
15015;Žemyna;Drugeliai;1941650167;Taip;3;2;0;5
15016;Žemyna;Drugeliai;1867198805;Taip;0;8;1;9
15017;Žemyna;Drugeliai;4519502372;Taip;12;4;0;16
15018;Žemyna;Drugeliai;8018865138;Ne;6;0;1;7
15019;Žemyna;Drugeliai;5233574060;Ne;6;1;1;8
15020;Žemyna;"ŽIRNIUKAI ";8694608716;Taip;9;4;0;13
15021;Žemyna;"ŽIRNIUKAI ";7620179886;Taip;7;0;8;15
15022;Žemyna;"ŽIRNIUKAI ";5069437469;Taip;0;3;1;4
15023;Žemyna;"ŽIRNIUKAI ";7277970673;Taip;14;0;0;14
15024;Žemyna;"ŽIRNIUKAI ";3074391266;Taip;13;1;0;14
15025;Žemyna;"ŽIRNIUKAI ";2547436771;Taip;14;0;3;17
15026;Žemyna;"ŽIRNIUKAI ";6346173832;Taip;10;0;1;11
15027;Žemyna;"ŽIRNIUKAI ";1365045512;Ne;12;0;0;12
15028;Žemyna;"ŽIRNIUKAI ";4642600915;Taip;2;1;0;3
15029;Žemyna;"ŽIRNIUKAI ";5416338054;Taip;7;4;9;20
15030;Žemyna;"ŽIRNIUKAI ";5133115712;Taip;11;4;5;20
15031;Žemyna;"ŽIRNIUKAI ";9570187081;Taip;6;0;1;7
15032;Žemyna;"ŽIRNIUKAI ";4693414703;Ne;10;0;0;10
15033;Žemyna;"ŽIRNIUKAI ";2792702536;Taip;10;4;0;14
15034;Žemyna;"ŽIRNIUKAI ";6051208732;Taip;0;0;2;2
15035;Žemyna;"ŽIRNIUKAI ";7427119736;Taip;12;0;3;15
15036;Žemyna;"ŽIRNIUKAI ";2354265632;Taip;19;1;0;20
15037;Žemyna;"ŽIRNIUKAI ";7376806308;Taip;7;0;0;7
15038;Žemyna;"ŽIOGELIAI ";9094718595;Taip;9;0;0;9
15039;Žemyna;"ŽIOGELIAI ";6208953341;Taip;16;0;0;16
15040;Žemyna;"ŽIOGELIAI ";9827401825;Taip;0;12;0;12
15041;Žemyna;"ŽIOGELIAI ";8559870965;Taip;9;2;0;11
15042;Žemyna;"ŽIOGELIAI ";4176386795;Taip;13;5;0;18
15043;Žemyna;"ŽIOGELIAI ";6958537154;Taip;0;5;0;5
15044;Žemyna;"ŽIOGELIAI ";2034162734;Taip;9;1;0;10
15045;Žemyna;"ŽIOGELIAI ";7122276019;Taip;17;0;0;17
15046;Žemyna;"ŽIOGELIAI ";7005045961;Taip;3;5;0;8
15047;Žemyna;"ŽIOGELIAI ";1745197274;Taip;18;1;0;19
15048;Žemyna;"ŽIOGELIAI ";6041223291;Taip;11;2;0;13
15049;Žemyna;"ŽIOGELIAI ";8248443265;Taip;9;0;0;9
15050;Žemyna;"ŽIOGELIAI ";1850100203;Taip;13;0;0;13
15051;Žemyna;"ŽIOGELIAI ";9628651723;Taip;21;0;0;21
15052;Žemyna;"ŽIOGELIAI ";5743535463;Taip;21;0;0;21
15053;Žemyna;"ŽIOGELIAI ";4613946229;Taip;6;5;0;11
15054;Žemyna;"ŽIOGELIAI ";1656335765;Taip;5;1;0;6
15055;Žemyna;"ŽIOGELIAI ";5127174926;Taip;17;0;0;17
15056;Žemuogėlė;Boružiukai;54663750186;Taip;0;6;0;6
15057;Žemuogėlė;Boružiukai;4231767115;Taip;11;2;0;13
15058;Žemuogėlė;Boružiukai;3977351017;Taip;11;2;0;13
15059;Žemuogėlė;Boružiukai;3854265246;Taip;0;1;0;1
15060;Žemuogėlė;Boružiukai;5147617128;Taip;0;10;0;10
15061;Žemuogėlė;Boružiukai;5625943720;Taip;0;7;2;9
15062;Žemuogėlė;Boružiukai;1058207935;Taip;7;2;0;9
15063;Žemuogėlė;Boružiukai;1628749648;Taip;6;1;0;7
15064;Žemuogėlė;Boružiukai;711908013;Taip;3;6;0;9
15065;Žemuogėlė;Boružiukai;6962103028;Taip;2;5;0;7
15066;Žemuogėlė;Boružiukai;7714826773;Taip;5;9;0;14
15067;Žemuogėlė;Boružiukai;3134493860;Taip;5;1;0;6
15068;Žemuogėlė;Boružiukai;8023936861;Taip;2;0;1;3
15069;Žemuogėlė;Boružiukai;1907004376;Taip;12;6;0;18
15070;Žemuogėlė;Boružiukai;38870047353;Taip;6;1;0;7
15071;Žemuogėlė;Boružiukai;7403172794;Taip;0;4;0;4
15072;Žemuogėlė;Boružiukai;9315711142;Taip;11;0;2;13
15073;Žemuogėlė;Boružiukai;2102057496;Taip;0;9;0;9
15074;Žemuogėlė;Boružiukai;94792383091;Taip;7;5;0;12
15075;Žemuogėlė;Boružiukai;4421397490;Taip;5;4;0;9
15076;Žemuogėlė;Šviesuliukai;1049009199;Taip;9;4;0;13
15077;Žemuogėlė;Šviesuliukai;4810459063;Taip;0;3;0;3
15078;Žemuogėlė;Šviesuliukai;1745679183;Taip;5;3;0;8
15079;Žemuogėlė;Šviesuliukai;9255723192;Taip;0;4;0;4
15080;Žemuogėlė;Šviesuliukai;2740942924;Taip;13;0;0;13
15081;Žemuogėlė;Šviesuliukai;5972567526;Taip;14;0;0;14
15082;Žemuogėlė;Šviesuliukai;1910570858;Taip;0;7;0;7
15083;Žemuogėlė;Šviesuliukai;8409711622;Taip;5;6;0;11
15084;Žemuogėlė;Šviesuliukai;6726124641;Taip;6;0;0;6
15085;Žemuogėlė;Šviesuliukai;5127370193;Taip;7;0;0;7
15086;Žemuogėlė;Šviesuliukai;5126348190;Taip;7;1;0;8
15087;Žemuogėlė;Šviesuliukai;9534937419;Taip;7;0;0;7
15088;Žemuogėlė;Šviesuliukai;3612833383;Taip;2;0;5;7
15089;Žemuogėlė;Šviesuliukai;3000676765;Taip;12;2;2;16
15090;Žemuogėlė;Šviesuliukai;9689082202;Ne;2;11;0;13
15091;Žemuogėlė;Šviesuliukai;3411390558;Taip;9;0;0;9
15092;Žemuogėlė;Šviesuliukai;1275552038;Taip;5;4;0;9
15093;Žemuogėlė;Šviesuliukai;1377813636;Taip;0;0;1;1
15094;Žemuogėlė;Šviesuliukai;2731544174;Taip;9;0;0;9
15095;Žemuogėlė;Šviesuliukai;4660479216;Taip;21;0;0;21
15096;Žemuogėlė;Lašiukai;1248683052;Taip;4;3;0;7
15097;Žemuogėlė;Lašiukai;2099256322;Taip;0;4;0;4
15098;Žemuogėlė;Lašiukai;2320908623;Taip;5;5;0;10
15099;Žemuogėlė;Lašiukai;3208009994;Taip;5;6;0;11
15100;Žemuogėlė;Lašiukai;60841198741;Taip;4;4;0;8
15101;Žemuogėlė;Lašiukai;2146044539;Taip;9;0;0;9
15102;Žemuogėlė;Lašiukai;97014601220;Ne;8;2;0;10
15103;Žemuogėlė;Lašiukai;31450036105;Taip;4;4;0;8
15104;Žemuogėlė;Lašiukai;93523683833;Taip;6;4;0;10
15105;Žemuogėlė;Lašiukai;1223819270;Ne;0;9;0;9
15106;Žemuogėlė;Lašiukai;1608506638;Taip;6;4;0;10
15107;Žemuogėlė;Lašiukai;1448477562;Taip;6;4;0;10
15108;Žemuogėlė;Lašiukai;4900328025;Taip;12;1;0;13
15109;Žemuogėlė;Lašiukai;8295541141;Ne;3;8;0;11
15110;Žemuogėlė;Lašiukai;1223648771;Taip;0;9;0;9
15111;Žemuogėlė;Skambaliukai;58894092756;Taip;0;2;0;2
15112;Žemuogėlė;Skambaliukai;34462365948;Taip;0;4;0;4
15113;Žemuogėlė;Skambaliukai;13768771915;Taip;0;2;0;2
15114;Žemuogėlė;Skambaliukai;96539338587;Taip;5;1;0;6
15115;Žemuogėlė;Skambaliukai;1844596636;Taip;7;2;0;9
15116;Žemuogėlė;Skambaliukai;10356039859;Taip;5;0;0;5
15117;Žemuogėlė;Skambaliukai;8952696734;Taip;0;9;0;9
15118;Žemuogėlė;Skambaliukai;77880141132;Taip;3;3;0;6
15119;Žemuogėlė;Skambaliukai;53763899224;Taip;3;4;0;7
15120;Žemuogėlė;Skambaliukai;29973978107;Taip;10;6;0;16
15121;Žemuogėlė;Skambaliukai;1366286798;Taip;0;1;0;1
15122;Žemuogėlė;Skambaliukai;58604834495;Taip;0;6;0;6
15123;Žemuogėlė;Skambaliukai;87719167969;Taip;0;5;0;5
15124;Žemuogėlė;Skambaliukai;97664138036;Ne;0;8;0;8
15125;Žemuogėlė;Skambaliukai;66464155865;Taip;8;1;0;9
15126;Žemuogėlė;Skambaliukai;3354347837;Ne;14;4;0;18
15127;Žemuogėlė;Skambaliukai;98006600854;Taip;2;5;0;7
15128;Žemuogėlė;Skambaliukai;92317183904;Taip;0;4;0;4
15129;Žemuogėlė;Skambaliukai;28795421460;Taip;3;6;0;9
15130;Žemuogėlė;Skambaliukai;33112231008;Taip;0;11;0;11
15131;Žemuogėlė;Skambaliukai;37726841145;Taip;0;1;0;1
15132;Žemuogėlė;Skambaliukai;24111477729;Taip;3;6;0;9
15133;Žemuogėlė;Spinduliukai;62210251654;Taip;0;11;0;11
15134;Žemuogėlė;Spinduliukai;22761916112;Ne;9;5;0;14
15135;Žemuogėlė;Spinduliukai;5888483930;Ne;0;12;0;12
15136;Žemuogėlė;Spinduliukai;97511628790;Taip;0;9;0;9
15137;Žemuogėlė;Spinduliukai;64042870424;Taip;9;0;0;9
15138;Žemuogėlė;Spinduliukai;1296464444;Taip;6;1;0;7
15139;Žemuogėlė;Spinduliukai;29436958034;Taip;9;0;0;9
15140;Žemuogėlė;Spinduliukai;9864664937;Taip;2;5;0;7
15141;Žemuogėlė;Spinduliukai;75012082294;Taip;3;6;0;9
15142;Žemuogėlė;Spinduliukai;9042246873;Taip;0;11;0;11
15143;Žemuogėlė;Spinduliukai;57783467185;Taip;0;4;0;4
15144;Žemuogėlė;Spinduliukai;1859848343;Taip;0;12;0;12
15145;Žemuogėlė;Spinduliukai;96167322031;Taip;9;2;0;11
15146;Žemuogėlė;Spinduliukai;4766971363;Taip;0;6;0;6
15147;Žemuogėlė;Spinduliukai;1608544032;Taip;0;8;0;8
15148;Žemuogėlė;Spinduliukai;8187939143;Taip;4;1;0;5
15149;Žemuogėlė;Spinduliukai;3062268362;Taip;0;1;0;1
15150;Žemuogėlė;Spinduliukai;5395954931;Taip;7;1;0;8
15151;Žemuogėlė;Spinduliukai;73679997517;Taip;0;4;0;4
15152;Žemuogėlė;Perliukai;64182347253;Taip;0;9;0;9
15153;Žemuogėlė;Perliukai;23841110826;Taip;0;7;2;9
15154;Žemuogėlė;Perliukai;89682626079;Taip;1;4;0;5
15155;Žemuogėlė;Perliukai;21886029194;Taip;0;6;0;6
15156;Žemuogėlė;Perliukai;95070515682;Taip;0;4;0;4
15157;Žemuogėlė;Perliukai;7503799036;Taip;10;0;0;10
15158;Žemuogėlė;Perliukai;95392130582;Taip;4;4;0;8
15159;Žemuogėlė;Perliukai;1099252682;Taip;4;4;0;8
15160;Žemuogėlė;Perliukai;1550066922;Taip;5;4;0;9
15161;Žemuogėlė;Perliukai;1354590098;Taip;5;6;1;12
15162;Žemuogėlė;Perliukai;1543283524;Taip;7;3;0;10
15163;Žemuogėlė;Perliukai;1085793430;Taip;0;6;0;6
15164;Žemuogėlė;Perliukai;1970687025;Taip;4;4;0;8
15165;Žemuogėlė;Perliukai;52842591023;Taip;13;0;0;13
15166;Žemuogėlė;Perliukai;5911529759;Taip;0;9;0;9
15167;Žemuogėlė;Perliukai;1093128368;Taip;6;7;0;13
15168;Žemuogėlė;Perliukai;70054283264;Taip;0;4;0;4
15169;Žemuogėlė;Perliukai;40590616715;Taip;0;5;0;5
15170;Žemuogėlė;Drugeliai;9592456683;Taip;8;4;0;12
15171;Žemuogėlė;Drugeliai;3765022476;Taip;3;4;0;7
15172;Žemuogėlė;Drugeliai;9519563708;Taip;0;5;0;5
15173;Žemuogėlė;Drugeliai;5266493632;Taip;12;1;0;13
15174;Žemuogėlė;Drugeliai;3237083654;Taip;16;0;0;16
15175;Žemuogėlė;Drugeliai;2259779058;Taip;2;4;0;6
15176;Žemuogėlė;Drugeliai;9693894254;Taip;0;8;0;8
15177;Žemuogėlė;Drugeliai;5418395023;Taip;7;5;0;12
15178;Žemuogėlė;Drugeliai;6581889641;Taip;7;1;0;8
15179;Žemuogėlė;Drugeliai;2555902309;Taip;3;7;0;10
15180;Žemuogėlė;Drugeliai;4536398519;Taip;0;6;1;7
15181;Žemuogėlė;Drugeliai;3458374439;Taip;8;0;0;8
15182;Žemuogėlė;Drugeliai;8757701456;Taip;5;4;0;9
15183;Žemuogėlė;Drugeliai;1713927628;Taip;0;8;0;8
15184;Žemuogėlė;Drugeliai;1844299594;Ne;2;6;1;9
15185;Žemuogėlė;Drugeliai;2132549536;Taip;2;7;0;9
15186;Žemuogėlė;Drugeliai;8496353410;Taip;11;6;0;17
15187;Žemuogėlė;Drugeliai;7804015060;Taip;6;6;0;12
15188;Žemuogėlė;Drugeliai;3714945248;Taip;21;0;0;21
15189;Žemuogėlė;Drugeliai;9378432383;Taip;3;8;2;13
15190;Žemuogėlė;Drugeliai;6913038845;Taip;12;1;0;13
15191;Žemuogėlė;Drugeliai;5532053268;Taip;5;0;0;5
15192;Žemuogėlė;"VIEVERSIUKAI ";4629107942;Taip;16;0;0;16
15193;Žemuogėlė;"VIEVERSIUKAI ";1658954821;Taip;10;1;0;11
15194;Žemuogėlė;"VIEVERSIUKAI ";7592566602;Taip;12;0;0;12
15195;Žemuogėlė;"VIEVERSIUKAI ";2664267604;Taip;11;1;0;12
15196;Žemuogėlė;"VIEVERSIUKAI ";9693814425;Taip;9;3;0;12
15197;Žemuogėlė;"VIEVERSIUKAI ";3288369628;Taip;10;5;0;15
15198;Žemuogėlė;"VIEVERSIUKAI ";3825509486;Taip;14;4;0;18
15199;Žemuogėlė;"VIEVERSIUKAI ";1060986850;Taip;21;0;0;21
15200;Žemuogėlė;"VIEVERSIUKAI ";1306065826;Taip;21;0;0;21
15201;Žemuogėlė;"VIEVERSIUKAI ";5992802843;Taip;6;8;0;14
15202;Žemuogėlė;"VIEVERSIUKAI ";5505719625;Taip;1;0;0;1
15203;Žemuogėlė;"VIEVERSIUKAI ";1555899448;Taip;21;0;0;21
15204;Žemuogėlė;"VIEVERSIUKAI ";7137182934;Taip;5;0;0;5
15205;Žemuogėlė;"VIEVERSIUKAI ";1796489729;Taip;18;0;0;18
15206;Žemuogėlė;"VIEVERSIUKAI ";3059525247;Taip;0;9;0;9
15207;Žemuogėlė;"NYKŠTUKAI ";3546429231;Taip;0;11;0;11
15208;Žemuogėlė;"NYKŠTUKAI ";2115883173;Taip;14;0;0;14
15209;Žemuogėlė;"NYKŠTUKAI ";1251497003;Taip;1;4;0;5
15210;Žemuogėlė;"NYKŠTUKAI ";3706531223;Taip;12;1;0;13
15211;Žemuogėlė;"NYKŠTUKAI ";2841634296;Taip;13;4;0;17
15212;Žemuogėlė;"NYKŠTUKAI ";4565097904;Ne;8;4;0;12
15213;Žemuogėlė;"NYKŠTUKAI ";8644564820;Taip;4;1;0;5
15214;Žemuogėlė;"NYKŠTUKAI ";9579921777;Taip;0;10;0;10
15215;Žemuogėlė;"NYKŠTUKAI ";6169845677;Taip;5;1;0;6
15216;Žemuogėlė;"NYKŠTUKAI ";1356340471;Taip;7;14;0;21
15217;Žemuogėlė;"NYKŠTUKAI ";6747566307;Taip;8;0;0;8
15218;Žemuogėlė;"NYKŠTUKAI ";3753156044;Ne;5;1;0;6
15219;Žemuogėlė;"NYKŠTUKAI ";3073956225;Taip;10;0;0;10
15220;Žemuogėlė;"NYKŠTUKAI ";1469759840;Taip;2;4;0;6
15221;Žemuogėlė;"NYKŠTUKAI ";4933948491;Taip;13;1;0;14
15222;Žemuogėlė;KIŠKUČIAI;3041461125;Taip;0;1;0;1
15223;Žemuogėlė;KIŠKUČIAI;1953538445;Taip;17;0;4;21
15224;Žemuogėlė;KIŠKUČIAI;6707522989;Taip;17;0;1;18
15225;Žemuogėlė;KIŠKUČIAI;9981446556;Taip;9;4;1;14
15226;Žemuogėlė;KIŠKUČIAI;3837424301;Taip;2;4;0;6
15227;Žemuogėlė;KIŠKUČIAI;9545690301;Taip;13;5;0;18
15228;Žemuogėlė;KIŠKUČIAI;8827421660;Taip;19;2;0;21
15229;Žemuogėlė;KIŠKUČIAI;7669457695;Taip;7;0;0;7
15230;Žemuogėlė;KIŠKUČIAI;8675089149;Taip;2;0;0;2
15231;Žemuogėlė;KIŠKUČIAI;4165354124;Taip;17;4;0;21
15232;Žemuogėlė;KIŠKUČIAI;6059069293;Taip;1;10;0;11
15233;Žemuogėlė;KIŠKUČIAI;5971652934;Taip;8;2;0;10
15234;Žemuogėlė;KIŠKUČIAI;9955429241;Taip;5;0;0;5
15235;Žemuogėlė;KIŠKUČIAI;5770044886;Taip;14;0;0;14
15236;Žemuogėlė;KIŠKUČIAI;5499401648;Taip;2;3;0;5
15237;Žibutė;PELĖDŽIUKAI;5811023607;Taip;0;0;2;2
15238;Žibutė;PELĖDŽIUKAI;54535455969;Taip;14;0;0;14
15239;Žibutė;PELĖDŽIUKAI;85042822872;Taip;0;0;4;4
15240;Žibutė;PELĖDŽIUKAI;59824395612;Taip;0;4;2;6
15241;Žibutė;PELĖDŽIUKAI;2361682400;Taip;2;1;1;4
15242;Žibutė;PELĖDŽIUKAI;1826763192;Taip;0;2;0;2
15243;Žibutė;PELĖDŽIUKAI;1259481487;Taip;0;1;0;1
15244;Žibutė;PELĖDŽIUKAI;3826875107;Taip;0;11;0;11
15245;Žibutė;PELĖDŽIUKAI;3186792146;Taip;0;0;2;2
15246;Žibutė;PELĖDŽIUKAI;1226458088;Taip;0;2;4;6
15247;Žibutė;PELĖDŽIUKAI;7344095020;Taip;0;9;0;9
15248;Žibutė;PELĖDŽIUKAI;1078105287;Taip;0;5;0;5
15249;Žibutė;PELĖDŽIUKAI;2152452830;Ne;9;0;0;9
15250;Žibutė;PELĖDŽIUKAI;1394895695;Ne;0;2;5;7
15251;Žibutė;PELĖDŽIUKAI;7095870173;Taip;0;7;0;7
15252;Žibutė;PELĖDŽIUKAI;2840754631;Taip;14;0;2;16
15253;Žibutė;PELĖDŽIUKAI;6089325755;Taip;11;0;4;15
15254;Žibutė;PELĖDŽIUKAI;1274409680;Taip;20;0;1;21
15255;Žibutė;KREGŽDUTĖS;8587562864;Ne;12;0;3;15
15256;Žibutė;KREGŽDUTĖS;1132220505;Taip;0;4;0;4
15257;Žibutė;KREGŽDUTĖS;29414890756;Ne;4;4;0;8
15258;Žibutė;KREGŽDUTĖS;2951520056;Taip;0;1;1;2
15259;Žibutė;KREGŽDUTĖS;3035056391;Taip;0;4;2;6
15260;Žibutė;KREGŽDUTĖS;4480906648;Ne;14;0;0;14
15261;Žibutė;KREGŽDUTĖS;90082848356;Taip;0;5;0;5
15262;Žibutė;KREGŽDUTĖS;3187977612;Ne;5;3;0;8
15263;Žibutė;KREGŽDUTĖS;81886125258;Ne;7;1;0;8
15264;Žibutė;KREGŽDUTĖS;22415995120;Taip;4;0;0;4
15265;Žibutė;KREGŽDUTĖS;1478348672;Taip;2;0;0;2
15266;Žibutė;KREGŽDUTĖS;82985105104;Ne;0;2;0;2
15267;Žibutė;KREGŽDUTĖS;24118925398;Taip;0;5;3;8
15268;Žibutė;KREGŽDUTĖS;37321817270;Taip;5;5;0;10
15269;Žibutė;KREGŽDUTĖS;8973875215;Taip;5;5;1;11
15270;Žibutė;KREGŽDUTĖS;2776197727;Ne;2;1;2;5
15271;Žibutė;KREGŽDUTĖS;3722925159;Taip;0;4;1;5
15272;Žibutė;KREGŽDUTĖS;6471216018;Taip;6;4;0;10
15273;Žibutė;KREGŽDUTĖS;8830047872;Taip;9;5;1;15
15274;Žibutė;BORUŽĖLĖS;8792292819;Taip;16;0;0;16
15275;Žibutė;BORUŽĖLĖS;2438980348;Taip;9;2;0;11
15276;Žibutė;BORUŽĖLĖS;7668484415;Taip;8;4;0;12
15277;Žibutė;BORUŽĖLĖS;5126232169;Taip;12;4;1;17
15278;Žibutė;BORUŽĖLĖS;9918283923;Taip;8;0;1;9
15279;Žibutė;BORUŽĖLĖS;9700866512;Taip;16;0;0;16
15280;Žibutė;BORUŽĖLĖS;3268141759;Ne;0;0;4;4
15281;Žibutė;BORUŽĖLĖS;7774532200;Taip;10;3;0;13
15282;Žibutė;BORUŽĖLĖS;1366469428;Ne;8;0;0;8
15283;Žibutė;BORUŽĖLĖS;2607509585;Taip;1;0;0;1
15284;Žibutė;BORUŽĖLĖS;4825064521;Taip;11;7;0;18
15285;Žibutė;BORUŽĖLĖS;5826523148;Taip;0;5;0;5
15286;Žibutė;BORUŽĖLĖS;5806696915;Taip;10;1;0;11
15287;Žibutė;BORUŽĖLĖS;3957898269;Taip;3;1;0;4
15288;Žibutė;BORUŽĖLĖS;4814936645;Taip;6;0;1;7
15289;Žibutė;BORUŽĖLĖS;4382812297;Taip;6;0;0;6
15290;Žibutė;BORUŽĖLĖS;5591698130;Taip;2;5;2;9
15291;Žibutė;BORUŽĖLĖS;1004098038;Taip;3;0;4;7
15292;Žibutė;BORUŽĖLĖS;2880593326;Taip;2;1;1;4
15293;Žibutė;BORUŽĖLĖS;7479437931;Ne;17;0;0;17
15294;Žibutė;BITUTĖS;3194445795;Taip;0;4;0;4
15295;Žibutė;BITUTĖS;14091973543;Taip;7;0;0;7
15296;Žibutė;BITUTĖS;24818054845;Taip;2;4;0;6
15297;Žibutė;BITUTĖS;27182644850;Taip;9;4;0;13
15298;Žibutė;BITUTĖS;9591439732;Taip;5;0;0;5
15299;Žibutė;BITUTĖS;90040902859;Taip;14;0;0;14
15300;Žibutė;BITUTĖS;39367516353;Taip;8;6;0;14
15301;Žibutė;BITUTĖS;1192143609;Taip;10;0;0;10
15302;Žibutė;BITUTĖS;72357016152;Taip;5;7;0;12
15303;Žibutė;BITUTĖS;1054908586;Taip;2;1;0;3
15304;Žibutė;BITUTĖS;2603387036;Taip;4;0;0;4
15305;Žibutė;BITUTĖS;1215072172;Taip;0;6;0;6
15306;Žibutė;BITUTĖS;1317512329;Taip;7;3;0;10
15307;Žibutė;BITUTĖS;2144866874;Ne;7;3;0;10
15308;Žibutė;BITUTĖS;1010766308;Taip;0;2;0;2
15309;Žibutė;BITUTĖS;1749323904;Taip;6;4;0;10
15310;Žibutė;BITUTĖS;19558564943;Taip;7;1;0;8
15311;Žibutė;BITUTĖS;9109825948;Taip;2;0;0;2
15312;Žibutė;BITUTĖS;6958822972;Ne;7;6;0;13
15313;Žibutė;BITUTĖS;62187632470;Ne;12;5;0;17
15314;Žibutė;KAČIUKAI;65433129636;Taip;0;4;2;6
15315;Žibutė;KAČIUKAI;25658034484;Taip;0;3;2;5
15316;Žibutė;KAČIUKAI;9982611436;Ne;2;1;0;3
15317;Žibutė;KAČIUKAI;6736950445;Ne;2;4;0;6
15318;Žibutė;KAČIUKAI;2089960385;Taip;0;5;4;9
15319;Žibutė;KAČIUKAI;30838051846;Taip;0;5;0;5
15320;Žibutė;KAČIUKAI;29408732286;Taip;2;4;0;6
15321;Žibutė;KAČIUKAI;35959201106;Taip;0;5;1;6
15322;Žibutė;KAČIUKAI;67702702073;Taip;0;3;0;3
15323;Žibutė;KAČIUKAI;60756444655;Ne;0;3;3;6
15324;Žibutė;KAČIUKAI;33367530216;Taip;2;5;9;16
15325;Žibutė;KAČIUKAI;97730387781;Taip;0;5;4;9
15326;Žibutė;KAČIUKAI;51435935201;Taip;0;9;3;12
15327;Žibutė;KAČIUKAI;14243834326;Taip;2;3;0;5
15328;Žibutė;KAČIUKAI;19029125959;Taip;0;3;0;3
15329;Žibutė;KAČIUKAI;1683770314;Taip;0;4;0;4
15330;Žibutė;KAČIUKAI;99502912405;Ne;7;0;1;8
15331;Žibutė;KAČIUKAI;10269347801;Taip;0;5;2;7
15332;Žibutė;KAČIUKAI;76137370554;Taip;0;5;2;7
15333;Žibutė;KAČIUKAI;4475507372;Taip;0;1;4;5
15334;Žibutė;KAČIUKAI;9655499291;Ne;0;8;2;10
15335;Žibutė;ZUIKIAI;6495108202;Ne;13;0;1;14
15336;Žibutė;ZUIKIAI;5677389434;Taip;0;5;0;5
15337;Žibutė;ZUIKIAI;5187777741;Taip;7;0;0;7
15338;Žibutė;ZUIKIAI;6013340521;Taip;12;0;0;12
15339;Žibutė;ZUIKIAI;7036454359;Ne;17;0;0;17
15340;Žibutė;ZUIKIAI;5412917352;Taip;10;0;1;11
15341;Žibutė;ZUIKIAI;8715912139;Taip;4;4;0;8
15342;Žibutė;ZUIKIAI;5416015554;Taip;10;0;2;12
15343;Žibutė;ZUIKIAI;2406005105;Taip;4;0;1;5
15344;Žibutė;ZUIKIAI;3555071718;Taip;21;0;0;21
15345;Žibutė;ZUIKIAI;7531027545;Taip;14;0;1;15
15346;Žibutė;ZUIKIAI;3645481894;Taip;9;1;1;11
15347;Žibutė;ZUIKIAI;6074488747;Ne;4;0;0;4
15348;Žibutė;ZUIKIAI;8880329060;Taip;11;0;1;12
15349;Žibutė;ZUIKIAI;2957525481;Taip;6;6;0;12
15350;Žibutė;ZUIKIAI;5009495840;Ne;10;0;0;10
15351;Žibutė;ZUIKIAI;7136145033;Taip;7;0;3;10
15352;Žibutė;ZUIKIAI;5575614158;Taip;14;0;4;18
15353;Žibutė;ZUIKIAI;5190377896;Taip;14;0;0;14
15354;Žibutė;ZUIKIAI;3191351976;Taip;10;0;0;10
15355;Žibutė;ZUIKIAI;9498011134;Taip;2;5;2;9
15356;Žiedas;Bitutės;7123756950;Taip;0;2;0;2
15357;Žiedas;Bitutės;1818701657;Ne;0;6;0;6
15358;Žiedas;Bitutės;2063680054;Taip;0;21;0;21
15359;Žiedas;Bitutės;1817676038;Taip;0;6;0;6
15360;Žiedas;Bitutės;38427730823;Ne;0;4;0;4
15361;Žiedas;Bitutės;1631546874;Ne;0;9;0;9
15362;Žiedas;Bitutės;33966765931;Taip;0;6;4;10
15363;Žiedas;Bitutės;29665685563;Taip;5;5;0;10
15364;Žiedas;Bitutės;42777955874;Ne;0;4;0;4
15365;Žiedas;Bitutės;31369021056;Taip;4;4;0;8
15366;Žiedas;Bitutės;83630991208;Taip;0;8;1;9
15367;Žiedas;Bitutės;20740539606;Ne;0;5;0;5
15368;Žiedas;Bitutės;80003937908;Taip;0;3;0;3
15369;Žiedas;Bitutės;81304970766;Taip;2;6;3;11
15370;Žiedas;Bitutės;1288374706;Taip;2;4;0;6
15371;Žiedas;Bitutės;34178608904;Ne;0;12;0;12
15372;Žiedas;Bitutės;58252361010;Taip;3;9;0;12
15373;Žiedas;Varpeliai;32671505578;Taip;0;5;0;5
15374;Žiedas;Varpeliai;5835879070;Taip;0;4;0;4
15375;Žiedas;Varpeliai;1733596148;Taip;0;6;2;8
15376;Žiedas;Varpeliai;55459877940;Ne;0;7;0;7
15377;Žiedas;Varpeliai;50069962197;Taip;0;4;1;5
15378;Žiedas;Varpeliai;59092030605;Ne;0;5;0;5
15379;Žiedas;Varpeliai;1748932818;Taip;0;2;0;2
15380;Žiedas;Varpeliai;17275054601;Taip;3;11;0;14
15381;Žiedas;Varpeliai;1897597456;Taip;0;3;0;3
15382;Žiedas;Varpeliai;1443451076;Taip;0;9;1;10
15383;Žiedas;Varpeliai;1491929025;Taip;0;11;0;11
15384;Žiedas;Varpeliai;2075892389;Taip;0;8;0;8
15385;Žiedas;Varpeliai;9044903345;Taip;0;4;0;4
15386;Žiedas;Varpeliai;85152640431;Ne;0;2;0;2
15387;Žiedas;Varpeliai;2147350804;Taip;0;13;0;13
15388;Žiedas;Varpeliai;1366570116;Taip;0;21;0;21
15389;Žiedas;Varpeliai;37314210812;Taip;0;5;0;5
15390;Žiedas;Varpeliai;52683198809;Taip;2;4;0;6
15391;Žiedas;Varpeliai;99985645406;Taip;0;4;2;6
15392;Žiedas;Varpeliai;39022317368;Ne;4;4;0;8
15393;Žiedas;Varpeliai;1618815502;Taip;2;4;1;7
15394;Žiedas;Varpeliai;1332249885;Ne;3;5;0;8
15395;Žiedas;Varpeliai;12622490543;Ne;16;4;0;20
15396;Žiedas;Varpeliai;1120478375;Taip;6;6;1;13
15397;Žiedas;Varpeliai;2081656643;Taip;2;4;0;6
15398;Žiedas;Ramunėlės;9648580306;Taip;0;11;0;11
15399;Žiedas;Ramunėlės;9736967156;Taip;7;5;0;12
15400;Žiedas;Ramunėlės;4922560649;Taip;0;6;0;6
15401;Žiedas;Ramunėlės;2511423525;Taip;2;0;2;4
15402;Žiedas;Ramunėlės;7814504623;Taip;0;4;1;5
15403;Žiedas;Ramunėlės;2095655987;Ne;12;6;0;18
15404;Žiedas;Ramunėlės;6703889237;Taip;0;0;1;1
15405;Žiedas;Ramunėlės;7954517383;Taip;0;5;0;5
15406;Žiedas;Ramunėlės;9247088735;Taip;21;0;0;21
15407;Žiedas;Ramunėlės;9699668892;Taip;0;6;0;6
15408;Žiedas;Ramunėlės;6432090199;Taip;13;4;0;17
15409;Žiedas;Ramunėlės;1139186052;Taip;0;5;0;5
15410;Žiedas;Ramunėlės;5653785844;Taip;5;3;0;8
15411;Žiedas;Ramunėlės;5588136738;Taip;0;7;0;7
15412;Žiedas;Ramunėlės;5626494892;Taip;17;4;0;21
15413;Žiedas;Ramunėlės;1794393042;Taip;8;3;0;11
15414;Žiedas;Ramunėlės;2083493509;Taip;0;0;4;4
15415;Žiedas;Ramunėlės;7708360056;Taip;0;6;0;6
15416;Žiedas;Ramunėlės;7396006218;Taip;10;3;0;13
15417;Žiedas;Ramunėlės;3586376571;Taip;12;4;1;17
15418;Žiedas;Ramunėlės;6786526552;Taip;0;6;7;13
15419;Žiedas;Ramunėlės;3702078720;Taip;7;4;0;11
15420;Žiedas;Ramunėlės;2849254119;Taip;0;10;0;10
15421;Žiedas;Pakalnutės;1063755068;Taip;4;4;0;8
15422;Žiedas;Pakalnutės;42049755986;Taip;0;8;0;8
15423;Žiedas;Pakalnutės;52721173922;Taip;5;6;0;11
15424;Žiedas;Pakalnutės;2060067625;Taip;0;11;0;11
15425;Žiedas;Pakalnutės;2434909184;Taip;10;4;0;14
15426;Žiedas;Pakalnutės;3616767119;Taip;10;4;0;14
15427;Žiedas;Pakalnutės;1835889494;Taip;7;5;0;12
15428;Žiedas;Pakalnutės;1600420971;Taip;2;9;0;11
15429;Žiedas;Pakalnutės;3930283171;Taip;8;8;0;16
15430;Žiedas;Pakalnutės;1708363648;Taip;5;9;0;14
15431;Žiedas;Pakalnutės;1779122644;Taip;0;4;0;4
15432;Žiedas;Pakalnutės;9940683245;Taip;0;4;0;4
15433;Žiedas;Pakalnutės;1200692015;Taip;0;2;0;2
15434;Žiedas;Pakalnutės;1013773415;Taip;6;4;0;10
15435;Žiedas;Pakalnutės;27339844730;Taip;5;9;0;14
15436;Žiedas;Pakalnutės;5812737969;Ne;6;1;0;7
15437;Žiedas;Pakalnutės;1127645903;Ne;0;8;2;10
15438;Žiedas;Pakalnutės;1219022794;Taip;8;11;0;19
15439;Žiedas;Pakalnutės;7647496475;Taip;0;5;0;5
15440;Žiedas;Pakalnutės;1785446716;Ne;2;5;0;7
15441;Žiedas;Pakalnutės;2094277643;Ne;0;5;0;5
15442;Žiedas;Pakalnutės;12960180114;Taip;0;8;0;8
15443;Žiedas;Pakalnutės;3346603228;Taip;0;10;0;10
15444;Žiedas;Rožytės;2718046390;Taip;12;4;0;16
15445;Žiedas;Rožytės;1136010138;Taip;6;13;0;19
15446;Žiedas;Rožytės;1618505155;Taip;8;4;0;12
15447;Žiedas;Rožytės;47457128214;Taip;13;0;0;13
15448;Žiedas;Rožytės;40744263923;Taip;0;4;0;4
15449;Žiedas;Rožytės;33135652351;Ne;8;0;0;8
15450;Žiedas;Rožytės;87240375524;Taip;2;4;3;9
15451;Žiedas;Rožytės;1893226570;Taip;0;17;0;17
15452;Žiedas;Rožytės;7283725455;Taip;21;0;0;21
15453;Žiedas;Rožytės;56707734658;Taip;9;8;0;17
15454;Žiedas;Rožytės;2157262849;Taip;0;15;0;15
15455;Žiedas;Rožytės;9757771445;Taip;8;5;0;13
15456;Žiedas;Rožytės;73923918829;Taip;9;0;2;11
15457;Žiedas;Rožytės;4749655084;Taip;0;7;0;7
15458;Žiedas;Rožytės;1772492727;Taip;16;0;0;16
15459;Žiedas;Rožytės;8372385066;Taip;11;0;0;11
15460;Žiedas;Rožytės;3613860509;Taip;0;9;0;9
15461;Žiedas;Rožytės;5537717174;Taip;0;12;0;12
15462;Žiedas;Rožytės;6925923143;Taip;7;11;0;18
15463;Žiedas;Rožytės;1453937876;Taip;16;0;0;16
15464;Žiedas;Rožytės;1781950568;Taip;0;2;0;2
15465;Žiedas;Rožytės;9573180529;Taip;9;12;0;21
15466;Žiedas;Rožytės;2026462074;Taip;0;4;0;4
15467;Žiedas;Pumpurėliai;9140396365;Taip;8;1;0;9
15468;Žiedas;Pumpurėliai;7097790025;Taip;0;3;0;3
15469;Žiedas;Pumpurėliai;3178778438;Taip;13;4;0;17
15470;Žiedas;Pumpurėliai;6444377924;Taip;4;1;0;5
15471;Žiedas;Pumpurėliai;9587581470;Taip;4;4;0;8
15472;Žiedas;Pumpurėliai;5578227349;Taip;8;0;0;8
15473;Žiedas;Pumpurėliai;8812316692;Taip;11;0;1;12
15474;Žiedas;Pumpurėliai;3387263016;Ne;4;1;1;6
15475;Žiedas;Pumpurėliai;3230107921;Ne;4;2;0;6
15476;Žiedas;Pumpurėliai;9602083568;Taip;15;4;0;19
15477;Žiedas;Pumpurėliai;5628720422;Ne;7;4;0;11
15478;Žiedas;Pumpurėliai;1582961378;Ne;13;4;0;17
15479;Žiedas;Pumpurėliai;9020540780;Taip;9;1;0;10
15480;Žiedas;Pumpurėliai;3704491209;Taip;13;4;0;17
15481;Žiedas;Pumpurėliai;6914059680;Taip;5;0;1;6
15482;Žiedas;Pumpurėliai;7771247056;Ne;10;1;0;11
15483;Žiedas;Pumpurėliai;6515510381;Taip;7;3;0;10
15484;Žiedas;Pumpurėliai;3842589827;Taip;15;0;2;17
15485;Žiedas;Pumpurėliai;5835309107;Taip;6;1;1;8
15486;Žiedas;Pumpurėliai;3178580610;Ne;10;0;0;10
15487;Žiedas;Pumpurėliai;1878050384;Taip;0;0;1;1
15488;Žiedas;"Dobiliukai ";88471315730;Taip;0;4;0;4
15489;Žiedas;"Dobiliukai ";1484464986;Taip;10;4;0;14
15490;Žiedas;"Dobiliukai ";34193530;Taip;9;0;0;9
15491;Žiedas;"Dobiliukai ";1529988412;Taip;0;2;0;2
15492;Žiedas;"Dobiliukai ";78720591915;Taip;16;1;0;17
15493;Žiedas;"Dobiliukai ";1550350520;Taip;7;4;0;11
15494;Žiedas;"Dobiliukai ";2763469583;Taip;7;0;0;7
15495;Žiedas;"Dobiliukai ";86877563124;Taip;6;1;1;8
15496;Žiedas;"Dobiliukai ";1458152054;Ne;0;9;0;9
15497;Žiedas;"Dobiliukai ";3414702993;Taip;7;4;1;12
15498;Žiedas;"Dobiliukai ";69485023219;Taip;0;4;0;4
15499;Žiedas;"Dobiliukai ";1007894628;Ne;6;5;0;11
15500;Žiedas;"Dobiliukai ";1625009666;Taip;0;7;0;7
15501;Žiedas;"Dobiliukai ";1868951268;Taip;7;4;0;11
15502;Žiedas;"Dobiliukai ";1824692620;Taip;7;0;0;7
15503;Žiedas;"Dobiliukai ";9058688663;Ne;0;12;0;12
15504;Žiedas;"Dobiliukai ";2026728639;Taip;5;1;0;6
15505;Žiedas;"Dobiliukai ";7150433256;Taip;0;5;0;5
15506;Žiedas;"Dobiliukai ";6145720452;Taip;0;1;0;1
15507;Žiedas;"Dobiliukai ";1030089009;Ne;0;3;0;3
15508;Žiedas;"Dobiliukai ";4807479784;Taip;0;6;0;6
15509;Žiedas;"Dobiliukai ";2507543124;Taip;19;0;0;19
15510;Žiedas;"Dobiliukai ";6945326867;Taip;3;3;0;6
15511;Žiedas;"Dobiliukai ";9337128671;Taip;0;9;0;9
15512;Žiedas;RŪTELĖS;5885209631;Taip;0;6;4;10
15513;Žiedas;RŪTELĖS;2134466899;Taip;0;6;0;6
15514;Žiedas;RŪTELĖS;5420327672;Taip;0;6;1;7
15515;Žiedas;RŪTELĖS;5108263139;Taip;8;6;0;14
15516;Žiedas;RŪTELĖS;6822887260;Taip;0;6;0;6
15517;Žiedas;RŪTELĖS;9352485926;Taip;5;4;0;9
15518;Žiedas;RŪTELĖS;5914428064;Taip;11;3;0;14
15519;Žiedas;RŪTELĖS;3857121753;Taip;8;4;3;15
15520;Žiedas;RŪTELĖS;6443633568;Taip;8;4;9;21
15521;Žiedas;RŪTELĖS;7491134119;Taip;10;0;0;10
15522;Žiedas;RŪTELĖS;5959899914;Taip;7;11;0;18
15523;Žiedas;RŪTELĖS;1737296046;Taip;0;5;0;5
15524;Žiedas;RŪTELĖS;7333813704;Ne;6;7;0;13
15525;Žiedas;RŪTELĖS;1048272199;Taip;4;6;2;12
15526;Žiedas;RŪTELĖS;1645402434;Taip;8;4;0;12
15527;Žiedas;RŪTELĖS;3715928992;Taip;6;4;0;10
15528;Žiedas;RŪTELĖS;6658762922;Taip;0;5;0;5
15529;Žiedas;RŪTELĖS;5703750436;Taip;0;1;0;1
15530;Žiedas;RŪTELĖS;1253833615;Taip;0;2;0;2
15531;Žiedas;RŪTELĖS;7578964555;Ne;0;8;0;8
15532;Žiedas;RŪTELĖS;5126173608;Taip;8;8;0;16
15533;Žiedas;RŪTELĖS;5647232875;Ne;5;5;0;10
15534;Žiedas;RŪTELĖS;7172793351;Ne;17;4;0;21
15535;Žiedas;RŪTELĖS;4497634040;Taip;10;1;2;13
15536;Žiedas;RŪTELĖS;7057747531;Taip;12;5;0;17
15537;Žiedas;RŪTELĖS;1738121071;Taip;6;1;0;7
15538;Žiedas;SAULĖGRĄŽOS;36350993825;Taip;0;6;0;6
15539;Žiedas;SAULĖGRĄŽOS;69245659818;Taip;7;0;0;7
15540;Žiedas;SAULĖGRĄŽOS;2391924358;Taip;0;1;0;1
15541;Žiedas;SAULĖGRĄŽOS;8172222365;Taip;7;3;0;10
15542;Žiedas;SAULĖGRĄŽOS;8753972322;Taip;0;21;0;21
15543;Žiedas;SAULĖGRĄŽOS;3900091129;Taip;3;10;0;13
15544;Žiedas;SAULĖGRĄŽOS;9363714015;Taip;0;11;0;11
15545;Žiedas;SAULĖGRĄŽOS;6964047214;Taip;0;7;0;7
15546;Žiedas;SAULĖGRĄŽOS;3067962647;Ne;2;6;0;8
15547;Žiedas;SAULĖGRĄŽOS;2037477873;Taip;9;4;0;13
15548;Žiedas;SAULĖGRĄŽOS;2843328732;Taip;6;0;0;6
15549;Žiedas;SAULĖGRĄŽOS;2515028280;Taip;0;9;0;9
15550;Žiedas;SAULĖGRĄŽOS;1215443920;Taip;0;4;0;4
15551;Žiedas;SAULĖGRĄŽOS;5282211767;Taip;0;8;0;8
15552;Žiedas;SAULĖGRĄŽOS;1583038469;Taip;7;5;0;12
15553;Žiedas;SAULĖGRĄŽOS;8208331527;Taip;4;4;0;8
15554;Žiedas;SAULĖGRĄŽOS;8517250094;Taip;0;8;0;8
15555;Žiedas;SAULĖGRĄŽOS;1318132922;Taip;0;7;0;7
15556;Žiedas;SAULĖGRĄŽOS;6815408748;Taip;2;5;0;7
15557;Žiedas;SAULĖGRĄŽOS;5079107907;Taip;3;5;0;8
15558;Žiedas;SAULĖGRĄŽOS;7136135394;Ne;11;5;0;16
15559;Žiedas;SAULĖGRĄŽOS;1450251779;Taip;0;4;0;4
15560;Žiedas;SAULĖGRĄŽOS;9037835899;Ne;17;4;0;21
15561;Žiedas;RUGIAGĖLĖS;8148831014;Taip;0;4;4;8
15562;Žiedas;RUGIAGĖLĖS;8645771800;Taip;21;0;0;21
15563;Žiedas;RUGIAGĖLĖS;9702211410;Taip;4;0;1;5
15564;Žiedas;RUGIAGĖLĖS;5570910138;Taip;0;9;0;9
15565;Žiedas;RUGIAGĖLĖS;7187176169;Taip;5;9;0;14
15566;Žiedas;RUGIAGĖLĖS;8163645535;Taip;12;0;0;12
15567;Žiedas;RUGIAGĖLĖS;9750690920;Taip;0;11;0;11
15568;Žiedas;RUGIAGĖLĖS;4222689492;Taip;6;1;0;7
15569;Žiedas;RUGIAGĖLĖS;2763996098;Ne;21;0;0;21
15570;Žiedas;RUGIAGĖLĖS;9894489800;Ne;0;3;1;4
15571;Žiedas;RUGIAGĖLĖS;4983852075;Taip;6;0;4;10
15572;Žiedas;RUGIAGĖLĖS;4521161684;Ne;0;4;0;4
15573;Žiedas;RUGIAGĖLĖS;3641595127;Taip;0;10;0;10
15574;Žiedas;RUGIAGĖLĖS;1333233100;Taip;15;0;2;17
15575;Žiedas;RUGIAGĖLĖS;9129315784;Taip;8;8;0;16
15576;Žiedas;RUGIAGĖLĖS;4284627073;Taip;10;0;0;10
15577;Žiedas;RUGIAGĖLĖS;9094287056;Taip;10;0;2;12
15578;Žiedas;RUGIAGĖLĖS;3370495317;Taip;6;4;0;10
15579;Žiedas;RUGIAGĖLĖS;7952899220;Taip;0;2;2;4
15580;Žiedas;RUGIAGĖLĖS;6261847845;Taip;9;0;3;12
15581;Žiedas;RUGIAGĖLĖS;3984607857;Taip;4;4;0;8
15582;Žiedas;RUGIAGĖLĖS;5020148822;Taip;4;6;0;10
15583;Žiedas;RUGIAGĖLĖS;9415269410;Taip;2;4;1;7
15584;Žiedas;RUGIAGĖLĖS;7672879525;Taip;3;1;0;4
15585;Žiedas;Boružėlės;1079445123;Taip;0;4;0;4
15586;Žiedas;Boružėlės;50534384762;Taip;0;9;0;9
15587;Žiedas;Boružėlės;1985949180;Taip;14;4;0;18
15588;Žiedas;Boružėlės;1782429057;Taip;0;7;0;7
15589;Žiedas;Boružėlės;75047415039;Taip;0;5;0;5
15590;Žiedas;Boružėlės;85519253910;Taip;5;6;0;11
15591;Žiedas;Boružėlės;43123840066;Taip;5;6;0;11
15592;Žiedas;Boružėlės;50295529511;Taip;0;6;1;7
15593;Žiedas;Boružėlės;66729734455;Ne;0;2;0;2
15594;Žiedas;Boružėlės;226707253;Ne;2;3;0;5
15595;Žiedas;Boružėlės;4665596321;Taip;0;4;2;6
15596;Žiedas;Boružėlės;22305887643;Taip;0;4;0;4
15597;Žiedas;Boružėlės;39792014616;Ne;0;6;1;7
15598;Žiedas;Boružėlės;65264733887;Ne;0;6;1;7
15599;Žiedas;Boružėlės;56303923223;Ne;0;2;0;2
15600;Žiedas;Boružėlės;29411390190;Ne;9;1;0;10
15601;Žiedas;Boružėlės;55136247841;Taip;7;3;0;10
15602;Žiedas;AGUONĖLĖS;3055218791;Taip;0;1;0;1
15603;Žiedas;AGUONĖLĖS;9218388800;Taip;5;8;0;13
15604;Žiedas;AGUONĖLĖS;1243169901;Taip;4;3;0;7
15605;Žiedas;AGUONĖLĖS;1333555044;Taip;5;6;0;11
15606;Žiedas;AGUONĖLĖS;2682112101;Taip;4;6;0;10
15607;Žiedas;AGUONĖLĖS;4917324037;Taip;4;4;0;8
15608;Žiedas;AGUONĖLĖS;5789261620;Taip;13;4;0;17
15609;Žiedas;AGUONĖLĖS;5920211041;Taip;10;3;0;13
15610;Žiedas;AGUONĖLĖS;3168061557;Taip;10;4;0;14
15611;Žiedas;AGUONĖLĖS;4044156905;Taip;3;4;2;9
15612;Žiedas;AGUONĖLĖS;5977423702;Taip;12;6;0;18
15613;Žiedas;AGUONĖLĖS;4844442247;Taip;5;4;0;9
15614;Žiedas;AGUONĖLĖS;6884933845;Taip;5;4;0;9
15615;Žiedas;AGUONĖLĖS;4348246825;Taip;15;1;0;16
15616;Žiedas;AGUONĖLĖS;7294671324;Taip;14;4;0;18
15617;Žiedas;AGUONĖLĖS;3821849812;Taip;10;6;0;16
15618;Žiedas;AGUONĖLĖS;2938302462;Taip;5;9;0;14
15619;Žiedas;AGUONĖLĖS;7869675895;Taip;10;0;0;10
15620;Žiedas;AGUONĖLĖS;2092319455;Taip;5;4;0;9
15621;Žiedas;ŽIBUTĖS;8857150598;Taip;6;2;7;15
15622;Žiedas;ŽIBUTĖS;7942276632;Taip;4;0;0;4
15623;Žiedas;ŽIBUTĖS;1011602827;Taip;0;2;0;2
15624;Žiedas;ŽIBUTĖS;6041919197;Taip;0;5;4;9
15625;Žiedas;ŽIBUTĖS;7799489700;Taip;0;18;0;18
15626;Žiedas;ŽIBUTĖS;2932857132;Taip;17;0;0;17
15627;Žiedas;ŽIBUTĖS;2642760082;Taip;0;13;8;21
15628;Žiedas;ŽIBUTĖS;8927034492;Taip;0;0;21;21
15629;Žiedas;ŽIBUTĖS;2182381160;Taip;15;0;0;15
15630;Žiedas;ŽIBUTĖS;9057761408;Taip;0;4;2;6
15631;Žiedas;ŽIBUTĖS;9562512849;Ne;0;0;21;21
15632;Žiedas;ŽIBUTĖS;6175213274;Ne;0;1;1;2
15633;Žiedas;ŽIBUTĖS;8822472312;Taip;0;5;0;5
15634;Žiedas;ŽIBUTĖS;9021286246;Taip;0;13;0;13
15635;Žiedas;ŽIBUTĖS;4556559021;Taip;21;0;0;21
15636;Žiedas;ŽIBUTĖS;1777501190;Taip;6;4;0;10
15637;Žiedas;ŽIBUTĖS;1043230748;Taip;0;5;0;5
15638;Žiedas;ŽIBUTĖS;1844621525;Ne;0;6;0;6
15639;Žiedas;ŽIBUTĖS;1219634640;Taip;3;0;2;5
15640;Žiogelis;SKRUZDELYTĖS;8819549855;Ne;0;5;0;5
15641;Žiogelis;SKRUZDELYTĖS;4508141956;Taip;2;4;4;10
15642;Žiogelis;SKRUZDELYTĖS;4343510173;Taip;0;9;0;9
15643;Žiogelis;SKRUZDELYTĖS;18018505301;Taip;0;4;0;4
15644;Žiogelis;SKRUZDELYTĖS;3503872654;Taip;0;9;1;10
15645;Žiogelis;SKRUZDELYTĖS;6067622823;Taip;2;4;0;6
15646;Žiogelis;SKRUZDELYTĖS;8702710674;Taip;0;12;0;12
15647;Žiogelis;SKRUZDELYTĖS;4671356872;Taip;0;5;0;5
15648;Žiogelis;SKRUZDELYTĖS;7881358741;Taip;0;1;0;1
15649;Žiogelis;SKRUZDELYTĖS;3750023611;Taip;0;5;0;5
15650;Žiogelis;SKRUZDELYTĖS;3609961581;Taip;0;6;1;7
15651;Žiogelis;SKRUZDELYTĖS;64865699245;Taip;3;0;0;3
15652;Žiogelis;SKRUZDELYTĖS;60959051938;Taip;6;0;0;6
15653;Žiogelis;SKRUZDELYTĖS;95713316600;Taip;2;7;0;9
15654;Žiogelis;SKRUZDELYTĖS;4445888917;Taip;3;0;0;3
15655;Žiogelis;SKRUZDELYTĖS;24941867247;Ne;5;1;1;7
15656;Žiogelis;SKRUZDELYTĖS;6659086172;Ne;7;4;0;11
15657;Žiogelis;SKRUZDELYTĖS;2883732914;Taip;1;7;0;8
15658;Žiogelis;SKRUZDELYTĖS;3189872952;Taip;1;7;0;8
15659;Žiogelis;SKRUZDELYTĖS;9295720241;Taip;11;3;0;14
15660;Žiogelis;SKRUZDELYTĖS;1568915914;Taip;0;0;3;3
15661;Žiogelis;SKRUZDELYTĖS;3203359908;Taip;7;1;0;8
15662;Žiogelis;SKRUZDELYTĖS;3320077143;Ne;5;5;0;10
15663;Žiogelis;ŽIRNIUKAI;7704256764;Taip;0;11;0;11
15664;Žiogelis;ŽIRNIUKAI;6701809272;Taip;0;1;0;1
15665;Žiogelis;ŽIRNIUKAI;2233244282;Taip;0;3;0;3
15666;Žiogelis;ŽIRNIUKAI;8675451323;Taip;17;1;0;18
15667;Žiogelis;ŽIRNIUKAI;85437321236;Taip;0;2;0;2
15668;Žiogelis;ŽIRNIUKAI;1660784232;Taip;4;1;0;5
15669;Žiogelis;ŽIRNIUKAI;1320651707;Taip;0;8;0;8
15670;Žiogelis;ŽIRNIUKAI;1235203700;Taip;0;1;0;1
15671;Žiogelis;ŽIRNIUKAI;1551989977;Taip;0;7;0;7
15672;Žiogelis;ŽIRNIUKAI;3310492752;Taip;0;3;0;3
15673;Žiogelis;ŽIRNIUKAI;5557800297;Taip;0;3;0;3
15674;Žiogelis;ŽIRNIUKAI;3392582853;Taip;0;3;0;3
15675;Žiogelis;ŽIRNIUKAI;2366095661;Taip;6;2;0;8
15676;Žiogelis;ŽIRNIUKAI;1320126836;Taip;3;3;0;6
15677;Žiogelis;ŽIRNIUKAI;1442866468;Taip;6;1;0;7
15678;Žiogelis;ŽIRNIUKAI;6697117406;Taip;7;1;0;8
15679;Žiogelis;ŽIRNIUKAI;9862582346;Taip;0;3;0;3
15680;Žiogelis;ŽIRNIUKAI;7087781379;Ne;5;0;0;5
15681;Žiogelis;ŽIRNIUKAI;4015109974;Ne;5;0;0;5
15682;Žiogelis;ŽIRNIUKAI;9406830518;Taip;4;8;0;12
15683;Žiogelis;ŽIRNIUKAI;3910954904;Taip;0;8;0;8
15684;Žiogelis;ŽIRNIUKAI;4713696984;Ne;4;0;0;4
15685;Žiogelis;ŽIRNIUKAI;2028383677;Taip;5;1;0;6
15686;Žiogelis;ŽIRNIUKAI;2704243085;Taip;2;0;0;2
15687;Žiogelis;DOBILĖLIAI;8683148826;Taip;7;11;0;18
15688;Žiogelis;DOBILĖLIAI;3502278745;Taip;8;0;0;8
15689;Žiogelis;DOBILĖLIAI;3308563362;Taip;0;5;0;5
15690;Žiogelis;DOBILĖLIAI;3928697936;Taip;19;0;0;19
15691;Žiogelis;DOBILĖLIAI;1190395481;Taip;0;8;0;8
15692;Žiogelis;DOBILĖLIAI;1465027680;Taip;6;0;3;9
15693;Žiogelis;DOBILĖLIAI;6495456608;Taip;0;10;0;10
15694;Žiogelis;DOBILĖLIAI;5364996984;Taip;5;4;0;9
15695;Žiogelis;DOBILĖLIAI;9568208184;Taip;5;4;0;9
15696;Žiogelis;DOBILĖLIAI;6340620973;Taip;0;18;0;18
15697;Žiogelis;DOBILĖLIAI;5961630249;Taip;7;4;0;11
15698;Žiogelis;DOBILĖLIAI;7630342576;Ne;12;0;0;12
15699;Žiogelis;DOBILĖLIAI;6532218580;Taip;11;0;0;11
15700;Žiogelis;DOBILĖLIAI;1763070523;Ne;4;1;0;5
15701;Žiogelis;DOBILĖLIAI;5911231906;Taip;0;7;0;7
15702;Žiogelis;DOBILĖLIAI;9610249055;Taip;14;0;0;14
15703;Žiogelis;DOBILĖLIAI;6115834138;Ne;9;0;0;9
15704;Žiogelis;DOBILĖLIAI;3887222613;Ne;0;17;0;17
15705;Žiogelis;DOBILĖLIAI;8485067381;Taip;5;0;0;5
15706;Žiogelis;DOBILĖLIAI;7065052244;Taip;8;3;0;11
15707;Žiogelis;BORUŽĖLĖS;54446173105;Taip;2;0;0;2
15708;Žiogelis;BORUŽĖLĖS;4776403513;Taip;0;5;0;5
15709;Žiogelis;BORUŽĖLĖS;1617516552;Taip;2;4;0;6
15710;Žiogelis;BORUŽĖLĖS;81608736626;Taip;0;4;0;4
15711;Žiogelis;BORUŽĖLĖS;4465151986;Taip;0;6;2;8
15712;Žiogelis;BORUŽĖLĖS;6963163354;Taip;3;6;0;9
15713;Žiogelis;BORUŽĖLĖS;98660118094;Taip;0;16;0;16
15714;Žiogelis;BORUŽĖLĖS;67475530006;Ne;0;7;0;7
15715;Žiogelis;BORUŽĖLĖS;8169022043;Taip;0;4;0;4
15716;Žiogelis;BORUŽĖLĖS;5639046412;Ne;0;7;0;7
15717;Žiogelis;BORUŽĖLĖS;65387706999;Ne;0;1;0;1
15718;Žiogelis;BORUŽĖLĖS;45051106222;Taip;0;5;0;5
15719;Žiogelis;BORUŽĖLĖS;39293593638;Taip;1;0;0;1
15720;Žiogelis;BORUŽĖLĖS;49836275638;Taip;0;5;0;5
15721;Žiogelis;BORUŽĖLĖS;14932261911;Taip;12;5;0;17
15722;Žiogelis;BORUŽĖLĖS;48896172781;Taip;0;6;0;6
15723;Žiogelis;BORUŽĖLĖS;63956907259;Taip;2;2;0;4
15724;Žiogelis;BORUŽĖLĖS;30488905109;Taip;0;5;0;5
15725;Žiogelis;BORUŽĖLĖS;84919810287;Taip;0;6;0;6
15726;Žiogelis;BORUŽĖLĖS;73793165310;Taip;7;0;0;7
15727;Žiogelis;BORUŽĖLĖS;28788742249;Taip;7;0;0;7
15728;Žiogelis;BORUŽĖLĖS;87755643169;Taip;5;4;0;9
15729;Žiogelis;BORUŽĖLĖS;89934673064;Ne;4;0;0;4
15730;Žiogelis;BORUŽĖLĖS;5072204356;Taip;0;2;2;4
15731;Žiogelis;DRUGELIAI;40049935108;Taip;0;6;0;6
15732;Žiogelis;DRUGELIAI;37505015919;Taip;0;4;0;4
15733;Žiogelis;DRUGELIAI;25631779076;Taip;0;10;0;10
15734;Žiogelis;DRUGELIAI;91499233609;Taip;0;4;3;7
15735;Žiogelis;DRUGELIAI;40186714037;Taip;0;7;0;7
15736;Žiogelis;DRUGELIAI;52847485981;Taip;11;5;0;16
15737;Žiogelis;DRUGELIAI;96369154198;Ne;0;4;0;4
15738;Žiogelis;DRUGELIAI;56579227266;Ne;6;4;3;13
15739;Žiogelis;DRUGELIAI;66037746045;Taip;5;0;0;5
15740;Žiogelis;DRUGELIAI;68621438109;Taip;0;4;2;6
15741;Žiogelis;DRUGELIAI;18225364866;Taip;1;2;0;3
15742;Žiogelis;DRUGELIAI;18957711548;Taip;5;5;0;10
15743;Žiogelis;DRUGELIAI;52855728176;Ne;0;8;0;8
15744;Žiogelis;DRUGELIAI;35609682774;Taip;10;4;1;15
15745;Žiogelis;DRUGELIAI;1096666450;Taip;0;1;0;1
15746;Žiogelis;DRUGELIAI;1237788562;Taip;2;8;0;10
15747;Žiogelis;DRUGELIAI;1867019234;Taip;0;7;0;7
15748;Žiogelis;DRUGELIAI;1082983134;Taip;0;3;6;9
15749;Žiogelis;DRUGELIAI;9326053563;Taip;3;4;0;7
15750;Žiogelis;DRUGELIAI;2853980993;Taip;0;4;1;5
15751;Žiogelis;DRUGELIAI;6980862023;Taip;0;4;1;5
15752;Žiogelis;DRUGELIAI;52901528922;Taip;0;1;0;1
15753;Žiogelis;DRUGELIAI;5975060180;Taip;0;0;4;4
15754;Žiogelis;PELĖDŽIUKAI;25765405268;Taip;0;11;0;11
15755;Žiogelis;PELĖDŽIUKAI;40656416455;Taip;5;8;0;13
15756;Žiogelis;PELĖDŽIUKAI;58435832422;Taip;0;4;0;4
15757;Žiogelis;PELĖDŽIUKAI;65431295185;Taip;0;4;0;4
15758;Žiogelis;PELĖDŽIUKAI;54157468880;Taip;0;4;0;4
15759;Žiogelis;PELĖDŽIUKAI;90856268042;Taip;0;4;0;4
15760;Žiogelis;PELĖDŽIUKAI;4546122149;Taip;0;4;0;4
15761;Žiogelis;PELĖDŽIUKAI;677032532;Taip;0;3;0;3
15762;Žiogelis;PELĖDŽIUKAI;75990939732;Taip;0;7;0;7
15763;Žiogelis;PELĖDŽIUKAI;99706324340;Taip;0;9;0;9
15764;Žiogelis;PELĖDŽIUKAI;46206606894;Ne;0;4;0;4
15765;Žiogelis;PELĖDŽIUKAI;87136010729;Taip;0;2;0;2
15766;Žiogelis;PELĖDŽIUKAI;83065651470;Ne;7;3;0;10
15767;Žiogelis;PELĖDŽIUKAI;88467192459;Taip;9;9;0;18
15768;Žiogelis;PELĖDŽIUKAI;23052639699;Taip;4;1;0;5
15769;Žiogelis;PELĖDŽIUKAI;30153333482;Ne;9;5;0;14
15770;Žiogelis;PELĖDŽIUKAI;9520854450;Taip;0;7;0;7
15771;Žiogelis;PELĖDŽIUKAI;46938187629;Taip;0;4;0;4
15772;Žiogelis;PELĖDŽIUKAI;65284631135;Taip;0;2;0;2
15773;Žiogelis;PELĖDŽIUKAI;1303123383;Taip;0;16;0;16
15774;Žiogelis;PELĖDŽIUKAI;62633906174;Taip;0;4;0;4
15775;Žiogelis;PELĖDŽIUKAI;2100993889;Ne;0;3;0;3
15776;Žiogelis;PELĖDŽIUKAI;82738581846;Taip;0;6;0;6
15777;Žiogelis;PELĖDŽIUKAI;80050087040;Taip;9;9;0;18
15778;Žiogelis;VARPELIAI;63443494015;Taip;0;2;0;2
15779;Žiogelis;VARPELIAI;1069475442;Ne;0;2;0;2
15780;Žiogelis;VARPELIAI;72043183625;Taip;0;4;0;4
15781;Žiogelis;VARPELIAI;1198917418;Taip;0;11;0;11
15782;Žiogelis;VARPELIAI;44118139818;Taip;0;4;0;4
15783;Žiogelis;VARPELIAI;7708273984;Taip;12;2;0;14
15784;Žiogelis;VARPELIAI;1060830668;Taip;11;3;0;14
15785;Žiogelis;VARPELIAI;9871477318;Taip;0;4;0;4
15786;Žiogelis;VARPELIAI;6225523016;Taip;0;10;0;10
15787;Žiogelis;VARPELIAI;2575280329;Taip;5;1;0;6
15788;Žiogelis;VARPELIAI;4402777236;Taip;16;0;0;16
15789;Žiogelis;VARPELIAI;1370071592;Taip;0;7;0;7
15790;Žiogelis;VARPELIAI;9416538794;Taip;4;2;0;6
15791;Žiogelis;VARPELIAI;7888873296;Taip;12;3;0;15
15792;Žiogelis;VARPELIAI;8262619320;Taip;0;8;0;8
15793;Žiogelis;VARPELIAI;1837140329;Ne;0;3;0;3
15794;Žiogelis;VARPELIAI;8983731310;Taip;4;3;0;7
15795;Žiogelis;VARPELIAI;7493919076;Taip;21;0;0;21
15796;Žiogelis;KREGŽDUTĖS;1195431423;Taip;0;1;0;1
15797;Žiogelis;KREGŽDUTĖS;20399291813;Taip;4;6;0;10
15798;Žiogelis;KREGŽDUTĖS;1521276302;Taip;5;4;0;9
15799;Žiogelis;KREGŽDUTĖS;52932005977;Taip;0;8;0;8
15800;Žiogelis;KREGŽDUTĖS;28585504631;Taip;14;0;0;14
15801;Žiogelis;KREGŽDUTĖS;71387182665;Ne;17;0;0;17
15802;Žiogelis;KREGŽDUTĖS;94690046398;Taip;0;8;0;8
15803;Žiogelis;KREGŽDUTĖS;94313785346;Taip;0;5;0;5
15804;Žiogelis;KREGŽDUTĖS;88933947850;Taip;0;1;2;3
15805;Žiogelis;KREGŽDUTĖS;22969768169;Taip;0;11;0;11
15806;Žiogelis;KREGŽDUTĖS;18304908981;Taip;0;1;0;1
15807;Žiogelis;KREGŽDUTĖS;1042591705;Taip;7;9;0;16
15808;Žiogelis;KREGŽDUTĖS;1160064257;Taip;0;5;0;5
15809;Žiogelis;KREGŽDUTĖS;1162630845;Taip;0;6;1;7
15810;Žiogelis;KREGŽDUTĖS;2072071751;Taip;0;6;0;6
15811;Žiogelis;KREGŽDUTĖS;1200247527;Taip;0;7;0;7
15812;Žiogelis;KREGŽDUTĖS;41448152472;Taip;0;2;1;3
15813;Žiogelis;KREGŽDUTĖS;44023584723;Taip;13;0;0;13
15814;Žiogelis;KREGŽDUTĖS;1915370991;Taip;0;6;0;6
15815;Žiogelis;KREGŽDUTĖS;1821759690;Ne;0;5;0;5
15816;Žiogelis;KREGŽDUTĖS;24010106626;Taip;0;10;0;10
15817;Žiogelis;KREGŽDUTĖS;2062794337;Ne;7;2;0;9
15818;Žiogelis;KREGŽDUTĖS;3802615302;Taip;0;1;0;1
15819;Žiogelis;KREGŽDUTĖS;84803452318;Taip;17;1;0;18
15820;Žiogelis;KREGŽDUTĖS;10001742134;Ne;3;1;0;4
15821;Žiogelis;KREGŽDUTĖS;4675275745;Taip;21;0;0;21
15822;Žiogelis;ŽVIRBLIUKAI;4156736676;Ne;7;0;0;7
15823;Žiogelis;ŽVIRBLIUKAI;4565342104;Taip;10;0;2;12
15824;Žiogelis;ŽVIRBLIUKAI;8894068297;Taip;9;5;0;14
15825;Žiogelis;ŽVIRBLIUKAI;4609861306;Taip;9;0;0;9
15826;Žiogelis;ŽVIRBLIUKAI;9387048672;Taip;2;12;0;14
15827;Žiogelis;ŽVIRBLIUKAI;7502572217;Taip;10;5;4;19
15828;Žiogelis;ŽVIRBLIUKAI;1939672072;Taip;11;0;1;12
15829;Žiogelis;ŽVIRBLIUKAI;2759766559;Taip;19;0;0;19
15830;Žiogelis;ŽVIRBLIUKAI;1134384178;Taip;2;6;0;8
15831;Žiogelis;ŽVIRBLIUKAI;8689074067;Taip;5;2;0;7
15832;Žiogelis;ŽVIRBLIUKAI;7128248940;Taip;7;0;2;9
15833;Žiogelis;ŽVIRBLIUKAI;3963308094;Taip;9;0;0;9
15834;Žiogelis;ŽVIRBLIUKAI;9250789113;Taip;9;0;0;9
15835;Žiogelis;ŽVIRBLIUKAI;8217782981;Taip;12;2;0;14
15836;Žiogelis;ŽVIRBLIUKAI;5876904663;Taip;18;0;0;18
15837;Žiogelis;ŽVIRBLIUKAI;7120126547;Taip;5;3;0;8
15838;Žiogelis;ŽVIRBLIUKAI;7098548563;Taip;9;2;0;11
15839;Žiogelis;ŽVIRBLIUKAI;3937261260;Taip;5;2;0;7
15840;Žiogelis;BITUTĖS;3752355139;Taip;4;2;0;6
15841;Žiogelis;BITUTĖS;4605250897;Taip;14;0;0;14
15842;Žiogelis;BITUTĖS;6942029629;Ne;0;4;0;4
15843;Žiogelis;BITUTĖS;2173494736;Taip;2;4;0;6
15844;Žiogelis;BITUTĖS;3420228264;Taip;7;0;0;7
15845;Žiogelis;BITUTĖS;5042341085;Taip;5;2;0;7
15846;Žiogelis;BITUTĖS;6347738933;Taip;9;0;0;9
15847;Žiogelis;BITUTĖS;3296450902;Taip;0;2;0;2
15848;Žiogelis;BITUTĖS;2455244286;Taip;0;6;0;6
15849;Žiogelis;BITUTĖS;3792114246;Taip;3;4;0;7
15850;Žiogelis;BITUTĖS;9981130790;Taip;18;1;0;19
15851;Žiogelis;BITUTĖS;8293687695;Taip;0;9;0;9
15852;Žiogelis;BITUTĖS;3820534331;Taip;0;3;0;3
15853;Žiogelis;BITUTĖS;1996517542;Ne;0;7;0;7
15854;Žiogelis;BITUTĖS;5545581078;Taip;0;6;0;6
15855;Žiogelis;BITUTĖS;4630381709;Taip;0;3;0;3
15856;Žiogelis;BITUTĖS;9790463889;Taip;16;4;0;20
15857;Žiogelis;BITUTĖS;6024752960;Taip;4;0;0;4
15858;Žiogelis;BITUTĖS;8853905367;Taip;4;0;0;4
15859;Žiogelis;BITUTĖS;1397686161;Taip;0;5;0;5
15860;Žiogelis;BITUTĖS;2171351454;Taip;0;4;0;4
15861;Žiogelis;RIEŠUTĖLIAI;6378295945;Taip;9;0;0;9
15862;Žiogelis;RIEŠUTĖLIAI;4150956779;Taip;15;0;0;15
15863;Žiogelis;RIEŠUTĖLIAI;1268908081;Taip;0;7;0;7
15864;Žiogelis;RIEŠUTĖLIAI;1828843135;Taip;5;0;0;5
15865;Žiogelis;RIEŠUTĖLIAI;5487213418;Taip;0;11;0;11
15866;Žiogelis;RIEŠUTĖLIAI;3856321373;Taip;12;1;0;13
15867;Žiogelis;RIEŠUTĖLIAI;7340918175;Taip;13;0;1;14
15868;Žiogelis;RIEŠUTĖLIAI;7310459638;Taip;0;4;0;4
15869;Žiogelis;RIEŠUTĖLIAI;4513613915;Taip;0;7;0;7
15870;Žiogelis;RIEŠUTĖLIAI;8712788346;Taip;21;0;0;21
15871;Žiogelis;RIEŠUTĖLIAI;6866685213;Taip;20;0;0;20
15872;Žiogelis;RIEŠUTĖLIAI;9813150014;Taip;7;5;0;12
15873;Žiogelis;RIEŠUTĖLIAI;9874412804;Taip;13;0;0;13
15874;Žiogelis;RIEŠUTĖLIAI;3361421852;Taip;6;1;0;7
15875;Žiogelis;RIEŠUTĖLIAI;1763603533;Taip;9;0;0;9
15876;Žolynėlis;Spanguolėlė;92615552899;Taip;10;4;0;14
15877;Žolynėlis;Spanguolėlė;5717038791;Taip;7;5;0;12
15878;Žolynėlis;Spanguolėlė;15306882704;Taip;0;6;0;6
15879;Žolynėlis;Spanguolėlė;9128728457;Taip;0;3;0;3
15880;Žolynėlis;Spanguolėlė;1216568014;Taip;0;9;0;9
15881;Žolynėlis;Spanguolėlė;7438853916;Taip;2;14;1;17
15882;Žolynėlis;Spanguolėlė;44063150309;Taip;10;4;0;14
15883;Žolynėlis;Spanguolėlė;8700231970;Taip;0;3;0;3
15884;Žolynėlis;Spanguolėlė;7831076713;Ne;21;0;0;21
15885;Žolynėlis;Spanguolėlė;1901979061;Ne;5;9;1;15
15886;Žolynėlis;"RŪTELĖ (spec)";48837362422;Taip;0;13;0;13
15887;Žolynėlis;"RŪTELĖ (spec)";88879292846;Ne;0;7;0;7
15888;Žolynėlis;"RŪTELĖ (spec)";1954888655;Taip;0;5;0;5
15889;Žolynėlis;"RŪTELĖ (spec)";6619551947;Taip;5;6;0;11
15890;Žolynėlis;"RŪTELĖ (spec)";4000928238;Taip;0;21;0;21
15891;Žolynėlis;"RŪTELĖ (spec)";6678697536;Taip;14;2;0;16
15892;Žolynėlis;"RŪTELĖ (spec)";6510930436;Taip;17;0;0;17
15893;Žolynėlis;"SAULUTĖ (spec)";89488434450;Taip;7;0;0;7
15894;Žolynėlis;"SAULUTĖ (spec)";9675783636;Taip;12;2;0;14
15895;Žolynėlis;"LINELIS (spec)";93519259505;Taip;0;2;1;3
15896;Žolynėlis;"LINELIS (spec)";23605662146;Ne;3;0;0;3
15897;Žolynėlis;"LINELIS (spec)";7717415005;Taip;0;9;0;9
15898;Žolynėlis;"LINELIS (spec)";2665355759;Taip;0;9;0;9
15899;Žolynėlis;"LINELIS (spec)";6080154964;Taip;21;0;0;21
15900;Žolynėlis;"RASAKILA (spec)";4971887781;Taip;21;0;0;21
15901;Žolynėlis;"RASAKILA (spec)";3337602618;Ne;8;0;0;8
15902;Žolynėlis;"RASAKILA (spec)";7962304738;Ne;2;4;0;6
15903;Žolynėlis;"RASAKILA (spec)";1196172221;Ne;5;9;0;14
15904;Žolynėlis;"RAMUNĖLĖS (spec)";1916465295;Taip;4;0;0;4
15905;Žolynėlis;"RAMUNĖLĖS (spec)";4438939800;Taip;4;0;2;6
15906;Žolynėlis;"RAMUNĖLĖS (spec)";2511678193;Taip;12;0;0;12
15907;Žolynėlis;"RAMUNĖLĖS (spec)";9926551617;Taip;8;0;1;9
15908;Žolynėlis;Dobiliukai;1655571687;Taip;17;4;0;21
15909;Žolynėlis;Dobiliukai;1331253673;Taip;14;4;0;18
15910;Žolynėlis;Dobiliukai;89750778560;Taip;11;3;0;14
15911;Žolynėlis;Dobiliukai;76688557717;Taip;6;5;0;11
15912;Žolynėlis;Dobiliukai;47442048515;Taip;0;5;0;5
15913;Žolynėlis;Dobiliukai;75335374706;Taip;7;4;0;11
15914;Žolynėlis;Dobiliukai;71887799705;Taip;0;2;0;2
15915;Žolynėlis;Dobiliukai;1122183123;Taip;0;5;0;5
15916;Žolynėlis;Dobiliukai;1933377698;Taip;0;7;1;8
15917;Žolynėlis;Dobiliukai;3198470147;Taip;0;6;1;7
15918;Žolynėlis;Aguonėlė;7313345140;Taip;4;4;0;8
15919;Žolynėlis;Aguonėlė;1620578562;Taip;0;13;0;13
15920;Žolynėlis;Aguonėlė;77707724932;Taip;6;1;0;7
15921;Žolynėlis;Aguonėlė;4545601535;Taip;0;5;0;5
15922;Žolynėlis;Aguonėlė;95007685205;Taip;0;8;0;8
15923;Žolynėlis;Aguonėlė;61475380296;Taip;0;9;0;9
15924;Žolynėlis;Aguonėlė;8027151284;Taip;0;21;0;21
15925;Žolynėlis;Aguonėlė;28730145668;Taip;0;9;0;9
15926;Žolynėlis;Aguonėlė;84849092452;Taip;0;6;0;6
15927;Žolynėlis;Aguonėlė;3263848791;Taip;0;2;11;13
15928;Žolynėlis;Aguonėlė;7256502393;Taip;0;4;3;7
15929;Žolynėlis;Aguonėlė;79704789499;Taip;0;3;0;3
15930;Žolynėlis;Aguonėlė;2881461471;Taip;5;7;0;12
15931;Žolynėlis;Aguonėlė;8547773739;Taip;0;10;0;10
15932;Žolynėlis;Aguonėlė;2565770471;Taip;5;6;0;11
15933;Žolynėlis;Aguonėlė;5650427433;Taip;0;8;0;8
15934;Žolynėlis;Pienė;3520272555;Taip;7;5;0;12
15935;Žolynėlis;Pienė;3088932720;Taip;10;4;0;14
15936;Žolynėlis;Pienė;2108221942;Taip;7;6;0;13
15937;Žolynėlis;Pienė;2934361190;Taip;11;1;0;12
15938;Žolynėlis;Pienė;7980206574;Ne;0;2;4;6
15939;Žolynėlis;Pienė;2460982987;Taip;0;12;0;12
15940;Žolynėlis;Pienė;7339110559;Taip;5;0;4;9
15941;Žolynėlis;Pienė;6763515483;Taip;7;0;1;8
15942;Žolynėlis;Pienė;8215427354;Ne;0;16;0;16
15943;Žolynėlis;Pienė;1485195267;Taip;4;2;2;8
15944;Žolynėlis;Pienė;1163753820;Ne;12;0;0;12
15945;Žolynėlis;Pienė;9106152447;Taip;9;0;0;9
15946;Žolynėlis;Pienė;1879046798;Taip;9;0;2;11
15947;Žolynėlis;Pienė;4758738231;Taip;0;21;0;21
15948;Žolynėlis;Čiobreliai;4379062413;Taip;0;10;0;10
15949;Žolynėlis;Čiobreliai;96960531652;Taip;0;9;0;9
15950;Žolynėlis;Čiobreliai;32852326605;Taip;0;5;0;5
15951;Žolynėlis;Čiobreliai;67610580721;Taip;0;11;0;11
15952;Žolynėlis;Čiobreliai;91866724044;Taip;10;8;0;18
15953;Žolynėlis;Čiobreliai;58271736414;Taip;0;6;0;6
15954;Žolynėlis;Čiobreliai;1123243743;Taip;0;13;0;13
15955;Žolynėlis;Čiobreliai;79759781705;Taip;0;6;0;6
15956;Žolynėlis;Čiobreliai;1833898567;Taip;8;6;0;14
15957;Žolynėlis;Čiobreliai;29420971822;Taip;6;2;0;8
15958;Žolynėlis;Čiobreliai;1080834237;Ne;0;8;0;8
15959;Žolynėlis;Čiobreliai;1619061427;Ne;0;9;0;9
15960;Žolynėlis;Čiobreliai;8104525380;Taip;0;6;0;6
15961;Žolynėlis;Čiobreliai;24353356454;Taip;6;7;0;13
15962;Žolynėlis;Čiobreliai;82641799101;Taip;17;4;0;21
15963;Žolynėlis;Čiobreliai;95943166746;Taip;9;0;0;9
15964;Žolynėlis;Čiobreliai;4109395683;Taip;7;5;0;12
15965;Žolynėlis;Čiobreliai;2984354887;Taip;0;3;0;3
15966;Žolynėlis;Čiobreliai;66167062016;Taip;0;5;0;5
15967;Žolynėlis;Čiobreliai;2051626484;Taip;10;7;0;17
15968;Žolynėlis;Čiobreliai;1348748628;Taip;5;0;0;5
15969;Žolynėlis;Čiobreliai;5668288544;Taip;0;6;0;6
15970;Žolynėlis;Avietėlė;1337138547;Taip;8;1;0;9
15971;Žolynėlis;Avietėlė;4618251201;Ne;0;21;0;21
15972;Žolynėlis;Avietėlė;5432464074;Taip;10;4;0;14
15973;Žolynėlis;Avietėlė;3149718901;Taip;0;21;0;21
15974;Žolynėlis;Avietėlė;6829144389;Taip;5;4;0;9
15975;Žolynėlis;Avietėlė;6416217971;Taip;7;6;0;13
15976;Žolynėlis;Avietėlė;8646095992;Taip;10;0;0;10
15977;Žolynėlis;Avietėlė;3877168024;Taip;0;20;0;20
15978;Žolynėlis;Avietėlė;9238832484;Taip;11;0;0;11
15979;Žuvėdra;"JŪROS ŽVAIGŽDUTĖS";3516571980;Taip;4;1;0;5
15980;Žuvėdra;"JŪROS ŽVAIGŽDUTĖS";8096854841;Taip;6;0;4;10
15981;Žuvėdra;"JŪROS ŽVAIGŽDUTĖS";3148638780;Taip;12;1;0;13
15982;Žuvėdra;"JŪROS ŽVAIGŽDUTĖS";7673681906;Taip;11;0;0;11
15983;Žuvėdra;"JŪROS ŽVAIGŽDUTĖS";6148764075;Taip;7;5;1;13
15984;Žuvėdra;"JŪROS ŽVAIGŽDUTĖS";97427805302;Taip;0;1;0;1
15985;Žuvėdra;"JŪROS ŽVAIGŽDUTĖS";8349985186;Taip;21;0;0;21
15986;Žuvėdra;"JŪROS ŽVAIGŽDUTĖS";29500668582;Taip;12;2;3;17
15987;Žuvėdra;"JŪROS ŽVAIGŽDUTĖS";4828788876;Taip;4;10;0;14
15988;Žuvėdra;"JŪROS ŽVAIGŽDUTĖS";6068515077;Taip;0;8;0;8
15989;Žuvėdra;"JŪROS ŽVAIGŽDUTĖS";8104921853;Taip;0;4;2;6
15990;Žuvėdra;"JŪROS ŽVAIGŽDUTĖS";87882215162;Taip;8;5;1;14
15991;Žuvėdra;"JŪROS ŽVAIGŽDUTĖS";11300891895;Taip;13;3;0;16
15992;Žuvėdra;"JŪROS ŽVAIGŽDUTĖS";23851864127;Taip;3;3;4;10
15993;Žuvėdra;"JŪROS ŽVAIGŽDUTĖS";8843700949;Ne;0;10;0;10
15994;Žuvėdra;"JŪROS ŽVAIGŽDUTĖS";5472830961;Ne;9;2;0;11
15995;Žuvėdra;"JŪROS ŽVAIGŽDUTĖS";8589283055;Taip;8;0;4;12
15996;Žuvėdra;DELFINUKAI;2334342995;Taip;4;13;0;17
15997;Žuvėdra;DELFINUKAI;5558584030;Taip;6;0;0;6
15998;Žuvėdra;DELFINUKAI;5049101816;Ne;3;10;0;13
15999;Žuvėdra;DELFINUKAI;9230342970;Taip;20;0;0;20
16000;Žuvėdra;DELFINUKAI;3620753237;Taip;3;6;0;9
16001;Žuvėdra;DELFINUKAI;7272717439;Taip;0;2;0;2
16002;Žuvėdra;DELFINUKAI;2462839180;Ne;9;0;3;12
16003;Žuvėdra;DELFINUKAI;2660909247;Taip;2;0;1;3
16004;Žuvėdra;DELFINUKAI;8822952385;Ne;20;0;0;20
16005;Žuvėdra;DELFINUKAI;2092890028;Taip;15;0;0;15
16006;Žuvėdra;DELFINUKAI;7916717208;Taip;7;7;0;14
16007;Žuvėdra;DELFINUKAI;1311162040;Taip;8;9;0;17
16008;Žuvėdra;DELFINUKAI;9870595577;Taip;14;0;2;16
16009;Žuvėdra;DELFINUKAI;6294045755;Taip;0;6;0;6
16010;Žuvėdra;DELFINUKAI;3068069755;Taip;0;4;0;4
16011;Žuvėdra;DELFINUKAI;1200084485;Taip;5;7;0;12
16012;Žuvėdra;DELFINUKAI;2694424532;Taip;20;0;0;20
16013;Žuvėdra;DELFINUKAI;4177319374;Taip;7;6;0;13
16014;Žuvėdra;DELFINUKAI;9733979816;Ne;13;0;0;13
16015;Žuvėdra;OSMINOŽKI;1762760384;Taip;7;3;0;10
16016;Žuvėdra;OSMINOŽKI;1963584073;Taip;0;7;0;7
16017;Žuvėdra;OSMINOŽKI;2136463079;Taip;0;4;1;5
16018;Žuvėdra;OSMINOŽKI;74446494235;Taip;0;11;0;11
16019;Žuvėdra;OSMINOŽKI;1639340750;Taip;6;7;0;13
16020;Žuvėdra;OSMINOŽKI;3487938908;Ne;11;0;0;11
16021;Žuvėdra;OSMINOŽKI;66236924555;Taip;0;4;0;4
16022;Žuvėdra;OSMINOŽKI;66973380124;Ne;7;4;3;14
16023;Žuvėdra;OSMINOŽKI;8134671188;Taip;0;11;0;11
16024;Žuvėdra;OSMINOŽKI;4588593273;Taip;0;3;3;6
16025;Žuvėdra;OSMINOŽKI;55687216943;Ne;0;11;0;11
16026;Žuvėdra;OSMINOŽKI;1236696072;Taip;5;4;0;9
16027;Žuvėdra;OSMINOŽKI;1203660127;Taip;5;7;0;12
16028;Žuvėdra;OSMINOŽKI;9911525172;Taip;0;9;0;9
16029;Žuvėdra;OSMINOŽKI;24915726868;Taip;0;11;0;11
16030;Žuvėdra;OSMINOŽKI;1116645502;Taip;7;6;0;13
16031;Žuvėdra;OSMINOŽKI;1195732987;Ne;7;0;0;7
16032;Žuvėdra;OSMINOŽKI;1312918359;Taip;3;6;0;9
16033;Žuvėdra;OSMINOŽKI;1923452638;Taip;0;0;5;5
16034;Žuvėdra;OSMINOŽKI;6468506668;Ne;16;0;0;16
16035;Žuvėdra;OSMINOŽKI;83890207087;Taip;0;6;0;6
16036;Žuvėdra;OSMINOŽKI;1127602652;Taip;0;5;0;5
16037;Žuvėdra;RUSALAČKA;8408371550;Taip;3;6;0;9
16038;Žuvėdra;RUSALAČKA;2731016281;Taip;8;7;0;15
16039;Žuvėdra;RUSALAČKA;1164464390;Taip;0;6;0;6
16040;Žuvėdra;RUSALAČKA;1340241206;Taip;7;0;0;7
16041;Žuvėdra;RUSALAČKA;5021263583;Taip;0;5;0;5
16042;Žuvėdra;RUSALAČKA;5489757084;Taip;0;8;0;8
16043;Žuvėdra;RUSALAČKA;14760907606;Taip;10;0;2;12
16044;Žuvėdra;RUSALAČKA;1632308084;Taip;5;0;0;5
16045;Žuvėdra;RUSALAČKA;4011849839;Taip;5;8;0;13
16046;Žuvėdra;RUSALAČKA;5684848140;Taip;2;15;0;17
16047;Žuvėdra;RUSALAČKA;5496071972;Taip;3;0;1;4
16048;Žuvėdra;RUSALAČKA;6612880861;Taip;14;2;0;16
16049;Žuvėdra;RUSALAČKA;1941428466;Taip;0;2;0;2
16050;Žuvėdra;RUSALAČKA;6007871092;Taip;2;2;0;4
16051;Žuvėdra;RUSALAČKA;63053155507;Taip;0;6;0;6
16052;Žuvėdra;RUSALAČKA;3853045274;Taip;0;7;0;7
16053;Žuvėdra;RUSALAČKA;6537464526;Taip;16;4;0;20
16054;Žuvėdra;RUSALAČKA;5674529681;Taip;5;1;0;6
16055;Žuvėdra;RUSALAČKA;7368183516;Taip;5;4;0;9
16056;Žuvėdra;RUSALAČKA;3185158741;Ne;0;4;0;4
16057;Žuvėdra;RUSALAČKA;5198825127;Ne;18;0;0;18
16058;Žuvėdra;RUSALAČKA;5561903903;Taip;0;14;0;14
16059;Žuvėdra;JANTARIKI;1960306957;Taip;0;15;0;15
16060;Žuvėdra;JANTARIKI;7467154866;Taip;8;5;0;13
16061;Žuvėdra;JANTARIKI;4715123063;Taip;0;4;0;4
16062;Žuvėdra;JANTARIKI;6715416675;Taip;2;0;0;2
16063;Žuvėdra;JANTARIKI;8308610070;Taip;5;6;0;11
16064;Žuvėdra;JANTARIKI;2582404760;Taip;0;7;0;7
16065;Žuvėdra;JANTARIKI;3613045982;Taip;3;0;0;3
16066;Žuvėdra;JANTARIKI;1509519996;Taip;18;0;0;18
16067;Žuvėdra;JANTARIKI;5151984122;Taip;0;5;0;5
16068;Žuvėdra;JANTARIKI;8942228415;Taip;8;0;2;10
16069;Žuvėdra;JANTARIKI;4373886054;Taip;6;0;1;7
16070;Žuvėdra;JANTARIKI;2987217910;Taip;17;0;0;17
16071;Žuvėdra;JANTARIKI;6672289932;Taip;7;0;0;7
16072;Žuvėdra;JANTARIKI;3349158713;Taip;12;0;0;12
16073;Žuvėdra;JANTARIKI;4702627979;Taip;0;8;0;8
16074;Žuvėdra;JANTARIKI;5398303580;Taip;5;4;0;9
16075;Žuvėdra;"AUKSINĖ ŽUVELĖ";1343293430;Ne;4;0;0;4
16076;Žuvėdra;"AUKSINĖ ŽUVELĖ";6324315523;Taip;17;0;0;17
16077;Žuvėdra;"AUKSINĖ ŽUVELĖ";7121154799;Taip;14;4;0;18
16078;Žuvėdra;"AUKSINĖ ŽUVELĖ";5744370516;Taip;16;0;0;16
16079;Žuvėdra;"AUKSINĖ ŽUVELĖ";5571732399;Taip;9;0;0;9
16080;Žuvėdra;"AUKSINĖ ŽUVELĖ";8472945857;Taip;2;2;0;4
16081;Žuvėdra;"AUKSINĖ ŽUVELĖ";7958768355;Ne;2;0;0;2
16082;Žuvėdra;"AUKSINĖ ŽUVELĖ";8185190219;Taip;11;0;0;11
16083;Žuvėdra;"AUKSINĖ ŽUVELĖ";8700802853;Taip;4;2;0;6
16084;Žuvėdra;"AUKSINĖ ŽUVELĖ";9485995178;Taip;0;13;0;13
16085;Žuvėdra;"AUKSINĖ ŽUVELĖ";5436158437;Taip;3;0;0;3
16086;Žuvėdra;"AUKSINĖ ŽUVELĖ";8599646291;Taip;4;5;0;9
16087;Žuvėdra;"AUKSINĖ ŽUVELĖ";9521104462;Taip;15;4;0;19
16088;Žuvėdra;"AUKSINĖ ŽUVELĖ";2849503557;Taip;16;0;0;16
16089;Žuvėdra;"AUKSINĖ ŽUVELĖ";8162649794;Taip;20;0;0;20
16090;Žuvėdra;"AUKSINĖ ŽUVELĖ";6952843736;Taip;8;0;0;8
16091;Žvangutis;PELIUKŲ;6701947168;Taip;0;2;0;2
16092;Žvangutis;PELIUKŲ;50889154641;Taip;11;0;2;13
16093;Žvangutis;PELIUKŲ;1165172787;Taip;7;1;0;8
16094;Žvangutis;PELIUKŲ;1339151674;Ne;7;0;0;7
16095;Žvangutis;PELIUKŲ;1310113034;Taip;0;0;1;1
16096;Žvangutis;PELIUKŲ;7202747419;Taip;8;0;2;10
16097;Žvangutis;PELIUKŲ;7320625500;Taip;14;4;0;18
16098;Žvangutis;PELIUKŲ;3513746926;Taip;20;0;0;20
16099;Žvangutis;PELIUKŲ;4053450010;Taip;0;13;0;13
16100;Žvangutis;PELIUKŲ;9408369641;Ne;6;2;0;8
16101;Žvangutis;PELIUKŲ;6110958520;Taip;16;0;1;17
16102;Žvangutis;PELIUKŲ;8288997508;Ne;7;2;0;9
16103;Žvangutis;PELIUKŲ;3817258555;Taip;8;0;0;8
16104;Žvangutis;PELIUKŲ;6844824726;Ne;10;7;0;17
16105;Žvangutis;PELIUKŲ;3315858185;Taip;5;0;1;6
16106;Žvangutis;PELIUKŲ;92356998180;Taip;16;0;0;16
16107;Žvangutis;PELIUKŲ;6815104137;Taip;11;0;1;12
16108;Žvangutis;PELIUKŲ;5683601025;Taip;6;4;0;10
16109;Žvangutis;PELIUKŲ;8617941954;Taip;6;4;0;10
16110;Žvangutis;PELIUKŲ;3775960571;Taip;0;19;0;19
16111;Žvangutis;PELIUKŲ;11567978993;Taip;17;0;0;17
16112;Žvangutis;PELIUKŲ;9134683276;Taip;2;7;0;9
16113;Žvangutis;PELIUKŲ;8511103595;Taip;5;4;0;9
16114;Žvangutis;PELIUKŲ;7267340112;Taip;7;1;0;8
16115;Žvangutis;PELIUKŲ;9145365865;Taip;7;10;0;17
16116;Žvangutis;ANČIUKŲ;46159057420;Taip;0;2;1;3
16117;Žvangutis;ANČIUKŲ;93175189832;Taip;0;2;2;4
16118;Žvangutis;ANČIUKŲ;1353686877;Taip;0;4;0;4
16119;Žvangutis;ANČIUKŲ;18751626988;Taip;0;4;0;4
16120;Žvangutis;ANČIUKŲ;98607926663;Taip;0;1;6;7
16121;Žvangutis;ANČIUKŲ;12457255518;Taip;0;11;0;11
16122;Žvangutis;ANČIUKŲ;9618217868;Taip;5;4;0;9
16123;Žvangutis;ANČIUKŲ;91140904183;Ne;0;4;0;4
16124;Žvangutis;ANČIUKŲ;30697407645;Ne;9;4;0;13
16125;Žvangutis;ANČIUKŲ;86145834840;Taip;0;12;0;12
16126;Žvangutis;ANČIUKŲ;93894162596;Taip;0;4;2;6
16127;Žvangutis;ANČIUKŲ;38451136109;Ne;0;4;0;4
16128;Žvangutis;ANČIUKŲ;39364323060;Taip;0;21;0;21
16129;Žvangutis;ANČIUKŲ;57033172828;Taip;2;5;5;12
16130;Žvangutis;ANČIUKŲ;80054829676;Taip;0;9;0;9
16131;Žvangutis;ANČIUKŲ;11053503331;Taip;7;0;1;8
16132;Žvangutis;ANČIUKŲ;41703990445;Ne;0;10;0;10
16133;Žvangutis;ANČIUKŲ;5929099485;Ne;14;2;0;16
16134;Žvangutis;ANČIUKŲ;95130491335;Taip;0;1;0;1
16135;Žvangutis;ANČIUKŲ;77459956838;Taip;0;5;0;5
16136;Žvangutis;ANČIUKŲ;77044982999;Taip;9;0;0;9
16137;Žvangutis;ANČIUKŲ;5616640228;Taip;0;2;1;3
16138;Žvangutis;ANČIUKŲ;1898484868;Taip;5;4;1;10
16139;Žvangutis;PELĖDŽIUKŲ;2755838558;Taip;0;5;0;5
16140;Žvangutis;PELĖDŽIUKŲ;1322688456;Taip;7;0;0;7
16141;Žvangutis;PELĖDŽIUKŲ;9036869235;Taip;0;12;0;12
16142;Žvangutis;PELĖDŽIUKŲ;2570379643;Taip;0;15;0;15
16143;Žvangutis;PELĖDŽIUKŲ;2600596320;Taip;11;2;0;13
16144;Žvangutis;PELĖDŽIUKŲ;2623107843;Taip;5;1;0;6
16145;Žvangutis;PELĖDŽIUKŲ;1185135525;Taip;0;8;0;8
16146;Žvangutis;PELĖDŽIUKŲ;2411307963;Ne;10;1;0;11
16147;Žvangutis;PELĖDŽIUKŲ;9468660351;Taip;2;6;0;8
16148;Žvangutis;PELĖDŽIUKŲ;1324948757;Taip;4;1;0;5
16149;Žvangutis;PELĖDŽIUKŲ;2922083476;Taip;9;7;0;16
16150;Žvangutis;PELĖDŽIUKŲ;1282567366;Taip;6;4;0;10
16151;Žvangutis;PELĖDŽIUKŲ;6068428687;Taip;9;1;0;10
16152;Žvangutis;PELĖDŽIUKŲ;9149037184;Taip;2;15;0;17
16153;Žvangutis;PELĖDŽIUKŲ;3665275100;Taip;0;3;0;3
16154;Žvangutis;PELĖDŽIUKŲ;5012996199;Taip;0;10;0;10
16155;Žvangutis;PELĖDŽIUKŲ;8295525284;Taip;11;0;0;11
16156;Žvangutis;PELĖDŽIUKŲ;3276065009;Taip;16;0;0;16
16157;Žvangutis;PELĖDŽIUKŲ;6040986672;Taip;7;13;0;20
16158;Žvangutis;PELĖDŽIUKŲ;2716216474;Ne;0;16;0;16
16159;Žvangutis;KAČIUKŲ;1882797491;Taip;0;8;0;8
16160;Žvangutis;KAČIUKŲ;52676408047;Taip;15;0;0;15
16161;Žvangutis;KAČIUKŲ;52544167449;Taip;0;6;0;6
16162;Žvangutis;KAČIUKŲ;8697156717;Taip;3;6;1;10
16163;Žvangutis;KAČIUKŲ;23369081648;Taip;2;6;0;8
16164;Žvangutis;KAČIUKŲ;6989839997;Taip;0;6;0;6
16165;Žvangutis;KAČIUKŲ;1065463278;Ne;0;3;0;3
16166;Žvangutis;KAČIUKŲ;1369424754;Taip;0;12;0;12
16167;Žvangutis;KAČIUKŲ;1823402065;Taip;6;2;0;8
16168;Žvangutis;KAČIUKŲ;6343552093;Taip;6;11;0;17
16169;Žvangutis;KAČIUKŲ;2145325174;Taip;4;3;0;7
16170;Žvangutis;KAČIUKŲ;2251482949;Taip;3;0;0;3
16171;Žvangutis;KAČIUKŲ;1251015310;Taip;2;4;0;6
16172;Žvangutis;KAČIUKŲ;45857502483;Taip;5;2;0;7
16173;Žvangutis;KAČIUKŲ;4699447138;Taip;4;1;0;5
16174;Žvangutis;KAČIUKŲ;1862121693;Taip;0;7;0;7
16175;Žvangutis;KAČIUKŲ;619059820;Taip;2;4;0;6
16176;Žvangutis;KAČIUKŲ;1541156624;Taip;8;0;0;8
16177;Žvangutis;KAČIUKŲ;1096499939;Taip;0;4;0;4
16178;Žvangutis;KAČIUKŲ;1847928083;Taip;10;8;0;18
16179;Žvangutis;KAČIUKŲ;1665136168;Taip;2;10;0;12
16180;Žvangutis;MEŠKUČIŲ;2296360416;Taip;16;3;0;19
16181;Žvangutis;MEŠKUČIŲ;3957064486;Taip;8;8;0;16
16182;Žvangutis;MEŠKUČIŲ;9958554027;Taip;0;15;0;15
16183;Žvangutis;MEŠKUČIŲ;9239279639;Taip;0;5;8;13
16184;Žvangutis;MEŠKUČIŲ;1142315595;Taip;20;0;0;20
16185;Žvangutis;MEŠKUČIŲ;2351386211;Taip;0;11;0;11
16186;Žvangutis;MEŠKUČIŲ;6041698323;Taip;17;4;0;21
16187;Žvangutis;MEŠKUČIŲ;8492637734;Taip;11;8;0;19
16188;Žvangutis;MEŠKUČIŲ;7581320158;Taip;0;1;0;1
16189;Žvangutis;MEŠKUČIŲ;7721746116;Taip;5;4;1;10
16190;Žvangutis;MEŠKUČIŲ;2598842770;Taip;13;0;0;13
16191;Žvangutis;MEŠKUČIŲ;6723079944;Taip;14;4;0;18
16192;Žvangutis;MEŠKUČIŲ;4696437804;Taip;7;0;14;21
16193;Žvangutis;MEŠKUČIŲ;2042324002;Taip;5;15;0;20
16194;Žvangutis;MEŠKUČIŲ;7213349517;Taip;9;0;0;9
16195;Žvangutis;KIŠKUČIŲ;1687362077;Taip;0;8;0;8
16196;Žvangutis;KIŠKUČIŲ;1886637245;Taip;2;8;0;10
16197;Žvangutis;KIŠKUČIŲ;96443240617;Taip;0;4;2;6
16198;Žvangutis;KIŠKUČIŲ;4249416168;Taip;0;4;2;6
16199;Žvangutis;KIŠKUČIŲ;6661791076;Taip;6;3;0;9
16200;Žvangutis;KIŠKUČIŲ;1615111824;Taip;3;4;0;7
16201;Žvangutis;KIŠKUČIŲ;1481786579;Taip;2;7;0;9
16202;Žvangutis;KIŠKUČIŲ;1334567751;Taip;0;4;0;4
16203;Žvangutis;KIŠKUČIŲ;2138652487;Taip;8;4;0;12
16204;Žvangutis;KIŠKUČIŲ;1693249341;Taip;0;1;0;1
16205;Žvangutis;KIŠKUČIŲ;4798540560;Taip;0;9;0;9
16206;Žvangutis;KIŠKUČIŲ;5563516622;Taip;0;11;0;11
16207;Žvangutis;KIŠKUČIŲ;74528704135;Taip;0;4;1;5
16208;Žvangutis;KIŠKUČIŲ;57385778197;Taip;5;8;0;13
16209;Žvangutis;KIŠKUČIŲ;79808715852;Ne;0;16;0;16
16210;Žvangutis;KIŠKUČIŲ;5643005222;Taip;0;13;0;13
16211;Žvangutis;KIŠKUČIŲ;25954145882;Taip;0;1;0;1
16212;Žvangutis;KIŠKUČIŲ;1702224809;Ne;0;4;2;6
16213;Žvangutis;KIŠKUČIŲ;2111430405;Taip;6;6;0;12
16214;Žvangutis;KIŠKUČIŲ;46410307693;Taip;4;4;0;8
16215;Žvangutis;KIŠKUČIŲ;3049348955;Taip;0;7;0;7
16216;Žvangutis;KIŠKUČIŲ;1845521463;Taip;0;4;0;4
16217;Žirniukas;Boružiukų;5311746004;Taip;14;1;0;15
16218;Žirniukas;Boružiukų;6466220057;Ne;19;0;0;19
16219;Žirniukas;Boružiukų;3107511189;Ne;12;0;0;12
16220;Žirniukas;Boružiukų;2476906136;Taip;2;19;0;21
16221;Žirniukas;Boružiukų;2785102131;Taip;7;3;0;10
16222;Žirniukas;Boružiukų;6624263476;Taip;2;1;0;3
16223;Žirniukas;Boružiukų;8213507698;Taip;9;1;3;13
16224;Žirniukas;Boružiukų;2528905738;Ne;7;4;0;11
16225;Žirniukas;Boružiukų;2348752207;Taip;0;0;21;21
16226;Žirniukas;Boružiukų;6268788036;Taip;5;1;0;6
16227;Žirniukas;Boružiukų;6363169823;Taip;5;2;2;9
16228;Žirniukas;Boružiukų;2636634198;Taip;0;5;2;7
16229;Žirniukas;Boružiukų;8148254025;Taip;5;3;0;8
16230;Žirniukas;Boružiukų;1867254291;Taip;5;6;3;14
16231;Žirniukas;Boružiukų;5058103759;Taip;0;4;0;4
16232;Žirniukas;Boružiukų;6531175340;Taip;11;1;0;12
16233;Žirniukas;Boružiukų;9647374339;Taip;0;5;0;5
16234;Žirniukas;Boružiukų;6641200341;Taip;14;1;0;15
16235;Žirniukas;Boružiukų;3022672028;Taip;14;1;0;15
16236;Žirniukas;Boružiukų;4433579937;Taip;0;0;8;8
16237;Žirniukas;Smalsučiai;1701389895;Taip;0;2;0;2
16238;Žirniukas;Smalsučiai;65471257240;Ne;0;7;0;7
16239;Žirniukas;Smalsučiai;99019576563;Taip;0;5;0;5
16240;Žirniukas;Smalsučiai;56948775759;Taip;0;4;0;4
16241;Žirniukas;Smalsučiai;83035751096;Taip;0;5;0;5
16242;Žirniukas;Smalsučiai;29792078209;Ne;0;1;0;1
16243;Žirniukas;Smalsučiai;23221186484;Taip;8;4;0;12
16244;Žirniukas;Smalsučiai;43241022100;Taip;0;2;4;6
16245;Žirniukas;Smalsučiai;54285529186;Taip;0;4;0;4
16246;Žirniukas;Smalsučiai;1382313386;Taip;0;4;0;4
16247;Žirniukas;Smalsučiai;49058747304;Taip;5;4;0;9
16248;Žirniukas;Smalsučiai;6718181545;Taip;0;1;0;1
16249;Žirniukas;Smalsučiai;54685058502;Taip;0;4;1;5
16250;Žirniukas;Smalsučiai;59972903968;Taip;0;5;0;5
16251;Žirniukas;Smalsučiai;4377015113;Taip;5;4;0;9
16252;Žirniukas;Smalsučiai;37416946100;Taip;0;1;0;1
16253;Žirniukas;Smalsučiai;3723155762;Ne;4;6;0;10
16254;Žirniukas;Smalsučiai;3239212369;Taip;0;2;0;2
16255;Žirniukas;Smalsučiai;15527206706;Taip;0;5;0;5
16256;Žirniukas;Smalsučiai;83997736517;Taip;0;5;1;6
16257;Žirniukas;Smalsučiai;7739943293;Ne;0;3;0;3
16258;Žirniukas;Smalsučiai;89146903524;Taip;0;4;1;5
16259;Žirniukas;Smalsučiai;65003409430;Taip;0;5;0;5
16260;Žirniukas;Smalsučiai;1150580143;Taip;6;4;5;15
16261;Žirniukas;Gėlyčių;74425301830;Ne;7;3;0;10
16262;Žirniukas;Gėlyčių;3763537106;Taip;11;0;1;12
16263;Žirniukas;Gėlyčių;6649555415;Taip;0;0;15;15
16264;Žirniukas;Gėlyčių;32583177093;Ne;2;2;0;4
16265;Žirniukas;Gėlyčių;91259031678;Taip;4;0;2;6
16266;Žirniukas;Gėlyčių;1804181833;Taip;0;10;0;10
16267;Žirniukas;Gėlyčių;47573534391;Taip;7;4;0;11
16268;Žirniukas;Gėlyčių;1878369945;Taip;6;6;0;12
16269;Žirniukas;Gėlyčių;2072018782;Taip;0;3;0;3
16270;Žirniukas;Gėlyčių;1378845384;Taip;10;1;0;11
16271;Žirniukas;Gėlyčių;6455741324;Taip;9;0;1;10
16272;Žirniukas;Gėlyčių;8190751348;Taip;15;0;2;17
16273;Žirniukas;Gėlyčių;7872611724;Taip;17;0;0;17
16274;Žirniukas;Gėlyčių;4992122911;Taip;8;0;1;9
16275;Žirniukas;Gėlyčių;8180092480;Ne;7;0;1;8
16276;Žirniukas;Gėlyčių;7397202752;Taip;5;0;11;16
16277;Žirniukas;Gėlyčių;9938936765;Ne;7;0;1;8
16278;Žirniukas;Gėlyčių;3306670221;Taip;0;8;0;8
16279;Žirniukas;Nykštukų;2309995947;Taip;5;0;0;5
16280;Žirniukas;Nykštukų;1944169398;Taip;0;5;0;5
16281;Žirniukas;Nykštukų;1514504241;Taip;0;7;0;7
16282;Žirniukas;Nykštukų;1064894307;Taip;12;3;0;15
16283;Žirniukas;Nykštukų;1162904969;Taip;7;4;0;11
16284;Žirniukas;Nykštukų;2049123663;Taip;9;0;1;10
16285;Žirniukas;Nykštukų;1017483419;Taip;8;0;0;8
16286;Žirniukas;Nykštukų;6957047759;Taip;8;0;0;8
16287;Žirniukas;Nykštukų;2151329751;Taip;0;8;1;9
16288;Žirniukas;Nykštukų;5939918015;Taip;7;4;0;11
16289;Žirniukas;Nykštukų;3010062747;Ne;0;2;2;4
16290;Žirniukas;Nykštukų;2162238771;Taip;0;4;0;4
16291;Žirniukas;Nykštukų;2029018108;Taip;2;4;0;6
16292;Žirniukas;Nykštukų;5987510202;Taip;3;0;5;8
16293;Žirniukas;Nykštukų;5104110821;Taip;0;0;3;3
16294;Žirniukas;Nykštukų;7644911127;Taip;5;0;4;9
16295;Žirniukas;Nykštukų;6180439078;Taip;5;0;0;5
16296;Žirniukas;Nykštukų;3808838764;Ne;20;0;0;20
16297;Žirniukas;Nykštukų;7975957714;Ne;15;0;0;15
16298;Žirniukas;Saulytės;37852143615;Taip;6;4;3;13
16299;Žirniukas;Saulytės;1409567693;Taip;0;7;2;9
16300;Žirniukas;Saulytės;2022475049;Taip;12;0;0;12
16301;Žirniukas;Saulytės;32419042337;Taip;5;5;2;12
16302;Žirniukas;Saulytės;71263500233;Taip;16;0;2;18
16303;Žirniukas;Saulytės;65898776759;Taip;0;0;1;1
16304;Žirniukas;Saulytės;51172128673;Taip;0;8;1;9
16305;Žirniukas;Saulytės;29420916883;Taip;0;0;3;3
16306;Žirniukas;Saulytės;5189034384;Ne;0;7;2;9
16307;Žirniukas;Saulytės;68565861419;Ne;0;4;1;5
16308;Žirniukas;Saulytės;2294854901;Taip;13;0;1;14
16309;Žirniukas;Saulytės;5188013194;Taip;19;0;0;19
16310;Žirniukas;Saulytės;69810421328;Taip;7;5;2;14
16311;Žirniukas;Saulytės;66153778144;Taip;0;0;15;15
16312;Žirniukas;Saulytės;47491327916;Ne;0;4;5;9
16313;Žirniukas;Saulytės;98028824068;Taip;0;0;2;2
16314;Žirniukas;Saulytės;28992463324;Taip;4;3;0;7
16315;Žirniukas;Saulytės;60060805955;Taip;4;0;0;4
16316;Žirniukas;Saulytės;71922426195;Taip;9;4;4;17
16317;Žirniukas;Saulytės;46265018782;Taip;10;0;1;11
16318;Žirniukas;Saulytės;1095501791;Taip;11;0;1;12
16319;Žirniukas;Drugelių;2141162140;Taip;10;6;0;16
16320;Žirniukas;Drugelių;1294183547;Taip;12;3;0;15
16321;Žirniukas;Drugelių;9192660067;Taip;0;18;0;18
16322;Žirniukas;Drugelių;2557138057;Taip;0;0;3;3
16323;Žirniukas;Drugelių;3068684150;Taip;21;0;0;21
16324;Žirniukas;Drugelių;8644938346;Ne;7;3;0;10
16325;Žirniukas;Drugelių;1991599271;Ne;6;5;1;12
16326;Žirniukas;Drugelių;2282495237;Taip;0;0;5;5
16327;Žirniukas;Drugelių;1961708150;Taip;0;11;0;11
16328;Žirniukas;Drugelių;1393738771;Taip;0;0;2;2
16329;Žirniukas;Drugelių;9896415564;Taip;0;2;0;2
16330;Žirniukas;Drugelių;98962928727;Taip;11;0;0;11
16331;Žirniukas;Drugelių;6409900451;Taip;2;14;0;16
16332;Žirniukas;Drugelių;7190628011;Taip;7;13;0;20
16333;Žirniukas;Drugelių;3248779733;Taip;0;0;2;2
16334;Žirniukas;Drugelių;9374080010;Taip;5;0;0;5
16335;Žirniukas;Drugelių;1678041002;Taip;2;6;1;9
16336;Žirniukas;Drugelių;9649896460;Taip;0;0;3;3
16337;Žirniukas;Pelėdžiukai;1685677297;Taip;0;6;2;8
16338;Žirniukas;Pelėdžiukai;9424009308;Taip;2;6;1;9
16339;Žirniukas;Pelėdžiukai;1542257475;Taip;2;4;0;6
16340;Žirniukas;Pelėdžiukai;98781117814;Taip;9;4;1;14
16341;Žirniukas;Pelėdžiukai;1158530590;Taip;0;7;0;7
16342;Žirniukas;Pelėdžiukai;1352159915;Taip;3;1;3;7
16343;Žirniukas;Pelėdžiukai;1096649614;Taip;0;6;1;7
16344;Žirniukas;Pelėdžiukai;1699821845;Taip;0;1;0;1
16345;Žirniukas;Pelėdžiukai;52845409413;Taip;0;4;0;4
16346;Žirniukas;Pelėdžiukai;1609778506;Taip;0;2;2;4
16347;Žirniukas;Pelėdžiukai;1506642709;Taip;0;6;2;8
16348;Žirniukas;Pelėdžiukai;98441955394;Taip;0;3;0;3
16349;Žirniukas;Pelėdžiukai;2118772211;Taip;13;6;2;21
16350;Žirniukas;Pelėdžiukai;1788183728;Taip;2;2;0;4
16351;Žirniukas;Pelėdžiukai;1907669506;Taip;3;0;0;3
16352;Žirniukas;Pelėdžiukai;1607867151;Ne;0;5;0;5
16353;Žirniukas;Pelėdžiukai;1586083174;Taip;4;8;0;12
16354;Žirniukas;Pelėdžiukai;52181077421;Taip;0;3;3;6
16355;Žirniukas;Pelėdžiukai;5479153220;Taip;9;5;0;14
16356;Žirniukas;Pelėdžiukai;3236175335;Taip;0;4;2;6
16357;Žirniukas;ZUIKUČIAI;2733313392;Taip;17;0;0;17
16358;Žirniukas;ZUIKUČIAI;9961947583;Taip;9;0;0;9
16359;Žirniukas;ZUIKUČIAI;6834792589;Taip;5;0;0;5
16360;Žirniukas;ZUIKUČIAI;3610402086;Ne;2;2;0;4
16361;Žirniukas;ZUIKUČIAI;4827797140;Taip;19;1;1;21
16362;Žirniukas;ZUIKUČIAI;5819443551;Ne;0;5;3;8
16363;Žirniukas;ZUIKUČIAI;4045432303;Taip;9;7;0;16
16364;Žirniukas;ZUIKUČIAI;9707776533;Taip;18;0;0;18
16365;Žirniukas;ZUIKUČIAI;7278153529;Taip;0;8;1;9
16366;Žirniukas;ZUIKUČIAI;2325139043;Taip;11;1;1;13
16367;Žirniukas;ZUIKUČIAI;6254250706;Taip;12;0;0;12
16368;Žirniukas;ZUIKUČIAI;1262404954;Taip;12;0;0;12
16369;Žirniukas;ZUIKUČIAI;7926160083;Taip;0;0;8;8
16370;Žirniukas;ZUIKUČIAI;9656768968;Taip;10;2;0;12
16371;Žirniukas;ZUIKUČIAI;2982628594;Taip;19;0;0;19
16372;Žirniukas;ZUIKUČIAI;5422282267;Taip;0;0;4;4
16373;Žirniukas;ZUIKUČIAI;6362626389;Taip;4;1;3;8
16374;Aušra;Kodėlčiukai;4702400490;Taip;11;4;0;15
16375;Aušra;Kodėlčiukai;3420851059;Taip;10;2;0;12
16376;Aušra;Kodėlčiukai;2199083085;Taip;0;3;0;3
16377;Aušra;Kodėlčiukai;4720749995;Taip;9;0;1;10
16378;Aušra;Kodėlčiukai;6139706771;Taip;9;4;0;13
16379;Aušra;Kodėlčiukai;7314273812;Ne;7;6;0;13
16380;Aušra;Kodėlčiukai;5046439805;Taip;0;1;0;1
16381;Aušra;Kodėlčiukai;4540040693;Taip;21;0;0;21
16382;Aušra;Kodėlčiukai;1423840991;Taip;7;2;0;9
16383;Aušra;Kodėlčiukai;5013135853;Taip;12;4;0;16
16384;Aušra;Kodėlčiukai;9728140172;Taip;6;2;0;8
16385;Aušra;Kodėlčiukai;7765504789;Taip;6;3;0;9
16386;Aušra;Kodėlčiukai;8108663467;Taip;16;1;0;17
16387;Aušra;Kodėlčiukai;4824773027;Ne;7;0;0;7
16388;Aušra;Kodėlčiukai;1897365632;Taip;12;0;0;12
16389;Aušra;Kodėlčiukai;7469266085;Taip;11;10;0;21
16390;Aušra;Kodėlčiukai;1010721404;Taip;0;14;0;14
16391;Aušra;Kodėlčiukai;1883185016;Taip;0;7;0;7
16392;Aušra;Pelėdžiukai;8686777160;Ne;0;10;0;10
16393;Aušra;Pelėdžiukai;15657824495;Taip;0;16;0;16
16394;Aušra;Pelėdžiukai;1385844067;Taip;0;5;0;5
16395;Aušra;Pelėdžiukai;35429495907;Taip;0;6;3;9
16396;Aušra;Pelėdžiukai;79051821501;Taip;3;4;1;8
16397;Aušra;Pelėdžiukai;3001784066;Taip;0;4;0;4
16398;Aušra;Pelėdžiukai;5815377310;Ne;0;5;0;5
16399;Aušra;Pelėdžiukai;23609052737;Taip;6;10;0;16
16400;Aušra;Pelėdžiukai;3823619675;Taip;0;11;0;11
16401;Aušra;Pelėdžiukai;41017803426;Taip;0;0;4;4
16402;Aušra;Pelėdžiukai;13825730049;Taip;0;2;0;2
16403;Aušra;Pelėdžiukai;58254707316;Ne;0;2;3;5
16404;Aušra;Pelėdžiukai;18943927144;Ne;7;2;2;11
16405;Aušra;Pelėdžiukai;1623803107;Taip;0;2;5;7
16406;Aušra;Pelėdžiukai;57469542504;Taip;0;1;0;1
16407;Aušra;Pelėdžiukai;5409157554;Taip;10;2;2;14
16408;Aušra;Pelėdžiukai;2227238810;Ne;5;0;0;5
16409;Aušra;Pelėdžiukai;2000206874;Ne;8;0;0;8
16410;Aušra;Pelėdžiukai;4325224130;Taip;5;2;4;11
16411;Aušra;Pelėdžiukai;59267104215;Taip;8;4;0;12
16412;Aušra;Pelėdžiukai;5988529284;Taip;5;5;0;10
16413;Aušra;Smalsučiai;1049364899;Taip;0;8;2;10
16414;Aušra;Smalsučiai;95327350432;Taip;0;4;0;4
16415;Aušra;Smalsučiai;1154675251;Taip;0;4;3;7
16416;Aušra;Smalsučiai;1473962346;Taip;2;8;2;12
16417;Aušra;Smalsučiai;1427235223;Taip;0;4;0;4
16418;Aušra;Smalsučiai;2128822237;Taip;0;4;0;4
16419;Aušra;Smalsučiai;81510885976;Ne;0;4;0;4
16420;Aušra;Smalsučiai;1767520195;Taip;0;1;0;1
16421;Aušra;Smalsučiai;76979979920;Taip;0;3;3;6
16422;Aušra;Smalsučiai;97571593143;Taip;0;8;0;8
16423;Aušra;Smalsučiai;59235411329;Taip;6;4;4;14
16424;Aušra;Smalsučiai;42344686036;Ne;0;5;0;5
16425;Aušra;Smalsučiai;62209740677;Taip;2;4;0;6
16426;Aušra;Smalsučiai;2019580127;Ne;5;10;0;15
16427;Aušra;Smalsučiai;95586246863;Taip;0;6;0;6
16428;Aušra;Smalsučiai;66203768924;Taip;5;4;2;11
16429;Aušra;Smalsučiai;7962184651;Taip;0;4;3;7
16430;Aušra;Smalsučiai;12689030409;Taip;5;5;0;10
16431;Aušra;Smalsučiai;98150444770;Taip;6;0;0;6
16432;Aušra;Smalsučiai;1167565535;Taip;0;15;0;15
16433;Aušra;Smalsučiai;52044254281;Taip;2;4;2;8
16434;Aušra;Smalsučiai;1831747749;Taip;4;4;0;8
16435;Aušra;Smalsučiai;7222605763;Taip;11;4;0;15
16436;Aušra;Smalsučiai;4645855409;Taip;10;5;0;15
16437;Aušra;Smalsučiai;14343589644;Taip;0;4;0;4
16438;Aušra;Pagrandukai;7043021721;Taip;0;18;0;18
16439;Aušra;Pagrandukai;2023718424;Taip;0;3;1;4
16440;Aušra;Pagrandukai;8709340592;Taip;4;0;1;5
16441;Aušra;Pagrandukai;5524681006;Ne;0;4;9;13
16442;Aušra;Pagrandukai;4404047456;Taip;0;4;7;11
16443;Aušra;Pagrandukai;3680329197;Taip;16;0;0;16
16444;Aušra;Pagrandukai;2288159223;Taip;21;0;0;21
16445;Aušra;Pagrandukai;4805298824;Taip;0;2;0;2
16446;Aušra;Pagrandukai;29499576216;Taip;10;3;0;13
16447;Aušra;Pagrandukai;1940882109;Taip;0;4;0;4
16448;Aušra;Pagrandukai;7814902928;Taip;4;1;0;5
16449;Aušra;Pagrandukai;9702136789;Taip;9;2;0;11
16450;Aušra;Pagrandukai;6384243597;Taip;10;6;0;16
16451;Aušra;Pagrandukai;1612662076;Taip;0;2;0;2
16452;Aušra;Pagrandukai;3898178166;Ne;0;5;0;5
16453;Aušra;Pagrandukai;1575761029;Taip;7;6;0;13
16454;Aušra;Pagrandukai;5673568541;Taip;0;4;0;4
16455;Aušra;Pagrandukai;97102749430;Taip;0;4;0;4
16456;Aušra;Pagrandukai;5777939563;Ne;11;0;0;11
16457;Aušra;Pagrandukai;1956830515;Taip;6;0;0;6
16458;Aušra;Pagrandukai;8740755922;Taip;0;4;2;6
16459;Aušra;Pagrandukai;9831054554;Taip;0;3;0;3
16460;Aušra;"1A klasė";8510995681;Taip;1;4;0;5
16461;Aušra;"1A klasė";9605206310;Taip;0;4;0;4
16462;Aušra;"1A klasė";3284383302;Taip;0;4;0;4
16463;Aušra;"1A klasė";13157844661;Taip;0;4;0;4
16464;Aušra;"1A klasė";68160889669;Taip;6;4;0;10
16465;Aušra;"1A klasė";88655846176;Taip;3;4;0;7
16466;Aušra;"1A klasė";73509864636;Ne;1;4;0;5
16467;Aušra;"1A klasė";40499781883;Taip;1;4;0;5
16468;Aušra;"1A klasė";70233681803;Taip;0;4;0;4
16469;Aušra;"1A klasė";40714551025;Taip;8;4;0;12
16470;Aušra;"1A klasė";97781409787;Ne;10;4;0;14
16471;Aušra;"1A klasė";1396233353;Taip;3;4;0;7
16472;Aušra;"1A klasė";1437126272;Ne;2;4;0;6
16473;Aušra;"1A klasė";39537089288;Taip;1;4;0;5
16474;Aušra;"1A klasė";3965445196;Taip;0;4;0;4
16475;Aušra;"1A klasė";85578471272;Taip;1;4;0;5
16476;Aušra;"1A klasė";27958163601;Taip;0;4;0;4
16477;Aušra;"1A klasė";68031503463;Taip;1;4;0;5
16478;Aušra;"1A klasė";81633973264;Taip;0;4;0;4
16479;Aušra;"1A klasė";52985512945;Taip;0;4;0;4
16480;Aušra;"1A klasė";51185323645;Ne;0;4;0;4
16481;Aušra;"1A klasė";1437385365;Taip;9;4;0;13
16482;Aušra;"1A klasė";80929303402;Taip;4;4;0;8
16483;Aušra;"1A klasė";15330844181;Taip;0;4;0;4
16484;Aušra;"1A klasė";92468615840;Taip;0;4;0;4
16485;Aušra;"1A klasė";2062775070;Ne;6;4;0;10
16486;Aušra;"1A klasė";14157070764;Taip;0;4;0;4
16487;Aušra;"2A klasė";94704151051;Taip;1;4;0;5
16488;Aušra;"2A klasė";99886964420;Taip;0;21;0;21
16489;Aušra;"2A klasė";19920237804;Taip;1;4;0;5
16490;Aušra;"2A klasė";13361663464;Taip;2;4;0;6
16491;Aušra;"2A klasė";95948867937;Taip;0;21;0;21
16492;Aušra;"2A klasė";78030425432;Taip;1;4;0;5
16493;Aušra;"2A klasė";34795588283;Ne;0;21;0;21
16494;Aušra;"2A klasė";29636399665;Taip;1;4;0;5
16495;Aušra;"2A klasė";81428848455;Taip;1;4;0;5
16496;Aušra;"2A klasė";47725613978;Taip;0;21;0;21
16497;Aušra;"2A klasė";93365393803;Ne;3;4;0;7
16498;Aušra;"2A klasė";70687041413;Taip;1;4;0;5
16499;Aušra;"2A klasė";52864653926;Taip;0;21;0;21
16500;Aušra;"2A klasė";10272136932;Taip;5;4;0;9
16501;Aušra;"2A klasė";77425098448;Taip;1;4;0;5
16502;Aušra;"2A klasė";20550256232;Taip;3;4;0;7
16503;Aušra;"2A klasė";42015974556;Taip;1;4;0;5
16504;Aušra;"2A klasė";2113586354;Taip;8;4;0;12
16505;Aušra;"2A klasė";19718806057;Taip;3;4;0;7
16506;Aušra;"2A klasė";21856009403;Taip;5;4;0;9
16507;Aušra;"2A klasė";5166358753;Taip;1;4;0;5
16508;Aušra;"2A klasė";44870195034;Taip;5;4;0;9
16509;Aušra;"2A klasė";68481706412;Taip;0;21;0;21
16510;Aušra;"3A klasė";2908360090;Ne;3;4;0;7
16511;Aušra;"3A klasė";1585279799;Ne;4;4;0;8
16512;Aušra;"3A klasė";8497743711;Ne;12;4;0;16
16513;Aušra;"3A klasė";7439801986;Ne;1;4;0;5
16514;Aušra;"3A klasė";4952796453;Ne;3;4;0;7
16515;Aušra;"3A klasė";1404310604;Ne;1;4;0;5
16516;Aušra;"3A klasė";5770340819;Ne;1;4;0;5
16517;Aušra;"3A klasė";9510786725;Ne;6;4;0;10
16518;Aušra;"3A klasė";2280410145;Ne;0;21;0;21
16519;Aušra;"3A klasė";29945175192;Taip;0;21;0;21
16520;Aušra;"3A klasė";8367064629;Ne;7;4;0;11
16521;Aušra;"3A klasė";7931858964;Ne;7;4;0;11
16522;Aušra;"3A klasė";5792862565;Ne;1;4;0;5
16523;Aušra;"3A klasė";6942076490;Ne;3;4;0;7
16524;Aušra;"3A klasė";4399210916;Ne;1;4;0;5
16525;Aušra;"3A klasė";8892613555;Ne;3;4;0;7
16526;Aušra;"3A klasė";6534693192;Ne;3;4;0;7
16527;Aušra;"3A klasė";2797588970;Ne;2;4;0;6
16528;Aušra;"3A klasė";5657162092;Ne;0;21;0;21
16529;Aušra;"3A klasė";3435983733;Ne;3;4;0;7
16530;Aušra;"3A klasė";5825720308;Ne;0;21;0;21
16531;Aušra;"3A klasė";7313001921;Ne;1;4;0;5
16532;Aušra;"3A klasė";2796012982;Ne;1;4;0;5
16533;Aušra;"3A klasė";8632721907;Ne;3;4;0;7
16534;Aušra;"3A klasė";7113793626;Ne;1;4;0;5
16535;Aušra;"3A klasė";75839555732;Taip;6;4;0;10
16536;Aušra;"3A klasė";96979357769;Taip;0;21;0;21
16537;Aušra;"3A klasė";9584232864;Ne;10;4;0;14
16538;Aušra;"4A klasė";4190936993;Ne;0;4;0;4
16539;Aušra;"4A klasė";1685764132;Ne;0;21;0;21
16540;Aušra;"4A klasė";5340257141;Ne;0;4;0;4
16541;Aušra;"4A klasė";8328298376;Ne;0;21;0;21
16542;Aušra;"4A klasė";8543429220;Ne;6;4;0;10
16543;Aušra;"4A klasė";4341245904;Ne;0;4;0;4
16544;Aušra;"4A klasė";7499852390;Ne;0;21;0;21
16545;Aušra;"4A klasė";3749854924;Ne;1;4;0;5
16546;Aušra;"4A klasė";2072790876;Ne;1;4;0;5
16547;Aušra;"4A klasė";2863356239;Ne;2;4;0;6
16548;Aušra;"4A klasė";1448718807;Ne;0;21;0;21
16549;Aušra;"4A klasė";8550981774;Ne;3;4;0;7
16550;Aušra;"4A klasė";2951199272;Ne;0;4;0;4
16551;Aušra;"4A klasė";9332506542;Ne;1;4;0;5
16552;Aušra;"4A klasė";3115696927;Ne;2;4;0;6
16553;Aušra;"4A klasė";62035537641;Taip;0;21;0;21
16554;Aušra;"4A klasė";4073898542;Ne;0;21;0;21
16555;Aušra;"4A klasė";1414034080;Ne;5;4;0;9
16556;Aušra;"4A klasė";7435902333;Ne;0;4;0;4
16557;Aušra;"4A klasė";6232778631;Ne;3;4;0;7
16558;Aušra;"4A klasė";54244461148;Ne;1;4;0;5
16559;Aušra;"4A klasė";6540515450;Ne;0;21;0;21
16560;Aušra;"4A klasė";4257487788;Ne;2;4;0;6
16561;Aušra;"4A klasė";2942755846;Ne;1;4;0;5
16562;Aušra;"2B klasė";92119607174;Taip;1;4;0;5
16563;Aušra;"2B klasė";22923377435;Ne;2;4;0;6
16564;Aušra;"2B klasė";41852924528;Taip;1;4;0;5
16565;Aušra;"2B klasė";58526614808;Taip;1;4;0;5
16566;Aušra;"2B klasė";41039525379;Ne;2;4;0;6
16567;Aušra;"2B klasė";37339481276;Taip;3;4;0;7
16568;Aušra;"2B klasė";45165946624;Taip;1;4;0;5
16569;Aušra;"2B klasė";59107169775;Ne;1;4;0;5
16570;Aušra;"2B klasė";48349819906;Ne;1;4;0;5
16571;Aušra;"2B klasė";71596384638;Taip;4;4;0;8
16572;Aušra;"2B klasė";52332096506;Taip;4;4;0;8
16573;Aušra;"2B klasė";35703433862;Taip;1;4;0;5
16574;Aušra;"2B klasė";6201728036;Taip;0;21;0;21
16575;Aušra;"2B klasė";36889923728;Taip;1;4;0;5
16576;Aušra;"2B klasė";39957179831;Taip;0;21;0;21
16577;Aušra;"2B klasė";52909474598;Ne;3;4;0;7
16578;Aušra;"2B klasė";8901585006;Taip;4;4;0;8
16579;Aušra;"2B klasė";64562667133;Taip;2;4;0;6
16580;Aušra;"2B klasė";95076478544;Ne;1;4;0;5
16581;Aušra;"2B klasė";36899257479;Ne;1;4;0;5
16582;Aušra;"2B klasė";57520886724;Taip;0;21;0;21
16583;Aušra;"2B klasė";1815771421;Ne;1;4;0;5
16584;Aušra;"2B klasė";75433637766;Taip;5;4;0;9
16585;Aušra;"2B klasė";83119050626;Taip;3;4;0;7
16586;Aušra;"3B klasė";5687605664;Ne;0;21;0;21
16587;Aušra;"3B klasė";7713995959;Ne;1;4;0;5
16588;Aušra;"3B klasė";2610054474;Ne;0;21;0;21
16589;Aušra;"3B klasė";95798840861;Taip;0;21;0;21
16590;Aušra;"3B klasė";7553225340;Ne;1;4;0;5
16591;Aušra;"3B klasė";9736905104;Ne;9;4;0;13
16592;Aušra;"3B klasė";70054065156;Taip;5;4;0;9
16593;Aušra;"3B klasė";9695887585;Ne;0;4;0;4
16594;Aušra;"3B klasė";3225989797;Ne;1;4;0;5
16595;Aušra;"3B klasė";7405776766;Ne;0;21;0;21
16596;Aušra;"3B klasė";5005513948;Ne;2;4;0;6
16597;Aušra;"3B klasė";7697924792;Ne;0;21;0;21
16598;Aušra;"3B klasė";2412235474;Ne;2;4;0;6
16599;Aušra;"3B klasė";2075587354;Ne;1;4;0;5
16600;Aušra;"3B klasė";65535488153;Taip;1;4;0;5
16601;Aušra;"3B klasė";9600565378;Ne;0;21;0;21
16602;Aušra;"3B klasė";3114317363;Ne;5;4;0;9
16603;Aušra;"3B klasė";7075053685;Ne;0;21;0;21
16604;Aušra;"3B klasė";98154599269;Taip;0;21;0;21
16605;Aušra;"3B klasė";7321317333;Ne;0;4;0;4
16606;Aušra;"3B klasė";2893668707;Ne;0;4;0;4
16607;Aušra;"3B klasė";7886658451;Ne;0;21;0;21
16608;Berželis;PČIOLKI;1612263252;Taip;0;7;0;7
16609;Berželis;PČIOLKI;58375151019;Taip;7;4;0;11
16610;Berželis;PČIOLKI;56738219250;Taip;0;4;2;6
16611;Berželis;PČIOLKI;88322206113;Taip;4;0;1;5
16612;Berželis;PČIOLKI;75750848557;Ne;0;4;7;11
16613;Berželis;PČIOLKI;24479725723;Taip;0;1;0;1
16614;Berželis;PČIOLKI;77431203813;Taip;0;4;0;4
16615;Berželis;PČIOLKI;69799827219;Taip;0;4;1;5
16616;Berželis;PČIOLKI;19460486970;Taip;0;4;0;4
16617;Berželis;PČIOLKI;79818178445;Taip;0;3;1;4
16618;Berželis;PČIOLKI;8942344021;Ne;0;4;0;4
16619;Berželis;PČIOLKI;59374659821;Taip;0;4;0;4
16620;Berželis;PČIOLKI;56482980062;Ne;10;4;1;15
16621;Berželis;PČIOLKI;1740077377;Taip;10;7;0;17
16622;Berželis;PČIOLKI;91676607875;Taip;0;4;5;9
16623;Berželis;PČIOLKI;1729593575;Taip;0;4;1;5
16624;Berželis;PČIOLKI;33843845240;Taip;0;4;0;4
16625;Berželis;PČIOLKI;4605587503;Taip;0;4;5;9
16626;Berželis;PČIOLKI;5747645162;Taip;0;4;0;4
16627;Berželis;PČIOLKI;3923999931;Ne;0;1;0;1
16628;Berželis;PČIOLKI;9901922166;Taip;0;4;9;13
16629;Berželis;PČIOLKI;68853290649;Ne;0;4;7;11
16630;Berželis;PČIOLKI;1929783185;Taip;7;6;0;13
16631;Berželis;PČIOLKI;50400542457;Taip;0;4;0;4
16632;Berželis;PČIOLKI;68192824475;Taip;0;4;0;4
16633;Berželis;"BOŽJI KOROVKI";3162044236;Taip;7;0;0;7
16634;Berželis;"BOŽJI KOROVKI";9132058594;Taip;4;1;0;5
16635;Berželis;"BOŽJI KOROVKI";7421059780;Taip;11;0;0;11
16636;Berželis;"BOŽJI KOROVKI";5739847580;Taip;0;21;0;21
16637;Berželis;"BOŽJI KOROVKI";4100740863;Taip;0;17;0;17
16638;Berželis;"BOŽJI KOROVKI";1750209600;Taip;0;4;0;4
16639;Berželis;"BOŽJI KOROVKI";5953387226;Taip;0;20;0;20
16640;Berželis;"BOŽJI KOROVKI";9466461910;Taip;16;5;0;21
16641;Berželis;"BOŽJI KOROVKI";3070917065;Taip;14;2;0;16
16642;Berželis;"BOŽJI KOROVKI";8118040960;Taip;2;3;0;5
16643;Berželis;"BOŽJI KOROVKI";2005082089;Taip;5;2;0;7
16644;Berželis;"BOŽJI KOROVKI";5692603837;Taip;5;2;0;7
16645;Berželis;"BOŽJI KOROVKI";5194480946;Taip;9;0;0;9
16646;Berželis;"BOŽJI KOROVKI";9848723402;Taip;13;0;0;13
16647;Berželis;"BOŽJI KOROVKI";5551459997;Taip;0;4;0;4
16648;Berželis;"BOŽJI KOROVKI";6651007152;Taip;0;21;0;21
16649;Berželis;SOLNYŠKO;8871199713;Taip;0;21;0;21
16650;Berželis;SOLNYŠKO;2182268389;Taip;4;0;0;4
16651;Berželis;SOLNYŠKO;1498165322;Taip;9;2;0;11
16652;Berželis;SOLNYŠKO;4163605313;Taip;14;1;0;15
16653;Berželis;SOLNYŠKO;2882693941;Taip;0;21;0;21
16654;Berželis;SOLNYŠKO;9438498834;Taip;11;0;0;11
16655;Berželis;SOLNYŠKO;7852089381;Taip;11;0;0;11
16656;Berželis;SOLNYŠKO;6189116357;Taip;0;0;20;20
16657;Berželis;SOLNYŠKO;8737788279;Taip;0;14;0;14
16658;Berželis;SOLNYŠKO;8875116641;Taip;9;0;0;9
16659;Berželis;SOLNYŠKO;8771171576;Taip;11;0;0;11
16660;Berželis;SOLNYŠKO;2901168499;Taip;9;0;0;9
16661;Berželis;SOLNYŠKO;8297975308;Taip;2;4;0;6
16662;Berželis;SOLNYŠKO;2693961315;Taip;4;10;0;14
16663;Berželis;SOLNYŠKO;7411282628;Taip;0;21;0;21
16664;Berželis;SOLNYŠKO;7080168105;Ne;21;0;0;21
16665;Berželis;SOLNYŠKO;1316018865;Taip;9;0;0;9
16666;Berželis;BABOČKI;4923631429;Ne;17;0;0;17
16667;Berželis;BABOČKI;5371508044;Taip;4;0;1;5
16668;Berželis;BABOČKI;1076719080;Taip;16;0;0;16
16669;Berželis;BABOČKI;2016194182;Taip;4;0;3;7
16670;Berželis;BABOČKI;2030770943;Taip;0;7;0;7
16671;Berželis;BABOČKI;9839929976;Taip;17;4;0;21
16672;Berželis;BABOČKI;2667957070;Taip;1;0;3;4
16673;Berželis;BABOČKI;7781031211;Taip;7;3;2;12
16674;Berželis;BABOČKI;2493612905;Taip;7;4;0;11
16675;Berželis;BABOČKI;5688897783;Taip;0;14;0;14
16676;Berželis;BABOČKI;6942559693;Taip;0;4;1;5
16677;Berželis;BABOČKI;9245706377;Taip;5;6;0;11
16678;Berželis;BABOČKI;6352635742;Ne;0;8;0;8
16679;Berželis;BABOČKI;3097809074;Taip;8;0;0;8
16680;Berželis;BABOČKI;8448872491;Taip;0;2;0;2
16681;Berželis;BABOČKI;5069322062;Taip;0;4;3;7
16682;Berželis;BABOČKI;2954451168;Taip;2;4;1;7
16683;Berželis;BABOČKI;4312062240;Taip;0;1;0;1
16684;Berželis;BABOČKI;9585609150;Taip;21;0;0;21
16685;Berželis;BABOČKI;9091691636;Taip;10;0;0;10
16686;Berželis;SOVUŠKI;8939353460;Taip;17;0;0;17
16687;Berželis;SOVUŠKI;5879965735;Taip;4;0;3;7
16688;Berželis;SOVUŠKI;1183377037;Ne;8;0;1;9
16689;Berželis;SOVUŠKI;61614684164;Taip;11;0;0;11
16690;Berželis;SOVUŠKI;1573177287;Taip;10;5;0;15
16691;Berželis;SOVUŠKI;48932211843;Ne;0;0;7;7
16692;Berželis;SOVUŠKI;11671380984;Taip;0;0;7;7
16693;Berželis;SOVUŠKI;1927042277;Taip;4;6;0;10
16694;Berželis;SOVUŠKI;1566912722;Taip;6;4;0;10
16695;Berželis;SOVUŠKI;1865658456;Taip;18;0;0;18
16696;Berželis;SOVUŠKI;1061894314;Taip;0;0;9;9
16697;Berželis;SOVUŠKI;5739686368;Taip;0;4;0;4
16698;Berželis;SOVUŠKI;25985469678;Taip;16;1;0;17
16699;Berželis;SOVUŠKI;2028316867;Ne;8;8;0;16
16700;Berželis;SOVUŠKI;83253240251;Taip;14;0;0;14
16701;Berželis;SOVUŠKI;1470907829;Ne;0;0;7;7
16702;Berželis;SOVUŠKI;9134420285;Ne;11;0;0;11
16703;Berželis;SOVUŠKI;9894036261;Taip;11;0;0;11
16704;Berželis;SOVUŠKI;5337604370;Taip;0;0;6;6
16705;Berželis;SOVUŠKI;1492203156;Taip;11;0;1;12
16706;Berželis;SOVUŠKI;1511044883;Taip;0;3;0;3
16707;Berželis;SOVUŠKI;7713921014;Taip;0;4;6;10
16708;Berželis;PODSOLNUŠKI;4521372127;Taip;0;6;0;6
16709;Berželis;PODSOLNUŠKI;2214171136;Taip;0;4;0;4
16710;Berželis;PODSOLNUŠKI;97218091736;Taip;0;0;14;14
16711;Berželis;PODSOLNUŠKI;1521982237;Taip;12;3;0;15
16712;Berželis;PODSOLNUŠKI;4013215941;Taip;0;6;0;6
16713;Berželis;PODSOLNUŠKI;7526006253;Taip;0;6;0;6
16714;Berželis;PODSOLNUŠKI;64214150955;Ne;9;4;0;13
16715;Berželis;PODSOLNUŠKI;9024992452;Taip;10;5;0;15
16716;Berželis;PODSOLNUŠKI;9644196870;Taip;13;0;0;13
16717;Berželis;PODSOLNUŠKI;5084171353;Taip;6;5;0;11
16718;Berželis;PODSOLNUŠKI;1225018351;Taip;4;0;0;4
16719;Berželis;PODSOLNUŠKI;6473498471;Taip;4;0;0;4
16720;Berželis;PODSOLNUŠKI;1067618571;Taip;10;0;0;10
16721;Berželis;PODSOLNUŠKI;3772780161;Taip;17;0;0;17
16722;Berželis;PODSOLNUŠKI;4563582416;Taip;17;0;0;17
16723;Berželis;PODSOLNUŠKI;7227603702;Taip;10;0;0;10
16724;Berželis;PODSOLNUŠKI;6113571093;Ne;15;0;0;15
16725;Berželis;PODSOLNUŠKI;1036370516;Taip;9;0;1;10
16726;Berželis;PODSOLNUŠKI;4284157599;Taip;9;3;0;12
16727;Berželis;PODSOLNUŠKI;2615440913;Taip;9;0;0;9
16728;Berželis;PODSOLNUŠKI;9894751274;Taip;9;0;0;9
16729;Berželis;PODSOLNUŠKI;3298044639;Taip;4;0;1;5
16730;Berželis;PODSOLNUŠKI;3437712794;Taip;7;5;0;12
16731;Berželis;"1 klasė";7375940325;Taip;0;4;0;4
16732;Berželis;"1 klasė";39511689145;Taip;0;21;0;21
16733;Berželis;"1 klasė";62426432001;Taip;8;4;0;12
16734;Berželis;"1 klasė";29561378525;Taip;0;21;0;21
16735;Berželis;"1 klasė";51807139150;Ne;0;4;0;4
16736;Berželis;"1 klasė";95780247776;Ne;0;4;0;4
16737;Berželis;"1 klasė";83552840429;Taip;0;4;0;4
16738;Berželis;"1 klasė";84379482983;Taip;0;4;0;4
16739;Berželis;"1 klasė";17710158252;Taip;0;4;0;4
16740;Berželis;"1 klasė";86666390300;Taip;0;4;0;4
16741;Berželis;"1 klasė";37637382978;Taip;0;4;0;4
16742;Berželis;"1 klasė";95587380846;Taip;11;4;0;15
16743;Berželis;"1 klasė";48161697699;Taip;6;4;0;10
16744;Berželis;"1 klasė";44215014337;Taip;1;4;0;5
16745;Berželis;"1 klasė";2066819593;Taip;0;4;0;4
16746;Berželis;"1 klasė";36959641642;Taip;6;4;0;10
16747;Berželis;"2 klasė";3554738276;Taip;8;4;0;12
16748;Berželis;"2 klasė";68739754511;Taip;6;4;0;10
16749;Berželis;"2 klasė";9168601277;Taip;15;4;0;19
16750;Berželis;"2 klasė";93543942806;Taip;11;4;0;15
16751;Berželis;"2 klasė";5442568208;Taip;3;4;0;7
16752;Berželis;"2 klasė";84043380820;Taip;7;4;0;11
16753;Berželis;"2 klasė";945754955;Taip;17;4;0;21
16754;Berželis;"2 klasė";12564193771;Taip;9;4;0;13
16755;Berželis;"2 klasė";2412399682;Taip;9;4;0;13
16756;Berželis;"2 klasė";40956353978;Taip;2;4;0;6
16757;Berželis;"2 klasė";34721593327;Taip;5;4;0;9
16758;Berželis;"2 klasė";2511800624;Ne;5;4;0;9
16759;Berželis;"3 klasė";66532479024;Ne;3;4;0;7
16760;Berželis;"3 klasė";4381565277;Ne;0;4;0;4
16761;Berželis;"3 klasė";47358747103;Taip;0;4;0;4
16762;Berželis;"3 klasė";4263364972;Taip;3;4;0;7
16763;Berželis;"3 klasė";4750570367;Ne;0;21;0;21
16764;Berželis;"3 klasė";67358830655;Taip;3;4;0;7
16765;Berželis;"3 klasė";12252622276;Taip;0;4;0;4
16766;Berželis;"3 klasė";68547063004;Taip;0;4;0;4
16767;Berželis;"3 klasė";12819628369;Taip;9;4;0;13
16768;Berželis;"3 klasė";13521812215;Taip;0;21;0;21
16769;Berželis;"3 klasė";32336500026;Taip;0;4;0;4
16770;Berželis;"3 klasė";17898339325;Taip;17;4;0;21
16771;Berželis;"3 klasė";9395016208;Taip;0;4;0;4
16772;Berželis;"3 klasė";55709962549;Taip;8;4;0;12
16773;Berželis;"3 klasė";62300805754;Taip;4;4;0;8
16774;Berželis;"3 klasė";1162529591;Taip;6;4;0;10
16775;Berželis;"4 klasė";2691853015;Ne;2;4;0;6
16776;Berželis;"4 klasė";5856177876;Ne;3;4;0;7
16777;Berželis;"4 klasė";8143634742;Ne;1;4;0;5
16778;Berželis;"4 klasė";5616257764;Taip;4;4;0;8
16779;Berželis;"4 klasė";9486991928;Ne;0;4;0;4
16780;Berželis;"4 klasė";62987603892;Taip;1;4;0;5
16781;Berželis;"4 klasė";9998560354;Ne;9;4;0;13
16782;Berželis;"4 klasė";6702857359;Ne;1;4;0;5
16783;Berželis;"4 klasė";2955045450;Ne;0;4;0;4
16784;Berželis;"4 klasė";3149377224;Ne;3;4;0;7
16785;Berželis;"4 klasė";50930845005;Taip;0;4;0;4
16786;Berželis;"4 klasė";1161378829;Ne;6;4;0;10
16787;Berželis;"4 klasė";8322372921;Ne;0;4;0;4
16788;Berželis;"4 klasė";2501433917;Ne;0;21;0;21
16789;Berželis;"4 klasė";7728620622;Ne;0;4;0;4
16790;Berželis;"4 klasė";8921842915;Ne;6;4;0;10
16791;Berželis;"4 klasė";3064700283;Ne;1;4;0;5
16792;Saulutė;Drugeliai;66108847230;Taip;5;6;2;13
16793;Saulutė;Drugeliai;1556270046;Taip;0;1;0;1
16794;Saulutė;Drugeliai;3064199909;Taip;0;0;6;6
16795;Saulutė;Drugeliai;2097055107;Taip;0;6;0;6
16796;Saulutė;Drugeliai;1717909005;Taip;0;5;1;6
16797;Saulutė;Drugeliai;1283800571;Taip;0;1;5;6
16798;Saulutė;Drugeliai;8599199376;Taip;7;1;0;8
16799;Saulutė;Drugeliai;1750571258;Taip;0;11;0;11
16800;Saulutė;Drugeliai;87814849917;Taip;5;5;5;15
16801;Saulutė;Drugeliai;1609952589;Taip;5;0;0;5
16802;Saulutė;Drugeliai;1386800520;Taip;7;1;3;11
16803;Saulutė;Drugeliai;1261384337;Taip;11;4;0;15
16804;Saulutė;Drugeliai;1320018338;Ne;19;0;0;19
16805;Saulutė;Drugeliai;1291318940;Taip;14;4;0;18
16806;Saulutė;Drugeliai;2162114750;Ne;0;0;9;9
16807;Saulutė;Drugeliai;9550046358;Taip;0;5;4;9
16808;Saulutė;Drugeliai;1391904744;Taip;15;1;0;16
16809;Saulutė;Drugeliai;8944601874;Taip;8;7;0;15
16810;Saulutė;Drugeliai;4272320685;Taip;0;7;0;7
16811;Saulutė;Drugeliai;2622662153;Ne;0;0;7;7
16812;Saulutė;Drugeliai;1020606591;Taip;9;4;0;13
16813;Saulutė;Drugeliai;7539721995;Taip;6;4;0;10
16814;Saulutė;"Saulės zuikučiai";8946107286;Taip;11;3;0;14
16815;Saulutė;"Saulės zuikučiai";2397257894;Taip;11;4;0;15
16816;Saulutė;"Saulės zuikučiai";2010774109;Taip;13;4;0;17
16817;Saulutė;"Saulės zuikučiai";3089541630;Taip;0;3;0;3
16818;Saulutė;"Saulės zuikučiai";5148542811;Taip;21;0;0;21
16819;Saulutė;"Saulės zuikučiai";1562393383;Taip;7;4;1;12
16820;Saulutė;"Saulės zuikučiai";2259917151;Taip;2;4;1;7
16821;Saulutė;"Saulės zuikučiai";3691381351;Taip;0;5;1;6
16822;Saulutė;"Saulės zuikučiai";3749374270;Taip;5;4;0;9
16823;Saulutė;"Saulės zuikučiai";9146298505;Taip;0;4;4;8
16824;Saulutė;"Saulės zuikučiai";8242602551;Ne;12;2;0;14
16825;Saulutė;"Saulės zuikučiai";1324799653;Taip;0;14;0;14
16826;Saulutė;"Saulės zuikučiai";5247769309;Taip;10;0;0;10
16827;Saulutė;"Saulės zuikučiai";2816806902;Taip;14;0;0;14
16828;Saulutė;"Saulės zuikučiai";7844396402;Taip;6;1;0;7
16829;Saulutė;"Saulės zuikučiai";2781003892;Taip;0;9;0;9
16830;Saulutė;"Saulės zuikučiai";9521155670;Taip;0;7;0;7
16831;Saulutė;"Saulės zuikučiai";9892855816;Taip;10;0;0;10
16832;Saulutė;"Saulės zuikučiai";5326279083;Taip;6;0;0;6
16833;Saulutė;"Saulės zuikučiai";3675783868;Taip;0;4;3;7
16834;Saulutė;"Saulės zuikučiai";7351477901;Taip;0;10;0;10
16835;Saulutė;"Saulės zuikučiai";5839981073;Ne;0;9;0;9
16836;Saulutė;"Saulės zuikučiai";7888435573;Taip;0;0;3;3
16837;Saulutė;Boružėlės;3272296969;Taip;0;6;1;7
16838;Saulutė;Boružėlės;6044672321;Taip;7;0;3;10
16839;Saulutė;Boružėlės;3295289082;Taip;3;12;0;15
16840;Saulutė;Boružėlės;1587328722;Taip;7;0;0;7
16841;Saulutė;Boružėlės;8390767549;Taip;5;4;0;9
16842;Saulutė;Boružėlės;7576532632;Taip;0;0;7;7
16843;Saulutė;Boružėlės;2725491887;Taip;10;0;3;13
16844;Saulutė;Boružėlės;9314889468;Taip;9;0;0;9
16845;Saulutė;Boružėlės;9173336078;Taip;3;1;0;4
16846;Saulutė;Boružėlės;3408369823;Taip;0;4;1;5
16847;Saulutė;Boružėlės;5329894543;Taip;17;0;0;17
16848;Saulutė;Boružėlės;6803541200;Taip;16;4;0;20
16849;Saulutė;Boružėlės;8643975544;Taip;0;0;1;1
16850;Saulutė;Boružėlės;4818911910;Ne;18;0;0;18
16851;Saulutė;Boružėlės;7081700501;Taip;0;0;3;3
16852;Saulutė;Boružėlės;9098663596;Taip;0;0;1;1
16853;Saulutė;Boružėlės;1803710557;Taip;0;0;5;5
16854;Saulutė;Boružėlės;7425789805;Taip;0;0;1;1
16855;Saulutė;Boružėlės;7474989619;Ne;0;8;7;15
16856;Saulutė;Boružėlės;8619163154;Ne;0;0;3;3
16857;Saulutė;Boružėlės;7574225926;Taip;0;0;3;3
16858;Saulutė;Nykštukai;6099238784;Taip;0;4;2;6
16859;Saulutė;Nykštukai;7318452189;Taip;0;13;0;13
16860;Saulutė;Nykštukai;1855999738;Ne;2;6;0;8
16861;Saulutė;Nykštukai;78558743548;Taip;0;11;0;11
16862;Saulutė;Nykštukai;91371507376;Ne;2;7;0;9
16863;Saulutė;Nykštukai;4771504414;Taip;0;4;5;9
16864;Saulutė;Nykštukai;55160240384;Taip;0;10;0;10
16865;Saulutė;Nykštukai;19852146326;Taip;0;7;0;7
16866;Saulutė;Nykštukai;1861612651;Ne;0;4;0;4
16867;Saulutė;Nykštukai;1745560688;Taip;0;1;0;1
16868;Saulutė;Nykštukai;63481737955;Taip;0;4;0;4
16869;Saulutė;Nykštukai;12674831673;Taip;0;4;2;6
16870;Saulutė;Nykštukai;32539394191;Taip;11;4;0;15
16871;Saulutė;Nykštukai;1913500127;Taip;0;6;0;6
16872;Saulutė;Nykštukai;23640604487;Taip;2;0;4;6
16873;Saulutė;Nykštukai;54373231773;Taip;2;4;0;6
16874;Saulutė;Nykštukai;88168936754;Taip;0;4;2;6
16875;Saulutė;Nykštukai;98979263108;Taip;0;7;0;7
16876;Saulutė;Nykštukai;1217446865;Taip;0;4;2;6
16877;Saulutė;Nykštukai;8399364592;Taip;0;4;5;9
16878;Saulutė;Nykštukai;1077526046;Ne;10;2;5;17
16879;Saulutė;Meškiukai;1776164273;Taip;0;0;5;5
16880;Saulutė;Meškiukai;5264813819;Taip;13;0;0;13
16881;Saulutė;Meškiukai;5850783789;Taip;19;0;0;19
16882;Saulutė;Meškiukai;7243072252;Taip;10;4;2;16
16883;Saulutė;Meškiukai;5607937410;Taip;13;1;0;14
16884;Saulutė;Meškiukai;3571751974;Taip;4;0;0;4
16885;Saulutė;Meškiukai;2527027536;Taip;8;4;2;14
16886;Saulutė;Meškiukai;7620841597;Taip;13;0;0;13
16887;Saulutė;Meškiukai;7640441297;Taip;0;7;3;10
16888;Saulutė;Meškiukai;6046611248;Taip;9;4;0;13
16889;Saulutė;Meškiukai;4301516165;Taip;19;2;0;21
16890;Saulutė;Meškiukai;3221612665;Taip;9;0;1;10
16891;Saulutė;Meškiukai;9903380188;Taip;5;0;0;5
16892;Saulutė;Meškiukai;6608003946;Taip;4;13;0;17
16893;Saulutė;Meškiukai;2450554594;Taip;5;1;0;6
16894;Saulutė;Ežiukai;1686338325;Taip;0;4;0;4
16895;Saulutė;Ežiukai;1888990522;Taip;4;4;1;9
16896;Saulutė;Ežiukai;2140277182;Taip;9;0;1;10
16897;Saulutė;Ežiukai;1546200973;Ne;7;0;0;7
16898;Saulutė;Ežiukai;1917058710;Taip;5;0;3;8
16899;Saulutė;Ežiukai;2813274509;Taip;11;0;0;11
16900;Saulutė;Ežiukai;4510990261;Taip;0;0;1;1
16901;Saulutė;Ežiukai;8708184278;Taip;0;0;2;2
16902;Saulutė;Ežiukai;8433646525;Taip;2;6;0;8
16903;Saulutė;Ežiukai;3410606033;Taip;0;7;0;7
16904;Saulutė;Ežiukai;6057668143;Ne;4;0;0;4
16905;Saulutė;Ežiukai;7413098580;Taip;9;2;2;13
16906;Saulutė;Ežiukai;5999318972;Taip;8;0;1;9
16907;Saulutė;Ežiukai;9269501176;Taip;0;0;1;1
16908;Saulutė;Ežiukai;2059342403;Ne;6;0;1;7
16909;Saulutė;Ežiukai;8257363228;Taip;18;0;0;18
16910;Saulutė;Ežiukai;7297886198;Taip;6;0;4;10
16911;Saulutė;Ežiukai;8736917541;Taip;2;0;0;2
16912;Saulutė;Ežiukai;6982979199;Taip;13;0;0;13
16913;Saulutė;Ežiukai;4800144085;Taip;9;0;2;11
16914;Saulutė;Bitutės;8984040932;Taip;0;2;0;2
16915;Saulutė;Bitutės;2373409300;Taip;0;10;6;16
16916;Saulutė;Bitutės;2545930114;Ne;13;0;0;13
16917;Saulutė;Bitutės;1056158093;Taip;4;0;2;6
16918;Saulutė;Bitutės;8512137633;Taip;16;0;0;16
16919;Saulutė;Bitutės;4123500930;Ne;0;0;7;7
16920;Saulutė;Bitutės;1745754752;Taip;0;0;1;1
16921;Saulutė;Bitutės;9497439410;Taip;0;16;0;16
16922;Saulutė;Bitutės;8405262902;Taip;10;0;0;10
16923;Saulutė;Bitutės;4363210987;Taip;8;0;2;10
16924;Saulutė;Bitutės;6842585310;Taip;13;0;2;15
16925;Saulutė;Bitutės;2601822200;Taip;0;0;2;2
16926;Saulutė;Bitutės;4211866191;Taip;3;0;0;3
16927;Saulutė;Bitutės;8371366346;Taip;12;0;0;12
16928;Saulutė;Bitutės;7139492238;Taip;0;0;5;5
16929;Saulutė;Bitutės;1323161584;Taip;2;4;0;6
16930;Saulutė;Bitutės;5165268747;Taip;8;0;1;9
16931;Saulutė;Bitutės;3244850673;Taip;9;4;0;13
16932;Saulutė;Pelėdžiukai;3445723020;Ne;0;2;0;2
16933;Saulutė;Pelėdžiukai;1534183935;Taip;0;5;0;5
16934;Saulutė;Pelėdžiukai;27386434894;Taip;0;1;0;1
16935;Saulutė;Pelėdžiukai;65492344097;Taip;0;8;0;8
16936;Saulutė;Pelėdžiukai;1935503629;Taip;0;1;1;2
16937;Saulutė;Pelėdžiukai;77923802656;Taip;6;4;1;11
16938;Saulutė;Pelėdžiukai;79919438191;Taip;0;2;3;5
16939;Saulutė;Pelėdžiukai;31705050946;Taip;2;5;3;10
16940;Saulutė;Pelėdžiukai;45306237230;Taip;17;4;0;21
16941;Saulutė;Pelėdžiukai;14195215027;Taip;7;5;1;13
16942;Saulutė;Pelėdžiukai;50944263059;Taip;0;5;4;9
16943;Saulutė;Pelėdžiukai;1510434265;Taip;0;1;0;1
16944;Saulutė;Pelėdžiukai;5574049005;Taip;0;5;1;6
16945;Saulutė;Pelėdžiukai;4312318284;Taip;13;4;0;17
16946;Saulutė;Pelėdžiukai;27752316336;Taip;0;3;0;3
16947;Saulutė;Pelėdžiukai;77170708225;Taip;0;5;0;5
16948;Saulutė;Pelėdžiukai;5745065672;Taip;0;4;0;4
16949;Saulutė;Pelėdžiukai;9612975694;Taip;0;4;5;9
16950;Saulutė;Pelėdžiukai;4287223197;Taip;0;4;0;4
16951;Saulutė;Pelėdžiukai;5511093996;Taip;4;5;2;11
16952;Saulutė;Zylutės;1277263391;Taip;11;5;0;16
16953;Saulutė;Zylutės;46280382280;Ne;0;5;3;8
16954;Saulutė;Zylutės;75405796772;Taip;0;5;0;5
16955;Saulutė;Zylutės;35570367633;Taip;0;5;0;5
16956;Saulutė;Zylutės;1786491396;Taip;8;5;0;13
16957;Saulutė;Zylutės;10893091651;Taip;0;1;3;4
16958;Saulutė;Zylutės;85182498024;Taip;0;6;0;6
16959;Saulutė;Zylutės;16622528829;Taip;13;4;0;17
16960;Saulutė;Zylutės;1911318708;Taip;7;0;2;9
16961;Saulutė;Zylutės;9565528566;Taip;0;14;0;14
16962;Saulutė;Zylutės;1332002470;Taip;5;9;2;16
16963;Saulutė;Zylutės;9081236999;Ne;7;4;0;11
16964;Saulutė;Zylutės;67332285574;Taip;8;0;2;10
16965;Saulutė;Zylutės;1513449225;Taip;0;5;8;13
16966;Saulutė;Zylutės;28772515317;Ne;9;4;0;13
16967;Saulutė;Zylutės;7564649742;Taip;17;4;0;21
16968;Saulutė;Zylutės;97145959022;Taip;12;4;0;16
16969;Saulutė;Zylutės;8372468555;Taip;8;5;1;14
16970;Saulutė;Zylutės;5928628498;Taip;6;0;7;13
16971;Saulutė;Zylutės;8040751073;Taip;0;12;6;18
16972;Saulutė;Zylutės;2074473832;Taip;6;0;0;6
16973;Saulutė;"1 klasė";3183309722;Ne;3;5;0;8
16974;Saulutė;"1 klasė";1475031090;Taip;17;5;0;22
16975;Saulutė;"1 klasė";3246485288;Taip;13;5;0;18
16976;Saulutė;"1 klasė";78967475616;Ne;6;5;0;11
16977;Saulutė;"1 klasė";3450668814;Taip;10;5;0;15
16978;Saulutė;"1 klasė";57283533169;Taip;0;5;0;5
16979;Saulutė;"1 klasė";21703177024;Taip;0;5;0;5
16980;Saulutė;"1 klasė";13147367113;Taip;6;5;0;11
16981;Saulutė;"1 klasė";6557918941;Taip;1;5;0;6
16982;Saulutė;"1 klasė";1005459768;Taip;5;5;0;10
16983;Saulutė;"1 klasė";1804521229;Taip;1;5;0;6
16984;Saulutė;"1 klasė";44452051978;Ne;4;5;0;9
16985;Saulutė;"1 klasė";89710141573;Taip;0;5;0;5
16986;Saulutė;"1 klasė";25124975646;Taip;1;5;0;6
16987;Saulutė;"1 klasė";8168961080;Ne;0;5;0;5
16988;Saulutė;"1 klasė";76744652185;Taip;1;5;0;6
16989;Saulutė;"1 klasė";97296161595;Taip;1;5;0;6
16990;Saulutė;"1 klasė";87409240076;Taip;1;5;0;6
16991;Saulutė;"1 klasė";1205642335;Taip;7;5;0;12
16992;Saulutė;"1 klasė";36414547943;Taip;1;5;0;6
16993;Saulutė;"1 klasė";1337654926;Taip;6;5;0;11
16994;Saulutė;"1 klasė";54950572289;Taip;5;5;0;10
16995;Saulutė;"1 klasė";1644704074;Taip;0;5;0;5
16996;Saulutė;"1 klasė";2426509692;Ne;11;5;0;16
16997;Saulutė;"1 klasė";96497471950;Taip;10;5;0;15
16998;Saulutė;"1 klasė";76108591835;Taip;1;5;0;6
16999;Saulutė;"1 klasė";5741276602;Taip;0;5;0;5
17000;Saulutė;"1 klasė";99841176399;Taip;3;5;0;8
17001;Saulutė;"1 klasė";2216383015;Taip;4;5;0;9
17002;Saulutė;"1 klasė";3156830821;Taip;2;5;0;7
17003;Saulutė;"2 klasė";58163470119;Taip;3;5;0;8
17004;Saulutė;"2 klasė";5822529731;Taip;6;5;0;11
17005;Saulutė;"2 klasė";67739063665;Taip;4;5;0;9
17006;Saulutė;"2 klasė";13916981850;Taip;3;5;0;8
17007;Saulutė;"2 klasė";1418237274;Taip;17;5;0;22
17008;Saulutė;"2 klasė";39606108938;Ne;1;5;0;6
17009;Saulutė;"2 klasė";81191097069;Taip;2;5;0;7
17010;Saulutė;"2 klasė";92198716772;Taip;4;5;0;9
17011;Saulutė;"2 klasė";16523279366;Taip;0;5;0;5
17012;Saulutė;"2 klasė";2095347468;Taip;0;5;0;5
17013;Saulutė;"2 klasė";37839378248;Taip;0;5;0;5
17014;Saulutė;"2 klasė";5997216605;Taip;17;5;0;22
17015;Saulutė;"2 klasė";8308288099;Ne;1;5;0;6
17016;Saulutė;"2 klasė";30863736694;Taip;1;5;0;6
17017;Saulutė;"2 klasė";18122758338;Taip;5;5;0;10
17018;Saulutė;"2 klasė";12964000357;Taip;3;5;0;8
17019;Saulutė;"2 klasė";54726632101;Taip;11;5;0;16
17020;Saulutė;"2 klasė";25720655179;Ne;0;5;0;5
17021;Saulutė;"2 klasė";6469772450;Taip;17;5;0;22
17022;Saulutė;"2 klasė";4302511346;Ne;17;5;0;22
17023;Saulutė;"2 klasė";8632066475;Ne;17;5;0;22
17024;Saulutė;"2 klasė";45877127245;Taip;1;5;0;6
17025;Saulutė;"2 klasė";82106514982;Taip;5;5;0;10
17026;Saulutė;"2 klasė";61113930769;Taip;6;5;0;11
17027;Saulutė;"2 klasė";8962761979;Taip;17;5;0;22
17028;Saulutė;"2 klasė";7785909571;Ne;2;5;0;7
17029;Saulutė;"2 klasė";90078805222;Taip;10;5;0;15
17030;Saulutė;"2 klasė";50110262859;Ne;2;5;0;7
17031;Saulutė;"2 klasė";42204884890;Ne;6;5;0;11
17032;Saulutė;"3 klasė";8531372660;Taip;0;5;0;5
17033;Saulutė;"3 klasė";3614749034;Taip;10;5;0;15
17034;Saulutė;"3 klasė";1153099638;Taip;0;5;0;5
17035;Saulutė;"3 klasė";5786453424;Taip;3;5;0;8
17036;Saulutė;"3 klasė";4342595483;Taip;8;5;0;13
17037;Saulutė;"3 klasė";1081812391;Taip;8;5;0;13
17038;Saulutė;"3 klasė";1436690766;Taip;2;5;0;7
17039;Saulutė;"3 klasė";4252242862;Taip;6;5;0;11
17040;Saulutė;"3 klasė";2517511237;Taip;1;5;0;6
17041;Saulutė;"3 klasė";8953313952;Ne;2;5;0;7
17042;Saulutė;"3 klasė";2957436888;Taip;2;5;0;7
17043;Saulutė;"3 klasė";7696948081;Taip;7;5;0;12
17044;Saulutė;"3 klasė";8192525690;Taip;0;5;0;5
17045;Saulutė;"3 klasė";3937034221;Ne;2;5;0;7
17046;Saulutė;"3 klasė";1312993030;Taip;11;5;0;16
17047;Saulutė;"3 klasė";3450860412;Ne;4;5;0;9
17048;Saulutė;"3 klasė";7543978588;Taip;9;5;0;14
17049;Saulutė;"3 klasė";6924270821;Ne;6;5;0;11
17050;Saulutė;"3 klasė";1701868565;Taip;1;5;0;6
17051;Saulutė;"3 klasė";3755300838;Taip;6;5;0;11
17052;Saulutė;"3 klasė";1117229507;Taip;9;5;0;14
17053;Saulutė;"3 klasė";6025668467;Ne;3;5;0;8
17054;Saulutė;"4 klasė";9113434597;Ne;0;5;0;5
17055;Saulutė;"4 klasė";9833653313;Ne;0;5;0;5
17056;Saulutė;"4 klasė";1659579883;Ne;5;5;0;10
17057;Saulutė;"4 klasė";39035147720;Taip;1;5;0;6
17058;Saulutė;"4 klasė";39035147720;Taip;1;5;0;6
17059;Saulutė;"4 klasė";9155511473;Ne;10;5;0;15
17060;Saulutė;"4 klasė";6957680310;Ne;10;5;0;15
17061;Saulutė;"4 klasė";7700196440;Ne;5;5;0;10
17062;Saulutė;"4 klasė";8601544457;Taip;5;5;0;10
17063;Saulutė;"4 klasė";8506064421;Ne;1;5;0;6
17064;Saulutė;"4 klasė";3302267009;Ne;4;5;0;9
17065;Saulutė;"4 klasė";7343265118;Ne;17;5;0;22
17066;Saulutė;"4 klasė";5193599921;Ne;0;5;0;5
17067;Saulutė;"4 klasė";2638495931;Ne;17;5;0;22
17068;Saulutė;"4 klasė";4189732482;Ne;17;5;0;22
17069;Saulutė;"4 klasė";2374587130;Ne;1;5;0;6
17070;Saulutė;"4 klasė";6797161399;Ne;2;5;0;7
17071;Saulutė;"4 klasė";6128992723;Ne;2;5;0;7
17072;Saulutė;"4 klasė";9621988308;Ne;17;5;0;22
17073;Saulutė;"4 klasė";1787634725;Ne;0;5;0;5
17074;Saulutė;"4 klasė";1604607524;Ne;17;5;0;22
17075;Saulutė;"4 klasė";9885756874;Ne;8;5;0;13
17076;Saulutė;"4 klasė";3495588866;Taip;4;5;0;9
17077;Saulutė;"4 klasė";5232445259;Ne;0;5;0;5
17078;Svaja;"1 B klasė";6905550313;Taip;0;8;0;8
17079;Svaja;"1 B klasė";1367687415;Taip;0;15;0;15
17080;Svaja;"1 B klasė";1847775266;Taip;0;5;0;5
17081;Svaja;"1 B klasė";44418402260;Taip;0;4;0;4
17082;Svaja;"1 B klasė";54328462992;Taip;0;4;0;4
17083;Svaja;"1 B klasė";92044111261;Ne;0;5;0;5
17084;Svaja;"1 B klasė";6020060540;Taip;0;8;0;8
17085;Svaja;"1 B klasė";71708072632;Taip;0;6;0;6
17086;Svaja;"1 B klasė";56506642672;Taip;0;7;0;7
17087;Svaja;"1 B klasė";34141773112;Ne;0;4;0;4
17088;Svaja;"1 B klasė";4416877973;Taip;0;5;0;5
17089;Svaja;"1 B klasė";73391331150;Ne;0;4;0;4
17090;Svaja;"1 B klasė";70507326327;Taip;0;7;0;7
17091;Svaja;"1 B klasė";1470843400;Taip;0;4;0;4
17092;Svaja;"1 B klasė";8011137572;Taip;0;7;0;7
17093;Svaja;"1 B klasė";70506691027;Taip;0;4;0;4
17094;Svaja;"1 B klasė";62971657427;Ne;0;4;0;4
17095;Svaja;"1 B klasė";17947580061;Taip;0;5;0;5
17096;Svaja;"1 B klasė";50649509868;Taip;0;7;0;7
17097;Svaja;"1 B klasė";80772711351;Taip;0;5;0;5
17098;Svaja;"1 B klasė";11937575740;Taip;0;6;0;6
17099;Svaja;"1 B klasė";3526873547;Ne;0;4;0;4
17100;Svaja;"1 B klasė";6969692916;Taip;0;10;0;10
17101;Svaja;"1 A klasė";3474439050;Ne;0;9;0;9
17102;Svaja;"1 A klasė";8828911320;Ne;0;4;0;4
17103;Svaja;"1 A klasė";75104768118;Taip;0;6;0;6
17104;Svaja;"1 A klasė";18238622848;Taip;0;6;0;6
17105;Svaja;"1 A klasė";4617061890;Taip;0;4;0;4
17106;Svaja;"1 A klasė";3604946305;Taip;0;10;0;10
17107;Svaja;"1 A klasė";1649920341;Taip;0;4;0;4
17108;Svaja;"1 A klasė";64487515384;Taip;0;8;0;8
17109;Svaja;"1 A klasė";63346231562;Taip;0;12;0;12
17110;Svaja;"1 A klasė";6057524892;Taip;0;5;0;5
17111;Svaja;"1 A klasė";1181877436;Taip;0;4;0;4
17112;Svaja;"1 A klasė";25578518444;Taip;0;5;0;5
17113;Svaja;"1 A klasė";7348182434;Taip;0;5;0;5
17114;Svaja;"1 A klasė";89695643588;Taip;0;6;0;6
17115;Svaja;"1 A klasė";15252353189;Taip;0;9;0;9
17116;Svaja;"1 A klasė";72752022712;Taip;0;11;0;11
17117;Svaja;"1 A klasė";36386223863;Taip;0;5;0;5
17118;Svaja;"1 A klasė";30754812113;Taip;0;6;0;6
17119;Svaja;"1 A klasė";75296600945;Ne;0;9;0;9
17120;Svaja;"1 A klasė";2321739150;Ne;0;4;0;4
17121;Svaja;"1 A klasė";1168637823;Taip;0;5;0;5
17122;Svaja;"1 A klasė";4906784415;Taip;0;10;0;10
17123;Svaja;"1 A klasė";6810463192;Taip;0;9;0;9
17124;Svaja;"1 C klasė";25934507261;Taip;0;4;0;4
17125;Svaja;"1 C klasė";89047123808;Taip;0;6;0;6
17126;Svaja;"1 C klasė";50510924690;Taip;0;4;0;4
17127;Svaja;"1 C klasė";41183537732;Taip;0;5;0;5
17128;Svaja;"1 C klasė";57216299421;Ne;0;21;0;21
17129;Svaja;"1 C klasė";1795682827;Taip;0;14;0;14
17130;Svaja;"1 C klasė";93651139102;Taip;0;6;0;6
17131;Svaja;"1 C klasė";54462393937;Taip;0;6;0;6
17132;Svaja;"1 C klasė";74904581010;Taip;0;6;0;6
17133;Svaja;"1 C klasė";2165716699;Taip;0;10;0;10
17134;Svaja;"1 C klasė";36001411632;Taip;0;4;0;4
17135;Svaja;"1 C klasė";94449039022;Taip;0;6;0;6
17136;Svaja;"1 C klasė";85150525696;Ne;0;4;0;4
17137;Svaja;"1 C klasė";1848422504;Taip;0;4;0;4
17138;Svaja;"1 C klasė";3743948734;Taip;0;4;0;4
17139;Svaja;"1 C klasė";70714898590;Taip;0;4;0;4
17140;Svaja;"1 C klasė";54852358913;Taip;0;5;0;5
17141;Svaja;"1 C klasė";57253216255;Taip;0;4;0;4
17142;Svaja;"1 C klasė";34995551069;Taip;0;4;0;4
17143;Svaja;"1 C klasė";1742951527;Taip;0;4;0;4
17144;Svaja;"1 C klasė";91855230473;Taip;0;10;0;10
17145;Svaja;"1 C klasė";1855559693;Taip;0;13;0;13
17146;Svaja;"1 C klasė";31216445971;Ne;0;6;0;6
17147;Svaja;"1 C klasė";20342193231;Taip;0;4;0;4
17148;Svaja;"1 C klasė";91088224294;Taip;0;21;0;21
17149;Svaja;"2 A klasė";8876971658;Taip;0;21;0;21
17150;Svaja;"2 A klasė";96680395594;Taip;0;5;0;5
17151;Svaja;"2 A klasė";31604152893;Ne;0;4;0;4
17152;Svaja;"2 A klasė";70513111186;Ne;0;4;0;4
17153;Svaja;"2 A klasė";72655912805;Taip;0;4;0;4
17154;Svaja;"2 A klasė";20363553383;Taip;0;5;0;5
17155;Svaja;"2 A klasė";69928474471;Taip;0;4;0;4
17156;Svaja;"2 A klasė";49184638535;Taip;0;21;0;21
17157;Svaja;"2 A klasė";58497063533;Taip;0;8;0;8
17158;Svaja;"2 A klasė";89075087937;Taip;0;21;0;21
17159;Svaja;"2 A klasė";99157757025;Ne;0;5;0;5
17160;Svaja;"2 A klasė";16955510836;Taip;0;8;0;8
17161;Svaja;"2 A klasė";24812635291;Taip;0;5;0;5
17162;Svaja;"2 A klasė";21534170175;Taip;0;7;0;7
17163;Svaja;"2 A klasė";28311552445;Taip;0;5;0;5
17164;Svaja;"2 A klasė";38781141060;Taip;0;13;0;13
17165;Svaja;"2 A klasė";88447528808;Taip;0;4;0;4
17166;Svaja;"2 A klasė";66507774550;Taip;0;4;0;4
17167;Svaja;"2 A klasė";48859926231;Taip;0;4;0;4
17168;Svaja;"2 A klasė";76101749947;Taip;0;21;0;21
17169;Svaja;"2 A klasė";3775578708;Ne;0;6;0;6
17170;Svaja;"2 B klasė";61996055386;Taip;0;5;0;5
17171;Svaja;"2 B klasė";57983452414;Taip;0;21;0;21
17172;Svaja;"2 B klasė";30200636424;Ne;0;8;0;8
17173;Svaja;"2 B klasė";8802243719;Taip;0;10;0;10
17174;Svaja;"2 B klasė";7747921362;Ne;0;7;0;7
17175;Svaja;"2 B klasė";38464012322;Taip;0;5;0;5
17176;Svaja;"2 B klasė";5712106350;Taip;0;5;0;5
17177;Svaja;"2 B klasė";9401605132;Taip;0;21;0;21
17178;Svaja;"2 B klasė";27313057222;Taip;0;21;0;21
17179;Svaja;"2 B klasė";68894832324;Taip;0;11;0;11
17180;Svaja;"2 B klasė";29972474690;Taip;0;4;0;4
17181;Svaja;"2 B klasė";47441661801;Ne;0;8;0;8
17182;Svaja;"2 B klasė";62579722313;Taip;0;11;0;11
17183;Svaja;"2 B klasė";21035820496;Ne;0;4;0;4
17184;Svaja;"2 B klasė";71840791098;Taip;0;4;0;4
17185;Svaja;"2 B klasė";59707838958;Taip;0;5;0;5
17186;Svaja;"2 B klasė";71086654007;Taip;0;5;0;5
17187;Svaja;"2 B klasė";15871540340;Taip;0;8;0;8
17188;Svaja;"2 B klasė";97651620085;Taip;0;21;0;21
17189;Svaja;"2 B klasė";77796846388;Taip;0;4;0;4
17190;Svaja;"3 A klasė";6331528628;Taip;0;6;0;6
17191;Svaja;"3 A klasė";3545160978;Taip;0;12;0;12
17192;Svaja;"3 A klasė";3812365439;Taip;0;7;0;7
17193;Svaja;"3 A klasė";4732976577;Taip;0;8;0;8
17194;Svaja;"3 A klasė";4819506647;Taip;0;12;0;12
17195;Svaja;"3 A klasė";7374204735;Taip;0;6;0;6
17196;Svaja;"3 A klasė";4147975771;Taip;0;4;0;4
17197;Svaja;"3 A klasė";5355661673;Taip;0;15;0;15
17198;Svaja;"3 A klasė";8907191675;Taip;0;10;0;10
17199;Svaja;"3 A klasė";6301200166;Ne;0;7;0;7
17200;Svaja;"3 A klasė";7406969545;Ne;0;11;0;11
17201;Svaja;"3 A klasė";6182584108;Taip;0;14;0;14
17202;Svaja;"3 A klasė";6561055995;Taip;0;5;0;5
17203;Svaja;"3 A klasė";7745440861;Taip;0;11;0;11
17204;Svaja;"3 A klasė";3100769948;Ne;0;10;0;10
17205;Svaja;"3 A klasė";1932041952;Taip;0;4;0;4
17206;Svaja;"3 A klasė";2963665708;Taip;0;9;0;9
17207;Svaja;"3 A klasė";6166818062;Taip;0;7;0;7
17208;Svaja;"3 A klasė";4677183471;Taip;0;4;0;4
17209;Svaja;"3 A klasė";3876795349;Taip;0;11;0;11
17210;Svaja;"3 A klasė";4570702330;Taip;0;13;0;13
17211;Svaja;"3 A klasė";4559408388;Taip;0;13;0;13
17212;Svaja;"3 A klasė";1851430613;Taip;0;15;0;15
17213;Svaja;"3 B klasė";6685023540;Ne;0;9;0;9
17214;Svaja;"3 B klasė";3917545035;Taip;0;21;0;21
17215;Svaja;"3 B klasė";3154268090;Ne;0;6;0;6
17216;Svaja;"3 B klasė";7137011094;Taip;0;18;0;18
17217;Svaja;"3 B klasė";8497722175;Taip;0;5;0;5
17218;Svaja;"3 B klasė";1949789571;Taip;0;5;0;5
17219;Svaja;"3 B klasė";986820082;Taip;0;5;0;5
17220;Svaja;"3 B klasė";5316972581;Taip;0;21;0;21
17221;Svaja;"3 B klasė";5304302886;Taip;0;8;0;8
17222;Svaja;"3 B klasė";9390649669;Ne;0;21;0;21
17223;Svaja;"3 B klasė";2543801351;Taip;0;5;0;5
17224;Svaja;"3 B klasė";2768998567;Taip;0;5;0;5
17225;Svaja;"3 B klasė";5417233257;Taip;0;10;0;10
17226;Svaja;"3 B klasė";8934053695;Ne;0;21;0;21
17227;Svaja;"3 B klasė";6888324693;Ne;0;5;0;5
17228;Svaja;"3 B klasė";9741563523;Taip;0;21;0;21
17229;Svaja;"3 B klasė";9474581791;Taip;0;5;0;5
17230;Svaja;"3 B klasė";7185891478;Ne;0;21;0;21
17231;Svaja;"3 B klasė";6949932613;Taip;0;5;0;5
17232;Svaja;"3 B klasė";9227257148;Taip;0;5;0;5
17233;Svaja;"3 B klasė";7403841330;Taip;0;14;0;14
17234;Svaja;"3 B klasė";6387070757;Taip;0;21;0;21
17235;Svaja;"3 B klasė";4859522896;Taip;0;5;0;5
17236;Svaja;"3 B klasė";7165840275;Taip;0;10;0;10
17237;Svaja;"3 B klasė";4858401763;Taip;0;5;0;5
17238;Svaja;"4 A klasė";6890796785;Taip;0;4;0;4
17239;Svaja;"4 A klasė";3060720122;Taip;0;9;0;9
17240;Svaja;"4 A klasė";4191652201;Taip;0;21;0;21
17241;Svaja;"4 A klasė";2408787820;Ne;0;9;0;9
17242;Svaja;"4 A klasė";2143707618;Taip;0;4;0;4
17243;Svaja;"4 A klasė";9922327181;Taip;0;4;0;4
17244;Svaja;"4 A klasė";7360643147;Taip;0;4;0;4
17245;Svaja;"4 A klasė";9431617139;Taip;0;21;0;21
17246;Svaja;"4 A klasė";5072924063;Taip;0;7;0;7
17247;Svaja;"4 A klasė";1224863574;Ne;0;4;0;4
17248;Svaja;"4 A klasė";5866029763;Ne;0;21;0;21
17249;Svaja;"4 A klasė";5224191012;Taip;0;10;0;10
17250;Svaja;"4 A klasė";2396489897;Taip;0;7;0;7
17251;Svaja;"4 A klasė";3362976996;Taip;0;4;0;4
17252;Svaja;"4 A klasė";6924433006;Taip;0;8;0;8
17253;Svaja;"4 A klasė";6379522088;Taip;0;9;0;9
17254;Svaja;"4 A klasė";6859893256;Taip;0;21;0;21
17255;Svaja;"4 A klasė";7222472406;Taip;0;12;0;12
17256;Svaja;"4 A klasė";8566329547;Ne;0;21;0;21
17257;Svaja;"4 A klasė";8014577929;Taip;0;7;0;7
17258;Svaja;"4 A klasė";5916292577;Taip;0;21;0;21
17259;Svaja;"4 B klasė";5552969529;Taip;0;10;0;10
17260;Svaja;"4 B klasė";4730576902;Taip;0;11;0;11
17261;Svaja;"4 B klasė";1717017574;Taip;0;21;0;21
17262;Svaja;"4 B klasė";6738703814;Taip;0;6;0;6
17263;Svaja;"4 B klasė";9134285226;Taip;0;5;0;5
17264;Svaja;"4 B klasė";5936330139;Taip;0;8;0;8
17265;Svaja;"4 B klasė";2601042375;Taip;0;6;0;6
17266;Svaja;"4 B klasė";5872552939;Taip;0;21;0;21
17267;Svaja;"4 B klasė";9268837216;Taip;0;21;0;21
17268;Svaja;"4 B klasė";3914701993;Taip;0;5;0;5
17269;Svaja;"4 B klasė";6125002433;Taip;0;21;0;21
17270;Svaja;"4 B klasė";7318107259;Taip;0;21;0;21
17271;Svaja;"4 B klasė";3710090923;Taip;0;9;0;9
17272;Svaja;"4 B klasė";4798681160;Taip;0;21;0;21
17273;Svaja;"4 B klasė";8694436642;Taip;0;7;0;7
17274;Svaja;"4 B klasė";9634453365;Taip;0;21;0;21
17275;Svaja;"4 B klasė";5247586745;Taip;0;21;0;21
17276;Svaja;"4 B klasė";3794316760;Taip;0;4;0;4
17277;Svaja;"4 B klasė";2827984254;Taip;0;7;0;7
17278;Svaja;"4 B klasė";2414969796;Taip;0;6;0;6
17279;Svaja;"4 B klasė";6780795284;Taip;0;5;0;5
17280;Svaja;"4 B klasė";7211076381;Taip;0;8;0;8
17281;Svaja;"4 B klasė";7731424463;Taip;0;21;0;21
17282;Svaja;"4 B klasė";6933648513;Taip;0;7;0;7
17283;Svaja;"2 C klasė";77712240909;Taip;0;4;0;4
17284;Svaja;"2 C klasė";79260508923;Taip;0;5;0;5
17285;Svaja;"2 C klasė";94437606762;Taip;0;21;0;21
17286;Svaja;"2 C klasė";73440582394;Taip;0;5;0;5
17287;Svaja;"2 C klasė";60982723867;Taip;0;21;0;21
17288;Svaja;"2 C klasė";70157518595;Taip;0;5;0;5
17289;Svaja;"2 C klasė";50116820543;Taip;0;4;0;4
17290;Svaja;"2 C klasė";5975083034;Ne;0;21;0;21
17291;Svaja;"2 C klasė";5288858941;Ne;0;7;0;7
17292;Svaja;"2 C klasė";76871144487;Taip;0;21;0;21
17293;Svaja;"2 C klasė";6613028133;Taip;0;7;0;7
17294;Svaja;"2 C klasė";48888360976;Taip;0;4;0;4
17295;Svaja;"2 C klasė";12226488343;Taip;0;6;0;6
17296;Svaja;"2 C klasė";3909240894;Ne;0;4;0;4
17297;Svaja;"2 C klasė";53352329988;Taip;0;8;0;8
17298;Svaja;"2 C klasė";59917024948;Taip;0;6;0;6
17299;Svaja;"2 C klasė";73691352138;Taip;0;4;0;4
17300;Svaja;"2 C klasė";66967032561;Taip;0;17;0;17
17301;Svaja;"2 C klasė";82358174131;Taip;0;6;0;6
17302;Svaja;"2 C klasė";2018073862;Taip;0;7;0;7
17303;Svaja;"2 C klasė";25585032766;Taip;0;21;0;21
17304;Svaja;"2 C klasė";79572045341;Ne;0;21;0;21
17305;Svaja;"3 C klasė";4022762780;Taip;0;21;0;21
17306;Svaja;"3 C klasė";4196053724;Taip;0;5;0;5
17307;Svaja;"3 C klasė";6750156163;Taip;0;6;0;6
17308;Svaja;"3 C klasė";5749575112;Taip;0;21;0;21
17309;Svaja;"3 C klasė";8150945946;Taip;0;21;0;21
17310;Svaja;"3 C klasė";1915009909;Taip;0;5;0;5
17311;Svaja;"3 C klasė";4310597965;Taip;0;17;0;17
17312;Svaja;"3 C klasė";8274918664;Taip;0;7;0;7
17313;Svaja;"3 C klasė";4333896021;Taip;0;5;0;5
17314;Svaja;"3 C klasė";5467666579;Taip;0;5;0;5
17315;Svaja;"3 C klasė";5453168902;Ne;0;8;0;8
17316;Svaja;"3 C klasė";1750972673;Taip;0;5;0;5
17317;Svaja;"3 C klasė";5633989310;Taip;0;5;0;5
17318;Svaja;"3 C klasė";4807854408;Taip;0;21;0;21
17319;Svaja;"3 C klasė";9653780566;Taip;0;8;0;8
17320;Svaja;"3 C klasė";8556383911;Ne;0;6;0;6
17321;Svaja;"3 C klasė";5736016717;Taip;0;21;0;21
17322;Svaja;"3 C klasė";6956015602;Ne;0;21;0;21
17323;Svaja;"3 C klasė";6155277279;Ne;0;21;0;21
17324;Svaja;"3 C klasė";3466700144;Ne;0;5;0;5
17325;Svaja;"3 C klasė";9961965117;Taip;0;21;0;21
17326;Svaja;"3 C klasė";4809644609;Taip;0;5;0;5
17327;Svaja;"3 C klasė";1910435736;Taip;0;6;0;6
17328;Svaja;"3 C klasė";5205253544;Taip;0;8;0;8
17329;Svaja;"3 C klasė";6958729265;Ne;0;6;0;6
17330;Vaduvos;PAGRANDUKAI;1048630061;Taip;9;4;0;13
17331;Vaduvos;PAGRANDUKAI;1431863758;Taip;0;8;0;8
17332;Vaduvos;PAGRANDUKAI;8408017356;Taip;0;10;0;10
17333;Vaduvos;PAGRANDUKAI;72724196791;Taip;21;0;0;21
17334;Vaduvos;PAGRANDUKAI;9371067563;Taip;0;10;0;10
17335;Vaduvos;PAGRANDUKAI;9987311980;Taip;0;10;6;16
17336;Vaduvos;PAGRANDUKAI;6425640531;Taip;16;0;0;16
17337;Vaduvos;PAGRANDUKAI;4029586203;Taip;0;2;0;2
17338;Vaduvos;PAGRANDUKAI;73800920781;Taip;11;0;2;13
17339;Vaduvos;PAGRANDUKAI;18035723255;Ne;16;0;0;16
17340;Vaduvos;PAGRANDUKAI;5954492368;Taip;9;0;0;9
17341;Vaduvos;PAGRANDUKAI;7397068779;Ne;0;11;0;11
17342;Vaduvos;PAGRANDUKAI;8875709110;Taip;0;9;0;9
17343;Vaduvos;PAGRANDUKAI;4789480822;Taip;21;0;0;21
17344;Vaduvos;PAGRANDUKAI;7305111076;Taip;16;0;0;16
17345;Vaduvos;PAGRANDUKAI;2897226343;Taip;0;1;0;1
17346;Vaduvos;PAGRANDUKAI;68848152670;Taip;9;6;0;15
17347;Vaduvos;PAGRANDUKAI;4105978403;Taip;0;7;0;7
17348;Vaduvos;PAGRANDUKAI;5428067167;Taip;0;5;0;5
17349;Vaduvos;PAGRANDUKAI;3699578284;Taip;13;0;2;15
17350;Vaduvos;KODĖLČIUKAI;9429028460;Taip;7;5;0;12
17351;Vaduvos;KODĖLČIUKAI;6210729584;Taip;16;0;4;20
17352;Vaduvos;KODĖLČIUKAI;9606193112;Taip;10;0;1;11
17353;Vaduvos;KODĖLČIUKAI;9540008495;Taip;5;0;1;6
17354;Vaduvos;KODĖLČIUKAI;4177935331;Taip;7;6;0;13
17355;Vaduvos;KODĖLČIUKAI;9983148737;Taip;3;0;1;4
17356;Vaduvos;KODĖLČIUKAI;9072097216;Ne;5;2;1;8
17357;Vaduvos;KODĖLČIUKAI;9062135043;Taip;0;4;0;4
17358;Vaduvos;KODĖLČIUKAI;6810198013;Taip;0;7;0;7
17359;Vaduvos;KODĖLČIUKAI;9178907705;Ne;14;6;0;20
17360;Vaduvos;KODĖLČIUKAI;3641822841;Taip;16;1;0;17
17361;Vaduvos;KODĖLČIUKAI;4270137614;Taip;15;0;1;16
17362;Vaduvos;KODĖLČIUKAI;3682708061;Taip;5;0;0;5
17363;Vaduvos;KODĖLČIUKAI;7181151562;Taip;9;0;0;9
17364;Vaduvos;KODĖLČIUKAI;5262165284;Taip;7;0;3;10
17365;Vaduvos;KODĖLČIUKAI;8603418399;Taip;10;0;0;10
17366;Vaduvos;KODĖLČIUKAI;3096104197;Taip;21;0;0;21
17367;Vaduvos;KODĖLČIUKAI;5761137540;Ne;7;9;0;16
17368;Vaduvos;KODĖLČIUKAI;9597857664;Taip;19;0;0;19
17369;Vaduvos;KODĖLČIUKAI;1054097622;Taip;0;9;0;9
17370;Vaduvos;SMALSUČIAI;5307128703;Taip;2;6;0;8
17371;Vaduvos;SMALSUČIAI;6121365922;Taip;11;4;0;15
17372;Vaduvos;SMALSUČIAI;62183976729;Taip;0;4;3;7
17373;Vaduvos;SMALSUČIAI;1825188497;Taip;14;0;0;14
17374;Vaduvos;SMALSUČIAI;1622695085;Taip;9;0;3;12
17375;Vaduvos;SMALSUČIAI;3555513755;Taip;5;0;0;5
17376;Vaduvos;SMALSUČIAI;2184711783;Taip;3;0;0;3
17377;Vaduvos;SMALSUČIAI;3010510262;Taip;3;9;0;12
17378;Vaduvos;SMALSUČIAI;7537754249;Taip;0;4;2;6
17379;Vaduvos;SMALSUČIAI;4565556635;Taip;11;0;1;12
17380;Vaduvos;SMALSUČIAI;5573145836;Taip;5;4;2;11
17381;Vaduvos;SMALSUČIAI;4615315809;Taip;0;0;8;8
17382;Vaduvos;SMALSUČIAI;7337663549;Taip;0;0;6;6
17383;Vaduvos;SMALSUČIAI;5055972872;Taip;3;7;0;10
17384;Vaduvos;SMALSUČIAI;1423148023;Taip;0;5;0;5
17385;Vaduvos;SMALSUČIAI;6192828320;Taip;0;13;0;13
17386;Vaduvos;SMALSUČIAI;13888236429;Taip;17;0;0;17
17387;Vaduvos;SMALSUČIAI;3722349868;Taip;0;9;0;9
17388;Vaduvos;SMALSUČIAI;3174998523;Ne;0;0;7;7
17389;Vaduvos;SMALSUČIAI;3091707832;Taip;9;0;0;9
17390;Vaduvos;SMALSUČIAI;13178417729;Taip;9;0;0;9
17391;Vaduvos;GILIUKAI;11202010413;Taip;0;8;0;8
17392;Vaduvos;GILIUKAI;1046867513;Ne;10;0;0;10
17393;Vaduvos;GILIUKAI;4342471835;Taip;3;0;0;3
17394;Vaduvos;GILIUKAI;15757662594;Taip;8;1;0;9
17395;Vaduvos;GILIUKAI;41870343319;Taip;0;4;0;4
17396;Vaduvos;GILIUKAI;97007740148;Taip;10;0;1;11
17397;Vaduvos;GILIUKAI;1464016847;Taip;11;0;2;13
17398;Vaduvos;GILIUKAI;2006018986;Taip;0;12;0;12
17399;Vaduvos;GILIUKAI;46608435244;Taip;11;0;1;12
17400;Vaduvos;GILIUKAI;86095539298;Taip;5;0;3;8
17401;Vaduvos;GILIUKAI;21499108813;Taip;7;4;0;11
17402;Vaduvos;GILIUKAI;59616893535;Taip;9;0;0;9
17403;Vaduvos;GILIUKAI;22641388717;Taip;0;1;0;1
17404;Vaduvos;GILIUKAI;61046090149;Taip;5;4;0;9
17405;Vaduvos;GILIUKAI;87008942241;Taip;5;0;2;7
17406;Vaduvos;GILIUKAI;56280470781;Taip;9;0;0;9
17407;Vaduvos;GILIUKAI;79437154441;Taip;0;0;1;1
17408;Vaduvos;GILIUKAI;68937983441;Taip;0;14;0;14
17409;Vaduvos;GILIUKAI;1703266825;Taip;9;0;0;9
17410;Vaduvos;GILIUKAI;65843855427;Taip;0;2;0;2
17411;Vaduvos;BORUŽĖLĖS;24887196729;Taip;0;10;0;10
17412;Vaduvos;BORUŽĖLĖS;16882774330;Taip;0;8;0;8
17413;Vaduvos;BORUŽĖLĖS;70693742936;Taip;11;0;0;11
17414;Vaduvos;BORUŽĖLĖS;4670249904;Taip;0;3;1;4
17415;Vaduvos;BORUŽĖLĖS;1385184350;Taip;0;5;4;9
17416;Vaduvos;BORUŽĖLĖS;65647119496;Taip;0;5;0;5
17417;Vaduvos;BORUŽĖLĖS;68420568339;Taip;1;1;0;2
17418;Vaduvos;BORUŽĖLĖS;96803174459;Taip;6;4;0;10
17419;Vaduvos;BORUŽĖLĖS;19390879176;Taip;12;0;1;13
17420;Vaduvos;BORUŽĖLĖS;47465933557;Taip;7;5;0;12
17421;Vaduvos;BORUŽĖLĖS;16006064074;Taip;7;3;0;10
17422;Vaduvos;BORUŽĖLĖS;55138588393;Taip;0;5;0;5
17423;Vaduvos;BORUŽĖLĖS;3172047211;Taip;5;2;0;7
17424;Vaduvos;BORUŽĖLĖS;62521006557;Taip;6;3;1;10
17425;Vaduvos;BORUŽĖLĖS;93924290247;Taip;0;4;4;8
17426;Vaduvos;BORUŽĖLĖS;61243200177;Taip;2;4;0;6
17427;Vaduvos;BORUŽĖLĖS;95104294893;Taip;15;3;2;20
17428;Vaduvos;BORUŽĖLĖS;6155494370;Ne;14;4;0;18
17429;Vaduvos;BORUŽĖLĖS;94906586734;Taip;0;2;1;3
17430;Vaduvos;BORUŽĖLĖS;7957072941;Taip;6;4;3;13
17431;Vaduvos;BORUŽĖLĖS;6386205227;Taip;0;4;9;13
17432;Vaduvos;DRUGELIAI;39687066893;Ne;0;4;0;4
17433;Vaduvos;DRUGELIAI;87671358423;Taip;9;0;0;9
17434;Vaduvos;DRUGELIAI;62703428759;Taip;0;2;0;2
17435;Vaduvos;DRUGELIAI;40872193458;Taip;9;0;1;10
17436;Vaduvos;DRUGELIAI;1241148402;Taip;4;1;0;5
17437;Vaduvos;DRUGELIAI;93406851755;Taip;13;1;0;14
17438;Vaduvos;DRUGELIAI;13203715320;Taip;7;4;1;12
17439;Vaduvos;DRUGELIAI;26736566969;Taip;3;0;2;5
17440;Vaduvos;DRUGELIAI;64074141491;Taip;0;4;2;6
17441;Vaduvos;DRUGELIAI;66359913774;Taip;0;8;0;8
17442;Vaduvos;DRUGELIAI;49738318631;Taip;7;6;0;13
17443;Vaduvos;DRUGELIAI;96892752634;Taip;0;4;1;5
17444;Vaduvos;DRUGELIAI;8802765960;Taip;0;4;1;5
17445;Vaduvos;DRUGELIAI;1107557891;Ne;11;3;0;14
17446;Vaduvos;DRUGELIAI;78931952732;Ne;0;9;0;9
17447;Vaduvos;DRUGELIAI;3632802933;Ne;5;4;2;11
17448;Vaduvos;DRUGELIAI;2605583220;Taip;14;0;0;14
17449;Vaduvos;DRUGELIAI;54193761898;Taip;0;1;0;1
17450;Vaduvos;DRUGELIAI;1010061503;Taip;8;4;4;16
17451;Vaduvos;DRUGELIAI;2348627375;Taip;11;1;1;13
17452;Vaduvos;DRUGELIAI;1139509471;Taip;7;4;5;16
17453;Vaduvos;RIEŠUTĖLIAI;1422507884;Taip;2;8;0;10
17454;Vaduvos;RIEŠUTĖLIAI;2417613291;Taip;4;0;5;9
17455;Vaduvos;RIEŠUTĖLIAI;6593754016;Taip;12;9;0;21
17456;Vaduvos;RIEŠUTĖLIAI;8324927031;Taip;13;1;0;14
17457;Vaduvos;RIEŠUTĖLIAI;5717064754;Ne;0;4;2;6
17458;Vaduvos;RIEŠUTĖLIAI;5634252033;Taip;5;0;2;7
17459;Vaduvos;RIEŠUTĖLIAI;9705185906;Taip;3;0;1;4
17460;Vaduvos;RIEŠUTĖLIAI;7904713344;Taip;0;4;0;4
17461;Vaduvos;RIEŠUTĖLIAI;2277525837;Taip;3;0;0;3
17462;Vaduvos;RIEŠUTĖLIAI;4465504676;Taip;3;7;0;10
17463;Vaduvos;RIEŠUTĖLIAI;6462126837;Taip;0;6;0;6
17464;Vaduvos;RIEŠUTĖLIAI;6991960029;Taip;10;1;0;11
17465;Vaduvos;RIEŠUTĖLIAI;7521846747;Ne;6;4;0;10
17466;Vaduvos;RIEŠUTĖLIAI;3461756429;Taip;0;4;3;7
17467;Vaduvos;"1 klasė";42498568346;Taip;0;7;0;7
17468;Vaduvos;"1 klasė";38504924027;Taip;0;5;0;5
17469;Vaduvos;"1 klasė";96148085691;Taip;0;8;0;8
17470;Vaduvos;"1 klasė";33277362439;Ne;0;7;0;7
17471;Vaduvos;"1 klasė";32138087379;Taip;0;7;0;7
17472;Vaduvos;"1 klasė";67324784528;Taip;0;6;0;6
17473;Vaduvos;"1 klasė";2181614424;Taip;0;7;0;7
17474;Vaduvos;"1 klasė";2019573643;Taip;0;5;0;5
17475;Vaduvos;"1 klasė";27419094487;Taip;0;5;0;5
17476;Vaduvos;"1 klasė";41272273463;Taip;0;5;0;5
17477;Vaduvos;"1 klasė";89793734700;Taip;0;5;0;5
17478;Vaduvos;"1 klasė";17473821556;Taip;0;9;0;9
17479;Vaduvos;"1 klasė";53866301875;Ne;0;6;0;6
17480;Vaduvos;"1 klasė";1532675814;Taip;0;5;0;5
17481;Vaduvos;"1 klasė";36931517006;Taip;0;5;0;5
17482;Vaduvos;"1 klasė";61243424057;Taip;0;9;0;9
17483;Vaduvos;"1 klasė";30979103892;Taip;0;5;0;5
17484;Vaduvos;"1 klasė";78245732319;Taip;0;5;0;5
17485;Vaduvos;"1 klasė";97878811046;Taip;0;5;0;5
17486;Vaduvos;"1 klasė";48433447683;Taip;0;5;0;5
17487;Vaduvos;"1 klasė";12330772986;Taip;0;5;0;5
17488;Vaduvos;"1 klasė";4807104855;Taip;0;7;0;7
17489;Vaduvos;"1 klasė";7786986697;Taip;0;6;0;6
17490;Vaduvos;"1 klasė";98259624669;Taip;0;5;0;5
17491;Vaduvos;"1 klasė";85090873161;Taip;0;6;0;6
17492;Vaduvos;"1 klasė";97423576166;Taip;0;5;0;5
17493;Vaduvos;"1 klasė";9147332638;Taip;0;8;0;8
17494;Vaduvos;"2 klasė";96473212525;Taip;0;4;0;4
17495;Vaduvos;"2 klasė";75428164558;Taip;0;4;0;4
17496;Vaduvos;"2 klasė";8188624118;Ne;0;21;0;21
17497;Vaduvos;"2 klasė";63286903462;Taip;0;4;0;4
17498;Vaduvos;"2 klasė";13721939854;Taip;0;5;0;5
17499;Vaduvos;"2 klasė";7172286009;Taip;0;8;0;8
17500;Vaduvos;"2 klasė";6049882391;Ne;0;6;0;6
17501;Vaduvos;"2 klasė";38013859931;Taip;0;4;0;4
17502;Vaduvos;"2 klasė";61830127618;Taip;0;4;0;4
17503;Vaduvos;"2 klasė";4591744662;Taip;0;4;0;4
17504;Vaduvos;"2 klasė";9149523910;Taip;0;4;0;4
17505;Vaduvos;"2 klasė";76662161382;Taip;0;5;0;5
17506;Vaduvos;"2 klasė";26934740147;Taip;0;21;0;21
17507;Vaduvos;"2 klasė";18300713872;Taip;0;21;0;21
17508;Vaduvos;"2 klasė";768455288;Ne;0;21;0;21
17509;Vaduvos;"2 klasė";1768173501;Taip;0;4;0;4
17510;Vaduvos;"2 klasė";60531886576;Ne;0;4;0;4
17511;Vaduvos;"2 klasė";2004208381;Ne;0;4;0;4
17512;Vaduvos;"2 klasė";38462664426;Ne;0;4;0;4
17513;Vaduvos;"2 klasė";1821644443;Ne;0;6;0;6
17514;Vaduvos;"2 klasė";1171210935;Ne;0;9;0;9
17515;Vaduvos;"3 klasė";8009941823;Taip;0;11;0;11
17516;Vaduvos;"3 klasė";2423925079;Ne;0;21;0;21
17517;Vaduvos;"3 klasė";7410760461;Taip;0;21;0;21
17518;Vaduvos;"3 klasė";6487033699;Taip;0;6;0;6
17519;Vaduvos;"3 klasė";1671409152;Taip;0;5;0;5
17520;Vaduvos;"3 klasė";5072769647;Taip;0;6;0;6
17521;Vaduvos;"3 klasė";4637670260;Taip;0;6;0;6
17522;Vaduvos;"3 klasė";7236550835;Taip;0;5;0;5
17523;Vaduvos;"3 klasė";9372936408;Taip;0;5;0;5
17524;Vaduvos;"3 klasė";7243175751;Taip;0;7;0;7
17525;Vaduvos;"3 klasė";2482212122;Taip;0;10;0;10
17526;Vaduvos;"3 klasė";1982860223;Taip;0;5;0;5
17527;Vaduvos;"3 klasė";4447152355;Taip;0;5;0;5
17528;Vaduvos;"3 klasė";3325229112;Taip;0;5;0;5
17529;Vaduvos;"3 klasė";5531150399;Taip;0;21;0;21
17530;Vaduvos;"3 klasė";6980440631;Taip;0;5;0;5
17531;Vaduvos;"3 klasė";1091221509;Ne;0;6;0;6
17532;Vaduvos;"3 klasė";7614692200;Taip;0;6;0;6
17533;Vaduvos;"3 klasė";8216757208;Taip;0;10;0;10
17534;Vaduvos;"3 klasė";5459268700;Ne;0;21;0;21
17535;Vaduvos;"3 klasė";5593756016;Taip;0;5;0;5
17536;Vaduvos;"3 klasė";1642242442;Taip;0;5;0;5
17537;Vaduvos;"3 klasė";8928517238;Taip;0;5;0;5
17538;Vaduvos;"3 klasė";5099560123;Taip;0;5;0;5
17539;Vaduvos;"3 klasė";7899239147;Taip;0;5;0;5
17540;Vaduvos;"4 klasė";6896561963;Taip;0;15;0;15
17541;Vaduvos;"4 klasė";2149582337;Taip;0;9;0;9
17542;Vaduvos;"4 klasė";2520421584;Ne;0;6;0;6
17543;Vaduvos;"4 klasė";8241399720;Taip;0;5;0;5
17544;Vaduvos;"4 klasė";7719637673;Taip;0;5;0;5
17545;Vaduvos;"4 klasė";9644782309;Taip;0;7;0;7
17546;Vaduvos;"4 klasė";5523290081;Taip;0;5;0;5
17547;Vaduvos;"4 klasė";5786723345;Ne;0;9;0;9
17548;Vaduvos;"4 klasė";1461738157;Taip;0;5;0;5
17549;Vaduvos;"4 klasė";7786044620;Taip;0;21;0;21
17550;Vaduvos;"4 klasė";4347558872;Taip;0;5;0;5
17551;Vaduvos;"4 klasė";1954540001;Taip;0;10;0;10
17552;Vaduvos;"4 klasė";9271050464;Taip;0;9;0;9
17553;Vaduvos;"4 klasė";3755145838;Taip;0;21;0;21
17554;Vaduvos;"4 klasė";9494193819;Ne;0;21;0;21
17555;Vaduvos;"4 klasė";7838224919;Ne;0;4;0;4
17556;Vaduvos;"4 klasė";1086186628;Taip;0;5;0;5
17557;Vaduvos;"4 klasė";9441676636;Ne;0;4;0;4
17558;Vaduvos;"4 klasė";1841919654;Ne;0;4;0;4
17559;Vaduvos;"4 klasė";6964778383;Taip;0;8;0;8
17560;Vaduvos;"4 klasė";6748405557;Taip;0;4;0;4
17561;Vaduvos;"4 klasė";1730710569;Taip;0;4;0;4
17562;Vaduvos;"4 klasė";6744521293;Ne;0;5;0;5
17563;Vaduvos;"4 klasė";8801412437;Taip;0;4;0;4
17564;Vaduvos;"4 klasė";3583694770;Taip;0;21;0;21
17565;Vilkpėdės;BORUŽĖLĖS;8969001990;Taip;17;0;0;17
17566;Vilkpėdės;BORUŽĖLĖS;6744834487;Taip;8;0;3;11
17567;Vilkpėdės;BORUŽĖLĖS;7401886306;Taip;8;6;0;14
17568;Vilkpėdės;BORUŽĖLĖS;1528619779;Taip;4;2;0;6
17569;Vilkpėdės;BORUŽĖLĖS;6820236577;Taip;11;1;0;12
17570;Vilkpėdės;BORUŽĖLĖS;4255757333;Taip;5;5;0;10
17571;Vilkpėdės;BORUŽĖLĖS;5053032081;Taip;9;0;0;9
17572;Vilkpėdės;BORUŽĖLĖS;4166416292;Taip;12;0;0;12
17573;Vilkpėdės;BORUŽĖLĖS;3785308006;Taip;11;0;1;12
17574;Vilkpėdės;BORUŽĖLĖS;6473925760;Taip;11;0;1;12
17575;Vilkpėdės;BORUŽĖLĖS;6283767445;Taip;0;3;0;3
17576;Vilkpėdės;BORUŽĖLĖS;9605430333;Taip;9;4;0;13
17577;Vilkpėdės;BORUŽĖLĖS;3888880306;Taip;2;19;0;21
17578;Vilkpėdės;BORUŽĖLĖS;9601934563;Taip;17;0;0;17
17579;Vilkpėdės;BORUŽĖLĖS;1571869318;Taip;9;0;0;9
17580;Vilkpėdės;SKRUZDĖLIUKAI;1838974989;Taip;0;21;0;21
17581;Vilkpėdės;SKRUZDĖLIUKAI;8820585407;Taip;5;0;0;5
17582;Vilkpėdės;SKRUZDĖLIUKAI;7661268641;Taip;5;1;0;6
17583;Vilkpėdės;SKRUZDĖLIUKAI;4018140154;Taip;11;0;0;11
17584;Vilkpėdės;SKRUZDĖLIUKAI;8385974099;Taip;12;0;0;12
17585;Vilkpėdės;SKRUZDĖLIUKAI;2525399410;Taip;7;0;3;10
17586;Vilkpėdės;SKRUZDĖLIUKAI;4031175523;Taip;14;0;0;14
17587;Vilkpėdės;SKRUZDĖLIUKAI;6778288398;Taip;7;0;0;7
17588;Vilkpėdės;SKRUZDĖLIUKAI;3948025914;Taip;0;12;0;12
17589;Vilkpėdės;SKRUZDĖLIUKAI;1655985778;Ne;14;0;0;14
17590;Vilkpėdės;SKRUZDĖLIUKAI;8018718405;Taip;2;4;0;6
17591;Vilkpėdės;SKRUZDĖLIUKAI;6514256499;Taip;4;4;4;12
17592;Vilkpėdės;DRUGELIAI;2420271759;Taip;3;4;0;7
17593;Vilkpėdės;DRUGELIAI;9294350205;Taip;4;5;0;9
17594;Vilkpėdės;DRUGELIAI;2377248778;Taip;0;5;0;5
17595;Vilkpėdės;DRUGELIAI;7698759895;Taip;10;0;0;10
17596;Vilkpėdės;DRUGELIAI;1019057127;Taip;10;1;0;11
17597;Vilkpėdės;DRUGELIAI;1807884737;Taip;2;7;1;10
17598;Vilkpėdės;DRUGELIAI;6816745585;Taip;2;5;0;7
17599;Vilkpėdės;DRUGELIAI;9460356725;Taip;6;4;0;10
17600;Vilkpėdės;DRUGELIAI;8015392054;Taip;0;1;0;1
17601;Vilkpėdės;DRUGELIAI;2320350937;Taip;6;6;0;12
17602;Vilkpėdės;DRUGELIAI;9795696242;Taip;8;0;0;8
17603;Vilkpėdės;DRUGELIAI;8581661608;Taip;0;1;0;1
17604;Vilkpėdės;DRUGELIAI;6261547304;Taip;4;0;0;4
17605;Vilkpėdės;DRUGELIAI;4095366279;Taip;10;1;0;11
17606;Vilkpėdės;DRUGELIAI;8128254701;Taip;2;14;0;16
17607;Vilkpėdės;DRUGELIAI;7908813288;Ne;12;4;0;16
17608;Vilkpėdės;ŽIOGELIAI;1267187553;Taip;4;6;0;10
17609;Vilkpėdės;ŽIOGELIAI;7508333714;Taip;11;1;0;12
17610;Vilkpėdės;ŽIOGELIAI;1396827668;Taip;14;0;0;14
17611;Vilkpėdės;ŽIOGELIAI;5551822633;Taip;17;4;0;21
17612;Vilkpėdės;ŽIOGELIAI;9544418642;Taip;3;0;1;4
17613;Vilkpėdės;ŽIOGELIAI;1063740772;Taip;2;0;0;2
17614;Vilkpėdės;ŽIOGELIAI;3666145718;Taip;4;5;0;9
17615;Vilkpėdės;ŽIOGELIAI;5633014328;Taip;13;4;0;17
17616;Vilkpėdės;ŽIOGELIAI;5422061533;Taip;20;0;0;20
17617;Vilkpėdės;ŽIOGELIAI;4311938034;Taip;12;4;0;16
17618;Vilkpėdės;ŽIOGELIAI;3833382641;Taip;2;0;0;2
17619;Vilkpėdės;ŽIOGELIAI;5346798201;Taip;7;3;0;10
17620;Vilkpėdės;ŽIOGELIAI;5340239466;Taip;20;0;0;20
17621;Vilkpėdės;ŽIOGELIAI;7745776486;Taip;16;0;0;16
17622;Vilkpėdės;BITUTĖS;9605399822;Taip;0;6;0;6
17623;Vilkpėdės;BITUTĖS;7875898177;Taip;5;1;0;6
17624;Vilkpėdės;BITUTĖS;4735164204;Taip;4;2;0;6
17625;Vilkpėdės;BITUTĖS;46561435465;Ne;0;13;0;13
17626;Vilkpėdės;BITUTĖS;48059844727;Taip;0;10;0;10
17627;Vilkpėdės;BITUTĖS;1195392132;Taip;5;0;0;5
17628;Vilkpėdės;BITUTĖS;7634355147;Taip;0;1;0;1
17629;Vilkpėdės;BITUTĖS;4392760215;Ne;0;2;0;2
17630;Vilkpėdės;BITUTĖS;2955411131;Taip;0;3;0;3
17631;Vilkpėdės;BITUTĖS;2736368118;Taip;0;8;0;8
17632;Vilkpėdės;BITUTĖS;4515945951;Taip;0;2;3;5
17633;Vilkpėdės;BITUTĖS;2900581406;Taip;0;2;0;2
17634;Vilkpėdės;BITUTĖS;7527929277;Taip;0;4;0;4
17635;Vilkpėdės;BITUTĖS;8865545376;Ne;0;8;0;8
17636;Vilkpėdės;BITUTĖS;4276158771;Taip;0;6;0;6
17637;Vilkpėdės;BITUTĖS;7889480219;Ne;0;3;0;3
17638;Vilkpėdės;BITUTĖS;2125569383;Taip;0;5;3;8
17639;Vilkpėdės;"2 klasė";14499651046;Ne;0;10;0;10
17640;Vilkpėdės;"2 klasė";90217345315;Taip;0;9;0;9
17641;Vilkpėdės;"2 klasė";51286525404;Taip;0;9;0;9
17642;Vilkpėdės;"2 klasė";49513181091;Taip;2;9;0;11
17643;Vilkpėdės;"2 klasė";1032216128;Taip;12;9;0;21
17644;Vilkpėdės;"2 klasė";37450374921;Taip;0;9;0;9
17645;Vilkpėdės;"2 klasė";36704555745;Taip;3;9;0;12
17646;Vilkpėdės;"2 klasė";66356984763;Taip;0;9;0;9
17647;Vilkpėdės;"2 klasė";88279045901;Taip;0;10;0;10
17648;Vilkpėdės;"2 klasė";66451097025;Taip;5;9;0;14
17649;Vilkpėdės;"2 klasė";2806307083;Taip;1;9;0;10
17650;Vilkpėdės;"2 klasė";51799865091;Taip;0;9;0;9
17651;Vilkpėdės;"2 klasė";79269485254;Taip;2;9;0;11
17652;Vilkpėdės;"2 klasė";61833757576;Taip;0;9;0;9
17653;Vilkpėdės;"2 klasė";64216245300;Taip;0;9;0;9
17654;Vilkpėdės;"3 klasė";54583403159;Ne;1;4;0;5
17655;Vilkpėdės;"3 klasė";6750171948;Ne;5;4;0;9
17656;Vilkpėdės;"3 klasė";3330174377;Ne;0;4;0;4
17657;Vilkpėdės;"3 klasė";1894949069;Ne;0;4;0;4
17658;Vilkpėdės;"3 klasė";2877690064;Ne;1;4;0;5
17659;Vilkpėdės;"3 klasė";63399321230;Taip;0;4;0;4
17660;Vilkpėdės;"3 klasė";5753361387;Ne;0;4;0;4
17661;Vilkpėdės;"3 klasė";7567054902;Ne;1;4;0;5
17662;Vilkpėdės;"3 klasė";3096541013;Ne;0;4;0;4
17663;Vilkpėdės;"3 klasė";2621713818;Ne;0;4;0;4
17664;Vilkpėdės;"3 klasė";2334044794;Ne;0;4;1;5
17665;Vilkpėdės;"3 klasė";4450490805;Ne;0;4;0;4
17666;Vilkpėdės;"3 klasė";45282785781;Taip;0;4;0;4
17667;Vilkpėdės;"3 klasė";87882890428;Taip;0;4;0;4
17668;Vilkpėdės;"3 klasė";9422266523;Ne;1;4;0;5
17669;Vilkpėdės;"3 klasė";6334059519;Ne;0;4;0;4
17670;Vilkpėdės;"3 klasė";4467711387;Ne;0;4;0;4
17671;Vilkpėdės;"3 klasė";4562930821;Ne;0;4;0;4
17672;Vilkpėdės;GUDRUČIAI;19719432462;Taip;0;4;0;4
17673;Vilkpėdės;GUDRUČIAI;63180329851;Ne;0;5;0;5
17674;Vilkpėdės;GUDRUČIAI;93775558547;Ne;0;2;0;2
17675;Vilkpėdės;GUDRUČIAI;5218466024;Taip;7;5;0;12
17676;Vilkpėdės;GUDRUČIAI;41394645789;Taip;0;4;0;4
17677;Vilkpėdės;GUDRUČIAI;4457851703;Taip;3;5;0;8
17678;Vilkpėdės;GUDRUČIAI;70184817311;Taip;0;6;0;6
17679;Vilkpėdės;GUDRUČIAI;81712437117;Taip;0;7;0;7
17680;Vilkpėdės;GUDRUČIAI;61457409195;Ne;0;11;0;11
17681;Vilkpėdės;GUDRUČIAI;60687258266;Taip;0;10;0;10
17682;Vilkpėdės;GUDRUČIAI;25846393751;Taip;0;1;0;1
17683;Vilkpėdės;GUDRUČIAI;95615604947;Taip;0;5;0;5
17684;Vilkpėdės;GUDRUČIAI;90226911248;Taip;0;9;0;9
17685;Vilkpėdės;GUDRUČIAI;18860888473;Taip;0;5;0;5
17686;Vilkpėdės;GUDRUČIAI;73812058890;Taip;0;6;0;6
17687;Vilkpėdės;GUDRUČIAI;95408044297;Taip;0;4;0;4
17688;Vilkpėdės;GUDRUČIAI;64155507543;Taip;0;2;0;2
17689;Vilkpėdės;GUDRUČIAI;33842357499;Taip;0;6;0;6
17690;Vilkpėdės;GUDRUČIAI;21841574426;Taip;0;9;0;9
17691;Vilkpėdės;GUDRUČIAI;32683398503;Taip;0;3;0;3
17692;Vilkpėdės;GUDRUČIAI;58037049872;Taip;0;4;0;4
17693;Vilkpėdės;GUDRUČIAI;89601406730;Taip;0;13;0;13
17694;Vilkpėdės;SMALSUČIAI;2065010940;Taip;0;10;0;10
17695;Vilkpėdės;SMALSUČIAI;1137529145;Ne;0;5;0;5
17696;Vilkpėdės;SMALSUČIAI;13241568469;Taip;4;4;0;8
17697;Vilkpėdės;SMALSUČIAI;1052719398;Taip;0;6;0;6
17698;Vilkpėdės;SMALSUČIAI;1145968615;Taip;4;4;0;8
17699;Vilkpėdės;SMALSUČIAI;1598018406;Taip;0;4;0;4
17700;Vilkpėdės;SMALSUČIAI;55747681017;Taip;0;5;0;5
17701;Vilkpėdės;SMALSUČIAI;1136036746;Taip;0;6;0;6
17702;Vilkpėdės;SMALSUČIAI;51976067616;Taip;15;0;0;15
17703;Vilkpėdės;SMALSUČIAI;5912919726;Taip;0;3;0;3
17704;Vilkpėdės;SMALSUČIAI;40385792431;Ne;0;4;0;4
17705;Vilkpėdės;SMALSUČIAI;72227817278;Ne;10;1;0;11
17706;Vilkpėdės;SMALSUČIAI;1795879331;Taip;9;4;0;13
17707;Vilkpėdės;SMALSUČIAI;2000428715;Taip;0;5;0;5
17708;Vilkpėdės;SMALSUČIAI;1042000830;Taip;0;1;0;1
17709;Vilkpėdės;SMALSUČIAI;72899151328;Taip;0;2;8;10
17710;Vilkpėdės;SMALSUČIAI;1527272055;Ne;0;5;0;5
17711;Vilkpėdės;SMALSUČIAI;1384224802;Taip;0;4;0;4
17712;Vilkpėdės;SMALSUČIAI;25008201566;Taip;21;0;0;21
17713;Vilkpėdės;SMALSUČIAI;9393571483;Taip;7;2;0;9
17714;Žiburėlis;Nykštukai;6696156248;Taip;0;4;0;4
17715;Žiburėlis;Nykštukai;7163594513;Taip;10;4;0;14
17716;Žiburėlis;Nykštukai;5209976632;Taip;0;2;2;4
17717;Žiburėlis;Nykštukai;5408766721;Ne;8;0;0;8
17718;Žiburėlis;Nykštukai;3646988912;Taip;12;1;0;13
17719;Žiburėlis;Nykštukai;8535429783;Ne;15;0;0;15
17720;Žiburėlis;Nykštukai;9670396828;Taip;21;0;0;21
17721;Žiburėlis;Nykštukai;7211961512;Ne;2;2;0;4
17722;Žiburėlis;Nykštukai;2928528630;Ne;12;2;0;14
17723;Žiburėlis;Nykštukai;2624326930;Taip;0;9;0;9
17724;Žiburėlis;Nykštukai;6300247811;Taip;12;4;0;16
17725;Žiburėlis;Nykštukai;3033049328;Taip;0;10;0;10
17726;Žiburėlis;Nykštukai;3687703187;Taip;2;1;0;3
17727;Žiburėlis;Nykštukai;7862546963;Taip;7;4;0;11
17728;Žiburėlis;Nykštukai;8902837168;Taip;7;4;0;11
17729;Žiburėlis;Nykštukai;5303511810;Taip;19;0;0;19
17730;Žiburėlis;Nykštukai;3262856058;Ne;6;1;0;7
17731;Žiburėlis;Nykštukai;5816890413;Taip;21;0;0;21
17732;Žiburėlis;"Žiniukai ";1463581257;Ne;0;4;0;4
17733;Žiburėlis;"Žiniukai ";90296810303;Taip;3;4;0;7
17734;Žiburėlis;"Žiniukai ";78896331135;Taip;0;2;0;2
17735;Žiburėlis;"Žiniukai ";32837087738;Taip;3;1;0;4
17736;Žiburėlis;"Žiniukai ";78861342608;Ne;11;4;0;15
17737;Žiburėlis;"Žiniukai ";49081936325;Taip;0;4;0;4
17738;Žiburėlis;"Žiniukai ";7135920347;Taip;0;4;0;4
17739;Žiburėlis;"Žiniukai ";61148040564;Taip;0;4;0;4
17740;Žiburėlis;"Žiniukai ";25826760783;Taip;13;2;0;15
17741;Žiburėlis;"Žiniukai ";45509849089;Taip;7;4;0;11
17742;Žiburėlis;"Žiniukai ";73054546792;Taip;8;5;0;13
17743;Žiburėlis;"Žiniukai ";1937753510;Taip;2;6;0;8
17744;Žiburėlis;"Žiniukai ";42442737710;Taip;2;4;0;6
17745;Žiburėlis;"Žiniukai ";50484332477;Taip;0;4;0;4
17746;Žiburėlis;"Žiniukai ";64418469679;Ne;2;2;0;4
17747;Žiburėlis;"Žiniukai ";16215414453;Taip;0;5;0;5
17748;Žiburėlis;"Žiniukai ";77674964341;Taip;0;6;0;6
17749;Žiburėlis;"Smalsiukai ";4631640931;Taip;10;4;0;14
17750;Žiburėlis;"Smalsiukai ";5006361324;Taip;5;0;0;5
17751;Žiburėlis;"Smalsiukai ";8109335587;Taip;2;4;0;6
17752;Žiburėlis;"Smalsiukai ";4187381976;Taip;15;4;0;19
17753;Žiburėlis;"Smalsiukai ";7424129974;Ne;4;3;0;7
17754;Žiburėlis;"Smalsiukai ";2982016133;Taip;0;1;0;1
17755;Žiburėlis;"Smalsiukai ";5517458323;Taip;5;4;0;9
17756;Žiburėlis;"Smalsiukai ";1720078356;Taip;8;4;0;12
17757;Žiburėlis;"Smalsiukai ";57892276898;Taip;13;4;0;17
17758;Žiburėlis;"Smalsiukai ";13256396372;Taip;5;2;0;7
17759;Žiburėlis;"Smalsiukai ";87417486808;Ne;0;9;0;9
17760;Žiburėlis;"Smalsiukai ";68423991252;Taip;0;7;0;7
17761;Žiburėlis;"Smalsiukai ";25079486133;Taip;0;1;0;1
17762;Žiburėlis;"Smalsiukai ";7518552326;Taip;4;5;4;13
17763;Žiburėlis;"Smalsiukai ";25134435204;Taip;9;6;0;15
17764;Žiburėlis;"Smalsiukai ";3966740507;Ne;0;5;0;5
17765;Žiburėlis;"Smalsiukai ";1115857147;Taip;10;5;0;15
17766;Žiburėlis;"Giliukai ";52216192635;Taip;16;0;0;16
17767;Žiburėlis;"Giliukai ";4355778076;Taip;10;0;0;10
17768;Žiburėlis;"Giliukai ";92490398630;Taip;2;3;0;5
17769;Žiburėlis;"Giliukai ";67168630669;Taip;7;0;0;7
17770;Žiburėlis;"Giliukai ";3867540155;Taip;4;6;0;10
17771;Žiburėlis;"Giliukai ";7578655857;Ne;0;2;0;2
17772;Žiburėlis;"Giliukai ";75538036055;Taip;9;1;0;10
17773;Žiburėlis;"Giliukai ";9253393819;Taip;4;3;0;7
17774;Žiburėlis;"Giliukai ";8677998615;Taip;8;3;0;11
17775;Žiburėlis;"Giliukai ";2796489509;Taip;7;4;0;11
17776;Žiburėlis;"Giliukai ";18739941845;Taip;11;4;0;15
17777;Žiburėlis;"Giliukai ";24639355056;Taip;13;4;0;17
17778;Žiburėlis;"Giliukai ";1842029645;Taip;0;21;0;21
17779;Žiburėlis;"Giliukai ";6519139977;Taip;0;20;0;20
17780;Žiburėlis;"Giliukai ";7861704875;Ne;6;1;0;7
17781;Žiburėlis;"Giliukai ";34873231652;Taip;2;1;0;3
17782;Žiburėlis;"Giliukai ";1125662904;Taip;7;6;0;13
17783;Žiburėlis;"Giliukai ";2175751377;Taip;7;1;1;9
17784;Žiburėlis;"Giliukai ";8531121002;Ne;13;0;0;13
17785;Žiburėlis;"Giliukai ";28985997205;Taip;3;4;0;7
17786;Žiburėlis;"1 klasė";5914668910;Ne;1;4;0;5
17787;Žiburėlis;"1 klasė";95216886081;Taip;0;4;0;4
17788;Žiburėlis;"1 klasė";37375035477;Taip;4;4;0;8
17789;Žiburėlis;"1 klasė";54487369856;Taip;3;4;0;7
17790;Žiburėlis;"1 klasė";1483522393;Taip;0;4;0;4
17791;Žiburėlis;"1 klasė";93584914250;Taip;0;4;0;4
17792;Žiburėlis;"1 klasė";1858285649;Taip;0;4;0;4
17793;Žiburėlis;"1 klasė";41774939326;Taip;0;4;0;4
17794;Žiburėlis;"1 klasė";5778346952;Taip;0;4;0;4
17795;Žiburėlis;"1 klasė";67896676967;Taip;3;4;0;7
17796;Žiburėlis;"1 klasė";1852949849;Ne;1;4;0;5
17797;Žiburėlis;"1 klasė";95176636771;Taip;0;4;0;4
17798;Žiburėlis;"1 klasė";88801862582;Taip;0;4;0;4
17799;Žiburėlis;Meškiukai;7070952018;Taip;7;5;0;12
17800;Žiburėlis;Meškiukai;874653320;Taip;0;4;0;4
17801;Žiburėlis;Meškiukai;38096163093;Taip;0;3;0;3
17802;Žiburėlis;Meškiukai;96004573835;Taip;7;6;0;13
17803;Žiburėlis;Meškiukai;549348368;Taip;0;6;0;6
17804;Žiburėlis;Meškiukai;2270893326;Taip;0;6;0;6
17805;Žiburėlis;Meškiukai;1728059994;Taip;0;5;0;5
17806;Žiburėlis;Meškiukai;1523632106;Taip;7;5;0;12
17807;Žiburėlis;Meškiukai;9069606713;Ne;2;4;0;6
17808;Žiburėlis;Meškiukai;46449810717;Taip;8;0;0;8
17809;Žiburėlis;Meškiukai;3678560815;Taip;3;4;0;7
17810;Žiburėlis;Meškiukai;57749440744;Taip;11;1;0;12
17811;Žiburėlis;Meškiukai;1614403409;Taip;0;1;0;1
17812;Žiburėlis;Meškiukai;808556747;Taip;0;14;0;14
17813;Žiburėlis;Meškiukai;43206636255;Taip;7;5;0;12
17814;Žiburėlis;Meškiukai;60150682872;Taip;3;11;0;14
17815;Žiburėlis;Meškiukai;50869669391;Taip;0;5;0;5
17816;Žiburėlis;Meškiukai;31669188580;Taip;1;2;0;3
17817;Žiburėlis;Meškiukai;30337030701;Taip;0;5;0;5
17818;Žiburėlis;Meškiukai;1612968712;Taip;4;2;0;6
17819;Žiburėlis;Meškiukai;5495813195;Taip;3;7;0;10
17820;Žiburėlis;Viščiukai;2491972986;Taip;10;7;0;17
17821;Žiburėlis;Viščiukai;8970153523;Taip;6;0;0;6
17822;Žiburėlis;Viščiukai;2702814930;Taip;13;0;0;13
17823;Žiburėlis;Viščiukai;4387021429;Taip;0;13;0;13
17824;Žiburėlis;Viščiukai;7865562941;Ne;5;1;0;6
17825;Žiburėlis;Viščiukai;8973307069;Ne;12;1;0;13
17826;Žiburėlis;Viščiukai;5002691930;Taip;0;4;0;4
17827;Žiburėlis;Viščiukai;8133371774;Taip;12;1;0;13
17828;Žiburėlis;Viščiukai;4916545915;Taip;5;5;0;10
17829;Žiburėlis;Viščiukai;6802308420;Taip;21;0;0;21
17830;Žiburėlis;Viščiukai;1775465307;Taip;0;1;0;1
17831;Žiburėlis;Viščiukai;6647598068;Taip;6;0;0;6
17832;Žiburėlis;Viščiukai;4109288891;Taip;3;4;0;7
17833;Žiburėlis;Viščiukai;7111530833;Ne;0;5;0;5
17834;Žiburėlis;Viščiukai;7825665451;Taip;2;4;0;6
17835;Žiburėlis;"Drambliukai ";7633450988;Taip;10;0;0;10
17836;Žiburėlis;"Drambliukai ";2741301903;Taip;0;10;0;10
17837;Žiburėlis;"Drambliukai ";6830200578;Ne;13;4;0;17
17838;Žiburėlis;"Drambliukai ";2253167147;Taip;19;0;0;19
17839;Žiburėlis;"Drambliukai ";7402647048;Taip;7;1;0;8
17840;Žiburėlis;"Drambliukai ";8215816053;Ne;13;6;0;19
17841;Žiburėlis;"Drambliukai ";9352485231;Taip;0;4;0;4
17842;Žiburėlis;"Drambliukai ";4710995351;Taip;7;1;0;8
17843;Žiburėlis;"Drambliukai ";2292895729;Taip;9;4;0;13
17844;Žiburėlis;"Drambliukai ";7273838695;Taip;0;6;0;6
17845;Žiburėlis;"Drambliukai ";5098955523;Taip;2;8;0;10
17846;Žiburėlis;"Drambliukai ";5629404179;Taip;13;6;0;19
17847;Žiburėlis;"Drambliukai ";9806454408;Taip;4;4;0;8
17848;Žiburėlis;"Drambliukai ";1764592065;Taip;4;0;0;4
17849;Žiburėlis;"Drambliukai ";8686565770;Taip;2;1;0;3
17850;Žiburėlis;"Drambliukai ";3938379566;Taip;7;6;0;13
17851;Žiburėlis;"Drambliukai ";5556807335;Taip;3;7;0;10
17852;Žiburėlis;"Drambliukai ";8346571253;Taip;9;0;0;9
17853;Žiburėlis;"2 klasė";78965453247;Ne;0;4;0;4
17854;Žiburėlis;"2 klasė";91489560481;Taip;6;4;0;10
17855;Žiburėlis;"2 klasė";86214644730;Taip;1;4;0;5
17856;Žiburėlis;"2 klasė";50386629614;Taip;0;4;0;4
17857;Žiburėlis;"2 klasė";29289711001;Ne;0;21;0;21
17858;Žiburėlis;"2 klasė";3462265950;Taip;0;21;0;21
17859;Žiburėlis;"2 klasė";97596344387;Taip;5;4;0;9
17860;Žiburėlis;"2 klasė";67880120356;Taip;2;4;0;6
17861;Žiburėlis;"2 klasė";83887875309;Taip;0;4;0;4
17862;Žiburėlis;"2 klasė";75779767358;Ne;0;4;0;4
17863;Žiburėlis;"2 klasė";33877368082;Taip;3;4;0;7
17864;Žiburėlis;"2 klasė";40167464240;Taip;0;4;0;4
17865;Žiburėlis;"2 klasė";91397954329;Taip;7;4;0;11
17866;Žiburėlis;"2 klasė";1266445858;Taip;9;4;0;13
17867;Žiburėlis;"2 klasė";19924188057;Taip;3;4;0;7
17868;Žiburėlis;"2 klasė";16657264022;Taip;0;4;0;4
17869;Žiburėlis;"2 klasė";23334642950;Taip;0;4;0;4
17870;Žiburėlis;"2 klasė";4909760547;Taip;0;4;0;4
17871;Žiburėlis;"3 klasė";8108287017;Ne;0;21;0;21
17872;Žiburėlis;"3 klasė";7328501055;Ne;4;4;0;8
17873;Žiburėlis;"3 klasė";6555937866;Ne;0;4;0;4
17874;Žiburėlis;"3 klasė";9986286327;Ne;0;21;0;21
17875;Žiburėlis;"3 klasė";8967516850;Ne;6;4;0;10
17876;Žiburėlis;"3 klasė";4955196776;Ne;0;4;1;5
17877;Žiburėlis;"3 klasė";5730454385;Ne;0;4;0;4
17878;Žiburėlis;"3 klasė";7420310542;Ne;7;4;0;11
17879;Žiburėlis;"3 klasė";9030168070;Ne;4;4;0;8
17880;Žiburėlis;"3 klasė";5120367724;Ne;0;4;0;4
17881;Žiburėlis;"3 klasė";5154752431;Ne;5;4;0;9
17882;Žiburėlis;"3 klasė";2895056046;Ne;5;4;0;9
17883;Žiburėlis;"3 klasė";2980656238;Ne;0;4;0;4
17884;Žiburėlis;"3 klasė";9444201589;Ne;6;4;0;10
17885;Žiburėlis;"3 klasė";6532799193;Ne;0;4;0;4
17886;Žiburėlis;"3 klasė";5587135070;Ne;7;4;0;11
17887;Žiburėlis;"3 klasė";7971654401;Ne;2;4;0;6
17888;Žiburėlis;"3 klasė";7244452816;Ne;0;4;0;4
17889;Žiburėlis;"4 klasė";2145461317;Ne;10;4;0;14
17890;Žiburėlis;"4 klasė";6992801094;Ne;5;4;0;9
17891;Žiburėlis;"4 klasė";7451312098;Ne;0;4;0;4
17892;Žiburėlis;"4 klasė";4444164248;Ne;2;4;0;6
17893;Žiburėlis;"4 klasė";8755335337;Ne;0;21;0;21
17894;Žiburėlis;"4 klasė";9803636658;Ne;0;21;0;21
17895;Žiburėlis;"4 klasė";7239532785;Ne;1;4;0;5
17896;Žiburėlis;"4 klasė";9676316394;Ne;0;4;0;4
17897;Žiburėlis;"4 klasė";8942909201;Ne;5;4;0;9
17898;Žiburėlis;"4 klasė";3493549126;Ne;0;21;0;21
17899;Žiburėlis;"4 klasė";6088424692;Ne;0;21;0;21
17900;Žiburėlis;"4 klasė";5999075406;Ne;0;21;0;21
17901;Žiburėlis;"4 klasė";8539444386;Ne;0;4;0;4
17902;Žiburėlis;"4 klasė";3931688013;Ne;0;4;0;4
17903;Žiburėlis;"4 klasė";1769155142;Ne;0;4;0;4
17904;Justinukas;PELEDŽIUKŲ;6268022925;Taip;15;0;0;15
17905;Justinukas;PELEDŽIUKŲ;1405642653;Taip;2;6;0;8
17906;Justinukas;PELEDŽIUKŲ;1976450069;Taip;4;0;1;5
17907;Justinukas;PELEDŽIUKŲ;90692179185;Taip;0;8;0;8
17908;Justinukas;PELEDŽIUKŲ;61301662234;Taip;5;4;0;9
17909;Justinukas;PELEDŽIUKŲ;2027779101;Taip;0;5;3;8
17910;Justinukas;PELEDŽIUKŲ;8742157840;Taip;4;5;0;9
17911;Justinukas;PELEDŽIUKŲ;55089909579;Taip;4;5;0;9
17912;Justinukas;PELEDŽIUKŲ;12741015006;Taip;0;15;0;15
17913;Justinukas;PELEDŽIUKŲ;48908098476;Taip;0;11;0;11
17914;Justinukas;PELEDŽIUKŲ;1956136425;Taip;0;7;0;7
17915;Justinukas;PELEDŽIUKŲ;29165025048;Taip;0;0;1;1
17916;Justinukas;PELEDŽIUKŲ;8748370028;Taip;0;0;8;8
17917;Justinukas;PELEDŽIUKŲ;5282345380;Ne;0;6;0;6
17918;Justinukas;PELEDŽIUKŲ;5610993611;Taip;0;6;1;7
17919;Justinukas;PELEDŽIUKŲ;67366895767;Taip;0;9;0;9
17920;Justinukas;PELEDŽIUKŲ;3427720250;Ne;6;0;4;10
17921;Justinukas;PELEDŽIUKŲ;6610166355;Taip;15;0;0;15
17922;Justinukas;BORUŽIUKŲ;6897988246;Taip;0;1;0;1
17923;Justinukas;BORUŽIUKŲ;4542350401;Taip;1;8;0;9
17924;Justinukas;BORUŽIUKŲ;4347647695;Ne;8;4;0;12
17925;Justinukas;BORUŽIUKŲ;3388483002;Taip;15;0;2;17
17926;Justinukas;BORUŽIUKŲ;9998493076;Taip;0;5;0;5
17927;Justinukas;BORUŽIUKŲ;1129392970;Taip;0;1;1;2
17928;Justinukas;BORUŽIUKŲ;8281005516;Taip;12;4;0;16
17929;Justinukas;BORUŽIUKŲ;1398976932;Taip;0;4;0;4
17930;Justinukas;BORUŽIUKŲ;9823188609;Taip;0;4;0;4
17931;Justinukas;BORUŽIUKŲ;1977242147;Taip;10;5;0;15
17932;Justinukas;BORUŽIUKŲ;5258444578;Taip;3;0;0;3
17933;Justinukas;BORUŽIUKŲ;4574673585;Taip;5;0;0;5
17934;Justinukas;BORUŽIUKŲ;7006338378;Taip;4;6;0;10
17935;Justinukas;BORUŽIUKŲ;7166828675;Ne;0;0;13;13
17936;Justinukas;BORUŽIUKŲ;39916867354;Taip;0;3;0;3
17937;Justinukas;BORUŽIUKŲ;4010638658;Taip;0;5;1;6
17938;Justinukas;BORUŽIUKŲ;1172609518;Ne;0;12;1;13
17939;Justinukas;BORUŽIUKŲ;1616324236;Taip;2;5;0;7
17940;Justinukas;BORUŽIUKŲ;3030820917;Taip;2;7;0;9
17941;Justinukas;BORUŽIUKŲ;4430183106;Ne;8;4;3;15
17942;Justinukas;BORUŽIUKŲ;1507699415;Taip;0;0;20;20
17943;Justinukas;SKRUZDĖLIUKAI;7035968183;Taip;16;4;1;21
17944;Justinukas;SKRUZDĖLIUKAI;5337728911;Taip;0;6;0;6
17945;Justinukas;SKRUZDĖLIUKAI;9714895573;Taip;6;4;0;10
17946;Justinukas;SKRUZDĖLIUKAI;7989662358;Taip;0;4;0;4
17947;Justinukas;SKRUZDĖLIUKAI;8874149122;Taip;2;1;1;4
17948;Justinukas;SKRUZDĖLIUKAI;9413817052;Taip;0;3;0;3
17949;Justinukas;SKRUZDĖLIUKAI;5583929465;Taip;5;0;0;5
17950;Justinukas;SKRUZDĖLIUKAI;2902901064;Taip;12;0;0;12
17951;Justinukas;SKRUZDĖLIUKAI;2362568676;Taip;7;0;5;12
17952;Justinukas;SKRUZDĖLIUKAI;2495027317;Taip;17;4;0;21
17953;Justinukas;SKRUZDĖLIUKAI;4169517353;Taip;9;0;1;10
17954;Justinukas;SKRUZDĖLIUKAI;2378107030;Taip;7;0;0;7
17955;Justinukas;SKRUZDĖLIUKAI;7135292839;Taip;0;2;1;3
17956;Justinukas;SKRUZDĖLIUKAI;3138582167;Taip;15;4;0;19
17957;Justinukas;SKRUZDĖLIUKAI;9037601873;Taip;5;0;6;11
17958;Justinukas;SKRUZDĖLIUKAI;7031501155;Taip;11;0;2;13
17959;Justinukas;SKRUZDĖLIUKAI;3082687604;Taip;9;0;0;9
17960;Justinukas;ŽVIRBLIUKAI;8185266162;Taip;0;11;0;11
17961;Justinukas;ŽVIRBLIUKAI;3777745443;Taip;19;1;0;20
17962;Justinukas;ŽVIRBLIUKAI;8564006025;Taip;19;1;0;20
17963;Justinukas;ŽVIRBLIUKAI;5711628356;Taip;3;6;0;9
17964;Justinukas;ŽVIRBLIUKAI;9151163087;Taip;0;4;0;4
17965;Justinukas;ŽVIRBLIUKAI;4897823765;Ne;16;0;0;16
17966;Justinukas;ŽVIRBLIUKAI;1447493567;Taip;21;0;0;21
17967;Justinukas;ŽVIRBLIUKAI;8242805821;Taip;0;0;21;21
17968;Justinukas;ŽVIRBLIUKAI;1779138446;Taip;4;0;0;4
17969;Justinukas;ŽVIRBLIUKAI;4328855128;Taip;0;4;0;4
17970;Justinukas;ŽVIRBLIUKAI;5490753578;Taip;21;0;0;21
17971;Justinukas;ŽVIRBLIUKAI;6184892609;Ne;0;5;0;5
17972;Justinukas;ŽVIRBLIUKAI;6984802993;Taip;6;0;2;8
17973;Justinukas;ŽVIRBLIUKAI;4699181819;Taip;0;3;0;3
17974;Justinukas;PELIUKAI;1555183700;Taip;0;6;5;11
17975;Justinukas;PELIUKAI;30823793919;Taip;7;0;5;12
17976;Justinukas;PELIUKAI;35192728896;Taip;4;4;0;8
17977;Justinukas;PELIUKAI;59176678396;Taip;0;6;0;6
17978;Justinukas;PELIUKAI;2002649360;Taip;8;0;0;8
17979;Justinukas;PELIUKAI;1181972027;Taip;11;3;0;14
17980;Justinukas;PELIUKAI;1785794727;Taip;0;7;1;8
17981;Justinukas;PELIUKAI;1319540676;Taip;6;4;0;10
17982;Justinukas;PELIUKAI;1490500434;Ne;0;7;0;7
17983;Justinukas;PELIUKAI;13774489893;Taip;4;0;4;8
17984;Justinukas;PELIUKAI;89330918024;Taip;10;0;0;10
17985;Justinukas;PELIUKAI;49578167204;Taip;0;4;1;5
17986;Justinukas;PELIUKAI;4056697803;Taip;0;6;0;6
17987;Justinukas;PELIUKAI;91620507403;Taip;4;0;4;8
17988;Justinukas;PELIUKAI;1956705813;Taip;3;0;2;5
17989;Justinukas;PELIUKAI;99512297006;Taip;8;6;0;14
17990;Justinukas;PELIUKAI;1598234416;Taip;0;7;0;7
17991;Justinukas;PELIUKAI;28095047700;Taip;8;4;0;12
17992;Justinukas;PELIUKAI;1585956968;Taip;3;6;3;12
17993;Justinukas;EŽIUKAI;28543773229;Taip;5;4;0;9
17994;Justinukas;EŽIUKAI;5199005933;Taip;4;5;0;9
17995;Justinukas;EŽIUKAI;59108759161;Taip;11;0;0;11
17996;Justinukas;EŽIUKAI;1955952962;Ne;0;8;0;8
17997;Justinukas;EŽIUKAI;55151392377;Taip;0;6;0;6
17998;Justinukas;EŽIUKAI;1844038414;Taip;10;4;0;14
17999;Justinukas;EŽIUKAI;79934530654;Taip;0;5;0;5
18000;Justinukas;EŽIUKAI;97284171512;Taip;7;0;0;7
18001;Justinukas;EŽIUKAI;1480054888;Taip;15;0;1;16
18002;Justinukas;EŽIUKAI;68853730495;Taip;20;0;0;20
18003;Justinukas;EŽIUKAI;7120661911;Taip;6;5;0;11
18004;Justinukas;EŽIUKAI;70062275466;Taip;0;1;0;1
18005;Justinukas;EŽIUKAI;57621616956;Taip;9;0;0;9
18006;Justinukas;EŽIUKAI;95467011497;Ne;8;4;0;12
18007;Justinukas;EŽIUKAI;311074533;Taip;9;1;0;10
18008;Justinukas;EŽIUKAI;2776259830;Taip;14;0;0;14
18009;Justinukas;EŽIUKAI;54102488427;Taip;9;3;0;12
18010;Justinukas;EŽIUKAI;80827159258;Taip;9;4;0;13
18011;Justinukas;EŽIUKAI;2120659659;Ne;5;3;0;8
18012;Justinukas;EŽIUKAI;48732379120;Ne;0;4;0;4
18013;Justinukas;EŽIUKAI;2952798555;Taip;20;1;0;21
18014;Justinukas;DRUGELIAI;3013789713;Taip;7;5;0;12
18015;Justinukas;DRUGELIAI;5922926572;Taip;0;8;0;8
18016;Justinukas;DRUGELIAI;5876182759;Taip;8;0;0;8
18017;Justinukas;DRUGELIAI;8566530492;Taip;0;5;0;5
18018;Justinukas;DRUGELIAI;9226989209;Taip;12;4;0;16
18019;Justinukas;DRUGELIAI;1341026177;Taip;10;0;0;10
18020;Justinukas;DRUGELIAI;3729297918;Taip;8;4;0;12
18021;Justinukas;DRUGELIAI;3611504027;Taip;6;6;0;12
18022;Justinukas;DRUGELIAI;8650379074;Taip;21;0;0;21
18023;Justinukas;DRUGELIAI;6886461269;Ne;13;0;0;13
18024;Justinukas;DRUGELIAI;2900181358;Taip;12;4;0;16
18025;Justinukas;DRUGELIAI;2268124610;Taip;0;11;0;11
18026;Justinukas;DRUGELIAI;2808141352;Taip;12;9;0;21
18027;Justinukas;DRUGELIAI;5978993456;Taip;21;0;0;21
18028;Justinukas;DRUGELIAI;5870609685;Ne;7;5;0;12
18029;Justinukas;DRUGELIAI;7066065324;Taip;8;0;0;8
18030;Justinukas;DRUGELIAI;8965456115;Taip;5;0;0;5
18031;Justinukas;DRUGELIAI;8874979704;Taip;11;1;0;12
18032;Justinukas;DRUGELIAI;2594906884;Taip;3;0;0;3
18033;Justinukas;DRUGELIAI;3193143474;Taip;13;0;0;13
18034;Justinukas;BITUTĖS;13170636069;Taip;0;10;0;10
18035;Justinukas;BITUTĖS;8741735734;Taip;3;2;0;5
18036;Justinukas;BITUTĖS;7005815238;Taip;2;4;0;6
18037;Justinukas;BITUTĖS;49343952061;Ne;0;4;0;4
18038;Justinukas;BITUTĖS;1830060403;Taip;0;14;0;14
18039;Justinukas;BITUTĖS;9349373645;Ne;0;3;0;3
18040;Justinukas;BITUTĖS;8848775795;Taip;0;3;0;3
18041;Justinukas;BITUTĖS;7678062264;Taip;7;4;0;11
18042;Justinukas;BITUTĖS;93600065957;Taip;2;3;0;5
18043;Justinukas;BITUTĖS;46705419124;Taip;7;4;0;11
18044;Justinukas;BITUTĖS;8529082669;Taip;2;9;0;11
18045;Justinukas;BITUTĖS;1121936989;Taip;1;4;0;5
18046;Justinukas;BITUTĖS;3312575449;Taip;0;4;0;4
18047;Justinukas;BITUTĖS;2160609412;Taip;0;5;0;5
18048;Justinukas;BITUTĖS;9343761295;Taip;3;9;0;12
18049;Justinukas;BITUTĖS;3118698712;Taip;0;7;0;7
18050;Justinukas;BITUTĖS;1773690115;Taip;0;16;0;16
18051;Justinukas;BITUTĖS;2317566323;Taip;2;4;0;6
18052;Justinukas;BITUTĖS;3062444365;Taip;0;4;0;4
18053;Justinukas;BITUTĖS;6597383913;Taip;1;3;0;4
18054;Justinukas;VOVERIUKAI;8603454290;Taip;2;8;0;10
18055;Justinukas;VOVERIUKAI;6482808707;Taip;6;4;0;10
18056;Justinukas;VOVERIUKAI;4756483798;Ne;0;6;1;7
18057;Justinukas;VOVERIUKAI;3206751576;Taip;0;3;0;3
18058;Justinukas;VOVERIUKAI;6470287041;Taip;10;0;0;10
18059;Justinukas;VOVERIUKAI;3268913601;Ne;2;2;0;4
18060;Justinukas;VOVERIUKAI;2017929633;Taip;2;1;0;3
18061;Justinukas;VOVERIUKAI;7710916537;Taip;13;2;0;15
18062;Justinukas;VOVERIUKAI;4194429972;Ne;5;6;0;11
18063;Justinukas;VOVERIUKAI;5928377774;Taip;12;3;0;15
18064;Justinukas;VOVERIUKAI;8913463448;Ne;14;0;0;14
18065;Justinukas;VOVERIUKAI;7727870261;Ne;8;6;0;14
18066;Justinukas;VOVERIUKAI;4698732792;Taip;12;0;3;15
18067;Justinukas;VOVERIUKAI;5524861976;Taip;12;1;2;15
18068;Justinukas;VOVERIUKAI;7854674833;Taip;5;7;0;12
18069;Justinukas;VOVERIUKAI;2585198498;Taip;3;0;0;3
18070;Justinukas;VOVERIUKAI;2160089993;Taip;16;0;0;16
18071;Justinukas;VOVERIUKAI;3768735503;Taip;9;0;0;9
18072;Justinukas;VOVERIUKAI;2241816838;Taip;8;0;0;8
18073;Justinukas;VOVERIUKAI;8086378912;Taip;13;0;0;13
18074;Justinukas;VOVERIUKAI;8878782037;Taip;13;4;0;17
18075;Justinukas;VOVERIUKAI;4271601149;Taip;0;4;0;4
18076;Justinukas;KAČIUKAI;9822696769;Taip;0;11;0;11
18077;Justinukas;KAČIUKAI;34905919221;Taip;0;4;0;4
18078;Justinukas;KAČIUKAI;1627717901;Taip;2;6;0;8
18079;Justinukas;KAČIUKAI;6234625191;Ne;2;6;0;8
18080;Justinukas;KAČIUKAI;752609119;Taip;0;2;0;2
18081;Justinukas;KAČIUKAI;5225263863;Taip;0;21;0;21
18082;Justinukas;KAČIUKAI;6766493175;Taip;7;5;0;12
18083;Justinukas;KAČIUKAI;5494500249;Taip;5;6;0;11
18084;Justinukas;KAČIUKAI;3863971540;Taip;0;4;0;4
18085;Justinukas;KAČIUKAI;43527855441;Taip;0;4;0;4
18086;Justinukas;KAČIUKAI;16029286933;Taip;4;6;0;10
18087;Justinukas;KAČIUKAI;8971898312;Taip;15;6;0;21
18088;Justinukas;KAČIUKAI;48101258124;Taip;9;1;0;10
18089;Justinukas;KAČIUKAI;1216138998;Taip;0;13;0;13
18090;Justinukas;KAČIUKAI;6816901962;Taip;0;10;0;10
18091;Justinukas;KAČIUKAI;7316804839;Ne;0;3;0;3
18092;Justinukas;KAČIUKAI;1814943669;Taip;0;6;0;6
18093;Justinukas;KAČIUKAI;37288931495;Taip;0;1;0;1
18094;Justinukas;KAČIUKAI;3657642693;Taip;4;8;0;12
18095;Justinukas;KAČIUKAI;8636869322;Ne;4;3;0;7
18096;Justinukas;ZUIKUČIAI;3813820356;Taip;14;5;0;19
18097;Justinukas;ZUIKUČIAI;1590855655;Taip;0;4;0;4
18098;Justinukas;ZUIKUČIAI;8350429513;Taip;7;5;0;12
18099;Justinukas;ZUIKUČIAI;49880907488;Taip;0;2;0;2
18100;Justinukas;ZUIKUČIAI;1801800210;Taip;5;4;0;9
18101;Justinukas;ZUIKUČIAI;78270625975;Taip;21;0;0;21
18102;Justinukas;ZUIKUČIAI;1550323727;Taip;0;6;1;7
18103;Justinukas;ZUIKUČIAI;40999006978;Taip;0;3;0;3
18104;Justinukas;ZUIKUČIAI;9411813711;Taip;0;4;3;7
18105;Justinukas;ZUIKUČIAI;2532510817;Taip;0;7;0;7
18106;Justinukas;ZUIKUČIAI;52253951149;Taip;0;5;0;5
18107;Justinukas;ZUIKUČIAI;5215250778;Taip;9;0;0;9
18108;Justinukas;ZUIKUČIAI;76257661228;Taip;0;4;0;4
18109;Justinukas;ZUIKUČIAI;1806484271;Ne;3;4;0;7
18110;Justinukas;ZUIKUČIAI;56402748009;Taip;0;4;0;4
18111;Justinukas;ZUIKUČIAI;29875250126;Taip;0;4;1;5
18112;Justinukas;ZUIKUČIAI;66240994100;Taip;4;4;0;8
18113;Justinukas;ZUIKUČIAI;1967313365;Taip;0;4;3;7
18114;Aidas;Boružėlių;8915901727;Taip;8;1;0;9
18115;Aidas;Boružėlių;5311183877;Taip;16;1;0;17
18116;Aidas;Boružėlių;5962551687;Taip;0;4;0;4
18117;Aidas;Drugelių;5346078886;Taip;3;0;0;3
18118;Aidas;Drugelių;7094228848;Ne;6;0;0;6
18119;Aidas;Drugelių;5560434420;Ne;6;0;0;6
18120;Aidas;Aitvariukų;7842079473;Taip;7;4;0;11
18121;Aidas;Aitvariukų;1505697405;Ne;2;4;0;6
18122;Aidas;Aitvariukų;6835234112;Taip;3;0;0;3
18123;Aidas;Aitvariukų;3473596157;Taip;10;0;0;10
18124;Aidas;Aitvariukų;3748420427;Taip;1;5;0;6
18125;Aidas;"Meškučių kl.";2970002617;Ne;0;4;0;4
18126;Aidas;"Meškučių kl.";8177181962;Ne;8;1;0;9
18127;Aidas;"Meškučių kl.";4980030389;Ne;0;4;0;4
18128;Aidas;"Meškučių kl.";5806540190;Taip;0;4;0;4
18129;Aidas;"Meškučių kl.";7803641933;Ne;0;4;0;4
18130;Aidas;"Meškučių kl.";8056436399;Ne;0;4;0;4
18131;Aidas;"Meškučių kl.";5100740847;Ne;0;4;0;4
18132;Aidas;"Meškučių kl.";8377829773;Ne;0;4;0;4
18133;Aidas;"Meškučių kl.";4367406525;Taip;1;0;0;1
18134;Aidas;"Gaidelių kl.";3442250711;Ne;7;4;0;11
18135;Aidas;"Gaidelių kl.";6213577188;Ne;6;4;0;10
18136;Aidas;"Gaidelių kl.";2446003793;Ne;1;4;0;5
18137;Aidas;"Gaidelių kl.";7740504510;Ne;0;4;0;4
18138;Aidas;"Gaidelių kl.";9057435844;Ne;13;0;0;13
18139;Aidas;"Gaidelių kl.";2681438925;Ne;0;4;0;4
18140;Aidas;"Gaidelių kl.";2234931428;Ne;0;21;0;21
18141;Aidas;"Kiškelių kl";5388697695;Ne;0;4;0;4
18142;Aidas;"Kiškelių kl";7354905114;Ne;5;4;0;9
18143;Aidas;"Kiškelių kl";6868265902;Ne;0;4;0;4
18144;Aidas;"Kiškelių kl";4738867530;Taip;0;4;0;4
18145;Aidas;"Kiškelių kl";5905008395;Ne;0;4;0;4
18146;Aidas;"Kiškelių kl";9613466086;Taip;8;4;0;12
18147;Aidas;"Ančiukų kl.";9816043688;Ne;10;9;0;19
18148;Aidas;"Ančiukų kl.";20604410476;Ne;0;5;0;5
18149;Aidas;"Ančiukų kl.";63508565206;Ne;0;2;0;2
18150;Aidas;"Ančiukų kl.";1079077463;Taip;3;4;0;7
18151;Aidas;"Ančiukų kl.";3194974747;Ne;0;4;0;4
18152;Aidas;"Ančiukų kl.";72751441075;Taip;15;4;0;19
18153;Aidas;"Ančiukų kl.";2000234311;Taip;7;0;0;7
18154;Aidas;"Ančiukų kl.";3366848846;Taip;16;4;0;20
18155;Aidas;"Ančiukų kl.";17920063762;Taip;3;4;0;7
18156;Aidas;"Ančiukų kl.";2954393415;Taip;12;4;0;16
18157;Aidas;"Pelėdžiukų kl.";5326012529;Ne;0;4;0;4
18158;Aidas;"Pelėdžiukų kl.";5655286565;Ne;0;4;0;4
18159;Aidas;"Pelėdžiukų kl.";3279914631;Ne;12;4;0;16
18160;Aidas;"Pelėdžiukų kl.";7148658584;Ne;0;4;0;4
18161;Aidas;"Pelėdžiukų kl.";2945444897;Taip;1;4;0;5
18162;Aidas;"Papūgėlių kl.";3447250754;Ne;0;3;0;3
18163;Aidas;"Papūgėlių kl.";3352587395;Ne;7;4;0;11
18164;Aidas;"Papūgėlių kl.";4372628947;Ne;7;0;0;7
18165;Aidas;"Papūgėlių kl.";5570772793;Taip;8;0;0;8
18166;Aidas;"Papūgėlių kl.";7821044288;Ne;5;4;0;9
18167;Aidas;"Papūgėlių kl.";1010885560;Ne;0;4;0;4
18168;Aidas;"Papūgėlių kl.";1322335360;Taip;0;4;0;4
18169;Aidas;"Papūgėlių kl.";3808707012;Ne;0;4;0;4
18170;Aidas;"Papūgėlių kl.";8642665550;Ne;1;4;0;5
18171;Aidas;"Papūgėlių kl.";5309862220;Taip;4;4;0;8
18172;Aidas;"Saulutės kl.";1535004699;Ne;11;4;0;15
18173;Aidas;"Saulutės kl.";62142659591;Ne;0;4;0;4
18174;Aidas;"Saulutės kl.";74897451962;Taip;3;4;0;7
18175;Aidas;"Saulutės kl.";4890362155;Taip;1;4;0;5
18176;Aidas;"Saulutės kl.";6778658540;Taip;1;4;0;5
18177;Aidas;"Saulutės kl.";7329254454;Taip;0;1;0;1
18178;Aidas;"Saulutės kl.";88721781220;Ne;8;0;0;8
18179;Aidas;"Saulutės kl.";3127870635;Taip;4;1;0;5
18180;Aidas;"Saulutės kl.";1999375828;Taip;11;6;0;17
18181;Aidas;"Katinėlių kl.";6356218442;Ne;3;4;0;7
18182;Aidas;"Katinėlių kl.";4990112920;Taip;1;4;0;5
18183;Aidas;"Katinėlių kl.";92425322676;Ne;4;4;0;8
18184;Aidas;"Katinėlių kl.";4081645294;Ne;0;4;0;4
18185;Aidas;"Katinėlių kl.";81654551230;Taip;2;4;0;6
18186;Aidas;"Katinėlių kl.";9944901942;Ne;3;4;0;7
18187;Bangelė;Aštuonkojai;1953702121;Taip;4;0;1;5
18188;Bangelė;Aštuonkojai;22773040549;Ne;0;0;3;3
18189;Bangelė;Aštuonkojai;1377575533;Taip;0;4;2;6
18190;Bangelė;Aštuonkojai;7059603451;Taip;0;6;0;6
18191;Bangelė;Aštuonkojai;4342844311;Taip;0;1;0;1
18192;Bangelė;Aštuonkojai;2045465669;Taip;0;13;1;14
18193;Bangelė;Aštuonkojai;5142785037;Taip;0;3;0;3
18194;Bangelė;Aštuonkojai;4865289474;Taip;10;6;0;16
18195;Bangelė;Aštuonkojai;5135762163;Taip;0;0;10;10
18196;Bangelė;Aštuonkojai;6559186441;Taip;14;4;1;19
18197;Bangelė;Aštuonkojai;1053744221;Taip;0;0;1;1
18198;Bangelė;Aštuonkojai;95548866362;Ne;0;15;0;15
18199;Bangelė;Aštuonkojai;7263228478;Taip;0;0;3;3
18200;Bangelė;Aštuonkojai;4187165474;Taip;7;0;1;8
18201;Bangelė;Aštuonkojai;1594486275;Taip;0;4;0;4
18202;Bangelė;Aštuonkojai;6508452044;Taip;0;2;0;2
18203;Bangelė;Aštuonkojai;6739499483;Taip;0;0;7;7
18204;Bangelė;Delfinukai,;2503946448;Taip;6;8;0;14
18205;Bangelė;Delfinukai,;2027892816;Taip;6;0;0;6
18206;Bangelė;Delfinukai,;3338203753;Taip;6;0;1;7
18207;Bangelė;Delfinukai,;9150185864;Taip;14;0;0;14
18208;Bangelė;Delfinukai,;1661384764;Ne;11;0;2;13
18209;Bangelė;Delfinukai,;9341038058;Taip;0;10;0;10
18210;Bangelė;Delfinukai,;6173470021;Taip;13;0;0;13
18211;Bangelė;Delfinukai,;1447396084;Taip;0;4;1;5
18212;Bangelė;Delfinukai,;1728085772;Taip;10;0;1;11
18213;Bangelė;Delfinukai,;55668308050;Taip;0;14;1;15
18214;Bangelė;Delfinukai,;1032881464;Ne;21;0;0;21
18215;Bangelė;Delfinukai,;5950451237;Taip;0;18;0;18
18216;Bangelė;Delfinukai,;1377734102;Taip;3;3;6;12
18217;Bangelė;Delfinukai,;5504180016;Taip;8;0;2;10
18218;Bangelė;Delfinukai,;6927540308;Taip;6;0;0;6
18219;Bangelė;Delfinukai,;4122927034;Ne;1;0;0;1
18220;Bangelė;Delfinukai,;4401389067;Ne;0;6;0;6
18221;Bangelė;Delfinukai,;9464115339;Taip;0;21;0;21
18222;Bangelė;Delfinukai,;9397947662;Taip;21;0;0;21
18223;Bangelė;Delfinukai,;5034268767;Taip;0;13;0;13
18224;Bangelė;Delfinukai,;6026399355;Taip;5;2;1;8
18225;Bangelė;"Saulės spindulėliai";81379253837;Ne;6;2;1;9
18226;Bangelė;"Saulės spindulėliai";20827674346;Taip;0;8;0;8
18227;Bangelė;"Saulės spindulėliai";83691968186;Taip;0;12;0;12
18228;Bangelė;"Saulės spindulėliai";76618850202;Taip;0;8;0;8
18229;Bangelė;"Saulės spindulėliai";84855013193;Taip;5;0;0;5
18230;Bangelė;"Saulės spindulėliai";51571795638;Ne;0;4;2;6
18231;Bangelė;"Saulės spindulėliai";68082711504;Taip;0;4;0;4
18232;Bangelė;"Saulės spindulėliai";18979714088;Taip;0;6;0;6
18233;Bangelė;"Saulės spindulėliai";89458174517;Taip;0;4;0;4
18234;Bangelė;"Saulės spindulėliai";70270153561;Ne;0;5;3;8
18235;Bangelė;"Saulės spindulėliai";24895047229;Taip;5;4;0;9
18236;Bangelė;"Saulės spindulėliai";1593861817;Taip;0;5;0;5
18237;Bangelė;"Saulės spindulėliai";45145282759;Ne;6;4;1;11
18238;Bangelė;"Saulės spindulėliai";2067377559;Taip;6;8;0;14
18239;Bangelė;"Saulės spindulėliai";1312545465;Taip;4;3;0;7
18240;Bangelė;"Saulės spindulėliai";8280327053;Ne;0;4;7;11
18241;Bangelė;"Saulės spindulėliai";1862514267;Taip;0;10;0;10
18242;Bangelė;"Saulės spindulėliai";61812452736;Taip;0;1;0;1
18243;Bangelė;"Pingvinukai ";1390623903;Taip;0;5;0;5
18244;Bangelė;"Pingvinukai ";6145050734;Taip;0;3;1;4
18245;Bangelė;"Pingvinukai ";3634678954;Taip;0;4;1;5
18246;Bangelė;"Pingvinukai ";2156837975;Taip;9;0;0;9
18247;Bangelė;"Pingvinukai ";3063439996;Ne;2;10;0;12
18248;Bangelė;"Pingvinukai ";6953698592;Taip;9;0;1;10
18249;Bangelė;"Pingvinukai ";1754002501;Taip;0;0;1;1
18250;Bangelė;"Pingvinukai ";1351714626;Taip;4;0;7;11
18251;Bangelė;"Pingvinukai ";8336001702;Ne;0;15;0;15
18252;Bangelė;"Pingvinukai ";5546256869;Taip;0;5;0;5
18253;Bangelė;"Pingvinukai ";8748218387;Ne;16;0;2;18
18254;Bangelė;"Pingvinukai ";6980232224;Ne;0;4;5;9
18255;Bangelė;"Pingvinukai ";8875703109;Taip;0;8;0;8
18256;Bangelė;"Pingvinukai ";9842873660;Ne;8;0;2;10
18257;Bangelė;"Pingvinukai ";3696611509;Taip;0;0;9;9
18258;Bangelė;"Pingvinukai ";3022508446;Taip;6;0;4;10
18259;Bangelė;"Pingvinukai ";9788923823;Taip;13;5;0;18
18260;Bangelė;"Pingvinukai ";6091573086;Taip;12;5;0;17
18261;Bangelė;"Pingvinukai ";7136625230;Taip;0;7;0;7
18262;Bangelė;"Jūros žvaigždutės ";6861123988;Taip;12;2;0;14
18263;Bangelė;"Jūros žvaigždutės ";2658414287;Ne;15;0;0;15
18264;Bangelė;"Jūros žvaigždutės ";3900236858;Taip;0;1;0;1
18265;Bangelė;"Jūros žvaigždutės ";8758933649;Taip;0;4;5;9
18266;Bangelė;"Jūros žvaigždutės ";9041585534;Taip;16;2;0;18
18267;Bangelė;"Jūros žvaigždutės ";4338067260;Taip;0;6;0;6
18268;Bangelė;"Jūros žvaigždutės ";4412780063;Taip;0;0;9;9
18269;Bangelė;"Jūros žvaigždutės ";9009809585;Ne;0;4;2;6
18270;Bangelė;"Jūros žvaigždutės ";6044653707;Taip;0;1;0;1
18271;Bangelė;"Jūros žvaigždutės ";1915827035;Taip;0;1;0;1
18272;Bangelė;"Jūros žvaigždutės ";7685394517;Taip;7;0;0;7
18273;Bangelė;"Jūros žvaigždutės ";9706351115;Taip;0;1;0;1
18274;Bangelė;"Jūros žvaigždutės ";6693019825;Taip;0;5;0;5
18275;Bangelė;"Jūros žvaigždutės ";3991021350;Taip;0;0;10;10
18276;Bangelė;"Jūros žvaigždutės ";3990966706;Taip;9;7;0;16
18277;Bangelė;"Jūros žvaigždutės ";2764009011;Taip;7;0;0;7
18278;Bangelė;"Jūros žvaigždutės ";8799415648;Taip;0;0;17;17
18279;Bangelė;"Jūros žvaigždutės ";7230987338;Taip;10;4;0;14
18280;Bangelė;"Jūros žvaigždutės ";7337449523;Taip;7;0;2;9
18281;Bangelė;"Jūros žvaigždutės ";8316505307;Taip;0;0;3;3
18282;Bangelė;Žuvytės;9983202427;Ne;10;4;4;18
18283;Bangelė;Žuvytės;47454787439;Taip;5;0;2;7
18284;Bangelė;Žuvytės;2112394008;Taip;0;4;2;6
18285;Bangelė;Žuvytės;8836861853;Taip;0;2;0;2
18286;Bangelė;Žuvytės;6712145066;Taip;6;0;0;6
18287;Bangelė;Žuvytės;1528387105;Taip;2;4;0;6
18288;Bangelė;Žuvytės;4506651162;Taip;10;4;0;14
18289;Bangelė;Žuvytės;9672505885;Taip;0;0;9;9
18290;Bangelė;Žuvytės;7248631013;Taip;4;4;0;8
18291;Bangelė;Žuvytės;7723290276;Taip;4;3;0;7
18292;Bangelė;Žuvytės;9822287576;Taip;0;14;2;16
18293;Bangelė;Žuvytės;7375004714;Ne;0;4;1;5
18294;Bangelė;Žuvytės;7701956270;Taip;0;4;7;11
18295;Bangelė;Žuvytės;1367082230;Taip;0;4;0;4
18296;Bangelė;Žuvytės;1348995498;Ne;7;6;0;13
18297;Bangelė;Žuvytės;2017886238;Taip;11;0;0;11
18298;Bangelė;Ruoniai;76353372848;Taip;0;2;3;5
18299;Bangelė;Ruoniai;99771696381;Taip;0;1;0;1
18300;Bangelė;Ruoniai;17608442103;Taip;0;11;0;11
18301;Bangelė;Ruoniai;60823401986;Taip;0;4;0;4
18302;Bangelė;Ruoniai;1189143700;Taip;0;1;0;1
18303;Bangelė;Ruoniai;84797019693;Ne;0;10;0;10
18304;Bangelė;Ruoniai;91953522637;Taip;0;2;2;4
18305;Bangelė;Ruoniai;99823581960;Taip;0;9;0;9
18306;Bangelė;Ruoniai;2423625777;Taip;0;14;0;14
18307;Bangelė;Ruoniai;1823592268;Taip;0;4;2;6
18308;Bangelė;Ruoniai;77615973000;Taip;0;4;0;4
18309;Bangelė;Ruoniai;411039166;Taip;0;8;0;8
18310;Bangelė;Ruoniai;3115177810;Ne;15;0;4;19
18311;Bangelė;Ruoniai;1790881495;Taip;0;5;0;5
18312;Bangelė;Ruoniai;1683377649;Taip;0;7;0;7
18313;Bangelė;Ruoniai;7114709352;Taip;7;3;0;10
18314;Bangelė;Ruoniai;5159962168;Taip;11;6;0;17
18315;Bangelė;Ruoniai;1766156349;Taip;0;4;1;5
18316;Bangelė;Ruoniai;1065164865;Taip;0;0;7;7
18317;Bangelė;Ruoniai;2195543161;Ne;0;4;0;4
18318;Bangelė;Ruoniai;42739113312;Ne;0;0;2;2
18319;Bangelė;Ruoniai;3961043533;Taip;2;0;0;2
18320;Bangelė;"Pagrandukai ";4250589212;Taip;19;0;0;19
18321;Bangelė;"Pagrandukai ";4222017733;Taip;21;0;0;21
18322;Bangelė;"Pagrandukai ";4036461205;Taip;0;1;0;1
18323;Bangelė;"Pagrandukai ";7434358474;Taip;0;16;0;16
18324;Bangelė;"Pagrandukai ";6216334243;Taip;0;0;2;2
18325;Bangelė;"Pagrandukai ";7434879947;Taip;7;0;0;7
18326;Bangelė;"Pagrandukai ";2491928697;Taip;14;1;0;15
18327;Bangelė;"Pagrandukai ";6819322060;Taip;8;0;2;10
18328;Bangelė;"Pagrandukai ";9790680407;Taip;7;0;3;10
18329;Bangelė;"Pagrandukai ";8535477233;Taip;8;0;6;14
18330;Bangelė;"Pagrandukai ";8575020060;Taip;6;0;0;6
18331;Bangelė;"Pagrandukai ";5747403413;Ne;0;5;0;5
18332;Bangelė;"Pagrandukai ";5994720767;Taip;8;0;0;8
18333;Bangelė;"Pagrandukai ";6480681705;Taip;4;5;0;9
18334;Bangelė;"Zuikučiai ";1895213200;Taip;6;0;0;6
18335;Bangelė;"Zuikučiai ";9954762483;Taip;16;0;0;16
18336;Bangelė;"Zuikučiai ";5597329949;Taip;16;4;0;20
18337;Bangelė;"Zuikučiai ";4494049529;Taip;0;0;1;1
18338;Bangelė;"Zuikučiai ";1898671487;Taip;7;0;0;7
18339;Bangelė;"Zuikučiai ";9268294844;Taip;0;0;3;3
18340;Bangelė;"Zuikučiai ";9980881014;Taip;0;0;5;5
18341;Bangelė;"Zuikučiai ";4532810332;Taip;4;0;3;7
18342;Bangelė;"Zuikučiai ";2946714377;Taip;12;0;1;13
18343;Bangelė;"Zuikučiai ";3016778137;Taip;7;0;0;7
18344;Bangelė;"Zuikučiai ";8734511431;Taip;12;0;0;12
18345;Bangelė;"Zuikučiai ";3334029244;Taip;5;0;4;9
18346;Bangelė;"Zuikučiai ";7174742281;Taip;17;2;0;19
18347;Bangelė;"Zuikučiai ";6514406042;Ne;21;0;0;21
18348;Bangelė;"Zuikučiai ";6806911810;Taip;12;4;0;16
18349;Gėlynas;PAKALNUTĖ;6375754699;Taip;3;0;3;6
18350;Gėlynas;PAKALNUTĖ;2349352560;Taip;1;0;2;3
18351;Gėlynas;PAKALNUTĖ;4445250490;Taip;1;0;0;1
18352;Gėlynas;PAKALNUTĖ;1897547388;Taip;0;5;0;5
18353;Gėlynas;PAKALNUTĖ;9911225363;Taip;0;4;0;4
18354;Gėlynas;PAKALNUTĖ;2400929266;Taip;0;4;0;4
18355;Gėlynas;PAKALNUTĖ;1257113113;Taip;0;0;1;1
18356;Gėlynas;PAKALNUTĖ;6898127005;Ne;0;2;0;2
18357;Gėlynas;PAKALNUTĖ;2906909558;Taip;12;0;1;13
18358;Gėlynas;PAKALNUTĖ;3365442661;Taip;15;0;0;15
18359;Gėlynas;PAKALNUTĖ;77283628988;Ne;12;5;0;17
18360;Gėlynas;PAKALNUTĖ;6528464599;Taip;0;0;6;6
18361;Gėlynas;PAKALNUTĖ;8464074679;Taip;0;1;1;2
18362;Gėlynas;PAKALNUTĖ;5395474698;Taip;0;6;0;6
18363;Gėlynas;PAKALNUTĖ;90046802421;Taip;4;10;0;14
18364;Gėlynas;PAKALNUTĖ;8615943743;Taip;0;5;0;5
18365;Gėlynas;PAKALNUTĖ;7814357385;Taip;0;4;1;5
18366;Gėlynas;PAKALNUTĖ;1674569569;Taip;0;2;0;2
18367;Gėlynas;PAKALNUTĖ;5695333666;Taip;7;4;0;11
18368;Gėlynas;PAKALNUTĖ;2348787949;Taip;12;1;0;13
18369;Gėlynas;VARPELIS;72991081966;Taip;0;3;0;3
18370;Gėlynas;VARPELIS;14307514975;Taip;0;3;0;3
18371;Gėlynas;VARPELIS;72544014665;Taip;3;4;3;10
18372;Gėlynas;VARPELIS;93919808581;Taip;2;6;0;8
18373;Gėlynas;VARPELIS;31532261756;Taip;0;9;0;9
18374;Gėlynas;VARPELIS;7735904549;Ne;7;4;2;13
18375;Gėlynas;VARPELIS;99637531213;Taip;0;1;0;1
18376;Gėlynas;VARPELIS;85912494214;Taip;0;11;0;11
18377;Gėlynas;VARPELIS;22067595840;Taip;10;4;0;14
18378;Gėlynas;VARPELIS;75827864070;Taip;0;7;0;7
18379;Gėlynas;VARPELIS;91530210644;Ne;5;4;4;13
18380;Gėlynas;VARPELIS;75222833700;Taip;0;10;0;10
18381;Gėlynas;VARPELIS;95681874019;Taip;0;5;0;5
18382;Gėlynas;VARPELIS;40702362906;Taip;0;6;0;6
18383;Gėlynas;VARPELIS;1406567756;Taip;0;12;0;12
18384;Gėlynas;VARPELIS;58542813068;Ne;0;4;1;5
18385;Gėlynas;VARPELIS;63379609794;Taip;0;4;4;8
18386;Gėlynas;VARPELIS;2100188574;Taip;0;18;0;18
18387;Gėlynas;RAKTAŽOLĖ;1797681067;Taip;0;4;0;4
18388;Gėlynas;RAKTAŽOLĖ;1117528954;Taip;0;14;0;14
18389;Gėlynas;RAKTAŽOLĖ;57429063547;Taip;6;10;0;16
18390;Gėlynas;RAKTAŽOLĖ;6264361257;Ne;13;1;0;14
18391;Gėlynas;RAKTAŽOLĖ;1047462165;Taip;0;12;0;12
18392;Gėlynas;RAKTAŽOLĖ;1754734306;Ne;0;12;0;12
18393;Gėlynas;RAKTAŽOLĖ;9780911032;Taip;0;2;0;2
18394;Gėlynas;RAKTAŽOLĖ;84546885977;Ne;0;13;0;13
18395;Gėlynas;RAKTAŽOLĖ;5135747448;Taip;0;9;0;9
18396;Gėlynas;RAKTAŽOLĖ;7808971151;Taip;0;17;0;17
18397;Gėlynas;RAKTAŽOLĖ;1036951275;Ne;0;6;0;6
18398;Gėlynas;RAKTAŽOLĖ;7337987259;Taip;0;3;1;4
18399;Gėlynas;RAKTAŽOLĖ;9026298982;Ne;0;7;0;7
18400;Gėlynas;RAKTAŽOLĖ;4382465307;Taip;2;11;0;13
18401;Gėlynas;RAKTAŽOLĖ;3890687425;Taip;0;1;0;1
18402;Gėlynas;RAKTAŽOLĖ;7562201835;Taip;9;3;0;12
18403;Gėlynas;RAKTAŽOLĖ;3572020585;Taip;0;1;0;1
18404;Gėlynas;RAKTAŽOLĖ;1557503831;Taip;0;0;2;2
18405;Gėlynas;RAKTAŽOLĖ;2417880374;Taip;0;0;2;2
18406;Gėlynas;RAKTAŽOLĖ;3491517766;Ne;10;0;0;10
18407;Gėlynas;SAULĖGRĄŽA;1995694892;Taip;0;0;2;2
18408;Gėlynas;SAULĖGRĄŽA;1191494598;Taip;0;0;11;11
18409;Gėlynas;SAULĖGRĄŽA;1407350449;Taip;4;0;0;4
18410;Gėlynas;SAULĖGRĄŽA;1676904275;Taip;7;4;0;11
18411;Gėlynas;SAULĖGRĄŽA;2050384850;Taip;0;1;0;1
18412;Gėlynas;SAULĖGRĄŽA;85310323038;Taip;0;2;0;2
18413;Gėlynas;SAULĖGRĄŽA;47220216751;Taip;0;5;0;5
18414;Gėlynas;SAULĖGRĄŽA;2099722437;Taip;0;4;1;5
18415;Gėlynas;SAULĖGRĄŽA;86881175896;Taip;10;0;0;10
18416;Gėlynas;SAULĖGRĄŽA;1053422007;Taip;0;1;0;1
18417;Gėlynas;SAULĖGRĄŽA;1608626732;Taip;5;7;0;12
18418;Gėlynas;SAULĖGRĄŽA;44391516295;Taip;0;0;2;2
18419;Gėlynas;SAULĖGRĄŽA;17587435701;Taip;0;4;0;4
18420;Gėlynas;SAULĖGRĄŽA;1363040744;Taip;0;2;1;3
18421;Gėlynas;SAULĖGRĄŽA;2018911523;Taip;0;4;8;12
18422;Gėlynas;SAULĖGRĄŽA;1431418368;Taip;0;4;0;4
18423;Gėlynas;SAULĖGRĄŽA;1881249769;Taip;0;4;0;4
18424;Gėlynas;SAULĖGRĄŽA;15277524754;Taip;0;0;4;4
18425;Gėlynas;SAULĖGRĄŽA;8324564359;Taip;4;2;0;6
18426;Gėlynas;RAMUNĖLĖ;6451922757;Taip;9;0;0;9
18427;Gėlynas;RAMUNĖLĖ;3549079170;Taip;8;0;4;12
18428;Gėlynas;RAMUNĖLĖ;4983822000;Taip;3;0;1;4
18429;Gėlynas;RAMUNĖLĖ;5898582218;Taip;5;1;0;6
18430;Gėlynas;RAMUNĖLĖ;2742456983;Taip;7;0;0;7
18431;Gėlynas;RAMUNĖLĖ;5124029118;Taip;9;8;0;17
18432;Gėlynas;RAMUNĖLĖ;6815740588;Ne;6;3;0;9
18433;Gėlynas;RAMUNĖLĖ;5541707540;Ne;4;0;0;4
18434;Gėlynas;RAMUNĖLĖ;5964419627;Taip;0;6;0;6
18435;Gėlynas;RAMUNĖLĖ;4824667762;Taip;3;5;0;8
18436;Gėlynas;RAMUNĖLĖ;2141722631;Taip;7;4;0;11
18437;Gėlynas;RAMUNĖLĖ;1505666690;Taip;2;0;4;6
18438;Gėlynas;RAMUNĖLĖ;3492361041;Taip;7;0;3;10
18439;Gėlynas;RAMUNĖLĖ;4505012978;Taip;0;10;0;10
18440;Gėlynas;RAMUNĖLĖ;3606076029;Taip;6;11;0;17
18441;Gėlynas;ŽIBUTĖ;1015554617;Taip;4;0;1;5
18442;Gėlynas;ŽIBUTĖ;9724668402;Taip;1;3;0;4
18443;Gėlynas;ŽIBUTĖ;1822933936;Taip;10;0;0;10
18444;Gėlynas;ŽIBUTĖ;8999346908;Taip;4;9;0;13
18445;Gėlynas;ŽIBUTĖ;6114995335;Taip;15;0;0;15
18446;Gėlynas;ŽIBUTĖ;7998013477;Ne;12;0;0;12
18447;Gėlynas;ŽIBUTĖ;9330385153;Taip;5;0;6;11
18448;Gėlynas;ŽIBUTĖ;2784709117;Taip;4;0;0;4
18449;Gėlynas;ŽIBUTĖ;9462822190;Ne;8;0;0;8
18450;Gėlynas;ŽIBUTĖ;9508507084;Taip;0;20;0;20
18451;Gėlynas;ŽIBUTĖ;5291444399;Ne;4;7;0;11
18452;Gėlynas;ŽIBUTĖ;9252696260;Taip;5;0;0;5
18453;Obelėlė;Bildukai;43664898514;Taip;11;0;0;11
18454;Obelėlė;Bildukai;58388471530;Taip;0;6;2;8
18455;Obelėlė;Bildukai;34628612328;Taip;4;4;1;9
18456;Obelėlė;Bildukai;2024391462;Taip;7;4;0;11
18457;Obelėlė;Bildukai;75737109657;Taip;6;0;2;8
18458;Obelėlė;Bildukai;1466324860;Taip;0;4;0;4
18459;Obelėlė;Bildukai;52857531341;Taip;0;8;0;8
18460;Obelėlė;Bildukai;68222818886;Ne;0;4;3;7
18461;Obelėlė;Bildukai;1831642058;Taip;0;8;0;8
18462;Obelėlė;Bildukai;13913516066;Taip;3;4;0;7
18463;Obelėlė;Bildukai;50077685481;Taip;0;3;0;3
18464;Obelėlė;Bildukai;14986936220;Taip;7;4;1;12
18465;Obelėlė;Bildukai;88058597079;Taip;0;4;0;4
18466;Obelėlė;Bildukai;22986329944;Ne;0;4;2;6
18467;Obelėlė;Bildukai;29677456066;Taip;2;1;1;4
18468;Obelėlė;Bildukai;646883449;Taip;0;4;1;5
18469;Obelėlė;Bildukai;89380447507;Taip;0;4;0;4
18470;Obelėlė;Bildukai;65936525141;Taip;0;6;0;6
18471;Obelėlė;Bildukai;19376935875;Taip;0;1;0;1
18472;Obelėlė;Gudručiai;2014314139;Taip;14;0;0;14
18473;Obelėlė;Gudručiai;9900484892;Taip;6;5;1;12
18474;Obelėlė;Gudručiai;6145113624;Taip;10;0;0;10
18475;Obelėlė;Gudručiai;9586720282;Taip;7;4;0;11
18476;Obelėlė;Gudručiai;9567704282;Taip;14;0;0;14
18477;Obelėlė;Gudručiai;9305279614;Ne;12;0;0;12
18478;Obelėlė;Gudručiai;4015702815;Taip;7;4;0;11
18479;Obelėlė;Gudručiai;4309139638;Taip;10;0;0;10
18480;Obelėlė;Gudručiai;5141585309;Taip;7;0;0;7
18481;Obelėlė;Gudručiai;9736557012;Taip;2;4;2;8
18482;Obelėlė;Gudručiai;6720058972;Taip;8;3;0;11
18483;Obelėlė;Gudručiai;4451814487;Taip;16;0;0;16
18484;Obelėlė;Gudručiai;2053807216;Taip;21;0;0;21
18485;Obelėlė;Gudručiai;2204293216;Taip;0;21;0;21
18486;Obelėlė;Gudručiai;1184082097;Taip;17;0;0;17
18487;Obelėlė;Gudručiai;6466755394;Taip;10;6;0;16
18488;Obelėlė;Gudručiai;2533715287;Taip;8;0;0;8
18489;Obelėlė;Gudručiai;1312484983;Taip;12;0;1;13
18490;Obelėlė;Gudručiai;1565630870;Taip;5;4;0;9
18491;Obelėlė;Gudručiai;1598785483;Taip;16;0;0;16
18492;Obelėlė;Drugeliai;5960204860;Taip;7;5;0;12
18493;Obelėlė;Drugeliai;1874574001;Taip;0;0;2;2
18494;Obelėlė;Drugeliai;1271351257;Taip;0;12;0;12
18495;Obelėlė;Drugeliai;1980250599;Taip;4;0;5;9
18496;Obelėlė;Drugeliai;1185247095;Taip;2;3;2;7
18497;Obelėlė;Drugeliai;4111486929;Taip;7;0;0;7
18498;Obelėlė;Drugeliai;8115772385;Taip;4;0;2;6
18499;Obelėlė;Drugeliai;2018689468;Taip;0;0;3;3
18500;Obelėlė;Drugeliai;7120041402;Taip;0;0;2;2
18501;Obelėlė;Drugeliai;9059791812;Taip;0;8;0;8
18502;Obelėlė;Drugeliai;4835765774;Taip;0;4;4;8
18503;Obelėlė;Drugeliai;8173154620;Taip;0;2;2;4
18504;Obelėlė;Drugeliai;46597815116;Taip;0;0;3;3
18505;Obelėlė;Drugeliai;65578250853;Taip;11;0;2;13
18506;Obelėlė;Drugeliai;1044733634;Taip;0;4;3;7
18507;Obelėlė;Drugeliai;1847501295;Taip;6;0;0;6
18508;Obelėlė;Drugeliai;6006139132;Taip;0;0;4;4
18509;Obelėlė;Drugeliai;6676145522;Taip;0;4;0;4
18510;Obelėlė;Drugeliai;6693601673;Taip;15;0;0;15
18511;Obelėlė;Pasakaitė;1695933896;Taip;14;0;0;14
18512;Obelėlė;Pasakaitė;1833543299;Taip;5;5;0;10
18513;Obelėlė;Pasakaitė;1555780072;Taip;5;0;1;6
18514;Obelėlė;Pasakaitė;77743243622;Taip;3;1;0;4
18515;Obelėlė;Pasakaitė;1543298097;Taip;3;4;0;7
18516;Obelėlė;Pasakaitė;79601449969;Ne;17;0;0;17
18517;Obelėlė;Pasakaitė;3330983614;Taip;5;4;2;11
18518;Obelėlė;Pasakaitė;4257479486;Taip;2;0;8;10
18519;Obelėlė;Pasakaitė;8394566707;Taip;0;4;3;7
18520;Obelėlė;Pasakaitė;9527363918;Taip;0;0;2;2
18521;Obelėlė;Pasakaitė;10939948244;Taip;0;0;2;2
18522;Obelėlė;Pasakaitė;1707652145;Taip;8;4;0;12
18523;Obelėlė;Pasakaitė;6789881144;Taip;0;4;0;4
18524;Obelėlė;Pasakaitė;6253266504;Taip;5;0;0;5
18525;Obelėlė;Pasakaitė;9934596750;Taip;2;0;0;2
18526;Obelėlė;Pasakaitė;6036130112;Taip;6;0;2;8
18527;Obelėlė;Pasakaitė;1893470952;Taip;0;0;2;2
18528;Obelėlė;Pasakaitė;7754276632;Taip;0;21;0;21
18529;Obelėlė;Svajokliai;7647724926;Taip;5;4;2;11
18530;Obelėlė;Svajokliai;2093164210;Taip;5;4;1;10
18531;Obelėlė;Svajokliai;8202131299;Ne;2;4;10;16
18532;Obelėlė;Svajokliai;58153232854;Taip;12;4;0;16
18533;Obelėlė;Svajokliai;57788788343;Taip;0;4;2;6
18534;Obelėlė;Svajokliai;2014450377;Taip;0;4;3;7
18535;Obelėlė;Svajokliai;5512990125;Taip;0;4;3;7
18536;Obelėlė;Svajokliai;1824412493;Taip;5;11;0;16
18537;Obelėlė;Svajokliai;2105005710;Taip;5;0;0;5
18538;Obelėlė;Svajokliai;31721462678;Taip;2;4;1;7
18539;Obelėlė;Svajokliai;52277220462;Ne;5;4;3;12
18540;Obelėlė;Svajokliai;1210385417;Taip;0;18;0;18
18541;Obelėlė;Svajokliai;8904956649;Ne;0;4;7;11
18542;Obelėlė;Svajokliai;82119081040;Taip;0;4;3;7
18543;Obelėlė;Svajokliai;1670594471;Ne;0;8;0;8
18544;Obelėlė;Svajokliai;1536889615;Taip;6;4;0;10
18545;Obelėlė;Svajokliai;1484822838;Taip;10;4;1;15
18546;Obelėlė;Smalsučiai;43103357250;Ne;5;4;0;9
18547;Obelėlė;Smalsučiai;6347375324;Taip;2;0;0;2
18548;Obelėlė;Smalsučiai;1337679766;Taip;0;4;3;7
18549;Obelėlė;Smalsučiai;2107924334;Taip;0;4;1;5
18550;Obelėlė;Smalsučiai;75387550210;Taip;4;0;0;4
18551;Obelėlė;Smalsučiai;72224972200;Taip;0;11;0;11
18552;Obelėlė;Smalsučiai;1844067391;Taip;0;0;1;1
18553;Obelėlė;Smalsučiai;72467035839;Taip;0;4;0;4
18554;Obelėlė;Smalsučiai;3220190193;Ne;9;4;3;16
18555;Obelėlė;Smalsučiai;39757539751;Taip;0;1;0;1
18556;Obelėlė;Smalsučiai;20691217408;Taip;0;4;0;4
18557;Obelėlė;Smalsučiai;35495444231;Ne;0;4;8;12
18558;Obelėlė;Smalsučiai;97298049429;Taip;0;4;5;9
18559;Obelėlė;Smalsučiai;68776273648;Taip;0;4;1;5
18560;Obelėlė;Smalsučiai;2605865270;Taip;0;2;2;4
18561;Obelėlė;Smalsučiai;1915402358;Taip;3;0;0;3
18562;Obelėlė;Smalsučiai;1758206243;Taip;0;4;5;9
18563;Obelėlė;Smalsučiai;78242377913;Taip;2;4;0;6
18564;Obelėlė;Pabiručiai;1586544097;Taip;1;0;0;1
18565;Obelėlė;Pabiručiai;94350358246;Taip;5;4;0;9
18566;Obelėlė;Pabiručiai;74915473313;Taip;0;4;0;4
18567;Obelėlė;Pabiručiai;79388410820;Taip;0;4;3;7
18568;Obelėlė;Pabiručiai;40103909643;Taip;0;12;0;12
18569;Obelėlė;Pabiručiai;2662966388;Taip;0;0;1;1
18570;Obelėlė;Pabiručiai;2678719111;Taip;3;4;0;7
18571;Obelėlė;Pabiručiai;1420633482;Taip;0;0;2;2
18572;Obelėlė;Pabiručiai;1698995389;Taip;0;4;0;4
18573;Obelėlė;Pabiručiai;79669290078;Ne;0;4;1;5
18574;Obelėlė;Pabiručiai;31018018065;Taip;4;0;1;5
18575;Obelėlė;Pabiručiai;2015165566;Ne;0;11;0;11
18576;Obelėlė;Pabiručiai;16430825029;Taip;5;0;0;5
18577;Obelėlė;Pabiručiai;8882103124;Taip;5;0;0;5
18578;Obelėlė;Pabiručiai;5471194804;Taip;4;0;0;4
18579;Obelėlė;Pabiručiai;69055416041;Taip;0;8;0;8
18580;Obelėlė;Pabiručiai;74455701543;Taip;7;4;2;13
18581;Obelėlė;Pabiručiai;74564453474;Taip;0;0;5;5
18582;Obelėlė;Strakaliukai;1706102918;Taip;8;0;8;16
18583;Obelėlė;Strakaliukai;2770477678;Taip;10;1;2;13
18584;Obelėlė;Strakaliukai;8682794598;Taip;0;0;4;4
18585;Obelėlė;Strakaliukai;8754552660;Taip;0;17;1;18
18586;Obelėlė;Strakaliukai;8092024850;Taip;4;0;0;4
18587;Obelėlė;Strakaliukai;9716500560;Taip;4;0;0;4
18588;Obelėlė;Strakaliukai;4251418414;Taip;8;0;0;8
18589;Obelėlė;Strakaliukai;7128421330;Taip;7;0;7;14
18590;Obelėlė;Strakaliukai;5943314566;Taip;0;21;0;21
18591;Obelėlė;Strakaliukai;3116100694;Taip;12;0;0;12
18592;Obelėlė;Strakaliukai;5326258755;Taip;0;5;7;12
18593;Obelėlė;Strakaliukai;5741823041;Taip;6;0;0;6
18594;Obelėlė;Strakaliukai;8050551266;Taip;4;0;3;7
18595;Obelėlė;Strakaliukai;7468335279;Taip;11;0;0;11
18596;Obelėlė;Strakaliukai;1180508643;Taip;5;5;0;10
18597;Obelėlė;Strakaliukai;7124393375;Taip;15;0;3;18
18598;Obelėlė;Strakaliukai;1040304018;Taip;6;0;0;6
18599;Obelėlė;Strakaliukai;2571249434;Taip;12;0;2;14
18600;Obelėlė;Strakaliukai;7514587933;Taip;21;0;0;21
18601;Obelėlė;Strakaliukai;5001844064;Taip;12;4;2;18
18602;Obelėlė;Saulutė;98290583667;Ne;12;0;0;12
18603;Obelėlė;Saulutė;77954383604;Taip;7;0;6;13
18604;Obelėlė;Saulutė;1826138505;Taip;2;0;6;8
18605;Obelėlė;Saulutė;1987783063;Taip;0;0;1;1
18606;Obelėlė;Saulutė;38968623613;Taip;5;0;2;7
18607;Obelėlė;Saulutė;1741425229;Taip;9;4;0;13
18608;Obelėlė;Saulutė;1336592238;Taip;4;0;4;8
18609;Obelėlė;Saulutė;1240673124;Taip;2;0;0;2
18610;Obelėlė;Saulutė;24010838180;Taip;0;13;0;13
18611;Obelėlė;Saulutė;1935023634;Ne;9;0;2;11
18612;Obelėlė;Saulutė;1061262980;Taip;9;0;0;9
18613;Obelėlė;Saulutė;2099500866;Taip;0;2;2;4
18614;Obelėlė;Saulutė;1352415596;Ne;0;0;8;8
18615;Obelėlė;Saulutė;6054898307;Taip;2;8;1;11
18616;Obelėlė;Saulutė;3076493150;Taip;7;4;3;14
18617;Obelėlė;Saulutė;1521926754;Ne;0;0;13;13
18618;Obelėlė;Saulutė;6720229368;Ne;3;0;13;16
18619;Obelėlė;Saulutė;1021948127;Taip;13;0;0;13
18620;Obelėlė;Saulutė;4107928390;Ne;10;0;6;16
18621;Obelėlė;Saulutė;4396725994;Taip;0;4;4;8
18622;Obelėlė;Rieduliukai;8173307704;Taip;0;21;0;21
18623;Obelėlė;Rieduliukai;6364101139;Taip;0;8;0;8
18624;Obelėlė;Rieduliukai;6691540418;Taip;5;2;0;7
18625;Obelėlė;Rieduliukai;4318546408;Taip;19;0;0;19
18626;Obelėlė;Rieduliukai;6008839269;Taip;0;0;1;1
18627;Obelėlė;Rieduliukai;6020342761;Taip;2;0;0;2
18628;Obelėlė;Rieduliukai;4987747783;Taip;5;5;0;10
18629;Obelėlė;Rieduliukai;5085970254;Taip;5;0;3;8
18630;Obelėlė;Rieduliukai;8709758561;Taip;1;0;19;20
18631;Obelėlė;Rieduliukai;5739522736;Taip;5;4;4;13
18632;Obelėlė;Rieduliukai;2631405243;Taip;5;0;0;5
18633;Obelėlė;Rieduliukai;1867185320;Taip;12;4;0;16
18634;Obelėlė;Rieduliukai;9796759067;Taip;5;7;0;12
18635;Obelėlė;Rieduliukai;6720808705;Taip;9;4;3;16
18636;Obelėlė;Rieduliukai;7850656031;Taip;4;0;2;6
18637;Obelėlė;Rieduliukai;9084969712;Taip;0;3;4;7
18638;Obelėlė;Žirniukai;7794072582;Taip;13;0;0;13
18639;Obelėlė;Žirniukai;9641297002;Taip;5;0;0;5
18640;Obelėlė;Žirniukai;8918176312;Taip;0;4;3;7
18641;Obelėlė;Žirniukai;9070960601;Taip;0;21;0;21
18642;Obelėlė;Žirniukai;7003947655;Taip;0;2;5;7
18643;Obelėlė;Žirniukai;3986892111;Taip;4;0;0;4
18644;Obelėlė;Žirniukai;1705232474;Taip;11;0;1;12
18645;Obelėlė;Žirniukai;5620250331;Taip;4;0;0;4
18646;Obelėlė;Žirniukai;5588467580;Taip;21;0;0;21
18647;Obelėlė;Žirniukai;6325027163;Taip;14;0;0;14
18648;Obelėlė;Žirniukai;8231489868;Taip;4;0;0;4
18649;Obelėlė;Žirniukai;4489212434;Taip;11;0;0;11
18650;Obelėlė;Žirniukai;8183287212;Taip;3;1;4;8
18651;Obelėlė;Žirniukai;8604451971;Taip;14;0;0;14
18652;Obelėlė;Bičiuliai;9031690002;Taip;3;0;4;7
18653;Obelėlė;Bičiuliai;3425736276;Taip;7;4;5;16
18654;Obelėlė;Bičiuliai;1507072248;Taip;7;0;0;7
18655;Obelėlė;Bičiuliai;5776116844;Taip;8;2;0;10
18656;Obelėlė;Bičiuliai;8487088625;Taip;0;2;5;7
18657;Obelėlė;Bičiuliai;1630067014;Taip;0;0;2;2
18658;Obelėlė;Bičiuliai;1537769810;Taip;5;0;0;5
18659;Obelėlė;Bičiuliai;3517342646;Taip;0;0;2;2
18660;Obelėlė;Bičiuliai;8757731600;Taip;7;0;2;9
18661;Obelėlė;Bičiuliai;1419189517;Taip;0;0;1;1
18662;Obelėlė;Bičiuliai;4220808775;Taip;0;4;2;6
18663;Obelėlė;Bičiuliai;8155712451;Ne;0;0;1;1
18664;Obelėlė;Bičiuliai;7934760271;Taip;21;0;0;21
18665;Obelėlė;Bičiuliai;4849175527;Taip;12;4;0;16
18666;Obelėlė;Bičiuliai;1362135757;Ne;0;0;6;6
18667;Obelėlė;Bičiuliai;3769993089;Taip;11;0;0;11
18668;Obelėlė;Bičiuliai;5374979248;Taip;5;0;3;8
18669;Obelėlė;Bičiuliai;5568285702;Taip;0;0;10;10
18670;Spygliukas;Bitutės;5827455834;Taip;10;0;0;10
18671;Spygliukas;Bitutės;9975117461;Taip;4;5;4;13
18672;Spygliukas;Bitutės;16828631895;Ne;7;0;4;11
18673;Spygliukas;Bitutės;4653108810;Ne;0;7;0;7
18674;Spygliukas;Bitutės;2980459339;Taip;5;0;0;5
18675;Spygliukas;Bitutės;7421000718;Taip;7;0;3;10
18676;Spygliukas;Bitutės;8103481313;Taip;5;8;1;14
18677;Spygliukas;Bitutės;4430242310;Taip;0;14;0;14
18678;Spygliukas;Bitutės;1228469923;Ne;12;0;1;13
18679;Spygliukas;Bitutės;5022615426;Taip;7;0;0;7
18680;Spygliukas;Bitutės;7250958367;Taip;7;5;0;12
18681;Spygliukas;Bitutės;1679263120;Taip;3;4;1;8
18682;Spygliukas;Bitutės;9001243644;Taip;13;0;0;13
18683;Spygliukas;Bitutės;8646122773;Taip;20;0;0;20
18684;Spygliukas;Bitutės;9392554576;Taip;6;2;0;8
18685;Spygliukas;Bitutės;4933577424;Taip;2;7;1;10
18686;Spygliukas;Bitutės;2935281062;Ne;0;0;19;19
18687;Spygliukas;Bitutės;8992822256;Taip;3;11;0;14
18688;Spygliukas;Bitutės;1940209166;Ne;0;7;3;10
18689;Spygliukas;Bitutės;1855897974;Ne;7;1;0;8
18690;Spygliukas;Kiškučiai;1401951658;Taip;16;0;3;19
18691;Spygliukas;Kiškučiai;8802722601;Taip;17;0;0;17
18692;Spygliukas;Kiškučiai;6248409896;Ne;16;0;0;16
18693;Spygliukas;Kiškučiai;3416275094;Taip;11;0;0;11
18694;Spygliukas;Kiškučiai;1341333016;Taip;25;0;0;25
18695;Spygliukas;Kiškučiai;5493599614;Taip;0;0;1;1
18696;Spygliukas;Kiškučiai;4477402331;Taip;12;0;1;13
18697;Spygliukas;Kiškučiai;6917435881;Taip;3;13;0;16
18698;Spygliukas;Kiškučiai;3569857813;Taip;12;0;0;12
18699;Spygliukas;Kiškučiai;2772801133;Taip;16;0;0;16
18700;Spygliukas;Kiškučiai;5561426508;Taip;5;0;1;6
18701;Spygliukas;Kiškučiai;2177856916;Taip;13;0;0;13
18702;Spygliukas;Kiškučiai;6931145017;Taip;19;0;1;20
18703;Spygliukas;Kiškučiai;9285259322;Taip;10;1;0;11
18704;Spygliukas;Kiškučiai;8806126755;Taip;14;0;3;17
18705;Spygliukas;Kiškučiai;4245624629;Taip;12;0;2;14
18706;Spygliukas;Kiškučiai;6332646009;Taip;10;4;0;14
18707;Spygliukas;Kiškučiai;3706443395;Taip;9;1;0;10
18708;Spygliukas;Kiškučiai;5765106914;Taip;5;4;1;10
18709;Spygliukas;Kiškučiai;8825264090;Taip;0;0;12;12
18710;Spygliukas;Boružėlės;1238940921;Taip;0;4;5;9
18711;Spygliukas;Boružėlės;93029375520;Taip;4;0;0;4
18712;Spygliukas;Boružėlės;1163722642;Taip;5;1;0;6
18713;Spygliukas;Boružėlės;9288806012;Taip;4;6;0;10
18714;Spygliukas;Boružėlės;1151844475;Taip;8;1;0;9
18715;Spygliukas;Boružėlės;4104158994;Taip;21;0;0;21
18716;Spygliukas;Boružėlės;10858715103;Taip;0;4;0;4
18717;Spygliukas;Boružėlės;1002603766;Taip;0;10;0;10
18718;Spygliukas;Boružėlės;34209607173;Taip;7;3;0;10
18719;Spygliukas;Boružėlės;1842315404;Taip;0;5;1;6
18720;Spygliukas;Boružėlės;73047963456;Taip;0;5;0;5
18721;Spygliukas;Boružėlės;7114613140;Taip;3;0;0;3
18722;Spygliukas;Boružėlės;92279064240;Taip;0;8;4;12
18723;Spygliukas;Boružėlės;1323720621;Taip;0;4;0;4
18724;Spygliukas;Boružėlės;30201229961;Ne;0;4;1;5
18725;Spygliukas;Boružėlės;79584454527;Taip;0;6;0;6
18726;Spygliukas;Boružėlės;47977103711;Taip;2;1;0;3
18727;Spygliukas;Boružėlės;1321926079;Taip;5;4;1;10
18728;Spygliukas;Boružėlės;9513387087;Ne;7;8;0;15
18729;Spygliukas;Boružėlės;1193015656;Taip;0;0;3;3
18730;Spygliukas;Ežiukai;1832756255;Taip;11;0;0;11
18731;Spygliukas;Ežiukai;9593700812;Taip;2;4;0;6
18732;Spygliukas;Ežiukai;2126162527;Taip;1;0;1;2
18733;Spygliukas;Ežiukai;1260920726;Ne;7;3;3;13
18734;Spygliukas;Ežiukai;42285404110;Taip;2;6;0;8
18735;Spygliukas;Ežiukai;2040903312;Taip;19;0;0;19
18736;Spygliukas;Ežiukai;3037648954;Taip;0;6;1;7
18737;Spygliukas;Ežiukai;1211969263;Taip;21;0;0;21
18738;Spygliukas;Ežiukai;7219659640;Taip;6;0;1;7
18739;Spygliukas;Ežiukai;1881745347;Taip;8;2;0;10
18740;Spygliukas;Ežiukai;4355472423;Taip;0;6;2;8
18741;Spygliukas;Ežiukai;53324066837;Ne;2;12;3;17
18742;Spygliukas;Ežiukai;9957292202;Taip;5;6;0;11
18743;Spygliukas;Ežiukai;1298381738;Taip;10;0;2;12
18744;Spygliukas;Ežiukai;7649832094;Taip;13;0;0;13
18745;Spygliukas;Ežiukai;5780485510;Taip;0;4;0;4
18746;Spygliukas;Ežiukai;8686118262;Taip;0;1;0;1
18747;Spygliukas;Ežiukai;5253108181;Taip;9;0;0;9
18748;Spygliukas;Ežiukai;3785469286;Taip;0;6;2;8
18749;Spygliukas;Ežiukai;29015391754;Taip;13;6;0;19
18750;Spygliukas;Ežiukai;84556142803;Taip;7;1;0;8
18751;Spygliukas;Geniukai;6242194100;Taip;2;0;0;2
18752;Spygliukas;Geniukai;4577592862;Ne;7;4;1;12
18753;Spygliukas;Geniukai;4721066953;Ne;6;4;1;11
18754;Spygliukas;Geniukai;4949371837;Taip;4;0;1;5
18755;Spygliukas;Geniukai;4650693672;Taip;0;6;0;6
18756;Spygliukas;Geniukai;6835488489;Taip;0;0;3;3
18757;Spygliukas;Geniukai;3658613027;Ne;2;0;2;4
18758;Spygliukas;Geniukai;3365209400;Ne;0;0;3;3
18759;Spygliukas;Geniukai;6457632191;Ne;12;0;1;13
18760;Spygliukas;Geniukai;1691209405;Taip;1;5;0;6
18761;Spygliukas;Geniukai;9178184431;Taip;2;0;0;2
18762;Spygliukas;Geniukai;5962360012;Taip;12;4;1;17
18763;Spygliukas;Geniukai;2739564216;Taip;2;4;0;6
18764;Spygliukas;Geniukai;4610504338;Taip;0;4;0;4
18765;Spygliukas;Geniukai;7900652746;Taip;7;2;0;9
18766;Spygliukas;Geniukai;5778081118;Taip;10;5;0;15
18767;Spygliukas;Geniukai;6000906766;Taip;21;0;0;21
18768;Spygliukas;Geniukai;50047868918;Ne;3;0;4;7
18769;Spygliukas;Riešutėliai;1227595604;Ne;0;11;0;11
18770;Spygliukas;Riešutėliai;21074122407;Taip;2;4;0;6
18771;Spygliukas;Riešutėliai;26697357569;Taip;7;10;0;17
18772;Spygliukas;Riešutėliai;48097650803;Taip;0;5;0;5
18773;Spygliukas;Riešutėliai;84487759175;Taip;7;4;0;11
18774;Spygliukas;Riešutėliai;47077562116;Taip;4;2;0;6
18775;Spygliukas;Riešutėliai;12711940653;Taip;4;2;0;6
18776;Spygliukas;Riešutėliai;68487983068;Taip;0;4;1;5
18777;Spygliukas;Riešutėliai;1341415412;Taip;0;5;1;6
18778;Spygliukas;Riešutėliai;26529424930;Taip;0;4;1;5
18779;Spygliukas;Riešutėliai;7829656569;Taip;0;4;1;5
18780;Spygliukas;Riešutėliai;1122973994;Taip;0;5;2;7
18781;Spygliukas;Riešutėliai;45296663285;Taip;0;3;0;3
18782;Spygliukas;Riešutėliai;56991221970;Taip;6;4;0;10
18783;Spygliukas;Riešutėliai;1971162865;Taip;5;4;2;11
18784;Spygliukas;Riešutėliai;1076152986;Ne;9;5;0;14
18785;Spygliukas;Riešutėliai;97773415559;Taip;0;4;0;4
18786;Spygliukas;Riešutėliai;7020789651;Taip;6;4;0;10
18787;Spygliukas;Riešutėliai;77970187363;Taip;0;5;0;5
18788;Spygliukas;Riešutėliai;43541072654;Taip;2;1;1;4
18789;Spygliukas;Pelėdžiukai;57098709793;Taip;0;8;0;8
18790;Spygliukas;Pelėdžiukai;1447408559;Taip;2;4;0;6
18791;Spygliukas;Pelėdžiukai;80768950728;Ne;0;10;0;10
18792;Spygliukas;Pelėdžiukai;15887839786;Taip;0;4;0;4
18793;Spygliukas;Pelėdžiukai;28639466275;Taip;0;3;2;5
18794;Spygliukas;Pelėdžiukai;67896776952;Ne;0;6;0;6
18795;Spygliukas;Pelėdžiukai;38040423877;Taip;0;5;0;5
18796;Spygliukas;Pelėdžiukai;53280907352;Taip;0;1;0;1
18797;Spygliukas;Pelėdžiukai;20458611180;Taip;0;1;0;1
18798;Spygliukas;Pelėdžiukai;88332181449;Taip;0;4;2;6
18799;Spygliukas;Pelėdžiukai;20248450562;Ne;16;0;0;16
18800;Spygliukas;Pelėdžiukai;58880461920;Taip;0;2;0;2
18801;Spygliukas;Pelėdžiukai;90555084491;Taip;8;2;0;10
18802;Spygliukas;Pelėdžiukai;91727550789;Taip;0;5;0;5
18803;Spygliukas;Pelėdžiukai;42786380899;Taip;0;6;0;6
18804;Spygliukas;Pelėdžiukai;1398592801;Taip;9;0;0;9
18805;Spygliukas;Pelėdžiukai;1482370515;Taip;2;6;0;8
18806;Spygliukas;Pelėdžiukai;35839138942;Taip;0;4;0;4
18807;Spygliukas;Pelėdžiukai;88798186419;Taip;17;1;0;18
18808;Spygliukas;Zylutės;7271659513;Taip;10;10;0;20
18809;Spygliukas;Zylutės;8604767396;Ne;0;0;8;8
18810;Spygliukas;Zylutės;4634660174;Taip;5;4;1;10
18811;Spygliukas;Zylutės;4368224847;Taip;7;0;3;10
18812;Spygliukas;Zylutės;9316731983;Taip;7;4;0;11
18813;Spygliukas;Zylutės;5012876830;Taip;5;0;1;6
18814;Spygliukas;Zylutės;2315421636;Taip;3;0;1;4
18815;Spygliukas;Zylutės;8708083787;Taip;7;6;0;13
18816;Spygliukas;Zylutės;7125425492;Taip;12;0;5;17
18817;Spygliukas;Zylutės;7928675053;Taip;7;1;1;9
18818;Spygliukas;Zylutės;1974541155;Taip;3;0;0;3
18819;Spygliukas;Zylutės;4505044604;Taip;5;0;2;7
18820;Spygliukas;Zylutės;2989701249;Taip;21;0;0;21
18821;Spygliukas;Zylutės;6630979640;Taip;3;0;10;13
18822;Spygliukas;Zylutės;5214431060;Taip;0;4;0;4
18823;Spygliukas;Zylutės;9086986643;Taip;2;0;0;2
18824;Spygliukas;Zylutės;9052337501;Taip;0;6;0;6
18825;Spygliukas;Skruzdėliukai;8404929784;Taip;5;1;1;7
18826;Spygliukas;Skruzdėliukai;3041184642;Taip;5;9;1;15
18827;Spygliukas;Skruzdėliukai;9070219319;Taip;9;2;0;11
18828;Spygliukas;Skruzdėliukai;8476882854;Taip;16;4;0;20
18829;Spygliukas;Skruzdėliukai;9112172144;Ne;8;0;3;11
18830;Spygliukas;Skruzdėliukai;2395961015;Taip;3;3;0;6
18831;Spygliukas;Skruzdėliukai;9413950200;Taip;13;2;0;15
18832;Spygliukas;Skruzdėliukai;1664878188;Taip;12;0;0;12
18833;Spygliukas;Skruzdėliukai;1333556956;Taip;0;6;2;8
18834;Spygliukas;Skruzdėliukai;4835818382;Taip;13;0;0;13
18835;Spygliukas;Skruzdėliukai;8869320003;Taip;8;1;0;9
18836;Spygliukas;Skruzdėliukai;8270525839;Taip;7;8;0;15
18837;Spygliukas;Skruzdėliukai;3697691132;Taip;22;0;0;22
18838;Spygliukas;Skruzdėliukai;4053158210;Taip;4;2;0;6
18839;Spygliukas;Skruzdėliukai;9444569348;Taip;13;0;0;13
18840;Spygliukas;Voveraitės;5049529300;Taip;11;2;0;13
18841;Spygliukas;Voveraitės;1987926577;Taip;0;1;0;1
18842;Spygliukas;Voveraitės;1773639994;Taip;0;5;3;8
18843;Spygliukas;Voveraitės;2066739772;Taip;12;5;0;17
18844;Spygliukas;Voveraitės;8596667547;Ne;7;6;0;13
18845;Spygliukas;Voveraitės;1042495269;Taip;4;6;0;10
18846;Spygliukas;Voveraitės;1590677993;Taip;12;5;1;18
18847;Spygliukas;Voveraitės;1030973848;Taip;10;0;0;10
18848;Spygliukas;Voveraitės;1935233612;Taip;5;7;0;12
18849;Spygliukas;Voveraitės;8801225066;Taip;3;1;0;4
18850;Spygliukas;Voveraitės;8453683673;Ne;13;4;0;17
18851;Spygliukas;Voveraitės;1045253540;Ne;0;2;2;4
18852;Spygliukas;Voveraitės;8048474808;Taip;0;5;10;15
18853;Spygliukas;Voveraitės;52719709314;Taip;5;0;0;5
18854;Spygliukas;Voveraitės;45881077771;Taip;0;10;0;10
18855;Spygliukas;Voveraitės;1415694208;Taip;2;6;3;11
18856;Spygliukas;Giliukų;6405496193;Taip;9;4;0;13
18857;Spygliukas;Giliukų;7113913750;Ne;15;0;0;15
18858;Spygliukas;Giliukų;9219327706;Taip;8;1;0;9
18859;Spygliukas;Giliukų;1426267001;Taip;14;0;0;14
18860;Spygliukas;Giliukų;1234195733;Taip;9;1;0;10
18861;Spygliukas;Giliukų;6758336405;Taip;0;0;6;6
18862;Spygliukas;Giliukų;6587957213;Taip;5;1;0;6
18863;Spygliukas;Giliukų;8877911083;Taip;5;5;0;10
18864;Spygliukas;Giliukų;7897603878;Taip;5;5;0;10
18865;Spygliukas;Giliukų;1177439438;Taip;7;1;3;11
18866;Spygliukas;Giliukų;7313828707;Taip;7;0;0;7
18867;Spygliukas;Giliukų;3668191959;Taip;8;2;0;10
18868;Spygliukas;Giliukų;2272141731;Taip;9;6;0;15
18869;Vieversys;Žirniukai;8129139979;Taip;5;5;0;10
18870;Vieversys;Žirniukai;1149316471;Taip;0;9;0;9
18871;Vieversys;Žirniukai;1728554204;Taip;3;4;1;8
18872;Vieversys;Žirniukai;6787960120;Ne;17;0;0;17
18873;Vieversys;Žirniukai;9612415733;Taip;0;4;0;4
18874;Vieversys;Žirniukai;5917328379;Taip;8;0;0;8
18875;Vieversys;Žirniukai;53977164888;Taip;0;4;0;4
18876;Vieversys;Žirniukai;82594887399;Taip;0;8;0;8
18877;Vieversys;Žirniukai;7500147648;Taip;10;1;1;12
18878;Vieversys;Žirniukai;2621046003;Taip;0;0;3;3
18879;Vieversys;Žirniukai;9835682858;Taip;21;0;0;21
18880;Vieversys;Žirniukai;6596979763;Taip;5;0;0;5
18881;Vieversys;Žirniukai;5286521728;Taip;15;5;0;20
18882;Vieversys;Žirniukai;8038341998;Taip;3;4;0;7
18883;Vieversys;Žirniukai;1247565595;Taip;0;1;0;1
18884;Vieversys;Žirniukai;6720355390;Taip;0;0;12;12
18885;Vieversys;Žirniukai;4313822180;Taip;0;7;0;7
18886;Vieversys;Žirniukai;7812227428;Ne;2;2;0;4
18887;Vieversys;Žirniukai;4455039401;Taip;1;4;0;5
18888;Vieversys;Žirniukai;5810605263;Taip;5;0;2;7
18889;Vieversys;Varpelių;38299255111;Taip;0;6;0;6
18890;Vieversys;Varpelių;34168958939;Taip;0;3;0;3
18891;Vieversys;Varpelių;35783466157;Taip;2;4;0;6
18892;Vieversys;Varpelių;25198979253;Taip;11;0;0;11
18893;Vieversys;Varpelių;50929651251;Taip;0;5;0;5
18894;Vieversys;Varpelių;65625227882;Taip;3;2;0;5
18895;Vieversys;Varpelių;29002693436;Taip;5;4;1;10
18896;Vieversys;Varpelių;41282339758;Taip;2;6;0;8
18897;Vieversys;Varpelių;6427430220;Taip;12;6;1;19
18898;Vieversys;Varpelių;25843076066;Taip;0;4;0;4
18899;Vieversys;Varpelių;72475350152;Taip;0;5;0;5
18900;Vieversys;Varpelių;61074394922;Taip;3;4;1;8
18901;Vieversys;Varpelių;11528430680;Taip;0;4;0;4
18902;Vieversys;Varpelių;67471794738;Taip;0;7;0;7
18903;Vieversys;Varpelių;13768739410;Taip;0;5;0;5
18904;Vieversys;Varpelių;45707453869;Taip;0;4;0;4
18905;Vieversys;Varpelių;79197759451;Taip;0;2;0;2
18906;Vieversys;Varpelių;2010825247;Ne;10;11;0;21
18907;Vieversys;Varpelių;89564962534;Taip;0;3;0;3
18908;Vieversys;Varpelių;65696183376;Taip;4;4;2;10
18909;Vieversys;Varpelių;2561825171;Taip;0;4;5;9
18910;Vieversys;Varpelių;87314456133;Ne;0;4;1;5
18911;Vieversys;Kiškučių;2511719188;Ne;6;2;0;8
18912;Vieversys;Kiškučių;6077365803;Taip;0;4;2;6
18913;Vieversys;Kiškučių;5337856442;Taip;4;6;1;11
18914;Vieversys;Kiškučių;5051310223;Ne;4;6;3;13
18915;Vieversys;Kiškučių;75434941104;Taip;0;2;0;2
18916;Vieversys;Kiškučių;83420473111;Taip;5;6;0;11
18917;Vieversys;Kiškučių;22717987850;Taip;5;0;0;5
18918;Vieversys;Kiškučių;26092685300;Ne;5;8;0;13
18919;Vieversys;Kiškučių;56670426557;Taip;0;1;0;1
18920;Vieversys;Kiškučių;22275121492;Taip;0;3;0;3
18921;Vieversys;Kiškučių;34494816770;Taip;5;2;1;8
18922;Vieversys;Kiškučių;27123496741;Taip;5;7;0;12
18923;Vieversys;Kiškučių;63139698249;Taip;0;4;0;4
18924;Vieversys;Kiškučių;66155667200;Taip;10;4;0;14
18925;Vieversys;Kiškučių;68374560306;Taip;0;3;2;5
18926;Vieversys;Kiškučių;7126970560;Taip;0;5;0;5
18927;Vieversys;Kiškučių;61951858540;Taip;6;5;0;11
18928;Vieversys;Kiškučių;1371669237;Taip;0;5;0;5
18929;Vieversys;Kiškučių;93582609868;Taip;5;4;0;9
18930;Vieversys;Kiškučių;35144734547;Taip;7;0;0;7
18931;Vieversys;Pelėdžiukų;8421719030;Taip;2;1;2;5
18932;Vieversys;Pelėdžiukų;77272293257;Taip;7;0;0;7
18933;Vieversys;Pelėdžiukų;94463134058;Taip;4;8;0;12
18934;Vieversys;Pelėdžiukų;5434952733;Taip;0;4;5;9
18935;Vieversys;Pelėdžiukų;7578552471;Taip;7;0;0;7
18936;Vieversys;Pelėdžiukų;2193074123;Taip;0;4;2;6
18937;Vieversys;Pelėdžiukų;7007620994;Taip;0;1;0;1
18938;Vieversys;Pelėdžiukų;9499315463;Taip;0;7;0;7
18939;Vieversys;Pelėdžiukų;9774365819;Taip;6;7;0;13
18940;Vieversys;Pelėdžiukų;9494957750;Taip;5;4;3;12
18941;Vieversys;Pelėdžiukų;2521488728;Taip;7;2;2;11
18942;Vieversys;Pelėdžiukų;6473759470;Taip;4;3;0;7
18943;Vieversys;Pelėdžiukų;1120594293;Taip;6;6;0;12
18944;Vieversys;Pelėdžiukų;1273951001;Taip;5;0;11;16
18945;Vieversys;Pelėdžiukų;48430863473;Taip;7;9;0;16
18946;Vieversys;Pelėdžiukų;50181034746;Taip;9;0;0;9
18947;Vieversys;Pelėdžiukų;52420072025;Taip;6;0;0;6
18948;Vieversys;Pelėdžiukų;1027693153;Taip;4;0;1;5
18949;Vieversys;Pelėdžiukų;5871715452;Taip;4;0;6;10
18950;Vieversys;Pelėdžiukų;9659337657;Ne;0;0;3;3
18951;Vieversys;Pelėdžiukų;3458399180;Taip;5;7;0;12
18952;Vieversys;Pelėdžiukų;1361156816;Taip;7;4;0;11
18953;Vieversys;Saulučių;53189421149;Taip;6;4;3;13
18954;Vieversys;Saulučių;81494754248;Taip;7;4;0;11
18955;Vieversys;Saulučių;12419984038;Taip;0;4;6;10
18956;Vieversys;Saulučių;78901148667;Taip;5;0;0;5
18957;Vieversys;Saulučių;1601102808;Ne;7;0;1;8
18958;Vieversys;Saulučių;84134333980;Taip;3;1;0;4
18959;Vieversys;Saulučių;9980447111;Taip;0;3;2;5
18960;Vieversys;Saulučių;2733479642;Taip;6;3;0;9
18961;Vieversys;Saulučių;25507613416;Ne;0;5;0;5
18962;Vieversys;Saulučių;1307701524;Taip;2;6;0;8
18963;Vieversys;Saulučių;8966153890;Taip;0;1;0;1
18964;Vieversys;Saulučių;69295745570;Taip;10;0;0;10
18965;Vieversys;Saulučių;2006826758;Taip;2;4;0;6
18966;Vieversys;Saulučių;2756075736;Taip;5;1;0;6
18967;Vieversys;Saulučių;3907748584;Taip;7;0;0;7
18968;Vieversys;Saulučių;93675768307;Taip;11;0;0;11
18969;Vieversys;Saulučių;6236703869;Taip;0;5;2;7
18970;Vieversys;Saulučių;4216521988;Taip;0;2;0;2
18971;Vieversys;Kregždučių;55553505459;Taip;0;7;1;8
18972;Vieversys;Kregždučių;16002848795;Taip;0;7;1;8
18973;Vieversys;Kregždučių;1933907389;Taip;2;1;0;3
18974;Vieversys;Kregždučių;1462608187;Ne;2;5;0;7
18975;Vieversys;Kregždučių;2130449373;Taip;0;5;0;5
18976;Vieversys;Kregždučių;44086673096;Taip;0;5;0;5
18977;Vieversys;Kregždučių;89223502405;Taip;6;6;0;12
18978;Vieversys;Kregždučių;41215224179;Taip;8;4;0;12
18979;Vieversys;Kregždučių;938801303;Taip;0;4;0;4
18980;Vieversys;Kregždučių;1190396975;Taip;0;5;0;5
18981;Vieversys;Kregždučių;62465517391;Taip;2;5;0;7
18982;Vieversys;Kregždučių;5123994167;Taip;6;0;0;6
18983;Vieversys;Kregždučių;12524976076;Taip;0;5;0;5
18984;Vieversys;Kregždučių;1300013110;Taip;10;4;0;14
18985;Vieversys;Kregždučių;61101237391;Taip;5;6;0;11
18986;Vieversys;Kregždučių;1716198618;Taip;0;13;0;13
18987;Vieversys;Kregždučių;8213134622;Taip;9;5;0;14
18988;Vieversys;Kregždučių;2879546284;Taip;10;4;0;14
18989;Vieversys;Kregždučių;3839507103;Taip;0;5;0;5
18990;Vieversys;Kregždučių;73657188876;Taip;4;0;0;4
18991;Vieversys;Boružėlių;6116471730;Ne;0;2;0;2
18992;Vieversys;Boružėlių;1815073796;Taip;0;4;0;4
18993;Vieversys;Boružėlių;32630544785;Taip;0;4;1;5
18994;Vieversys;Boružėlių;20960056744;Ne;0;4;4;8
18995;Vieversys;Boružėlių;95472887427;Taip;0;0;1;1
18996;Vieversys;Boružėlių;58287759954;Taip;0;8;3;11
18997;Vieversys;Boružėlių;72395946516;Ne;6;0;0;6
18998;Vieversys;Boružėlių;86213464121;Taip;3;1;7;11
18999;Vieversys;Boružėlių;55764266970;Taip;9;1;0;10
19000;Vieversys;Boružėlių;1588939300;Taip;5;0;0;5
19001;Vieversys;Boružėlių;86119860485;Taip;5;1;0;6
19002;Vieversys;Boružėlių;57223617591;Taip;2;1;0;3
19003;Vieversys;Boružėlių;1028950997;Taip;2;0;12;14
19004;Vieversys;Boružėlių;14574836082;Ne;2;6;0;8
19005;Vieversys;Boružėlių;95886969053;Taip;9;0;0;9
19006;Vieversys;Boružėlių;95891054066;Taip;7;0;0;7
19007;Vieversys;Boružėlių;5197639355;Taip;4;1;0;5
19008;Vieversys;Boružėlių;15473504836;Taip;5;0;1;6
19009;Vieversys;Boružėlių;8744701209;Taip;0;9;0;9
19010;Vieversys;Boružėlių;1715902540;Taip;8;7;0;15
19011;Vieversys;Boružėlių;1765258957;Taip;4;0;0;4
19012;Vieversys;Bitučių;9972526744;Taip;5;7;0;12
19013;Vieversys;Bitučių;5654533451;Taip;0;10;0;10
19014;Vieversys;Bitučių;6127272124;Taip;9;0;1;10
19015;Vieversys;Bitučių;3405502715;Taip;7;0;1;8
19016;Vieversys;Bitučių;9985374057;Taip;0;5;0;5
19017;Vieversys;Bitučių;4741252829;Taip;19;0;0;19
19018;Vieversys;Bitučių;7048475906;Taip;8;0;2;10
19019;Vieversys;Bitučių;6031200259;Ne;16;0;0;16
19020;Vieversys;Bitučių;4072323869;Taip;6;2;0;8
19021;Vieversys;Bitučių;6110034652;Taip;14;4;0;18
19022;Vieversys;Bitučių;2663322242;Ne;1;0;0;1
19023;Vieversys;Bitučių;7596355010;Taip;0;11;0;11
19024;Vieversys;Bitučių;4892622551;Ne;4;0;3;7
19025;Vieversys;Bitučių;2140887757;Taip;0;0;1;1
19026;Vieversys;Bitučių;4690095102;Taip;7;4;0;11
19027;Vieversys;Bitučių;4968278870;Taip;16;0;0;16
19028;Vieversys;Smalsučių;5922485482;Taip;8;0;0;8
19029;Vieversys;Smalsučių;9164615794;Taip;10;2;0;12
19030;Vieversys;Smalsučių;3684937630;Taip;0;1;0;1
19031;Vieversys;Smalsučių;6563139211;Taip;0;2;0;2
19032;Vieversys;Smalsučių;1757028935;Taip;6;4;0;10
19033;Vieversys;Smalsučių;4488027554;Taip;6;4;0;10
19034;Vieversys;Smalsučių;4294676988;Taip;13;1;0;14
19035;Vieversys;Smalsučių;3917758713;Taip;6;6;0;12
19036;Vieversys;Smalsučių;4835022593;Taip;9;0;2;11
19037;Vieversys;Smalsučių;3249717073;Taip;8;4;0;12
19038;Vieversys;Smalsučių;7120329258;Taip;0;4;0;4
19039;Vieversys;Smalsučių;9387421639;Taip;16;2;0;18
19040;Vieversys;Smalsučių;8174124875;Taip;9;0;0;9
19041;Vieversys;Smalsučių;5769453869;Taip;0;2;0;2
19042;Vieversys;Smalsučių;5789530087;Taip;12;0;8;20
19043;Vieversys;Smalsučių;3755410640;Ne;0;8;0;8
19044;Vieversys;Smalsučių;1322495361;Taip;17;0;0;17
19045;Vieversys;Kodėlčiukų;69275621813;Taip;2;9;0;11
19046;Vieversys;Kodėlčiukų;1455615413;Taip;9;0;3;12
19047;Vieversys;Kodėlčiukų;1970088958;Taip;0;2;0;2
19048;Vieversys;Kodėlčiukų;1586720551;Taip;0;5;0;5
19049;Vieversys;Kodėlčiukų;9012978017;Taip;0;12;0;12
19050;Vieversys;Kodėlčiukų;1599787985;Ne;0;0;8;8
19051;Vieversys;Kodėlčiukų;1491424075;Taip;9;0;6;15
19052;Vieversys;Kodėlčiukų;1361494430;Taip;6;4;0;10
19053;Vieversys;Kodėlčiukų;9829388743;Taip;0;15;0;15
19054;Vieversys;Kodėlčiukų;1878278158;Taip;2;1;2;5
19055;Vieversys;Kodėlčiukų;7315438787;Taip;0;9;0;9
19056;Vieversys;Kodėlčiukų;16617102917;Taip;10;0;0;10
19057;Vieversys;Kodėlčiukų;1793994492;Taip;0;0;15;15
19058;Vieversys;Kodėlčiukų;2236904814;Taip;7;0;10;17
19059;Vieversys;Kodėlčiukų;3792076932;Taip;11;0;0;11
19060;Vieversys;Kodėlčiukų;7385860819;Taip;0;0;4;4
19061;Vieversys;Kodėlčiukų;2294276744;Taip;0;4;0;4
19062;Vieversys;Kodėlčiukų;3640960566;Taip;10;4;3;17
19063;Vieversys;Kodėlčiukų;2006325359;Taip;0;4;0;4
19064;Vieversys;NYKŠTUKAI;9453100342;Taip;0;4;2;6
19065;Vieversys;NYKŠTUKAI;3731412573;Ne;0;5;0;5
19066;Vieversys;NYKŠTUKAI;9826657384;Taip;12;0;0;12
19067;Vieversys;NYKŠTUKAI;8084767846;Taip;0;0;1;1
19068;Vieversys;NYKŠTUKAI;7364582681;Taip;2;4;0;6
19069;Vieversys;NYKŠTUKAI;4088189914;Taip;0;4;0;4
19070;Vieversys;NYKŠTUKAI;7399326463;Taip;14;0;0;14
19071;Vieversys;NYKŠTUKAI;4565799599;Taip;3;1;0;4
19072;Vieversys;NYKŠTUKAI;9884517851;Taip;0;6;0;6
19073;Vieversys;NYKŠTUKAI;6765094662;Ne;5;0;0;5
19074;Vieversys;NYKŠTUKAI;5683183310;Taip;2;4;0;6
19075;Vieversys;NYKŠTUKAI;8587368497;Taip;0;3;0;3
19076;Vieversys;NYKŠTUKAI;6838828193;Taip;4;0;0;4
19077;Vieversys;NYKŠTUKAI;2027613318;Taip;0;1;0;1
19078;Vieversys;NYKŠTUKAI;1478357320;Taip;7;10;0;17
19079;Vieversys;NYKŠTUKAI;7329004031;Taip;2;0;0;2
19080;Vieversys;DRUGELIAI;9093088054;Taip;9;0;4;13
19081;Vieversys;DRUGELIAI;6808541662;Taip;0;0;1;1
19082;Vieversys;DRUGELIAI;5486475468;Taip;0;0;2;2
19083;Vieversys;DRUGELIAI;8141710663;Taip;0;0;8;8
19084;Vieversys;DRUGELIAI;2230503026;Taip;0;4;2;6
19085;Vieversys;DRUGELIAI;5645852451;Taip;11;1;0;12
19086;Vieversys;DRUGELIAI;3122763958;Taip;0;7;5;12
19087;Vieversys;DRUGELIAI;9088171869;Taip;12;0;0;12
19088;Vieversys;DRUGELIAI;1685531183;Ne;15;0;0;15
19089;Vieversys;DRUGELIAI;7998100115;Taip;0;6;0;6
19090;Vieversys;DRUGELIAI;3156245273;Taip;0;0;2;2
19091;Vieversys;DRUGELIAI;7568415178;Taip;0;0;3;3
19092;Vieversys;DRUGELIAI;4870401841;Taip;5;0;2;7
19093;Vieversys;DRUGELIAI;5912306325;Taip;0;6;3;9
19094;Žirmūnėliai;SAULUTĖS;8030469722;Taip;0;7;0;7
19095;Žirmūnėliai;SAULUTĖS;1258769646;Taip;0;4;0;4
19096;Žirmūnėliai;SAULUTĖS;3166454638;Taip;16;0;0;16
19097;Žirmūnėliai;SAULUTĖS;73664204182;Taip;5;4;0;9
19098;Žirmūnėliai;SAULUTĖS;1725143117;Taip;7;4;0;11
19099;Žirmūnėliai;SAULUTĖS;1073135587;Taip;0;10;0;10
19100;Žirmūnėliai;SAULUTĖS;4598761492;Taip;0;14;0;14
19101;Žirmūnėliai;SAULUTĖS;3128190518;Taip;8;9;0;17
19102;Žirmūnėliai;SAULUTĖS;8317328771;Taip;6;5;4;15
19103;Žirmūnėliai;SAULUTĖS;1478039469;Taip;6;0;1;7
19104;Žirmūnėliai;SAULUTĖS;6896145409;Taip;9;4;0;13
19105;Žirmūnėliai;SAULUTĖS;1255857051;Taip;9;2;0;11
19106;Žirmūnėliai;SAULUTĖS;72738770293;Taip;7;0;0;7
19107;Žirmūnėliai;SAULUTĖS;4517290068;Taip;0;4;1;5
19108;Žirmūnėliai;SAULUTĖS;1582563837;Taip;4;1;0;5
19109;Žirmūnėliai;SAULUTĖS;1381923106;Taip;12;4;0;16
19110;Žirmūnėliai;SAULUTĖS;5037669167;Taip;15;0;0;15
19111;Žirmūnėliai;SAULUTĖS;1761284228;Taip;8;4;0;12
19112;Žirmūnėliai;SAULUTĖS;41018224936;Taip;6;1;4;11
19113;Žirmūnėliai;SAULUTĖS;1894070647;Taip;0;6;0;6
19114;Žirmūnėliai;SAULUTĖS;1347664230;Taip;0;1;0;1
19115;Žirmūnėliai;SAULUTĖS;1302022463;Taip;0;1;0;1
19116;Žirmūnėliai;GILIUKAI;37231106844;Taip;10;4;0;14
19117;Žirmūnėliai;GILIUKAI;5673929155;Taip;0;5;0;5
19118;Žirmūnėliai;GILIUKAI;50829749038;Taip;0;4;0;4
19119;Žirmūnėliai;GILIUKAI;1401250193;Taip;1;0;0;1
19120;Žirmūnėliai;GILIUKAI;1818060330;Taip;0;8;1;9
19121;Žirmūnėliai;GILIUKAI;1963980356;Taip;0;2;0;2
19122;Žirmūnėliai;GILIUKAI;1302040861;Ne;0;7;0;7
19123;Žirmūnėliai;GILIUKAI;99546532431;Taip;0;1;0;1
19124;Žirmūnėliai;GILIUKAI;1816123753;Taip;0;13;0;13
19125;Žirmūnėliai;GILIUKAI;1308593517;Taip;0;6;0;6
19126;Žirmūnėliai;GILIUKAI;53028161711;Taip;0;17;0;17
19127;Žirmūnėliai;GILIUKAI;6578685370;Ne;19;0;0;19
19128;Žirmūnėliai;GILIUKAI;1493536049;Taip;0;1;0;1
19129;Žirmūnėliai;GILIUKAI;1626619024;Taip;0;2;1;3
19130;Žirmūnėliai;GILIUKAI;8824743884;Taip;0;2;2;4
19131;Žirmūnėliai;GILIUKAI;1556389237;Taip;0;2;3;5
19132;Žirmūnėliai;GILIUKAI;1764226619;Taip;0;4;0;4
19133;Žirmūnėliai;GILIUKAI;1183883183;Taip;0;18;0;18
19134;Žirmūnėliai;GILIUKAI;7929881052;Ne;8;3;0;11
19135;Žirmūnėliai;GILIUKAI;5996547081;Taip;17;0;0;17
19136;Žirmūnėliai;DAINORĖLIAI;6493142538;Taip;7;0;0;7
19137;Žirmūnėliai;DAINORĖLIAI;1655437833;Taip;10;4;0;14
19138;Žirmūnėliai;DAINORĖLIAI;2693415717;Taip;2;0;4;6
19139;Žirmūnėliai;DAINORĖLIAI;8930536051;Taip;14;0;0;14
19140;Žirmūnėliai;DAINORĖLIAI;7953019230;Taip;20;0;0;20
19141;Žirmūnėliai;DAINORĖLIAI;6982109508;Taip;6;0;3;9
19142;Žirmūnėliai;DAINORĖLIAI;3458810185;Ne;7;0;2;9
19143;Žirmūnėliai;DAINORĖLIAI;3994865244;Taip;7;0;11;18
19144;Žirmūnėliai;DAINORĖLIAI;3640979388;Taip;10;2;0;12
19145;Žirmūnėliai;DAINORĖLIAI;6878528100;Taip;8;0;2;10
19146;Žirmūnėliai;DAINORĖLIAI;8440187348;Ne;12;0;0;12
19147;Žirmūnėliai;DAINORĖLIAI;9402567487;Taip;16;0;0;16
19148;Žirmūnėliai;DAINORĖLIAI;9759491055;Taip;0;0;14;14
19149;Žirmūnėliai;DAINORĖLIAI;3297360222;Ne;10;0;6;16
19150;Žirmūnėliai;DAINORĖLIAI;1127214387;Taip;0;0;3;3
19151;Žirmūnėliai;DAINORĖLIAI;4101748829;Taip;14;0;0;14
19152;Žirmūnėliai;DAINORĖLIAI;2379638934;Taip;9;4;0;13
19153;Žirmūnėliai;DAINORĖLIAI;6448582622;Taip;13;0;1;14
19154;Žirmūnėliai;DAINORĖLIAI;2661052835;Taip;9;2;0;11
19155;Žirmūnėliai;DAINORĖLIAI;7011701994;Ne;5;5;0;10
19156;Žirmūnėliai;DRUGELIAI;4218266688;Taip;5;0;0;5
19157;Žirmūnėliai;DRUGELIAI;7020486370;Taip;2;5;0;7
19158;Žirmūnėliai;DRUGELIAI;3449815783;Taip;2;2;0;4
19159;Žirmūnėliai;DRUGELIAI;9541122034;Taip;3;5;0;8
19160;Žirmūnėliai;DRUGELIAI;5736502380;Ne;0;3;0;3
19161;Žirmūnėliai;DRUGELIAI;9378860669;Taip;2;3;0;5
19162;Žirmūnėliai;DRUGELIAI;8607934394;Taip;21;0;0;21
19163;Žirmūnėliai;DRUGELIAI;5723289396;Taip;11;0;2;13
19164;Žirmūnėliai;DRUGELIAI;7892626521;Taip;0;4;0;4
19165;Žirmūnėliai;DRUGELIAI;8999160836;Taip;10;2;4;16
19166;Žirmūnėliai;DRUGELIAI;8209309240;Taip;0;10;0;10
19167;Žirmūnėliai;DRUGELIAI;2837129621;Taip;4;2;0;6
19168;Žirmūnėliai;DRUGELIAI;1273684243;Taip;4;0;0;4
19169;Žirmūnėliai;DRUGELIAI;2971175236;Taip;0;2;0;2
19170;Žirmūnėliai;DRUGELIAI;6594728970;Taip;0;5;0;5
19171;Žirmūnėliai;DRUGELIAI;5090067954;Taip;2;0;0;2
19172;Žirmūnėliai;DRUGELIAI;7422544482;Taip;5;1;4;10
19173;Žirmūnėliai;DRUGELIAI;4336415033;Taip;4;0;1;5
19174;Žirmūnėliai;DRUGELIAI;9241738140;Taip;18;0;0;18
19175;Žirmūnėliai;BORUŽIUKAI;99393944540;Taip;7;4;0;11
19176;Žirmūnėliai;BORUŽIUKAI;76779474158;Taip;2;6;2;10
19177;Žirmūnėliai;BORUŽIUKAI;18242077086;Taip;0;2;0;2
19178;Žirmūnėliai;BORUŽIUKAI;37429281370;Taip;0;5;3;8
19179;Žirmūnėliai;BORUŽIUKAI;19044383213;Taip;6;1;0;7
19180;Žirmūnėliai;BORUŽIUKAI;1119678857;Taip;0;6;0;6
19181;Žirmūnėliai;BORUŽIUKAI;99980167497;Taip;0;5;0;5
19182;Žirmūnėliai;BORUŽIUKAI;88436070676;Taip;0;4;0;4
19183;Žirmūnėliai;BORUŽIUKAI;66100956443;Taip;0;1;8;9
19184;Žirmūnėliai;BORUŽIUKAI;85286691926;Taip;2;6;4;12
19185;Žirmūnėliai;BORUŽIUKAI;1634724759;Taip;0;8;0;8
19186;Žirmūnėliai;BORUŽIUKAI;7777166572;Taip;0;10;0;10
19187;Žirmūnėliai;BORUŽIUKAI;20851917855;Taip;0;18;0;18
19188;Žirmūnėliai;BORUŽIUKAI;26463655365;Ne;7;5;0;12
19189;Žirmūnėliai;BORUŽIUKAI;32213803056;Taip;5;7;0;12
19190;Žirmūnėliai;BORUŽIUKAI;1157270725;Taip;0;16;0;16
19191;Žirmūnėliai;BORUŽIUKAI;22592450568;Taip;5;5;1;11
19192;Žirmūnėliai;BORUŽIUKAI;78535860714;Taip;0;4;0;4
19193;Žirmūnėliai;BORUŽIUKAI;34205058356;Taip;0;8;0;8
19194;Žirmūnėliai;EŽIUKAI;75310341519;Taip;0;4;1;5
19195;Žirmūnėliai;EŽIUKAI;1617021385;Taip;0;4;0;4
19196;Žirmūnėliai;EŽIUKAI;36822027549;Taip;0;4;7;11
19197;Žirmūnėliai;EŽIUKAI;22385656372;Taip;0;1;0;1
19198;Žirmūnėliai;EŽIUKAI;1563132542;Taip;0;4;4;8
19199;Žirmūnėliai;EŽIUKAI;31231655300;Taip;0;4;9;13
19200;Žirmūnėliai;EŽIUKAI;5450253994;Taip;2;3;0;5
19201;Žirmūnėliai;EŽIUKAI;97123184267;Ne;0;4;2;6
19202;Žirmūnėliai;EŽIUKAI;67024451309;Taip;7;4;0;11
19203;Žirmūnėliai;EŽIUKAI;39347099487;Taip;1;5;0;6
19204;Žirmūnėliai;EŽIUKAI;6380354636;Ne;1;4;1;6
19205;Žirmūnėliai;EŽIUKAI;2548081116;Taip;6;4;0;10
19206;Žirmūnėliai;EŽIUKAI;58158145123;Taip;0;5;1;6
19207;Žirmūnėliai;EŽIUKAI;30933761145;Taip;7;4;5;16
19208;Žirmūnėliai;EŽIUKAI;33441696614;Taip;9;4;0;13
19209;Žirmūnėliai;EŽIUKAI;51268874840;Taip;0;7;0;7
19210;Žirmūnėliai;EŽIUKAI;57457297276;Taip;3;4;0;7
19211;Žirmūnėliai;EŽIUKAI;1023642666;Taip;9;4;1;14
19212;Žirmūnėliai;EŽIUKAI;9039313646;Taip;0;3;0;3
19213;Žirmūnėliai;EŽIUKAI;7386776624;Taip;0;3;0;3
19214;Žirmūnėliai;ŽVIRBLIUKAI;73552867802;Taip;0;5;0;5
19215;Žirmūnėliai;ŽVIRBLIUKAI;38316483993;Taip;0;5;0;5
19216;Žirmūnėliai;ŽVIRBLIUKAI;1250060420;Taip;11;4;1;16
19217;Žirmūnėliai;ŽVIRBLIUKAI;1477593223;Ne;2;5;0;7
19218;Žirmūnėliai;ŽVIRBLIUKAI;3896978775;Taip;15;4;0;19
19219;Žirmūnėliai;ŽVIRBLIUKAI;1235090013;Taip;4;4;0;8
19220;Žirmūnėliai;ŽVIRBLIUKAI;4136421440;Taip;4;4;0;8
19221;Žirmūnėliai;ŽVIRBLIUKAI;87693490164;Taip;8;4;0;12
19222;Žirmūnėliai;ŽVIRBLIUKAI;65010448998;Taip;0;4;0;4
19223;Žirmūnėliai;ŽVIRBLIUKAI;45541156029;Taip;0;6;7;13
19224;Žirmūnėliai;ŽVIRBLIUKAI;96121856269;Taip;0;10;0;10
19225;Žirmūnėliai;ŽVIRBLIUKAI;28826938550;Taip;0;4;5;9
19226;Žirmūnėliai;ŽVIRBLIUKAI;65810358813;Taip;0;4;1;5
19227;Žirmūnėliai;ŽVIRBLIUKAI;12766765793;Taip;13;3;0;16
19228;Žirmūnėliai;ŽVIRBLIUKAI;86142962074;Taip;0;12;0;12
19229;Žirmūnėliai;ŽVIRBLIUKAI;61531418513;Taip;0;6;0;6
19230;Žirmūnėliai;ŽVIRBLIUKAI;5276699877;Taip;0;4;2;6
19231;Žirmūnėliai;ŽVIRBLIUKAI;6531982232;Taip;0;4;0;4
19232;Žirmūnėliai;ŽVIRBLIUKAI;20902834369;Taip;0;7;0;7
19233;Žirmūnėliai;SPALVELĖS;4986702792;Ne;0;6;7;13
19234;Žirmūnėliai;SPALVELĖS;86501162211;Taip;0;9;1;10
19235;Žirmūnėliai;SPALVELĖS;3691651489;Taip;0;0;11;11
19236;Žirmūnėliai;SPALVELĖS;1120531178;Taip;0;6;4;10
19237;Žirmūnėliai;SPALVELĖS;1273301982;Taip;10;1;0;11
19238;Žirmūnėliai;SPALVELĖS;29952298800;Taip;0;0;21;21
19239;Žirmūnėliai;SPALVELĖS;8348616350;Taip;0;3;0;3
19240;Žirmūnėliai;SPALVELĖS;2127930970;Taip;8;6;0;14
19241;Žirmūnėliai;SPALVELĖS;3150467744;Taip;4;0;0;4
19242;Žirmūnėliai;SPALVELĖS;4330975876;Taip;0;0;4;4
19243;Žirmūnėliai;SPALVELĖS;4710829908;Taip;0;4;0;4
19244;Žirmūnėliai;SPALVELĖS;7918747416;Taip;0;4;0;4
19245;Žirmūnėliai;SPALVELĖS;1865240339;Taip;4;1;0;5
19246;Žirmūnėliai;SPALVELĖS;8339819296;Taip;0;6;2;8
19247;Žirmūnėliai;SPALVELĖS;51723882387;Taip;2;6;2;10
19248;Žirmūnėliai;SPALVELĖS;8308074932;Taip;5;1;0;6
19249;Žirmūnėliai;SPALVELĖS;4638575301;Taip;2;4;0;6
19250;Žirmūnėliai;SPALVELĖS;7996709950;Ne;0;6;0;6
19251;Žirmūnėliai;SPALVELĖS;1017903291;Ne;0;13;0;13
19252;Žirmūnėliai;SPALVELĖS;33296480709;Taip;6;0;1;7
19253;Žirmūnėliai;SPALVELĖS;52524235797;Ne;9;0;0;9
19254;Žirmūnėliai;SPALVELĖS;9482910388;Taip;0;16;0;16
19255;Žirmūnėliai;DEBESĖLIAI;64969220116;Taip;0;21;0;21
19256;Žirmūnėliai;DEBESĖLIAI;1690539251;Taip;5;0;0;5
19257;Žirmūnėliai;DEBESĖLIAI;1542147528;Taip;13;1;0;14
19258;Žirmūnėliai;DEBESĖLIAI;5527904792;Taip;0;21;0;21
19259;Žirmūnėliai;DEBESĖLIAI;6161223611;Taip;9;1;0;10
19260;Žirmūnėliai;DEBESĖLIAI;31403739893;Taip;8;0;1;9
19261;Žirmūnėliai;DEBESĖLIAI;9926432375;Ne;8;6;0;14
19262;Žirmūnėliai;DEBESĖLIAI;5367009184;Taip;0;3;0;3
19263;Žirmūnėliai;DEBESĖLIAI;2263604297;Taip;0;2;0;2
19264;Žirmūnėliai;DEBESĖLIAI;1885292520;Taip;0;4;1;5
19265;Žirmūnėliai;DEBESĖLIAI;1618573494;Taip;0;21;0;21
19266;Žirmūnėliai;DEBESĖLIAI;5611315994;Taip;10;4;0;14
19267;Žirmūnėliai;DEBESĖLIAI;6337036947;Taip;10;0;1;11
19268;Žirmūnėliai;DEBESĖLIAI;2739395691;Ne;0;9;0;9
19269;Žirmūnėliai;DEBESĖLIAI;7528704460;Taip;10;4;0;14
19270;Žirmūnėliai;DEBESĖLIAI;8623037038;Taip;3;0;0;3
19271;Žirmūnėliai;DEBESĖLIAI;3006508357;Ne;5;5;2;12
19272;Žirmūnėliai;DEBESĖLIAI;5125341440;Taip;10;4;0;14
19273;Žirmūnėliai;DEBESĖLIAI;6647641423;Taip;5;9;0;14
19274;Žirmūnėliai;DEBESĖLIAI;3351861764;Taip;6;2;0;8
19275;Žirmūnėliai;DEBESĖLIAI;3274576752;Taip;21;0;0;21
19276;Žirmūnėliai;DEBESĖLIAI;1234956674;Taip;5;0;0;5
19277;Žirmūnėliai;DEBESĖLIAI;3540307559;Taip;6;0;0;6
19278;Žirmūnėliai;VIŠČIUKAI;6597451758;Taip;6;0;1;7
19279;Žirmūnėliai;VIŠČIUKAI;6875484657;Taip;8;0;3;11
19280;Žirmūnėliai;VIŠČIUKAI;7410921362;Taip;0;0;1;1
19281;Žirmūnėliai;VIŠČIUKAI;3431320961;Taip;4;0;4;8
19282;Žirmūnėliai;VIŠČIUKAI;3532895278;Taip;9;0;0;9
19283;Žirmūnėliai;VIŠČIUKAI;8432654056;Taip;2;0;0;2
19284;Žirmūnėliai;VIŠČIUKAI;8538773532;Taip;0;0;2;2
19285;Žirmūnėliai;VIŠČIUKAI;8459217612;Taip;5;1;0;6
19286;Žirmūnėliai;VIŠČIUKAI;2959090234;Taip;8;0;1;9
19287;Žirmūnėliai;VIŠČIUKAI;9871163622;Taip;6;0;0;6
19288;Žirmūnėliai;VIŠČIUKAI;5089884149;Taip;4;0;0;4
19289;Žirmūnėliai;VIŠČIUKAI;1356219744;Taip;0;15;0;15
19290;Žirmūnėliai;VIŠČIUKAI;1791977446;Ne;9;2;0;11
19291;Žirmūnėliai;VIŠČIUKAI;6259368139;Taip;9;1;3;13
19292;Žirmūnėliai;VIŠČIUKAI;4548601585;Taip;15;0;0;15
19293;Žirmūnėliai;VIŠČIUKAI;9367849317;Taip;4;0;0;4
19294;Žirmūnėliai;VIŠČIUKAI;9892620134;Taip;7;0;0;7
19295;Žirmūnėliai;VIŠČIUKAI;8627403283;Taip;9;0;0;9
19296;Žirmūnėliai;ZUIKUČIŲ;3562689670;Taip;6;9;0;15
19297;Žirmūnėliai;ZUIKUČIŲ;1571242696;Ne;15;0;0;15
19298;Žirmūnėliai;ZUIKUČIŲ;1401001989;Taip;8;0;0;8
19299;Žirmūnėliai;ZUIKUČIŲ;8631248243;Taip;13;1;2;16
19300;Žirmūnėliai;ZUIKUČIŲ;2866010286;Taip;6;4;0;10
19301;Žirmūnėliai;ZUIKUČIŲ;2904787614;Taip;6;4;0;10
19302;Žirmūnėliai;ZUIKUČIŲ;1025809131;Taip;14;0;2;16
19303;Žirmūnėliai;ZUIKUČIŲ;5929166560;Taip;14;0;3;17
19304;Žirmūnėliai;ZUIKUČIŲ;5104310002;Taip;9;2;0;11
19305;Žirmūnėliai;ZUIKUČIŲ;2506945279;Taip;0;14;0;14
19306;Žirmūnėliai;ZUIKUČIŲ;1473482823;Ne;5;0;0;5
19307;Žirmūnėliai;ZUIKUČIŲ;6899109664;Taip;0;7;8;15
19308;Žirmūnėliai;ZUIKUČIŲ;3949374730;Taip;9;2;0;11
19309;Žirmūnėliai;ZUIKUČIŲ;3767421827;Taip;9;0;2;11
19310;Žirmūnėliai;ZUIKUČIŲ;4327504033;Taip;11;0;1;12
19311;Žirmūnėliai;ZUIKUČIŲ;6869102228;Taip;19;0;1;20
19312;Žirmūnėliai;ZUIKUČIŲ;2841958534;Taip;6;1;0;7
19313;Žirmūnėliai;ZUIKUČIŲ;6430944858;Taip;13;0;0;13
19314;Žirmūnėliai;OBUOLIUKAI;9666769523;Taip;5;9;0;14
19315;Žirmūnėliai;OBUOLIUKAI;24877884441;Taip;6;6;0;12
19316;Žirmūnėliai;OBUOLIUKAI;85408994677;Taip;0;4;0;4
19317;Žirmūnėliai;OBUOLIUKAI;2336720944;Taip;0;1;0;1
19318;Žirmūnėliai;OBUOLIUKAI;1110585472;Taip;2;3;1;6
19319;Žirmūnėliai;OBUOLIUKAI;93072181228;Ne;2;2;0;4
19320;Žirmūnėliai;OBUOLIUKAI;1259227112;Taip;0;0;4;4
19321;Žirmūnėliai;OBUOLIUKAI;155054610;Taip;0;0;2;2
19322;Žirmūnėliai;OBUOLIUKAI;89429083939;Taip;4;1;2;7
19323;Žirmūnėliai;OBUOLIUKAI;35353356752;Ne;10;0;4;14
19324;Žirmūnėliai;OBUOLIUKAI;36305353664;Taip;0;0;1;1
19325;Žirmūnėliai;OBUOLIUKAI;4030572434;Taip;0;14;0;14
19326;Žirmūnėliai;OBUOLIUKAI;6758118659;Taip;0;14;0;14
19327;Žirmūnėliai;OBUOLIUKAI;53081289792;Taip;0;4;0;4
19328;Žirmūnėliai;OBUOLIUKAI;4675716163;Taip;0;5;2;7
19329;Žirmūnėliai;OBUOLIUKAI;2216383670;Ne;0;0;11;11
19330;Žirmūnėliai;OBUOLIUKAI;47645482781;Taip;4;0;0;4
19331;Žirmūnėliai;OBUOLIUKAI;9232201424;Ne;4;0;0;4
19332;Žirmūnėliai;OBUOLIUKAI;9448136354;Ne;0;0;10;10
19333;Žirmūnėliai;OBUOLIUKAI;2094542223;Ne;0;8;0;8
19334;Dainorėliai;VARPELIAI;11506295275;Taip;0;4;0;4
19335;Dainorėliai;VARPELIAI;87242570532;Taip;4;4;0;8
19336;Dainorėliai;VARPELIAI;31902102771;Taip;11;6;0;17
19337;Dainorėliai;VARPELIAI;18233813290;Taip;0;4;0;4
19338;Dainorėliai;VARPELIAI;6176171443;Taip;0;6;2;8
19339;Dainorėliai;VARPELIAI;88781762328;Ne;3;2;7;12
19340;Dainorėliai;VARPELIAI;9319771186;Taip;15;1;0;16
19341;Dainorėliai;VARPELIAI;7822546498;Taip;0;5;0;5
19342;Dainorėliai;VARPELIAI;8719834064;Taip;0;8;3;11
19343;Dainorėliai;VARPELIAI;5693385617;Taip;0;7;0;7
19344;Dainorėliai;VARPELIAI;8267213392;Ne;0;8;4;12
19345;Dainorėliai;VARPELIAI;5959380807;Taip;5;4;0;9
19346;Dainorėliai;VARPELIAI;2938732886;Taip;3;4;0;7
19347;Dainorėliai;VARPELIAI;3183793211;Taip;0;6;6;12
19348;Dainorėliai;VARPELIAI;2797544232;Taip;5;4;0;9
19349;Dainorėliai;VARPELIAI;65467351140;Taip;12;4;0;16
19350;Dainorėliai;VARPELIAI;8521878734;Taip;4;4;0;8
19351;Dainorėliai;VARPELIAI;1928369859;Taip;2;2;2;6
19352;Dainorėliai;VARPELIAI;6909583023;Taip;0;0;4;4
19353;Dainorėliai;VARPELIAI;6430425182;Taip;6;4;0;10
19354;Dainorėliai;VARPELIAI;4269946363;Taip;5;1;4;10
19355;Dainorėliai;VARPELIAI;1088248393;Taip;0;3;7;10
19356;Dainorėliai;ŽIOGELIAI;99597416067;Taip;0;4;0;4
19357;Dainorėliai;ŽIOGELIAI;88201007119;Taip;0;5;2;7
19358;Dainorėliai;ŽIOGELIAI;31267856584;Ne;0;5;4;9
19359;Dainorėliai;ŽIOGELIAI;87717571411;Taip;0;4;0;4
19360;Dainorėliai;ŽIOGELIAI;18936645521;Ne;12;4;0;16
19361;Dainorėliai;ŽIOGELIAI;97947842490;Taip;0;4;0;4
19362;Dainorėliai;ŽIOGELIAI;35528654099;Taip;0;4;0;4
19363;Dainorėliai;ŽIOGELIAI;29132059636;Taip;0;4;0;4
19364;Dainorėliai;ŽIOGELIAI;32573583030;Taip;0;5;1;6
19365;Dainorėliai;ŽIOGELIAI;1470784692;Taip;0;4;0;4
19366;Dainorėliai;ŽIOGELIAI;35134511946;Taip;0;3;0;3
19367;Dainorėliai;ŽIOGELIAI;67124516230;Taip;0;3;2;5
19368;Dainorėliai;ŽIOGELIAI;17358842027;Taip;0;5;5;10
19369;Dainorėliai;ŽIOGELIAI;54344466523;Taip;0;2;0;2
19370;Dainorėliai;ŽIOGELIAI;63211091321;Taip;0;5;3;8
19371;Dainorėliai;ŽIOGELIAI;45577031767;Taip;0;15;0;15
19372;Dainorėliai;ŽIOGELIAI;92157879830;Ne;0;4;1;5
19373;Dainorėliai;ŽIOGELIAI;80499999855;Taip;0;4;0;4
19374;Dainorėliai;ŽIOGELIAI;72073028506;Ne;0;4;0;4
19375;Dainorėliai;ŽIOGELIAI;78002267589;Ne;0;4;5;9
19376;Dainorėliai;ŽIOGELIAI;3761026792;Taip;0;4;8;12
19377;Dainorėliai;ŽIOGELIAI;71027372459;Taip;3;1;0;4
19378;Dainorėliai;ŽIOGELIAI;58071607976;Ne;0;5;1;6
19379;Dainorėliai;DRUGELIAI;65253606353;Taip;0;4;0;4
19380;Dainorėliai;DRUGELIAI;6411939690;Taip;0;6;0;6
19381;Dainorėliai;DRUGELIAI;50432354832;Taip;0;4;4;8
19382;Dainorėliai;DRUGELIAI;19286303769;Taip;1;4;0;5
19383;Dainorėliai;DRUGELIAI;2483267929;Taip;20;0;0;20
19384;Dainorėliai;DRUGELIAI;1015870220;Taip;0;6;3;9
19385;Dainorėliai;DRUGELIAI;5212308610;Taip;0;8;1;9
19386;Dainorėliai;DRUGELIAI;6404337541;Taip;4;0;1;5
19387;Dainorėliai;DRUGELIAI;94480397292;Taip;15;0;0;15
19388;Dainorėliai;DRUGELIAI;53935690864;Taip;17;0;0;17
19389;Dainorėliai;DRUGELIAI;27521381629;Taip;0;1;0;1
19390;Dainorėliai;DRUGELIAI;86187568203;Taip;0;4;5;9
19391;Dainorėliai;DRUGELIAI;5238082419;Taip;6;0;3;9
19392;Dainorėliai;DRUGELIAI;49483881135;Taip;0;4;1;5
19393;Dainorėliai;DRUGELIAI;1626877066;Taip;5;3;1;9
19394;Dainorėliai;DRUGELIAI;1158895670;Ne;11;0;0;11
19395;Dainorėliai;DRUGELIAI;4087344015;Taip;0;6;5;11
19396;Dainorėliai;DRUGELIAI;3128897752;Taip;2;0;1;3
19397;Dainorėliai;DRUGELIAI;1357413314;Taip;3;5;1;9
19398;Dainorėliai;DRUGELIAI;1515552402;Ne;0;4;0;4
19399;Dainorėliai;DRUGELIAI;36313982965;Taip;0;1;0;1
19400;Dainorėliai;"1 klasė";1889037823;Ne;3;4;0;7
19401;Dainorėliai;"1 klasė";2922026996;Taip;0;4;0;4
19402;Dainorėliai;"1 klasė";2441164154;Taip;5;4;0;9
19403;Dainorėliai;"1 klasė";69556449215;Taip;0;4;0;4
19404;Dainorėliai;"1 klasė";98796240124;Taip;2;4;0;6
19405;Dainorėliai;"1 klasė";37660372564;Taip;0;4;0;4
19406;Dainorėliai;"1 klasė";13138644060;Taip;0;4;0;4
19407;Dainorėliai;"1 klasė";84084897419;Taip;0;4;0;4
19408;Dainorėliai;"1 klasė";98830139164;Taip;3;4;0;7
19409;Dainorėliai;"1 klasė";37708779599;Taip;0;4;0;4
19410;Dainorėliai;"1 klasė";18741625569;Ne;0;4;0;4
19411;Dainorėliai;"1 klasė";84424772471;Taip;0;4;0;4
19412;Dainorėliai;"1 klasė";34686211072;Taip;5;4;0;9
19413;Dainorėliai;"1 klasė";79461209783;Ne;5;4;0;9
19414;Dainorėliai;"1 klasė";47323045857;Taip;2;4;0;6
19415;Dainorėliai;"1 klasė";10679627657;Taip;0;4;0;4
19416;Dainorėliai;"1 klasė";25073134850;Taip;0;4;0;4
19417;Dainorėliai;"1 klasė";84999972369;Taip;0;4;0;4
19418;Dainorėliai;"1 klasė";69732047046;Taip;9;4;0;13
19419;Dainorėliai;"1 klasė";49342277188;Ne;2;4;0;6
19420;Dainorėliai;"1 klasė";34219208558;Taip;0;4;0;4
19421;Dainorėliai;"1 klasė";8244355193;Ne;1;4;0;5
19422;Dainorėliai;"1 klasė";65118883315;Taip;0;4;0;4
19423;Dainorėliai;"1 klasė";42402953271;Ne;0;4;0;4
19424;Dainorėliai;"1 klasė";2045625141;Taip;0;4;0;4
19425;Dainorėliai;"1 klasė";2142553899;Taip;3;4;0;7
19426;Dainorėliai;"2 klasė";26315465923;Taip;1;4;0;5
19427;Dainorėliai;"2 klasė";84749521489;Taip;6;4;0;10
19428;Dainorėliai;"2 klasė";6203511535;Ne;3;4;0;7
19429;Dainorėliai;"2 klasė";23144978287;Taip;3;4;0;7
19430;Dainorėliai;"2 klasė";29726515194;Taip;4;4;0;8
19431;Dainorėliai;"2 klasė";24048489264;Ne;0;4;0;4
19432;Dainorėliai;"2 klasė";69409530494;Taip;0;4;0;4
19433;Dainorėliai;"2 klasė";93738984644;Taip;1;4;0;5
19434;Dainorėliai;"2 klasė";77907054102;Taip;0;4;0;4
19435;Dainorėliai;"2 klasė";4773358825;Taip;7;4;0;11
19436;Dainorėliai;"2 klasė";65982869126;Ne;2;4;0;6
19437;Dainorėliai;"2 klasė";8562371599;Taip;0;4;0;4
19438;Dainorėliai;"2 klasė";19292860218;Taip;0;4;0;4
19439;Dainorėliai;"2 klasė";81956978417;Taip;2;4;0;6
19440;Dainorėliai;"2 klasė";91457137356;Taip;0;4;0;4
19441;Dainorėliai;"2 klasė";97182565649;Taip;1;4;0;5
19442;Dainorėliai;"2 klasė";3018657993;Taip;0;4;0;4
19443;Dainorėliai;"2 klasė";5010994621;Taip;0;4;0;4
19444;Dainorėliai;"2 klasė";57179351170;Taip;3;4;0;7
19445;Dainorėliai;"2 klasė";48245075123;Taip;0;4;0;4
19446;Dainorėliai;"2 klasė";14664307658;Ne;0;4;0;4
19447;Dainorėliai;"2 klasė";57618865048;Taip;0;4;0;4
19448;Dainorėliai;"2 klasė";13846131820;Taip;0;4;0;4
19449;Dainorėliai;"3 klasė";4792505132;Taip;1;4;0;5
19450;Dainorėliai;"3 klasė";9028699114;Taip;4;4;0;8
19451;Dainorėliai;"3 klasė";1629229178;Ne;0;4;0;4
19452;Dainorėliai;"3 klasė";3109138914;Taip;0;4;0;4
19453;Dainorėliai;"3 klasė";6513001151;Taip;0;4;0;4
19454;Dainorėliai;"3 klasė";7332518731;Taip;0;4;0;4
19455;Dainorėliai;"3 klasė";7013545705;Taip;1;4;0;5
19456;Dainorėliai;"3 klasė";5181789063;Taip;0;4;0;4
19457;Dainorėliai;"3 klasė";4642369086;Taip;1;4;0;5
19458;Dainorėliai;"3 klasė";7589862952;Ne;0;4;0;4
19459;Dainorėliai;"3 klasė";2135997501;Taip;1;4;0;5
19460;Dainorėliai;"3 klasė";2991348691;Taip;6;4;0;10
19461;Dainorėliai;"3 klasė";1472986325;Ne;0;4;0;4
19462;Dainorėliai;"3 klasė";9691052273;Taip;1;4;0;5
19463;Dainorėliai;"3 klasė";4631981231;Ne;1;4;0;5
19464;Dainorėliai;"3 klasė";6576505338;Ne;3;4;0;7
19465;Dainorėliai;"3 klasė";47031645815;Ne;5;4;0;9
19466;Dainorėliai;"3 klasė";1734712911;Taip;2;4;0;6
19467;Dainorėliai;"3 klasė";6898321145;Taip;0;4;0;4
19468;Dainorėliai;"3 klasė";8014881349;Taip;1;4;0;5
19469;Dainorėliai;"3 klasė";2685423821;Taip;5;4;0;9
19470;Dainorėliai;"3 klasė";3713835329;Taip;1;4;0;5
19471;Dainorėliai;"3 klasė";4309610318;Taip;2;4;0;6
19472;Dainorėliai;"3 klasė";3916502039;Taip;4;4;0;8
19473;Dainorėliai;"4 klasė";1289801462;Taip;0;4;0;4
19474;Dainorėliai;"4 klasė";7327414673;Taip;0;4;0;4
19475;Dainorėliai;"4 klasė";6497830034;Taip;2;4;0;6
19476;Dainorėliai;"4 klasė";8569165891;Taip;0;4;0;4
19477;Dainorėliai;"4 klasė";7309477306;Taip;0;4;0;4
19478;Dainorėliai;"4 klasė";3683531357;Ne;2;4;0;6
19479;Dainorėliai;"4 klasė";4490125789;Taip;2;4;0;6
19480;Dainorėliai;"4 klasė";4497264004;Taip;0;4;0;4
19481;Dainorėliai;"4 klasė";2704452184;Taip;0;4;0;4
19482;Dainorėliai;"4 klasė";5468429196;Taip;0;4;0;4
19483;Dainorėliai;"4 klasė";2519518637;Taip;0;4;0;4
19484;Dainorėliai;"4 klasė";5072041112;Taip;0;4;0;4
19485;Dainorėliai;"4 klasė";1347410803;Taip;0;4;0;4
19486;Dainorėliai;"4 klasė";2164782968;Ne;0;4;0;4
19487;Dainorėliai;"4 klasė";1311444933;Taip;0;4;0;4
19488;Dainorėliai;"4 klasė";3053044929;Taip;0;4;0;4
19489;Dainorėliai;"4 klasė";5177714429;Ne;2;4;0;6
19490;Dainorėliai;"4 klasė";4275023010;Taip;2;4;0;6
19491;Dainorėliai;"4 klasė";74881322515;Taip;5;4;0;9
19492;Dainorėliai;"4 klasė";4691497223;Taip;2;4;0;6
19493;Dainorėliai;SAULUTĖS;4798415786;Ne;9;0;0;9
19494;Dainorėliai;SAULUTĖS;5102030168;Ne;10;0;0;10
19495;Dainorėliai;SAULUTĖS;6385439136;Taip;0;5;0;5
19496;Dainorėliai;SAULUTĖS;6704354150;Taip;6;4;0;10
19497;Dainorėliai;SAULUTĖS;4612995336;Taip;5;0;0;5
19498;Dainorėliai;SAULUTĖS;5687390372;Taip;0;5;0;5
19499;Dainorėliai;SAULUTĖS;6697149560;Taip;6;0;0;6
19500;Dainorėliai;SAULUTĖS;8977759216;Ne;12;3;0;15
19501;Dainorėliai;SAULUTĖS;8857018998;Taip;3;5;0;8
19502;Dainorėliai;SAULUTĖS;7118473669;Ne;2;2;0;4
19503;Dainorėliai;SAULUTĖS;4307591123;Taip;0;10;0;10
19504;Dainorėliai;SAULUTĖS;2070086316;Taip;0;4;0;4
19505;Dainorėliai;SAULUTĖS;5632663846;Taip;21;0;0;21
19506;Dainorėliai;SAULUTĖS;7804441689;Taip;4;0;0;4
19507;Dainorėliai;SAULUTĖS;6090746954;Taip;0;4;0;4
19508;Dainorėliai;SAULUTĖS;5410183494;Taip;10;4;0;14
19509;Dainorėliai;SAULUTĖS;9130473411;Taip;2;0;1;3
19510;Dainorėliai;SAULUTĖS;5587907483;Ne;13;4;0;17
19511;Dainorėliai;SAULUTĖS;1547686786;Ne;16;0;0;16
19512;Dainorėliai;SAULUTĖS;1552829080;Taip;0;5;0;5
19513;Dainorėliai;PUMPURĖLIŲ;6513417505;Taip;9;11;0;20
19514;Dainorėliai;PUMPURĖLIŲ;5605084046;Taip;0;8;2;10
19515;Dainorėliai;PUMPURĖLIŲ;8015545426;Taip;0;4;1;5
19516;Dainorėliai;PUMPURĖLIŲ;5691833295;Taip;0;8;0;8
19517;Dainorėliai;PUMPURĖLIŲ;4286864865;Taip;5;7;0;12
19518;Dainorėliai;PUMPURĖLIŲ;1554081754;Taip;15;8;0;23
19519;Dainorėliai;PUMPURĖLIŲ;2823401633;Taip;7;4;0;11
19520;Dainorėliai;PUMPURĖLIŲ;7054808979;Ne;10;6;0;16
19521;Dainorėliai;PUMPURĖLIŲ;9562194143;Taip;0;0;11;11
19522;Dainorėliai;PUMPURĖLIŲ;1381923971;Taip;0;20;0;20
19523;Dainorėliai;PUMPURĖLIŲ;4033317616;Taip;8;7;0;15
19524;Dainorėliai;PUMPURĖLIŲ;6449332338;Taip;0;6;1;7
19525;Dainorėliai;PUMPURĖLIŲ;9285865812;Taip;0;7;2;9
19526;Dainorėliai;PUMPURĖLIŲ;6284140548;Taip;15;8;0;23
19527;Dainorėliai;PUMPURĖLIŲ;5283566263;Taip;3;9;0;12
19528;Dainorėliai;PUMPURĖLIŲ;1826360100;Taip;4;2;0;6
19529;Dainorėliai;DEBESĖLIŲ;1300411811;Taip;0;18;0;18
19530;Dainorėliai;DEBESĖLIŲ;2003536788;Taip;9;6;0;15
19531;Dainorėliai;DEBESĖLIŲ;40087119136;Taip;2;4;0;6
19532;Dainorėliai;DEBESĖLIŲ;1117389814;Taip;5;1;0;6
19533;Dainorėliai;DEBESĖLIŲ;14071513289;Taip;0;6;0;6
19534;Dainorėliai;DEBESĖLIŲ;6378297641;Taip;0;8;0;8
19535;Dainorėliai;DEBESĖLIŲ;40762091796;Ne;6;10;0;16
19536;Dainorėliai;DEBESĖLIŲ;6373805301;Ne;0;17;0;17
19537;Dainorėliai;DEBESĖLIŲ;1355661922;Taip;8;5;0;13
19538;Dainorėliai;DEBESĖLIŲ;5189351158;Ne;0;2;0;2
19539;Dainorėliai;DEBESĖLIŲ;42514000113;Ne;0;9;0;9
19540;Dainorėliai;DEBESĖLIŲ;2093218810;Taip;7;7;0;14
19541;Dainorėliai;DEBESĖLIŲ;4058545269;Taip;0;6;0;6
19542;Dainorėliai;DEBESĖLIŲ;2531690903;Taip;0;13;0;13
19543;Dainorėliai;DEBESĖLIŲ;74139269246;Taip;2;2;0;4
19544;Dainorėliai;DEBESĖLIŲ;1046385778;Taip;0;10;0;10
19545;Dainorėliai;DEBESĖLIŲ;25015347703;Taip;4;17;0;21
19546;Dainorėliai;DEBESĖLIŲ;6994378824;Taip;3;9;0;12
19547;Dainorėliai;DEBESĖLIŲ;4112888398;Taip;0;8;0;8
19548;Lokiukas;BITUTĖS;6758550653;Taip;12;7;0;19
19549;Lokiukas;BITUTĖS;1040288021;Taip;13;4;0;17
19550;Lokiukas;BITUTĖS;1733486244;Taip;6;4;0;10
19551;Lokiukas;BITUTĖS;6336140882;Taip;5;4;6;15
19552;Lokiukas;BITUTĖS;9142262360;Taip;9;5;1;15
19553;Lokiukas;BITUTĖS;8775608581;Taip;0;4;3;7
19554;Lokiukas;BITUTĖS;1752784666;Taip;7;4;0;11
19555;Lokiukas;BITUTĖS;34546519642;Taip;5;4;0;9
19556;Lokiukas;BITUTĖS;7305062511;Taip;4;1;0;5
19557;Lokiukas;BITUTĖS;1025576053;Taip;8;3;1;12
19558;Lokiukas;BITUTĖS;6069516217;Taip;5;6;0;11
19559;Lokiukas;BITUTĖS;7943213321;Taip;14;3;0;17
19560;Lokiukas;BITUTĖS;8915504279;Taip;0;3;0;3
19561;Lokiukas;BITUTĖS;4007839265;Taip;8;4;0;12
19562;Lokiukas;BITUTĖS;8796640190;Taip;8;4;0;12
19563;Lokiukas;BITUTĖS;5943412920;Taip;7;4;0;11
19564;Lokiukas;BITUTĖS;2885398200;Taip;10;5;0;15
19565;Lokiukas;BITUTĖS;3694653020;Taip;12;0;0;12
19566;Lokiukas;BITUTĖS;4379238557;Taip;0;11;0;11
19567;Lokiukas;BITUTĖS;2052174669;Taip;9;7;0;16
19568;Lokiukas;BITUTĖS;8902619265;Taip;5;8;0;13
19569;Lokiukas;BITUTĖS;9336617879;Taip;0;5;5;10
19570;Lokiukas;BITUTĖS;3485639108;Taip;0;5;0;5
19571;Lokiukas;BITUTĖS;4060641736;Ne;0;2;2;4
19572;Lokiukas;"1 B klasė";18336619115;Taip;7;0;0;7
19573;Lokiukas;"1 B klasė";32506466236;Taip;11;0;0;11
19574;Lokiukas;"1 B klasė";7324496782;Taip;21;0;0;21
19575;Lokiukas;"1 B klasė";10811780420;Taip;6;0;0;6
19576;Lokiukas;"1 B klasė";28796727185;Taip;12;0;0;12
19577;Lokiukas;"1 B klasė";96046361641;Taip;6;0;0;6
19578;Lokiukas;"1 B klasė";95910336503;Taip;6;0;0;6
19579;Lokiukas;"1 B klasė";88415635113;Taip;15;0;0;15
19580;Lokiukas;"1 B klasė";7497324442;Ne;21;0;0;21
19581;Lokiukas;"1 B klasė";7903535850;Taip;7;0;0;7
19582;Lokiukas;"1 B klasė";61890775725;Taip;7;0;0;7
19583;Lokiukas;"1 B klasė";24221829774;Taip;13;0;0;13
19584;Lokiukas;"1 B klasė";58513885211;Taip;8;0;0;8
19585;Lokiukas;"1 B klasė";57958699478;Ne;12;0;0;12
19586;Lokiukas;"1 B klasė";79109699217;Taip;6;0;0;6
19587;Lokiukas;"1 B klasė";18646642032;Taip;5;0;0;5
19588;Lokiukas;"1 B klasė";50713289266;Ne;5;0;0;5
19589;Lokiukas;"1 B klasė";20231469825;Ne;7;0;0;7
19590;Lokiukas;"1 B klasė";1146878499;Taip;6;0;0;6
19591;Lokiukas;"1 B klasė";46587243900;Taip;11;0;0;11
19592;Lokiukas;"1 B klasė";9141446821;Taip;10;0;0;10
19593;Lokiukas;"1 B klasė";75507005694;Taip;9;0;0;9
19594;Lokiukas;"1 B klasė";73426072972;Ne;15;0;0;15
19595;Lokiukas;"1 B klasė";59913848400;Taip;10;0;0;10
19596;Lokiukas;"1 B klasė";39867459515;Taip;10;0;0;10
19597;Lokiukas;"1 B klasė";2105377652;Taip;4;0;0;4
19598;Lokiukas;"1 B klasė";62268017779;Taip;11;0;0;11
19599;Lokiukas;"1 A klasė";15406362908;Taip;7;0;0;7
19600;Lokiukas;"1 A klasė";45122233067;Taip;6;0;0;6
19601;Lokiukas;"1 A klasė";21802863853;Taip;6;0;0;6
19602;Lokiukas;"1 A klasė";84682977618;Taip;4;0;0;4
19603;Lokiukas;"1 A klasė";22979689191;Taip;9;0;0;9
19604;Lokiukas;"1 A klasė";80754592972;Taip;7;0;0;7
19605;Lokiukas;"1 A klasė";14903100496;Taip;5;0;0;5
19606;Lokiukas;"1 A klasė";99706061553;Taip;5;0;0;5
19607;Lokiukas;"1 A klasė";7785940412;Taip;21;0;0;21
19608;Lokiukas;"1 A klasė";24099693663;Taip;21;0;0;21
19609;Lokiukas;"1 A klasė";72092394330;Taip;8;0;0;8
19610;Lokiukas;"1 A klasė";9413274607;Taip;6;0;0;6
19611;Lokiukas;"1 A klasė";35769782473;Taip;7;0;0;7
19612;Lokiukas;"1 A klasė";38531751377;Taip;6;0;0;6
19613;Lokiukas;"1 A klasė";80793623068;Ne;20;0;0;20
19614;Lokiukas;"1 A klasė";25170045140;Ne;21;0;0;21
19615;Lokiukas;"1 A klasė";10948160841;Taip;21;0;0;21
19616;Lokiukas;"1 A klasė";4608275224;Taip;10;0;0;10
19617;Lokiukas;"1 A klasė";43070670534;Taip;4;0;0;4
19618;Lokiukas;"1 A klasė";59840033826;Taip;21;0;0;21
19619;Lokiukas;"1 A klasė";1855267362;Taip;6;0;0;6
19620;Lokiukas;"1 A klasė";84273668685;Taip;7;0;0;7
19621;Lokiukas;"1 A klasė";9747265775;Taip;7;0;0;7
19622;Lokiukas;"1 A klasė";5198408183;Taip;5;0;0;5
19623;Lokiukas;"1 A klasė";93374754851;Ne;10;0;0;10
19624;Lokiukas;"1 A klasė";15685936471;Taip;9;0;0;9
19625;Lokiukas;"1 A klasė";97609897018;Taip;8;0;0;8
19626;Lokiukas;"1 A klasė";23688235312;Taip;11;0;0;11
19627;Lokiukas;"1 A klasė";15574258138;Ne;7;0;0;7
19628;Lokiukas;"1 A klasė";9077016953;Taip;8;0;0;8
19629;Lokiukas;GUDRUČIAI;7334971595;Ne;0;4;3;7
19630;Lokiukas;GUDRUČIAI;83279104490;Taip;0;4;0;4
19631;Lokiukas;GUDRUČIAI;7235277422;Taip;8;5;0;13
19632;Lokiukas;GUDRUČIAI;7130407913;Taip;8;4;0;12
19633;Lokiukas;GUDRUČIAI;1072148409;Taip;7;5;0;12
19634;Lokiukas;GUDRUČIAI;57505829630;Taip;5;4;0;9
19635;Lokiukas;GUDRUČIAI;7628603262;Taip;0;4;0;4
19636;Lokiukas;GUDRUČIAI;2959877846;Taip;6;4;0;10
19637;Lokiukas;GUDRUČIAI;32714964224;Taip;0;4;0;4
19638;Lokiukas;GUDRUČIAI;8920359311;Taip;0;5;0;5
19639;Lokiukas;GUDRUČIAI;1133294157;Taip;17;4;0;21
19640;Lokiukas;GUDRUČIAI;38884246104;Ne;0;4;2;6
19641;Lokiukas;GUDRUČIAI;29396361769;Taip;0;4;0;4
19642;Lokiukas;GUDRUČIAI;51059574159;Taip;2;3;0;5
19643;Lokiukas;GUDRUČIAI;61807094999;Taip;7;0;0;7
19644;Lokiukas;GUDRUČIAI;2955445066;Ne;4;4;3;11
19645;Lokiukas;BORUŽĖLĖS;4849031542;Taip;0;11;0;11
19646;Lokiukas;BORUŽĖLĖS;9307491947;Taip;16;1;0;17
19647;Lokiukas;BORUŽĖLĖS;3744484616;Taip;2;6;0;8
19648;Lokiukas;BORUŽĖLĖS;8286358519;Taip;0;4;0;4
19649;Lokiukas;BORUŽĖLĖS;2625981190;Taip;5;0;1;6
19650;Lokiukas;BORUŽĖLĖS;4585621105;Taip;0;1;0;1
19651;Lokiukas;BORUŽĖLĖS;5522089503;Taip;8;4;2;14
19652;Lokiukas;BORUŽĖLĖS;8576418875;Taip;7;10;0;17
19653;Lokiukas;BORUŽĖLĖS;4617372387;Taip;4;2;0;6
19654;Lokiukas;BORUŽĖLĖS;6869785650;Taip;0;4;0;4
19655;Lokiukas;BORUŽĖLĖS;8630112458;Taip;17;4;0;21
19656;Lokiukas;BORUŽĖLĖS;5467387832;Ne;11;4;0;15
19657;Lokiukas;BORUŽĖLĖS;6245610875;Taip;0;9;0;9
19658;Lokiukas;BORUŽĖLĖS;3930463578;Taip;4;4;2;10
19659;Lokiukas;BORUŽĖLĖS;5548875714;Taip;7;0;0;7
19660;Lokiukas;BORUŽĖLĖS;6277388612;Taip;14;1;0;15
19661;Lokiukas;BORUŽĖLĖS;1833001939;Taip;6;10;0;16
19662;Lokiukas;BORUŽĖLĖS;2660616022;Taip;2;4;1;7
19663;Lokiukas;BORUŽĖLĖS;9798351980;Taip;7;2;0;9
19664;Lokiukas;BORUŽĖLĖS;5401463671;Ne;7;2;0;9
19665;Lokiukas;BORUŽĖLĖS;9996442005;Ne;7;2;0;9
19666;Lokiukas;BORUŽĖLĖS;4317453894;Taip;3;0;0;3
19667;Lokiukas;BORUŽĖLĖS;1226376844;Ne;0;5;5;10
19668;Lokiukas;ANČIUKAI;5518041213;Taip;8;0;1;9
19669;Lokiukas;ANČIUKAI;8738488104;Taip;12;0;0;12
19670;Lokiukas;ANČIUKAI;9834746275;Taip;0;3;3;6
19671;Lokiukas;ANČIUKAI;4197547631;Taip;0;7;0;7
19672;Lokiukas;ANČIUKAI;7783006852;Taip;7;0;1;8
19673;Lokiukas;ANČIUKAI;8596706753;Taip;7;4;0;11
19674;Lokiukas;ANČIUKAI;7006828256;Taip;10;0;0;10
19675;Lokiukas;ANČIUKAI;2782818158;Taip;0;2;0;2
19676;Lokiukas;ANČIUKAI;1170293017;Taip;6;4;0;10
19677;Lokiukas;ANČIUKAI;7532603655;Taip;0;8;0;8
19678;Lokiukas;ANČIUKAI;2021477393;Taip;11;3;0;14
19679;Lokiukas;ANČIUKAI;4442073527;Taip;0;7;0;7
19680;Lokiukas;ANČIUKAI;8329540746;Taip;0;0;3;3
19681;Lokiukas;KODĖLČIUKAI;2548712970;Taip;5;5;0;10
19682;Lokiukas;KODĖLČIUKAI;2673522432;Taip;17;4;0;21
19683;Lokiukas;KODĖLČIUKAI;9625041533;Ne;0;4;2;6
19684;Lokiukas;KODĖLČIUKAI;8399364170;Taip;8;5;0;13
19685;Lokiukas;KODĖLČIUKAI;4427448272;Taip;9;4;0;13
19686;Lokiukas;KODĖLČIUKAI;4580716838;Taip;4;5;0;9
19687;Lokiukas;KODĖLČIUKAI;1201125655;Taip;7;5;1;13
19688;Lokiukas;KODĖLČIUKAI;67133709394;Taip;12;0;0;12
19689;Lokiukas;KODĖLČIUKAI;73696992182;Taip;2;6;0;8
19690;Lokiukas;KODĖLČIUKAI;1056075876;Taip;0;3;0;3
19691;Lokiukas;KODĖLČIUKAI;82025637099;Taip;5;0;0;5
19692;Lokiukas;KODĖLČIUKAI;73515179103;Taip;13;4;0;17
19693;Lokiukas;KODĖLČIUKAI;36677665098;Taip;4;3;0;7
19694;Lokiukas;KODĖLČIUKAI;131300206;Taip;10;3;0;13
19695;Lokiukas;KODĖLČIUKAI;66528256040;Taip;10;4;0;14
19696;Lokiukas;KODĖLČIUKAI;7495691956;Ne;5;6;0;11
19697;Lokiukas;KODĖLČIUKAI;1333650630;Ne;15;4;0;19
19698;Lokiukas;KODĖLČIUKAI;52940830874;Taip;10;4;0;14
19699;Lokiukas;KODĖLČIUKAI;8240261104;Taip;2;4;0;6
19700;Lokiukas;KODĖLČIUKAI;41809745552;Taip;3;4;1;8
19701;Lokiukas;KODĖLČIUKAI;83086633109;Taip;12;4;0;16
19702;Lokiukas;KODĖLČIUKAI;4353695640;Ne;0;3;1;4
19703;Lokiukas;DRUGELIAI;7942641594;Taip;8;0;0;8
19704;Lokiukas;DRUGELIAI;8568285232;Taip;0;6;0;6
19705;Lokiukas;DRUGELIAI;5453470660;Taip;9;5;0;14
19706;Lokiukas;DRUGELIAI;5879386524;Taip;11;0;0;11
19707;Lokiukas;DRUGELIAI;14605095801;Taip;0;6;0;6
19708;Lokiukas;DRUGELIAI;46838695582;Taip;9;6;0;15
19709;Lokiukas;DRUGELIAI;2642065594;Taip;5;3;0;8
19710;Lokiukas;DRUGELIAI;1626698185;Taip;0;4;0;4
19711;Lokiukas;DRUGELIAI;39222094073;Taip;16;0;0;16
19712;Lokiukas;DRUGELIAI;1695680881;Ne;9;4;0;13
19713;Lokiukas;DRUGELIAI;69364831994;Taip;7;4;0;11
19714;Lokiukas;DRUGELIAI;39975872119;Taip;0;1;0;1
19715;Lokiukas;DRUGELIAI;78106313493;Taip;9;5;0;14
19716;Lokiukas;DRUGELIAI;1625137322;Taip;2;6;0;8
19717;Lokiukas;DRUGELIAI;1381505711;Taip;21;0;0;21
19718;Lokiukas;DRUGELIAI;8452600632;Taip;12;4;0;16
19719;Lokiukas;DRUGELIAI;7386571822;Ne;19;0;0;19
19720;Lokiukas;DRUGELIAI;35890122494;Taip;12;4;0;16
19721;Lokiukas;DRUGELIAI;1210407640;Taip;7;5;1;13
19722;Lokiukas;DRUGELIAI;7591418969;Taip;15;4;0;19
19723;Lokiukas;DRUGELIAI;8270572748;Taip;0;1;0;1
19724;Lokiukas;DRUGELIAI;8036643654;Taip;12;4;1;17
19725;Lokiukas;DRUGELIAI;2476231041;Ne;8;4;0;12
19726;Lokiukas;"2 A klasė";67818191566;Ne;6;0;0;6
19727;Lokiukas;"2 A klasė";45280536946;Taip;21;0;0;21
19728;Lokiukas;"2 A klasė";53087036306;Taip;21;0;0;21
19729;Lokiukas;"2 A klasė";79223457439;Ne;12;0;0;12
19730;Lokiukas;"2 A klasė";75613665040;Taip;15;0;0;15
19731;Lokiukas;"2 A klasė";1143130271;Taip;10;0;0;10
19732;Lokiukas;"2 A klasė";86623153797;Taip;10;0;0;10
19733;Lokiukas;"2 A klasė";27050402360;Ne;5;0;0;5
19734;Lokiukas;"2 A klasė";43389930516;Taip;11;0;0;11
19735;Lokiukas;"2 A klasė";53245573692;Taip;7;0;0;7
19736;Lokiukas;"2 A klasė";23222644824;Taip;8;0;0;8
19737;Lokiukas;"2 A klasė";52296454506;Ne;5;0;0;5
19738;Lokiukas;"2 A klasė";66999644935;Taip;21;0;0;21
19739;Lokiukas;"2 A klasė";72167964645;Ne;10;0;0;10
19740;Lokiukas;"2 A klasė";2143040924;Taip;21;0;0;21
19741;Lokiukas;"2 A klasė";3206276637;Taip;21;0;0;21
19742;Lokiukas;"2 A klasė";5775631777;Ne;11;0;0;11
19743;Lokiukas;"2 A klasė";25058082693;Ne;21;0;0;21
19744;Lokiukas;"2 A klasė";38636200254;Ne;7;0;0;7
19745;Lokiukas;"2 A klasė";47410036889;Taip;5;0;0;5
19746;Lokiukas;"2 A klasė";53544600623;Taip;16;0;0;16
19747;Lokiukas;"2 A klasė";14341255985;Taip;17;0;0;17
19748;Lokiukas;"2 A klasė";6702448475;Taip;13;0;0;13
19749;Lokiukas;"2 A klasė";82966541165;Taip;5;0;0;5
19750;Lokiukas;"2 A klasė";80180114948;Taip;8;0;0;8
19751;Lokiukas;"2 A klasė";42292408557;Taip;6;0;0;6
19752;Lokiukas;"2 A klasė";10240586503;Taip;21;0;0;21
19753;Lokiukas;"2 A klasė";3703002168;Taip;6;0;0;6
19754;Lokiukas;"2 B klasė";35018370441;Taip;4;0;0;4
19755;Lokiukas;"2 B klasė";60370754283;Taip;4;0;0;4
19756;Lokiukas;"2 B klasė";98289469398;Taip;4;0;0;4
19757;Lokiukas;"2 B klasė";15445053855;Taip;6;0;0;6
19758;Lokiukas;"2 B klasė";3262579895;Taip;4;0;0;4
19759;Lokiukas;"2 B klasė";51554951703;Taip;10;0;0;10
19760;Lokiukas;"2 B klasė";88947878548;Ne;5;0;0;5
19761;Lokiukas;"2 B klasė";29198900240;Taip;5;0;0;5
19762;Lokiukas;"2 B klasė";17034757778;Taip;6;0;0;6
19763;Lokiukas;"2 B klasė";1716358913;Taip;6;0;0;6
19764;Lokiukas;"2 B klasė";77441549037;Taip;5;0;0;5
19765;Lokiukas;"2 B klasė";79301547085;Ne;6;0;0;6
19766;Lokiukas;"2 B klasė";10897713744;Taip;5;0;0;5
19767;Lokiukas;"2 B klasė";16889795010;Ne;21;0;0;21
19768;Lokiukas;"2 B klasė";45805925058;Taip;6;0;0;6
19769;Lokiukas;"2 B klasė";5067673212;Taip;7;0;0;7
19770;Lokiukas;"2 B klasė";1104333637;Taip;6;0;0;6
19771;Lokiukas;"2 B klasė";79597160668;Taip;5;0;0;5
19772;Lokiukas;"2 B klasė";45735190114;Taip;21;0;0;21
19773;Lokiukas;"2 B klasė";37669645510;Taip;5;0;0;5
19774;Lokiukas;"2 B klasė";2353550739;Taip;21;0;0;21
19775;Lokiukas;"2 B klasė";15004419516;Taip;5;0;0;5
19776;Lokiukas;"2 B klasė";69089214980;Taip;4;0;0;4
19777;Lokiukas;"3 A klasė";2374089307;Taip;4;0;0;4
19778;Lokiukas;"3 A klasė";2607988265;Taip;9;0;0;9
19779;Lokiukas;"3 A klasė";4992275038;Taip;4;0;0;4
19780;Lokiukas;"3 A klasė";1492303633;Taip;5;0;0;5
19781;Lokiukas;"3 A klasė";6856770462;Ne;7;0;0;7
19782;Lokiukas;"3 A klasė";8766212402;Ne;4;0;0;4
19783;Lokiukas;"3 A klasė";5559967651;Taip;21;0;0;21
19784;Lokiukas;"3 A klasė";3528533437;Taip;21;0;0;21
19785;Lokiukas;"3 A klasė";5465758477;Taip;4;0;0;4
19786;Lokiukas;"3 A klasė";5700685872;Ne;4;0;0;4
19787;Lokiukas;"3 A klasė";6496662759;Taip;14;0;0;14
19788;Lokiukas;"3 A klasė";5737714024;Ne;11;0;0;11
19789;Lokiukas;"3 A klasė";7069020705;Ne;6;0;0;6
19790;Lokiukas;"3 A klasė";6129602024;Ne;4;0;0;4
19791;Lokiukas;"3 A klasė";9199283952;Taip;21;0;0;21
19792;Lokiukas;"3 A klasė";8378630091;Taip;6;0;0;6
19793;Lokiukas;"3 A klasė";3138145333;Ne;21;0;0;21
19794;Lokiukas;"3 A klasė";3506723678;Taip;13;0;0;13
19795;Lokiukas;"3 A klasė";1555365851;Ne;15;0;0;15
19796;Lokiukas;"3 A klasė";4615481025;Ne;11;0;0;11
19797;Lokiukas;"3 A klasė";5889819809;Ne;4;0;0;4
19798;Lokiukas;"3 A klasė";8499895935;Taip;21;0;0;21
19799;Lokiukas;"3 A klasė";7553457572;Ne;15;0;0;15
19800;Lokiukas;"3 A klasė";1571404671;Taip;9;0;0;9
19801;Lokiukas;"3 A klasė";1729941577;Taip;12;0;0;12
19802;Lokiukas;"3 B klasė";5745254234;Taip;7;0;0;7
19803;Lokiukas;"3 B klasė";8189433550;Taip;21;0;0;21
19804;Lokiukas;"3 B klasė";9114504810;Taip;11;0;0;11
19805;Lokiukas;"3 B klasė";1048772300;Taip;11;0;0;11
19806;Lokiukas;"3 B klasė";2021690274;Taip;21;0;0;21
19807;Lokiukas;"3 B klasė";5918592397;Taip;7;0;0;7
19808;Lokiukas;"3 B klasė";6538311120;Taip;11;0;0;11
19809;Lokiukas;"3 B klasė";7595514531;Taip;9;0;0;9
19810;Lokiukas;"3 B klasė";7144013238;Ne;8;0;0;8
19811;Lokiukas;"3 B klasė";8235437961;Taip;6;0;0;6
19812;Lokiukas;"3 B klasė";2905935730;Taip;21;0;0;21
19813;Lokiukas;"3 B klasė";8395026474;Ne;7;0;0;7
19814;Lokiukas;"3 B klasė";7439047502;Taip;5;0;0;5
19815;Lokiukas;"3 B klasė";8954484534;Taip;10;0;0;10
19816;Lokiukas;"3 B klasė";7722830021;Taip;9;0;0;9
19817;Lokiukas;"3 B klasė";9681048306;Taip;6;0;0;6
19818;Lokiukas;"3 B klasė";1388342336;Taip;8;0;0;8
19819;Lokiukas;"3 B klasė";1746819279;Taip;11;0;0;11
19820;Lokiukas;"3 B klasė";4418425219;Taip;11;0;0;11
19821;Lokiukas;"3 B klasė";3364994110;Taip;21;0;0;21
19822;Lokiukas;"3 B klasė";6063796643;Taip;11;0;0;11
19823;Lokiukas;"3 B klasė";6663700618;Taip;7;0;0;7
19824;Lokiukas;"3 B klasė";6151885589;Taip;6;0;0;6
19825;Lokiukas;"3 B klasė";1440437389;Taip;6;0;0;6
19826;Lokiukas;"3 B klasė";2059112380;Taip;5;0;0;5
19827;Lokiukas;"3 B klasė";1676862169;Ne;7;0;0;7
19828;Lokiukas;"4 A klasė";2220223549;Taip;21;0;0;21
19829;Lokiukas;"4 A klasė";7349936354;Ne;21;0;0;21
19830;Lokiukas;"4 A klasė";8192834838;Taip;5;0;0;5
19831;Lokiukas;"4 A klasė";7086818828;Taip;20;0;0;20
19832;Lokiukas;"4 A klasė";8959417696;Taip;6;0;0;6
19833;Lokiukas;"4 A klasė";1362995666;Taip;4;0;0;4
19834;Lokiukas;"4 A klasė";4873942674;Taip;21;0;0;21
19835;Lokiukas;"4 A klasė";2745780921;Taip;8;0;0;8
19836;Lokiukas;"4 A klasė";3007573139;Taip;14;0;0;14
19837;Lokiukas;"4 A klasė";5058488696;Taip;8;0;0;8
19838;Lokiukas;"4 A klasė";6008557035;Taip;17;0;0;17
19839;Lokiukas;"4 A klasė";1243245356;Taip;5;0;0;5
19840;Lokiukas;"4 A klasė";9322204885;Taip;21;0;0;21
19841;Lokiukas;"4 A klasė";1822055099;Ne;21;0;0;21
19842;Lokiukas;"4 A klasė";3700837936;Taip;5;0;0;5
19843;Lokiukas;"4 A klasė";6022402998;Taip;11;0;0;11
19844;Lokiukas;"4 A klasė";9743363133;Taip;19;0;0;19
19845;Lokiukas;"4 A klasė";2029507962;Taip;10;0;0;10
19846;Lokiukas;"4 A klasė";88967710414;Taip;16;0;0;16
19847;Lokiukas;"4 A klasė";2129701351;Taip;19;0;0;19
19848;Lokiukas;"4 B klasė";1692231191;Taip;8;0;0;8
19849;Lokiukas;"4 B klasė";2284932363;Taip;21;0;0;21
19850;Lokiukas;"4 B klasė";4160279615;Taip;16;0;0;16
19851;Lokiukas;"4 B klasė";4368235682;Taip;9;0;0;9
19852;Lokiukas;"4 B klasė";9376247296;Taip;19;0;0;19
19853;Lokiukas;"4 B klasė";7943448919;Taip;6;0;0;6
19854;Lokiukas;"4 B klasė";9922964495;Taip;9;0;0;9
19855;Lokiukas;"4 B klasė";8822883914;Ne;4;0;0;4
19856;Lokiukas;"4 B klasė";6270747705;Taip;7;0;0;7
19857;Lokiukas;"4 B klasė";9390626220;Taip;21;0;0;21
19858;Lokiukas;"4 B klasė";5562737843;Taip;10;0;0;10
19859;Lokiukas;"4 B klasė";4467643205;Taip;9;0;0;9
19860;Lokiukas;"4 B klasė";6110849113;Taip;6;0;0;6
19861;Lokiukas;"4 B klasė";8175005473;Taip;16;0;0;16
19862;Lokiukas;"4 B klasė";4504812769;Taip;11;0;0;11
19863;Lokiukas;"4 B klasė";6210160161;Taip;19;0;0;19
19864;Lokiukas;"4 B klasė";1860245985;Ne;21;0;0;21
19865;Lokiukas;"4 B klasė";1727242060;Taip;21;0;0;21
19866;Lokiukas;"4 B klasė";8300861451;Taip;17;0;0;17
19867;Lokiukas;"4 B klasė";7692067948;Taip;7;0;0;7
19868;Lokiukas;"4 B klasė";7728788069;Taip;21;0;0;21
19869;Lokiukas;"4 B klasė";9985555940;Taip;21;0;0;21
19870;Lokiukas;"4 B klasė";4447860405;Taip;21;0;0;21
19871;Lokiukas;"4 B klasė";3823547337;Taip;5;0;0;5
19872;Lokiukas;"4 B klasė";5496591880;Taip;21;0;0;21
19873;Lokiukas;"4 B klasė";1491789191;Taip;6;0;0;6
19874;Lokiukas;"4 B klasė";1419846182;Taip;8;0;0;8
19875;Lokiukas;"4 B klasė";9310088026;Taip;9;0;0;9
19876;Lokiukas;"4 B klasė";1787800667;Taip;11;0;0;11
19877;Šaltinėlis;Ančiukų;3011747942;Taip;0;6;0;6
19878;Šaltinėlis;Ančiukų;9769491789;Taip;0;8;0;8
19879;Šaltinėlis;Ančiukų;56396772538;Taip;0;12;0;12
19880;Šaltinėlis;Ančiukų;6462738640;Taip;0;8;0;8
19881;Šaltinėlis;Ančiukų;3493429067;Taip;0;7;0;7
19882;Šaltinėlis;Ančiukų;77872075694;Taip;0;7;0;7
19883;Šaltinėlis;Ančiukų;9218883174;Ne;5;7;0;12
19884;Šaltinėlis;Ančiukų;7133143923;Taip;0;11;0;11
19885;Šaltinėlis;Ančiukų;9820788524;Taip;0;16;0;16
19886;Šaltinėlis;Ančiukų;3691635011;Ne;3;0;0;3
19887;Šaltinėlis;Ančiukų;2630875135;Taip;0;5;0;5
19888;Šaltinėlis;Ančiukų;2973820849;Ne;7;5;0;12
19889;Šaltinėlis;Ančiukų;6487378225;Ne;11;3;0;14
19890;Šaltinėlis;Ančiukų;1464992631;Taip;7;6;0;13
19891;Šaltinėlis;Ančiukų;9274165569;Taip;3;4;0;7
19892;Šaltinėlis;Ančiukų;8500790262;Taip;9;2;0;11
19893;Šaltinėlis;Ančiukų;4332884673;Taip;0;8;0;8
19894;Šaltinėlis;Ančiukų;9362495172;Ne;0;10;0;10
19895;Šaltinėlis;Ančiukų;7737797979;Taip;0;7;0;7
19896;Šaltinėlis;Ančiukų;5455278072;Taip;6;8;0;14
19897;Šaltinėlis;Ančiukų;6887838949;Taip;7;4;0;11
19898;Šaltinėlis;Ančiukų;2084451705;Ne;0;5;0;5
19899;Šaltinėlis;Bitučių;3455754351;Taip;7;4;0;11
19900;Šaltinėlis;Bitučių;1224027643;Taip;0;17;0;17
19901;Šaltinėlis;Bitučių;35748040565;Taip;0;4;2;6
19902;Šaltinėlis;Bitučių;86592374576;Taip;10;4;3;17
19903;Šaltinėlis;Bitučių;3022926855;Ne;1;4;0;5
19904;Šaltinėlis;Bitučių;32264290873;Taip;0;4;2;6
19905;Šaltinėlis;Bitučių;1767635282;Taip;0;4;1;5
19906;Šaltinėlis;Bitučių;1390316465;Taip;12;4;0;16
19907;Šaltinėlis;Bitučių;37786438977;Taip;6;9;1;16
19908;Šaltinėlis;Bitučių;5442943843;Taip;0;4;3;7
19909;Šaltinėlis;Bitučių;6764006747;Taip;5;4;0;9
19910;Šaltinėlis;Bitučių;1658370782;Ne;7;11;0;18
19911;Šaltinėlis;Bitučių;10918276041;Ne;4;4;0;8
19912;Šaltinėlis;Bitučių;66575684640;Taip;0;4;0;4
19913;Šaltinėlis;Bitučių;13808708760;Taip;0;4;0;4
19914;Šaltinėlis;Bitučių;1718488108;Taip;0;7;0;7
19915;Šaltinėlis;Bitučių;79406746980;Taip;0;11;0;11
19916;Šaltinėlis;Bitučių;3577137327;Taip;8;4;0;12
19917;Šaltinėlis;Bitučių;48525545812;Taip;0;8;0;8
19918;Šaltinėlis;Bitučių;7073644279;Taip;0;4;1;5
19919;Šaltinėlis;Bitučių;1190394855;Taip;0;4;0;4
19920;Šaltinėlis;Bitučių;1456486363;Taip;9;4;0;13
19921;Šaltinėlis;Bitučių;32949623652;Taip;0;15;0;15
19922;Šaltinėlis;Bitučių;1614411921;Ne;0;9;0;9
19923;Šaltinėlis;Bitučių;29359826470;Taip;13;4;0;17
19924;Šaltinėlis;Bitučių;6176560054;Ne;0;4;0;4
19925;Šaltinėlis;Saulutės;7311831014;Taip;3;4;0;7
19926;Šaltinėlis;Saulutės;5854723120;Taip;5;9;0;14
19927;Šaltinėlis;Saulutės;5833136956;Taip;6;4;0;10
19928;Šaltinėlis;Saulutės;3483756240;Taip;7;4;2;13
19929;Šaltinėlis;Saulutės;6380346298;Taip;6;1;0;7
19930;Šaltinėlis;Saulutės;5799032398;Taip;10;4;1;15
19931;Šaltinėlis;Saulutės;5525740049;Taip;3;4;0;7
19932;Šaltinėlis;Saulutės;5382567842;Taip;0;5;0;5
19933;Šaltinėlis;Saulutės;1978469605;Ne;0;4;0;4
19934;Šaltinėlis;Saulutės;9762392403;Ne;19;0;0;19
19935;Šaltinėlis;Saulutės;4743907195;Taip;14;3;0;17
19936;Šaltinėlis;Saulutės;5343279219;Taip;7;4;0;11
19937;Šaltinėlis;Saulutės;7118672118;Taip;0;0;1;1
19938;Šaltinėlis;Saulutės;2465009553;Taip;0;3;0;3
19939;Šaltinėlis;Saulutės;9108653045;Taip;8;0;0;8
19940;Šaltinėlis;Saulutės;5345738219;Ne;15;0;0;15
19941;Šaltinėlis;Saulutės;3579974049;Taip;0;2;0;2
19942;Šaltinėlis;Saulutės;6721510313;Ne;5;0;0;5
19943;Šaltinėlis;Saulutės;7650840990;Taip;4;7;0;11
19944;Šaltinėlis;Meškiukų;3264138693;Taip;0;12;0;12
19945;Šaltinėlis;Meškiukų;2013810425;Taip;0;3;0;3
19946;Šaltinėlis;Meškiukų;1045163890;Taip;4;5;0;9
19947;Šaltinėlis;Meškiukų;7231645416;Ne;3;4;0;7
19948;Šaltinėlis;Meškiukų;8555517284;Taip;9;4;0;13
19949;Šaltinėlis;Meškiukų;9757246434;Taip;21;0;0;21
19950;Šaltinėlis;Meškiukų;1073305554;Taip;0;4;1;5
19951;Šaltinėlis;Meškiukų;7483928256;Taip;17;0;0;17
19952;Šaltinėlis;Meškiukų;3516760367;Taip;8;5;0;13
19953;Šaltinėlis;Meškiukų;2628936055;Taip;18;0;0;18
19954;Šaltinėlis;Meškiukų;5256665649;Taip;19;0;0;19
19955;Šaltinėlis;Meškiukų;2700475528;Taip;5;5;0;10
19956;Šaltinėlis;Meškiukų;1035890284;Taip;12;4;0;16
19957;Šaltinėlis;Meškiukų;6880337593;Ne;5;5;0;10
19958;Šaltinėlis;Meškiukų;1543331408;Taip;0;4;0;4
19959;Šaltinėlis;Meškiukų;9305706589;Ne;0;2;0;2
19960;Šaltinėlis;Meškiukų;9968637187;Taip;10;4;0;14
19961;Šaltinėlis;Nykštukai;1823048790;Taip;12;0;0;12
19962;Šaltinėlis;Nykštukai;9522524163;Taip;0;7;0;7
19963;Šaltinėlis;Nykštukai;4681460322;Taip;0;7;0;7
19964;Šaltinėlis;Nykštukai;4430546695;Taip;10;4;0;14
19965;Šaltinėlis;Nykštukai;1686009371;Taip;21;0;0;21
19966;Šaltinėlis;Nykštukai;9075507649;Taip;4;0;0;4
19967;Šaltinėlis;Nykštukai;7068058767;Taip;11;3;0;14
19968;Šaltinėlis;Nykštukai;8914777163;Taip;0;6;0;6
19969;Šaltinėlis;Nykštukai;7387221265;Taip;4;4;0;8
19970;Šaltinėlis;Nykštukai;3073692882;Taip;6;4;1;11
19971;Šaltinėlis;Nykštukai;2126751248;Taip;17;0;0;17
19972;Šaltinėlis;Nykštukai;7133044918;Taip;21;0;0;21
19973;Šaltinėlis;Nykštukai;2806453623;Taip;12;1;0;13
19974;Šaltinėlis;Nykštukai;8695191968;Taip;19;0;0;19
19975;Šaltinėlis;Nykštukai;8506287076;Taip;4;0;0;4
19976;Šaltinėlis;Nykštukai;2825412170;Taip;3;7;0;10
19977;Šaltinėlis;Perliukų;17147527171;Ne;1;4;0;5
19978;Šaltinėlis;Perliukų;11083638216;Taip;14;0;0;14
19979;Šaltinėlis;Perliukų;1091056386;Taip;7;5;0;12
19980;Šaltinėlis;Perliukų;52507085619;Taip;0;4;1;5
19981;Šaltinėlis;Perliukų;23301579810;Taip;0;5;0;5
19982;Šaltinėlis;Perliukų;2146141461;Taip;0;4;1;5
19983;Šaltinėlis;Perliukų;1958647188;Ne;5;5;0;10
19984;Šaltinėlis;Perliukų;2034838765;Taip;12;0;0;12
19985;Šaltinėlis;Perliukų;1935762293;Taip;0;0;7;7
19986;Šaltinėlis;Perliukų;1583520894;Ne;0;16;0;16
19987;Šaltinėlis;Perliukų;1023238509;Taip;9;3;0;12
19988;Šaltinėlis;Perliukų;84494627465;Taip;0;5;0;5
19989;Šaltinėlis;Perliukų;98941037508;Taip;0;5;0;5
19990;Šaltinėlis;Perliukų;1004445904;Taip;6;3;0;9
19991;Šaltinėlis;Perliukų;9425353041;Taip;0;12;0;12
19992;Šaltinėlis;Perliukų;526307704;Taip;0;12;0;12
19993;Šaltinėlis;Perliukų;7262120071;Ne;0;0;4;4
19994;Šaltinėlis;Perliukų;6068980312;Taip;6;2;0;8
19995;Šaltinėlis;Perliukų;5869977541;Taip;0;10;0;10
19996;Šaltinėlis;Perliukų;4416064304;Ne;8;4;1;13
19997;Šaltinėlis;Perliukų;2333071711;Ne;0;3;0;3
19998;Šaltinėlis;Perliukų;1580090516;Taip;0;8;3;11
19999;Šaltinėlis;BORUŽĖLĖS;8896316882;Taip;0;7;0;7
20000;Šaltinėlis;BORUŽĖLĖS;5325974488;Taip;21;0;0;21
20001;Šaltinėlis;BORUŽĖLĖS;1445108285;Taip;2;4;0;6
20002;Šaltinėlis;BORUŽĖLĖS;6586783795;Taip;8;9;0;17
20003;Šaltinėlis;BORUŽĖLĖS;9691993251;Taip;8;0;1;9
20004;Šaltinėlis;BORUŽĖLĖS;4248763165;Taip;5;0;0;5
20005;Šaltinėlis;BORUŽĖLĖS;2189112609;Taip;2;0;0;2
20006;Šaltinėlis;BORUŽĖLĖS;9674923143;Taip;4;3;0;7
20007;Šaltinėlis;BORUŽĖLĖS;2022956307;Taip;2;5;0;7
20008;Šaltinėlis;BORUŽĖLĖS;7955094634;Taip;0;6;0;6
20009;Šaltinėlis;BORUŽĖLĖS;4664741207;Taip;6;0;0;6
20010;Šaltinėlis;BORUŽĖLĖS;9950106412;Taip;8;0;0;8
20011;Šaltinėlis;BORUŽĖLĖS;8995077908;Taip;0;11;0;11
20012;Šaltinėlis;"4B klasė";2413295020;Ne;0;21;0;21
20013;Šaltinėlis;"4B klasė";7404225862;Ne;0;5;0;5
20014;Šaltinėlis;"4B klasė";3375856084;Ne;0;8;0;8
20015;Šaltinėlis;"4B klasė";8670777468;Ne;0;5;0;5
20016;Šaltinėlis;"4B klasė";1687964284;Ne;0;5;0;5
20017;Šaltinėlis;"4B klasė";5105961386;Ne;0;4;0;4
20018;Šaltinėlis;"4B klasė";7121732840;Ne;0;21;0;21
20019;Šaltinėlis;"4B klasė";7917468152;Taip;0;6;0;6
20020;Šaltinėlis;"4B klasė";4335720836;Ne;0;5;0;5
20021;Šaltinėlis;"4B klasė";4994088781;Ne;0;5;0;5
20022;Šaltinėlis;"4B klasė";3680528737;Ne;0;7;0;7
20023;Šaltinėlis;"4B klasė";9708038079;Ne;0;8;0;8
20024;Šaltinėlis;"4B klasė";2160937385;Ne;0;21;0;21
20025;Šaltinėlis;"4B klasė";6381956693;Ne;0;21;0;21
20026;Šaltinėlis;"4B klasė";5181754988;Ne;0;6;0;6
20027;Šaltinėlis;"4B klasė";4543101402;Ne;0;12;0;12
20028;Šaltinėlis;1A;14213856824;Taip;0;7;0;7
20029;Šaltinėlis;1A;80649337160;Taip;0;5;0;5
20030;Šaltinėlis;1A;92958012146;Taip;0;6;0;6
20031;Šaltinėlis;1A;84656960510;Taip;0;5;0;5
20032;Šaltinėlis;1A;83621946293;Taip;0;21;0;21
20033;Šaltinėlis;1A;67808618878;Ne;0;5;0;5
20034;Šaltinėlis;1A;1278910777;Taip;0;5;0;5
20035;Šaltinėlis;1A;9647785988;Ne;0;21;0;21
20036;Šaltinėlis;1A;82671662416;Taip;0;5;0;5
20037;Šaltinėlis;1A;54025577281;Taip;0;6;0;6
20038;Šaltinėlis;1A;29482180151;Taip;0;5;0;5
20039;Šaltinėlis;1A;54753218491;Taip;0;4;0;4
20040;Šaltinėlis;1A;86029472773;Taip;0;4;0;4
20041;Šaltinėlis;1A;64821172553;Taip;0;11;0;11
20042;Šaltinėlis;1A;5744976843;Taip;0;21;0;21
20043;Šaltinėlis;1A;25459069972;Ne;0;6;0;6
20044;Šaltinėlis;1A;6669392157;Taip;0;5;0;5
20045;Šaltinėlis;1A;89358384113;Taip;0;5;0;5
20046;Šaltinėlis;1A;28956971978;Taip;0;5;0;5
20047;Šaltinėlis;1A;4050444191;Taip;0;7;0;7
20048;Šaltinėlis;1A;89093437170;Taip;0;5;0;5
20049;Šaltinėlis;1A;51872331010;Taip;0;5;0;5
20050;Šaltinėlis;1A;5056986469;Taip;0;21;0;21
20051;Šaltinėlis;1A;488285764;Taip;0;4;0;4
20052;Šaltinėlis;"2A klasė";83657465071;Taip;0;4;0;4
20053;Šaltinėlis;"2A klasė";86309198604;Taip;0;4;0;4
20054;Šaltinėlis;"2A klasė";9705941341;Taip;0;21;0;21
20055;Šaltinėlis;"2A klasė";38496350161;Taip;0;21;0;21
20056;Šaltinėlis;"2A klasė";62612067151;Taip;0;7;0;7
20057;Šaltinėlis;"2A klasė";96133834896;Ne;0;21;0;21
20058;Šaltinėlis;"2A klasė";2323456393;Ne;0;21;0;21
20059;Šaltinėlis;"2A klasė";56279691365;Taip;0;4;0;4
20060;Šaltinėlis;"2A klasė";4587186145;Taip;0;4;0;4
20061;Šaltinėlis;"2A klasė";70948186548;Taip;0;8;0;8
20062;Šaltinėlis;"2A klasė";47045578599;Taip;0;17;0;17
20063;Šaltinėlis;"2A klasė";36718328105;Taip;0;9;0;9
20064;Šaltinėlis;"2A klasė";86995081866;Taip;0;12;0;12
20065;Šaltinėlis;"2A klasė";7929809205;Ne;0;4;0;4
20066;Šaltinėlis;"2A klasė";29683761586;Ne;0;6;0;6
20067;Šaltinėlis;"2A klasė";40769315138;Taip;0;10;0;10
20068;Šaltinėlis;"2A klasė";7563879445;Ne;0;4;0;4
20069;Šaltinėlis;"2A klasė";66754907606;Taip;0;21;0;21
20070;Šaltinėlis;"2A klasė";35387543586;Taip;0;7;0;7
20071;Šaltinėlis;"2A klasė";9927833966;Ne;0;4;0;4
20072;Šaltinėlis;"3A klasė";7214517805;Ne;0;21;0;21
20073;Šaltinėlis;"3A klasė";9978493148;Ne;0;6;0;6
20074;Šaltinėlis;"3A klasė";1839665658;Ne;0;5;0;5
20075;Šaltinėlis;"3A klasė";8445115141;Ne;0;6;0;6
20076;Šaltinėlis;"3A klasė";1450894955;Ne;0;21;0;21
20077;Šaltinėlis;"3A klasė";8898225999;Ne;0;21;0;21
20078;Šaltinėlis;"3A klasė";6044895102;Ne;0;6;0;6
20079;Šaltinėlis;"3A klasė";7967108692;Ne;0;10;0;10
20080;Šaltinėlis;"3A klasė";4843823058;Ne;0;6;0;6
20081;Šaltinėlis;"3A klasė";92001008485;Taip;0;6;0;6
20082;Šaltinėlis;"3A klasė";7264810605;Ne;0;6;0;6
20083;Šaltinėlis;"3A klasė";7058348243;Ne;0;6;0;6
20084;Šaltinėlis;"3A klasė";5012608633;Ne;0;5;0;5
20085;Šaltinėlis;"3A klasė";2076892804;Ne;0;14;0;14
20086;Šaltinėlis;"3A klasė";8680271000;Ne;0;21;0;21
20087;Šaltinėlis;"3A klasė";6876036723;Ne;0;9;0;9
20088;Šaltinėlis;"3A klasė";6171441011;Ne;0;7;0;7
20089;Šaltinėlis;"4A klasė";9057225956;Ne;0;4;0;4
20090;Šaltinėlis;"4A klasė";8714253922;Ne;0;6;0;6
20091;Šaltinėlis;"4A klasė";6765467361;Ne;0;4;0;4
20092;Šaltinėlis;"4A klasė";2010277249;Ne;0;6;0;6
20093;Šaltinėlis;"4A klasė";3636296862;Ne;0;7;0;7
20094;Šaltinėlis;"4A klasė";4062628468;Ne;0;10;0;10
20095;Šaltinėlis;"4A klasė";6948074305;Ne;0;4;0;4
20096;Šaltinėlis;"4A klasė";2154195956;Ne;0;21;0;21
20097;Šaltinėlis;"4A klasė";47857916979;Taip;0;21;0;21
20098;Šaltinėlis;"4A klasė";6443537515;Ne;0;7;0;7
20099;Šaltinėlis;"4A klasė";57928407025;Ne;0;21;0;21
20100;Šaltinėlis;"4A klasė";8503985429;Ne;0;13;0;13
20101;Šaltinėlis;"4A klasė";4977611599;Ne;0;4;0;4
20102;Šaltinėlis;"4A klasė";24414070672;Ne;0;21;0;21
20103;Šaltinėlis;"4A klasė";3553168020;Ne;0;4;0;4
20104;Šaltinėlis;3B;7142082502;Ne;0;21;0;21
20105;Šaltinėlis;3B;6719801285;Ne;0;12;0;12
20106;Šaltinėlis;3B;1756003648;Taip;0;21;0;21
20107;Šaltinėlis;3B;4141263000;Ne;0;5;0;5
20108;Šaltinėlis;3B;3863654037;Ne;0;8;0;8
20109;Šaltinėlis;3B;5776007602;Ne;0;14;0;14
20110;Šaltinėlis;3B;3037854361;Ne;0;5;0;5
20111;Šaltinėlis;3B;2089316824;Ne;0;6;0;6
20112;Šaltinėlis;3B;7420737103;Ne;0;5;0;5
20113;Šaltinėlis;3B;8380122669;Ne;0;7;0;7
20114;Šaltinėlis;3B;82404351290;Taip;0;8;0;8
20115;Šaltinėlis;3B;5999279571;Ne;0;6;0;6
20116;Šaltinėlis;3B;3329317171;Ne;0;4;0;4
20117;Šaltinėlis;3B;8219291385;Ne;0;16;0;16
20118;Šaltinėlis;3B;49275031765;Taip;0;14;0;14
20119;Šaltinėlis;1B;93256161233;Taip;0;5;0;5
20120;Šaltinėlis;1B;83173349544;Taip;0;7;0;7
20121;Šaltinėlis;1B;39088869084;Taip;0;5;0;5
20122;Šaltinėlis;1B;95542489944;Taip;0;5;0;5
20123;Šaltinėlis;1B;3072314714;Taip;0;10;0;10
20124;Šaltinėlis;1B;1220687492;Taip;0;5;0;5
20125;Šaltinėlis;1B;74337710550;Ne;0;6;0;6
20126;Šaltinėlis;1B;35401075864;Ne;0;21;0;21
20127;Šaltinėlis;1B;19630605543;Taip;0;14;0;14
20128;Šaltinėlis;1B;3626545396;Ne;0;9;0;9
20129;Šaltinėlis;1B;72372808270;Taip;0;5;0;5
20130;Šaltinėlis;1B;1924418657;Taip;0;12;0;12
20131;Šaltinėlis;1B;77194317310;Taip;0;5;0;5
20132;Šaltinėlis;1B;57847832778;Taip;0;7;0;7
20133;Šaltinėlis;1B;70315400705;Ne;0;5;0;5
20134;Šaltinėlis;1B;81082410620;Taip;0;9;0;9
20135;Šaltinėlis;1B;1422035829;Taip;0;21;0;21
20136;Šaltinėlis;1B;84522552145;Taip;0;6;0;6
20137;Šaltinėlis;1B;7711903999;Ne;0;5;0;5
20138;Šaltinėlis;1B;6317111400;Taip;0;9;0;9
20139;Šaltinėlis;1B;4762756751;Ne;0;5;0;5
20140;Gabijėlė;GANDRIUKŲ;4498088417;Taip;9;2;0;11
20141;Gabijėlė;GANDRIUKŲ;9706026832;Taip;5;8;0;13
20142;Gabijėlė;GANDRIUKŲ;2277489032;Taip;0;0;4;4
20143;Gabijėlė;GANDRIUKŲ;8994076883;Taip;2;0;3;5
20144;Gabijėlė;GANDRIUKŲ;7087892822;Taip;19;0;1;20
20145;Gabijėlė;GANDRIUKŲ;2550300871;Taip;8;1;0;9
20146;Gabijėlė;GANDRIUKŲ;5057272847;Taip;4;7;4;15
20147;Gabijėlė;GANDRIUKŲ;3548399391;Taip;0;4;7;11
20148;Gabijėlė;GANDRIUKŲ;3532989398;Taip;3;1;0;4
20149;Gabijėlė;GANDRIUKŲ;2215880644;Taip;13;0;3;16
20150;Gabijėlė;GANDRIUKŲ;8904768332;Taip;8;4;2;14
20151;Gabijėlė;GANDRIUKŲ;3799003783;Taip;7;4;5;16
20152;Gabijėlė;GANDRIUKŲ;8572833698;Taip;2;0;10;12
20153;Gabijėlė;GANDRIUKŲ;7433142478;Taip;0;0;2;2
20154;Gabijėlė;GANDRIUKŲ;2491503656;Taip;0;10;0;10
20155;Gabijėlė;GANDRIUKŲ;9116153981;Taip;21;0;0;21
20156;Gabijėlė;LAKŠTINGALIUKŲ;92624581275;Taip;0;5;1;6
20157;Gabijėlė;LAKŠTINGALIUKŲ;38094271521;Taip;0;9;2;11
20158;Gabijėlė;LAKŠTINGALIUKŲ;53325200270;Taip;5;5;0;10
20159;Gabijėlė;LAKŠTINGALIUKŲ;45682950511;Taip;0;4;2;6
20160;Gabijėlė;LAKŠTINGALIUKŲ;48032842307;Taip;3;4;4;11
20161;Gabijėlė;LAKŠTINGALIUKŲ;49951048159;Taip;7;4;0;11
20162;Gabijėlė;LAKŠTINGALIUKŲ;1451870519;Ne;0;13;0;13
20163;Gabijėlė;LAKŠTINGALIUKŲ;2131349938;Taip;5;5;0;10
20164;Gabijėlė;LAKŠTINGALIUKŲ;67649373235;Taip;0;4;0;4
20165;Gabijėlė;LAKŠTINGALIUKŲ;9376398157;Taip;2;4;0;6
20166;Gabijėlė;LAKŠTINGALIUKŲ;80455285324;Taip;2;6;0;8
20167;Gabijėlė;LAKŠTINGALIUKŲ;2220139259;Ne;0;4;3;7
20168;Gabijėlė;LAKŠTINGALIUKŲ;82760473229;Taip;0;6;2;8
20169;Gabijėlė;LAKŠTINGALIUKŲ;77966124767;Taip;0;4;0;4
20170;Gabijėlė;LAKŠTINGALIUKŲ;54950294060;Taip;0;5;0;5
20171;Gabijėlė;LAKŠTINGALIUKŲ;1988838165;Taip;0;4;0;4
20172;Gabijėlė;LAKŠTINGALIUKŲ;89100449385;Taip;2;4;0;6
20173;Gabijėlė;LAKŠTINGALIUKŲ;67189240970;Taip;0;6;0;6
20174;Gabijėlė;LAKŠTINGALIUKŲ;1240051312;Taip;0;4;1;5
20175;Gabijėlė;LAKŠTINGALIUKŲ;4662981914;Taip;9;6;0;15
20176;Gabijėlė;LAKŠTINGALIUKŲ;1945407792;Taip;2;4;0;6
20177;Gabijėlė;ŽVIRBLIUKŲ;7043775905;Taip;0;17;0;17
20178;Gabijėlė;ŽVIRBLIUKŲ;4475530177;Taip;9;0;0;9
20179;Gabijėlė;ŽVIRBLIUKŲ;5743861607;Taip;0;4;0;4
20180;Gabijėlė;ŽVIRBLIUKŲ;7410541320;Taip;16;5;0;21
20181;Gabijėlė;ŽVIRBLIUKŲ;4493192224;Taip;21;0;0;21
20182;Gabijėlė;ŽVIRBLIUKŲ;9259964641;Taip;0;7;1;8
20183;Gabijėlė;ŽVIRBLIUKŲ;3268231136;Ne;0;14;0;14
20184;Gabijėlė;ŽVIRBLIUKŲ;8879972953;Taip;10;6;0;16
20185;Gabijėlė;ŽVIRBLIUKŲ;5332825339;Taip;8;0;6;14
20186;Gabijėlė;ŽVIRBLIUKŲ;9627906252;Taip;8;0;2;10
20187;Gabijėlė;ŽVIRBLIUKŲ;2264669298;Taip;0;5;5;10
20188;Gabijėlė;ŽVIRBLIUKŲ;5942625633;Taip;10;0;1;11
20189;Gabijėlė;ŽVIRBLIUKŲ;7417179112;Taip;0;2;0;2
20190;Gabijėlė;ŽVIRBLIUKŲ;5387026410;Taip;0;2;0;2
20191;Gabijėlė;ŽVIRBLIUKŲ;8292463617;Taip;4;0;2;6
20192;Gabijėlė;ŽVIRBLIUKŲ;3155403180;Taip;4;0;5;9
20193;Gabijėlė;ŽVIRBLIUKŲ;1158461185;Taip;4;0;5;9
20194;Gabijėlė;ŽVIRBLIUKŲ;6604681536;Ne;0;12;0;12
20195;Gabijėlė;ŽVIRBLIUKŲ;3218415151;Taip;11;0;9;20
20196;Gabijėlė;ŽVIRBLIUKŲ;8384795164;Ne;9;0;0;9
20197;Gabijėlė;ŽVIRBLIUKŲ;4146051969;Ne;0;12;0;12
20198;Gabijėlė;ŽVIRBLIUKŲ;6674038058;Taip;6;4;0;10
20199;Gabijėlė;ŽVIRBLIUKŲ;8823299212;Taip;8;4;4;16
20200;Gabijėlė;GENIUKŲ;3445433386;Taip;0;17;0;17
20201;Gabijėlė;GENIUKŲ;2980295345;Taip;0;4;0;4
20202;Gabijėlė;GENIUKŲ;1862655595;Taip;0;4;0;4
20203;Gabijėlė;GENIUKŲ;7312628876;Taip;7;4;0;11
20204;Gabijėlė;GENIUKŲ;1581688238;Taip;0;4;2;6
20205;Gabijėlė;GENIUKŲ;5301905117;Taip;0;16;0;16
20206;Gabijėlė;GENIUKŲ;3176075887;Taip;13;5;0;18
20207;Gabijėlė;GENIUKŲ;6866641272;Taip;5;0;8;13
20208;Gabijėlė;GENIUKŲ;9972967198;Taip;8;0;0;8
20209;Gabijėlė;GENIUKŲ;8305098808;Ne;0;4;1;5
20210;Gabijėlė;GENIUKŲ;1589534853;Ne;4;4;0;8
20211;Gabijėlė;GENIUKŲ;3020599503;Taip;0;14;0;14
20212;Gabijėlė;GENIUKŲ;4234733280;Taip;0;0;5;5
20213;Gabijėlė;GENIUKŲ;1922979974;Ne;11;0;1;12
20214;Gabijėlė;GENIUKŲ;6482824000;Taip;8;0;0;8
20215;Gabijėlė;GENIUKŲ;5962852108;Taip;0;19;0;19
20216;Gabijėlė;GENIUKŲ;7178676049;Taip;0;4;0;4
20217;Gabijėlė;DAGILIUKŲ;9348393550;Taip;9;2;0;11
20218;Gabijėlė;DAGILIUKŲ;4264925447;Taip;9;2;0;11
20219;Gabijėlė;DAGILIUKŲ;9120107749;Taip;5;0;11;16
20220;Gabijėlė;DAGILIUKŲ;9494313873;Taip;0;9;0;9
20221;Gabijėlė;DAGILIUKŲ;7426579018;Taip;15;4;1;20
20222;Gabijėlė;DAGILIUKŲ;9783343968;Taip;5;4;0;9
20223;Gabijėlė;DAGILIUKŲ;3700639354;Taip;2;0;0;2
20224;Gabijėlė;DAGILIUKŲ;6438144206;Taip;0;5;5;10
20225;Gabijėlė;DAGILIUKŲ;8078326688;Taip;9;0;0;9
20226;Gabijėlė;DAGILIUKŲ;3017939983;Ne;8;1;0;9
20227;Gabijėlė;DAGILIUKŲ;4462129182;Taip;7;6;6;19
20228;Gabijėlė;DAGILIUKŲ;8662914262;Taip;0;13;0;13
20229;Gabijėlė;DAGILIUKŲ;9280283478;Ne;21;0;0;21
20230;Gabijėlė;DAGILIUKŲ;9503639471;Taip;4;1;0;5
20231;Gabijėlė;DAGILIUKŲ;1988597157;Ne;9;11;0;20
20232;Gabijėlė;DAGILIUKŲ;8036572198;Taip;21;0;0;21
20233;Gabijėlė;DAGILIUKŲ;9895518740;Taip;13;4;2;19
20234;Gabijėlė;DAGILIUKŲ;1455856766;Taip;6;4;0;10
20235;Gabijėlė;DAGILIUKŲ;6322094719;Taip;0;14;0;14
20236;Gabijėlė;DAGILIUKŲ;9449023766;Taip;2;13;0;15
20237;Gabijėlė;DAGILIUKŲ;2254104149;Taip;7;0;0;7
20238;Gabijėlė;DAGILIUKŲ;1286688629;Taip;0;4;0;4
20239;Gabijėlė;DAGILIUKŲ;8864190314;Ne;0;0;3;3
20240;Gabijėlė;DAGILIUKŲ;4797994026;Ne;4;6;1;11
20241;Gabijėlė;PELEDŽIUKŲ;94478599707;Taip;4;5;0;9
20242;Gabijėlė;PELEDŽIUKŲ;2067646395;Taip;0;2;6;8
20243;Gabijėlė;PELEDŽIUKŲ;1068556799;Taip;0;8;0;8
20244;Gabijėlė;PELEDŽIUKŲ;1171257945;Ne;0;6;5;11
20245;Gabijėlė;PELEDŽIUKŲ;8044682830;Taip;0;6;0;6
20246;Gabijėlė;PELEDŽIUKŲ;43109352262;Taip;3;15;0;18
20247;Gabijėlė;PELEDŽIUKŲ;1747282196;Taip;4;4;0;8
20248;Gabijėlė;PELEDŽIUKŲ;39679870094;Taip;7;7;0;14
20249;Gabijėlė;PELEDŽIUKŲ;36642141718;Taip;7;7;0;14
20250;Gabijėlė;PELEDŽIUKŲ;1491653325;Taip;4;2;0;6
20251;Gabijėlė;PELEDŽIUKŲ;1608940997;Taip;0;4;0;4
20252;Gabijėlė;PELEDŽIUKŲ;3610392405;Ne;0;12;0;12
20253;Gabijėlė;PELEDŽIUKŲ;4916964663;Taip;2;8;0;10
20254;Gabijėlė;PELEDŽIUKŲ;17443601729;Ne;8;0;5;13
20255;Gabijėlė;PELEDŽIUKŲ;1286307671;Taip;11;0;1;12
20256;Gabijėlė;PELEDŽIUKŲ;37544281230;Taip;0;5;3;8
20257;Gabijėlė;PELEDŽIUKŲ;8428069167;Taip;9;0;0;9
20258;Gabijėlė;PELEDŽIUKŲ;4726771205;Ne;11;0;3;14
20259;Gabijėlė;PELEDŽIUKŲ;24035160251;Taip;13;0;4;17
20260;Gabijėlė;PELEDŽIUKŲ;38497069329;Taip;0;4;3;7
20261;Gabijėlė;PELEDŽIUKŲ;57559227292;Ne;4;1;2;7
20262;Gabijėlė;PELEDŽIUKŲ;65735862964;Taip;7;0;1;8
20263;Gabijėlė;PELEDŽIUKŲ;8746641978;Ne;0;5;7;12
20264;Gabijėlė;KREGZDŽIUKŲ;84945768423;Taip;0;4;8;12
20265;Gabijėlė;KREGZDŽIUKŲ;41661694634;Taip;0;4;1;5
20266;Gabijėlė;KREGZDŽIUKŲ;1743647754;Ne;0;6;0;6
20267;Gabijėlė;KREGZDŽIUKŲ;79544806044;Taip;0;4;0;4
20268;Gabijėlė;KREGZDŽIUKŲ;34683603878;Ne;0;6;1;7
20269;Gabijėlė;KREGZDŽIUKŲ;13013873198;Taip;0;4;0;4
20270;Gabijėlė;KREGZDŽIUKŲ;91643373754;Taip;0;17;0;17
20271;Gabijėlė;KREGZDŽIUKŲ;7298662616;Taip;17;4;0;21
20272;Gabijėlė;KREGZDŽIUKŲ;5884453557;Taip;0;4;3;7
20273;Gabijėlė;KREGZDŽIUKŲ;61217725255;Ne;0;4;1;5
20274;Gabijėlė;KREGZDŽIUKŲ;53576382572;Ne;0;6;0;6
20275;Gabijėlė;KREGZDŽIUKŲ;2958504770;Taip;0;1;0;1
20276;Gabijėlė;KREGZDŽIUKŲ;16720415967;Taip;8;3;0;11
20277;Gabijėlė;KREGZDŽIUKŲ;34998957585;Taip;10;4;1;15
20278;Gabijėlė;KREGZDŽIUKŲ;1770578935;Taip;0;6;1;7
20279;Gabijėlė;KREGZDŽIUKŲ;1455625997;Taip;3;4;0;7
20280;Gabijėlė;KREGZDŽIUKŲ;1937862725;Taip;0;3;0;3
20281;Gabijėlė;KREGZDŽIUKŲ;25732601952;Taip;0;1;0;1
20282;Gabijėlė;KREGZDŽIUKŲ;1217019582;Taip;5;5;0;10
20283;Gabijėlė;KREGZDŽIUKŲ;46552208567;Taip;0;9;0;9
20284;Gabijėlė;KREGZDŽIUKŲ;2075744479;Taip;6;4;0;10
20285;Gabijėlė;KREGZDŽIUKŲ;62457368692;Taip;0;4;1;5
20286;Gabijėlė;KREGZDŽIUKŲ;26058036933;Ne;7;4;0;11
20287;Gabijėlė;KREGZDŽIUKŲ;84120660883;Ne;7;4;0;11
20288;Gabijėlė;KREGZDŽIUKŲ;36447115547;Taip;0;4;0;4
20289;Gabijėlė;KREGZDŽIUKŲ;69294465170;Taip;0;5;0;5
20290;Gabijėlė;ZYLIUKŲ;41421082754;Taip;0;3;0;3
20291;Gabijėlė;ZYLIUKŲ;90540638931;Taip;0;3;0;3
20292;Gabijėlė;ZYLIUKŲ;20248530233;Taip;0;5;0;5
20293;Gabijėlė;ZYLIUKŲ;25691510343;Taip;0;4;5;9
20294;Gabijėlė;ZYLIUKŲ;70110432877;Taip;0;3;0;3
20295;Gabijėlė;ZYLIUKŲ;84464214049;Taip;0;12;0;12
20296;Gabijėlė;ZYLIUKŲ;62562568076;Taip;0;6;4;10
20297;Gabijėlė;ZYLIUKŲ;1505873499;Taip;0;4;1;5
20298;Gabijėlė;ZYLIUKŲ;1257150362;Ne;0;4;0;4
20299;Gabijėlė;ZYLIUKŲ;32203098792;Taip;0;17;0;17
20300;Gabijėlė;ZYLIUKŲ;1642361191;Ne;0;4;1;5
20301;Gabijėlė;ZYLIUKŲ;1036201997;Taip;0;1;0;1
20302;Gabijėlė;ZYLIUKŲ;60548215051;Taip;5;4;1;10
20303;Gabijėlė;ZYLIUKŲ;7778613039;Taip;0;4;3;7
20304;Gabijėlė;ZYLIUKŲ;31458685084;Taip;0;9;0;9
20305;Gabijėlė;ZYLIUKŲ;16804922682;Taip;0;4;7;11
20306;Gabijėlė;ZYLIUKŲ;1213013384;Ne;0;4;1;5
20307;Gabijėlė;ZYLIUKŲ;2010619186;Ne;0;4;1;5
20308;Gabijėlė;ZYLIUKŲ;1145863002;Ne;6;7;0;13
20309;Gabijėlė;ZYLIUKŲ;1649556120;Taip;0;4;1;5
20310;Gabijėlė;VOLUNGĖLIŲ;1779924073;Ne;12;0;2;14
20311;Gabijėlė;VOLUNGĖLIŲ;4166739739;Taip;0;6;0;6
20312;Gabijėlė;VOLUNGĖLIŲ;1492231030;Taip;0;6;0;6
20313;Gabijėlė;VOLUNGĖLIŲ;1317309811;Taip;0;8;0;8
20314;Gabijėlė;VOLUNGĖLIŲ;1523331860;Taip;0;4;0;4
20315;Gabijėlė;VOLUNGĖLIŲ;21740150080;Taip;0;8;0;8
20316;Gabijėlė;VOLUNGĖLIŲ;5558919097;Taip;2;0;2;4
20317;Gabijėlė;VOLUNGĖLIŲ;9683524530;Taip;11;0;5;16
20318;Gabijėlė;VOLUNGĖLIŲ;59837942520;Taip;0;4;0;4
20319;Gabijėlė;VOLUNGĖLIŲ;46021970332;Ne;0;0;4;4
20320;Gabijėlė;VOLUNGĖLIŲ;8480479946;Taip;3;7;0;10
20321;Gabijėlė;VOLUNGĖLIŲ;13265905500;Taip;0;6;0;6
20322;Gabijėlė;VOLUNGĖLIŲ;43737170074;Taip;6;2;0;8
20323;Gabijėlė;VOLUNGĖLIŲ;1480704497;Taip;0;11;0;11
20324;Gabijėlė;VOLUNGĖLIŲ;5704281727;Taip;0;4;3;7
20325;Gabijėlė;VOLUNGĖLIŲ;95685721388;Taip;0;10;0;10
20326;Gabijėlė;VOLUNGĖLIŲ;29328876924;Taip;0;4;0;4
20327;Gabijėlė;VOLUNGĖLIŲ;76416239647;Ne;0;0;3;3
20328;Gabijėlė;VOLUNGĖLIŲ;2102821834;Taip;0;4;0;4
20329;Gabijėlė;VOLUNGĖLIŲ;6271780003;Taip;5;4;2;11
20330;Gabijėlė;VOLUNGĖLIŲ;2051109865;Ne;0;9;0;9
20331;Gabijėlė;VOLUNGĖLIŲ;64252867351;Ne;0;18;0;18
20332;Gabijėlė;ANČIUKŲ;43123279348;Taip;0;11;0;11
20333;Gabijėlė;ANČIUKŲ;2036978425;Taip;0;13;0;13
20334;Gabijėlė;ANČIUKŲ;5219706067;Taip;0;6;0;6
20335;Gabijėlė;ANČIUKŲ;10796114623;Ne;0;9;0;9
20336;Gabijėlė;ANČIUKŲ;3454412432;Ne;8;0;2;10
20337;Gabijėlė;ANČIUKŲ;4752631976;Taip;0;0;3;3
20338;Gabijėlė;ANČIUKŲ;9822093084;Taip;7;4;0;11
20339;Gabijėlė;ANČIUKŲ;1415184607;Taip;3;4;5;12
20340;Gabijėlė;ANČIUKŲ;85836097485;Taip;0;0;3;3
20341;Gabijėlė;ANČIUKŲ;28017865889;Taip;0;15;0;15
20342;Gabijėlė;ANČIUKŲ;1917587420;Ne;6;14;0;20
20343;Gabijėlė;ANČIUKŲ;1465584524;Taip;6;4;0;10
20344;Gabijėlė;ANČIUKŲ;6198439092;Taip;1;7;0;8
20345;Gabijėlė;ANČIUKŲ;5783373671;Taip;0;8;0;8
20346;Gabijėlė;ANČIUKŲ;7948343328;Taip;0;0;1;1
20347;Gabijėlė;ANČIUKŲ;2052892422;Ne;0;0;12;12
20348;Gabijėlė;ANČIUKŲ;8111239476;Ne;15;6;0;21
20349;Gabijėlė;ANČIUKŲ;6766770793;Taip;0;0;11;11
20350;Gabijėlė;ANČIUKŲ;8778396292;Ne;11;0;4;15
20351;Gabijėlė;ANČIUKŲ;4085049535;Taip;0;15;0;15
20352;Gabijėlė;ANČIUKŲ;8893637755;Taip;0;10;0;10
20353;Gabijėlė;BALANDŽIUKŲ;6196322537;Taip;5;0;0;5
20354;Gabijėlė;BALANDŽIUKŲ;4110081664;Taip;9;0;0;9
20355;Gabijėlė;BALANDŽIUKŲ;6719097956;Taip;0;1;2;3
20356;Gabijėlė;BALANDŽIUKŲ;9157819780;Taip;0;10;0;10
20357;Gabijėlė;BALANDŽIUKŲ;2921208571;Taip;0;4;2;6
20358;Gabijėlė;BALANDŽIUKŲ;1045338865;Taip;0;0;7;7
20359;Gabijėlė;BALANDŽIUKŲ;4330624300;Taip;0;0;3;3
20360;Gabijėlė;BALANDŽIUKŲ;33124420723;Taip;9;0;1;10
20361;Gabijėlė;BALANDŽIUKŲ;2097260657;Taip;21;0;0;21
20362;Gabijėlė;BALANDŽIUKŲ;8131229306;Ne;6;2;0;8
20363;Gabijėlė;BALANDŽIUKŲ;8525869648;Taip;8;3;0;11
20364;Gabijėlė;BALANDŽIUKŲ;56914218692;Ne;16;0;0;16
20365;Gabijėlė;BALANDŽIUKŲ;2070050969;Taip;9;0;0;9
20366;Gabijėlė;BALANDŽIUKŲ;7144977279;Ne;0;4;0;4
20367;Gabijėlė;BALANDŽIUKŲ;15049855022;Taip;0;3;0;3
20368;Gabijėlė;BALANDŽIUKŲ;2776579713;Taip;2;3;0;5
20369;Gabijėlė;BALANDŽIUKŲ;7977751362;Taip;4;0;1;5
20370;Gabijėlė;BALANDŽIUKŲ;5906952432;Taip;4;0;1;5
20371;Gabijėlė;BALANDŽIUKŲ;9197020006;Taip;0;10;0;10
20372;Gabijėlė;BALANDŽIUKŲ;1615940996;Taip;8;0;1;9
20373;Gabijėlė;BALANDŽIUKŲ;1273722177;Taip;12;0;5;17
20374;Gabijėlė;VYTURIUKŲ;3484413830;Taip;5;4;0;9
20375;Gabijėlė;VYTURIUKŲ;87868591956;Taip;0;2;1;3
20376;Gabijėlė;VYTURIUKŲ;1859288888;Ne;0;5;0;5
20377;Gabijėlė;VYTURIUKŲ;44322663690;Ne;0;0;5;5
20378;Gabijėlė;VYTURIUKŲ;1479311429;Ne;3;1;0;4
20379;Gabijėlė;VYTURIUKŲ;4765125810;Taip;0;4;2;6
20380;Gabijėlė;VYTURIUKŲ;1219257874;Taip;9;0;0;9
20381;Gabijėlė;VYTURIUKŲ;39269336820;Taip;0;6;0;6
20382;Gabijėlė;VYTURIUKŲ;1829866148;Ne;15;0;0;15
20383;Gabijėlė;VYTURIUKŲ;1949644078;Taip;0;5;0;5
20384;Gabijėlė;VYTURIUKŲ;47989272121;Ne;0;11;0;11
20385;Gabijėlė;VYTURIUKŲ;5736000160;Taip;17;4;0;21
20386;Gabijėlė;VYTURIUKŲ;9320327120;Taip;9;0;0;9
20387;Gabijėlė;VYTURIUKŲ;4632508075;Taip;0;0;1;1
20388;Gabijėlė;VYTURIUKŲ;1426802917;Taip;0;2;2;4
20389;Gabijėlė;VYTURIUKŲ;41212490042;Ne;0;0;7;7
20390;Gabijėlė;VYTURIUKŲ;1852597048;Taip;0;5;0;5
20391;Gabijėlė;VYTURIUKŲ;1287165224;Taip;0;4;0;4
20392;Gabijėlė;VYTURIUKŲ;34609028374;Taip;7;6;0;13
20393;Gabijėlė;VYTURIUKŲ;48342584892;Taip;6;0;1;7
20394;Gabijėlė;VYTURIUKŲ;1185452849;Taip;0;4;0;4
20395;Gabijėlė;VYTURIUKŲ;90520726029;Taip;0;4;0;4
20396;Gabijėlė;VYTURIUKŲ;11048695176;Taip;2;0;0;2
20397;Gabijėlė;VYTURIUKŲ;6492199649;Ne;4;2;1;7
20398;Pilaitukas;BITUTĖS;4305634374;Taip;8;4;0;12
20399;Pilaitukas;BITUTĖS;3519198814;Taip;16;0;0;16
20400;Pilaitukas;BITUTĖS;8169484415;Taip;0;0;2;2
20401;Pilaitukas;BITUTĖS;1729494874;Taip;0;13;0;13
20402;Pilaitukas;BITUTĖS;2242454299;Taip;6;0;0;6
20403;Pilaitukas;BITUTĖS;9793278788;Taip;0;0;2;2
20404;Pilaitukas;BITUTĖS;4082490488;Taip;0;11;5;16
20405;Pilaitukas;BITUTĖS;3345387791;Taip;4;4;1;9
20406;Pilaitukas;BITUTĖS;3913169122;Taip;10;0;1;11
20407;Pilaitukas;BITUTĖS;3541354283;Taip;10;2;0;12
20408;Pilaitukas;BITUTĖS;7342388716;Taip;0;0;4;4
20409;Pilaitukas;BITUTĖS;5740951665;Taip;16;4;0;20
20410;Pilaitukas;BITUTĖS;4591799893;Taip;21;0;0;21
20411;Pilaitukas;BITUTĖS;6308557885;Taip;21;0;0;21
20412;Pilaitukas;BITUTĖS;6514731102;Taip;21;0;0;21
20413;Pilaitukas;BITUTĖS;5988165204;Taip;3;0;1;4
20414;Pilaitukas;BITUTĖS;3037850837;Ne;3;0;2;5
20415;Pilaitukas;BITUTĖS;9126553732;Taip;2;0;2;4
20416;Pilaitukas;BITUTĖS;7438112270;Taip;0;0;3;3
20417;Pilaitukas;ZUIKUČIAI;8993885764;Ne;10;0;0;10
20418;Pilaitukas;ZUIKUČIAI;5206637809;Taip;9;0;3;12
20419;Pilaitukas;ZUIKUČIAI;5288784331;Taip;0;0;2;2
20420;Pilaitukas;ZUIKUČIAI;8255398803;Ne;13;0;0;13
20421;Pilaitukas;ZUIKUČIAI;2862447956;Taip;9;4;0;13
20422;Pilaitukas;ZUIKUČIAI;8727175656;Taip;9;4;0;13
20423;Pilaitukas;ZUIKUČIAI;8207194955;Taip;10;0;0;10
20424;Pilaitukas;ZUIKUČIAI;5640802570;Taip;6;0;2;8
20425;Pilaitukas;ZUIKUČIAI;4623818227;Taip;0;0;4;4
20426;Pilaitukas;ZUIKUČIAI;9260893320;Taip;0;1;1;2
20427;Pilaitukas;ZUIKUČIAI;9988041515;Taip;13;0;0;13
20428;Pilaitukas;ZUIKUČIAI;9108428738;Taip;13;0;0;13
20429;Pilaitukas;ZUIKUČIAI;1607454890;Taip;8;0;1;9
20430;Pilaitukas;ZUIKUČIAI;9878890346;Ne;7;0;7;14
20431;Pilaitukas;ZUIKUČIAI;6838035491;Taip;5;0;1;6
20432;Pilaitukas;ZUIKUČIAI;5710747769;Taip;9;0;3;12
20433;Pilaitukas;ZUIKUČIAI;7568744500;Taip;0;8;0;8
20434;Pilaitukas;ZUIKUČIAI;5407354218;Taip;12;4;0;16
20435;Pilaitukas;ZUIKUČIAI;9414051187;Taip;20;0;0;20
20436;Pilaitukas;ANČIUKAI;5949185075;Taip;5;4;0;9
20437;Pilaitukas;ANČIUKAI;92108889661;Ne;0;0;2;2
20438;Pilaitukas;ANČIUKAI;9724892897;Taip;0;4;1;5
20439;Pilaitukas;ANČIUKAI;36338976218;Taip;6;0;0;6
20440;Pilaitukas;ANČIUKAI;1114477688;Taip;7;4;0;11
20441;Pilaitukas;ANČIUKAI;1512181401;Taip;5;4;2;11
20442;Pilaitukas;ANČIUKAI;3821748678;Taip;7;4;0;11
20443;Pilaitukas;ANČIUKAI;6222888898;Taip;10;4;0;14
20444;Pilaitukas;ANČIUKAI;8319676743;Taip;8;4;0;12
20445;Pilaitukas;ANČIUKAI;4505384039;Taip;10;0;0;10
20446;Pilaitukas;ANČIUKAI;5206439753;Taip;14;2;1;17
20447;Pilaitukas;ANČIUKAI;79485847381;Taip;7;5;0;12
20448;Pilaitukas;ANČIUKAI;5211988291;Taip;16;4;0;20
20449;Pilaitukas;ANČIUKAI;2117570444;Taip;0;17;1;18
20450;Pilaitukas;ANČIUKAI;87760608710;Taip;0;0;20;20
20451;Pilaitukas;ANČIUKAI;7909465673;Taip;5;11;0;16
20452;Pilaitukas;ANČIUKAI;2298935154;Taip;11;0;0;11
20453;Pilaitukas;ANČIUKAI;4694691187;Taip;1;0;5;6
20454;Pilaitukas;ANČIUKAI;9224653856;Taip;6;0;4;10
20455;Pilaitukas;ANČIUKAI;58250008277;Taip;6;4;0;10
20456;Pilaitukas;MEŠKIUKAI;57931719105;Taip;0;5;0;5
20457;Pilaitukas;MEŠKIUKAI;14554050141;Taip;14;0;0;14
20458;Pilaitukas;MEŠKIUKAI;9015675095;Taip;0;4;1;5
20459;Pilaitukas;MEŠKIUKAI;2929868229;Ne;0;4;0;4
20460;Pilaitukas;MEŠKIUKAI;1135880899;Taip;2;4;1;7
20461;Pilaitukas;MEŠKIUKAI;4505147961;Taip;0;4;1;5
20462;Pilaitukas;MEŠKIUKAI;9618329726;Taip;5;0;6;11
20463;Pilaitukas;MEŠKIUKAI;6514784647;Taip;6;0;4;10
20464;Pilaitukas;MEŠKIUKAI;9732741366;Taip;4;2;0;6
20465;Pilaitukas;MEŠKIUKAI;4038320896;Taip;7;13;0;20
20466;Pilaitukas;MEŠKIUKAI;3794882532;Taip;0;6;0;6
20467;Pilaitukas;MEŠKIUKAI;18466900688;Taip;18;0;0;18
20468;Pilaitukas;MEŠKIUKAI;2736736697;Ne;4;0;3;7
20469;Pilaitukas;MEŠKIUKAI;3214740183;Ne;0;8;0;8
20470;Pilaitukas;MEŠKIUKAI;39600380611;Taip;2;0;6;8
20471;Pilaitukas;MEŠKIUKAI;5604992163;Taip;7;9;0;16
20472;Pilaitukas;MEŠKIUKAI;9450834035;Taip;7;9;0;16
20473;Pilaitukas;MEŠKIUKAI;5689385925;Taip;4;4;0;8
20474;Pilaitukas;MEŠKIUKAI;1003278169;Ne;0;4;0;4
20475;Pilaitukas;MEŠKIUKAI;6117985788;Taip;4;0;2;6
20476;Pilaitukas;MEŠKIUKAI;9924612250;Taip;0;4;2;6
20477;Pilaitukas;ŽUVYTĖS;86572852457;Taip;5;4;1;10
20478;Pilaitukas;ŽUVYTĖS;83886439719;Taip;7;4;1;12
20479;Pilaitukas;ŽUVYTĖS;74367577786;Ne;0;4;2;6
20480;Pilaitukas;ŽUVYTĖS;8441380474;Taip;0;6;1;7
20481;Pilaitukas;ŽUVYTĖS;79398058989;Taip;9;4;0;13
20482;Pilaitukas;ŽUVYTĖS;53049608654;Taip;4;8;0;12
20483;Pilaitukas;ŽUVYTĖS;62992423192;Taip;5;4;2;11
20484;Pilaitukas;ŽUVYTĖS;1707355162;Ne;0;1;1;2
20485;Pilaitukas;ŽUVYTĖS;27233065857;Ne;0;2;0;2
20486;Pilaitukas;ŽUVYTĖS;49728283339;Taip;0;1;1;2
20487;Pilaitukas;ŽUVYTĖS;1824063553;Taip;2;4;0;6
20488;Pilaitukas;ŽUVYTĖS;37415672544;Taip;12;0;1;13
20489;Pilaitukas;ŽUVYTĖS;44413072002;Taip;5;0;1;6
20490;Pilaitukas;ŽUVYTĖS;66377321935;Taip;0;9;2;11
20491;Pilaitukas;ŽUVYTĖS;63470473930;Taip;11;4;0;15
20492;Pilaitukas;ŽUVYTĖS;45165187254;Taip;0;9;0;9
20493;Pilaitukas;ŽUVYTĖS;1286286153;Ne;0;4;1;5
20494;Pilaitukas;ŽUVYTĖS;1896452184;Taip;8;7;1;16
20495;Pilaitukas;ŽUVYTĖS;49542027658;Taip;5;7;0;12
20496;Pilaitukas;ŽUVYTĖS;3723836301;Taip;8;4;0;12
20497;Pilaitukas;ŽUVYTĖS;6913383121;Ne;0;6;0;6
20498;Pilaitukas;ŽUVYTĖS;50368168240;Taip;0;4;3;7
20499;Pilaitukas;ŽUVYTĖS;81347327136;Taip;6;4;0;10
20500;Pilaitukas;PAUKŠTELIAI;68262699910;Taip;0;4;0;4
20501;Pilaitukas;PAUKŠTELIAI;98876022289;Taip;1;4;1;6
20502;Pilaitukas;PAUKŠTELIAI;25872504305;Taip;7;4;2;13
20503;Pilaitukas;PAUKŠTELIAI;26318820010;Taip;0;9;0;9
20504;Pilaitukas;PAUKŠTELIAI;68819621853;Taip;0;4;0;4
20505;Pilaitukas;PAUKŠTELIAI;99558991322;Taip;0;4;0;4
20506;Pilaitukas;PAUKŠTELIAI;61458733284;Taip;0;0;6;6
20507;Pilaitukas;PAUKŠTELIAI;92116532227;Taip;0;4;3;7
20508;Pilaitukas;PAUKŠTELIAI;88894299577;Taip;5;4;0;9
20509;Pilaitukas;PAUKŠTELIAI;32580431386;Taip;0;4;1;5
20510;Pilaitukas;PAUKŠTELIAI;95753711905;Taip;0;4;0;4
20511;Pilaitukas;PAUKŠTELIAI;46467461875;Ne;3;13;0;16
20512;Pilaitukas;PAUKŠTELIAI;89335569661;Ne;0;5;4;9
20513;Pilaitukas;PAUKŠTELIAI;49882457703;Ne;7;4;1;12
20514;Pilaitukas;PAUKŠTELIAI;97868106590;Taip;0;1;0;1
20515;Pilaitukas;PAUKŠTELIAI;61725559703;Taip;0;8;0;8
20516;Pilaitukas;PAUKŠTELIAI;17314387753;Taip;0;2;3;5
20517;Pilaitukas;PAUKŠTELIAI;36677686051;Taip;0;4;1;5
20518;Pilaitukas;PAUKŠTELIAI;56237836622;Taip;0;5;0;5
20519;Pilaitukas;PAUKŠTELIAI;98123777614;Taip;11;5;0;16
20520;Pilaitukas;PAUKŠTELIAI;93292073339;Taip;9;4;0;13
20521;Pilaitukas;PAUKŠTELIAI;27134663020;Taip;9;4;0;13
20522;Pilaitukas;PAUKŠTELIAI;74933839730;Taip;0;4;0;4
20523;Pilaitukas;PAUKŠTELIAI;29035791508;Ne;0;4;2;6
20524;Pilaitukas;BORUŽĖLĖS;98045145204;Taip;0;4;1;5
20525;Pilaitukas;BORUŽĖLĖS;2145561638;Taip;0;6;0;6
20526;Pilaitukas;BORUŽĖLĖS;14937983736;Taip;0;4;0;4
20527;Pilaitukas;BORUŽĖLĖS;1704733670;Ne;7;0;0;7
20528;Pilaitukas;BORUŽĖLĖS;2308673826;Taip;0;4;4;8
20529;Pilaitukas;BORUŽĖLĖS;1714711904;Taip;6;0;0;6
20530;Pilaitukas;BORUŽĖLĖS;2436416327;Taip;0;0;8;8
20531;Pilaitukas;BORUŽĖLĖS;2561804291;Taip;0;4;6;10
20532;Pilaitukas;BORUŽĖLĖS;9414846817;Taip;6;0;0;6
20533;Pilaitukas;BORUŽĖLĖS;56069293343;Taip;0;4;2;6
20534;Pilaitukas;BORUŽĖLĖS;7156205658;Taip;21;0;0;21
20535;Pilaitukas;BORUŽĖLĖS;8364902911;Taip;9;0;0;9
20536;Pilaitukas;BORUŽĖLĖS;5063602139;Ne;12;0;0;12
20537;Pilaitukas;BORUŽĖLĖS;5464065587;Taip;5;0;6;11
20538;Pilaitukas;BORUŽĖLĖS;5984878126;Taip;9;0;5;14
20539;Pilaitukas;BORUŽĖLĖS;84508228457;Taip;5;0;1;6
20540;Pilaitukas;BORUŽĖLĖS;1142014148;Taip;0;2;0;2
20541;Pilaitukas;BORUŽĖLĖS;95439358242;Ne;12;0;0;12
20542;Pilaitukas;BORUŽĖLĖS;6024861998;Taip;19;0;0;19
20543;Pilaitukas;BORUŽĖLĖS;58416972423;Taip;0;0;12;12
20544;Pilaitukas;BORUŽĖLĖS;9898379569;Taip;2;4;0;6
20545;Pilaitukas;DRUGELIAI;7961518607;Taip;13;0;0;13
20546;Pilaitukas;DRUGELIAI;7082054458;Taip;13;0;0;13
20547;Pilaitukas;DRUGELIAI;1290119150;Taip;4;4;0;8
20548;Pilaitukas;DRUGELIAI;64601938351;Ne;0;8;1;9
20549;Pilaitukas;DRUGELIAI;38456484551;Taip;0;7;1;8
20550;Pilaitukas;DRUGELIAI;7838787153;Taip;0;4;4;8
20551;Pilaitukas;DRUGELIAI;2613078582;Taip;13;4;0;17
20552;Pilaitukas;DRUGELIAI;9246391309;Ne;10;1;4;15
20553;Pilaitukas;DRUGELIAI;1677962644;Taip;12;3;0;15
20554;Pilaitukas;DRUGELIAI;4745358362;Taip;12;3;0;15
20555;Pilaitukas;DRUGELIAI;3483758882;Taip;9;0;3;12
20556;Pilaitukas;DRUGELIAI;7853910193;Taip;7;0;1;8
20557;Pilaitukas;DRUGELIAI;6646474196;Taip;5;3;1;9
20558;Pilaitukas;DRUGELIAI;9801214344;Ne;0;0;13;13
20559;Pilaitukas;DRUGELIAI;5331915157;Taip;13;0;0;13
20560;Pilaitukas;DRUGELIAI;8302624354;Taip;9;0;1;10
20561;Pilaitukas;DRUGELIAI;5422289286;Taip;4;4;0;8
20562;Pilaitukas;DRUGELIAI;1272758839;Taip;10;4;0;14
20563;Pilaitukas;PELIUKAI;89730708991;Taip;0;6;0;6
20564;Pilaitukas;PELIUKAI;71302602535;Taip;5;7;0;12
20565;Pilaitukas;PELIUKAI;28559756114;Taip;5;4;0;9
20566;Pilaitukas;PELIUKAI;54387359229;Taip;6;4;0;10
20567;Pilaitukas;PELIUKAI;29229117661;Taip;0;8;0;8
20568;Pilaitukas;PELIUKAI;15303269615;Taip;0;4;0;4
20569;Pilaitukas;PELIUKAI;12327235652;Ne;0;9;0;9
20570;Pilaitukas;PELIUKAI;26063381713;Ne;11;0;0;11
20571;Pilaitukas;PELIUKAI;90148331957;Taip;0;4;0;4
20572;Pilaitukas;PELIUKAI;89719236172;Ne;0;11;0;11
20573;Pilaitukas;PELIUKAI;49084081967;Taip;4;4;0;8
20574;Pilaitukas;PELIUKAI;3685682772;Taip;0;21;0;21
20575;Pilaitukas;PELIUKAI;25608611239;Taip;1;0;0;1
20576;Pilaitukas;PELIUKAI;54706920576;Taip;7;0;0;7
20577;Pilaitukas;PELIUKAI;1168958446;Taip;9;4;0;13
20578;Pilaitukas;PELIUKAI;8152280709;Taip;11;4;0;15
20579;Pilaitukas;PELIUKAI;1613536796;Taip;16;0;0;16
20580;Pilaitukas;PELIUKAI;42514613325;Taip;12;0;0;12
20581;Pilaitukas;PELIUKAI;1611616941;Taip;0;9;0;9
20582;Pilaitukas;PELIUKAI;68571454940;Ne;0;0;1;1
20583;Pilaitukas;PELIUKAI;1779631590;Taip;0;7;0;7
20584;Pilaitukas;KAČIUKAI;74264627858;Taip;10;4;0;14
20585;Pilaitukas;KAČIUKAI;71072645939;Taip;0;4;0;4
20586;Pilaitukas;KAČIUKAI;70465651068;Taip;0;4;0;4
20587;Pilaitukas;KAČIUKAI;4283157555;Taip;4;4;0;8
20588;Pilaitukas;KAČIUKAI;78293798850;Taip;7;4;0;11
20589;Pilaitukas;KAČIUKAI;90472705680;Taip;0;4;0;4
20590;Pilaitukas;KAČIUKAI;58064353914;Taip;0;3;0;3
20591;Pilaitukas;KAČIUKAI;92823052045;Taip;1;4;1;6
20592;Pilaitukas;KAČIUKAI;7032684121;Taip;0;4;0;4
20593;Pilaitukas;KAČIUKAI;91980974377;Taip;0;3;1;4
20594;Pilaitukas;KAČIUKAI;28902841059;Taip;7;4;1;12
20595;Pilaitukas;KAČIUKAI;2045735700;Taip;7;4;2;13
20596;Pilaitukas;KAČIUKAI;78048449266;Taip;0;4;0;4
20597;Pilaitukas;KAČIUKAI;82688660737;Taip;4;4;0;8
20598;Pilaitukas;KAČIUKAI;1508672511;Taip;8;2;2;12
20599;Pilaitukas;KAČIUKAI;4348058482;Taip;0;4;0;4
20600;Pilaitukas;KAČIUKAI;1056269188;Taip;0;3;0;3
20601;Pilaitukas;KAČIUKAI;17571219106;Ne;4;0;1;5
20602;Pilaitukas;KAČIUKAI;34346418650;Ne;7;0;0;7
20603;Pilaitukas;KAČIUKAI;8640149293;Ne;0;4;0;4
20604;Pilaitukas;KAČIUKAI;9496336005;Taip;12;3;0;15
20605;Pilaitukas;KAČIUKAI;6069797837;Taip;5;4;4;13
20606;Pilaitukas;SAULUTĖS;7222856683;Taip;0;21;0;21
20607;Pilaitukas;SAULUTĖS;6436694057;Taip;0;0;4;4
20608;Pilaitukas;SAULUTĖS;4719223490;Taip;11;0;4;15
20609;Pilaitukas;SAULUTĖS;8787181006;Taip;10;3;0;13
20610;Pilaitukas;SAULUTĖS;9247501721;Taip;18;0;0;18
20611;Pilaitukas;SAULUTĖS;3825942473;Taip;0;11;0;11
20612;Pilaitukas;SAULUTĖS;9870994949;Taip;20;0;0;20
20613;Pilaitukas;SAULUTĖS;3298272815;Taip;20;0;0;20
20614;Pilaitukas;SAULUTĖS;1731106179;Taip;15;3;0;18
20615;Pilaitukas;SAULUTĖS;8767785444;Taip;11;1;3;15
20616;Pilaitukas;SAULUTĖS;2697591669;Ne;5;0;8;13
20617;Pilaitukas;SAULUTĖS;3954210452;Ne;15;3;0;18
20618;Pilaitukas;SAULUTĖS;3772830210;Ne;0;4;6;10
20619;Pilaitukas;SAULUTĖS;1611371690;Taip;0;0;17;17
20620;Pilaitukas;SAULUTĖS;9974310580;Taip;4;0;2;6
20621;Pilaitukas;MENULIUKAI;4014329370;Taip;4;0;0;4
20622;Pilaitukas;MENULIUKAI;9774222130;Taip;10;0;5;15
20623;Pilaitukas;MENULIUKAI;4810825253;Taip;11;4;0;15
20624;Pilaitukas;MENULIUKAI;8877142428;Taip;4;0;0;4
20625;Pilaitukas;MENULIUKAI;9556421129;Taip;9;0;2;11
20626;Pilaitukas;MENULIUKAI;8168228529;Ne;4;2;2;8
20627;Pilaitukas;MENULIUKAI;5421602723;Taip;14;1;0;15
20628;Pilaitukas;MENULIUKAI;8769116377;Taip;5;0;1;6
20629;Pilaitukas;MENULIUKAI;8501376663;Taip;9;4;0;13
20630;Pilaitukas;MENULIUKAI;6833933586;Taip;7;2;0;9
20631;Pilaitukas;MENULIUKAI;1270365948;Taip;3;0;0;3
20632;Pilaitukas;MENULIUKAI;2416277190;Taip;0;21;0;21
20633;Pilaitukas;MENULIUKAI;7808204054;Ne;14;0;0;14
20634;Pilaitukas;ĖŽIUKAI;9653647227;Taip;0;4;17;21
20635;Pilaitukas;ĖŽIUKAI;5326689274;Taip;0;4;17;21
20636;Pilaitukas;ĖŽIUKAI;2463482642;Ne;20;0;0;20
20637;Pilaitukas;ĖŽIUKAI;9038324313;Taip;6;4;0;10
20638;Pilaitukas;ĖŽIUKAI;2406183145;Taip;0;7;0;7
20639;Pilaitukas;ĖŽIUKAI;2379660463;Taip;0;7;0;7
20640;Pilaitukas;ĖŽIUKAI;1585341963;Taip;9;0;0;9
20641;Pilaitukas;ĖŽIUKAI;3080014745;Taip;11;2;0;13
20642;Pilaitukas;ĖŽIUKAI;5353687011;Taip;20;0;0;20
20643;Pilaitukas;ĖŽIUKAI;6102253106;Taip;11;0;0;11
20644;Pilaitukas;ĖŽIUKAI;8009040109;Taip;3;11;0;14
20645;Pilaitukas;ĖŽIUKAI;4022543517;Taip;4;1;0;5
20646;Pilaitukas;ĖŽIUKAI;7594484959;Taip;0;9;0;9
20647;Pilaitukas;ĖŽIUKAI;6525191057;Taip;8;0;0;8
20648;Pilaitukas;ĖŽIUKAI;9187961584;Taip;16;0;0;16
20649;"Naujųjų verkių";Lopšelinė;1994856959;Taip;6;4;0;10
20650;"Naujųjų verkių";Lopšelinė;1045355492;Taip;16;0;0;16
20651;"Naujųjų verkių";Lopšelinė;3825572125;Taip;0;6;0;6
20652;"Naujųjų verkių";Lopšelinė;8223747534;Ne;12;0;0;12
20653;"Naujųjų verkių";Lopšelinė;7916257692;Taip;0;4;0;4
20654;"Naujųjų verkių";Lopšelinė;9200073539;Taip;0;5;0;5
20655;"Naujųjų verkių";Lopšelinė;8429923120;Taip;5;0;0;5
20656;"Naujųjų verkių";Lopšelinė;1693323032;Taip;21;0;0;21
20657;"Naujųjų verkių";Lopšelinė;7010430969;Taip;3;9;0;12
20658;"Naujųjų verkių";Lopšelinė;9462019924;Taip;0;6;0;6
20659;"Naujųjų verkių";Lopšelinė;7734802846;Taip;0;2;0;2
20660;"Naujųjų verkių";Lopšelinė;3459439843;Taip;0;9;0;9
20661;"Naujųjų verkių";Lopšelinė;7510541192;Taip;0;12;0;12
20662;"Naujųjų verkių";Lopšelinė;6162836315;Taip;8;3;0;11
20663;"Naujųjų verkių";Darželinė;12970840107;Taip;4;2;0;6
20664;"Naujųjų verkių";Darželinė;91710448735;Taip;11;1;0;12
20665;"Naujųjų verkių";Darželinė;70974231925;Taip;0;8;0;8
20666;"Naujųjų verkių";Darželinė;60556803369;Taip;0;4;0;4
20667;"Naujųjų verkių";Darželinė;2636744220;Taip;0;7;0;7
20668;"Naujųjų verkių";Darželinė;4419831934;Taip;0;1;0;1
20669;"Naujųjų verkių";Darželinė;1273331977;Taip;5;4;0;9
20670;"Naujųjų verkių";Darželinė;45101251137;Taip;0;5;0;5
20671;"Naujųjų verkių";Darželinė;1321551506;Taip;0;9;0;9
20672;"Naujųjų verkių";Darželinė;1061601585;Ne;0;12;0;12
20673;"Naujųjų verkių";Darželinė;19360482785;Ne;0;4;0;4
20674;"Naujųjų verkių";Darželinė;49937307547;Taip;0;21;0;21
20675;"Naujųjų verkių";Darželinė;89540088936;Taip;0;2;0;2
20676;"Naujųjų verkių";Darželinė;1023447413;Taip;0;4;0;4
20677;"Naujųjų verkių";Darželinė;7872515649;Taip;14;0;0;14
20678;"Naujųjų verkių";Darželinė;9840473841;Taip;5;0;0;5
20679;"Naujųjų verkių";Darželinė;63932903598;Taip;5;0;0;5
20680;"Naujųjų verkių";Darželinė;3572188688;Taip;11;0;0;11
20681;Švelnukas;Pelėdžiukai;97312326369;Taip;0;6;0;6
20682;Švelnukas;Pelėdžiukai;35501839416;Taip;4;2;0;6
20683;Švelnukas;Pelėdžiukai;1102317067;Taip;3;6;0;9
20684;Švelnukas;Pelėdžiukai;54159329795;Taip;0;4;0;4
20685;Švelnukas;Pelėdžiukai;56353311492;Taip;6;6;4;16
20686;Švelnukas;Pelėdžiukai;23911831780;Taip;0;4;0;4
20687;Švelnukas;Pelėdžiukai;73720184241;Taip;2;6;0;8
20688;Švelnukas;Pelėdžiukai;94832155557;Taip;12;6;0;18
20689;Švelnukas;Pelėdžiukai;1398812288;Taip;0;6;0;6
20690;Švelnukas;Pelėdžiukai;4006769867;Taip;0;9;0;9
20691;Švelnukas;Pelėdžiukai;39249642586;Taip;0;5;1;6
20692;Švelnukas;Pelėdžiukai;81569596159;Taip;0;7;0;7
20693;Švelnukas;Pelėdžiukai;12011187563;Taip;5;5;0;10
20694;Švelnukas;Pelėdžiukai;72764312386;Ne;0;7;0;7
20695;Švelnukas;Pelėdžiukai;59229958089;Taip;16;4;0;20
20696;Švelnukas;Pelėdžiukai;57026029080;Taip;5;4;0;9
20697;Švelnukas;Pelėdžiukai;30679686753;Taip;12;4;0;16
20698;Švelnukas;Pelėdžiukai;32473329970;Ne;0;6;0;6
20699;Švelnukas;Pelėdžiukai;50326830712;Taip;4;8;0;12
20700;Švelnukas;Pelėdžiukai;16880708270;Taip;0;4;0;4
20701;Švelnukas;Pelėdžiukai;19279790066;Taip;0;6;0;6
20702;Švelnukas;Pelėdžiukai;76470453844;Taip;0;6;0;6
20703;Švelnukas;Pelėdžiukai;88430357193;Taip;3;5;0;8
20704;Švelnukas;Pelėdžiukai;52477782880;Taip;5;5;0;10
20705;Švelnukas;Pelėdžiukai;2123115761;Taip;0;5;0;5
20706;Švelnukas;Ežiukai;89383668208;Taip;6;4;0;10
20707;Švelnukas;Ežiukai;79306550532;Taip;5;3;0;8
20708;Švelnukas;Ežiukai;68248605297;Taip;7;4;0;11
20709;Švelnukas;Ežiukai;41867077386;Ne;12;6;0;18
20710;Švelnukas;Ežiukai;64192510147;Taip;5;3;0;8
20711;Švelnukas;Ežiukai;41365412569;Taip;0;6;2;8
20712;Švelnukas;Ežiukai;25374873288;Taip;8;5;0;13
20713;Švelnukas;Ežiukai;15308444101;Taip;0;0;5;5
20714;Švelnukas;Ežiukai;6282389058;Taip;10;4;0;14
20715;Švelnukas;Ežiukai;1755384216;Ne;11;4;0;15
20716;Švelnukas;Ežiukai;23795609183;Taip;4;4;0;8
20717;Švelnukas;Ežiukai;31881188589;Taip;0;6;0;6
20718;Švelnukas;Ežiukai;38902466526;Taip;14;0;0;14
20719;Švelnukas;Ežiukai;33263455673;Taip;5;5;1;11
20720;Švelnukas;Ežiukai;8399963483;Taip;8;0;3;11
20721;Švelnukas;Ežiukai;8681264696;Taip;12;9;0;21
20722;Švelnukas;Ežiukai;3126384599;Ne;3;5;3;11
20723;Švelnukas;Ežiukai;5608926908;Taip;0;0;2;2
20724;Švelnukas;Ežiukai;4373567509;Ne;7;0;8;15
20725;Švelnukas;Ežiukai;73628749439;Taip;0;0;1;1
20726;Švelnukas;Ežiukai;2521009631;Ne;7;4;0;11
20727;Švelnukas;Ežiukai;56642886337;Taip;0;4;4;8
20728;Švelnukas;Švelnukai;4681584014;Taip;17;0;0;17
20729;Švelnukas;Švelnukai;8211289456;Taip;3;0;0;3
20730;Švelnukas;Švelnukai;6607578153;Taip;10;0;0;10
20731;Švelnukas;Švelnukai;8847738918;Taip;3;1;0;4
20732;Švelnukas;Švelnukai;5212827184;Taip;13;0;0;13
20733;Švelnukas;Švelnukai;9829912750;Taip;5;0;5;10
20734;Švelnukas;Švelnukai;2464467471;Taip;5;4;0;9
20735;Švelnukas;Švelnukai;5213589179;Taip;15;3;0;18
20736;Švelnukas;Švelnukai;4544791546;Taip;16;0;0;16
20737;Švelnukas;Švelnukai;1963518457;Taip;0;21;0;21
20738;Švelnukas;Švelnukai;5936821902;Taip;7;0;0;7
20739;Švelnukas;Švelnukai;3228293160;Taip;0;0;8;8
20740;Švelnukas;Boružiukai;1951447127;Taip;10;0;0;10
20741;Švelnukas;Boružiukai;3849957906;Taip;8;0;0;8
20742;Švelnukas;Boružiukai;5550841477;Taip;9;4;0;13
20743;Švelnukas;Boružiukai;9722532034;Ne;9;0;1;10
20744;Švelnukas;Boružiukai;2400781175;Taip;18;0;0;18
20745;Švelnukas;Boružiukai;1264256177;Taip;7;0;4;11
20746;Švelnukas;Boružiukai;1332533332;Taip;7;0;2;9
20747;Švelnukas;Boružiukai;8787505507;Taip;5;0;0;5
20748;Švelnukas;Boružiukai;4134678301;Ne;10;0;0;10
20749;Švelnukas;Boružiukai;8458233793;Taip;4;4;0;8
20750;Švelnukas;Boružiukai;7967996032;Taip;14;0;2;16
20751;Švelnukas;Boružiukai;8951980999;Taip;0;0;7;7
20752;Švelnukas;Boružiukai;4990399144;Taip;12;3;0;15
20753;Švelnukas;Boružiukai;9575767514;Taip;0;0;3;3
20754;Švelnukas;Boružiukai;6282137936;Taip;3;5;1;9
20755;Švelnukas;Boružiukai;5409130195;Taip;16;0;0;16
20756;Švelnukas;Boružiukai;9479536507;Taip;7;0;3;10
20757;Švelnukas;Boružiukai;2088128734;Ne;0;0;8;8
20758;Švelnukas;Boružiukai;3145935641;Taip;8;6;0;14
20759;Švelnukas;Smalsučiai;76418408780;Taip;13;2;0;15
20760;Švelnukas;Smalsučiai;82202942341;Taip;0;11;0;11
20761;Švelnukas;Smalsučiai;63394075248;Taip;0;4;0;4
20762;Švelnukas;Smalsučiai;53619702326;Taip;7;5;0;12
20763;Švelnukas;Smalsučiai;1183982303;Taip;0;4;0;4
20764;Švelnukas;Smalsučiai;74759523550;Taip;0;1;1;2
20765;Švelnukas;Smalsučiai;87770765141;Taip;3;0;1;4
20766;Švelnukas;Smalsučiai;47645479348;Taip;0;6;0;6
20767;Švelnukas;Smalsučiai;19117783391;Taip;4;0;0;4
20768;Švelnukas;Smalsučiai;26077395334;Ne;9;5;0;14
20769;Švelnukas;Smalsučiai;15711256627;Taip;0;8;0;8
20770;Švelnukas;Smalsučiai;95780894209;Taip;2;0;7;9
20771;Švelnukas;Smalsučiai;76563731138;Taip;0;13;0;13
20772;Švelnukas;Smalsučiai;3388721433;Taip;0;1;0;1
20773;Švelnukas;Smalsučiai;1742714140;Taip;1;0;7;8
20774;Švelnukas;Smalsučiai;54425041280;Taip;0;4;0;4
20775;Švelnukas;Smalsučiai;91569132037;Taip;0;10;0;10
20776;Švelnukas;Smalsučiai;34570338962;Taip;7;0;4;11
20777;Švelnukas;Smalsučiai;78611632021;Taip;5;10;0;15
20778;Švelnukas;Smalsučiai;1139744541;Taip;0;0;3;3
20779;Švelnukas;Smalsučiai;15774114007;Taip;20;0;0;20
20780;Švelnukas;Smalsučiai;26312856720;Taip;16;0;1;17
20781;Švelnukas;Nykštukai;5518267134;Ne;16;0;0;16
20782;Švelnukas;Nykštukai;1293700097;Taip;0;4;0;4
20783;Švelnukas;Nykštukai;8221642452;Taip;0;6;0;6
20784;Švelnukas;Nykštukai;2141519946;Taip;6;7;0;13
20785;Švelnukas;Nykštukai;8771953161;Taip;0;4;0;4
20786;Švelnukas;Nykštukai;5327209876;Ne;3;3;0;6
20787;Švelnukas;Nykštukai;2282356211;Taip;14;3;0;17
20788;Švelnukas;Nykštukai;4697253853;Ne;0;6;0;6
20789;Švelnukas;Nykštukai;7387060610;Taip;0;10;0;10
20790;Švelnukas;Nykštukai;1762528313;Taip;6;6;3;15
20791;Švelnukas;Nykštukai;7380948648;Taip;13;0;0;13
20792;Švelnukas;Nykštukai;3473146893;Taip;13;0;0;13
20793;Švelnukas;Nykštukai;3370028567;Taip;1;5;0;6
20794;Švelnukas;Nykštukai;62969317035;Ne;20;0;0;20
20795;Švelnukas;Nykštukai;6633233824;Taip;13;0;0;13
20796;Švelnukas;Nykštukai;2106591525;Ne;13;0;0;13
20797;Švelnukas;Nykštukai;93497358197;Taip;13;0;0;13
20798;Švelnukas;Nykštukai;2971380970;Taip;0;5;0;5
20799;Švelnukas;Nykštukai;3389897065;Taip;0;5;0;5
20800;Švelnukas;Nykštukai;4302735157;Taip;21;0;0;21
20801;Švelnukas;Nykštukai;2785396019;Ne;0;6;4;10
20802;Švelnukas;Nykštukai;6195335543;Ne;0;0;6;6
20803;Boružėlė;"Nykštukai gudručiai";16750834044;Taip;7;1;0;8
20804;Boružėlė;"Nykštukai gudručiai";17133057179;Taip;5;11;0;16
20805;Boružėlė;"Nykštukai gudručiai";48975225740;Taip;0;2;0;2
20806;Boružėlė;"Nykštukai gudručiai";61157651941;Ne;0;4;0;4
20807;Boružėlė;"Nykštukai gudručiai";27819440058;Taip;0;4;0;4
20808;Boružėlė;"Nykštukai gudručiai";62849453206;Taip;0;6;0;6
20809;Boružėlė;"Nykštukai gudručiai";90752643228;Taip;0;5;0;5
20810;Boružėlė;"Nykštukai gudručiai";91349343635;Taip;0;3;0;3
20811;Boružėlė;"Nykštukai gudručiai";52470353273;Taip;12;4;0;16
20812;Boružėlė;"Nykštukai gudručiai";3659004986;Taip;0;2;0;2
20813;Boružėlė;"Nykštukai gudručiai";28726593347;Taip;0;4;0;4
20814;Boružėlė;"Nykštukai gudručiai";47122226309;Taip;0;4;0;4
20815;Boružėlė;"Nykštukai gudručiai";13957276157;Taip;6;4;0;10
20816;Boružėlė;"Nykštukai gudručiai";29807061047;Taip;0;2;0;2
20817;Boružėlė;"Nykštukai gudručiai";55985459125;Ne;0;5;0;5
20818;Boružėlė;"Nykštukai gudručiai";68875252308;Taip;0;5;0;5
20819;Boružėlė;"Nykštukai gudručiai";22491205325;Taip;0;2;0;2
20820;Boružėlė;"Nykštukai gudručiai";229765248;Taip;0;4;0;4
20821;Boružėlė;"Nykštukai gudručiai";82591189080;Taip;0;9;0;9
20822;Boružėlė;"Nykštukai gudručiai";5105514215;Taip;0;5;0;5
20823;Boružėlė;"Nykštukai gudručiai";64502791927;Taip;0;4;0;4
20824;Boružėlė;"Nykštukai gudručiai";95194187600;Taip;0;6;0;6
20825;Boružėlė;"Nykštukai gudručiai";59772973857;Taip;5;6;0;11
20826;Boružėlė;"Nykštukai gudručiai";473765285;Taip;0;2;0;2
20827;Boružėlė;"Saulės zuikučiai";4554260776;Taip;20;0;0;20
20828;Boružėlė;"Saulės zuikučiai";8259586236;Taip;10;0;0;10
20829;Boružėlė;"Saulės zuikučiai";3955841578;Taip;10;0;0;10
20830;Boružėlė;"Saulės zuikučiai";1583223569;Taip;10;2;0;12
20831;Boružėlė;"Saulės zuikučiai";5516103398;Taip;10;0;0;10
20832;Boružėlė;"Saulės zuikučiai";5298170118;Taip;11;5;0;16
20833;Boružėlė;"Saulės zuikučiai";9271331800;Taip;7;2;1;10
20834;Boružėlė;"Saulės zuikučiai";2133849514;Taip;5;5;0;10
20835;Boružėlė;"Saulės zuikučiai";1116012068;Ne;21;0;0;21
20836;Boružėlė;"Saulės zuikučiai";3412892266;Taip;4;0;1;5
20837;Boružėlė;"Saulės zuikučiai";1292298259;Taip;5;0;0;5
20838;Boružėlė;"Saulės zuikučiai";3130977416;Taip;16;0;0;16
20839;Boružėlė;"Saulės zuikučiai";7256396576;Taip;0;2;6;8
20840;Boružėlė;"Saulės zuikučiai";4323998138;Taip;21;0;0;21
20841;Boružėlė;"Saulės zuikučiai";2087238951;Taip;2;2;0;4
20842;Boružėlė;"Saulės zuikučiai";4999277693;Taip;10;0;0;10
20843;Boružėlė;"Saulės zuikučiai";6990311896;Taip;10;0;0;10
20844;Boružėlė;"Saulės zuikučiai";4509233532;Taip;12;4;0;16
20845;Boružėlė;"Saulės zuikučiai";3952645542;Taip;10;7;0;17
20846;Boružėlė;Gėlytės;4023646693;Taip;10;0;0;10
20847;Boružėlė;Gėlytės;51321138507;Taip;5;4;9;18
20848;Boružėlė;Gėlytės;62298785353;Taip;7;4;0;11
20849;Boružėlė;Gėlytės;84087304104;Taip;7;0;3;10
20850;Boružėlė;Gėlytės;11785706048;Taip;14;0;0;14
20851;Boružėlė;Gėlytės;41726574939;Taip;4;2;0;6
20852;Boružėlė;Gėlytės;81433480408;Taip;2;4;0;6
20853;Boružėlė;Gėlytės;51923600458;Taip;0;4;2;6
20854;Boružėlė;Gėlytės;77207874939;Taip;0;6;0;6
20855;Boružėlė;Gėlytės;60999303687;Taip;0;1;0;1
20856;Boružėlė;Gėlytės;86742600111;Taip;0;3;0;3
20857;Boružėlė;Gėlytės;43579952892;Taip;0;9;0;9
20858;Boružėlė;Gėlytės;40388424785;Taip;9;0;0;9
20859;Boružėlė;Gėlytės;54530233692;Ne;0;6;0;6
20860;Boružėlė;Gėlytės;25443948372;Taip;2;4;0;6
20861;Boružėlė;Gėlytės;33639051694;Taip;0;10;0;10
20862;Boružėlė;Gėlytės;57842027470;Taip;0;5;0;5
20863;Boružėlė;Gėlytės;1010790194;Taip;3;5;1;9
20864;Boružėlė;Gėlytės;1813949172;Taip;2;7;0;9
20865;Boružėlė;Gėlytės;9148646597;Taip;0;5;0;5
20866;Boružėlė;Gėlytės;5306841409;Taip;0;4;0;4
20867;Boružėlė;Gėlytės;1080735912;Taip;0;4;0;4
20868;Boružėlė;Gėlytės;43198292519;Taip;0;4;1;5
20869;Boružėlė;Smalsutis;2086485441;Taip;0;0;4;4
20870;Boružėlė;Smalsutis;5129244830;Taip;14;0;0;14
20871;Boružėlė;Smalsutis;6927100979;Ne;9;2;2;13
20872;Boružėlė;Smalsutis;2887130633;Taip;9;0;0;9
20873;Boružėlė;Smalsutis;4947670606;Taip;10;0;2;12
20874;Boružėlė;Smalsutis;5267216044;Taip;4;0;0;4
20875;Boružėlė;Smalsutis;2917508421;Taip;5;0;5;10
20876;Boružėlė;Smalsutis;7263730692;Taip;6;0;1;7
20877;Boružėlė;Smalsutis;5708558321;Taip;0;5;0;5
20878;Boružėlė;Smalsutis;6484173786;Taip;7;4;0;11
20879;Boružėlė;Smalsutis;6742157071;Taip;0;0;3;3
20880;Boružėlė;Smalsutis;2132904457;Ne;0;7;6;13
20881;Boružėlė;Smalsutis;77513300382;Ne;7;0;0;7
20882;Boružėlė;Smalsutis;39553430808;Taip;0;9;5;14
20883;Boružėlė;Smalsutis;4958704459;Taip;5;6;2;13
20884;Boružėlė;Smalsutis;5618586722;Taip;0;4;0;4
20885;Boružėlė;Smalsutis;8493908653;Taip;0;4;0;4
20886;Boružėlė;Smalsutis;4283064680;Taip;0;0;3;3
20887;Boružėlė;Smalsutis;2447148171;Ne;5;6;2;13
20888;Boružėlė;Smalsutis;1391562352;Taip;0;0;3;3
20889;Boružėlė;Drugeliai;8357946299;Taip;11;1;0;12
20890;Boružėlė;Drugeliai;1130980139;Taip;0;6;0;6
20891;Boružėlė;Drugeliai;6463583187;Taip;2;6;0;8
20892;Boružėlė;Drugeliai;6049501362;Taip;0;6;0;6
20893;Boružėlė;Drugeliai;8683282162;Taip;9;2;0;11
20894;Boružėlė;Drugeliai;3136028536;Taip;9;0;0;9
20895;Boružėlė;Drugeliai;2211576663;Taip;6;7;0;13
20896;Boružėlė;Drugeliai;1559001916;Taip;3;5;1;9
20897;Boružėlė;Drugeliai;4233602822;Taip;16;0;0;16
20898;Boružėlė;Drugeliai;9463322491;Taip;15;0;0;15
20899;Boružėlė;Drugeliai;3108758436;Taip;0;5;1;6
20900;Boružėlė;Drugeliai;8482813204;Ne;8;0;1;9
20901;Boružėlė;Drugeliai;6369070055;Taip;0;0;1;1
20902;Boružėlė;Drugeliai;6902130914;Taip;17;0;0;17
20903;Boružėlė;Drugeliai;3459207879;Ne;8;1;1;10
20904;Boružėlė;Drugeliai;1545244006;Taip;0;5;1;6
20905;Boružėlė;Drugeliai;6980022864;Taip;14;0;0;14
20906;Boružėlė;Drugeliai;7756929745;Taip;0;1;0;1
20907;Boružėlė;Drugeliai;5726187445;Taip;0;1;4;5
20908;Boružėlė;Drugeliai;2308405580;Taip;10;0;0;10
20909;Boružėlė;Vyturėliai;1913540317;Taip;0;0;2;2
20910;Boružėlė;Vyturėliai;1950269258;Taip;0;10;0;10
20911;Boružėlė;Vyturėliai;1591582954;Taip;7;8;0;15
20912;Boružėlė;Vyturėliai;9180459278;Taip;0;4;0;4
20913;Boružėlė;Vyturėliai;3322567969;Taip;2;3;0;5
20914;Boružėlė;Vyturėliai;1718509953;Taip;0;3;0;3
20915;Boružėlė;Vyturėliai;8311383437;Taip;9;1;0;10
20916;Boružėlė;Vyturėliai;7534482245;Ne;13;1;0;14
20917;Boružėlė;Vyturėliai;3310676316;Taip;0;0;3;3
20918;Boružėlė;Vyturėliai;87834777247;Ne;5;4;0;9
20919;Boružėlė;Vyturėliai;50071056728;Taip;5;13;0;18
20920;Boružėlė;Vyturėliai;43300167107;Taip;0;3;0;3
20921;Boružėlė;Vyturėliai;2098408445;Taip;0;6;0;6
20922;Boružėlė;Vyturėliai;8706461730;Taip;0;10;0;10
20923;Boružėlė;Vyturėliai;5337704114;Taip;0;3;0;3
20924;Boružėlė;Vyturėliai;8146684259;Taip;0;8;0;8
20925;Boružėlė;Vyturėliai;8225622711;Taip;6;1;0;7
20926;Boružėlė;Vyturėliai;67504667512;Taip;0;3;0;3
20927;Boružėlė;Vyturėliai;9150703371;Taip;2;4;0;6
20928;Boružėlė;Vyturėliai;5811751925;Taip;0;3;0;3
20929;Boružėlė;Vyturėliai;7136428795;Taip;0;5;0;5
20930;Boružėlė;Žvaigždutės;9838823214;Taip;21;0;0;21
20931;Boružėlė;Žvaigždutės;7825636053;Taip;1;9;0;10
20932;Boružėlė;Žvaigždutės;6293878183;Taip;0;5;0;5
20933;Boružėlė;Žvaigždutės;7901880926;Taip;9;2;1;12
20934;Boružėlė;Žvaigždutės;6242220139;Taip;9;4;0;13
20935;Boružėlė;Žvaigždutės;1663216529;Taip;0;3;0;3
20936;Boružėlė;Žvaigždutės;3489498503;Taip;8;5;0;13
20937;Boružėlė;Žvaigždutės;5274016839;Taip;0;6;1;7
20938;Boružėlė;Žvaigždutės;6972646373;Taip;2;2;0;4
20939;Boružėlė;Žvaigždutės;9720535449;Taip;0;6;3;9
20940;Boružėlė;Žvaigždutės;6435556131;Taip;0;6;3;9
20941;Boružėlė;Žvaigždutės;3140264242;Taip;0;4;0;4
20942;Boružėlė;Žvaigždutės;1136249597;Taip;11;0;0;11
20943;Boružėlė;Žvaigždutės;5804189049;Taip;0;4;1;5
20944;Boružėlė;Žvaigždutės;8029389952;Taip;2;4;0;6
20945;Boružėlė;Žvaigždutės;5307997577;Taip;19;0;1;20
20946;Boružėlė;Žvaigždutės;7078709057;Taip;9;0;0;9
20947;Boružėlė;Žvaigždutės;8213060214;Taip;2;4;0;6
20948;Boružėlė;Žvaigždutės;8916241914;Taip;7;1;0;8
20949;Boružėlė;Žvaigždutės;6724101421;Taip;5;3;0;8
20950;Boružėlė;Ąžuoliukai;5774358876;Taip;0;7;1;8
20951;Boružėlė;Ąžuoliukai;4519645340;Taip;0;10;0;10
20952;Boružėlė;Ąžuoliukai;24315678618;Taip;9;0;3;12
20953;Boružėlė;Ąžuoliukai;4994696176;Taip;0;1;0;1
20954;Boružėlė;Ąžuoliukai;5138737297;Taip;4;1;0;5
20955;Boružėlė;Ąžuoliukai;2618814096;Ne;0;6;0;6
20956;Boružėlė;Ąžuoliukai;6439902117;Taip;2;5;0;7
20957;Boružėlė;Ąžuoliukai;3040376382;Taip;1;4;1;6
20958;Boružėlė;Ąžuoliukai;3912668735;Taip;11;6;0;17
20959;Boružėlė;Ąžuoliukai;3840860155;Taip;5;0;0;5
20960;Boružėlė;Ąžuoliukai;3869817904;Taip;0;6;2;8
20961;Boružėlė;Ąžuoliukai;7722277859;Taip;5;4;0;9
20962;Boružėlė;Ąžuoliukai;6954794465;Taip;2;6;0;8
20963;Boružėlė;Ąžuoliukai;6545116373;Taip;0;15;0;15
20964;Boružėlė;Ąžuoliukai;5832223872;Taip;0;2;2;4
20965;Boružėlė;Ąžuoliukai;3695411422;Ne;2;1;2;5
20966;Boružėlė;Ąžuoliukai;5148410392;Ne;0;0;9;9
20967;Boružėlė;Ąžuoliukai;76222777017;Taip;0;2;3;5
20968;Boružėlė;Ąžuoliukai;45181369655;Taip;5;4;0;9
20969;Boružėlė;Ąžuoliukai;6022191251;Taip;0;1;8;9
20970;Boružėlė;Saulutės;55049551150;Taip;0;7;0;7
20971;Boružėlė;Saulutės;1311485296;Taip;0;6;5;11
20972;Boružėlė;Saulutės;64389558278;Taip;1;3;0;4
20973;Boružėlė;Saulutės;46425201501;Taip;5;7;0;12
20974;Boružėlė;Saulutės;1399195259;Taip;7;9;0;16
20975;Boružėlė;Saulutės;72321159041;Taip;0;8;0;8
20976;Boružėlė;Saulutės;1247185819;Taip;0;6;0;6
20977;Boružėlė;Saulutės;1910653135;Ne;0;4;8;12
20978;Boružėlė;Saulutės;1527135537;Taip;0;2;0;2
20979;Boružėlė;Saulutės;8814486475;Taip;0;8;3;11
20980;Boružėlė;Saulutės;48414697489;Taip;4;6;0;10
20981;Boružėlė;Saulutės;3004650727;Taip;3;0;0;3
20982;Boružėlė;Saulutės;4567360023;Taip;5;6;1;12
20983;Boružėlė;Saulutės;96500755145;Ne;3;5;0;8
20984;Boružėlė;Saulutės;1506999888;Taip;0;5;0;5
20985;Boružėlė;Saulutės;2402968573;Taip;0;5;0;5
20986;Boružėlė;Saulutės;2690216341;Ne;7;5;0;12
20987;Boružėlė;Saulutės;1456577285;Taip;0;3;0;3
20988;Boružėlė;Saulutės;64347371263;Taip;0;5;0;5
20989;Boružėlė;Saulutės;1040409859;Taip;4;2;0;6
20990;Boružėlė;Saulutės;1750151078;Taip;0;2;7;9
20991;Boružėlė;Saulutės;1580917200;Taip;0;4;1;5
20992;Boružėlė;Saulutės;89046897963;Taip;0;2;5;7
20993;Boružėlė;Ežiukai;1637965530;Taip;7;4;0;11
20994;Boružėlė;Ežiukai;80490841186;Taip;21;0;0;21
20995;Boružėlė;Ežiukai;9645420240;Taip;3;4;0;7
20996;Boružėlė;Ežiukai;97765175729;Taip;4;4;0;8
20997;Boružėlė;Ežiukai;9436674675;Taip;0;3;0;3
20998;Boružėlė;Ežiukai;58923894463;Taip;6;4;0;10
20999;Boružėlė;Ežiukai;27456755162;Taip;7;4;0;11
21000;Boružėlė;Ežiukai;1339605077;Taip;0;6;0;6
21001;Boružėlė;Ežiukai;80239337645;Taip;0;4;0;4
21002;Boružėlė;Ežiukai;1007058344;Taip;7;4;0;11
21003;Boružėlė;Ežiukai;86859788504;Taip;5;4;0;9
21004;Boružėlė;Ežiukai;2138048547;Ne;16;0;0;16
21005;Boružėlė;Ežiukai;1431869021;Taip;10;4;0;14
21006;Boružėlė;Ežiukai;1474967056;Taip;12;4;0;16
21007;Boružėlė;Ežiukai;1732533643;Taip;0;4;0;4
21008;Boružėlė;Ežiukai;62548032852;Taip;4;6;0;10
21009;Boružėlė;Ežiukai;87991501724;Taip;0;6;0;6
21010;Boružėlė;Ežiukai;17258743024;Taip;0;5;0;5
21011;Boružėlė;Ežiukai;31109596405;Taip;8;9;0;17
21012;Boružėlė;Ežiukai;3702413611;Taip;6;0;0;6
21013;Boružėlė;Ežiukai;49403734292;Taip;14;0;0;14
21014;Boružėlė;Ežiukai;46486992436;Taip;0;9;0;9
21015;Boružėlė;Ežiukai;39704329817;Taip;8;4;0;12
21016;Boružėlė;Ežiukai;61932744418;Taip;6;9;0;15
21017;Boružėlė;Ežiukai;1459630343;Taip;0;9;0;9
21018;Boružėlė;Ežiukai;8266904750;Taip;0;2;0;2
21019;Boružėlė;Ežiukai;80378241169;Taip;6;1;0;7
21020;Boružėlė;Ežiukai;73347816357;Taip;6;1;0;7
21021;Boružėlė;Boružiukai;4433248526;Taip;0;0;5;5
21022;Boružėlė;Boružiukai;9520696660;Taip;5;0;0;5
21023;Boružėlė;Boružiukai;3288141024;Taip;5;6;0;11
21024;Boružėlė;Boružiukai;7942043844;Taip;7;11;0;18
21025;Boružėlė;Boružiukai;3226733236;Taip;3;4;0;7
21026;Boružėlė;Boružiukai;2842256033;Taip;2;2;0;4
21027;Boružėlė;Boružiukai;7262515868;Taip;0;5;0;5
21028;Boružėlė;Boružiukai;1146297996;Taip;0;6;0;6
21029;Boružėlė;Boružiukai;3340082011;Taip;6;2;0;8
21030;Boružėlė;Boružiukai;4020348640;Taip;13;0;3;16
21031;Boružėlė;Boružiukai;1166207929;Ne;9;2;0;11
21032;Boružėlė;Boružiukai;2561969142;Taip;4;0;0;4
21033;Boružėlė;Boružiukai;7956982615;Ne;10;2;3;15
21034;Boružėlė;Boružiukai;6070356395;Taip;15;0;0;15
21035;Boružėlė;Boružiukai;4637656311;Taip;5;0;0;5
21036;Boružėlė;Boružiukai;5768415821;Taip;9;0;12;21
21037;Boružėlė;Boružiukai;2524469162;Taip;16;2;0;18
21038;Boružėlė;Nykštukai;6590829182;Ne;17;0;0;17
21039;Boružėlė;Nykštukai;8141240094;Taip;0;5;2;7
21040;Boružėlė;Nykštukai;3129825206;Taip;0;10;0;10
21041;Boružėlė;Nykštukai;2349571778;Taip;0;7;0;7
21042;Boružėlė;Nykštukai;3171990207;Taip;0;5;0;5
21043;Boružėlė;Nykštukai;1894170218;Taip;20;0;0;20
21044;Boružėlė;Nykštukai;1784594085;Taip;10;4;0;14
21045;Boružėlė;Nykštukai;3509512899;Taip;17;1;0;18
21046;Boružėlė;Nykštukai;8888151470;Taip;17;1;0;18
21047;Boružėlė;Nykštukai;3430953692;Ne;10;10;1;21
21048;Boružėlė;Nykštukai;6166247730;Taip;0;6;0;6
21049;Boružėlė;Nykštukai;8365962523;Taip;3;4;1;8
21050;Boružėlė;Nykštukai;6876323023;Taip;0;0;19;19
21051;Boružėlė;Nykštukai;2744894565;Taip;17;4;0;21
21052;Boružėlė;Nykštukai;9771767352;Taip;13;0;0;13
21053;Boružėlė;Nykštukai;2571360077;Taip;0;2;0;2
21054;Boružėlė;Nykštukai;5825164520;Taip;2;0;0;2
21055;Boružėlė;Nykštukai;4990831292;Taip;13;0;2;15
21056;Boružėlė;Nykštukai;8789209196;Taip;14;0;1;15
21057;Boružėlė;Nykštukai;3592853535;Taip;10;2;0;12
21058;Žaliakalnio;Drugeliai;38025903441;Taip;0;6;0;6
21059;Žaliakalnio;Drugeliai;98394011032;Ne;0;5;2;7
21060;Žaliakalnio;Drugeliai;96127127960;Ne;5;5;0;10
21061;Žaliakalnio;Drugeliai;69892069029;Taip;3;4;0;7
21062;Žaliakalnio;Drugeliai;1012597457;Taip;7;5;0;12
21063;Žaliakalnio;Drugeliai;55967554391;Taip;12;1;0;13
21064;Žaliakalnio;Drugeliai;1357321617;Taip;5;4;0;9
21065;Žaliakalnio;Drugeliai;1967580906;Ne;7;4;0;11
21066;Žaliakalnio;Drugeliai;19165022144;Taip;0;5;0;5
21067;Žaliakalnio;Drugeliai;5428225559;Ne;4;4;2;10
21068;Žaliakalnio;Drugeliai;1902477771;Taip;0;4;2;6
21069;Žaliakalnio;Drugeliai;56222558457;Taip;12;4;0;16
21070;Žaliakalnio;Drugeliai;2059763621;Taip;0;3;0;3
21071;Žaliakalnio;Drugeliai;21032761681;Taip;12;4;0;16
21072;Žaliakalnio;Drugeliai;1919996835;Taip;5;7;0;12
21073;Žaliakalnio;Drugeliai;12010376482;Taip;0;4;0;4
21074;Žaliakalnio;Drugeliai;12932356909;Taip;0;5;1;6
21075;Žaliakalnio;Boružėlių;5843020412;Taip;16;1;0;17
21076;Žaliakalnio;Boružėlių;9625531462;Taip;5;14;0;19
21077;Žaliakalnio;Boružėlių;6699373334;Taip;5;14;0;19
21078;Žaliakalnio;Boružėlių;7087535800;Taip;17;0;0;17
21079;Žaliakalnio;Boružėlių;1528111839;Ne;7;1;0;8
21080;Žaliakalnio;Boružėlių;7023886811;Taip;7;4;0;11
21081;Žaliakalnio;Boružėlių;1673321992;Taip;4;6;0;10
21082;Žaliakalnio;Boružėlių;2284465378;Taip;0;15;0;15
21083;Žaliakalnio;Boružėlių;7977009681;Taip;5;8;0;13
21084;Žaliakalnio;Boružėlių;2808776865;Taip;12;3;0;15
21085;Žaliakalnio;Boružėlių;2278681435;Taip;10;8;0;18
21086;Žaliakalnio;Boružėlių;6547167325;Taip;8;0;0;8
21087;Žaliakalnio;Boružėlių;5157814568;Taip;14;0;0;14
21088;Žaliakalnio;Boružėlių;9421259943;Taip;12;1;0;13
21089;Žaliakalnio;Boružėlių;3445649442;Taip;0;2;0;2
21090;Žaliakalnio;Boružėlių;3105500733;Taip;13;1;0;14
21091;Žaliakalnio;Boružėlių;4864834075;Taip;0;10;0;10
21092;Žaliakalnio;Boružėlių;5764128482;Taip;16;0;0;16
21093;Žaliakalnio;Boružėlių;9848057352;Ne;0;21;0;21
21094;Žaliakalnio;Boružėlių;1200844791;Ne;7;11;0;18
21095;Žaliakalnio;Boružėlių;8052539476;Taip;10;5;0;15
21096;Žaliakalnio;Zuikučiai;1592051491;Ne;0;6;0;6
21097;Žaliakalnio;Zuikučiai;6088333997;Taip;20;0;0;20
21098;Žaliakalnio;Zuikučiai;2621828772;Taip;3;4;0;7
21099;Žaliakalnio;Zuikučiai;2673619031;Taip;0;14;0;14
21100;Žaliakalnio;Zuikučiai;5843314345;Taip;7;4;0;11
21101;Žaliakalnio;Zuikučiai;7447278960;Taip;5;11;0;16
21102;Žaliakalnio;Zuikučiai;2180165053;Taip;19;0;0;19
21103;Žaliakalnio;Zuikučiai;6823528666;Taip;12;2;0;14
21104;Žaliakalnio;Zuikučiai;3509064089;Taip;0;6;0;6
21105;Žaliakalnio;Zuikučiai;7000429934;Taip;7;4;0;11
21106;Žaliakalnio;Zuikučiai;5730610895;Taip;0;9;0;9
21107;Žaliakalnio;Zuikučiai;6881070397;Taip;17;1;0;18
21108;Žaliakalnio;Zuikučiai;8209559343;Taip;21;0;0;21
21109;Žaliakalnio;Zuikučiai;3835667120;Taip;11;4;0;15
21110;Žaliakalnio;Zuikučiai;9799056285;Taip;7;5;0;12
21111;Žaliakalnio;Zuikučiai;1321592040;Taip;9;1;0;10
21112;Žaliakalnio;Zuikučiai;8298313285;Taip;0;8;0;8
21113;Žaliakalnio;Zuikučiai;9331287916;Taip;21;0;0;21
21114;Žaliakalnio;Zuikučiai;6726832258;Taip;5;6;0;11
21115;Žaliakalnio;Zuikučiai;4607456527;Taip;0;12;0;12
21116;Žaliakalnio;Zuikučiai;4511376806;Taip;6;1;0;7
21117;Žaliakalnio;Bitutė;23692122313;Ne;0;15;0;15
21118;Žaliakalnio;Bitutė;47735728560;Taip;9;5;0;14
21119;Žaliakalnio;Bitutė;1581365258;Taip;0;9;0;9
21120;Žaliakalnio;Bitutė;26003637304;Taip;0;15;0;15
21121;Žaliakalnio;Bitutė;46360583256;Taip;10;4;0;14
21122;Žaliakalnio;Bitutė;1027036769;Ne;0;9;0;9
21123;Žaliakalnio;Bitutė;1142844672;Taip;0;14;0;14
21124;Žaliakalnio;Bitutė;1447567627;Taip;0;14;0;14
21125;Žaliakalnio;Bitutė;1113616994;Ne;0;12;0;12
21126;Žaliakalnio;Bitutė;64628389691;Taip;6;6;0;12
21127;Žaliakalnio;Bitutė;1909837418;Ne;5;2;0;7
21128;Žaliakalnio;Bitutė;56508324349;Taip;0;13;0;13
21129;Žaliakalnio;Bitutė;92533370070;Ne;9;9;0;18
21130;Žaliakalnio;Bitutė;7700118291;Ne;7;1;0;8
21131;Žaliakalnio;Bitutė;5761499050;Taip;8;4;0;12
21132;Žaliakalnio;Nykštukų;9057678671;Ne;0;10;0;10
21133;Žaliakalnio;Nykštukų;8640423692;Ne;0;5;0;5
21134;Žaliakalnio;Nykštukų;19192494119;Taip;0;9;0;9
21135;Žaliakalnio;Nykštukų;91524700281;Taip;0;11;0;11
21136;Žaliakalnio;Nykštukų;1932906021;Taip;0;8;0;8
21137;Žaliakalnio;Nykštukų;1753760382;Taip;0;5;0;5
21138;Žaliakalnio;Nykštukų;61215164827;Ne;21;0;0;21
21139;Žaliakalnio;Nykštukų;4936664829;Taip;0;1;0;1
21140;Žaliakalnio;Nykštukų;1657390839;Taip;7;9;0;16
21141;Žaliakalnio;Nykštukų;2655227703;Taip;6;3;0;9
21142;Žaliakalnio;Nykštukų;8085215871;Taip;5;6;0;11
21143;Žaliakalnio;Nykštukų;8469042778;Taip;7;9;0;16
21144;Žaliakalnio;Nykštukų;41844570217;Ne;6;1;0;7
21145;Žaliakalnio;Nykštukų;6638075273;Ne;21;0;0;21
21146;Žaliakalnio;Nykštukų;21744638321;Taip;0;14;0;14
21147;Žaliakalnio;Nykštukų;1514982516;Taip;7;14;0;21
21148;Žaliakalnio;Nykštukų;1497932659;Ne;0;2;0;2
21149;Žaliakalnio;Nykštukų;5946168564;Ne;2;9;0;11
21150;Žaliakalnio;Nykštukų;1589546605;Taip;0;8;0;8
21151;Žaliakalnio;Nykštukų;44058368949;Ne;0;13;0;13
21152;Žaliakalnio;Nykštukų;1511544568;Taip;3;2;0;5
21153;Žaliakalnio;ŽIOGELIAI;1413563085;Ne;5;5;0;10
21154;Žaliakalnio;ŽIOGELIAI;7449949339;Ne;14;0;0;14
21155;Žaliakalnio;ŽIOGELIAI;6379145626;Ne;14;2;0;16
21156;Žaliakalnio;ŽIOGELIAI;7094914749;Taip;21;0;0;21
21157;Žaliakalnio;ŽIOGELIAI;2607433844;Taip;6;0;0;6
21158;Žaliakalnio;ŽIOGELIAI;2432935088;Ne;0;8;0;8
21159;Žaliakalnio;ŽIOGELIAI;3058369504;Ne;4;0;0;4
21160;Žaliakalnio;ŽIOGELIAI;9771191966;Taip;12;9;0;21
21161;Žaliakalnio;ŽIOGELIAI;6919074533;Taip;12;3;0;15
21162;Žaliakalnio;ŽIOGELIAI;2426844621;Ne;8;0;0;8
21163;Žaliakalnio;ŽIOGELIAI;4961762841;Taip;17;4;0;21
21164;Žaliakalnio;ŽIOGELIAI;5752912101;Ne;11;6;0;17
21165;Žaliakalnio;ŽIOGELIAI;9967098834;Ne;0;10;0;10
21166;Žaliakalnio;ŽIOGELIAI;1133557422;Taip;0;7;0;7
21167;Žaliakalnio;ŽIOGELIAI;3464935314;Taip;9;3;0;12
21168;Žaliakalnio;ŽIOGELIAI;4497938258;Taip;4;8;0;12
21169;Žaliakalnio;ŽIOGELIAI;7648422668;Ne;8;6;0;14
21170;Žaliakalnio;ŽIOGELIAI;4702470511;Taip;9;2;0;11
21171;Žaliakalnio;ŽIOGELIAI;2272043654;Taip;0;2;3;5
21172;Žaliakalnio;ŽIOGELIAI;9363615751;Taip;0;15;0;15
21173;Volungė;Bitutės;1866419277;Taip;3;4;0;7
21174;Volungė;Bitutės;73677227470;Taip;0;0;5;5
21175;Volungė;Bitutės;58770101384;Taip;9;6;0;15
21176;Volungė;Bitutės;38549010202;Taip;0;4;4;8
21177;Volungė;Bitutės;1184098245;Taip;0;1;0;1
21178;Volungė;Bitutės;77965211614;Taip;0;9;0;9
21179;Volungė;Bitutės;33437446320;Taip;0;4;0;4
21180;Volungė;Bitutės;57009443613;Taip;7;4;0;11
21181;Volungė;Bitutės;87185412767;Ne;5;5;1;11
21182;Volungė;Bitutės;1002996169;Taip;4;7;0;11
21183;Volungė;Bitutės;51999447522;Taip;5;2;3;10
21184;Volungė;Bitutės;54054647743;Taip;5;4;0;9
21185;Volungė;Bitutės;50724446122;Taip;0;0;5;5
21186;Volungė;Bitutės;33864104545;Taip;0;5;6;11
21187;Volungė;Bitutės;1673755671;Taip;0;5;4;9
21188;Volungė;Bitutės;1177104323;Taip;0;9;3;12
21189;Volungė;Bitutės;7623915697;Taip;0;6;1;7
21190;Volungė;Bitutės;6426464927;Taip;0;12;0;12
21191;Volungė;Bitutės;25298531632;Ne;19;2;0;21
21192;Volungė;Boružiukai;28521139566;Ne;0;4;0;4
21193;Volungė;Boružiukai;44878463386;Taip;0;4;0;4
21194;Volungė;Boružiukai;1812871720;Taip;0;4;7;11
21195;Volungė;Boružiukai;1574141255;Taip;7;1;0;8
21196;Volungė;Boružiukai;18572342676;Ne;0;4;11;15
21197;Volungė;Boružiukai;1921353660;Taip;0;0;1;1
21198;Volungė;Boružiukai;16359638255;Taip;4;0;0;4
21199;Volungė;Boružiukai;99572426508;Taip;0;0;1;1
21200;Volungė;Boružiukai;1776413826;Taip;4;0;0;4
21201;Volungė;Boružiukai;52112359999;Ne;0;4;5;9
21202;Volungė;Boružiukai;55920793056;Taip;0;3;2;5
21203;Volungė;Boružiukai;20829614346;Taip;5;4;2;11
21204;Volungė;Boružiukai;50525901200;Taip;7;4;0;11
21205;Volungė;Boružiukai;73555360631;Ne;7;4;2;13
21206;Volungė;Boružiukai;1766449043;Taip;0;4;1;5
21207;Volungė;Boružiukai;55892369610;Taip;0;4;4;8
21208;Volungė;Boružiukai;23806383679;Taip;0;4;7;11
21209;Volungė;Žvirbliukai;7965601199;Taip;6;0;6;12
21210;Volungė;Žvirbliukai;8287344195;Taip;11;2;0;13
21211;Volungė;Žvirbliukai;5710662590;Taip;0;4;6;10
21212;Volungė;Žvirbliukai;1528289101;Taip;6;0;0;6
21213;Volungė;Žvirbliukai;4839484528;Taip;4;0;2;6
21214;Volungė;Žvirbliukai;9188994935;Taip;0;9;0;9
21215;Volungė;Žvirbliukai;8285309230;Taip;0;21;0;21
21216;Volungė;Žvirbliukai;7149986415;Taip;0;4;6;10
21217;Volungė;Žvirbliukai;5174427959;Taip;13;0;8;21
21218;Volungė;Žvirbliukai;7867741556;Ne;6;0;3;9
21219;Volungė;Žvirbliukai;3430719834;Ne;0;4;5;9
21220;Volungė;Žvirbliukai;8459167833;Taip;0;0;11;11
21221;Volungė;Žvirbliukai;6028582927;Taip;0;0;11;11
21222;Volungė;Žvirbliukai;8784150784;Taip;11;4;0;15
21223;Volungė;Žvirbliukai;1137713075;Taip;11;0;7;18
21224;Volungė;Žvirbliukai;9578228103;Taip;0;10;0;10
21225;Volungė;Žvirbliukai;6431477042;Taip;5;0;5;10
21226;Volungė;Žvirbliukai;4598763851;Taip;6;0;2;8
21227;Volungė;Žvirbliukai;2322594823;Taip;21;0;0;21
21228;Volungė;Žvirbliukai;3746978206;Taip;0;0;10;10
21229;Volungė;Žiogeliai;6360834021;Taip;0;0;4;4
21230;Volungė;Žiogeliai;4856240879;Taip;0;0;6;6
21231;Volungė;Žiogeliai;8767261039;Taip;14;0;0;14
21232;Volungė;Žiogeliai;9100947038;Taip;4;0;7;11
21233;Volungė;Žiogeliai;4694016281;Taip;0;0;1;1
21234;Volungė;Žiogeliai;9749609738;Taip;0;0;4;4
21235;Volungė;Žiogeliai;9816038480;Taip;5;0;6;11
21236;Volungė;Žiogeliai;8640511964;Ne;0;0;20;20
21237;Volungė;Žiogeliai;5170536566;Taip;0;1;2;3
21238;Volungė;Žiogeliai;8421730419;Taip;10;0;2;12
21239;Volungė;Žiogeliai;6532202782;Taip;18;0;2;20
21240;Volungė;Žiogeliai;2712034356;Taip;4;7;0;11
21241;Volungė;Žiogeliai;6074678642;Taip;15;0;6;21
21242;Volungė;Žiogeliai;2246291631;Ne;4;0;2;6
21243;Volungė;Žiogeliai;2456643081;Taip;5;0;1;6
21244;Volungė;Žiogeliai;6920821813;Taip;8;0;3;11
21245;Volungė;Žiogeliai;1781838937;Taip;6;15;0;21
21246;Volungė;Pelėdžiukai;1032406917;Taip;0;4;0;4
21247;Volungė;Pelėdžiukai;2106837525;Taip;2;0;0;2
21248;Volungė;Pelėdžiukai;1105647976;Ne;9;0;4;13
21249;Volungė;Pelėdžiukai;1705153224;Taip;10;2;2;14
21250;Volungė;Pelėdžiukai;2048619311;Taip;7;0;1;8
21251;Volungė;Pelėdžiukai;3675279848;Taip;0;4;2;6
21252;Volungė;Pelėdžiukai;9097775073;Ne;4;0;0;4
21253;Volungė;Pelėdžiukai;1938717633;Taip;9;6;0;15
21254;Volungė;Pelėdžiukai;56766828567;Taip;5;3;0;8
21255;Volungė;Pelėdžiukai;1072302178;Taip;0;0;4;4
21256;Volungė;Pelėdžiukai;6977873198;Taip;0;3;0;3
21257;Volungė;Pelėdžiukai;1917593287;Taip;4;0;2;6
21258;Volungė;Pelėdžiukai;2558681375;Taip;0;4;0;4
21259;Volungė;Pelėdžiukai;85731265908;Taip;5;2;0;7
21260;Volungė;Pelėdžiukai;1861218588;Ne;0;0;5;5
21261;Volungė;Pelėdžiukai;5483140534;Taip;0;4;1;5
21262;Volungė;Pelėdžiukai;8236836742;Taip;2;0;2;4
21263;Volungė;Pelėdžiukai;1158253769;Ne;0;0;1;1
21264;Volungė;Pelėdžiukai;3632828615;Taip;0;2;3;5
21265;Volungė;Drugeliai;2111319986;Taip;0;4;5;9
21266;Volungė;Drugeliai;1742777458;Taip;0;8;1;9
21267;Volungė;Drugeliai;2139675610;Taip;0;4;6;10
21268;Volungė;Drugeliai;1752357091;Taip;0;0;7;7
21269;Volungė;Drugeliai;1974360497;Taip;0;4;7;11
21270;Volungė;Drugeliai;86769531194;Taip;0;4;1;5
21271;Volungė;Drugeliai;86784613109;Taip;0;0;10;10
21272;Volungė;Drugeliai;3803129970;Taip;9;7;0;16
21273;Volungė;Drugeliai;1726933019;Taip;0;4;10;14
21274;Volungė;Drugeliai;1333045175;Ne;0;0;10;10
21275;Volungė;Drugeliai;1900204936;Taip;3;1;0;4
21276;Volungė;Drugeliai;1333755594;Taip;0;0;8;8
21277;Volungė;Drugeliai;1539188909;Taip;0;4;10;14
21278;Volungė;Drugeliai;1731981819;Ne;9;0;1;10
21279;Volungė;Drugeliai;2763686861;Taip;4;0;2;6
21280;Volungė;Drugeliai;19340864795;Taip;3;0;6;9
21281;Volungė;Drugeliai;3155184296;Taip;0;4;8;12
21282;Volungė;Drugeliai;7075466773;Taip;6;0;0;6
21283;Volungė;Drugeliai;1291153830;Taip;0;12;0;12
21284;Volungė;Drugeliai;1167124464;Taip;4;4;0;8
21285;Volungė;"SKRUZDĖLIUKAI ";8174587725;Taip;14;0;2;16
21286;Volungė;"SKRUZDĖLIUKAI ";7521910384;Taip;0;0;7;7
21287;Volungė;"SKRUZDĖLIUKAI ";5240126123;Taip;13;0;0;13
21288;Volungė;"SKRUZDĖLIUKAI ";8268202101;Taip;7;4;1;12
21289;Volungė;"SKRUZDĖLIUKAI ";2566901599;Taip;0;0;5;5
21290;Volungė;"SKRUZDĖLIUKAI ";3215314804;Ne;0;0;9;9
21291;Volungė;"SKRUZDĖLIUKAI ";7281448136;Ne;2;0;0;2
21292;Volungė;"SKRUZDĖLIUKAI ";2420242319;Taip;0;5;4;9
21293;Volungė;"SKRUZDĖLIUKAI ";1120682487;Taip;2;1;3;6
21294;Volungė;"SKRUZDĖLIUKAI ";1366066359;Taip;9;0;2;11
21295;Volungė;"SKRUZDĖLIUKAI ";9068889427;Ne;5;4;2;11
21296;Volungė;"SKRUZDĖLIUKAI ";6565522808;Taip;5;4;1;10
21297;Volungė;"SKRUZDĖLIUKAI ";1225378067;Ne;5;0;3;8
21298;Volungė;"SKRUZDĖLIUKAI ";3356901662;Taip;19;0;0;19
21299;Volungė;"SKRUZDĖLIUKAI ";9082860913;Taip;7;0;5;12
21300;Volungė;"SKRUZDĖLIUKAI ";9629567682;Taip;7;0;9;16
21301;Volungė;"SKRUZDĖLIUKAI ";3814647332;Taip;0;5;14;19
21302;Volungė;"SKRUZDĖLIUKAI ";4123080241;Taip;19;0;0;19
21303;Volungė;Zylutės;8905401944;Taip;11;0;0;11
21304;Volungė;Zylutės;2530804242;Taip;0;0;4;4
21305;Volungė;Zylutės;2686827560;Taip;11;0;0;11
21306;Volungė;Zylutės;9973604148;Taip;2;0;2;4
21307;Volungė;Zylutės;6782622442;Ne;7;4;3;14
21308;Volungė;Zylutės;5354511593;Taip;10;0;1;11
21309;Volungė;Zylutės;7574856429;Taip;21;0;0;21
21310;Volungė;Zylutės;9729285419;Taip;0;4;12;16
21311;Volungė;Zylutės;5284011092;Taip;2;4;1;7
21312;Volungė;Zylutės;2981560931;Taip;18;0;0;18
21313;Volungė;Zylutės;4252713086;Taip;8;0;1;9
21314;Volungė;Zylutės;2923810441;Taip;0;0;2;2
21315;Volungė;Zylutės;4427076715;Taip;7;4;1;12
21316;Volungė;Zylutės;3020629341;Taip;21;0;0;21
21317;Volungė;Zylutės;1164632050;Taip;0;0;8;8
21318;Giliukas;SMALSUČIAI;1289574961;Taip;2;5;0;7
21319;Giliukas;SMALSUČIAI;1664239181;Taip;0;5;0;5
21320;Giliukas;SMALSUČIAI;9747155435;Taip;0;1;1;2
21321;Giliukas;SMALSUČIAI;2006450088;Ne;9;0;0;9
21322;Giliukas;SMALSUČIAI;89954209937;Taip;0;2;0;2
21323;Giliukas;SMALSUČIAI;40373221046;Taip;0;8;0;8
21324;Giliukas;SMALSUČIAI;9461909264;Taip;0;4;2;6
21325;Giliukas;SMALSUČIAI;8575067944;Ne;7;2;0;9
21326;Giliukas;SMALSUČIAI;1463748654;Taip;0;6;0;6
21327;Giliukas;SMALSUČIAI;45270647252;Taip;0;4;0;4
21328;Giliukas;SMALSUČIAI;26109227683;Taip;0;2;0;2
21329;Giliukas;SMALSUČIAI;1417138570;Taip;0;4;0;4
21330;Giliukas;SMALSUČIAI;4053376466;Ne;10;2;0;12
21331;Giliukas;SMALSUČIAI;1406371374;Ne;2;4;0;6
21332;Giliukas;SMALSUČIAI;34155615138;Ne;0;8;1;9
21333;Giliukas;SMALSUČIAI;10326073797;Taip;5;4;0;9
21334;Giliukas;SMALSUČIAI;7732836522;Taip;5;0;0;5
21335;Giliukas;SMALSUČIAI;5914236976;Taip;0;4;1;5
21336;Giliukas;SMALSUČIAI;9225515816;Taip;0;5;0;5
21337;Giliukas;SMALSUČIAI;6453425490;Taip;6;0;2;8
21338;Giliukas;SMALSUČIAI;1190611675;Ne;0;6;0;6
21339;Giliukas;SMALSUČIAI;14318411597;Taip;2;4;0;6
21340;Giliukas;GUDRUČIAI;51201920656;Taip;12;0;0;12
21341;Giliukas;GUDRUČIAI;2617670085;Ne;0;4;0;4
21342;Giliukas;GUDRUČIAI;1649456516;Taip;16;0;0;16
21343;Giliukas;GUDRUČIAI;1431811346;Taip;0;9;0;9
21344;Giliukas;GUDRUČIAI;76716908362;Taip;0;5;1;6
21345;Giliukas;GUDRUČIAI;1771662094;Taip;0;9;0;9
21346;Giliukas;GUDRUČIAI;60766023175;Taip;0;1;0;1
21347;Giliukas;GUDRUČIAI;1869027087;Taip;0;4;0;4
21348;Giliukas;GUDRUČIAI;4145860286;Taip;0;1;0;1
21349;Giliukas;GUDRUČIAI;7223355423;Taip;4;4;1;9
21350;Giliukas;GUDRUČIAI;1624952768;Ne;0;5;0;5
21351;Giliukas;GUDRUČIAI;84750777858;Taip;0;14;0;14
21352;Giliukas;GUDRUČIAI;76463522285;Taip;0;3;0;3
21353;Giliukas;GUDRUČIAI;1910800137;Taip;0;3;1;4
21354;Giliukas;GUDRUČIAI;9826756136;Taip;0;1;1;2
21355;Giliukas;GUDRUČIAI;1733875411;Taip;9;2;0;11
21356;Giliukas;GUDRUČIAI;8284364049;Taip;0;4;0;4
21357;Giliukas;GUDRUČIAI;80254838594;Taip;0;0;1;1
21358;Giliukas;GUDRUČIAI;4163391813;Taip;7;2;0;9
21359;Giliukas;GUDRUČIAI;50289768374;Taip;0;1;0;1
21360;Giliukas;GUDRUČIAI;6154379463;Taip;0;1;1;2
21361;Giliukas;ŠNEKUČIAI;3691791222;Taip;14;0;0;14
21362;Giliukas;ŠNEKUČIAI;24030146209;Taip;14;0;0;14
21363;Giliukas;ŠNEKUČIAI;3847358328;Taip;15;0;0;15
21364;Giliukas;ŠNEKUČIAI;1890147760;Taip;0;0;1;1
21365;Giliukas;ŠNEKUČIAI;1469477982;Ne;13;0;0;13
21366;Giliukas;ŠNEKUČIAI;3983555939;Taip;0;10;0;10
21367;Giliukas;ŠNEKUČIAI;7780118692;Taip;0;3;1;4
21368;Giliukas;ŠNEKUČIAI;2951628295;Taip;0;2;0;2
21369;Giliukas;ŠNEKUČIAI;9401247559;Taip;0;4;2;6
21370;Giliukas;ŠNEKUČIAI;5994213515;Taip;6;2;0;8
21371;Giliukas;ŠNEKUČIAI;4916844983;Taip;0;6;1;7
21372;Giliukas;ŠNEKUČIAI;5787041097;Taip;13;1;0;14
21373;Giliukas;ŠNEKUČIAI;4987348316;Taip;0;6;1;7
21374;Giliukas;ŠNEKUČIAI;7159681896;Taip;0;0;3;3
21375;Giliukas;ŠNEKUČIAI;7540576615;Taip;0;0;3;3
21376;Giliukas;ŠNEKUČIAI;7386694567;Taip;5;0;1;6
21377;Giliukas;ŠNEKUČIAI;1734336095;Taip;4;0;2;6
21378;Giliukas;PABIRUČIAI;8267507304;Ne;4;10;0;14
21379;Giliukas;PABIRUČIAI;4854370266;Taip;0;6;0;6
21380;Giliukas;PABIRUČIAI;9608331265;Taip;16;0;0;16
21381;Giliukas;PABIRUČIAI;1870173947;Taip;7;0;4;11
21382;Giliukas;PABIRUČIAI;9644050818;Taip;8;6;0;14
21383;Giliukas;PABIRUČIAI;3150981084;Taip;12;2;0;14
21384;Giliukas;PABIRUČIAI;3137768675;Taip;13;1;0;14
21385;Giliukas;PABIRUČIAI;5816317197;Taip;14;2;0;16
21386;Giliukas;PABIRUČIAI;9408948207;Ne;13;1;0;14
21387;Giliukas;PABIRUČIAI;2003990493;Taip;9;3;0;12
21388;Giliukas;PABIRUČIAI;4960232685;Taip;13;0;1;14
21389;Giliukas;PABIRUČIAI;6338583515;Taip;6;2;2;10
21390;Giliukas;PABIRUČIAI;9458151965;Taip;0;0;17;17
21391;Giliukas;PABIRUČIAI;6703080106;Taip;8;2;5;15
21392;Giliukas;PABIRUČIAI;4912872957;Taip;3;0;5;8
21393;Giliukas;PABIRUČIAI;8502974441;Taip;14;1;0;15
21394;"Lazdynų mokykla";Drugeliai;10453975773;Taip;0;12;0;12
21395;"Lazdynų mokykla";Drugeliai;93091209041;Taip;3;6;0;9
21396;"Lazdynų mokykla";Drugeliai;89878430155;Taip;0;3;0;3
21397;"Lazdynų mokykla";Drugeliai;1117304239;Taip;7;2;1;10
21398;"Lazdynų mokykla";Drugeliai;2079967590;Taip;0;1;0;1
21399;"Lazdynų mokykla";Drugeliai;6209271043;Ne;11;2;0;13
21400;"Lazdynų mokykla";Drugeliai;7154882168;Taip;0;21;0;21
21401;"Lazdynų mokykla";Drugeliai;28132502877;Taip;4;4;0;8
21402;"Lazdynų mokykla";Drugeliai;6835150864;Taip;2;12;0;14
21403;"Lazdynų mokykla";Drugeliai;7772177095;Taip;3;0;0;3
21404;"Lazdynų mokykla";Drugeliai;9449948668;Taip;0;13;0;13
21405;"Lazdynų mokykla";Drugeliai;4520091712;Taip;0;0;4;4
21406;"Lazdynų mokykla";Drugeliai;1177208864;Ne;10;1;1;12
21407;"Lazdynų mokykla";Drugeliai;8472834181;Taip;2;3;0;5
21408;"Lazdynų mokykla";Drugeliai;9196184984;Taip;14;4;1;19
21409;"Lazdynų mokykla";Drugeliai;6394098306;Taip;0;0;6;6
21410;"Lazdynų mokykla";Drugeliai;2027751624;Taip;0;4;0;4
21411;"Lazdynų mokykla";Drugeliai;2767732459;Ne;6;3;0;9
21412;"Lazdynų mokykla";Zuikučiai;1065999533;Ne;5;1;0;6
21413;"Lazdynų mokykla";Zuikučiai;5613360688;Ne;9;1;0;10
21414;"Lazdynų mokykla";Zuikučiai;40995112936;Taip;7;4;0;11
21415;"Lazdynų mokykla";Zuikučiai;9591838054;Taip;0;9;0;9
21416;"Lazdynų mokykla";Zuikučiai;8847547438;Ne;11;1;0;12
21417;"Lazdynų mokykla";Zuikučiai;6615724604;Taip;0;4;0;4
21418;"Lazdynų mokykla";Zuikučiai;9386629495;Taip;2;4;1;7
21419;"Lazdynų mokykla";Zuikučiai;1817040419;Taip;0;7;0;7
21420;"Lazdynų mokykla";Zuikučiai;1910670134;Taip;0;5;0;5
21421;"Lazdynų mokykla";Zuikučiai;25106446270;Ne;0;6;0;6
21422;"Lazdynų mokykla";Zuikučiai;9123178095;Taip;0;12;0;12
21423;"Lazdynų mokykla";Zuikučiai;8152577445;Taip;0;0;5;5
21424;"Lazdynų mokykla";Zuikučiai;6848743350;Taip;0;14;0;14
21425;"Lazdynų mokykla";Zuikučiai;1365362641;Taip;3;0;1;4
21426;"Lazdynų mokykla";Zuikučiai;3435025978;Taip;0;4;4;8
21427;"Lazdynų mokykla";Zuikučiai;7549389699;Ne;18;0;0;18
21428;"Lazdynų mokykla";Zuikučiai;8899186547;Taip;2;4;3;9
21429;"Lazdynų mokykla";Zuikučiai;5465094647;Taip;9;1;0;10
21430;"Lazdynų mokykla";Zuikučiai;1044630813;Taip;0;4;0;4
21431;"Lazdynų mokykla";RUPG;8280802645;Taip;9;4;0;13
21432;"Lazdynų mokykla";RUPG;2495494392;Taip;0;21;0;21
21433;"Lazdynų mokykla";RUPG;14092687895;Taip;0;4;0;4
21434;"Lazdynų mokykla";RUPG;11571302488;Taip;0;4;2;6
21435;"Lazdynų mokykla";RUPG;83425301719;Taip;3;4;2;9
21436;"Lazdynų mokykla";RUPG;7809088591;Ne;7;4;1;12
21437;"Lazdynų mokykla";RUPG;1558843252;Taip;9;4;0;13
21438;"Lazdynų mokykla";RUPG;53011933771;Taip;9;4;0;13
21439;"Lazdynų mokykla";RUPG;5286305468;Ne;0;7;0;7
21440;"Lazdynų mokykla";RUPG;7639418071;Ne;0;4;6;10
21441;"Lazdynų mokykla";RUPG;10051044012;Taip;0;7;0;7
21442;"Lazdynų mokykla";RUPG;83174865018;Taip;0;4;0;4
21443;"Lazdynų mokykla";RUPG;3746366243;Taip;1;4;1;6
21444;"Lazdynų mokykla";RUPG;59028339197;Taip;3;4;1;8
21445;"Lazdynų mokykla";RUPG;13284428796;Taip;2;5;0;7
21446;"Lazdynų mokykla";RUPG;2054450461;Taip;0;4;0;4
21447;"Lazdynų mokykla";RUPG;9380814933;Taip;0;4;4;8
21448;"Lazdynų mokykla";RUPG;1837465174;Taip;3;9;0;12
21449;"Lazdynų mokykla";PG;6813765251;Taip;5;6;0;11
21450;"Lazdynų mokykla";PG;6453272974;Taip;0;5;0;5
21451;"Lazdynų mokykla";PG;1602013811;Taip;0;6;0;6
21452;"Lazdynų mokykla";PG;38094866639;Taip;3;4;1;8
21453;"Lazdynų mokykla";PG;58679808617;Ne;0;4;0;4
21454;"Lazdynų mokykla";PG;3349776899;Taip;0;5;0;5
21455;"Lazdynų mokykla";PG;5039060603;Taip;6;4;2;12
21456;"Lazdynų mokykla";PG;5357769446;Taip;0;7;0;7
21457;"Lazdynų mokykla";PG;7276376278;Taip;0;21;0;21
21458;"„Atžalyno” mokykla-darželis";Giliukai;40936892543;Taip;9;5;0;14
21459;"„Atžalyno” mokykla-darželis";Giliukai;1426814743;Taip;9;5;1;15
21460;"„Atžalyno” mokykla-darželis";Giliukai;7699590933;Taip;11;5;0;16
21461;"„Atžalyno” mokykla-darželis";Giliukai;17672482867;Taip;9;5;3;17
21462;"„Atžalyno” mokykla-darželis";Giliukai;9038892388;Taip;5;1;0;6
21463;"„Atžalyno” mokykla-darželis";Giliukai;4537410041;Taip;10;5;0;15
21464;"„Atžalyno” mokykla-darželis";Giliukai;91701621174;Taip;0;5;2;7
21465;"„Atžalyno” mokykla-darželis";Giliukai;98404616387;Taip;9;5;0;14
21466;"„Atžalyno” mokykla-darželis";Giliukai;1267427191;Taip;10;5;0;15
21467;"„Atžalyno” mokykla-darželis";Giliukai;42069870710;Taip;0;5;0;5
21468;"„Atžalyno” mokykla-darželis";Giliukai;28021807339;Taip;0;5;2;7
21469;"„Atžalyno” mokykla-darželis";Giliukai;67652620656;Taip;0;5;0;5
21470;"„Atžalyno” mokykla-darželis";Giliukai;1275007023;Taip;6;5;0;11
21471;"„Atžalyno” mokykla-darželis";Giliukai;17110908746;Taip;0;5;3;8
21472;"„Atžalyno” mokykla-darželis";Giliukai;96867169512;Taip;4;1;0;5
21473;"„Atžalyno” mokykla-darželis";Giliukai;1481021352;Taip;6;5;5;16
21474;"„Atžalyno” mokykla-darželis";Giliukai;94908008744;Taip;0;5;1;6
21475;"„Atžalyno” mokykla-darželis";Giliukai;1997515382;Ne;0;5;3;8
21476;"„Atžalyno” mokykla-darželis";Giliukai;8806492917;Taip;6;5;2;13
21477;"„Atžalyno” mokykla-darželis";Giliukai;8495976081;Ne;9;5;2;16
21478;"„Atžalyno” mokykla-darželis";Giliukai;77204026281;Taip;0;5;0;5
21479;"„Atžalyno” mokykla-darželis";Giliukai;1342370096;Taip;8;5;1;14
21480;"„Atžalyno” mokykla-darželis";Giliukai;3943563359;Taip;11;5;0;16
21481;"„Atžalyno” mokykla-darželis";Riešutėliai;4784990018;Taip;13;0;0;13
21482;"„Atžalyno” mokykla-darželis";Riešutėliai;4345420422;Taip;15;0;0;15
21483;"„Atžalyno” mokykla-darželis";Riešutėliai;71840666522;Taip;13;0;0;13
21484;"„Atžalyno” mokykla-darželis";Riešutėliai;4290226052;Ne;9;6;4;19
21485;"„Atžalyno” mokykla-darželis";Riešutėliai;5596753512;Ne;12;0;5;17
21486;"„Atžalyno” mokykla-darželis";Riešutėliai;9806203065;Taip;14;0;0;14
21487;"„Atžalyno” mokykla-darželis";Riešutėliai;4832534190;Ne;14;0;0;14
21488;"„Atžalyno” mokykla-darželis";Riešutėliai;1151879281;Ne;0;2;1;3
21489;"„Atžalyno” mokykla-darželis";Riešutėliai;9215658103;Taip;7;0;1;8
21490;"„Atžalyno” mokykla-darželis";Riešutėliai;3484401937;Taip;0;0;10;10
21491;"„Atžalyno” mokykla-darželis";Riešutėliai;7652421432;Taip;0;5;0;5
21492;"„Atžalyno” mokykla-darželis";Riešutėliai;2002555659;Taip;0;0;4;4
21493;"„Atžalyno” mokykla-darželis";Riešutėliai;37897965773;Taip;0;0;5;5
21494;"„Atžalyno” mokykla-darželis";Riešutėliai;8254801574;Taip;0;0;12;12
21495;"„Atžalyno” mokykla-darželis";Riešutėliai;9013323901;Taip;10;3;2;15
21496;"„Atžalyno” mokykla-darželis";Riešutėliai;3529875728;Taip;14;0;0;14
21497;"„Atžalyno” mokykla-darželis";Riešutėliai;3770972703;Taip;7;0;9;16
21498;"„Atžalyno” mokykla-darželis";Žirniukai;6903825217;Taip;6;7;0;13
21499;"„Atžalyno” mokykla-darželis";Žirniukai;9101301819;Taip;16;0;0;16
21500;"„Atžalyno” mokykla-darželis";Žirniukai;6602037942;Taip;0;5;0;5
21501;"„Atžalyno” mokykla-darželis";Žirniukai;7579781779;Taip;8;0;0;8
21502;"„Atžalyno” mokykla-darželis";Žirniukai;1915676392;Ne;16;0;0;16
21503;"„Atžalyno” mokykla-darželis";Žirniukai;7669725276;Taip;13;2;0;15
21504;"„Atžalyno” mokykla-darželis";Žirniukai;5986664970;Taip;11;0;1;12
21505;"„Atžalyno” mokykla-darželis";Žirniukai;9913048992;Taip;17;1;0;18
21506;"„Atžalyno” mokykla-darželis";Žirniukai;4616870552;Taip;6;2;2;10
21507;"„Atžalyno” mokykla-darželis";Žirniukai;4107946143;Taip;15;0;0;15
21508;"„Atžalyno” mokykla-darželis";Žirniukai;7883570492;Ne;10;4;0;14
21509;"„Atžalyno” mokykla-darželis";Žirniukai;8320161812;Taip;19;0;0;19
21510;"„Atžalyno” mokykla-darželis";Žirniukai;5335059675;Taip;7;3;0;10
21511;"„Atžalyno” mokykla-darželis";Žirniukai;1766599777;Taip;3;7;0;10
21512;"„Atžalyno” mokykla-darželis";Žirniukai;6922776405;Ne;3;0;0;3
21513;"„Atžalyno” mokykla-darželis";Žirniukai;9690554753;Taip;21;0;0;21
21514;"„Atžalyno” mokykla-darželis";Žirniukai;1961428224;Ne;9;0;6;15
21515;"Vilniaus Emilijos Pliaterytės progimnazija";PELĖDŽIUKAI;1475766630;Taip;17;4;0;21
21516;"Vilniaus Emilijos Pliaterytės progimnazija";PELĖDŽIUKAI;6025990670;Taip;0;4;2;6
21517;"Vilniaus Emilijos Pliaterytės progimnazija";PELĖDŽIUKAI;11101488283;Taip;4;4;0;8
21518;"Vilniaus Emilijos Pliaterytės progimnazija";PELĖDŽIUKAI;1551926849;Taip;4;2;0;6
21519;"Vilniaus Emilijos Pliaterytės progimnazija";PELĖDŽIUKAI;9980215936;Ne;0;4;0;4
21520;"Vilniaus Emilijos Pliaterytės progimnazija";PELĖDŽIUKAI;6406833864;Taip;0;7;0;7
21521;"Vilniaus Emilijos Pliaterytės progimnazija";PELĖDŽIUKAI;2450382256;Taip;0;4;0;4
21522;"Vilniaus Emilijos Pliaterytės progimnazija";PELĖDŽIUKAI;7540156488;Taip;0;11;0;11
21523;"Vilniaus Emilijos Pliaterytės progimnazija";PELĖDŽIUKAI;4146983741;Taip;0;5;0;5
21524;"Vilniaus Emilijos Pliaterytės progimnazija";PELĖDŽIUKAI;9886869275;Taip;0;4;0;4
21525;"Vilniaus Emilijos Pliaterytės progimnazija";PELĖDŽIUKAI;1412529910;Taip;0;7;0;7
21526;"Vilniaus Emilijos Pliaterytės progimnazija";PELĖDŽIUKAI;8202177756;Taip;0;4;0;4
21527;"Vilniaus Emilijos Pliaterytės progimnazija";PELĖDŽIUKAI;96590022188;Taip;2;7;0;9
21528;"Vilniaus Emilijos Pliaterytės progimnazija";PELĖDŽIUKAI;15309143797;Taip;3;0;0;3
21529;"Vilniaus Emilijos Pliaterytės progimnazija";PELĖDŽIUKAI;63585262568;Taip;0;3;1;4
21530;"Vilniaus Emilijos Pliaterytės progimnazija";PELĖDŽIUKAI;1653793823;Taip;0;2;0;2
21531;"Vilniaus Emilijos Pliaterytės progimnazija";BITUTĖS;68989648581;Taip;0;6;5;11
21532;"Vilniaus Emilijos Pliaterytės progimnazija";BITUTĖS;8848135087;Taip;6;4;0;10
21533;"Vilniaus Emilijos Pliaterytės progimnazija";BITUTĖS;49658335428;Taip;0;4;0;4
21534;"Vilniaus Emilijos Pliaterytės progimnazija";BITUTĖS;18253351529;Taip;9;4;1;14
21535;"Vilniaus Emilijos Pliaterytės progimnazija";BITUTĖS;40082135876;Taip;0;4;3;7
21536;"Vilniaus Emilijos Pliaterytės progimnazija";BITUTĖS;57217727711;Taip;0;4;0;4
21537;"Vilniaus Emilijos Pliaterytės progimnazija";BITUTĖS;57461575212;Taip;0;4;0;4
21538;"Vilniaus Emilijos Pliaterytės progimnazija";BITUTĖS;3419150668;Ne;0;5;0;5
21539;"Vilniaus Emilijos Pliaterytės progimnazija";BITUTĖS;9371122369;Taip;0;4;2;6
21540;"Vilniaus Emilijos Pliaterytės progimnazija";BITUTĖS;4680059512;Taip;4;4;1;9
21541;"Vilniaus Emilijos Pliaterytės progimnazija";BITUTĖS;3608072547;Taip;0;0;4;4
21542;"Vilniaus Emilijos Pliaterytės progimnazija";BITUTĖS;8303408604;Taip;0;21;0;21
21543;"Vilniaus Emilijos Pliaterytės progimnazija";BITUTĖS;1082350468;Taip;7;4;1;12
21544;"Vilniaus Emilijos Pliaterytės progimnazija";BITUTĖS;3431209621;Ne;7;4;0;11
21545;"Vilniaus Emilijos Pliaterytės progimnazija";BITUTĖS;2519294942;Taip;9;4;0;13
21546;"Vilniaus Emilijos Pliaterytės progimnazija";BITUTĖS;2188905055;Taip;0;6;3;9
21547;"Vilniaus Emilijos Pliaterytės progimnazija";BITUTĖS;1167405137;Taip;2;4;0;6
21548;"Vilniaus Emilijos Pliaterytės progimnazija";BITUTĖS;61701898739;Taip;3;4;0;7
21549;"Vilniaus Karaliaus Mindaugo pagrindinė mokykla";"PUG 3";1860540266;Taip;12;0;9;21
21550;"Vilniaus Karaliaus Mindaugo pagrindinė mokykla";"PUG 3";9555191234;Taip;0;0;17;17
21551;"Vilniaus Karaliaus Mindaugo pagrindinė mokykla";"PUG 3";9136681731;Taip;0;0;6;6
21552;"Vilniaus Karaliaus Mindaugo pagrindinė mokykla";"PUG 3";3680257542;Ne;0;0;9;9
21553;"Vilniaus Karaliaus Mindaugo pagrindinė mokykla";"PUG 3";1257750782;Taip;5;4;0;9
21554;"Vilniaus Karaliaus Mindaugo pagrindinė mokykla";"PUG 3";1401502095;Ne;0;0;9;9
21555;"Vilniaus Karaliaus Mindaugo pagrindinė mokykla";"PUG 3";65541524010;Taip;0;4;3;7
21556;"Vilniaus Karaliaus Mindaugo pagrindinė mokykla";"PUG 3";1450039671;Taip;0;0;2;2
21557;"Vilniaus Karaliaus Mindaugo pagrindinė mokykla";"PUG 3";61864833085;Taip;0;0;4;4
21558;"Vilniaus Karaliaus Mindaugo pagrindinė mokykla";"PUG 3";1823039323;Taip;0;0;4;4
21559;"Vilniaus Karaliaus Mindaugo pagrindinė mokykla";"PUG 3";1969208564;Taip;0;4;2;6
21560;"Vilniaus Karaliaus Mindaugo pagrindinė mokykla";"PUG 3";3447871828;Taip;3;2;0;5
21561;"Vilniaus Karaliaus Mindaugo pagrindinė mokykla";"PUG 3";45774870210;Taip;8;4;0;12
21562;"Vilniaus Karaliaus Mindaugo pagrindinė mokykla";"PUG 3";10083948781;Taip;0;1;0;1
21563;"Vilniaus Karaliaus Mindaugo pagrindinė mokykla";"PUG 3";47224065699;Taip;0;0;5;5
21564;"Vilniaus Karaliaus Mindaugo pagrindinė mokykla";"PUG 2";2027114365;Taip;4;0;0;4
21565;"Vilniaus Karaliaus Mindaugo pagrindinė mokykla";"PUG 2";2787942076;Taip;0;7;0;7
21566;"Vilniaus Karaliaus Mindaugo pagrindinė mokykla";"PUG 2";39088931809;Taip;6;0;5;11
21567;"Vilniaus Karaliaus Mindaugo pagrindinė mokykla";"PUG 2";1812197417;Ne;5;0;4;9
21568;"Vilniaus Karaliaus Mindaugo pagrindinė mokykla";"PUG 2";46282997811;Ne;0;0;6;6
21569;"Vilniaus Karaliaus Mindaugo pagrindinė mokykla";"PUG 2";41323355319;Taip;0;5;0;5
21570;"Vilniaus Karaliaus Mindaugo pagrindinė mokykla";"PUG 2";7641286244;Taip;0;0;5;5
21571;"Vilniaus Karaliaus Mindaugo pagrindinė mokykla";"PUG 2";1245722149;Taip;4;0;9;13
21572;"Vilniaus Karaliaus Mindaugo pagrindinė mokykla";"PUG 2";7259413060;Taip;0;21;0;21
21573;"Vilniaus Karaliaus Mindaugo pagrindinė mokykla";"PUG 2";13211267463;Taip;0;4;2;6
21574;"Vilniaus Karaliaus Mindaugo pagrindinė mokykla";"PUG 2";57220861535;Ne;4;0;2;6
21575;"Vilniaus Karaliaus Mindaugo pagrindinė mokykla";"PUG 2";8452554061;Taip;0;4;1;5
21576;"Vilniaus Karaliaus Mindaugo pagrindinė mokykla";"PUG 2";21847996888;Taip;0;0;2;2
21577;"Vilniaus Karaliaus Mindaugo pagrindinė mokykla";"PUG 2";10114111509;Taip;0;1;1;2
21578;"Vilniaus Karaliaus Mindaugo pagrindinė mokykla";"PUG 2";48069555680;Taip;0;0;11;11
21579;"Vilniaus Karaliaus Mindaugo pagrindinė mokykla";"PUG 2";55747365118;Taip;0;4;2;6
21580;"Vilniaus Karaliaus Mindaugo pagrindinė mokykla";"PUG 1";11446344891;Taip;0;0;1;1
21581;"Vilniaus Karaliaus Mindaugo pagrindinė mokykla";"PUG 1";5049742406;Ne;7;0;0;7
21582;"Vilniaus Karaliaus Mindaugo pagrindinė mokykla";"PUG 1";56814748796;Taip;5;1;2;8
21583;"Vilniaus Karaliaus Mindaugo pagrindinė mokykla";"PUG 1";14054918119;Ne;0;21;0;21
21584;"Vilniaus Karaliaus Mindaugo pagrindinė mokykla";"PUG 1";152363521;Taip;3;5;4;12
21585;"Vilniaus Karaliaus Mindaugo pagrindinė mokykla";"PUG 1";18443760034;Taip;3;0;0;3
21586;"Vilniaus Karaliaus Mindaugo pagrindinė mokykla";"PUG 1";61301531283;Taip;2;0;4;6
21587;"Vilniaus Karaliaus Mindaugo pagrindinė mokykla";"PUG 1";5052576808;Taip;1;6;1;8
21588;"Vilniaus Karaliaus Mindaugo pagrindinė mokykla";"PUG 1";7561608160;Taip;4;0;0;4
21589;"Vilniaus Karaliaus Mindaugo pagrindinė mokykla";"PUG 1";8567961973;Taip;0;21;0;21
21590;"Vilniaus Karaliaus Mindaugo pagrindinė mokykla";"PUG 1";3468743460;Taip;0;21;0;21
21591;"Vilniaus Karaliaus Mindaugo pagrindinė mokykla";"PUG 1";1934113564;Ne;0;5;4;9
21592;"Vilniaus Karaliaus Mindaugo pagrindinė mokykla";"PUG 1";1967327730;Taip;1;4;10;15
21593;"Vilniaus Karaliaus Mindaugo pagrindinė mokykla";"PUG 1";1417730062;Taip;1;4;10;15
21594;"Vilniaus Karaliaus Mindaugo pagrindinė mokykla";"PUG 1";93604802567;Taip;0;0;2;2
21595;"Vilniaus Karaliaus Mindaugo pagrindinė mokykla";"PUG 1";2026314698;Taip;0;0;5;5
21596;"Vilniaus Baltupių progimnazija";Kodėlčiukai;61434205619;Taip;0;5;0;5
21597;"Vilniaus Baltupių progimnazija";Kodėlčiukai;1423766054;Taip;6;0;0;6
21598;"Vilniaus Baltupių progimnazija";Kodėlčiukai;9512110089;Taip;7;4;3;14
21599;"Vilniaus Baltupių progimnazija";Kodėlčiukai;5693741068;Ne;2;4;0;6
21600;"Vilniaus Baltupių progimnazija";Kodėlčiukai;1435972746;Taip;0;6;0;6
21601;"Vilniaus Baltupių progimnazija";Kodėlčiukai;1756560941;Taip;0;4;2;6
21602;"Vilniaus Baltupių progimnazija";Kodėlčiukai;23183915482;Taip;6;4;3;13
21603;"Vilniaus Baltupių progimnazija";Kodėlčiukai;77960723329;Taip;0;4;1;5
21604;"Vilniaus Baltupių progimnazija";Kodėlčiukai;1766518710;Taip;0;12;0;12
21605;"Vilniaus Baltupių progimnazija";Kodėlčiukai;3127742267;Taip;0;4;1;5
21606;"Vilniaus Baltupių progimnazija";Kodėlčiukai;61072571858;Taip;0;4;0;4
21607;"Vilniaus Baltupių progimnazija";Kodėlčiukai;285754903;Taip;5;4;0;9
21608;"Vilniaus Baltupių progimnazija";Kodėlčiukai;82893485399;Taip;7;4;3;14
21609;"Vilniaus Baltupių progimnazija";Kodėlčiukai;60386582602;Taip;0;2;0;2
21610;"Vilniaus Baltupių progimnazija";Kodėlčiukai;59444737813;Taip;0;4;5;9
21611;"Vilniaus Baltupių progimnazija";Kodėlčiukai;12162032447;Taip;8;4;0;12
21612;"Vilniaus Baltupių progimnazija";Kodėlčiukai;40376432941;Taip;0;5;0;5
21613;"Vilniaus Baltupių progimnazija";Smalsučiai;74116167225;Taip;0;4;0;4
21614;"Vilniaus Baltupių progimnazija";Smalsučiai;43183534908;Taip;0;4;0;4
21615;"Vilniaus Baltupių progimnazija";Smalsučiai;2027225055;Taip;0;4;0;4
21616;"Vilniaus Baltupių progimnazija";Smalsučiai;28510314765;Taip;3;4;0;7
21617;"Vilniaus Baltupių progimnazija";Smalsučiai;6541323688;Taip;0;4;0;4
21618;"Vilniaus Baltupių progimnazija";Smalsučiai;51805829511;Taip;0;3;0;3
21619;"Vilniaus Baltupių progimnazija";Smalsučiai;4071266695;Taip;9;0;2;11
21620;"Vilniaus Baltupių progimnazija";Smalsučiai;62371949439;Ne;0;4;0;4
21621;"Vilniaus Baltupių progimnazija";Smalsučiai;484847222;Taip;0;4;0;4
21622;"Vilniaus Baltupių progimnazija";Smalsučiai;96812991513;Taip;1;4;0;5
21623;"Vilniaus Baltupių progimnazija";Smalsučiai;61360761151;Taip;0;4;7;11
21624;"Vilniaus Baltupių progimnazija";Smalsučiai;85813209902;Taip;0;4;0;4
21625;"Vilniaus Baltupių progimnazija";Smalsučiai;52323041708;Taip;0;4;2;6
21626;"Vilniaus Baltupių progimnazija";Smalsučiai;3100442808;Taip;0;11;0;11
21627;"Vilniaus Baltupių progimnazija";Smalsučiai;51243218101;Taip;0;4;5;9
21628;"Vilniaus Baltupių progimnazija";Smalsučiai;2464612365;Ne;7;1;0;8
21629;"Vilniaus Baltupių progimnazija";Smalsučiai;6452806962;Taip;3;4;2;9
21630;"Vilniaus Baltupių progimnazija";Svajokliai;29392171144;Taip;0;4;4;8
21631;"Vilniaus Baltupių progimnazija";Svajokliai;45279808861;Taip;0;9;0;9
21632;"Vilniaus Baltupių progimnazija";Svajokliai;67605405121;Ne;2;4;5;11
21633;"Vilniaus Baltupių progimnazija";Svajokliai;9282551787;Ne;0;4;0;4
21634;"Vilniaus Baltupių progimnazija";Svajokliai;7086903275;Taip;17;4;0;21
21635;"Vilniaus Baltupių progimnazija";Svajokliai;4252327217;Taip;0;4;0;4
21636;"Vilniaus Baltupių progimnazija";Svajokliai;21730416615;Taip;0;4;3;7
21637;"Vilniaus Baltupių progimnazija";Svajokliai;9973922799;Taip;8;4;0;12
21638;"Vilniaus Baltupių progimnazija";Svajokliai;53696873596;Taip;0;4;0;4
21639;"Vilniaus Baltupių progimnazija";Svajokliai;2099549218;Taip;7;4;1;12
21640;"Vilniaus Baltupių progimnazija";Svajokliai;1919180102;Ne;4;4;0;8
21641;"Vilniaus Baltupių progimnazija";Svajokliai;1579287935;Taip;12;4;0;16
21642;"Vilniaus Baltupių progimnazija";Svajokliai;74202598052;Taip;7;4;3;14
21643;"Vilniaus Baltupių progimnazija";Svajokliai;78752324241;Taip;5;4;1;10
21644;"Vilniaus Baltupių progimnazija";Svajokliai;58108486480;Taip;2;6;0;8
21645;"Vilniaus Baltupių progimnazija";Svajokliai;1823681047;Taip;0;11;0;11
21646;"Vilniaus Baltupių progimnazija";Svajokliai;96134869997;Taip;4;4;1;9
21647;"Vilniaus Levo Karsavino vidurinė mokykla";"Priešmokyklinukai A";6379177542;Taip;0;4;0;4
21648;"Vilniaus Levo Karsavino vidurinė mokykla";"Priešmokyklinukai A";1840757726;Taip;0;5;0;5
21649;"Vilniaus Levo Karsavino vidurinė mokykla";"Priešmokyklinukai A";36362624522;Taip;0;4;5;9
21650;"Vilniaus Levo Karsavino vidurinė mokykla";"Priešmokyklinukai A";60768660940;Taip;7;7;0;14
21651;"Vilniaus Levo Karsavino vidurinė mokykla";"Priešmokyklinukai A";9756832600;Taip;5;6;0;11
21652;"Vilniaus Levo Karsavino vidurinė mokykla";"Priešmokyklinukai A";6965021762;Taip;0;7;0;7
21653;"Vilniaus Levo Karsavino vidurinė mokykla";"Priešmokyklinukai A";71494345484;Taip;0;11;0;11
21654;"Vilniaus Levo Karsavino vidurinė mokykla";"Priešmokyklinukai A";1035415228;Taip;0;11;0;11
21655;"Vilniaus Levo Karsavino vidurinė mokykla";"Priešmokyklinukai A";26012978171;Taip;0;4;2;6
21656;"Vilniaus Levo Karsavino vidurinė mokykla";"Priešmokyklinukai A";24566804095;Taip;0;11;0;11
21657;"Vilniaus Levo Karsavino vidurinė mokykla";"Priešmokyklinukai A";27116746304;Taip;0;4;5;9
21658;"Vilniaus Levo Karsavino vidurinė mokykla";"Priešmokyklinukai A";86343860903;Taip;7;4;0;11
21659;"Vilniaus Levo Karsavino vidurinė mokykla";"Priešmokyklinukai A";11546608192;Taip;0;4;1;5
21660;"Vilniaus Levo Karsavino vidurinė mokykla";"Priešmokyklinukai A";3847912854;Taip;0;4;3;7
21661;"Vilniaus Levo Karsavino vidurinė mokykla";"Priešmokyklinukai A";5332069480;Taip;4;4;1;9
21662;"Vilniaus Levo Karsavino vidurinė mokykla";"Priešmokyklinukai A";1620139958;Taip;10;6;0;16
21663;"Vilniaus Levo Karsavino vidurinė mokykla";"Priešmokyklinukai A";1356029457;Taip;0;4;4;8
21664;"Vilniaus Levo Karsavino vidurinė mokykla";"Priešmokyklinukai A";89044270439;Taip;0;4;1;5
21665;"Vilniaus Levo Karsavino vidurinė mokykla";"Priešmokyklinukai A";8870341896;Taip;5;4;1;10
21666;"Vilniaus Levo Karsavino vidurinė mokykla";"Priešmokyklinukai A";27150769109;Taip;0;4;1;5
21667;"Vilniaus Liepkalnio Pagrindinė Mokykla";Bitutės;1181500775;Taip;2;4;1;7
21668;"Vilniaus Liepkalnio Pagrindinė Mokykla";Bitutės;5028304472;Taip;0;4;2;6
21669;"Vilniaus Liepkalnio Pagrindinė Mokykla";Bitutės;3784549444;Taip;0;4;2;6
21670;"Vilniaus Liepkalnio Pagrindinė Mokykla";Bitutės;73391370015;Taip;0;5;0;5
21671;"Vilniaus Liepkalnio Pagrindinė Mokykla";Bitutės;8550048533;Ne;0;4;7;11
21672;"Vilniaus Liepkalnio Pagrindinė Mokykla";Bitutės;1614647892;Taip;0;4;0;4
21673;"Vilniaus Liepkalnio Pagrindinė Mokykla";Bitutės;1886141947;Taip;0;4;3;7
21674;"Vilniaus Liepkalnio Pagrindinė Mokykla";Bitutės;8372336161;Ne;5;4;0;9
21675;"Vilniaus Liepkalnio Pagrindinė Mokykla";Bitutės;1141466643;Taip;0;4;1;5
21676;"Vilniaus Pranciškaus Skorinos gimnazija";Saulytė;72376520386;Taip;12;8;1;21
21677;"Vilniaus Pranciškaus Skorinos gimnazija";Saulytė;6268191102;Ne;4;8;0;12
21678;"Vilniaus Pranciškaus Skorinos gimnazija";Saulytė;9902282505;Taip;5;8;0;13
21679;"Vilniaus Pranciškaus Skorinos gimnazija";Saulytė;3374669528;Taip;5;8;0;13
21680;"Vilniaus Pranciškaus Skorinos gimnazija";Saulytė;2214122633;Taip;2;8;0;10
21681;"Vilniaus Pranciškaus Skorinos gimnazija";Saulytė;48454225305;Taip;2;8;0;10
21682;"Vilniaus Pranciškaus Skorinos gimnazija";Saulytė;77518622497;Taip;4;11;0;15
21683;"Vilniaus Pranciškaus Skorinos gimnazija";Saulytė;69884900143;Taip;3;8;4;15
21684;"Vilniaus Pranciškaus Skorinos gimnazija";Saulytė;10188975432;Taip;7;11;0;18
21685;"Vilniaus Pranciškaus Skorinos gimnazija";Saulytė;1326855282;Taip;7;8;3;18
21686;"Vilniaus Pranciškaus Skorinos gimnazija";Saulytė;8996622650;Ne;0;13;0;13
21687;"Vilniaus Pranciškaus Skorinos gimnazija";Saulytė;1332354208;Taip;2;8;0;10
21688;"Vilniaus Pranciškaus Skorinos gimnazija";Saulytė;78048289126;Taip;2;8;0;10
21689;"Vilniaus Pranciškaus Skorinos gimnazija";Saulytė;2135571148;Ne;2;9;0;11
21690;"Vilniaus Pranciškaus Skorinos gimnazija";Saulytė;1098174103;Taip;0;15;0;15
21691;"Vilniaus Pranciškaus Skorinos gimnazija";Saulytė;3697024369;Taip;3;8;2;13
21692;"Vilniaus Pranciškaus Skorinos gimnazija";Saulytė;2034261990;Taip;14;8;0;22
21693;"Vilniaus Pranciškaus Skorinos gimnazija";Saulytė;91720422401;Taip;9;8;0;17
21694;"Vilniaus Pranciškaus Skorinos gimnazija";Saulytė;1590889839;Taip;10;10;0;20
21695;"Vilniaus Pranciškaus Skorinos gimnazija";Saulytė;8198614500;Taip;4;13;0;17
21696;"Vilniaus Pranciškaus Skorinos gimnazija";Saulytė;8585340012;Ne;2;8;2;12
21697;"Vilniaus Simono Konarskio vidurinės mokykla";"1 gr.";4600958567;Taip;7;4;0;11
21698;"Vilniaus Simono Konarskio vidurinės mokykla";"1 gr.";5738026683;Taip;0;4;0;4
21699;"Vilniaus Simono Konarskio vidurinės mokykla";"1 gr.";24072345175;Taip;0;4;0;4
21700;"Vilniaus Simono Konarskio vidurinės mokykla";"1 gr.";2749669816;Taip;0;4;0;4
21701;"Vilniaus Simono Konarskio vidurinės mokykla";"1 gr.";51558463647;Taip;11;4;0;15
21702;"Vilniaus Simono Konarskio vidurinės mokykla";"1 gr.";49643543408;Taip;0;4;0;4
21703;"Vilniaus Simono Konarskio vidurinės mokykla";"1 gr.";93797285418;Ne;0;4;0;4
21704;"Vilniaus Simono Konarskio vidurinės mokykla";"1 gr.";30126718224;Taip;0;4;0;4
21705;"Vilniaus Simono Konarskio vidurinės mokykla";"1 gr.";47729405181;Taip;0;4;0;4
21706;"Vilniaus Simono Konarskio vidurinės mokykla";"1 gr.";88609559814;Taip;2;4;0;6
21707;"Vilniaus Simono Konarskio vidurinės mokykla";"1 gr.";41776089342;Taip;9;4;0;13
21708;"Vilniaus Simono Konarskio vidurinės mokykla";"1 gr.";69882566734;Taip;0;4;0;4
21709;"Vilniaus Simono Konarskio vidurinės mokykla";"1 gr.";7559190407;Taip;7;4;0;11
21710;"Vilniaus Simono Konarskio vidurinės mokykla";"1 gr.";28845494407;Taip;0;4;0;4
21711;"Vilniaus Simono Konarskio vidurinės mokykla";"1 gr.";9585599736;Taip;0;4;0;4
21712;"Vilniaus Simono Konarskio vidurinės mokykla";"1 gr.";2125176999;Ne;3;4;0;7
21713;"Vilniaus Simono Konarskio vidurinės mokykla";"1 gr.";7591001646;Ne;0;4;0;4
21714;"Vilniaus Trakų Vokės gimnazija";Priešmokyklinė;84749146259;Taip;0;6;0;6
21715;"Vilniaus Trakų Vokės gimnazija";Priešmokyklinė;37080835526;Taip;6;2;0;8
21716;"Vilniaus Trakų Vokės gimnazija";Priešmokyklinė;92262591306;Taip;0;4;0;4
21717;"Vilniaus Trakų Vokės gimnazija";Priešmokyklinė;49616069190;Taip;15;2;0;17
21718;"Vilniaus Trakų Vokės gimnazija";Priešmokyklinė;76399539244;Taip;0;6;4;10
21719;"Vilniaus Trakų Vokės gimnazija";Priešmokyklinė;96632696431;Taip;7;6;0;13
21720;"Vilniaus Trakų Vokės gimnazija";Priešmokyklinė;9642375918;Taip;5;6;0;11
21721;"Vilniaus Trakų Vokės gimnazija";Priešmokyklinė;1809637955;Taip;4;7;0;11
21722;"Vilniaus Trakų Vokės gimnazija";Priešmokyklinė;43780546254;Taip;0;10;0;10
21723;"Vilniaus Trakų Vokės gimnazija";Priešmokyklinė;1858168427;Ne;9;2;0;11
21724;"Vilniaus Trakų Vokės gimnazija";Priešmokyklinė;39658854196;Taip;4;6;2;12
21725;"Vilniaus Trakų Vokės gimnazija";Priešmokyklinė;32336388708;Taip;0;5;0;5
21726;"Vilniaus Trakų Vokės gimnazija";Priešmokyklinė;1994808263;Taip;0;6;1;7
21727;"Vilniaus Trakų Vokės gimnazija";Priešmokyklinė;1805549433;Taip;0;6;0;6
21728;"Vilniaus Trakų Vokės gimnazija";Priešmokyklinė;68968521202;Taip;0;8;4;12
21729;"Vilniaus Trakų Vokės gimnazija";Priešmokyklinė;1837766168;Taip;0;11;0;11
21730;"Vilniaus Trakų Vokės gimnazija";Priešmokyklinė;38738283929;Ne;0;3;0;3
21731;"Vilniaus Trakų Vokės gimnazija";Priešmokyklinė;71993634591;Taip;0;5;4;9
21732;"Vilniaus Trakų Vokės gimnazija";Priešmokyklinė;66607811394;Taip;4;6;0;10
21733;"Vilniaus Trakų Vokės gimnazija";Priešmokyklinė;2052523633;Taip;0;4;2;6
21734;"Vilniaus Trakų Vokės gimnazija";Priešmokyklinė;95403241312;Taip;0;4;0;4
21735;"Vilniaus Trakų Vokės gimnazija";"Priešmokyklinė 2";28609993291;Taip;0;6;0;6
21736;"Vilniaus Trakų Vokės gimnazija";"Priešmokyklinė 2";2742109510;Taip;0;8;0;8
21737;"Vilniaus Trakų Vokės gimnazija";"Priešmokyklinė 2";4137954109;Taip;0;4;5;9
21738;"Vilniaus Trakų Vokės gimnazija";"Priešmokyklinė 2";41050699676;Taip;0;4;1;5
21739;"Vilniaus Trakų Vokės gimnazija";"Priešmokyklinė 2";76000339425;Ne;0;4;6;10
21740;"Vilniaus Trakų Vokės gimnazija";"Priešmokyklinė 2";4025564140;Ne;0;4;2;6
21741;"Vilniaus Trakų Vokės gimnazija";"Priešmokyklinė 2";42898142937;Ne;0;6;0;6
21742;"Vilniaus Trakų Vokės gimnazija";"Priešmokyklinė 2";7405750799;Ne;0;21;0;21
21743;"Vilniaus Trakų Vokės gimnazija";"Priešmokyklinė 2";9212173480;Taip;4;4;0;8
21744;"Vilniaus Trakų Vokės gimnazija";"Priešmokyklinė 2";29983824202;Taip;0;4;0;4
21745;"Vilniaus Trakų Vokės gimnazija";"Priešmokyklinė 2";39185053006;Taip;0;9;0;9
21746;"Vilniaus Trakų Vokės gimnazija";"Priešmokyklinė 2";6075862061;Taip;0;9;0;9
21747;"Vilniaus Trakų Vokės gimnazija";"Priešmokyklinė 2";1100961040;Taip;0;4;1;5
21748;"Vilniaus Trakų Vokės gimnazija";"Priešmokyklinė 2";1246702054;Taip;0;4;0;4
21749;"Vilniaus Trakų Vokės gimnazija";"Priešmokyklinė 2";1604147234;Taip;0;4;11;15
21750;"Vilniaus Trakų Vokės gimnazija";"Priešmokyklinė 2";2671842885;Taip;0;4;0;4
21751;"Vilniaus Ryto progimnazija";Pelėdžiukai;8927710614;Taip;2;5;0;7
21752;"Vilniaus Ryto progimnazija";Pelėdžiukai;83599369692;Taip;0;9;0;9
21753;"Vilniaus Ryto progimnazija";Pelėdžiukai;1498045991;Taip;0;4;0;4
21754;"Vilniaus Ryto progimnazija";Pelėdžiukai;5003717844;Taip;4;4;1;9
21755;"Vilniaus Ryto progimnazija";Pelėdžiukai;2033804954;Taip;0;7;0;7
21756;"Vilniaus Ryto progimnazija";Pelėdžiukai;88370692635;Taip;0;4;0;4
21757;"Vilniaus Ryto progimnazija";Pelėdžiukai;4459592042;Taip;7;4;0;11
21758;"Vilniaus Ryto progimnazija";Pelėdžiukai;53152433196;Taip;0;4;0;4
21759;"Vilniaus Ryto progimnazija";Pelėdžiukai;4334517915;Taip;0;3;0;3
21760;"Vilniaus Ryto progimnazija";Vyturiukai;70950123240;Taip;0;2;0;2
21761;"Vilniaus Ryto progimnazija";Vyturiukai;79094523868;Taip;10;4;0;14
21762;"Vilniaus Ryto progimnazija";Vyturiukai;98670272543;Taip;0;8;0;8
21763;"Vilniaus Ryto progimnazija";Vyturiukai;58253869146;Taip;0;8;0;8
21764;"Vilniaus Ryto progimnazija";Vyturiukai;5202479867;Taip;4;0;3;7
21765;"Vilniaus Ryto progimnazija";Vyturiukai;1480772531;Taip;3;5;0;8
21766;"Vilniaus Ryto progimnazija";Vyturiukai;35463696785;Taip;0;4;0;4
21767;"Vilniaus Ryto progimnazija";Vyturiukai;9651077239;Taip;0;4;0;4
21768;"Vilniaus Ryto progimnazija";Vyturiukai;11940207202;Taip;5;6;0;11
21769;"Vilniaus Ryto progimnazija";Vyturiukai;22316575729;Taip;0;4;0;4
21770;"Vilniaus Ryto progimnazija";Vyturiukai;8782782031;Taip;0;3;0;3
21771;"Vilniaus Ryto progimnazija";Vyturiukai;5157022077;Taip;0;3;0;3
21772;"Vilniaus Ryto progimnazija";Vyturiukai;1037795359;Taip;0;5;0;5
21773;"Vilniaus Ryto progimnazija";Vyturiukai;24547508796;Ne;6;4;0;10
21774;"Vilniaus Ryto progimnazija";Vyturiukai;2877310618;Taip;2;4;0;6
21775;"Vilniaus Ryto progimnazija";Vyturiukai;24021665703;Taip;10;4;0;14
21776;"Vilniaus Ryto progimnazija";Vyturiukai;7602825079;Taip;10;4;0;14
21777;"Vilniaus Salininkų gimnazija";"Priešmokyklinė A";8897523583;Taip;0;12;0;12
21778;"Vilniaus Salininkų gimnazija";"Priešmokyklinė A";1507178637;Taip;0;12;0;12
21779;"Vilniaus Salininkų gimnazija";"Priešmokyklinė A";7015482971;Taip;0;6;0;6
21780;"Vilniaus Salininkų gimnazija";"Priešmokyklinė A";81713688097;Taip;4;6;0;10
21781;"Vilniaus Salininkų gimnazija";"Priešmokyklinė A";77477857775;Taip;10;4;0;14
21782;"Vilniaus Salininkų gimnazija";"Priešmokyklinė A";93466518815;Taip;6;7;0;13
21783;"Vilniaus Salininkų gimnazija";"Priešmokyklinė A";86262807558;Taip;1;4;2;7
21784;"Vilniaus Salininkų gimnazija";"Priešmokyklinė A";8726140660;Ne;4;4;0;8
21785;"Vilniaus Salininkų gimnazija";"Priešmokyklinė A";1614501473;Taip;5;7;0;12
21786;"Vilniaus Salininkų gimnazija";"Priešmokyklinė A";1489067126;Taip;7;5;0;12
21787;"Vilniaus Salininkų gimnazija";"Priešmokyklinė A";32201000670;Taip;0;7;0;7
21788;"Vilniaus Salininkų gimnazija";"Priešmokyklinė A";75056599725;Taip;10;11;0;21
21789;"Vilniaus Salininkų gimnazija";"Priešmokyklinė A";3263103387;Ne;11;4;0;15
21790;"Vilniaus Salininkų gimnazija";"Priešmokyklinė A";72090235276;Taip;5;4;1;10
21791;"Vilniaus Salininkų gimnazija";"PRIEŠMOKYKLINĖ B";54352547774;Taip;4;4;0;8
21792;"Vilniaus Salininkų gimnazija";"PRIEŠMOKYKLINĖ B";87653480003;Taip;4;4;0;8
21793;"Vilniaus Salininkų gimnazija";"PRIEŠMOKYKLINĖ B";2035304515;Ne;0;21;0;21
21794;"Vilniaus Salininkų gimnazija";"PRIEŠMOKYKLINĖ B";1632485114;Taip;0;21;0;21
21795;"Vilniaus Salininkų gimnazija";"PRIEŠMOKYKLINĖ B";1619190849;Taip;9;4;0;13
21796;"Vilniaus Salininkų gimnazija";"PRIEŠMOKYKLINĖ B";5483806059;Taip;0;21;0;21
21797;"Vilniaus Salininkų gimnazija";"PRIEŠMOKYKLINĖ B";74503311061;Taip;1;4;0;5
21798;"Vilniaus Salininkų gimnazija";"PRIEŠMOKYKLINĖ B";6978618796;Taip;13;4;0;17
21799;"Vilniaus Salininkų gimnazija";"PRIEŠMOKYKLINĖ B";61252066272;Ne;0;21;0;21
21800;"Vilniaus Salininkų gimnazija";"PRIEŠMOKYKLINĖ B";9441176013;Taip;0;21;0;21
21801;"Vilniaus Salininkų gimnazija";"PRIEŠMOKYKLINĖ B";16879258172;Taip;0;21;0;21
21802;"Vilniaus Salininkų gimnazija";"PRIEŠMOKYKLINĖ B";88149790626;Taip;1;4;0;5
21803;"Vilniaus Salininkų gimnazija";"PRIEŠMOKYKLINĖ B";2081621978;Taip;0;21;0;21
21804;"Vilniaus Salininkų gimnazija";"PRIEŠMOKYKLINĖ B";2097313917;Taip;10;4;0;14
21805;"Vilniaus Salininkų gimnazija";"PRIEŠMOKYKLINĖ B";56301286871;Taip;0;21;0;21
21806;"Vilniaus Salininkų gimnazija";"PRIEŠMOKYKLINĖ B";69329549093;Taip;0;4;0;4
21807;"Vilniaus Salininkų gimnazija";"PRIEŠMOKYKLINĖ B";8258045565;Taip;5;4;0;9
21808;"Vilniaus Salininkų gimnazija";"PRIEŠMOKYKLINĖ B";10179604964;Taip;2;4;0;6
21809;"Vilniaus Salininkų gimnazija";"PRIEŠMOKYKLINĖ B";1364275404;Taip;4;4;0;8
21810;"Vilniaus Spindulio pagrindinė mokykla";PM3;22293456491;Taip;0;21;0;21
21811;"Vilniaus Spindulio pagrindinė mokykla";PM3;90681333497;Taip;5;4;5;14
21812;"Vilniaus Spindulio pagrindinė mokykla";PM3;77980907763;Taip;0;4;0;4
21813;"Vilniaus Spindulio pagrindinė mokykla";PM3;43582907178;Taip;0;4;0;4
21814;"Vilniaus Spindulio pagrindinė mokykla";PM3;3310208029;Taip;0;7;0;7
21815;"Vilniaus Spindulio pagrindinė mokykla";PM3;88850421821;Taip;0;4;0;4
21816;"Vilniaus Spindulio pagrindinė mokykla";PM3;83704349624;Ne;0;5;0;5
21817;"Vilniaus Spindulio pagrindinė mokykla";PM3;51686992586;Taip;17;4;0;21
21818;"Vilniaus Spindulio pagrindinė mokykla";PM3;4549364929;Taip;0;4;0;4
21819;"Vilniaus Spindulio pagrindinė mokykla";PM3;4497323553;Taip;0;4;0;4
21820;"Vilniaus Spindulio pagrindinė mokykla";PM3;96655135353;Taip;0;4;0;4
21821;"Vilniaus Spindulio pagrindinė mokykla";PM3;1452723869;Ne;0;21;0;21
21822;"Vilniaus Spindulio pagrindinė mokykla";PM3;1535907893;Ne;0;5;0;5
21823;"Vilniaus Spindulio pagrindinė mokykla";PM3;1238188049;Ne;0;4;2;6
21824;"Vilniaus Spindulio pagrindinė mokykla";PM3;1876110301;Taip;0;4;4;8
21825;"Vilniaus Spindulio pagrindinė mokykla";PM3;1201971467;Taip;0;21;0;21
21826;"Vilniaus Spindulio pagrindinė mokykla";PM3;2141617594;Taip;0;4;1;5
21827;"Vilniaus Spindulio pagrindinė mokykla";PM3;9330213866;Taip;0;4;1;5
21828;"Vilniaus Spindulio pagrindinė mokykla";PM3;30104416225;Taip;0;4;0;4
21829;"Vilniaus Spindulio pagrindinė mokykla";PM3;11528618044;Taip;0;11;0;11
21830;"Vilniaus Spindulio pagrindinė mokykla";PM3;65948673886;Taip;2;6;0;8
21831;"Vilniaus Spindulio pagrindinė mokykla";PM3;33466088300;Taip;0;7;0;7
21832;"Vilniaus Spindulio pagrindinė mokykla";PM3;8838175732;Taip;0;21;0;21
21833;"Vilniaus Spindulio pagrindinė mokykla";PM2;24363585231;Taip;0;4;0;4
21834;"Vilniaus Spindulio pagrindinė mokykla";PM2;46792667256;Taip;0;4;0;4
21835;"Vilniaus Spindulio pagrindinė mokykla";PM2;1882976317;Taip;5;4;1;10
21836;"Vilniaus Spindulio pagrindinė mokykla";PM2;30064453011;Ne;0;4;3;7
21837;"Vilniaus Spindulio pagrindinė mokykla";PM2;37530814188;Taip;4;5;0;9
21838;"Vilniaus Spindulio pagrindinė mokykla";PM2;94392092103;Ne;0;4;0;4
21839;"Vilniaus Spindulio pagrindinė mokykla";PM2;8335398345;Taip;3;4;0;7
21840;"Vilniaus Spindulio pagrindinė mokykla";PM2;1119763619;Taip;0;4;2;6
21841;"Vilniaus Spindulio pagrindinė mokykla";PM2;1275460051;Taip;10;4;0;14
21842;"Vilniaus Spindulio pagrindinė mokykla";PM2;51442842468;Taip;0;5;0;5
21843;"Vilniaus Spindulio pagrindinė mokykla";PM2;70985723823;Ne;0;4;1;5
21844;"Vilniaus Spindulio pagrindinė mokykla";PM2;2308733347;Taip;5;6;1;12
21845;"Vilniaus Spindulio pagrindinė mokykla";PM2;89455376961;Taip;0;4;0;4
21846;"Vilniaus Spindulio pagrindinė mokykla";PM2;8096536272;Ne;5;4;0;9
21847;"Vilniaus Spindulio pagrindinė mokykla";PM2;8367775964;Taip;0;4;0;4
21848;"Vilniaus Spindulio pagrindinė mokykla";PM2;1382754985;Taip;0;4;0;4
21849;"Vilniaus Spindulio pagrindinė mokykla";PM2;82176273307;Taip;0;4;1;5
21850;"Vilniaus Spindulio pagrindinė mokykla";PM2;38262299304;Taip;0;4;3;7
21851;"Vilniaus Spindulio pagrindinė mokykla";PM2;4402050671;Taip;0;4;0;4
21852;"Vilniaus Spindulio pagrindinė mokykla";PM2;98839852579;Taip;0;6;1;7
21853;"Vilniaus Spindulio pagrindinė mokykla";PM2;96133788423;Taip;3;4;0;7
21854;"Vilniaus Spindulio pagrindinė mokykla";PM1;84024727184;Taip;0;4;0;4
21855;"Vilniaus Spindulio pagrindinė mokykla";PM1;71828460624;Taip;0;4;2;6
21856;"Vilniaus Spindulio pagrindinė mokykla";PM1;40665480700;Taip;0;4;1;5
21857;"Vilniaus Spindulio pagrindinė mokykla";PM1;13655605764;Taip;0;4;0;4
21858;"Vilniaus Spindulio pagrindinė mokykla";PM1;47625081475;Taip;0;4;1;5
21859;"Vilniaus Spindulio pagrindinė mokykla";PM1;31006890017;Taip;0;4;0;4
21860;"Vilniaus Spindulio pagrindinė mokykla";PM1;1435104895;Taip;12;4;0;16
21861;"Vilniaus Spindulio pagrindinė mokykla";PM1;29649846186;Taip;0;4;0;4
21862;"Vilniaus Spindulio pagrindinė mokykla";PM1;1963422247;Taip;0;4;0;4
21863;"Vilniaus Spindulio pagrindinė mokykla";PM1;1641742927;Ne;2;4;0;6
21864;"Vilniaus Spindulio pagrindinė mokykla";PM1;26554152266;Taip;10;4;0;14
21865;"Vilniaus Spindulio pagrindinė mokykla";PM1;1101237825;Taip;0;4;6;10
21866;"Vilniaus Spindulio pagrindinė mokykla";PM1;31776667512;Taip;0;4;0;4
21867;"Vilniaus Spindulio pagrindinė mokykla";PM1;2960662435;Taip;2;4;4;10
21868;"Vilniaus Spindulio pagrindinė mokykla";PM1;8461648619;Taip;0;21;0;21
21869;"Vilniaus Spindulio pagrindinė mokykla";PM1;29959372638;Taip;0;4;1;5
21870;"Vilniaus Spindulio pagrindinė mokykla";PM1;82936702613;Taip;0;4;0;4
21871;"Vilniaus Spindulio pagrindinė mokykla";PM1;1515422367;Taip;0;11;0;11
21872;"Vilniaus Spindulio pagrindinė mokykla";PM1;42543506690;Ne;4;7;0;11
21873;"Vilniaus Spindulio pagrindinė mokykla";PM1;47377556072;Taip;0;4;0;4
21874;"Vilniaus Spindulio pagrindinė mokykla";PM1;6460911796;Taip;9;4;0;13
21875;"Vilniaus Spindulio pagrindinė mokykla";PM1;54282609151;Taip;5;4;0;9
21876;"Vilniaus Vladislavo Sirokomlės vidurinė mokykla";Nykštukai;3757723755;Taip;0;26;0;26
21877;"Vilniaus Vladislavo Sirokomlės vidurinė mokykla";Nykštukai;6973757062;Taip;5;11;0;16
21878;"Vilniaus Vladislavo Sirokomlės vidurinė mokykla";Nykštukai;67365224459;Taip;11;10;1;22
21879;"Vilniaus Vladislavo Sirokomlės vidurinė mokykla";Nykštukai;1182643102;Taip;5;10;4;19
21880;"Vilniaus Vladislavo Sirokomlės vidurinė mokykla";Nykštukai;6027613840;Taip;0;10;0;10
21881;"Vilniaus Vladislavo Sirokomlės vidurinė mokykla";Nykštukai;7921336790;Taip;0;10;1;11
21882;"Vilniaus Vladislavo Sirokomlės vidurinė mokykla";Nykštukai;93097026538;Taip;0;10;0;10
21883;"Vilniaus Vladislavo Sirokomlės vidurinė mokykla";Nykštukai;87849011303;Taip;3;10;1;14
21884;"Vilniaus Vladislavo Sirokomlės vidurinė mokykla";Nykštukai;80664259551;Taip;5;10;2;17
21885;"Vilniaus Vladislavo Sirokomlės vidurinė mokykla";Nykštukai;19918665437;Taip;3;10;0;13
21886;"Vilniaus Vladislavo Sirokomlės vidurinė mokykla";Nykštukai;1755934341;Taip;0;26;0;26
21887;"Vilniaus Vladislavo Sirokomlės vidurinė mokykla";Nykštukai;8471020975;Taip;7;10;2;19
21888;"Vilniaus Vladislavo Sirokomlės vidurinė mokykla";Nykštukai;9715654332;Taip;0;10;0;10
21889;"Vilniaus Vladislavo Sirokomlės vidurinė mokykla";Nykštukai;67716590566;Taip;5;10;0;15
21890;"Vilniaus Vladislavo Sirokomlės vidurinė mokykla";Nykštukai;68958022216;Ne;4;10;0;14
21891;"Vilniaus Vladislavo Sirokomlės vidurinė mokykla";Smurfai;91568484446;Taip;0;10;0;10
21892;"Vilniaus Vladislavo Sirokomlės vidurinė mokykla";Smurfai;1277422207;Taip;2;14;0;16
21893;"Vilniaus Vladislavo Sirokomlės vidurinė mokykla";Smurfai;18847368957;Taip;10;10;0;20
21894;"Vilniaus Vladislavo Sirokomlės vidurinė mokykla";Smurfai;1824370122;Taip;0;12;0;12
21895;"Vilniaus Vladislavo Sirokomlės vidurinė mokykla";Smurfai;8377601628;Ne;0;13;0;13
21896;"Vilniaus Vladislavo Sirokomlės vidurinė mokykla";Smurfai;1292350264;Taip;5;11;0;16
21897;"Vilniaus Vladislavo Sirokomlės vidurinė mokykla";Smurfai;4727762605;Taip;0;16;0;16
21898;"Vilniaus Vladislavo Sirokomlės vidurinė mokykla";Smurfai;93964052608;Taip;0;10;0;10
21899;"Vilniaus Vladislavo Sirokomlės vidurinė mokykla";Smurfai;1775227032;Taip;4;9;0;13
21900;"Vilniaus Vladislavo Sirokomlės vidurinė mokykla";Smurfai;18652266729;Ne;0;9;0;9
21901;"Vilniaus Vladislavo Sirokomlės vidurinė mokykla";Smurfai;1380861719;Taip;0;9;0;9
21902;"Vilniaus „Pelėdos” pradinė mokykla";Bitutės;72626222053;Taip;0;4;1;5
21903;"Vilniaus „Pelėdos” pradinė mokykla";Bitutės;1962802968;Taip;0;4;2;6
21904;"Vilniaus „Pelėdos” pradinė mokykla";Bitutės;70334519732;Taip;2;4;2;8
21905;"Vilniaus „Pelėdos” pradinė mokykla";Bitutės;31817312555;Taip;0;4;2;6
21906;"Vilniaus „Pelėdos” pradinė mokykla";Bitutės;16910061636;Taip;5;1;1;7
21907;"Vilniaus „Pelėdos” pradinė mokykla";Bitutės;62276887757;Taip;0;4;0;4
21908;"Vilniaus „Pelėdos” pradinė mokykla";Bitutės;37019368317;Ne;0;4;5;9
21909;"Vilniaus „Pelėdos” pradinė mokykla";Bitutės;55808304356;Taip;5;4;0;9
21910;"Vilniaus „Pelėdos” pradinė mokykla";Bitutės;90159009940;Taip;0;4;1;5
21911;"Vilniaus „Pelėdos” pradinė mokykla";Bitutės;42486181827;Taip;0;4;2;6
21912;"Vilniaus „Pelėdos” pradinė mokykla";Bitutės;86774266699;Taip;0;4;0;4
21913;"Vilniaus „Pelėdos” pradinė mokykla";Bitutės;1846303993;Taip;4;4;0;8
21914;"Vilniaus „Pelėdos” pradinė mokykla";Bitutės;46373287636;Taip;2;4;0;6
21915;"Vilniaus „Pelėdos” pradinė mokykla";Bitutės;23762150256;Taip;0;4;0;4
21916;"Vilniaus „Pelėdos” pradinė mokykla";Bitutės;72517122863;Taip;7;4;1;12
21917;"Vilniaus „Pelėdos” pradinė mokykla";Bitutės;53571863888;Taip;0;4;0;4
21918;"Vilniaus „Pelėdos” pradinė mokykla";Bitutės;45490599266;Taip;0;4;1;5
21919;"Vilniaus „Pelėdos” pradinė mokykla";Bitutės;42959183109;Taip;0;4;5;9
21920;"Vilniaus „Pelėdos” pradinė mokykla";Bitutės;21904117684;Taip;0;4;1;5
21921;"Vilniaus „Pelėdos” pradinė mokykla";Bitutės;94562009887;Taip;0;4;3;7
21922;"Vilniaus „Pelėdos” pradinė mokykla";Bitutės;76659578448;Taip;0;4;2;6
21923;"Vilniaus „Pelėdos” pradinė mokykla";Bitutės;1206482166;Taip;2;4;8;14
21924;"Vilniaus „Pelėdos” pradinė mokykla";Bitutės;1996480143;Taip;0;4;0;4
21925;"Vilniaus „Pelėdos” pradinė mokykla";Bitutės;1655237708;Taip;0;4;2;6
21926;"Vilniaus „Pelėdos” pradinė mokykla";Boružėlės;60187200;Taip;0;4;0;4
21927;"Vilniaus „Pelėdos” pradinė mokykla";Boružėlės;1022310072;Taip;0;4;0;4
21928;"Vilniaus „Pelėdos” pradinė mokykla";Boružėlės;42308434800;Taip;6;0;0;6
21929;"Vilniaus „Pelėdos” pradinė mokykla";Boružėlės;1557388485;Taip;2;4;0;6
21930;"Vilniaus „Pelėdos” pradinė mokykla";Boružėlės;10573989701;Taip;0;4;0;4
21931;"Vilniaus „Pelėdos” pradinė mokykla";Boružėlės;4946448574;Taip;0;3;3;6
21932;"Vilniaus „Pelėdos” pradinė mokykla";Boružėlės;11824002845;Ne;0;4;2;6
21933;"Vilniaus „Pelėdos” pradinė mokykla";Boružėlės;1266695122;Ne;0;4;3;7
21934;"Vilniaus „Pelėdos” pradinė mokykla";Boružėlės;33481357566;Taip;0;4;4;8
21935;"Vilniaus „Pelėdos” pradinė mokykla";Boružėlės;51111749099;Taip;4;4;0;8
21936;"Vilniaus „Pelėdos” pradinė mokykla";Boružėlės;74887990218;Taip;0;4;1;5
21937;"Vilniaus „Pelėdos” pradinė mokykla";Boružėlės;67436657541;Taip;0;4;0;4
21938;"Vilniaus „Pelėdos” pradinė mokykla";Boružėlės;50050288702;Taip;0;3;0;3
21939;"Vilniaus „Pelėdos” pradinė mokykla";Boružėlės;89566764594;Taip;0;2;0;2
21940;"Vilniaus „Pelėdos” pradinė mokykla";Boružėlės;70144957042;Taip;0;4;0;4
21941;"Vilniaus „Pelėdos” pradinė mokykla";Boružėlės;29009575642;Taip;0;4;2;6
21942;"Vilniaus „Pelėdos” pradinė mokykla";Boružėlės;29696816177;Taip;5;4;1;10
21943;"Vilniaus „Pelėdos” pradinė mokykla";Boružėlės;38087400506;Taip;2;3;0;5
21944;"Vilniaus „Pelėdos” pradinė mokykla";Boružėlės;41914970891;Taip;6;4;0;10
21945;"Vilniaus „Pelėdos” pradinė mokykla";Boružėlės;20865224818;Ne;0;4;0;4
21946;"Vilniaus „Pelėdos” pradinė mokykla";Boružėlės;91433727359;Taip;4;4;0;8
21947;"Vilniaus „Pelėdos” pradinė mokykla";Boružėlės;1378219785;Taip;0;4;0;4
21948;"Vilniaus „Pelėdos” pradinė mokykla";Boružėlės;6961211392;Taip;6;0;0;6
21949;"Vilniaus Joachimo Lelevelio inžinerijos mokykla";0A;2854451964;Taip;2;7;0;9
21950;"Vilniaus Joachimo Lelevelio inžinerijos mokykla";0A;6406533101;Taip;0;6;0;6
21951;"Vilniaus Joachimo Lelevelio inžinerijos mokykla";0A;3842907348;Taip;0;7;0;7
21952;"Vilniaus Joachimo Lelevelio inžinerijos mokykla";0A;28504617099;Taip;0;21;0;21
21953;"Vilniaus Joachimo Lelevelio inžinerijos mokykla";0A;4513335615;Taip;0;4;0;4
21954;"Vilniaus Joachimo Lelevelio inžinerijos mokykla";0A;4250816034;Taip;4;8;0;12
21955;"Vilniaus Joachimo Lelevelio inžinerijos mokykla";0A;1771141306;Taip;0;11;0;11
21956;"Vilniaus Joachimo Lelevelio inžinerijos mokykla";0A;7557437205;Taip;0;4;3;7
21957;"Vilniaus Joachimo Lelevelio inžinerijos mokykla";0A;1615068173;Taip;0;4;0;4
21958;"Vilniaus Joachimo Lelevelio inžinerijos mokykla";0A;2062489205;Taip;1;9;0;10
21959;"Vilniaus Joachimo Lelevelio inžinerijos mokykla";0A;52212151760;Taip;0;4;2;6
21960;"Vilniaus Joachimo Lelevelio inžinerijos mokykla";0A;98526928421;Taip;0;4;3;7
21961;"Vilniaus Joachimo Lelevelio inžinerijos mokykla";0A;18542160352;Taip;0;7;0;7
21962;"Vilniaus Joachimo Lelevelio inžinerijos mokykla";0A;1701035826;Ne;3;4;1;8
21963;"Vilniaus Joachimo Lelevelio inžinerijos mokykla";0A;2059267616;Taip;0;4;0;4
21964;"Vilniaus Joachimo Lelevelio inžinerijos mokykla";0A;87500842251;Taip;0;4;0;4
21965;"Vilniaus Joachimo Lelevelio inžinerijos mokykla";0B;1398713963;Taip;0;4;1;5
21966;"Vilniaus Joachimo Lelevelio inžinerijos mokykla";0B;7498447014;Ne;0;21;0;21
21967;"Vilniaus Joachimo Lelevelio inžinerijos mokykla";0B;12358360731;Taip;3;4;1;8
21968;"Vilniaus Joachimo Lelevelio inžinerijos mokykla";0B;1294879767;Taip;0;10;0;10
21969;"Vilniaus Joachimo Lelevelio inžinerijos mokykla";0B;13127077816;Taip;0;21;0;21
21970;"Vilniaus Joachimo Lelevelio inžinerijos mokykla";0B;5734485363;Ne;5;5;0;10
21971;"Vilniaus Joachimo Lelevelio inžinerijos mokykla";0B;97106889191;Taip;0;21;0;21
21972;"Vilniaus Joachimo Lelevelio inžinerijos mokykla";0B;1400614987;Taip;0;7;0;7
21973;"Vilniaus Joachimo Lelevelio inžinerijos mokykla";0B;5826045578;Ne;2;9;0;11
21974;"Vilniaus Joachimo Lelevelio inžinerijos mokykla";0B;94748215851;Taip;10;4;0;14
21975;"Vilniaus Joachimo Lelevelio inžinerijos mokykla";0B;5628943541;Taip;0;5;1;6
21976;"Vilniaus Joachimo Lelevelio inžinerijos mokykla";0B;65825430797;Taip;3;5;0;8
21977;"Vilniaus Joachimo Lelevelio inžinerijos mokykla";0B;4537724747;Ne;0;5;7;12
21978;"Vilniaus Joachimo Lelevelio inžinerijos mokykla";0C;77834846979;Taip;0;24;0;24
21979;"Vilniaus Joachimo Lelevelio inžinerijos mokykla";0C;7474239709;Taip;0;24;0;24
21980;"Vilniaus Joachimo Lelevelio inžinerijos mokykla";0C;4298878720;Ne;0;24;0;24
21981;"Vilniaus Joachimo Lelevelio inžinerijos mokykla";0C;2066262598;Ne;0;8;0;8
21982;"Vilniaus Joachimo Lelevelio inžinerijos mokykla";0C;6729635545;Taip;5;7;0;12
21983;"Vilniaus Joachimo Lelevelio inžinerijos mokykla";0C;47825918748;Taip;7;7;0;14
21984;"Vilniaus Joachimo Lelevelio inžinerijos mokykla";0C;74314676598;Taip;0;7;0;7
21985;"Vilniaus Joachimo Lelevelio inžinerijos mokykla";0C;1634442815;Taip;0;8;0;8
21986;"Vilniaus Joachimo Lelevelio inžinerijos mokykla";0C;8552721960;Taip;11;7;0;18
21987;"Vilniaus Juzefo Ignacijaus Kraševskio gimnazija";Priešmokyklinė;3992602769;Ne;3;4;2;9
21988;"Vilniaus Juzefo Ignacijaus Kraševskio gimnazija";Priešmokyklinė;96528175390;Ne;7;4;0;11
21989;"Vilniaus Juzefo Ignacijaus Kraševskio gimnazija";Priešmokyklinė;7947779677;Taip;11;4;0;15
21990;"Vilniaus Juzefo Ignacijaus Kraševskio gimnazija";Priešmokyklinė;45246620717;Taip;5;4;0;9
21991;"Vilniaus Juzefo Ignacijaus Kraševskio gimnazija";Priešmokyklinė;9640287886;Ne;14;4;1;19
21992;"Vilniaus Juzefo Ignacijaus Kraševskio gimnazija";Priešmokyklinė;67676283920;Taip;15;4;0;19
21993;"Vilniaus Juzefo Ignacijaus Kraševskio gimnazija";Priešmokyklinė;85741340293;Taip;6;4;0;10
21994;"Vilniaus Juzefo Ignacijaus Kraševskio gimnazija";Priešmokyklinė;3041637447;Taip;8;4;0;12
21995;"Vilniaus Juzefo Ignacijaus Kraševskio gimnazija";Priešmokyklinė;52109524827;Ne;10;4;2;16
21996;"Vilniaus Juzefo Ignacijaus Kraševskio gimnazija";Priešmokyklinė;42562816168;Ne;0;4;0;4
21997;"Vilniaus Juzefo Ignacijaus Kraševskio gimnazija";Priešmokyklinė;4917899323;Taip;0;4;6;10
21998;"Vilniaus Juzefo Ignacijaus Kraševskio gimnazija";Priešmokyklinė;1963122314;Taip;6;4;3;13
21999;"Vilniaus Juzefo Ignacijaus Kraševskio gimnazija";Priešmokyklinė;9167719015;Ne;14;4;0;18
22000;"Vilniaus Juzefo Ignacijaus Kraševskio gimnazija";Priešmokyklinė;6560740320;Taip;0;4;3;7
22001;"Vilniaus Juzefo Ignacijaus Kraševskio gimnazija";Priešmokyklinė;6224053661;Taip;0;4;7;11
22002;"Vilniaus Juzefo Ignacijaus Kraševskio gimnazija";Priešmokyklinė;6879140016;Taip;0;21;0;21
22003;"Vilniaus Juzefo Ignacijaus Kraševskio gimnazija";Priešmokyklinė;3738703854;Taip;4;6;0;10
22004;"Vilniaus Jono Pauliaus II progimnazija";Nykštukai;33235320630;Taip;0;4;2;6
22005;"Vilniaus Jono Pauliaus II progimnazija";Nykštukai;62887824954;Taip;4;4;0;8
22006;"Vilniaus Jono Pauliaus II progimnazija";Nykštukai;33266635443;Taip;0;5;0;5
22007;"Vilniaus Jono Pauliaus II progimnazija";Nykštukai;21391476676;Ne;0;4;0;4
22008;"Vilniaus Jono Pauliaus II progimnazija";Nykštukai;9286664165;Ne;8;4;0;12
22009;"Vilniaus Jono Pauliaus II progimnazija";Nykštukai;2441033469;Ne;12;9;0;21
22010;"Vilniaus Jono Pauliaus II progimnazija";Nykštukai;69740475863;Ne;0;4;1;5
22011;"Vilniaus Jono Pauliaus II progimnazija";Nykštukai;9711206546;Taip;0;5;0;5
22012;"Vilniaus Jono Pauliaus II progimnazija";Nykštukai;63900641942;Taip;0;8;0;8
22013;"Vilniaus Jono Pauliaus II progimnazija";Nykštukai;72881976363;Taip;0;8;0;8
22014;"Vilniaus Jono Pauliaus II progimnazija";Nykštukai;1448250372;Taip;14;4;0;18
22015;"Vilniaus Jono Pauliaus II progimnazija";Nykštukai;1974161463;Taip;0;5;1;6
22016;"Vilniaus Jono Pauliaus II progimnazija";Nykštukai;6069988171;Taip;11;4;0;15
22017;"Vilniaus Jono Pauliaus II progimnazija";Nykštukai;69919525470;Taip;0;21;0;21
22018;"Vilniaus Jono Pauliaus II progimnazija";Nykštukai;12487059850;Taip;0;4;0;4
22019;"Vilniaus Jono Pauliaus II progimnazija";Nykštukai;47716333909;Taip;0;7;0;7
22020;"Vilniaus Jono Pauliaus II progimnazija";Nykštukai;62372417041;Taip;9;4;0;13
22021;"Vilniaus Jono Pauliaus II progimnazija";Nykštukai;43690245314;Taip;0;4;0;4
22022;"Vilniaus Jono Pauliaus II progimnazija";Nykštukai;2030227606;Taip;0;4;2;6
22023;"Vilniaus Jono Pauliaus II progimnazija";Nykštukai;1623576857;Taip;0;4;0;4
22024;"Vilniaus Jono Pauliaus II progimnazija";Nykštukai;29087363179;Taip;9;4;0;13
22025;"Vilniaus Jono Pauliaus II progimnazija";Nykštukai;40427909744;Taip;0;14;0;14
22026;"Vilniaus Jono Pauliaus II progimnazija";Nykštukai;86192743256;Taip;5;7;0;12
22027;"Vilniaus Jono Pauliaus II progimnazija";Žiniukai;1911748280;Taip;2;4;0;6
22028;"Vilniaus Jono Pauliaus II progimnazija";Žiniukai;5306416511;Taip;5;5;0;10
22029;"Vilniaus Jono Pauliaus II progimnazija";Žiniukai;84947394033;Taip;2;4;0;6
22030;"Vilniaus Jono Pauliaus II progimnazija";Žiniukai;1148796296;Taip;0;7;0;7
22031;"Vilniaus Jono Pauliaus II progimnazija";Žiniukai;66327590524;Taip;0;6;0;6
22032;"Vilniaus Jono Pauliaus II progimnazija";Žiniukai;71909273139;Taip;6;4;0;10
22033;"Vilniaus Jono Pauliaus II progimnazija";Žiniukai;9949006053;Taip;11;5;0;16
22034;"Vilniaus Jono Pauliaus II progimnazija";Žiniukai;9000145666;Taip;0;21;0;21
22035;"Vilniaus Jono Pauliaus II progimnazija";Žiniukai;8259564583;Taip;0;6;0;6
22036;"Vilniaus Jono Pauliaus II progimnazija";Žiniukai;5323116194;Taip;0;5;0;5
22037;"Vilniaus Jono Pauliaus II progimnazija";Žiniukai;15597884044;Taip;0;4;0;4
22038;"Vilniaus Jono Pauliaus II progimnazija";Žiniukai;21795184411;Ne;12;5;0;17
22039;"Vilniaus Jono Pauliaus II progimnazija";Žiniukai;90741594830;Ne;5;4;0;9
22040;"Vilniaus Jono Pauliaus II progimnazija";Žiniukai;92871710315;Taip;2;4;0;6
22041;"Vilniaus Jono Pauliaus II progimnazija";Žiniukai;66338689682;Taip;10;4;0;14
22042;"Vilniaus Jono Pauliaus II progimnazija";Žiniukai;40117721972;Taip;6;4;0;10
22043;"Vilniaus Jono Pauliaus II progimnazija";Žiniukai;56656769188;Taip;12;5;0;17
22044;"Vilniaus Jono Pauliaus II progimnazija";Žiniukai;9962282406;Taip;12;4;0;16
22045;"Vilniaus Jono Pauliaus II progimnazija";Žiniukai;1000417905;Taip;4;8;0;12
22046;"Vilniaus Jono Pauliaus II progimnazija";Žiniukai;2132492766;Taip;0;5;0;5
22047;"Vilniaus Jono Pauliaus II progimnazija";Žiniukai;52202199212;Taip;0;5;1;6
22048;"Vilniaus Jono Pauliaus II progimnazija";Žiniukai;64337451741;Ne;0;5;6;11
22049;"Vilniaus Jono Pauliaus II progimnazija";Spindulėlis;6312963672;Taip;0;21;0;21
22050;"Vilniaus Jono Pauliaus II progimnazija";Spindulėlis;73847154996;Taip;0;6;0;6
22051;"Vilniaus Jono Pauliaus II progimnazija";Spindulėlis;38517844902;Taip;3;4;0;7
22052;"Vilniaus Jono Pauliaus II progimnazija";Spindulėlis;14754302946;Ne;0;21;0;21
22053;"Vilniaus Jono Pauliaus II progimnazija";Spindulėlis;1053502203;Ne;0;21;0;21
22054;"Vilniaus Jono Pauliaus II progimnazija";Spindulėlis;53090437775;Taip;11;4;0;15
22055;"Vilniaus Jono Pauliaus II progimnazija";Spindulėlis;82679341920;Taip;6;4;0;10
22056;"Vilniaus Jono Pauliaus II progimnazija";Spindulėlis;99037281876;Taip;0;5;0;5
22057;"Vilniaus Jono Pauliaus II progimnazija";Spindulėlis;78465993753;Ne;15;4;0;19
22058;"Vilniaus Jono Pauliaus II progimnazija";Spindulėlis;92991242443;Taip;3;4;0;7
22059;"Vilniaus Jono Pauliaus II progimnazija";Spindulėlis;85352317063;Taip;0;7;0;7
22060;"Vilniaus Jono Pauliaus II progimnazija";Spindulėlis;7126070419;Ne;8;4;0;12
22061;"Vilniaus Jono Pauliaus II progimnazija";Spindulėlis;1481976292;Taip;0;5;0;5
22062;"Vilniaus Jono Pauliaus II progimnazija";Spindulėlis;68841073274;Taip;7;5;0;12
22063;"Vilniaus Jono Pauliaus II progimnazija";Spindulėlis;9989277772;Taip;5;5;0;10
22064;"Vilniaus Jono Pauliaus II progimnazija";Spindulėlis;9275686861;Ne;10;4;0;14
22065;"Vilniaus Jono Pauliaus II progimnazija";Spindulėlis;17472648959;Taip;6;4;0;10
22066;"Vilniaus Jono Pauliaus II progimnazija";Spindulėlis;2957745091;Taip;8;4;0;12
22067;"Vilniaus Jono Pauliaus II progimnazija";Spindulėlis;4502784565;Ne;7;6;1;14
22068;"Vilniaus Jono Pauliaus II progimnazija";Spindulėlis;4113350416;Taip;12;4;0;16
22069;"Vilniaus Jono Pauliaus II progimnazija";Spindulėlis;2939189437;Ne;0;5;3;8
22070;"Vilniaus Jono Pauliaus II progimnazija";Spindulėlis;1573790467;Taip;7;5;0;12
22071;"Vilniaus Senamiesčio vidurinė mokykla";PG1;2869694644;Taip;0;24;0;24
22072;"Vilniaus Senamiesčio vidurinė mokykla";PG1;3511904436;Taip;0;10;0;10
22073;"Vilniaus Senamiesčio vidurinė mokykla";PG1;87869418489;Taip;7;7;0;14
22074;"Vilniaus Senamiesčio vidurinė mokykla";PG1;1905141424;Taip;0;7;0;7
22075;"Vilniaus Senamiesčio vidurinė mokykla";PG1;9906690140;Ne;0;7;0;7
22076;"Vilniaus Senamiesčio vidurinė mokykla";PG1;1984531468;Taip;0;15;0;15
22077;"Vilniaus Senamiesčio vidurinė mokykla";PG1;78593862724;Taip;0;7;0;7
22078;"Vilniaus Senamiesčio vidurinė mokykla";PG1;91834332717;Taip;0;8;0;8
22079;"Vilniaus Senamiesčio vidurinė mokykla";PG1;1882022060;Ne;3;7;0;10
22080;"Vilniaus Senamiesčio vidurinė mokykla";PG1;47953806522;Taip;0;7;0;7
22081;"Vilniaus Senamiesčio vidurinė mokykla";PG1;5536467023;Ne;0;7;1;8
22082;"Vilniaus Senamiesčio vidurinė mokykla";PG1;5721777059;Ne;0;7;0;7
22083;"Vilniaus Senamiesčio vidurinė mokykla";PG1;2864419137;Taip;0;14;0;14
22084;"Vilniaus Senamiesčio vidurinė mokykla";PG1;2764636358;Taip;0;7;0;7
22085;"Vilniaus Senamiesčio vidurinė mokykla";PG1;1369622524;Taip;0;24;0;24
22086;"Vilniaus Senamiesčio vidurinė mokykla";PG1;8449484660;Taip;0;7;1;8
22087;"Vilniaus Senamiesčio vidurinė mokykla";PG1;2094485999;Taip;0;7;0;7
22088;"Vilniaus Senamiesčio vidurinė mokykla";PG1;1813072867;Taip;0;7;0;7
22089;"Vilniaus Senamiesčio vidurinė mokykla";PG1;7764171885;Taip;9;7;3;19
22090;"Vilniaus Senamiesčio vidurinė mokykla";PG1;7756934694;Taip;0;7;0;7
22091;Gluosnis;KIŠKUČIAI;4591550636;Taip;8;8;0;16
22092;Gluosnis;KIŠKUČIAI;8689557248;Taip;9;0;0;9
22093;Gluosnis;KIŠKUČIAI;2984134115;Taip;0;0;2;2
22094;Gluosnis;KIŠKUČIAI;6955695422;Taip;10;0;1;11
22095;Gluosnis;KIŠKUČIAI;6140294839;Taip;18;0;0;18
22096;Gluosnis;KIŠKUČIAI;1305651237;Taip;0;0;2;2
22097;Gluosnis;KIŠKUČIAI;1341265560;Taip;21;0;0;21
22098;Gluosnis;KIŠKUČIAI;4285562600;Taip;5;8;0;13
22099;Gluosnis;KIŠKUČIAI;1773343262;Taip;9;0;0;9
22100;Gluosnis;KIŠKUČIAI;5432102004;Taip;12;0;1;13
22101;Gluosnis;KIŠKUČIAI;8009719622;Taip;8;0;1;9
22102;Gluosnis;KIŠKUČIAI;9833971809;Taip;16;0;0;16
22103;Gluosnis;KIŠKUČIAI;6883663577;Taip;16;0;0;16
22104;Gluosnis;KIŠKUČIAI;1512855055;Taip;1;7;4;12
22105;Gluosnis;KIŠKUČIAI;8383489040;Taip;13;0;0;13
22106;Gluosnis;KIŠKUČIAI;8337313448;Taip;0;3;9;12
22107;Gluosnis;KIŠKUČIAI;4632419177;Taip;0;19;1;20
22108;Gluosnis;EŽIUKAI;6113153127;Taip;15;0;1;16
22109;Gluosnis;EŽIUKAI;4153713911;Taip;2;0;10;12
22110;Gluosnis;EŽIUKAI;7073637619;Taip;5;0;2;7
22111;Gluosnis;EŽIUKAI;4493877427;Taip;16;0;0;16
22112;Gluosnis;EŽIUKAI;6612468095;Taip;18;0;0;18
22113;Gluosnis;EŽIUKAI;3323237449;Taip;9;1;0;10
22114;Gluosnis;EŽIUKAI;7769522093;Taip;16;0;0;16
22115;Gluosnis;EŽIUKAI;8928597187;Taip;0;0;19;19
22116;Gluosnis;EŽIUKAI;9993638596;Taip;16;0;4;20
22117;Gluosnis;EŽIUKAI;4107344313;Taip;9;0;0;9
22118;Gluosnis;EŽIUKAI;1101472999;Taip;0;5;0;5
22119;Gluosnis;EŽIUKAI;9888037899;Taip;8;0;0;8
22120;Gluosnis;EŽIUKAI;1574272380;Taip;7;14;0;21
22121;Gluosnis;EŽIUKAI;3273127718;Taip;20;0;0;20
22122;Gluosnis;EŽIUKAI;6768501780;Taip;21;0;0;21
22123;Gluosnis;EŽIUKAI;1301904113;Taip;6;0;2;8
22124;Gluosnis;EŽIUKAI;6994005000;Taip;0;0;1;1
22125;Gluosnis;MEŠKIUKAI;4022182529;Taip;15;0;6;21
22126;Gluosnis;MEŠKIUKAI;8981904827;Taip;12;0;3;15
22127;Gluosnis;MEŠKIUKAI;8998776286;Taip;9;0;0;9
22128;Gluosnis;MEŠKIUKAI;4506243333;Taip;7;0;0;7
22129;Gluosnis;MEŠKIUKAI;1846499141;Taip;0;0;17;17
22130;Gluosnis;MEŠKIUKAI;7935750427;Taip;9;9;0;18
22131;Gluosnis;MEŠKIUKAI;4905002832;Taip;11;1;0;12
22132;Gluosnis;MEŠKIUKAI;9201769624;Taip;0;0;7;7
22133;Gluosnis;MEŠKIUKAI;9102081648;Taip;7;0;5;12
22134;Gluosnis;MEŠKIUKAI;4498429439;Taip;8;0;0;8
22135;Gluosnis;MEŠKIUKAI;6067801976;Taip;15;0;0;15
22136;Gluosnis;MEŠKIUKAI;8259160584;Taip;6;6;0;12
22137;Gluosnis;MEŠKIUKAI;1235091885;Taip;11;4;0;15
22138;Gluosnis;MEŠKIUKAI;1165636758;Taip;13;0;1;14
22139;Gluosnis;MEŠKIUKAI;8499748544;Taip;5;0;3;8
22140;Gluosnis;MEŠKIUKAI;2867319899;Taip;5;9;0;14
22141;Gluosnis;MEŠKIUKAI;9699577397;Taip;20;0;0;20
22142;Gluosnis;BORUŽĖLĖS;8840658383;Taip;6;10;0;16
22143;Gluosnis;BORUŽĖLĖS;1102935178;Taip;0;0;2;2
22144;Gluosnis;BORUŽĖLĖS;8328948120;Ne;5;0;0;5
22145;Gluosnis;BORUŽĖLĖS;2167312808;Taip;9;0;2;11
22146;Gluosnis;BORUŽĖLĖS;4204797742;Taip;4;7;0;11
22147;Gluosnis;BORUŽĖLĖS;6302765948;Taip;7;0;4;11
22148;Gluosnis;BORUŽĖLĖS;9938235476;Taip;3;0;4;7
22149;Gluosnis;BORUŽĖLĖS;2173191971;Taip;11;0;5;16
22150;Gluosnis;BORUŽĖLĖS;4237053702;Taip;10;5;0;15
22151;Gluosnis;BORUŽĖLĖS;7731887361;Taip;0;0;9;9
22152;Gluosnis;BORUŽĖLĖS;8502947568;Taip;7;4;0;11
22153;Gluosnis;BORUŽĖLĖS;9664090375;Taip;21;0;0;21
22154;Gluosnis;BORUŽĖLĖS;1335152703;Taip;11;4;1;16
22155;Gluosnis;BORUŽĖLĖS;1314992969;Taip;9;5;1;15
22156;Gluosnis;BORUŽĖLĖS;7833136455;Taip;10;3;0;13
22157;Gluosnis;BORUŽĖLĖS;5556821953;Ne;9;0;0;9
22158;Gluosnis;BORUŽĖLĖS;2515646510;Taip;7;5;0;12
22159;Gluosnis;BORUŽĖLĖS;3212658311;Taip;3;0;4;7
22160;Gluosnis;BORUŽĖLĖS;2603201633;Ne;0;0;8;8
22161;Gluosnis;LAPIUKAI;94487630173;Taip;8;10;0;18
22162;Gluosnis;LAPIUKAI;7445566160;Taip;2;4;15;21
22163;Gluosnis;LAPIUKAI;1933496033;Ne;9;2;1;12
22164;Gluosnis;LAPIUKAI;8259035822;Taip;2;8;0;10
22165;Gluosnis;LAPIUKAI;5354082364;Ne;17;1;2;20
22166;Gluosnis;LAPIUKAI;6536698798;Taip;12;0;0;12
22167;Gluosnis;LAPIUKAI;4960167173;Taip;0;5;0;5
22168;Gluosnis;LAPIUKAI;3504197974;Taip;2;4;4;10
22169;Gluosnis;LAPIUKAI;1153781469;Taip;12;0;0;12
22170;Gluosnis;LAPIUKAI;2810808007;Taip;17;4;0;21
22171;Gluosnis;LAPIUKAI;6163009686;Taip;11;1;0;12
22172;Gluosnis;LAPIUKAI;9146356004;Taip;17;0;4;21
22173;Gluosnis;LAPIUKAI;1671693932;Taip;10;0;4;14
22174;Gluosnis;LAPIUKAI;4005023841;Ne;10;0;3;13
22175;Gluosnis;LAPIUKAI;9497547057;Ne;8;0;1;9
22176;Gluosnis;LAPIUKAI;1119389682;Taip;0;0;5;5
22177;Gluosnis;LAPIUKAI;2819283284;Taip;15;0;2;17
22178;Gluosnis;PELĖDŽIUKAI;1739047746;Ne;9;0;2;11
22179;Gluosnis;PELĖDŽIUKAI;3840001741;Ne;0;4;0;4
22180;Gluosnis;PELĖDŽIUKAI;4856769984;Taip;12;0;4;16
22181;Gluosnis;PELĖDŽIUKAI;1944291082;Taip;9;0;2;11
22182;Gluosnis;PELĖDŽIUKAI;54773515741;Taip;0;9;1;10
22183;Gluosnis;PELĖDŽIUKAI;75777330223;Taip;4;0;4;8
22184;Gluosnis;PELĖDŽIUKAI;1319664504;Taip;6;0;3;9
22185;Gluosnis;PELĖDŽIUKAI;11053850075;Taip;0;3;0;3
22186;Gluosnis;PELĖDŽIUKAI;8925611940;Taip;9;0;1;10
22187;Gluosnis;PELĖDŽIUKAI;1269360325;Taip;0;1;0;1
22188;Gluosnis;PELĖDŽIUKAI;3107005229;Taip;0;0;2;2
22189;Gluosnis;PELĖDŽIUKAI;8014916932;Ne;8;0;1;9
22190;Gluosnis;PELĖDŽIUKAI;98818207299;Ne;12;6;0;18
22191;Gluosnis;PELĖDŽIUKAI;31133574731;Taip;0;12;0;12
22192;Gluosnis;PELĖDŽIUKAI;5853981937;Taip;2;4;1;7
22193;Gluosnis;PELĖDŽIUKAI;8788880196;Taip;11;5;1;17
22194;Gluosnis;PELĖDŽIUKAI;1984089149;Ne;13;0;2;15
22195;Gluosnis;PELĖDŽIUKAI;2562046934;Ne;0;0;4;4
22196;Gluosnis;VOVERIUKAI;6047375980;Taip;0;0;4;4
22197;Gluosnis;VOVERIUKAI;4743331873;Taip;0;0;20;20
22198;Gluosnis;VOVERIUKAI;8719047997;Taip;9;0;0;9
22199;Gluosnis;VOVERIUKAI;5059528135;Taip;13;1;0;14
22200;Gluosnis;VOVERIUKAI;7075070566;Taip;0;0;4;4
22201;Gluosnis;VOVERIUKAI;7761376910;Taip;0;0;2;2
22202;Gluosnis;VOVERIUKAI;3434902234;Taip;3;0;0;3
22203;Gluosnis;VOVERIUKAI;1147279898;Taip;8;0;5;13
22204;Gluosnis;VOVERIUKAI;8928237970;Ne;15;0;0;15
22205;Gluosnis;VOVERIUKAI;9786252471;Taip;0;0;1;1
22206;Gluosnis;VOVERIUKAI;6493474181;Taip;9;0;1;10
22207;Gluosnis;VOVERIUKAI;6944918504;Taip;0;0;9;9
22208;Gluosnis;VOVERIUKAI;9669118189;Taip;5;4;0;9
22209;Gluosnis;VOVERIUKAI;4757276892;Taip;0;0;4;4
22210;Gluosnis;VOVERIUKAI;3961201852;Taip;0;0;8;8
22211;Gluosnis;VOVERIUKAI;9379825678;Taip;0;0;2;2
22212;Gluosnis;VOVERIUKAI;1185903576;Taip;0;0;4;4
22213;Gluosnis;VOVERIUKAI;6113600571;Taip;0;0;10;10
22214;Gluosnis;VOVERIUKAI;6443602669;Taip;6;0;3;9
22215;Gluosnis;VOVERIUKAI;1565251804;Taip;0;0;2;2
22216;Gluosnis;DRUGELIAI;5949954525;Taip;18;0;0;18
22217;Gluosnis;DRUGELIAI;7537587118;Taip;17;0;1;18
22218;Gluosnis;DRUGELIAI;6478139233;Taip;10;2;0;12
22219;Gluosnis;DRUGELIAI;1716235604;Taip;2;7;0;9
22220;Gluosnis;DRUGELIAI;7642311375;Taip;7;0;0;7
22221;Gluosnis;DRUGELIAI;8430102757;Taip;4;0;0;4
22222;Gluosnis;DRUGELIAI;4125830926;Taip;9;4;8;21
22223;Gluosnis;DRUGELIAI;6358187113;Taip;14;0;0;14
22224;Gluosnis;DRUGELIAI;2260938817;Taip;10;0;0;10
22225;Gluosnis;DRUGELIAI;9084785666;Taip;1;10;2;13
22226;Gluosnis;DRUGELIAI;4940563623;Taip;21;0;0;21
22227;Gluosnis;DRUGELIAI;1113731535;Taip;9;0;0;9
22228;Gluosnis;DRUGELIAI;4653963373;Ne;21;0;0;21
22229;Gluosnis;DRUGELIAI;2458662117;Taip;2;4;0;6
22230;Gluosnis;DRUGELIAI;3936418539;Ne;15;0;0;15
22231;Gluosnis;DRUGELIAI;8314366921;Taip;15;0;0;15
22232;Gluosnis;DRUGELIAI;4220504133;Taip;2;0;3;5
22233;Gluosnis;DRUGELIAI;9931766935;Taip;3;0;7;10
22234;Gluosnis;DRUGELIAI;3527418865;Taip;10;0;5;15
22235;Gluosnis;DRUGELIAI;6914171069;Taip;11;0;1;12
22236;Gluosnis;BITUTĖS;4176300773;Taip;9;0;0;9
22237;Gluosnis;BITUTĖS;1848647593;Taip;13;0;0;13
22238;Gluosnis;BITUTĖS;2554790908;Taip;6;5;0;11
22239;Gluosnis;BITUTĖS;8281499182;Taip;18;0;0;18
22240;Gluosnis;BITUTĖS;5186060122;Taip;18;0;0;18
22241;Gluosnis;BITUTĖS;8690911930;Taip;9;0;4;13
22242;Gluosnis;BITUTĖS;2403029153;Taip;4;0;4;8
22243;Gluosnis;BITUTĖS;6432475763;Taip;2;0;1;3
22244;Gluosnis;BITUTĖS;9963769327;Taip;19;0;0;19
22245;Gluosnis;BITUTĖS;9542889575;Taip;0;1;0;1
22246;Gluosnis;BITUTĖS;1966484574;Taip;7;0;0;7
22247;Gluosnis;BITUTĖS;4353195155;Taip;17;0;1;18
22248;Gluosnis;BITUTĖS;5889360726;Taip;0;4;1;5
22249;Gluosnis;BITUTĖS;3235523199;Taip;7;0;2;9
22250;Gluosnis;BITUTĖS;8035097045;Taip;5;0;1;6
22251;Gluosnis;BITUTĖS;3362089746;Taip;6;0;8;14
22252;Gluosnis;BITUTĖS;6767500085;Ne;16;0;0;16
22253;Gluosnis;BITUTĖS;4505504276;Taip;8;4;2;14
22254;Gluosnis;BITUTĖS;7390361159;Ne;10;0;1;11
22255;Gluosnis;BITUTĖS;8380310240;Taip;18;0;0;18
22256;"Vilniaus Saulėtekio mokykla-daugiafunkcinis centras";Priešmokyklinė;7047619741;Taip;9;0;0;9
22257;"Vilniaus Saulėtekio mokykla-daugiafunkcinis centras";Priešmokyklinė;3447120578;Ne;4;0;5;9
22258;"Vilniaus Saulėtekio mokykla-daugiafunkcinis centras";Priešmokyklinė;1024982577;Ne;0;4;0;4
22259;"Vilniaus Saulėtekio mokykla-daugiafunkcinis centras";Priešmokyklinė;7061749750;Taip;0;0;4;4
22260;"Vilniaus Saulėtekio mokykla-daugiafunkcinis centras";Priešmokyklinė;51312232477;Taip;0;4;0;4
22261;"Vilniaus Saulėtekio mokykla-daugiafunkcinis centras";Priešmokyklinė;6414861823;Taip;11;4;0;15
22262;"Vilniaus Saulėtekio mokykla-daugiafunkcinis centras";Priešmokyklinė;7563665059;Ne;0;5;0;5
22263;"Vilniaus Saulėtekio mokykla-daugiafunkcinis centras";Priešmokyklinė;1421523719;Taip;5;4;3;12
22264;"Vilniaus Saulėtekio mokykla-daugiafunkcinis centras";Priešmokyklinė;5867141673;Taip;0;4;14;18
22265;"Vilniaus Saulėtekio mokykla-daugiafunkcinis centras";Priešmokyklinė;5248302086;Taip;0;21;0;21
22266;"Vilniaus Saulėtekio mokykla-daugiafunkcinis centras";Priešmokyklinė;80029915729;Taip;0;4;2;6
22267;"Vilniaus Saulėtekio mokykla-daugiafunkcinis centras";Priešmokyklinė;1772051140;Taip;0;4;3;7
22268;"Vilniaus Saulėtekio mokykla-daugiafunkcinis centras";Priešmokyklinė;9932216845;Taip;0;0;20;20
22269;"Vilniaus Saulėtekio mokykla-daugiafunkcinis centras";Priešmokyklinė;9665282942;Ne;7;0;4;11
22270;"Vilniaus Martyno Mažvydo progimnazija";PRIEŠMOKYKLINĖ;96793345108;Taip;0;5;0;5
22271;"Vilniaus Martyno Mažvydo progimnazija";PRIEŠMOKYKLINĖ;19181545360;Taip;10;5;0;15
22272;"Vilniaus Martyno Mažvydo progimnazija";PRIEŠMOKYKLINĖ;3905693699;Ne;0;5;0;5
22273;"Vilniaus Martyno Mažvydo progimnazija";PRIEŠMOKYKLINĖ;4858524232;Taip;0;22;0;22
22274;"Vilniaus Martyno Mažvydo progimnazija";PRIEŠMOKYKLINĖ;68127870846;Taip;10;5;0;15
22275;"Vilniaus Martyno Mažvydo progimnazija";PRIEŠMOKYKLINĖ;3964251862;Taip;0;5;0;5
22276;"Vilniaus Martyno Mažvydo progimnazija";PRIEŠMOKYKLINĖ;41410871117;Taip;8;5;0;13
22277;"Vilniaus Martyno Mažvydo progimnazija";PRIEŠMOKYKLINĖ;4773489765;Taip;0;5;0;5
22278;"Vilniaus Martyno Mažvydo progimnazija";PRIEŠMOKYKLINĖ;2032732500;Taip;3;5;0;8
22279;"Vilniaus Martyno Mažvydo progimnazija";PRIEŠMOKYKLINĖ;18742574853;Taip;0;5;0;5
22280;"Vilniaus Martyno Mažvydo progimnazija";PRIEŠMOKYKLINĖ;1126288017;Taip;0;5;0;5
22281;"Vilniaus Martyno Mažvydo progimnazija";PRIEŠMOKYKLINĖ;1148912605;Taip;0;6;0;6
22282;"Vilniaus Martyno Mažvydo progimnazija";PRIEŠMOKYKLINĖ;83270172138;Taip;0;5;0;5
22283;"Vilniaus Martyno Mažvydo progimnazija";PRIEŠMOKYKLINĖ;1693121016;Taip;3;5;0;8
22284;"Vilniaus Martyno Mažvydo progimnazija";PRIEŠMOKYKLINĖ;1993355696;Ne;0;6;0;6
22285;"Vilniaus Martyno Mažvydo progimnazija";PRIEŠMOKYKLINĖ;25732368565;Ne;0;22;0;22
22286;"Vilniaus Martyno Mažvydo progimnazija";PRIEŠMOKYKLINĖ;5973303255;Taip;9;5;1;15
22287;"Vilniaus Martyno Mažvydo progimnazija";PRIEŠMOKYKLINĖ;34352165481;Taip;0;6;0;6
22288;"Vilniaus Martyno Mažvydo progimnazija";PRIEŠMOKYKLINĖ;1726899445;Ne;0;5;0;5
22289;"Vilniaus Martyno Mažvydo progimnazija";PRIEŠMOKYKLINĖ;15196087730;Ne;2;5;0;7
22290;"Vilniaus Martyno Mažvydo progimnazija";PRIEŠMOKYKLINĖ;4134546404;Ne;5;5;0;10
22291;"Vilniaus „Genio“ progimnazija";Priešmokyklinė;3158067311;Taip;0;4;0;4
22292;"Vilniaus „Genio“ progimnazija";Priešmokyklinė;4754232120;Ne;2;6;1;9
22293;"Vilniaus „Genio“ progimnazija";Priešmokyklinė;6265455084;Taip;5;4;2;11
22294;"Vilniaus „Genio“ progimnazija";Priešmokyklinė;50466456602;Taip;0;4;0;4
22295;"Vilniaus „Genio“ progimnazija";Priešmokyklinė;1924335940;Ne;5;4;0;9
22296;"Vilniaus „Genio“ progimnazija";Priešmokyklinė;2259206809;Taip;0;4;4;8
22297;"Vilniaus „Genio“ progimnazija";Priešmokyklinė;2085116521;Taip;0;4;2;6
22298;"Vilniaus „Genio“ progimnazija";Priešmokyklinė;1877764699;Taip;0;4;0;4
22299;"Vilniaus „Genio“ progimnazija";Priešmokyklinė;2104449007;Ne;3;4;1;8
22300;"Vilniaus „Genio“ progimnazija";Priešmokyklinė;2238619197;Taip;4;4;0;8
22301;"Vilniaus „Genio“ progimnazija";Priešmokyklinė;55275739324;Ne;2;4;3;9
22302;"Vilniaus „Genio“ progimnazija";Priešmokyklinė;1020959963;Taip;5;6;0;11
22303;"Vilniaus „Genio“ progimnazija";Priešmokyklinė;93664116601;Ne;7;4;0;11
22304;"Vilniaus „Genio“ progimnazija";Priešmokyklinė;1203715568;Taip;0;4;1;5
22305;"Vilniaus „Genio“ progimnazija";Priešmokyklinė;8585966469;Ne;5;4;3;12
22306;"Vilniaus „Genio“ progimnazija";Priešmokyklinė;47677246360;Taip;0;4;0;4
22307;"Vilniaus „Genio“ progimnazija";Priešmokyklinė;7961006993;Taip;5;4;0;9
22308;"Vilniaus „Genio“ progimnazija";Priešmokyklinė;80762814965;Taip;1;4;3;8
22309;"Vilniaus „Genio“ progimnazija";Priešmokyklinė;4550479746;Taip;0;4;2;6
22310;"Vilniaus „Genio“ progimnazija";Priešmokyklinė;93498963556;Ne;0;5;3;8
22311;"Vilniaus „Genio“ progimnazija";Priešmokyklinė;4674740550;Taip;5;4;0;9
