Nr.;"Darželio pavadinimas";"Grupės pavadinimas";"Vaiko Identifikacinis Nr.";"Deklaruotas mieste";"Pateisintos dėl ligos";"Pateisintos dėl kitų priežasčių";"Nepateisintos dienos";"Praleistos dienos Viso"
1;Aitvaras;"VIJURKAI (ALERG.)";1795308718;Taip;0;1;0;1
2;Aitvaras;"VIJURKAI (ALERG.)";84922258988;Taip;5;2;0;7
3;Aitvaras;"VIJURKAI (ALERG.)";1201862001;Ne;8;0;1;9
4;Aitvaras;"VIJURKAI (ALERG.)";8970519668;Ne;0;3;0;3
5;Aitvaras;"VIJURKAI (ALERG.)";1600657305;Taip;5;7;0;12
6;Aitvaras;"VIJURKAI (ALERG.)";1621302802;Taip;0;4;0;4
7;Aitvaras;"VIJURKAI (ALERG.)";94080483856;Taip;0;5;0;5
8;Aitvaras;"VIJURKAI (ALERG.)";5083382326;Taip;0;11;0;11
9;Aitvaras;"VIJURKAI (ALERG.)";1834535594;Taip;0;1;0;1
10;Aitvaras;"VIJURKAI (ALERG.)";7083046536;Taip;0;1;0;1
11;Aitvaras;"VIJURKAI (ALERG.)";1773366241;Taip;10;2;0;12
12;Aitvaras;"VIJURKAI (ALERG.)";1553462849;Ne;0;2;0;2
13;Aitvaras;"VIJURKAI (ALERG.)";1398792964;Taip;0;4;0;4
14;Aitvaras;"VIJURKAI (ALERG.)";5770779699;Taip;0;7;0;7
15;Aitvaras;"VIJURKAI (ALERG.)";3716313515;Ne;0;4;2;6
16;Aitvaras;"VIJURKAI (ALERG.)";8366627546;Taip;0;11;0;11
17;Aitvaras;"VIJURKAI (ALERG.)";1481849611;Taip;11;0;1;12
18;Aitvaras;"VIJURKAI (ALERG.)";1090979323;Taip;0;2;0;2
19;Aitvaras;"SMALSUČIAI (ALERG.)";85826303673;Ne;0;7;0;7
20;Aitvaras;"SMALSUČIAI (ALERG.)";7592535089;Taip;3;0;0;3
21;Aitvaras;"SMALSUČIAI (ALERG.)";9845539641;Taip;3;3;0;6
22;Aitvaras;"SMALSUČIAI (ALERG.)";44139920757;Ne;4;0;0;4
23;Aitvaras;"SMALSUČIAI (ALERG.)";3001619281;Taip;0;4;0;4
24;Aitvaras;"SMALSUČIAI (ALERG.)";1301667420;Taip;0;8;0;8
25;Aitvaras;"SMALSUČIAI (ALERG.)";47686798724;Taip;0;2;0;2
26;Aitvaras;"SMALSUČIAI (ALERG.)";1892295973;Ne;0;1;1;2
27;Aitvaras;"SMALSUČIAI (ALERG.)";89623351867;Taip;0;1;0;1
28;Aitvaras;"SMALSUČIAI (ALERG.)";5204534227;Taip;0;1;0;1
29;Aitvaras;"SMALSUČIAI (ALERG.)";2674192321;Taip;0;0;7;7
30;Aitvaras;"SMALSUČIAI (ALERG.)";37391225613;Taip;0;5;0;5
31;Aitvaras;"SMALSUČIAI (ALERG.)";36359228257;Taip;1;1;0;2
32;Aitvaras;"SMALSUČIAI (ALERG.)";31074942686;Taip;0;6;0;6
33;Aitvaras;"SMALSUČIAI (ALERG.)";13670186807;Taip;13;0;7;20
34;Aitvaras;"SMALSUČIAI (ALERG.)";76280361479;Taip;0;2;0;2
35;Aitvaras;"SMALSUČIAI (ALERG.)";12962784212;Ne;0;2;0;2
36;Aitvaras;PADAUŽIUKAI;46998364516;Taip;2;0;1;3
37;Aitvaras;PADAUŽIUKAI;1355296093;Taip;10;0;0;10
38;Aitvaras;PADAUŽIUKAI;54438500410;Taip;0;2;0;2
39;Aitvaras;PADAUŽIUKAI;1476238636;Taip;0;0;1;1
40;Aitvaras;PADAUŽIUKAI;1641140396;Ne;10;0;0;10
41;Aitvaras;PADAUŽIUKAI;2136550853;Ne;5;1;1;7
42;Aitvaras;PADAUŽIUKAI;64683090780;Ne;0;0;1;1
43;Aitvaras;PADAUŽIUKAI;87846069433;Taip;0;1;1;2
44;Aitvaras;PADAUŽIUKAI;30517554931;Taip;0;2;0;2
45;Aitvaras;PADAUŽIUKAI;89194677727;Taip;5;0;1;6
46;Aitvaras;PADAUŽIUKAI;1371102633;Taip;13;1;1;15
47;Aitvaras;PADAUŽIUKAI;24017694836;Taip;1;0;0;1
48;Aitvaras;PADAUŽIUKAI;2092431875;Taip;0;4;2;6
49;Aitvaras;PADAUŽIUKAI;64205113506;Taip;0;0;3;3
50;Aitvaras;PADAUŽIUKAI;1315081684;Taip;5;0;0;5
51;Aitvaras;PADAUŽIUKAI;403821197;Taip;0;2;0;2
52;Aitvaras;"AITVARIUKAI (ALERG.)";1542575012;Taip;0;2;0;2
53;Aitvaras;"AITVARIUKAI (ALERG.)";1223627682;Taip;0;4;0;4
54;Aitvaras;"AITVARIUKAI (ALERG.)";3471031093;Taip;0;3;0;3
55;Aitvaras;"AITVARIUKAI (ALERG.)";9810370596;Taip;11;0;0;11
56;Aitvaras;"AITVARIUKAI (ALERG.)";34735287315;Taip;0;5;0;5
57;Aitvaras;"AITVARIUKAI (ALERG.)";4833313373;Taip;7;0;0;7
58;Aitvaras;"AITVARIUKAI (ALERG.)";9745864667;Taip;3;4;0;7
59;Aitvaras;"AITVARIUKAI (ALERG.)";5389627560;Taip;0;6;0;6
60;Aitvaras;"AITVARIUKAI (ALERG.)";5956333024;Taip;2;1;0;3
61;Aitvaras;"AITVARIUKAI (ALERG.)";1636794584;Taip;0;1;0;1
62;Aitvaras;"AITVARIUKAI (ALERG.)";2953536545;Taip;0;2;1;3
63;Aitvaras;"AITVARIUKAI (ALERG.)";3535659630;Taip;13;0;0;13
64;Aitvaras;"AITVARIUKAI (ALERG.)";3488467265;Taip;5;1;0;6
65;Aitvaras;"AITVARIUKAI (ALERG.)";2566375128;Taip;0;1;0;1
66;Aitvaras;"AITVARIUKAI (ALERG.)";3639102842;Taip;0;1;0;1
67;Aitvaras;"AITVARIUKAI (ALERG.)";7243387750;Taip;9;0;0;9
68;Aitvaras;"AITVARIUKAI (ALERG.)";6587437949;Taip;0;4;0;4
69;Aitvaras;"AITVARIUKAI (ALERG.)";7461284958;Taip;3;4;0;7
70;Aitvaras;"SAULĖS ZUIKUČIAI  (ALERG.)";55369747065;Ne;0;0;1;1
71;Aitvaras;"SAULĖS ZUIKUČIAI  (ALERG.)";837021325;Taip;0;2;0;2
72;Aitvaras;"SAULĖS ZUIKUČIAI  (ALERG.)";1207249857;Taip;4;2;0;6
73;Aitvaras;"SAULĖS ZUIKUČIAI  (ALERG.)";1516018865;Taip;0;2;0;2
74;Aitvaras;"SAULĖS ZUIKUČIAI  (ALERG.)";1392528718;Taip;0;2;1;3
75;Aitvaras;"SAULĖS ZUIKUČIAI  (ALERG.)";1011446683;Taip;0;0;4;4
76;Aitvaras;"SAULĖS ZUIKUČIAI  (ALERG.)";2021772475;Ne;0;1;0;1
77;Aitvaras;"SAULĖS ZUIKUČIAI  (ALERG.)";3433178644;Ne;3;3;0;6
78;Aitvaras;"SAULĖS ZUIKUČIAI  (ALERG.)";69352006024;Taip;4;0;0;4
79;Aitvaras;"SAULĖS ZUIKUČIAI  (ALERG.)";2083332491;Ne;0;1;0;1
80;Aitvaras;"SAULĖS ZUIKUČIAI  (ALERG.)";61721665912;Taip;0;2;0;2
81;Aitvaras;"SAULĖS ZUIKUČIAI  (ALERG.)";6238828251;Taip;5;8;2;15
82;Aitvaras;"SAULĖS ZUIKUČIAI  (ALERG.)";1877245088;Taip;10;1;0;11
83;Aitvaras;"SAULĖS ZUIKUČIAI  (ALERG.)";5619137905;Taip;3;3;0;6
84;Aitvaras;"SAULĖS ZUIKUČIAI  (ALERG.)";4426643908;Taip;0;4;0;4
85;Aitvaras;"ŽEMYNUKAI (ALERG.)";1652681820;Taip;10;0;0;10
86;Aitvaras;"ŽEMYNUKAI (ALERG.)";6166757095;Taip;5;4;0;9
87;Aitvaras;"ŽEMYNUKAI (ALERG.)";5595233402;Taip;13;0;0;13
88;Aitvaras;"ŽEMYNUKAI (ALERG.)";2650483861;Taip;9;0;0;9
89;Aitvaras;"ŽEMYNUKAI (ALERG.)";5922357091;Taip;15;2;0;17
90;Aitvaras;"ŽEMYNUKAI (ALERG.)";6951219468;Taip;0;2;0;2
91;Aitvaras;"ŽEMYNUKAI (ALERG.)";1494094426;Taip;0;3;0;3
92;Aitvaras;"ŽEMYNUKAI (ALERG.)";9562494357;Taip;0;1;4;5
93;Aitvaras;"ŽEMYNUKAI (ALERG.)";6021342178;Taip;0;4;0;4
94;Aitvaras;"ŽEMYNUKAI (ALERG.)";9142513631;Taip;0;8;0;8
95;Aitvaras;"ŽEMYNUKAI (ALERG.)";2737503753;Taip;12;0;0;12
96;Aitvaras;"ŽEMYNUKAI (ALERG.)";4480921300;Taip;10;10;0;20
97;Aitvaras;"ŽEMYNUKAI (ALERG.)";8567255042;Ne;10;0;0;10
98;Aitvaras;"ŽEMYNUKAI (ALERG.)";6218019092;Taip;4;0;2;6
99;Aitvaras;"ŽEMYNUKAI (ALERG.)";7560642918;Taip;4;0;0;4
100;Aitvaras;"ŽEMYNUKAI (ALERG.)";3820930777;Taip;15;3;0;18
101;Aitvaras;"ŽEMYNUKAI (ALERG.)";6624986090;Taip;20;0;0;20
102;Aitvaras;"ŽEMYNUKAI (ALERG.)";4733627644;Taip;0;2;3;5
103;Aitvaras;"ŽEMYNUKAI (ALERG.)";3104109370;Taip;1;0;1;2
104;Aitvaras;"LINKSMUČIAI (ALERG.)";7109001184;Taip;0;0;1;1
105;Aitvaras;"LINKSMUČIAI (ALERG.)";5378212904;Ne;13;1;0;14
106;Aitvaras;"LINKSMUČIAI (ALERG.)";3655710511;Taip;7;2;1;10
107;Aitvaras;"LINKSMUČIAI (ALERG.)";1091372798;Taip;0;2;0;2
108;Aitvaras;"LINKSMUČIAI (ALERG.)";8666824607;Ne;0;1;4;5
109;Aitvaras;"LINKSMUČIAI (ALERG.)";5612991255;Taip;0;2;1;3
110;Aitvaras;"LINKSMUČIAI (ALERG.)";5330618557;Ne;14;0;0;14
111;Aitvaras;"LINKSMUČIAI (ALERG.)";5504431748;Taip;12;0;0;12
112;Aitvaras;"LINKSMUČIAI (ALERG.)";8178703988;Taip;5;0;2;7
113;Aitvaras;"LINKSMUČIAI (ALERG.)";7260577885;Taip;0;4;0;4
114;Aitvaras;"LINKSMUČIAI (ALERG.)";1599183050;Taip;7;0;0;7
115;Aitvaras;"LINKSMUČIAI (ALERG.)";1115202169;Ne;10;0;0;10
116;Aitvaras;"LINKSMUČIAI (ALERG.)";7029464687;Taip;9;0;1;10
117;Aitvaras;"LINKSMUČIAI (ALERG.)";4613894944;Taip;10;0;0;10
118;Aitvaras;"LINKSMUČIAI (ALERG.)";4120515569;Taip;14;0;0;14
119;Aitvaras;"LINKSMUČIAI (ALERG.)";9885781306;Taip;4;1;0;5
120;Aitvaras;"LINKSMUČIAI (ALERG.)";4564723798;Taip;0;0;10;10
121;Aitvaras;"LINKSMUČIAI (ALERG.)";4612994715;Taip;0;0;8;8
122;Aitvaras;NAMINUKAI;40344230133;Taip;0;0;3;3
123;Aitvaras;NAMINUKAI;1493048970;Ne;5;0;1;6
124;Aitvaras;NAMINUKAI;1306408890;Taip;0;8;0;8
125;Aitvaras;NAMINUKAI;59572108690;Taip;0;0;1;1
126;Aitvaras;NAMINUKAI;74628671065;Taip;0;0;1;1
127;Aitvaras;NAMINUKAI;62126044317;Taip;0;7;0;7
128;Aitvaras;NAMINUKAI;46021715174;Taip;0;0;2;2
129;Aitvaras;NAMINUKAI;85560586048;Taip;0;0;1;1
130;Aitvaras;NAMINUKAI;26906648835;Taip;0;2;0;2
131;Aitvaras;NAMINUKAI;42556460388;Taip;15;0;0;15
132;Aitvaras;NAMINUKAI;1487264184;Ne;0;0;3;3
133;Aitvaras;NAMINUKAI;97382092851;Taip;5;14;0;19
134;Aitvaras;NAMINUKAI;1886917840;Taip;17;0;0;17
135;Aitvaras;NAMINUKAI;6647800967;Ne;0;0;1;1
136;Aitvaras;NAMINUKAI;1500548803;Taip;0;4;0;4
137;Aitvaras;NAMINUKAI;5103057090;Taip;0;4;0;4
138;Aitvaras;NAMINUKAI;3836513736;Taip;1;0;1;2
139;Aitvaras;ŠELMIAI;9332771711;Ne;6;1;2;9
140;Aitvaras;ŠELMIAI;6550426644;Taip;0;7;0;7
141;Aitvaras;ŠELMIAI;5818794912;Taip;1;5;1;7
142;Aitvaras;ŠELMIAI;58780461337;Taip;0;2;0;2
143;Aitvaras;ŠELMIAI;1116271183;Taip;0;1;0;1
144;Aitvaras;ŠELMIAI;44046627149;Taip;0;7;1;8
145;Aitvaras;ŠELMIAI;43711349817;Taip;2;0;1;3
146;Aitvaras;ŠELMIAI;7469656671;Taip;3;0;0;3
147;Aitvaras;ŠELMIAI;2408952971;Taip;17;0;0;17
148;Aitvaras;ŠELMIAI;2330782717;Taip;7;0;2;9
149;Aitvaras;ŠELMIAI;40799643122;Taip;4;2;0;6
150;Aitvaras;ŠELMIAI;1387254053;Taip;7;0;0;7
151;Aitvaras;ŠELMIAI;8503279655;Taip;0;2;0;2
152;Aitvaras;ŠELMIAI;1105354193;Taip;4;1;0;5
153;Aitvaras;ŠELMIAI;2034293999;Taip;15;1;0;16
154;Aitvaras;ŠELMIAI;2804106417;Taip;2;1;0;3
155;Aitvaras;ŠELMIAI;2711888522;Taip;7;0;0;7
156;Aitvaras;ŠELMIAI;1996524718;Taip;0;1;3;4
157;Aitvaras;ŠELMIAI;4110585744;Ne;5;0;0;5
158;Aitvaras;ŠELMIAI;6010324894;Taip;0;0;2;2
159;Aitvaras;KODĖLČIUKAI;6214572150;Taip;20;0;0;20
160;Aitvaras;KODĖLČIUKAI;8065540507;Taip;7;0;5;12
161;Aitvaras;KODĖLČIUKAI;1288810999;Taip;5;7;3;15
162;Aitvaras;KODĖLČIUKAI;6501943902;Taip;14;0;6;20
163;Aitvaras;KODĖLČIUKAI;7777235021;Ne;13;0;0;13
164;Aitvaras;KODĖLČIUKAI;5641224483;Taip;0;3;0;3
165;Aitvaras;KODĖLČIUKAI;1830134108;Taip;0;16;0;16
166;Aitvaras;KODĖLČIUKAI;2452780076;Taip;5;7;0;12
167;Aitvaras;KODĖLČIUKAI;3178965623;Taip;0;8;0;8
168;Aitvaras;KODĖLČIUKAI;5905456814;Ne;5;2;0;7
169;Aitvaras;KODĖLČIUKAI;1761446849;Taip;5;0;1;6
170;Aitvaras;KODĖLČIUKAI;6739827530;Taip;5;0;0;5
171;Aitvaras;KODĖLČIUKAI;2807595769;Ne;0;2;0;2
172;Aitvaras;KODĖLČIUKAI;1252145346;Taip;0;0;2;2
173;Aitvaras;PABIRUČIAI;8043062737;Taip;0;0;1;1
174;Aitvaras;PABIRUČIAI;9039303562;Taip;5;0;6;11
175;Aitvaras;PABIRUČIAI;6080549524;Taip;5;0;6;11
176;Aitvaras;PABIRUČIAI;6060880045;Taip;6;0;0;6
177;Aitvaras;PABIRUČIAI;1376605323;Taip;6;0;0;6
178;Aitvaras;PABIRUČIAI;4106097701;Taip;0;4;0;4
179;Aitvaras;PABIRUČIAI;8512502118;Taip;5;1;1;7
180;Aitvaras;PABIRUČIAI;3347213578;Taip;10;0;2;12
181;Aitvaras;PABIRUČIAI;3053557807;Taip;14;0;1;15
182;Aitvaras;PABIRUČIAI;2821221241;Ne;7;0;0;7
183;Aitvaras;PABIRUČIAI;9453994213;Taip;4;0;0;4
184;Aitvaras;PABIRUČIAI;6048701733;Taip;5;2;0;7
185;Aitvaras;PABIRUČIAI;9024245490;Taip;11;0;3;14
186;Aitvaras;PABIRUČIAI;6110226958;Taip;9;0;0;9
187;Aitvaras;PABIRUČIAI;6126913961;Taip;10;0;0;10
188;Aitvaras;"SVAJOKLIAI  (ALERG.)";1606267845;Taip;2;0;0;2
189;Aitvaras;"SVAJOKLIAI  (ALERG.)";5856250605;Taip;10;0;0;10
190;Aitvaras;"SVAJOKLIAI  (ALERG.)";2004112424;Taip;5;5;0;10
191;Aitvaras;"SVAJOKLIAI  (ALERG.)";5750154036;Taip;0;2;2;4
192;Aitvaras;"SVAJOKLIAI  (ALERG.)";6201118021;Taip;0;11;0;11
193;Aitvaras;"SVAJOKLIAI  (ALERG.)";3133031845;Ne;2;6;0;8
194;Aitvaras;"SVAJOKLIAI  (ALERG.)";1275561645;Ne;5;7;0;12
195;Aitvaras;"SVAJOKLIAI  (ALERG.)";1879540041;Taip;12;0;0;12
196;Aitvaras;"SVAJOKLIAI  (ALERG.)";1347364985;Taip;2;0;1;3
197;Aitvaras;"SVAJOKLIAI  (ALERG.)";5425259260;Taip;5;2;0;7
198;Aitvaras;"SVAJOKLIAI  (ALERG.)";9228736015;Taip;0;2;0;2
199;Aitvaras;"SVAJOKLIAI  (ALERG.)";9763502346;Taip;18;0;0;18
200;Aitvaras;"SVAJOKLIAI  (ALERG.)";7568388141;Taip;0;1;0;1
201;Aitvaras;"SVAJOKLIAI  (ALERG.)";4204923580;Taip;15;0;0;15
202;Aitvaras;"SVAJOKLIAI  (ALERG.)";1532588441;Ne;3;5;0;8
203;Aitvaras;"SVAJOKLIAI  (ALERG.)";8206046301;Taip;2;0;0;2
204;Aitvaras;"SVAJOKLIAI  (ALERG.)";6572235324;Taip;15;0;0;15
205;Atžalėlės;Gėlytės;5742471497;Taip;9;0;0;9
206;Atžalėlės;Gėlytės;4284673729;Ne;11;1;7;19
207;Atžalėlės;Gėlytės;8695865604;Ne;5;0;4;9
208;Atžalėlės;Gėlytės;1137741059;Taip;15;0;0;15
209;Atžalėlės;Gėlytės;2385614957;Taip;9;0;0;9
210;Atžalėlės;Gėlytės;5432433423;Taip;0;3;0;3
211;Atžalėlės;Gėlytės;9715625283;Taip;5;0;0;5
212;Atžalėlės;Gėlytės;6024189665;Taip;0;0;5;5
213;Atžalėlės;Gėlytės;4682216852;Ne;17;0;1;18
214;Atžalėlės;Gėlytės;8819893830;Taip;0;0;14;14
215;Atžalėlės;Gėlytės;2131592139;Taip;7;0;4;11
216;Atžalėlės;Gėlytės;1500456945;Taip;0;0;4;4
217;Atžalėlės;Gėlytės;6177038838;Taip;5;1;0;6
218;Atžalėlės;Gėlytės;1722233272;Taip;8;6;0;14
219;Atžalėlės;Gėlytės;5310990513;Taip;5;0;0;5
220;Atžalėlės;Gėlytės;7702502252;Taip;0;12;0;12
221;Atžalėlės;Gėlytės;9189223222;Taip;5;6;0;11
222;Atžalėlės;Gėlytės;3283415814;Taip;4;0;0;4
223;Atžalėlės;Gėlytės;1146492807;Taip;0;0;4;4
224;Atžalėlės;Gėlytės;1036410428;Taip;0;3;0;3
225;Atžalėlės;Gėlytės;1450609695;Taip;4;6;0;10
226;Atžalėlės;Gėlytės;6202250600;Taip;10;0;0;10
227;Atžalėlės;Drugeliai;4643154006;Taip;0;2;0;2
228;Atžalėlės;Drugeliai;6903666624;Taip;5;5;0;10
229;Atžalėlės;Drugeliai;6570245757;Taip;4;0;2;6
230;Atžalėlės;Drugeliai;6782007470;Taip;0;6;0;6
231;Atžalėlės;Drugeliai;8393217418;Taip;0;13;0;13
232;Atžalėlės;Drugeliai;1805496887;Taip;5;0;0;5
233;Atžalėlės;Drugeliai;5417971068;Taip;3;0;0;3
234;Atžalėlės;Drugeliai;9463215947;Taip;2;7;0;9
235;Atžalėlės;Drugeliai;7953922166;Taip;8;0;0;8
236;Atžalėlės;Drugeliai;1830572633;Taip;3;0;0;3
237;Atžalėlės;Drugeliai;9222670655;Taip;8;5;0;13
238;Atžalėlės;Drugeliai;77261118958;Taip;5;0;4;9
239;Atžalėlės;Drugeliai;1429493246;Taip;0;4;0;4
240;Atžalėlės;Drugeliai;6114426973;Taip;14;1;0;15
241;Atžalėlės;Drugeliai;1456979448;Taip;0;2;0;2
242;Atžalėlės;Drugeliai;4884599397;Taip;20;0;2;22
243;Atžalėlės;Drugeliai;8718036014;Taip;20;0;2;22
244;Atžalėlės;Drugeliai;3571134734;Taip;6;5;0;11
245;Atžalėlės;Gandriukai;28910361902;Taip;0;10;0;10
246;Atžalėlės;Gandriukai;93452036571;Taip;0;5;0;5
247;Atžalėlės;Gandriukai;4483002806;Taip;0;0;14;14
248;Atžalėlės;Gandriukai;16442821393;Taip;0;4;0;4
249;Atžalėlės;Gandriukai;1197205716;Taip;0;0;1;1
250;Atžalėlės;Gandriukai;70694002130;Taip;0;0;3;3
251;Atžalėlės;Gandriukai;87334806437;Taip;0;1;0;1
252;Atžalėlės;Gandriukai;1204800605;Taip;9;4;0;13
253;Atžalėlės;Gandriukai;1074259644;Taip;0;1;0;1
254;Atžalėlės;Gandriukai;66107666615;Taip;5;0;0;5
255;Atžalėlės;Gandriukai;2124150483;Taip;0;4;0;4
256;Atžalėlės;Gandriukai;63867153552;Taip;0;1;0;1
257;Atžalėlės;Gandriukai;87567915519;Taip;0;2;0;2
258;Atžalėlės;Gandriukai;1011601294;Taip;0;4;0;4
259;Atžalėlės;Gandriukai;1299048195;Taip;0;0;2;2
260;Atžalėlės;Gandriukai;54869610865;Taip;9;0;0;9
261;Atžalėlės;Gandriukai;80500800894;Taip;0;0;2;2
262;Atžalėlės;Gandriukai;519493490;Ne;0;4;0;4
263;Atžalėlės;Gandriukai;82777644548;Taip;0;0;9;9
264;Atžalėlės;Gandriukai;23453799177;Taip;6;5;0;11
265;Atžalėlės;Gandriukai;78664848612;Taip;1;4;0;5
266;Atžalėlės;Voveriukai;52803011399;Taip;7;0;1;8
267;Atžalėlės;Voveriukai;30370285022;Taip;0;2;0;2
268;Atžalėlės;Voveriukai;1447259034;Taip;0;5;0;5
269;Atžalėlės;Voveriukai;64596277701;Taip;6;0;3;9
270;Atžalėlės;Voveriukai;3379307367;Taip;0;0;2;2
271;Atžalėlės;Voveriukai;62325712598;Taip;5;0;2;7
272;Atžalėlės;Voveriukai;1312772153;Taip;5;0;2;7
273;Atžalėlės;Voveriukai;1865339755;Taip;0;0;5;5
274;Atžalėlės;Voveriukai;8138683218;Taip;0;3;0;3
275;Atžalėlės;Voveriukai;1804802235;Taip;0;2;0;2
276;Atžalėlės;Voveriukai;1316154666;Taip;5;0;1;6
277;Atžalėlės;Voveriukai;9699811980;Ne;0;6;0;6
278;Atžalėlės;Voveriukai;7689394485;Taip;0;10;2;12
279;Atžalėlės;Voveriukai;2013707106;Taip;3;0;0;3
280;Atžalėlės;Voveriukai;2757744826;Ne;4;1;0;5
281;Atžalėlės;Voveriukai;8201582382;Taip;0;0;7;7
282;Atžalėlės;Voveriukai;4362058013;Taip;0;0;7;7
283;Atžalėlės;Voveriukai;51586822606;Taip;0;0;3;3
284;Atžalėlės;Žirniukai;4098210138;Ne;4;0;1;5
285;Atžalėlės;Žirniukai;7807313362;Taip;11;0;0;11
286;Atžalėlės;Žirniukai;4081717007;Taip;1;0;5;6
287;Atžalėlės;Žirniukai;9977104915;Taip;0;0;2;2
288;Atžalėlės;Žirniukai;6265777690;Taip;0;0;1;1
289;Atžalėlės;Žirniukai;7321516783;Taip;10;1;0;11
290;Atžalėlės;Žirniukai;6537864486;Taip;0;0;2;2
291;Atžalėlės;Žirniukai;8768704484;Taip;0;0;9;9
292;Atžalėlės;Žirniukai;6675588261;Taip;0;0;10;10
293;Atžalėlės;Žirniukai;1844980319;Ne;8;5;0;13
294;Atžalėlės;Žirniukai;5997958773;Ne;3;5;1;9
295;Atžalėlės;Žirniukai;8524244526;Taip;17;0;1;18
296;Atžalėlės;Žirniukai;1704679306;Taip;0;2;1;3
297;Atžalėlės;Žirniukai;7356877676;Taip;0;7;0;7
298;Atžalėlės;Žirniukai;6873507667;Taip;12;0;2;14
299;Atžalėlės;Žirniukai;2374624441;Taip;0;6;0;6
300;Atžalėlės;Ežiukai;8586739429;Taip;0;0;1;1
301;Atžalėlės;Ežiukai;1423254771;Taip;7;0;0;7
302;Atžalėlės;Ežiukai;3281114596;Taip;11;0;2;13
303;Atžalėlės;Ežiukai;1431197358;Taip;0;5;4;9
304;Atžalėlės;Ežiukai;4177753994;Taip;0;0;3;3
305;Atžalėlės;Ežiukai;3982090601;Taip;0;0;4;4
306;Atžalėlės;Ežiukai;9925178685;Taip;15;0;1;16
307;Atžalėlės;Ežiukai;2617568019;Taip;6;0;6;12
308;Atžalėlės;Ežiukai;4233689945;Taip;0;0;1;1
309;Atžalėlės;Ežiukai;9053620501;Taip;6;0;4;10
310;Atžalėlės;Ežiukai;8508450500;Taip;6;1;0;7
311;Atžalėlės;Ežiukai;3743308789;Taip;13;0;0;13
312;Atžalėlės;Ežiukai;2339599448;Ne;5;4;0;9
313;Atžalėlės;Paukšteliai;77693032830;Ne;7;2;0;9
314;Atžalėlės;Paukšteliai;99097316080;Taip;0;0;1;1
315;Atžalėlės;Paukšteliai;1576891322;Ne;6;0;2;8
316;Atžalėlės;Paukšteliai;72360139252;Taip;0;8;0;8
317;Atžalėlės;Paukšteliai;89028851257;Taip;0;0;1;1
318;Atžalėlės;Paukšteliai;88525056192;Taip;0;0;1;1
319;Atžalėlės;Paukšteliai;30452835434;Taip;0;0;1;1
320;Atžalėlės;Paukšteliai;1046971571;Taip;0;0;3;3
321;Atžalėlės;Paukšteliai;71490200980;Taip;0;0;1;1
322;Atžalėlės;Paukšteliai;93709702327;Taip;5;0;0;5
323;Atžalėlės;Paukšteliai;90664899396;Taip;0;0;1;1
324;Atžalėlės;Paukšteliai;93762990685;Taip;2;0;1;3
325;Atžalėlės;Paukšteliai;42752976301;Taip;0;0;4;4
326;Atžalėlės;Paukšteliai;27330226432;Ne;0;0;1;1
327;Atžalėlės;Paukšteliai;57459192709;Ne;0;5;0;5
328;Atžalėlės;Paukšteliai;5438129052;Taip;0;0;4;4
329;Atžalėlės;Meškiukai;26878092629;Taip;0;8;0;8
330;Atžalėlės;Meškiukai;1083996834;Taip;0;10;0;10
331;Atžalėlės;Meškiukai;53385285795;Ne;5;2;2;9
332;Atžalėlės;Meškiukai;57197465236;Taip;0;0;4;4
333;Atžalėlės;Meškiukai;96954269567;Taip;4;0;0;4
334;Atžalėlės;Meškiukai;91094623082;Taip;0;8;0;8
335;Atžalėlės;Meškiukai;97667536161;Taip;0;3;0;3
336;Atžalėlės;Meškiukai;32165722689;Taip;0;10;0;10
337;Atžalėlės;Meškiukai;59994970570;Taip;10;0;3;13
338;Atžalėlės;Meškiukai;83433461267;Taip;0;7;0;7
339;Atžalėlės;Meškiukai;46263888918;Taip;0;4;0;4
340;Atžalėlės;Meškiukai;30776087985;Taip;5;0;0;5
341;Atžalėlės;Meškiukai;74153703568;Taip;0;2;0;2
342;Atžalėlės;Meškiukai;40388417436;Taip;0;2;0;2
343;Atžalėlės;Meškiukai;1512766841;Taip;6;0;2;8
344;Atžalėlės;Meškiukai;76280495364;Taip;0;4;0;4
345;Atžalėlės;Meškiukai;1448431632;Taip;5;10;0;15
346;Atžalėlės;Meškiukai;4702130326;Taip;0;7;0;7
347;Aušrelė;PASAKIUKAI;2974714806;Ne;0;6;0;6
348;Aušrelė;PASAKIUKAI;1327431679;Taip;0;6;0;6
349;Aušrelė;PASAKIUKAI;8960462835;Taip;0;0;1;1
350;Aušrelė;PASAKIUKAI;6037757548;Taip;0;0;2;2
351;Aušrelė;PASAKIUKAI;7682402576;Taip;0;1;0;1
352;Aušrelė;PASAKIUKAI;1408751702;Taip;0;7;0;7
353;Aušrelė;PASAKIUKAI;6995749373;Taip;0;1;0;1
354;Aušrelė;PASAKIUKAI;8372554796;Taip;0;1;0;1
355;Aušrelė;PASAKIUKAI;8230362307;Taip;0;0;5;5
356;Aušrelė;PASAKIUKAI;9440600785;Taip;8;0;0;8
357;Aušrelė;PASAKIUKAI;4306578299;Taip;7;5;0;12
358;Aušrelė;PASAKIUKAI;6277405405;Taip;0;9;0;9
359;Aušrelė;PASAKIUKAI;3682523696;Taip;10;0;0;10
360;Aušrelė;PASAKIUKAI;6909708079;Ne;0;4;3;7
361;Aušrelė;BORUŽĖLĖS;6673034329;Taip;7;5;0;12
362;Aušrelė;BORUŽĖLĖS;4957581753;Ne;0;2;8;10
363;Aušrelė;BORUŽĖLĖS;3165692699;Ne;11;0;0;11
364;Aušrelė;BORUŽĖLĖS;1928260563;Taip;11;0;0;11
365;Aušrelė;BORUŽĖLĖS;2626569015;Taip;0;1;0;1
366;Aušrelė;BORUŽĖLĖS;2574681867;Taip;0;0;9;9
367;Aušrelė;BORUŽĖLĖS;6084682084;Taip;0;2;1;3
368;Aušrelė;BORUŽĖLĖS;8243716759;Taip;0;0;5;5
369;Aušrelė;BORUŽĖLĖS;6886505025;Taip;0;3;1;4
370;Aušrelė;BORUŽĖLĖS;3206495858;Taip;0;1;0;1
371;Aušrelė;BORUŽĖLĖS;7861208185;Taip;0;1;0;1
372;Aušrelė;BORUŽĖLĖS;1549962200;Taip;0;2;0;2
373;Aušrelė;BORUŽĖLĖS;4895872593;Taip;7;0;1;8
374;Aušrelė;BORUŽĖLĖS;1582618217;Taip;0;0;3;3
375;Aušrelė;BORUŽĖLĖS;7190665397;Taip;0;4;4;8
376;Aušrelė;BORUŽĖLĖS;2991828434;Taip;7;0;0;7
377;Aušrelė;SMALSUČIAI;76459345433;Ne;0;0;3;3
378;Aušrelė;SMALSUČIAI;17931731597;Taip;5;4;0;9
379;Aušrelė;SMALSUČIAI;8572216200;Taip;0;5;0;5
380;Aušrelė;SMALSUČIAI;74365190360;Taip;0;2;0;2
381;Aušrelė;SMALSUČIAI;1951435363;Taip;6;0;0;6
382;Aušrelė;SMALSUČIAI;3392276890;Taip;10;0;0;10
383;Aušrelė;SMALSUČIAI;14080739740;Taip;0;3;0;3
384;Aušrelė;SMALSUČIAI;73050137188;Taip;0;3;0;3
385;Aušrelė;SMALSUČIAI;49563719275;Taip;7;0;1;8
386;Aušrelė;SMALSUČIAI;7859894371;Taip;0;6;0;6
387;Aušrelė;SMALSUČIAI;1883795851;Taip;5;2;0;7
388;Aušrelė;SMALSUČIAI;68223308125;Ne;5;0;4;9
389;Aušrelė;SMALSUČIAI;90185478786;Taip;0;9;0;9
390;Aušrelė;SMALSUČIAI;26235102809;Taip;0;0;2;2
391;Aušrelė;SMALSUČIAI;42158121278;Taip;8;0;5;13
392;Aušrelė;SMALSUČIAI;78823564616;Taip;0;18;0;18
393;Aušrelė;SMALSUČIAI;1561253093;Taip;0;0;4;4
394;Aušrelė;SMALSUČIAI;1322089393;Taip;0;2;0;2
395;Aušrelė;SMALSUČIAI;94997479625;Ne;0;1;1;2
396;Aušrelė;KODĖLČIUKAI;12032618723;Taip;15;0;0;15
397;Aušrelė;KODĖLČIUKAI;75580617180;Taip;0;3;0;3
398;Aušrelė;KODĖLČIUKAI;24202090947;Ne;4;0;0;4
399;Aušrelė;KODĖLČIUKAI;50864528673;Ne;5;0;0;5
400;Aušrelė;KODĖLČIUKAI;2427329184;Taip;0;1;3;4
401;Aušrelė;KODĖLČIUKAI;24201363476;Taip;0;0;4;4
402;Aušrelė;KODĖLČIUKAI;39887348225;Taip;0;4;0;4
403;Aušrelė;KODĖLČIUKAI;1535153901;Taip;0;0;1;1
404;Aušrelė;KODĖLČIUKAI;63497657826;Taip;0;0;1;1
405;Aušrelė;KODĖLČIUKAI;8837069458;Taip;0;0;2;2
406;Aušrelė;KODĖLČIUKAI;36096756485;Taip;0;2;0;2
407;Aušrelė;KODĖLČIUKAI;1058114795;Taip;11;0;0;11
408;Aušrelė;KODĖLČIUKAI;19415824416;Taip;0;1;0;1
409;Aušrelė;KODĖLČIUKAI;4476948928;Taip;0;3;0;3
410;Aušrelė;KODĖLČIUKAI;44971525276;Taip;5;0;0;5
411;Aušrelė;KODĖLČIUKAI;26185247513;Taip;0;22;0;22
412;Aušrelė;KODĖLČIUKAI;9107952292;Taip;0;0;8;8
413;Aušrelė;KODĖLČIUKAI;58007820848;Taip;0;0;12;12
414;Aušrelė;PELĖDŽIUKAI;34891640909;Taip;0;1;0;1
415;Aušrelė;PELĖDŽIUKAI;5955421544;Ne;0;2;0;2
416;Aušrelė;PELĖDŽIUKAI;1706417053;Taip;5;0;0;5
417;Aušrelė;PELĖDŽIUKAI;31441512644;Taip;11;5;0;16
418;Aušrelė;PELĖDŽIUKAI;2030362509;Taip;0;14;0;14
419;Aušrelė;PELĖDŽIUKAI;1160772086;Taip;0;16;0;16
420;Aušrelė;PELĖDŽIUKAI;1352195876;Taip;8;0;2;10
421;Aušrelė;PELĖDŽIUKAI;1599595256;Taip;0;6;0;6
422;Aušrelė;PELĖDŽIUKAI;2125080379;Taip;5;8;0;13
423;Aušrelė;PELĖDŽIUKAI;1539176090;Taip;0;6;0;6
424;Aušrelė;PELĖDŽIUKAI;1225272131;Taip;6;0;0;6
425;Aušrelė;PELĖDŽIUKAI;1868818387;Taip;8;0;0;8
426;Aušrelė;PELĖDŽIUKAI;2987088389;Ne;0;0;2;2
427;Aušrelė;PELĖDŽIUKAI;1506444915;Taip;0;2;0;2
428;Aušrelė;PELĖDŽIUKAI;5304765447;Taip;0;3;0;3
429;Aušrelė;PELĖDŽIUKAI;85739624682;Taip;11;0;4;15
430;Aušrelė;PELĖDŽIUKAI;6837623034;Taip;0;0;7;7
431;Aušrelė;PELĖDŽIUKAI;3974308431;Ne;0;0;4;4
432;Aušrelė;AITVARIUKAI;49583107808;Taip;9;0;0;9
433;Aušrelė;AITVARIUKAI;2045076279;Taip;0;1;0;1
434;Aušrelė;AITVARIUKAI;1153416324;Taip;0;22;0;22
435;Aušrelė;AITVARIUKAI;1340754039;Taip;10;0;0;10
436;Aušrelė;AITVARIUKAI;42721248496;Taip;0;12;0;12
437;Aušrelė;AITVARIUKAI;79695989966;Taip;0;11;0;11
438;Aušrelė;AITVARIUKAI;1045290039;Taip;0;7;0;7
439;Aušrelė;AITVARIUKAI;51119593813;Taip;5;0;0;5
440;Aušrelė;AITVARIUKAI;5813735533;Taip;0;0;3;3
441;Aušrelė;AITVARIUKAI;18117725053;Taip;15;0;2;17
442;Aušrelė;AITVARIUKAI;27629722512;Taip;0;9;0;9
443;Aušrelė;AITVARIUKAI;1830501248;Ne;10;0;3;13
444;Aušrelė;AITVARIUKAI;65369497777;Taip;0;22;0;22
445;Aušrelė;AITVARIUKAI;1750555187;Taip;9;0;0;9
446;Aušrelė;AITVARIUKAI;8221635058;Taip;0;1;3;4
447;Aušrelė;AITVARIUKAI;1163757003;Taip;9;5;0;14
448;Aušrelė;AITVARIUKAI;1792774415;Taip;5;2;1;8
449;Aušrelė;BITUTĖS;2096291405;Taip;0;10;0;10
450;Aušrelė;BITUTĖS;6519246290;Taip;5;3;0;8
451;Aušrelė;BITUTĖS;2085252423;Ne;0;5;0;5
452;Aušrelė;BITUTĖS;1666951645;Taip;0;6;0;6
453;Aušrelė;BITUTĖS;1958425979;Taip;0;1;0;1
454;Aušrelė;BITUTĖS;72441793163;Ne;0;6;0;6
455;Aušrelė;BITUTĖS;1177022224;Taip;0;0;1;1
456;Aušrelė;ŽIRNIUKAI;6761263775;Taip;0;1;2;3
457;Aušrelė;ŽIRNIUKAI;8503309819;Taip;16;3;0;19
458;Aušrelė;ŽIRNIUKAI;2827216981;Taip;7;2;0;9
459;Aušrelė;ŽIRNIUKAI;2852596989;Taip;0;20;2;22
460;Aušrelė;ŽIRNIUKAI;7930717076;Taip;0;5;0;5
461;Aušrelė;ŽIRNIUKAI;4942168388;Taip;0;13;9;22
462;Aušrelė;ŽIRNIUKAI;2266390402;Taip;0;7;0;7
463;Aušrelė;ŽIRNIUKAI;4262596104;Taip;7;0;0;7
464;Aušrelė;ŽIRNIUKAI;2390128933;Taip;13;1;0;14
465;Aušrelė;ŽIRNIUKAI;9443641849;Taip;7;0;0;7
466;Aušrelė;ŽIRNIUKAI;7609339123;Taip;0;6;0;6
467;Aušrelė;ŽIRNIUKAI;7070013052;Taip;9;0;0;9
468;Aušrelė;ŽIRNIUKAI;5478028396;Ne;19;0;0;19
469;Aušrelė;ŽIRNIUKAI;5935579452;Taip;0;13;0;13
470;Aušrelė;ŽIRNIUKAI;2863655361;Taip;10;0;0;10
471;Aušrelė;ŽIRNIUKAI;3581155949;Taip;2;0;0;2
472;Aušrelė;GRYBUKAI;6911735462;Taip;5;0;0;5
473;Aušrelė;GRYBUKAI;5712867880;Taip;7;15;0;22
474;Aušrelė;GRYBUKAI;6002434911;Taip;0;4;0;4
475;Aušrelė;GRYBUKAI;4288695809;Taip;0;0;1;1
476;Aušrelė;GRYBUKAI;3807967685;Taip;12;0;0;12
477;Aušrelė;GRYBUKAI;7327544406;Ne;11;0;0;11
478;Aušrelė;GRYBUKAI;5046027475;Taip;13;1;0;14
479;Aušrelė;GRYBUKAI;3320399046;Taip;17;0;0;17
480;Aušrelė;GRYBUKAI;7723159748;Taip;15;0;0;15
481;Aušrelė;GRYBUKAI;6109859056;Ne;10;0;0;10
482;Aušrelė;GRYBUKAI;2030555139;Taip;0;8;0;8
483;Aušrelė;GRYBUKAI;3623813061;Taip;5;2;0;7
484;Aušrelė;GRYBUKAI;8693750994;Taip;5;0;0;5
485;Aušrelė;GRYBUKAI;6308519574;Taip;5;0;0;5
486;Aušrelė;DRUGELIAI;8780847265;Taip;6;0;0;6
487;Aušrelė;DRUGELIAI;8210698019;Taip;10;5;0;15
488;Aušrelė;DRUGELIAI;2545065554;Taip;0;0;2;2
489;Aušrelė;DRUGELIAI;8411336992;Taip;5;0;0;5
490;Aušrelė;DRUGELIAI;2656152037;Taip;5;0;1;6
491;Aušrelė;DRUGELIAI;8917907028;Taip;10;0;0;10
492;Aušrelė;DRUGELIAI;3738923947;Taip;10;0;0;10
493;Aušrelė;DRUGELIAI;1741716341;Taip;12;8;0;20
494;Aušrelė;DRUGELIAI;3223092149;Taip;11;0;0;11
495;Aušrelė;DRUGELIAI;8580241126;Taip;6;0;1;7
496;Aušrelė;DRUGELIAI;9244715396;Taip;10;0;0;10
497;Aušrelė;DRUGELIAI;4227228548;Taip;6;0;0;6
498;Aušrelė;DRUGELIAI;8996445434;Taip;6;0;0;6
499;Aušrelė;NYKŠTUKAI;5311181664;Taip;5;3;0;8
500;Aušrelė;NYKŠTUKAI;9158248746;Taip;3;0;4;7
501;Aušrelė;NYKŠTUKAI;5708459561;Taip;9;0;0;9
502;Aušrelė;NYKŠTUKAI;5125295651;Taip;5;0;0;5
503;Aušrelė;NYKŠTUKAI;6601922746;Taip;11;0;0;11
504;Aušrelė;NYKŠTUKAI;1039180129;Taip;10;0;0;10
505;Beržynėlis;SVIRPLIUKAI;29356394553;Taip;0;8;0;8
506;Beržynėlis;SVIRPLIUKAI;45685658789;Taip;8;0;0;8
507;Beržynėlis;SVIRPLIUKAI;74856278886;Taip;0;1;0;1
508;Beržynėlis;SVIRPLIUKAI;1207208151;Taip;6;0;0;6
509;Beržynėlis;SVIRPLIUKAI;1895493234;Taip;5;0;0;5
510;Beržynėlis;SVIRPLIUKAI;1583090840;Taip;5;0;0;5
511;Beržynėlis;SVIRPLIUKAI;7289803632;Taip;0;1;0;1
512;Beržynėlis;SVIRPLIUKAI;1682929565;Taip;5;2;0;7
513;Beržynėlis;SVIRPLIUKAI;1612137286;Taip;0;3;0;3
514;Beržynėlis;SVIRPLIUKAI;71505149611;Ne;0;1;0;1
515;Beržynėlis;SVIRPLIUKAI;1395819329;Taip;4;0;0;4
516;Beržynėlis;SVIRPLIUKAI;7248602510;Taip;7;0;0;7
517;Beržynėlis;SVIRPLIUKAI;3641421009;Ne;10;0;0;10
518;Beržynėlis;SVIRPLIUKAI;2791734213;Taip;1;0;0;1
519;Beržynėlis;SVIRPLIUKAI;3278699117;Taip;0;2;0;2
520;Beržynėlis;SVIRPLIUKAI;1838631438;Taip;5;0;0;5
521;Beržynėlis;SVIRPLIUKAI;2681482042;Taip;2;0;0;2
522;Beržynėlis;SVIRPLIUKAI;1516309509;Taip;0;2;0;2
523;Beržynėlis;SVIRPLIUKAI;6395436937;Ne;5;3;0;8
524;Beržynėlis;PELEDŽIUKAI;9035951859;Ne;0;2;0;2
525;Beržynėlis;PELEDŽIUKAI;46844790286;Taip;0;0;1;1
526;Beržynėlis;PELEDŽIUKAI;69893760439;Taip;0;4;0;4
527;Beržynėlis;PELEDŽIUKAI;6082843533;Taip;5;0;0;5
528;Beržynėlis;PELEDŽIUKAI;23484694902;Taip;0;10;0;10
529;Beržynėlis;PELEDŽIUKAI;50686761208;Ne;3;0;1;4
530;Beržynėlis;PELEDŽIUKAI;73555363332;Taip;0;2;3;5
531;Beržynėlis;PELEDŽIUKAI;69508373227;Taip;14;2;0;16
532;Beržynėlis;PELEDŽIUKAI;80418262829;Taip;0;2;1;3
533;Beržynėlis;PELEDŽIUKAI;48768116923;Taip;5;0;0;5
534;Beržynėlis;PELEDŽIUKAI;87966535672;Taip;3;0;0;3
535;Beržynėlis;PELEDŽIUKAI;48258183822;Taip;0;2;1;3
536;Beržynėlis;PELEDŽIUKAI;19892724367;Taip;3;7;2;12
537;Beržynėlis;PELEDŽIUKAI;11586645391;Taip;6;0;0;6
538;Beržynėlis;PELEDŽIUKAI;9737673167;Taip;0;0;2;2
539;Beržynėlis;ŽIOGELIAI;7929997884;Ne;4;1;0;5
540;Beržynėlis;ŽIOGELIAI;5114301953;Taip;10;9;0;19
541;Beržynėlis;ŽIOGELIAI;5308596559;Taip;5;7;1;13
542;Beržynėlis;ŽIOGELIAI;4035764376;Taip;2;2;1;5
543;Beržynėlis;ŽIOGELIAI;4970999989;Taip;4;0;0;4
544;Beržynėlis;ŽIOGELIAI;1325972861;Taip;11;0;2;13
545;Beržynėlis;ŽIOGELIAI;8297427176;Taip;6;1;0;7
546;Beržynėlis;ŽIOGELIAI;3149966189;Taip;0;0;1;1
547;Beržynėlis;ŽIOGELIAI;8688852668;Taip;8;0;0;8
548;Beržynėlis;ŽIOGELIAI;9540292311;Taip;0;0;5;5
549;Beržynėlis;ŽIOGELIAI;6218165554;Taip;0;0;5;5
550;Beržynėlis;ŽIOGELIAI;5473666098;Taip;5;2;0;7
551;Beržynėlis;ŽIOGELIAI;7589778533;Taip;0;11;0;11
552;Beržynėlis;ŽIOGELIAI;6739927917;Taip;0;0;1;1
553;Beržynėlis;ŽIOGELIAI;2971686368;Taip;5;0;2;7
554;Beržynėlis;ŽIOGELIAI;9409317403;Taip;7;1;0;8
555;Beržynėlis;ŽIOGELIAI;6334152631;Taip;19;0;0;19
556;Beržynėlis;ŽVIRBLIUKAI;7520394353;Taip;0;1;0;1
557;Beržynėlis;ŽVIRBLIUKAI;95544821432;Taip;0;2;2;4
558;Beržynėlis;ŽVIRBLIUKAI;1426962644;Taip;0;2;1;3
559;Beržynėlis;ŽVIRBLIUKAI;1527942602;Taip;0;1;0;1
560;Beržynėlis;ŽVIRBLIUKAI;1910024785;Taip;15;2;0;17
561;Beržynėlis;ŽVIRBLIUKAI;1823144276;Ne;9;2;1;12
562;Beržynėlis;ŽVIRBLIUKAI;1464556813;Taip;0;6;0;6
563;Beržynėlis;ŽVIRBLIUKAI;1945230630;Taip;5;0;0;5
564;Beržynėlis;ŽVIRBLIUKAI;1466742506;Taip;0;0;1;1
565;Beržynėlis;ŽVIRBLIUKAI;1578089280;Taip;0;1;0;1
566;Beržynėlis;ŽVIRBLIUKAI;87592204193;Taip;0;1;0;1
567;Beržynėlis;ŽVIRBLIUKAI;62962970458;Taip;12;2;0;14
568;Beržynėlis;ŽVIRBLIUKAI;17743947386;Taip;0;2;2;4
569;Beržynėlis;ŽVIRBLIUKAI;1885972165;Taip;0;2;0;2
570;Beržynėlis;ŽVIRBLIUKAI;81022321678;Taip;6;0;1;7
571;Beržynėlis;ŽVIRBLIUKAI;1391844432;Taip;5;2;7;14
572;Beržynėlis;ŽVIRBLIUKAI;1014895926;Taip;5;2;7;14
573;Beržynėlis;ŽIRNIUKAI;8880151537;Taip;8;2;0;10
574;Beržynėlis;ŽIRNIUKAI;2221708263;Taip;20;0;0;20
575;Beržynėlis;ŽIRNIUKAI;6330033887;Taip;8;0;0;8
576;Beržynėlis;ŽIRNIUKAI;9503352345;Taip;5;1;0;6
577;Beržynėlis;ŽIRNIUKAI;5189335842;Taip;4;0;0;4
578;Beržynėlis;ŽIRNIUKAI;6293884233;Taip;4;0;0;4
579;Beržynėlis;ŽIRNIUKAI;4161974847;Ne;7;0;0;7
580;Beržynėlis;ŽIRNIUKAI;3209966996;Taip;0;2;0;2
581;Beržynėlis;ŽIRNIUKAI;2273629510;Taip;5;0;0;5
582;Beržynėlis;ŽIRNIUKAI;1799326151;Taip;5;0;0;5
583;Beržynėlis;VIŠČIUKAI;4466393687;Taip;0;0;1;1
584;Beržynėlis;VIŠČIUKAI;8280378527;Taip;3;2;0;5
585;Beržynėlis;VIŠČIUKAI;1729819557;Taip;0;0;2;2
586;Beržynėlis;VIŠČIUKAI;4774769217;Taip;9;0;1;10
587;Beržynėlis;VIŠČIUKAI;8881566865;Taip;5;0;2;7
588;Beržynėlis;VIŠČIUKAI;5194416351;Taip;5;0;0;5
589;Beržynėlis;VIŠČIUKAI;9754455116;Taip;10;2;0;12
590;Beržynėlis;VIŠČIUKAI;5069929376;Taip;0;3;4;7
591;Beržynėlis;VIŠČIUKAI;4013099670;Taip;3;2;0;5
592;Beržynėlis;VIŠČIUKAI;2892553878;Taip;0;2;0;2
593;Bildukas;"Svetliački savaitinė";80327840821;Taip;4;2;0;6
594;Bildukas;"Svetliački savaitinė";96874940646;Taip;0;1;1;2
595;Bildukas;"Svetliački savaitinė";6441340680;Taip;0;3;0;3
596;Bildukas;"Svetliački savaitinė";1029617146;Taip;0;4;0;4
597;Bildukas;"Svetliački savaitinė";1643122874;Taip;5;7;0;12
598;Bildukas;"Svetliački savaitinė";70033583066;Taip;0;9;0;9
599;Bildukas;"Svetliački savaitinė";75301544496;Taip;5;0;0;5
600;Bildukas;"Svetliački savaitinė";1023163775;Ne;0;12;0;12
601;Bildukas;"Svetliački savaitinė";5026245712;Taip;0;1;0;1
602;Bildukas;"Svetliački savaitinė";9084423113;Ne;0;1;4;5
603;Bildukas;"Svetliački savaitinė";13885215871;Taip;0;1;3;4
604;Bildukas;"Svetliački savaitinė";25050688839;Ne;3;0;0;3
605;Bildukas;"Svetliački savaitinė";9535522910;Ne;0;8;0;8
606;Bildukas;"Svetliački savaitinė";1183272346;Ne;9;1;4;14
607;Bildukas;"Svetliački savaitinė";3226370339;Taip;5;0;1;6
608;Bildukas;"Svetliački savaitinė";6548776238;Taip;0;0;22;22
609;Bildukas;"Svetliački savaitinė";6219872984;Taip;5;0;2;7
610;Bildukas;"Svetliački savaitinė";2091204077;Taip;0;2;0;2
611;Bildukas;"Svetliački savaitinė";4112888719;Taip;0;0;22;22
612;Bildukas;"Svetliački savaitinė";3531285331;Taip;0;1;3;4
613;Bildukas;"Svetliački savaitinė";1409708149;Taip;0;6;0;6
614;Bildukas;"Zaičiata savaitinė ( keli alergiški vaikai)";8927489885;Taip;14;0;0;14
615;Bildukas;"Zaičiata savaitinė ( keli alergiški vaikai)";8694887879;Taip;0;0;4;4
616;Bildukas;"Zaičiata savaitinė ( keli alergiški vaikai)";1916522637;Taip;0;0;2;2
617;Bildukas;"Zaičiata savaitinė ( keli alergiški vaikai)";6376189019;Taip;10;1;2;13
618;Bildukas;"Zaičiata savaitinė ( keli alergiški vaikai)";5747277587;Taip;11;0;0;11
619;Bildukas;"Zaičiata savaitinė ( keli alergiški vaikai)";3239566139;Taip;0;2;0;2
620;Bildukas;"Zaičiata savaitinė ( keli alergiški vaikai)";3323226123;Ne;0;0;5;5
621;Bildukas;"Zaičiata savaitinė ( keli alergiški vaikai)";5794471794;Taip;5;1;0;6
622;Bildukas;"Zaičiata savaitinė ( keli alergiški vaikai)";4894478262;Taip;9;5;5;19
623;Bildukas;"Zaičiata savaitinė ( keli alergiški vaikai)";2539486337;Taip;0;0;11;11
624;Bildukas;"Zaičiata savaitinė ( keli alergiški vaikai)";8496678513;Taip;0;0;1;1
625;Bildukas;"Zaičiata savaitinė ( keli alergiški vaikai)";2154916232;Taip;12;1;0;13
626;Bildukas;"Zaičiata savaitinė ( keli alergiški vaikai)";1566191212;Taip;0;9;0;9
627;Bildukas;"Zaičiata savaitinė ( keli alergiški vaikai)";9155896981;Taip;22;0;0;22
628;Bildukas;"Zaičiata savaitinė ( keli alergiški vaikai)";8080989574;Taip;0;11;0;11
629;Bildukas;Gnomiki;8382899180;Taip;0;4;0;4
630;Bildukas;Gnomiki;4392299046;Taip;0;0;2;2
631;Bildukas;Gnomiki;1486878343;Taip;0;3;0;3
632;Bildukas;Gnomiki;1987773024;Taip;10;0;0;10
633;Bildukas;Gnomiki;5217751936;Taip;0;13;0;13
634;Bildukas;Gnomiki;8999239172;Taip;0;0;1;1
635;Bildukas;Gnomiki;9156801640;Ne;11;0;1;12
636;Bildukas;Gnomiki;1047459617;Taip;0;2;0;2
637;Bildukas;Gnomiki;9756326725;Taip;0;0;5;5
638;Bildukas;Gnomiki;5724787637;Taip;10;0;1;11
639;Bildukas;Gnomiki;9835391223;Taip;20;0;0;20
640;Bildukas;Gnomiki;2429527586;Taip;0;0;9;9
641;Bildukas;Gnomiki;4116831802;Ne;15;0;0;15
642;Bildukas;Zvonočki;4866401336;Taip;5;0;0;5
643;Bildukas;Zvonočki;1180357950;Taip;4;2;0;6
644;Bildukas;Zvonočki;99302309410;Taip;0;2;0;2
645;Bildukas;Zvonočki;91777282521;Ne;0;5;0;5
646;Bildukas;Zvonočki;1713133196;Ne;0;1;1;2
647;Bildukas;Zvonočki;1956741726;Taip;5;0;2;7
648;Bildukas;Zvonočki;1234033395;Ne;0;1;0;1
649;Bildukas;Zvonočki;4404602365;Taip;0;1;0;1
650;Bildukas;Zvonočki;4014493868;Taip;7;4;0;11
651;Bildukas;Zvonočki;6388514464;Taip;7;4;0;11
652;Bildukas;Zvonočki;4377803110;Taip;8;2;0;10
653;Bildukas;Zvonočki;7898746258;Taip;8;0;2;10
654;Bildukas;Zvonočki;9569296370;Taip;0;0;5;5
655;Bildukas;Zvonočki;1113168085;Taip;4;0;7;11
656;Bildukas;Zvonočki;1125206576;Taip;0;13;0;13
657;Bildukas;Zvonočki;4623727349;Taip;7;1;0;8
658;Birutės;SKRUZDELIUKŲ;7526975680;Taip;7;0;0;7
659;Birutės;SKRUZDELIUKŲ;4968068043;Taip;7;0;1;8
660;Birutės;SKRUZDELIUKŲ;1761065941;Taip;15;0;0;15
661;Birutės;SKRUZDELIUKŲ;3728361481;Taip;0;0;1;1
662;Birutės;SKRUZDELIUKŲ;9610268046;Taip;10;0;0;10
663;Birutės;SKRUZDELIUKŲ;4027700332;Taip;6;0;1;7
664;Birutės;SKRUZDELIUKŲ;7685356079;Ne;8;0;0;8
665;Birutės;SKRUZDELIUKŲ;4375683234;Taip;8;0;0;8
666;Birutės;SKRUZDELIUKŲ;1105133326;Taip;1;0;0;1
667;Birutės;SKRUZDELIUKŲ;8413760872;Taip;19;0;0;19
668;Birutės;SKRUZDELIUKŲ;8636113039;Taip;0;4;2;6
669;Birutės;SKRUZDELIUKŲ;3893693567;Taip;7;0;0;7
670;Birutės;SKRUZDELIUKŲ;7119951690;Taip;8;0;0;8
671;Birutės;SKRUZDELIUKŲ;1945532852;Taip;0;0;3;3
672;Birutės;SKRUZDELIUKŲ;5811810714;Ne;10;0;0;10
673;Birutės;SKRUZDELIUKŲ;6815916679;Taip;0;8;4;12
674;Birutės;SKRUZDELIUKŲ;7251592439;Taip;2;0;2;4
675;Birutės;SKRUZDELIUKŲ;7940403585;Taip;0;1;0;1
676;Birutės;BITUČIŲ;1599159924;Taip;10;0;0;10
677;Birutės;BITUČIŲ;33770983649;Taip;0;2;0;2
678;Birutės;BITUČIŲ;87693588654;Taip;0;9;0;9
679;Birutės;BITUČIŲ;2975442228;Ne;7;0;3;10
680;Birutės;BITUČIŲ;5770026060;Taip;5;0;0;5
681;Birutės;BITUČIŲ;98391790116;Taip;0;0;9;9
682;Birutės;BITUČIŲ;5947971037;Taip;0;5;0;5
683;Birutės;BITUČIŲ;3870702348;Taip;0;0;5;5
684;Birutės;BITUČIŲ;7149060118;Ne;0;5;0;5
685;Birutės;BITUČIŲ;1064449916;Taip;0;6;0;6
686;Birutės;BITUČIŲ;3436637062;Taip;0;2;0;2
687;Birutės;BITUČIŲ;9769645272;Taip;13;0;2;15
688;Birutės;BITUČIŲ;8465645434;Taip;5;0;2;7
689;Birutės;BITUČIŲ;9722922540;Ne;5;0;0;5
690;Birutės;BITUČIŲ;4427232735;Ne;0;0;5;5
691;Birutės;BITUČIŲ;6006110601;Ne;0;0;3;3
692;Birutės;BITUČIŲ;5164196372;Taip;4;0;0;4
693;Birutės;BITUČIŲ;3061210677;Taip;0;0;5;5
694;Birutės;BITUČIŲ;6431396285;Taip;5;0;1;6
695;Birutės;BITUČIŲ;6081472534;Taip;0;0;1;1
696;Birutės;BORUŽIUKAI;83627433055;Taip;0;8;0;8
697;Birutės;BORUŽIUKAI;48493277224;Taip;0;2;1;3
698;Birutės;BORUŽIUKAI;1244627213;Taip;0;0;18;18
699;Birutės;BORUŽIUKAI;44098551169;Taip;0;0;1;1
700;Birutės;BORUŽIUKAI;1228407191;Taip;5;0;0;5
701;Birutės;BORUŽIUKAI;76900751891;Taip;3;6;0;9
702;Birutės;BORUŽIUKAI;78441249067;Taip;0;2;0;2
703;Birutės;BORUŽIUKAI;1735549924;Taip;9;0;0;9
704;Birutės;BORUŽIUKAI;1905393478;Taip;1;0;0;1
705;Birutės;BORUŽIUKAI;1427891290;Taip;13;2;0;15
706;Birutės;BORUŽIUKAI;44844176536;Taip;0;6;1;7
707;Birutės;BORUŽIUKAI;22452517583;Taip;0;1;0;1
708;Birutės;BORUŽIUKAI;9450257904;Taip;0;1;0;1
709;Birutės;BORUŽIUKAI;1596098119;Ne;2;2;0;4
710;Birutės;BORUŽIUKAI;60466633757;Taip;5;5;0;10
711;Birutės;BORUŽIUKAI;9936423295;Ne;0;0;2;2
712;Birutės;BORUŽIUKAI;4217246188;Taip;11;1;0;12
713;Birutės;BORUŽIUKAI;70370187632;Taip;0;6;0;6
714;Birutės;BORUŽIUKAI;1264545164;Taip;0;6;6;12
715;Birutės;DRUGELIAI;1884820602;Taip;2;0;0;2
716;Birutės;DRUGELIAI;77244600491;Taip;9;0;3;12
717;Birutės;DRUGELIAI;49162494334;Taip;10;0;0;10
718;Birutės;DRUGELIAI;3213573357;Ne;0;0;1;1
719;Birutės;DRUGELIAI;1163666527;Taip;0;6;0;6
720;Birutės;DRUGELIAI;32780299044;Taip;6;0;0;6
721;Birutės;DRUGELIAI;1346957081;Taip;0;4;0;4
722;Birutės;DRUGELIAI;88939598407;Taip;4;2;0;6
723;Birutės;DRUGELIAI;1950295916;Taip;15;0;0;15
724;Birutės;DRUGELIAI;9662009307;Ne;13;0;6;19
725;Birutės;DRUGELIAI;9860683556;Taip;1;1;0;2
726;Birutės;DRUGELIAI;32821891070;Ne;1;0;0;1
727;Birutės;DRUGELIAI;18503890312;Taip;0;6;0;6
728;Birutės;DRUGELIAI;5574120561;Taip;1;0;0;1
729;Birutės;DRUGELIAI;7215289265;Taip;2;0;0;2
730;Bitutė;Aitvariukų;6674923740;Taip;0;2;0;2
731;Bitutė;Aitvariukų;8394685672;Taip;0;6;0;6
732;Bitutė;Aitvariukų;3796188100;Taip;0;1;0;1
733;Bitutė;Aitvariukų;1846974702;Taip;0;5;0;5
734;Bitutė;Aitvariukų;1162903905;Taip;0;9;0;9
735;Bitutė;Aitvariukų;1560715159;Taip;0;21;0;21
736;Bitutė;Aitvariukų;6204566294;Taip;0;6;0;6
737;Bitutė;Aitvariukų;2518730247;Taip;0;6;0;6
738;Bitutė;Aitvariukų;5895868876;Taip;0;22;0;22
739;Bitutė;Aitvariukų;8743734366;Taip;0;5;0;5
740;Bitutė;Aitvariukų;2804203556;Taip;0;20;0;20
741;Bitutė;Aitvariukų;5455919343;Taip;0;11;0;11
742;Bitutė;Aitvariukų;6737174004;Taip;0;12;0;12
743;Bitutė;Aitvariukų;3432065233;Taip;0;14;0;14
744;Bitutė;Aitvariukų;5679397165;Taip;0;20;0;20
745;Bitutė;Aitvariukų;1564763789;Taip;0;3;0;3
746;Bitutė;Aitvariukų;7456328992;Taip;0;17;0;17
747;Bitutė;Aitvariukų;5810344229;Taip;0;6;0;6
748;Bitutė;Ežiukų;78233050805;Taip;0;5;0;5
749;Bitutė;Ežiukų;43167655810;Ne;0;11;0;11
750;Bitutė;Ežiukų;38137764071;Taip;0;10;0;10
751;Bitutė;Ežiukų;40949937934;Taip;0;10;0;10
752;Bitutė;Ežiukų;67601917966;Taip;0;6;0;6
753;Bitutė;Ežiukų;1824939092;Taip;0;3;0;3
754;Bitutė;Ežiukų;21280284948;Taip;0;5;0;5
755;Bitutė;Ežiukų;1262030751;Taip;0;13;0;13
756;Bitutė;Ežiukų;57841590670;Taip;0;18;0;18
757;Bitutė;Ežiukų;70388118169;Taip;5;0;0;5
758;Bitutė;Ežiukų;56287634684;Taip;0;7;0;7
759;Bitutė;Ežiukų;4315172747;Taip;0;6;0;6
760;Bitutė;Ežiukų;5126303823;Taip;9;2;0;11
761;Bitutė;Ežiukų;9838379838;Taip;0;22;0;22
762;Bitutė;Ežiukų;42098027592;Ne;0;21;0;21
763;Bitutė;Ežiukų;17953339860;Taip;0;11;0;11
764;Bitutė;Ežiukų;4764586168;Taip;0;13;0;13
765;Bitutė;Ežiukų;8905075899;Taip;0;1;0;1
766;Bitutė;Žvirbliukų;3804171750;Taip;0;2;0;2
767;Bitutė;Žvirbliukų;8545377054;Taip;0;6;0;6
768;Bitutė;Žvirbliukų;5406667195;Taip;0;6;0;6
769;Bitutė;Žvirbliukų;3723040682;Taip;0;4;0;4
770;Bitutė;Žvirbliukų;2190439190;Taip;8;0;0;8
771;Bitutė;Žvirbliukų;7113693496;Taip;0;17;0;17
772;Bitutė;Žvirbliukų;2483462846;Taip;0;5;0;5
773;Bitutė;Žvirbliukų;8186706520;Taip;0;22;0;22
774;Bitutė;Žvirbliukų;6044969600;Taip;5;6;0;11
775;Bitutė;Žvirbliukų;2444289145;Taip;0;4;0;4
776;Bitutė;Žvirbliukų;3517750478;Taip;0;1;0;1
777;Bitutė;Žvirbliukų;5291764696;Taip;0;16;0;16
778;Bitutė;Žvirbliukų;1942685472;Taip;0;1;0;1
779;Bitutė;Žvirbliukų;4303490614;Taip;5;1;0;6
780;Bitutė;Žvirbliukų;9523588597;Taip;12;0;0;12
781;Bitutė;Žvirbliukų;3654065124;Taip;0;3;0;3
782;Bitutė;Žvirbliukų;9166624750;Taip;21;1;0;22
783;Bitutė;Gandriukų;20823074269;Taip;0;3;0;3
784;Bitutė;Gandriukų;20308800957;Taip;0;6;0;6
785;Bitutė;Gandriukų;55394933894;Taip;0;11;0;11
786;Bitutė;Gandriukų;83034164893;Taip;0;10;0;10
787;Bitutė;Gandriukų;28698703670;Taip;0;2;0;2
788;Bitutė;Gandriukų;51014007755;Taip;0;7;0;7
789;Bitutė;Gandriukų;85845989245;Taip;0;2;0;2
790;Bitutė;Gandriukų;55763538285;Taip;0;20;0;20
791;Bitutė;Gandriukų;55722176820;Taip;0;17;0;17
792;Bitutė;Gandriukų;41836931870;Taip;0;6;0;6
793;Bitutė;Gandriukų;1926912966;Taip;0;20;0;20
794;Bitutė;Gandriukų;16096919364;Ne;0;2;0;2
795;Bitutė;Gandriukų;2007360730;Taip;0;14;0;14
796;Bitutė;Gandriukų;2004589442;Taip;0;15;0;15
797;Bitutė;Gandriukų;1514919519;Ne;0;6;0;6
798;Bitutė;Gandriukų;1756799209;Ne;0;2;0;2
799;Bitutė;Gandriukų;7858925572;Taip;0;12;0;12
800;Bitutė;Gandriukų;1946893053;Taip;0;4;0;4
801;Bitutė;Gandriukų;2311037144;Taip;0;1;0;1
802;Bitutė;Gandriukų;41659768159;Taip;0;10;0;10
803;Bitutė;Pelėdžiukai;2045667491;Taip;0;15;0;15
804;Bitutė;Pelėdžiukai;76504719475;Taip;0;18;0;18
805;Bitutė;Pelėdžiukai;29837823635;Taip;0;3;0;3
806;Bitutė;Pelėdžiukai;96246198900;Taip;0;2;0;2
807;Bitutė;Pelėdžiukai;40578882341;Taip;0;3;0;3
808;Bitutė;Pelėdžiukai;73214901448;Taip;0;7;0;7
809;Bitutė;Pelėdžiukai;239058855;Ne;0;19;0;19
810;Bitutė;Pelėdžiukai;94263857872;Taip;4;1;0;5
811;Bitutė;Pelėdžiukai;4311138099;Ne;0;14;0;14
812;Bitutė;Pelėdžiukai;27177678441;Taip;0;1;0;1
813;Bitutė;Pelėdžiukai;87682328632;Taip;0;22;0;22
814;Bitutė;Pelėdžiukai;2004079473;Taip;0;15;0;15
815;Bitutė;Pelėdžiukai;5513662035;Taip;0;6;0;6
816;Bitutė;Pelėdžiukai;1799005979;Taip;0;12;0;12
817;Bitutė;Pelėdžiukai;1342209916;Taip;0;10;0;10
818;Bitutė;Pelėdžiukai;1235354320;Taip;0;5;0;5
819;Bitutė;Pelėdžiukai;1086803168;Taip;0;21;0;21
820;Bitutė;Pelėdžiukai;54838528906;Taip;0;11;0;11
821;Bitutė;Pelėdžiukai;5365203210;Taip;0;6;0;6
822;Bitutė;Boružėlių;6586888742;Taip;0;5;0;5
823;Bitutė;Boružėlių;5783154071;Taip;0;12;0;12
824;Bitutė;Boružėlių;6052204491;Taip;7;0;0;7
825;Bitutė;Boružėlių;37105491775;Ne;0;7;0;7
826;Bitutė;Boružėlių;50869152455;Taip;0;2;0;2
827;Bitutė;Boružėlių;9683582019;Taip;3;3;0;6
828;Bitutė;Boružėlių;7352524951;Taip;0;2;0;2
829;Bitutė;Boružėlių;27144303911;Taip;0;6;0;6
830;Bitutė;Boružėlių;1802887869;Ne;1;10;0;11
831;Bitutė;Boružėlių;51054491845;Taip;0;22;0;22
832;Bitutė;Boružėlių;5653055907;Taip;10;1;0;11
833;Bitutė;Boružėlių;1809034174;Taip;8;7;0;15
834;Bitutė;Boružėlių;5644789669;Taip;0;14;0;14
835;Bitutė;Boružėlių;2350260809;Taip;0;18;0;18
836;Bitutė;Boružėlių;1307749129;Taip;15;1;0;16
837;Bitutė;Boružėlių;3980455738;Taip;0;12;0;12
838;Bitutė;Boružėlių;6678928989;Taip;7;3;0;10
839;Bitutė;Boružėlių;6572832247;Taip;0;10;0;10
840;Bitutė;Boružėlių;8519978626;Taip;0;7;0;7
841;Bitutė;Šokliukų;8754340459;Taip;0;10;0;10
842;Bitutė;Šokliukų;91649072251;Taip;0;3;0;3
843;Bitutė;Šokliukų;22504941477;Taip;0;7;0;7
844;Bitutė;Šokliukų;4054959628;Taip;0;4;0;4
845;Bitutė;Šokliukų;74038944722;Taip;9;0;0;9
846;Bitutė;Šokliukų;9314363274;Taip;0;22;0;22
847;Bitutė;Šokliukų;1703630417;Taip;0;2;0;2
848;Bitutė;Šokliukų;80788107109;Taip;0;3;0;3
849;Bitutė;Šokliukų;14787330368;Taip;0;2;0;2
850;Bitutė;Šokliukų;6591291681;Taip;5;7;0;12
851;Bitutė;Šokliukų;86636444738;Taip;0;5;0;5
852;Bitutė;Šokliukų;1956718350;Ne;0;3;0;3
853;Bitutė;Šokliukų;11128936533;Taip;0;3;0;3
854;Bitutė;Šokliukų;2775304620;Taip;0;17;0;17
855;Bitutė;Šokliukų;26573486858;Taip;0;12;0;12
856;Bitutė;Šokliukų;2104500642;Taip;0;3;0;3
857;Bitutė;Šokliukų;1385876629;Taip;0;3;0;3
858;Bitutė;Šokliukų;84694903978;Taip;0;2;0;2
859;Bitutė;Šokliukų;71957147569;Taip;0;3;0;3
860;Bitutė;Šokliukų;98029500731;Taip;0;5;0;5
861;Bitutė;Drugelių;2531472741;Taip;0;3;0;3
862;Bitutė;Drugelių;74525712637;Taip;0;16;0;16
863;Bitutė;Drugelių;56620848568;Taip;0;22;0;22
864;Bitutė;Drugelių;2049938111;Taip;0;1;0;1
865;Bitutė;Drugelių;58668298206;Taip;0;18;0;18
866;Bitutė;Drugelių;1863634233;Taip;0;3;0;3
867;Bitutė;Drugelių;9550491607;Taip;0;15;0;15
868;Bitutė;Drugelių;3982159333;Taip;0;22;0;22
869;Bitutė;Drugelių;27461264704;Taip;0;5;0;5
870;Bitutė;Drugelių;29300327608;Taip;0;8;0;8
871;Bitutė;Drugelių;50605497381;Taip;0;12;0;12
872;Bitutė;Drugelių;1030677273;Taip;0;14;0;14
873;Bitutė;Drugelių;3319657847;Taip;0;8;0;8
874;Bitutė;Drugelių;1861373542;Taip;0;4;0;4
875;Bitutė;Drugelių;48695762145;Taip;0;8;0;8
876;Bitutė;Drugelių;72872147664;Taip;0;5;0;5
877;Bitutė;Kiškučių;2812580726;Taip;5;3;0;8
878;Bitutė;Kiškučių;1907876695;Taip;0;4;0;4
879;Bitutė;Kiškučių;7720798466;Taip;0;4;0;4
880;Bitutė;Kiškučių;1662815358;Taip;0;3;0;3
881;Bitutė;Kiškučių;1733189730;Taip;8;3;0;11
882;Bitutė;Kiškučių;9966437881;Taip;0;16;0;16
883;Bitutė;Kiškučių;8373296210;Taip;0;1;0;1
884;Bitutė;Kiškučių;1985958540;Taip;0;6;0;6
885;Bitutė;Kiškučių;8743960488;Taip;0;4;0;4
886;Bitutė;Kiškučių;9337144831;Taip;0;6;0;6
887;Bitutė;Kiškučių;4639968278;Taip;0;1;0;1
888;Bitutė;Kiškučių;1024337077;Taip;0;1;0;1
889;Bitutė;Kiškučių;4566919587;Taip;9;1;0;10
890;Bitutė;Kiškučių;6569166515;Taip;0;7;0;7
891;Bitutė;Kiškučių;2806899030;Taip;3;0;0;3
892;Bitutė;Kiškučių;5443722813;Taip;0;9;0;9
893;Bitutė;Kiškučių;8789574593;Taip;0;9;0;9
894;Bitutė;"Viščiukų ";1348548294;Taip;0;6;0;6
895;Bitutė;"Viščiukų ";5169768042;Taip;0;8;0;8
896;Bitutė;"Viščiukų ";7165511381;Taip;0;1;0;1
897;Bitutė;"Viščiukų ";4527880105;Taip;0;5;0;5
898;Bitutė;"Viščiukų ";1012702386;Taip;4;0;0;4
899;Bitutė;"Viščiukų ";9834697190;Taip;0;5;0;5
900;Bitutė;"Viščiukų ";9465186207;Taip;0;11;0;11
901;Bitutė;"Viščiukų ";9924340801;Taip;0;11;0;11
902;Bitutė;"Viščiukų ";4917599786;Taip;1;0;0;1
903;Bitutė;"Viščiukų ";7979566741;Taip;1;0;0;1
904;Bitutė;"Viščiukų ";9855080887;Taip;0;6;0;6
905;Bitutė;"Viščiukų ";8211710975;Taip;0;6;0;6
906;Bitutė;"Viščiukų ";7318555933;Taip;0;8;0;8
907;Bitutė;"Viščiukų ";4513783927;Ne;1;0;0;1
908;Bitutė;"Skruzdėliukai ";37364063140;Ne;5;10;0;15
909;Bitutė;"Skruzdėliukai ";1590580158;Taip;0;3;0;3
910;Bitutė;"Skruzdėliukai ";5910842956;Taip;5;0;0;5
911;Bitutė;"Skruzdėliukai ";1913421864;Taip;5;6;0;11
912;Bitutė;"Skruzdėliukai ";38436660859;Taip;0;22;0;22
913;Bitutė;"Skruzdėliukai ";2126118124;Taip;10;1;0;11
914;Bitutė;"Skruzdėliukai ";87960363246;Taip;0;2;0;2
915;Bitutė;"Skruzdėliukai ";1064809221;Taip;0;21;0;21
916;Bitutė;"Skruzdėliukai ";1521753712;Taip;0;22;0;22
917;Bitutė;"Skruzdėliukai ";1307910515;Taip;0;13;0;13
918;Bitutė;"Skruzdėliukai ";5886190377;Taip;3;0;0;3
919;Bitutė;"Skruzdėliukai ";61233878620;Taip;3;7;0;10
920;Bitutė;"Skruzdėliukai ";1130379531;Taip;0;10;0;10
921;Bitutė;"Skruzdėliukai ";2031043488;Ne;0;9;0;9
922;Bitutė;"Skruzdėliukai ";55469634385;Taip;0;4;0;4
923;Bitutė;"Skruzdėliukai ";1354608761;Taip;0;3;0;3
924;Bitutė;"Skruzdėliukai ";95252521365;Taip;0;22;0;22
925;Bitutė;"Skruzdėliukai ";26206836171;Ne;0;16;0;16
926;Bitutė;"Skruzdėliukai ";6969112590;Ne;0;1;0;1
927;Bitutė;"Nykštukų ";5188828679;Taip;5;8;0;13
928;Bitutė;"Nykštukų ";8109028957;Taip;3;8;0;11
929;Bitutė;"Nykštukų ";6169426273;Taip;0;5;0;5
930;Bitutė;"Nykštukų ";5942493696;Taip;0;1;0;1
931;Bitutė;"Nykštukų ";2252157473;Taip;8;7;0;15
932;Bitutė;"Nykštukų ";8439759353;Taip;0;10;0;10
933;Bitutė;"Nykštukų ";2853616585;Taip;8;5;0;13
934;Bitutė;"Nykštukų ";1423694056;Taip;0;8;0;8
935;Bitutė;"Nykštukų ";5686278261;Taip;10;1;0;11
936;Bitutė;"Nykštukų ";7145036085;Taip;10;2;0;12
937;Bitutė;"Nykštukų ";9602659259;Taip;0;9;0;9
938;Bitutė;"Nykštukų ";6311396261;Taip;8;3;0;11
939;Bitutė;"Nykštukų ";5378885117;Taip;0;3;0;3
940;Coliukė;DRUGELIAI;6011110970;Ne;0;3;0;3
941;Coliukė;DRUGELIAI;1968467455;Taip;6;1;0;7
942;Coliukė;DRUGELIAI;4645245689;Ne;15;0;0;15
943;Coliukė;DRUGELIAI;5450167562;Taip;3;0;0;3
944;Coliukė;DRUGELIAI;7248705010;Taip;10;0;8;18
945;Coliukė;DRUGELIAI;8835394030;Ne;4;5;0;9
946;Coliukė;DRUGELIAI;3427704550;Ne;0;2;0;2
947;Coliukė;DRUGELIAI;9885547263;Taip;2;0;0;2
948;Coliukė;DRUGELIAI;5139645108;Taip;0;11;0;11
949;Coliukė;DRUGELIAI;8209209881;Taip;6;0;1;7
950;Coliukė;DRUGELIAI;3499575148;Taip;5;0;1;6
951;Coliukė;DRUGELIAI;9462610674;Taip;9;2;0;11
952;Coliukė;DRUGELIAI;2167230398;Taip;5;1;0;6
953;Coliukė;DRUGELIAI;3323738649;Taip;0;3;0;3
954;Coliukė;DRUGELIAI;9331485675;Taip;10;11;0;21
955;Coliukė;DRUGELIAI;4845247006;Taip;0;1;0;1
956;Coliukė;DRUGELIAI;5349969025;Taip;5;0;4;9
957;Coliukė;BITUTĖS;93361426448;Taip;16;1;0;17
958;Coliukė;BITUTĖS;1199350941;Taip;5;11;0;16
959;Coliukė;BITUTĖS;1960898805;Taip;0;5;0;5
960;Coliukė;BITUTĖS;58421006265;Taip;0;7;0;7
961;Coliukė;BITUTĖS;9311775782;Taip;17;2;0;19
962;Coliukė;BITUTĖS;81003830638;Taip;6;5;0;11
963;Coliukė;BITUTĖS;36554487034;Taip;0;3;0;3
964;Coliukė;BITUTĖS;1423711475;Taip;3;1;0;4
965;Coliukė;BITUTĖS;7920728387;Taip;6;0;0;6
966;Coliukė;BITUTĖS;1240946719;Taip;0;7;0;7
967;Coliukė;BITUTĖS;4408284518;Taip;12;3;0;15
968;Coliukė;BITUTĖS;3346269598;Taip;6;1;0;7
969;Coliukė;BITUTĖS;6860757091;Taip;5;0;0;5
970;Coliukė;BITUTĖS;3919482569;Taip;6;0;0;6
971;Coliukė;BITUTĖS;8517128464;Taip;2;0;0;2
972;Coliukė;BITUTĖS;1328505569;Ne;4;1;0;5
973;Coliukė;VABALIUKAI;62876576078;Taip;0;3;0;3
974;Coliukė;VABALIUKAI;26698840369;Taip;0;10;0;10
975;Coliukė;VABALIUKAI;78760440826;Taip;0;9;0;9
976;Coliukė;VABALIUKAI;1556841186;Taip;8;0;0;8
977;Coliukė;VABALIUKAI;22951260339;Taip;0;3;0;3
978;Coliukė;VABALIUKAI;33587152454;Taip;0;7;0;7
979;Coliukė;VABALIUKAI;57504928606;Taip;0;6;0;6
980;Coliukė;VABALIUKAI;63258983714;Taip;0;4;0;4
981;Coliukė;VABALIUKAI;99200764707;Taip;0;9;0;9
982;Coliukė;VABALIUKAI;1476750428;Ne;3;4;0;7
983;Coliukė;VABALIUKAI;6775470024;Taip;3;0;0;3
984;Coliukė;VABALIUKAI;8323242104;Taip;0;7;0;7
985;Coliukė;VABALIUKAI;9526108197;Ne;12;0;0;12
986;Coliukė;VABALIUKAI;4739310916;Taip;0;3;0;3
987;Coliukė;VABALIUKAI;5541328815;Taip;0;0;1;1
988;Coliukė;VABALIUKAI;1318558913;Taip;10;10;0;20
989;Coliukė;VABALIUKAI;4010374947;Taip;15;0;0;15
990;Coliukė;VABALIUKAI;7622526793;Taip;5;8;0;13
991;Coliukė;NYKŠTUKAI;1659532709;Ne;0;0;2;2
992;Coliukė;NYKŠTUKAI;1812071213;Taip;0;5;0;5
993;Coliukė;NYKŠTUKAI;3738703854;Taip;18;2;0;20
994;Coliukė;NYKŠTUKAI;4747481676;Ne;0;2;0;2
995;Coliukė;NYKŠTUKAI;83027842354;Ne;5;6;0;11
996;Coliukė;NYKŠTUKAI;2684151591;Taip;0;9;0;9
997;Coliukė;NYKŠTUKAI;4499924331;Taip;5;0;0;5
998;Coliukė;NYKŠTUKAI;4806478786;Taip;2;0;1;3
999;Coliukė;NYKŠTUKAI;7566429633;Taip;0;6;0;6
1000;Coliukė;NYKŠTUKAI;9542366183;Taip;0;7;0;7
1001;Coliukė;NYKŠTUKAI;7670166244;Taip;0;4;0;4
1002;Coliukė;NYKŠTUKAI;1166820133;Ne;7;0;2;9
1003;Coliukė;NYKŠTUKAI;4845049639;Taip;8;0;4;12
1004;Coliukė;NYKŠTUKAI;1537341012;Taip;12;1;0;13
1005;Coliukė;NYKŠTUKAI;1105879142;Taip;0;3;0;3
1006;Coliukė;NYKŠTUKAI;4022408510;Taip;0;9;0;9
1007;Coliukė;NYKŠTUKAI;1600495468;Taip;0;11;0;11
1008;Coliukė;NYKŠTUKAI;6781303455;Taip;5;0;1;6
1009;Coliukė;GĖLYTĖS;3318808813;Taip;13;0;0;13
1010;Coliukė;GĖLYTĖS;4498253271;Taip;5;3;0;8
1011;Coliukė;GĖLYTĖS;1390751418;Taip;11;0;0;11
1012;Coliukė;GĖLYTĖS;9752408693;Taip;5;0;0;5
1013;Coliukė;GĖLYTĖS;7216221020;Taip;1;1;0;2
1014;Coliukė;"BORUŽĖLĖS (SPEC.)";1988394967;Taip;7;6;0;13
1015;Coliukė;"BORUŽĖLĖS (SPEC.)";8070499557;Taip;0;8;0;8
1016;Coliukė;"BORUŽĖLĖS (SPEC.)";2617816991;Taip;9;1;0;10
1017;Coliukė;"BORUŽĖLĖS (SPEC.)";9368334915;Taip;10;0;0;10
1018;Coliukė;"BORUŽĖLĖS (SPEC.)";2555073719;Ne;5;0;0;5
1019;Coliukė;"BORUŽĖLĖS (SPEC.)";6170362846;Taip;4;0;0;4
1020;Coliukė;"BORUŽĖLĖS (SPEC.)";5706671963;Taip;8;0;0;8
1021;Čiauškutis;BITUTĖS;3499391608;Taip;3;0;0;3
1022;Čiauškutis;BITUTĖS;1443155220;Taip;11;2;0;13
1023;Čiauškutis;BITUTĖS;1804509009;Taip;0;0;3;3
1024;Čiauškutis;BITUTĖS;22717947028;Taip;0;10;0;10
1025;Čiauškutis;BITUTĖS;3917667527;Taip;6;0;1;7
1026;Čiauškutis;BITUTĖS;5900996969;Taip;16;0;0;16
1027;Čiauškutis;BITUTĖS;7060197354;Taip;0;0;3;3
1028;Čiauškutis;BITUTĖS;30480486366;Taip;4;0;0;4
1029;Čiauškutis;BITUTĖS;1732370199;Ne;3;0;0;3
1030;Čiauškutis;BITUTĖS;3370047940;Taip;3;0;1;4
1031;Čiauškutis;ŽVIRBLIUKAI;2044220236;Taip;10;0;0;10
1032;Čiauškutis;ŽVIRBLIUKAI;4239145386;Taip;0;5;4;9
1033;Čiauškutis;ŽVIRBLIUKAI;3490305325;Taip;10;0;0;10
1034;Čiauškutis;ŽVIRBLIUKAI;2633243682;Taip;9;0;0;9
1035;Čiauškutis;ŽVIRBLIUKAI;7009893338;Taip;5;0;0;5
1036;Čiauškutis;ŽVIRBLIUKAI;2511568496;Taip;10;0;0;10
1037;Čiauškutis;ŽVIRBLIUKAI;8033122929;Ne;0;0;6;6
1038;Čiauškutis;ŽVIRBLIUKAI;5957587644;Taip;5;0;0;5
1039;Čiauškutis;ŽVIRBLIUKAI;1733251156;Ne;2;0;0;2
1040;Čiauškutis;SAULUTĖS;6279678482;Taip;0;1;0;1
1041;Čiauškutis;SAULUTĖS;93468721158;Taip;0;5;0;5
1042;Čiauškutis;SAULUTĖS;2012201854;Taip;0;2;0;2
1043;Čiauškutis;SAULUTĖS;27158851138;Taip;0;0;2;2
1044;Čiauškutis;SAULUTĖS;78373250443;Taip;10;2;0;12
1045;Čiauškutis;SAULUTĖS;7755428393;Taip;5;0;0;5
1046;Čiauškutis;SAULUTĖS;1417978731;Taip;0;3;0;3
1047;Čiauškutis;SAULUTĖS;1503190001;Taip;0;0;2;2
1048;Čiauškutis;SAULUTĖS;4817007142;Taip;0;14;0;14
1049;Čiauškutis;SAULUTĖS;1719875491;Taip;7;0;2;9
1050;Čiauškutis;EŽIUKAI;7746580858;Taip;4;0;0;4
1051;Čiauškutis;EŽIUKAI;2411714732;Taip;7;0;1;8
1052;Čiauškutis;EŽIUKAI;2686038029;Taip;0;0;5;5
1053;Čiauškutis;EŽIUKAI;1928404791;Taip;10;0;0;10
1054;Čiauškutis;EŽIUKAI;7489733038;Taip;6;0;1;7
1055;Čiauškutis;EŽIUKAI;5404165993;Taip;0;0;3;3
1056;Čiauškutis;EŽIUKAI;9959952114;Taip;3;0;0;3
1057;Čiauškutis;EŽIUKAI;1158816422;Ne;7;0;0;7
1058;Čiauškutis;EŽIUKAI;7239878097;Taip;0;0;2;2
1059;Čiauškutis;EŽIUKAI;5910818962;Ne;6;0;0;6
1060;Čiauškutis;DRUGELIAI;8500010303;Taip;10;6;0;16
1061;Čiauškutis;DRUGELIAI;7080320173;Taip;6;0;2;8
1062;Čiauškutis;DRUGELIAI;7440425102;Ne;3;0;2;5
1063;Čiauškutis;DRUGELIAI;7312776041;Ne;2;0;3;5
1064;Čiauškutis;DRUGELIAI;6170362846;Taip;0;0;2;2
1065;Čiauškutis;DRUGELIAI;1036358147;Ne;5;0;17;22
1066;Čiauškutis;DRUGELIAI;8346845876;Taip;15;0;0;15
1067;Čiauškutis;DRUGELIAI;1426744251;Taip;0;0;1;1
1068;Čiauškutis;GENELIAI;47866559654;Taip;0;2;0;2
1069;Čiauškutis;GENELIAI;1404146538;Taip;4;0;0;4
1070;Čiauškutis;GENELIAI;45303538716;Taip;2;3;0;5
1071;Čiauškutis;GENELIAI;7011763860;Taip;0;0;5;5
1072;Čiauškutis;GENELIAI;2273215873;Ne;6;0;1;7
1073;Čiauškutis;GENELIAI;7332285452;Taip;5;1;0;6
1074;Čiauškutis;GENELIAI;28814860843;Taip;1;0;1;2
1075;Čiauškutis;LINKSMUČIAI;4600623461;Taip;0;0;2;2
1076;Čiauškutis;LINKSMUČIAI;1332686904;Taip;0;1;2;3
1077;Čiauškutis;LINKSMUČIAI;55539901360;Taip;3;0;0;3
1078;Čiauškutis;LINKSMUČIAI;1380571576;Taip;0;6;4;10
1079;Čiauškutis;LINKSMUČIAI;1109018212;Taip;0;5;0;5
1080;Čiauškutis;LINKSMUČIAI;8884708945;Taip;5;0;7;12
1081;Čiauškutis;LINKSMUČIAI;2019831231;Taip;3;0;0;3
1082;Čiauškutis;LINKSMUČIAI;67405154291;Taip;0;0;4;4
1083;Čiauškutis;LINKSMUČIAI;1778900145;Taip;15;0;0;15
1084;Čiauškutis;KIŠKUČIAI;1474355889;Ne;5;1;0;6
1085;Čiauškutis;KIŠKUČIAI;72264057427;Taip;0;1;0;1
1086;Čiauškutis;KIŠKUČIAI;8808041204;Taip;10;0;0;10
1087;Čiauškutis;KIŠKUČIAI;2099735647;Taip;8;0;1;9
1088;Čiauškutis;KIŠKUČIAI;8992775168;Taip;0;3;4;7
1089;Čiauškutis;KIŠKUČIAI;1480363762;Taip;10;0;2;12
1090;Čiauškutis;KIŠKUČIAI;1849532875;Ne;0;0;1;1
1091;Čiauškutis;KIŠKUČIAI;2218793969;Ne;6;1;3;10
1092;Čiauškutis;KIŠKUČIAI;6115354862;Taip;0;0;3;3
1093;Čiauškutis;KIŠKUČIAI;5759367884;Taip;0;10;0;10
1094;Čiauškutis;KIŠKUČIAI;1456067541;Ne;5;0;3;8
1095;Čiauškutis;KIŠKUČIAI;7367933940;Ne;9;0;0;9
1096;Čiauškutis;LAPIUKAI;60265156684;Taip;0;4;0;4
1097;Čiauškutis;LAPIUKAI;8857039064;Taip;6;0;0;6
1098;Čiauškutis;LAPIUKAI;1657452686;Ne;5;0;0;5
1099;Čiauškutis;LAPIUKAI;43313173294;Taip;13;0;0;13
1100;Čiauškutis;LAPIUKAI;5513758257;Taip;0;0;1;1
1101;Čiauškutis;LAPIUKAI;1739403100;Taip;0;0;1;1
1102;Čiauškutis;MEŠKUČIAI;4341825486;Taip;0;0;1;1
1103;Čiauškutis;MEŠKUČIAI;8375416027;Taip;3;0;0;3
1104;Čiauškutis;MEŠKUČIAI;88294995405;Taip;0;0;3;3
1105;Čiauškutis;MEŠKUČIAI;1938531597;Ne;0;2;0;2
1106;Čiauškutis;MEŠKUČIAI;5739889733;Taip;0;0;1;1
1107;Čiauškutis;PELĖDŽIUKAI;7961309940;Taip;0;0;1;1
1108;Čiauškutis;PELĖDŽIUKAI;8728572783;Ne;0;1;0;1
1109;Čiauškutis;PELĖDŽIUKAI;1253449294;Taip;0;0;2;2
1110;Čiauškutis;PELĖDŽIUKAI;82575455120;Taip;2;0;1;3
1111;Čiauškutis;PELĖDŽIUKAI;4135020826;Taip;0;0;1;1
1112;Čiauškutis;PELĖDŽIUKAI;5897061482;Taip;0;5;1;6
1113;Čiauškutis;PELĖDŽIUKAI;1079827182;Taip;0;0;1;1
1114;Čiauškutis;NYKŠTUKAI;6258150407;Taip;0;0;6;6
1115;Čiauškutis;NYKŠTUKAI;4898534899;Ne;2;0;20;22
1116;Čiauškutis;NYKŠTUKAI;1413414774;Taip;3;0;0;3
1117;Čiauškutis;NYKŠTUKAI;4917339896;Taip;3;0;0;3
1118;Čiauškutis;NYKŠTUKAI;8896526358;Taip;2;0;0;2
1119;Čiauškutis;NYKŠTUKAI;8030685444;Ne;13;0;0;13
1120;Čiauškutis;NYKŠTUKAI;1809511815;Taip;3;0;4;7
1121;Čiauškutis;NYKŠTUKAI;1533938659;Ne;8;0;0;8
1122;Čiauškutis;NYKŠTUKAI;8709039752;Taip;0;0;9;9
1123;Delfinukas;Boružėlių;7904803011;Taip;1;0;3;4
1124;Delfinukas;Boružėlių;8186312409;Taip;3;1;2;6
1125;Delfinukas;Boružėlių;8148610460;Taip;4;4;0;8
1126;Delfinukas;Boružėlių;1873630966;Taip;0;1;0;1
1127;Delfinukas;Boružėlių;8076961367;Ne;0;2;1;3
1128;Delfinukas;Boružėlių;5783537897;Taip;3;6;0;9
1129;Delfinukas;Boružėlių;4989239822;Taip;5;0;5;10
1130;Delfinukas;Boružėlių;7638190553;Taip;0;0;7;7
1131;Delfinukas;Boružėlių;8728791932;Taip;0;0;1;1
1132;Delfinukas;Boružėlių;5794346039;Taip;0;0;1;1
1133;Delfinukas;Boružėlių;6700068320;Taip;5;4;0;9
1134;Delfinukas;Boružėlių;7277680544;Ne;4;0;2;6
1135;Delfinukas;Boružėlių;9099945815;Ne;2;1;2;5
1136;Delfinukas;Boružėlių;1212995285;Taip;0;1;0;1
1137;Delfinukas;Saulytės;65798709244;Ne;1;0;0;1
1138;Delfinukas;Saulytės;76643778833;Ne;0;9;0;9
1139;Delfinukas;Saulytės;35058841521;Taip;0;2;0;2
1140;Delfinukas;Saulytės;79934072325;Taip;8;1;0;9
1141;Delfinukas;Saulytės;2096874518;Taip;10;7;0;17
1142;Delfinukas;Saulytės;2009324145;Taip;5;1;0;6
1143;Delfinukas;Saulytės;27140729689;Taip;10;3;0;13
1144;Delfinukas;Saulytės;46847640903;Taip;7;0;6;13
1145;Delfinukas;Saulytės;4142864015;Ne;5;5;0;10
1146;Delfinukas;Saulytės;86601289023;Taip;0;2;2;4
1147;Delfinukas;Saulytės;16785309188;Taip;12;2;0;14
1148;Delfinukas;Saulytės;34563800372;Taip;10;2;10;22
1149;Delfinukas;Saulytės;2074439295;Taip;5;0;0;5
1150;Delfinukas;Saulytės;1939499375;Taip;0;6;0;6
1151;Delfinukas;Saulytės;1813240176;Taip;3;0;0;3
1152;Delfinukas;Saulytės;1293348150;Taip;0;2;1;3
1153;Delfinukas;Saulytės;1364873935;Taip;0;2;0;2
1154;Delfinukas;Saulytės;5912904296;Taip;12;2;0;14
1155;Delfinukas;Saulytės;1988406276;Taip;0;1;0;1
1156;Delfinukas;Pelėdžiukų;3940838205;Taip;0;5;2;7
1157;Delfinukas;Pelėdžiukų;8774145277;Taip;5;0;5;10
1158;Delfinukas;Pelėdžiukų;1395257200;Taip;9;0;0;9
1159;Delfinukas;Pelėdžiukų;7249857412;Taip;2;0;3;5
1160;Delfinukas;Pelėdžiukų;2658828200;Taip;8;0;1;9
1161;Delfinukas;Pelėdžiukų;3770227955;Taip;17;0;1;18
1162;Delfinukas;Pelėdžiukų;6113662246;Taip;2;0;0;2
1163;Delfinukas;Pelėdžiukų;1526129772;Taip;2;0;3;5
1164;Delfinukas;Pelėdžiukų;8659309242;Taip;5;0;0;5
1165;Delfinukas;Pelėdžiukų;1227257543;Taip;9;0;0;9
1166;Delfinukas;Pelėdžiukų;8882370994;Ne;12;0;2;14
1167;Delfinukas;Pelėdžiukų;8267992425;Taip;0;0;9;9
1168;Delfinukas;Pelėdžiukų;9319874239;Taip;2;0;0;2
1169;Delfinukas;Pelėdžiukų;2809947323;Taip;6;0;1;7
1170;Delfinukas;Varliukų;1153333591;Ne;0;4;0;4
1171;Delfinukas;Varliukų;1091165849;Taip;4;1;0;5
1172;Delfinukas;Varliukų;9573336239;Ne;5;0;0;5
1173;Delfinukas;Varliukų;1454101129;Taip;2;1;0;3
1174;Delfinukas;Varliukų;1251961268;Taip;0;2;0;2
1175;Delfinukas;Varliukų;1789047913;Taip;0;13;0;13
1176;Delfinukas;Varliukų;3678131609;Ne;0;2;0;2
1177;Delfinukas;Varliukų;1194444282;Taip;0;2;1;3
1178;Delfinukas;Varliukų;9347513042;Taip;0;2;0;2
1179;Delfinukas;Varliukų;8875479631;Taip;0;16;0;16
1180;Delfinukas;Varliukų;3344476309;Taip;7;1;0;8
1181;Delfinukas;Varliukų;3955783379;Taip;11;3;0;14
1182;Delfinukas;Varliukų;9502789660;Taip;0;1;1;2
1183;Delfinukas;Varliukų;3489297719;Taip;5;4;0;9
1184;Delfinukas;Varliukų;1948438336;Ne;6;4;0;10
1185;Delfinukas;Varliukų;9266646602;Taip;18;0;0;18
1186;Delfinukas;Varliukų;3674481373;Taip;0;8;0;8
1187;Delfinukas;Varliukų;9516852657;Taip;6;2;3;11
1188;Delfinukas;Varliukų;1338476746;Taip;0;5;0;5
1189;Delfinukas;Varliukų;2819283284;Taip;10;0;0;10
1190;Delfinukas;Varpelių;62769117892;Ne;0;9;0;9
1191;Delfinukas;Varpelių;8855690221;Taip;17;1;0;18
1192;Delfinukas;Varpelių;3093606855;Taip;0;2;4;6
1193;Delfinukas;Varpelių;6393090675;Taip;11;1;2;14
1194;Delfinukas;Varpelių;1268754720;Taip;0;6;0;6
1195;Delfinukas;Varpelių;1959331544;Taip;5;0;4;9
1196;Delfinukas;Varpelių;3718612458;Taip;5;1;0;6
1197;Delfinukas;Varpelių;2531571615;Taip;0;1;0;1
1198;Delfinukas;Varpelių;91028452879;Taip;0;1;0;1
1199;Delfinukas;Varpelių;1325054642;Ne;0;3;0;3
1200;Delfinukas;Varpelių;7163839896;Ne;0;3;0;3
1201;Delfinukas;Varpelių;7493037613;Ne;0;2;0;2
1202;Delfinukas;Varpelių;4239224971;Taip;0;0;1;1
1203;Delfinukas;Varpelių;1650166115;Ne;3;0;0;3
1204;Delfinukas;Varpelių;5123666058;Taip;0;18;0;18
1205;Delfinukas;Varpelių;4713803167;Taip;0;0;22;22
1206;Delfinukas;Varpelių;8936645508;Taip;0;3;0;3
1207;Delfinukas;Varpelių;26626004000;Taip;5;0;2;7
1208;Delfinukas;Varpelių;6047881184;Taip;0;0;2;2
1209;Delfinukas;Delfinukai;5093418481;Taip;0;0;2;2
1210;Delfinukas;Delfinukai;6190642132;Taip;0;7;0;7
1211;Delfinukas;Delfinukai;17266052771;Taip;4;0;0;4
1212;Delfinukas;Delfinukai;46276990963;Taip;0;2;0;2
1213;Delfinukas;Delfinukai;7528505426;Taip;1;0;0;1
1214;Delfinukas;Delfinukai;545765924;Taip;5;7;1;13
1215;Delfinukas;Delfinukai;4405301567;Taip;4;0;0;4
1216;Delfinukas;Delfinukai;2402524470;Taip;4;0;0;4
1217;Delfinukas;Delfinukai;2135364149;Taip;9;0;0;9
1218;Delfinukas;Delfinukai;94713648240;Taip;0;2;0;2
1219;Delfinukas;Delfinukai;34706967888;Taip;0;0;22;22
1220;Delfinukas;Delfinukai;4435982727;Taip;0;1;0;1
1221;Delfinukas;Delfinukai;85274001355;Taip;7;0;0;7
1222;Delfinukas;Delfinukai;9821969586;Taip;0;12;0;12
1223;Delfinukas;Delfinukai;4569691896;Taip;12;2;0;14
1224;Delfinukas;Drugeliai;2402204674;Taip;5;0;16;21
1225;Delfinukas;Drugeliai;6561536457;Taip;0;0;3;3
1226;Delfinukas;Drugeliai;4179507316;Taip;0;1;3;4
1227;Delfinukas;Drugeliai;2701448160;Ne;0;0;19;19
1228;Delfinukas;Drugeliai;8440546956;Taip;0;1;2;3
1229;Delfinukas;Drugeliai;6201567680;Taip;0;0;22;22
1230;Delfinukas;Drugeliai;1672021829;Ne;6;1;3;10
1231;Delfinukas;Drugeliai;2429427703;Ne;0;0;22;22
1232;Delfinukas;Drugeliai;9921730735;Taip;0;0;20;20
1233;Delfinukas;Drugeliai;7826428639;Ne;0;1;0;1
1234;Delfinukas;Drugeliai;1000049779;Taip;10;1;4;15
1235;Delfinukas;Drugeliai;3071312399;Ne;0;0;22;22
1236;Delfinukas;Drugeliai;7290732562;Taip;0;0;22;22
1237;Delfinukas;Drugeliai;8038163444;Taip;0;0;1;1
1238;Delfinukas;Drugeliai;7886801955;Taip;0;0;22;22
1239;Delfinukas;Drugeliai;8227660508;Taip;0;1;0;1
1240;Delfinukas;Drugeliai;2883959240;Taip;0;0;22;22
1241;Delfinukas;Drugeliai;1160537966;Taip;10;0;12;22
1242;Delfinukas;Drugeliai;1430155044;Taip;7;1;1;9
1243;Delfinukas;Žuvytės;6578506861;Taip;10;1;0;11
1244;Delfinukas;Žuvytės;6578506861;Taip;10;1;0;11
1245;Delfinukas;Žuvytės;6572690788;Taip;0;5;0;5
1246;Delfinukas;Žuvytės;3397350274;Taip;5;0;0;5
1247;Delfinukas;Žuvytės;9520598359;Taip;9;7;0;16
1248;Delfinukas;Žuvytės;3804996594;Taip;6;0;0;6
1249;Delfinukas;Žuvytės;1136182876;Taip;4;2;0;6
1250;Delfinukas;Žuvytės;7873373923;Taip;0;0;2;2
1251;Delfinukas;Žuvytės;2066127119;Ne;5;2;0;7
1252;Delfinukas;Žuvytės;2869506388;Taip;11;0;2;13
1253;Delfinukas;Žuvytės;7487111570;Taip;6;5;0;11
1254;Delfinukas;Žuvytės;6844500395;Taip;7;1;0;8
1255;Delfinukas;Žuvytės;9074294473;Taip;0;0;7;7
1256;Delfinukas;Žuvytės;2445742257;Taip;0;0;22;22
1257;Delfinukas;Žuvytės;8938997208;Taip;16;0;0;16
1258;Delfinukas;Žuvytės;9934325492;Taip;0;0;3;3
1259;Delfinukas;Žuvytės;8160982025;Taip;15;0;0;15
1260;Delfinukas;Žuvytės;6949000708;Taip;0;0;1;1
1261;Delfinukas;Žuvytės;6322255194;Taip;0;4;0;4
1262;Delfinukas;Žuvytės;9898412288;Taip;15;0;1;16
1263;Delfinukas;Žuvytės;8702718951;Taip;7;2;1;10
1264;Delfinukas;Žuvytės;6445868759;Taip;3;1;0;4
1265;Delfinukas;Delfinai;9628317328;Taip;7;10;0;17
1266;Delfinukas;Delfinai;8038737019;Taip;0;2;0;2
1267;Delfinukas;Delfinai;5797308373;Taip;0;1;0;1
1268;Delfinukas;Delfinai;6337962165;Taip;0;1;1;2
1269;Delfinukas;Delfinai;5241426445;Taip;5;1;2;8
1270;Delfinukas;Delfinai;8099120371;Taip;0;0;2;2
1271;Delfinukas;Delfinai;7663934825;Taip;0;10;0;10
1272;Delfinukas;Delfinai;1200205376;Taip;8;1;0;9
1273;Delfinukas;Delfinai;7629622746;Ne;2;0;0;2
1274;Delfinukas;Delfinai;4347116918;Taip;6;0;2;8
1275;Delfinukas;Delfinai;2784942324;Ne;5;0;0;5
1276;Delfinukas;Delfinai;1922513830;Taip;10;2;0;12
1277;Delfinukas;Paukšteliai;7609115506;Taip;0;0;21;21
1278;Delfinukas;Paukšteliai;6873181103;Taip;10;0;5;15
1279;Delfinukas;Paukšteliai;2756574162;Taip;0;0;21;21
1280;Delfinukas;Paukšteliai;6992505341;Ne;0;0;21;21
1281;Delfinukas;Paukšteliai;9927854348;Taip;0;0;21;21
1282;Delfinukas;Paukšteliai;8028279246;Taip;0;0;9;9
1283;Delfinukas;Paukšteliai;6884260821;Taip;0;0;21;21
1284;Delfinukas;Paukšteliai;2985669766;Taip;0;0;22;22
1285;Delfinukas;Paukšteliai;8328481987;Taip;0;0;9;9
1286;Delfinukas;Kiškučiai;67554154339;Taip;0;0;1;1
1287;Delfinukas;Kiškučiai;7766292005;Taip;0;14;0;14
1288;Delfinukas;Kiškučiai;98742243823;Taip;12;0;6;18
1289;Delfinukas;Kiškučiai;7920401664;Taip;0;2;0;2
1290;Delfinukas;Kiškučiai;1767369189;Ne;5;5;0;10
1291;Delfinukas;Kiškučiai;1495145663;Taip;0;0;6;6
1292;Delfinukas;Kiškučiai;1301231548;Taip;3;0;1;4
1293;Delfinukas;Kiškučiai;1613911039;Taip;0;2;0;2
1294;Delfinukas;Kiškučiai;1477374660;Taip;10;0;1;11
1295;Delfinukas;Kiškučiai;2993704795;Taip;0;3;0;3
1296;Delfinukas;Kiškučiai;1487082744;Taip;0;2;1;3
1297;Delfinukas;Kiškučiai;99919425286;Taip;16;0;0;16
1298;Delfinukas;Kiškučiai;2063259303;Taip;0;7;0;7
1299;Delfinukas;Kiškučiai;1166370228;Taip;5;2;0;7
1300;Delfinukas;Kiškučiai;96861425670;Taip;0;10;0;10
1301;Delfinukas;Kiškučiai;60320557464;Ne;5;2;0;7
1302;Delfinukas;Kiškučiai;1594700604;Ne;4;7;0;11
1303;Delfinukas;Kiškučiai;7509276953;Ne;0;1;0;1
1304;Delfinukas;Kiškučiai;49489087212;Taip;3;0;0;3
1305;Delfinukas;Kiškučiai;83920976768;Taip;0;12;0;12
1306;Dobilėlis;"I grupė";8709039752;Taip;0;3;0;3
1307;Drevinukas;ZUIKUČIAI;1720464417;Taip;0;0;6;6
1308;Drevinukas;ZUIKUČIAI;6095020718;Ne;5;0;0;5
1309;Drevinukas;ZUIKUČIAI;3981507849;Taip;4;0;1;5
1310;Drevinukas;ZUIKUČIAI;5679723776;Taip;10;3;0;13
1311;Drevinukas;ZUIKUČIAI;2857797268;Taip;5;0;3;8
1312;Drevinukas;ZUIKUČIAI;7753238387;Taip;6;0;1;7
1313;Drevinukas;ZUIKUČIAI;3875062228;Taip;0;10;1;11
1314;Drevinukas;ZUIKUČIAI;8130416781;Taip;2;0;0;2
1315;Drevinukas;ZUIKUČIAI;8479979176;Taip;15;0;0;15
1316;Drevinukas;ZUIKUČIAI;2531207946;Taip;7;0;0;7
1317;Drevinukas;ZUIKUČIAI;3972897839;Taip;10;1;1;12
1318;Drevinukas;ZUIKUČIAI;1152161183;Taip;3;0;0;3
1319;Drevinukas;ZUIKUČIAI;6256572875;Taip;3;0;0;3
1320;Drevinukas;ZUIKUČIAI;8936058501;Taip;9;0;2;11
1321;Drevinukas;ZUIKUČIAI;9772484901;Taip;8;0;0;8
1322;Drevinukas;ZUIKUČIAI;7520907833;Taip;0;4;0;4
1323;Drevinukas;ZUIKUČIAI;8625382465;Ne;6;0;0;6
1324;Drevinukas;ZUIKUČIAI;1099462840;Taip;10;0;0;10
1325;Drevinukas;ZUIKUČIAI;8611131264;Taip;9;5;0;14
1326;Drevinukas;ZUIKUČIAI;7607135647;Taip;0;0;2;2
1327;Drevinukas;AŽUOLIUKŲ;1970787957;Taip;0;8;0;8
1328;Drevinukas;AŽUOLIUKŲ;39014589824;Taip;0;1;0;1
1329;Drevinukas;AŽUOLIUKŲ;3625661236;Taip;0;1;0;1
1330;Drevinukas;AŽUOLIUKŲ;46323011887;Taip;0;0;1;1
1331;Drevinukas;AŽUOLIUKŲ;8325320616;Taip;0;0;1;1
1332;Drevinukas;AŽUOLIUKŲ;1577311253;Taip;0;0;13;13
1333;Drevinukas;AŽUOLIUKŲ;6539595624;Taip;4;0;2;6
1334;Drevinukas;AŽUOLIUKŲ;7570410899;Ne;14;0;0;14
1335;Drevinukas;AŽUOLIUKŲ;1929303009;Ne;0;0;8;8
1336;Drevinukas;AŽUOLIUKŲ;64093448834;Ne;0;0;2;2
1337;Drevinukas;AŽUOLIUKŲ;1585468549;Taip;0;2;0;2
1338;Drevinukas;AŽUOLIUKŲ;1276720097;Taip;0;2;6;8
1339;Drevinukas;AŽUOLIUKŲ;3604979285;Taip;4;0;1;5
1340;Drevinukas;AŽUOLIUKŲ;78348414683;Taip;5;3;0;8
1341;Drevinukas;AŽUOLIUKŲ;30667895560;Ne;0;0;1;1
1342;Drevinukas;AŽUOLIUKŲ;83194462453;Taip;0;5;0;5
1343;Drevinukas;PELĖDŽIUKAI;13638194271;Taip;0;0;1;1
1344;Drevinukas;PELĖDŽIUKAI;64560340218;Taip;9;3;0;12
1345;Drevinukas;PELĖDŽIUKAI;17456144256;Taip;5;0;1;6
1346;Drevinukas;PELĖDŽIUKAI;3066586415;Taip;0;0;3;3
1347;Drevinukas;PELĖDŽIUKAI;1250033881;Taip;0;0;1;1
1348;Drevinukas;PELĖDŽIUKAI;22050717457;Taip;0;0;1;1
1349;Drevinukas;PELĖDŽIUKAI;73923305630;Ne;5;1;4;10
1350;Drevinukas;PELĖDŽIUKAI;29000633056;Taip;0;0;1;1
1351;Drevinukas;PELĖDŽIUKAI;1254845545;Taip;0;0;1;1
1352;Drevinukas;PELĖDŽIUKAI;46006802320;Taip;0;1;0;1
1353;Drevinukas;PELĖDŽIUKAI;49704496121;Taip;0;0;3;3
1354;Drevinukas;PELĖDŽIUKAI;9657606451;Taip;0;0;5;5
1355;Drevinukas;PELĖDŽIUKAI;4150306697;Taip;0;22;0;22
1356;Drevinukas;PELĖDŽIUKAI;37485364300;Taip;0;0;1;1
1357;Drevinukas;PELĖDŽIUKAI;71447591085;Taip;21;1;0;22
1358;Drevinukas;PELĖDŽIUKAI;2483043689;Taip;0;0;3;3
1359;Drevinukas;BORUŽĖLĖS;1123115847;Taip;7;0;0;7
1360;Drevinukas;BORUŽĖLĖS;1987939679;Taip;0;0;2;2
1361;Drevinukas;BORUŽĖLĖS;9336227821;Taip;3;0;1;4
1362;Drevinukas;BORUŽĖLĖS;2070374746;Taip;0;0;1;1
1363;Drevinukas;BORUŽĖLĖS;9803670483;Taip;0;3;0;3
1364;Drevinukas;BORUŽĖLĖS;2074070030;Ne;0;0;1;1
1365;Drevinukas;BORUŽĖLĖS;16952164778;Taip;3;0;1;4
1366;Drevinukas;BORUŽĖLĖS;3657451903;Taip;4;0;1;5
1367;Drevinukas;BORUŽĖLĖS;8180027849;Taip;0;0;2;2
1368;Drevinukas;BORUŽĖLĖS;4332606643;Ne;0;5;3;8
1369;Drevinukas;BORUŽĖLĖS;7632515230;Taip;0;0;1;1
1370;Drevinukas;BORUŽĖLĖS;6304169257;Taip;0;1;1;2
1371;Drevinukas;BORUŽĖLĖS;56028675283;Taip;0;0;1;1
1372;Drevinukas;BORUŽĖLĖS;85288014888;Taip;0;0;1;1
1373;Drevinukas;BORUŽĖLĖS;6425268903;Taip;0;8;4;12
1374;Drevinukas;BORUŽĖLĖS;1019214451;Taip;7;0;0;7
1375;Drevinukas;BITUTĖS;96688324084;Taip;0;2;0;2
1376;Drevinukas;BITUTĖS;70347618653;Taip;0;0;19;19
1377;Drevinukas;BITUTĖS;7088781332;Taip;0;10;1;11
1378;Drevinukas;BITUTĖS;67343152327;Ne;3;2;0;5
1379;Drevinukas;BITUTĖS;73165075762;Taip;0;0;1;1
1380;Drevinukas;BITUTĖS;43087053446;Ne;4;0;2;6
1381;Drevinukas;BITUTĖS;1180916359;Taip;7;0;0;7
1382;Drevinukas;BITUTĖS;63665560323;Taip;0;0;1;1
1383;Drevinukas;BITUTĖS;8943620706;Taip;6;0;2;8
1384;Drevinukas;BITUTĖS;4352184625;Taip;0;0;4;4
1385;Drevinukas;BITUTĖS;1025218361;Taip;2;0;3;5
1386;Drevinukas;BITUTĖS;1711831210;Taip;2;0;3;5
1387;Drevinukas;NYKŠTUKAI;7334626684;Taip;6;0;0;6
1388;Drevinukas;NYKŠTUKAI;2423143170;Taip;16;0;1;17
1389;Drevinukas;NYKŠTUKAI;8313674636;Taip;0;0;10;10
1390;Drevinukas;NYKŠTUKAI;5236292764;Taip;5;0;0;5
1391;Drevinukas;NYKŠTUKAI;1098647410;Taip;0;0;12;12
1392;Drevinukas;NYKŠTUKAI;2935175014;Taip;6;1;1;8
1393;Drevinukas;NYKŠTUKAI;5348609358;Taip;5;0;3;8
1394;Drevinukas;NYKŠTUKAI;2312241894;Taip;20;1;0;21
1395;Drevinukas;NYKŠTUKAI;5394143000;Taip;0;6;3;9
1396;Drevinukas;NYKŠTUKAI;4260123123;Taip;3;10;2;15
1397;Drevinukas;NYKŠTUKAI;5754055310;Taip;0;0;8;8
1398;Drevinukas;NYKŠTUKAI;3871506691;Taip;0;2;1;3
1399;Drevinukas;NYKŠTUKAI;6914111231;Taip;0;2;1;3
1400;Drevinukas;NYKŠTUKAI;3046196006;Taip;0;2;0;2
1401;Drevinukas;NYKŠTUKAI;3377957769;Taip;0;0;3;3
1402;Drevinukas;NYKŠTUKAI;3779983775;Taip;12;0;0;12
1403;Drevinukas;NYKŠTUKAI;1343431478;Taip;3;0;3;6
1404;Drevinukas;NYKŠTUKAI;1829421385;Taip;3;0;0;3
1405;Drevinukas;NYKŠTUKAI;4134729710;Taip;0;0;5;5
1406;Drevinukas;NYKŠTUKAI;8262224710;Taip;10;0;0;10
1407;Drevinukas;SMALSUČIAI;1644656704;Taip;11;0;0;11
1408;Drevinukas;SMALSUČIAI;1058927778;Taip;8;0;3;11
1409;Drevinukas;SMALSUČIAI;5673244101;Taip;12;0;1;13
1410;Drevinukas;SMALSUČIAI;1564065835;Taip;14;0;1;15
1411;Drevinukas;SMALSUČIAI;8143614891;Ne;11;0;0;11
1412;Drevinukas;SMALSUČIAI;4262951360;Taip;3;0;3;6
1413;Drevinukas;SMALSUČIAI;3617533357;Taip;3;0;0;3
1414;Drevinukas;SMALSUČIAI;6904083734;Taip;6;0;0;6
1415;Drevinukas;SMALSUČIAI;3725760478;Taip;0;0;1;1
1416;Drevinukas;SMALSUČIAI;8239000041;Ne;0;0;2;2
1417;Drevinukas;ŽVIRBLIUKAI;3032536983;Taip;8;2;0;10
1418;Drevinukas;ŽVIRBLIUKAI;8556218971;Taip;0;5;2;7
1419;Drevinukas;ŽVIRBLIUKAI;5524567803;Taip;0;0;1;1
1420;Drevinukas;ŽVIRBLIUKAI;9016985238;Taip;0;0;2;2
1421;Drevinukas;ŽVIRBLIUKAI;2929598743;Taip;10;1;0;11
1422;Drevinukas;ŽVIRBLIUKAI;6373230526;Taip;5;0;8;13
1423;Drevinukas;ŽVIRBLIUKAI;4404254932;Taip;6;0;5;11
1424;Drevinukas;ŽVIRBLIUKAI;2378493422;Taip;0;0;1;1
1425;Drevinukas;ŽVIRBLIUKAI;8984653958;Taip;0;3;0;3
1426;Drevinukas;ŽVIRBLIUKAI;5620887702;Ne;3;2;0;5
1427;Drevinukas;ŽVIRBLIUKAI;2281463885;Ne;3;0;2;5
1428;Drevinukas;ŽVIRBLIUKAI;7218201733;Taip;7;0;3;10
1429;Drevinukas;ŽVIRBLIUKAI;4076576850;Taip;10;0;2;12
1430;Drevinukas;ŽVIRBLIUKAI;4471405682;Taip;0;1;0;1
1431;Drevinukas;ŽVIRBLIUKAI;1859208322;Taip;7;0;0;7
1432;Drevinukas;ŽVIRBLIUKAI;4312429104;Taip;0;7;1;8
1433;Drugelis;NYKŠTUKŲ;6452921695;Taip;0;0;2;2
1434;Drugelis;NYKŠTUKŲ;4927896706;Ne;0;1;0;1
1435;Drugelis;NYKŠTUKŲ;3551095669;Taip;0;3;0;3
1436;Drugelis;NYKŠTUKŲ;1785724340;Taip;5;3;0;8
1437;Drugelis;NYKŠTUKŲ;6632884258;Taip;4;0;8;12
1438;Drugelis;NYKŠTUKŲ;9612696781;Taip;11;0;11;22
1439;Drugelis;NYKŠTUKŲ;4523513611;Taip;0;2;0;2
1440;Drugelis;NYKŠTUKŲ;5692743298;Taip;3;12;0;15
1441;Drugelis;NYKŠTUKŲ;6594452094;Ne;5;4;1;10
1442;Drugelis;NYKŠTUKŲ;5122256823;Taip;0;2;0;2
1443;Drugelis;NYKŠTUKŲ;4825232236;Ne;0;1;8;9
1444;Drugelis;NYKŠTUKŲ;8752459733;Taip;5;1;0;6
1445;Drugelis;NYKŠTUKŲ;8717445483;Taip;5;2;1;8
1446;Drugelis;NYKŠTUKŲ;4158475365;Ne;5;2;0;7
1447;Drugelis;NYKŠTUKŲ;7609530453;Taip;0;6;0;6
1448;Drugelis;NYKŠTUKŲ;4867387611;Taip;0;9;2;11
1449;Drugelis;SMALSUČIŲ;3096906506;Taip;0;2;0;2
1450;Drugelis;SMALSUČIŲ;1576853049;Taip;6;0;1;7
1451;Drugelis;SMALSUČIŲ;1856912386;Ne;7;10;0;17
1452;Drugelis;SMALSUČIŲ;1255315664;Ne;2;0;0;2
1453;Drugelis;SMALSUČIŲ;7406396614;Ne;0;2;0;2
1454;Drugelis;SMALSUČIŲ;1217635751;Taip;18;0;0;18
1455;Drugelis;SMALSUČIŲ;68223183150;Ne;0;2;1;3
1456;Drugelis;SMALSUČIŲ;3479833265;Taip;10;0;0;10
1457;Drugelis;SMALSUČIŲ;3202149560;Taip;9;2;0;11
1458;Drugelis;SMALSUČIŲ;27569805506;Taip;0;7;0;7
1459;Drugelis;SMALSUČIŲ;1901608445;Taip;5;2;1;8
1460;Drugelis;SMALSUČIŲ;1160161173;Taip;0;1;0;1
1461;Drugelis;SMALSUČIŲ;1843605624;Taip;0;1;0;1
1462;Drugelis;SMALSUČIŲ;1506988472;Taip;0;1;0;1
1463;Drugelis;SMALSUČIŲ;1991420008;Taip;0;1;0;1
1464;Drugelis;SMALSUČIŲ;1421438458;Ne;0;6;0;6
1465;Drugelis;SMALSUČIŲ;53874036107;Taip;0;1;0;1
1466;Drugelis;SMALSUČIŲ;1961898730;Taip;0;2;0;2
1467;Drugelis;SMALSUČIŲ;4788423265;Taip;0;0;3;3
1468;Drugelis;SMALSUČIŲ;1541276266;Taip;0;2;0;2
1469;Drugelis;SMALSUČIŲ;5954059321;Ne;11;2;5;18
1470;Drugelis;SMALSUČIŲ;1888002607;Taip;0;1;0;1
1471;Drugelis;MUMINUKŲ;51963723965;Taip;1;2;0;3
1472;Drugelis;MUMINUKŲ;10841811704;Taip;0;3;0;3
1473;Drugelis;MUMINUKŲ;55662263930;Taip;0;3;0;3
1474;Drugelis;MUMINUKŲ;78391738678;Taip;5;1;0;6
1475;Drugelis;MUMINUKŲ;44627668646;Ne;0;3;0;3
1476;Drugelis;MUMINUKŲ;35386244403;Taip;0;6;0;6
1477;Drugelis;MUMINUKŲ;16512391370;Taip;0;5;0;5
1478;Drugelis;MUMINUKŲ;88073976875;Ne;0;4;0;4
1479;Drugelis;MUMINUKŲ;13989264253;Taip;0;14;0;14
1480;Drugelis;MUMINUKŲ;55339135155;Ne;0;4;0;4
1481;Drugelis;MUMINUKŲ;63173368598;Taip;0;2;0;2
1482;Drugelis;MUMINUKŲ;70288969200;Taip;0;4;0;4
1483;Drugelis;MUMINUKŲ;72147158912;Taip;0;1;0;1
1484;Drugelis;MUMINUKŲ;1240607928;Taip;0;8;0;8
1485;Drugelis;MUMINUKŲ;59819126556;Taip;10;0;0;10
1486;Drugelis;PŪKUOTUKAI;49035429728;Taip;0;1;0;1
1487;Drugelis;PŪKUOTUKAI;3156382280;Taip;0;2;0;2
1488;Drugelis;PŪKUOTUKAI;4989130624;Taip;0;0;20;20
1489;Drugelis;PŪKUOTUKAI;26436464504;Taip;0;4;0;4
1490;Drugelis;PŪKUOTUKAI;1657445173;Taip;0;1;3;4
1491;Drugelis;PŪKUOTUKAI;91538620813;Taip;0;3;0;3
1492;Drugelis;PŪKUOTUKAI;68716515660;Taip;0;1;0;1
1493;Drugelis;PŪKUOTUKAI;1162058481;Taip;0;1;0;1
1494;Drugelis;PŪKUOTUKAI;3161396176;Taip;2;0;0;2
1495;Drugelis;PŪKUOTUKAI;5649225445;Taip;3;0;0;3
1496;Drugelis;PŪKUOTUKAI;1060282804;Taip;2;1;0;3
1497;Drugelis;PŪKUOTUKAI;1667056936;Taip;0;1;5;6
1498;Drugelis;PŪKUOTUKAI;1005872691;Taip;0;4;0;4
1499;Drugelis;PŪKUOTUKAI;49678120281;Taip;5;0;0;5
1500;Drugelis;PŪKUOTUKAI;3403116175;Taip;8;0;2;10
1501;Drugelis;PŪKUOTUKAI;9654611393;Taip;5;1;0;6
1502;Drugelis;PŪKUOTUKAI;1651512363;Taip;7;0;1;8
1503;Drugelis;PŪKUOTUKAI;1546655542;Taip;10;0;4;14
1504;Drugelis;SPINDULIUKAI;1858504360;Taip;8;0;0;8
1505;Drugelis;SPINDULIUKAI;8107970910;Taip;15;0;0;15
1506;Drugelis;SPINDULIUKAI;1666992752;Taip;7;0;1;8
1507;Drugelis;SPINDULIUKAI;9907121223;Taip;4;0;0;4
1508;Drugelis;SPINDULIUKAI;8500348389;Taip;7;0;0;7
1509;Drugelis;SPINDULIUKAI;1142209285;Taip;3;2;0;5
1510;Drugelis;SPINDULIUKAI;9510744779;Taip;5;2;0;7
1511;Drugelis;SPINDULIUKAI;9836193857;Taip;4;2;0;6
1512;Drugelis;SPINDULIUKAI;5515894973;Taip;2;2;0;4
1513;Drugelis;SPINDULIUKAI;8282807535;Taip;4;7;0;11
1514;Drugelis;KIŠKUČIAI;7590759136;Taip;0;0;11;11
1515;Drugelis;KIŠKUČIAI;6321332888;Taip;14;1;0;15
1516;Drugelis;KIŠKUČIAI;5902687211;Taip;3;0;0;3
1517;Drugelis;KIŠKUČIAI;7253876812;Taip;11;0;0;11
1518;Drugelis;KIŠKUČIAI;7390061272;Taip;2;0;0;2
1519;Drugelis;KIŠKUČIAI;2146963673;Taip;10;0;0;10
1520;Drugelis;KIŠKUČIAI;2256221485;Taip;0;2;1;3
1521;Drugelis;KIŠKUČIAI;3085309902;Taip;10;0;0;10
1522;Drugelis;KIŠKUČIAI;3037496936;Taip;0;0;15;15
1523;Drugelis;KIŠKUČIAI;9345527734;Taip;3;0;0;3
1524;Drugelis;KIŠKUČIAI;6038184222;Taip;0;1;0;1
1525;Drugelis;KIŠKUČIAI;1816845006;Taip;13;0;0;13
1526;Drugelis;KIŠKUČIAI;8591548746;Taip;0;5;0;5
1527;"Du gaideliai";Uodelių;3507387826;Taip;10;2;0;12
1528;"Du gaideliai";Uodelių;4144269068;Taip;0;5;0;5
1529;"Du gaideliai";Uodelių;5894974508;Taip;0;4;0;4
1530;"Du gaideliai";Uodelių;1135098595;Taip;0;7;5;12
1531;"Du gaideliai";Uodelių;3370029981;Ne;0;1;0;1
1532;"Du gaideliai";Uodelių;5652662610;Taip;0;1;0;1
1533;"Du gaideliai";Uodelių;5103483956;Taip;0;1;0;1
1534;"Du gaideliai";Uodelių;4378924981;Taip;0;1;0;1
1535;"Du gaideliai";Uodelių;3854355215;Taip;0;0;12;12
1536;"Du gaideliai";Uodelių;3849899284;Taip;5;1;0;6
1537;"Du gaideliai";Uodelių;7373413569;Taip;0;4;0;4
1538;"Du gaideliai";Uodelių;6783206132;Taip;5;0;0;5
1539;"Du gaideliai";Uodelių;2262425557;Taip;10;0;0;10
1540;"Du gaideliai";Uodelių;6417648753;Taip;8;0;0;8
1541;"Du gaideliai";Uodelių;2240947701;Taip;11;0;2;13
1542;"Du gaideliai";Uodelių;6247706405;Taip;0;0;3;3
1543;"Du gaideliai";Uodelių;1268479215;Taip;6;0;0;6
1544;"Du gaideliai";OŽIUKŲ;2159833613;Taip;0;16;0;16
1545;"Du gaideliai";OŽIUKŲ;1549762923;Ne;1;0;0;1
1546;"Du gaideliai";OŽIUKŲ;5430986033;Taip;2;3;0;5
1547;"Du gaideliai";OŽIUKŲ;2601122166;Taip;15;0;0;15
1548;"Du gaideliai";OŽIUKŲ;6750787450;Taip;0;4;0;4
1549;"Du gaideliai";OŽIUKŲ;4387568448;Taip;3;0;6;9
1550;"Du gaideliai";OŽIUKŲ;1500684755;Taip;0;1;0;1
1551;"Du gaideliai";OŽIUKŲ;7084763712;Taip;0;0;1;1
1552;"Du gaideliai";OŽIUKŲ;6715434585;Taip;0;8;0;8
1553;"Du gaideliai";OŽIUKŲ;9324740716;Ne;8;0;0;8
1554;"Du gaideliai";OŽIUKŲ;1230622413;Taip;0;3;0;3
1555;"Du gaideliai";OŽIUKŲ;94639433266;Taip;0;2;0;2
1556;"Du gaideliai";OŽIUKŲ;7783203480;Taip;0;5;0;5
1557;"Du gaideliai";OŽIUKŲ;1758546983;Taip;0;12;0;12
1558;"Du gaideliai";OŽIUKŲ;6203383711;Taip;0;0;8;8
1559;"Du gaideliai";OŽIUKŲ;1876870081;Ne;10;0;0;10
1560;"Du gaideliai";OŽIUKŲ;1962859229;Taip;0;2;0;2
1561;"Du gaideliai";OŽIUKŲ;1557413692;Taip;7;1;0;8
1562;"Du gaideliai";OŽIUKŲ;3560637865;Taip;6;8;0;14
1563;"Du gaideliai";Vištyčių;1791530261;Taip;0;1;2;3
1564;"Du gaideliai";Vištyčių;50087080642;Taip;7;1;0;8
1565;"Du gaideliai";Vištyčių;25738622801;Taip;10;0;0;10
1566;"Du gaideliai";Vištyčių;1628346439;Taip;0;6;0;6
1567;"Du gaideliai";Vištyčių;14681393632;Taip;0;4;0;4
1568;"Du gaideliai";Vištyčių;1128234653;Taip;0;2;0;2
1569;"Du gaideliai";Vištyčių;60934378499;Taip;0;1;0;1
1570;"Du gaideliai";Vištyčių;91470338843;Taip;3;0;1;4
1571;"Du gaideliai";Vištyčių;6161829923;Taip;5;11;0;16
1572;"Du gaideliai";Vištyčių;30562958921;Ne;0;5;2;7
1573;"Du gaideliai";Vištyčių;85962801220;Taip;0;1;0;1
1574;"Du gaideliai";Vištyčių;1261678548;Taip;0;5;0;5
1575;"Du gaideliai";Vištyčių;73447542654;Taip;0;1;0;1
1576;"Du gaideliai";Vištyčių;1304400387;Taip;0;2;1;3
1577;"Du gaideliai";Vištyčių;1291620608;Taip;2;0;0;2
1578;"Du gaideliai";Vištyčių;1923863232;Taip;0;1;1;2
1579;"Du gaideliai";Vištyčių;1906486044;Taip;6;2;0;8
1580;"Du gaideliai";Vištyčių;13384312035;Taip;10;0;2;12
1581;"Du gaideliai";GAIDŽIUKŲ;25898248315;Taip;0;2;0;2
1582;"Du gaideliai";GAIDŽIUKŲ;14599820571;Taip;5;0;1;6
1583;"Du gaideliai";GAIDŽIUKŲ;73654636959;Taip;0;1;1;2
1584;"Du gaideliai";GAIDŽIUKŲ;82205925738;Taip;0;1;0;1
1585;"Du gaideliai";GAIDŽIUKŲ;1258859998;Taip;0;2;0;2
1586;"Du gaideliai";GAIDŽIUKŲ;56826255179;Ne;6;0;0;6
1587;"Du gaideliai";GAIDŽIUKŲ;9173656753;Ne;3;6;0;9
1588;"Du gaideliai";GAIDŽIUKŲ;1888402861;Taip;0;4;0;4
1589;"Du gaideliai";GAIDŽIUKŲ;8087660692;Taip;10;5;0;15
1590;"Du gaideliai";GAIDŽIUKŲ;31139048776;Taip;0;1;0;1
1591;"Du gaideliai";GAIDŽIUKŲ;59558745879;Ne;5;0;0;5
1592;"Du gaideliai";GAIDŽIUKŲ;1277603882;Taip;3;6;0;9
1593;"Du gaideliai";GAIDŽIUKŲ;46193129936;Taip;0;6;0;6
1594;"Du gaideliai";GAIDŽIUKŲ;11621795110;Taip;10;0;0;10
1595;"Du gaideliai";GAIDŽIUKŲ;8634553012;Ne;5;0;0;5
1596;"Du gaideliai";GAIDŽIUKŲ;1469877068;Taip;0;0;2;2
1597;"Du gaideliai";Musyčių;3247101840;Taip;0;0;9;9
1598;"Du gaideliai";Musyčių;5998344519;Taip;15;0;0;15
1599;"Du gaideliai";Musyčių;4798503931;Taip;5;5;0;10
1600;"Du gaideliai";Musyčių;6870356241;Taip;7;0;0;7
1601;"Du gaideliai";Musyčių;6053941133;Taip;0;2;0;2
1602;"Du gaideliai";Musyčių;6522707709;Taip;0;0;4;4
1603;"Du gaideliai";Musyčių;6120647567;Taip;0;6;0;6
1604;"Du gaideliai";Musyčių;1156396094;Taip;5;0;0;5
1605;"Du gaideliai";Musyčių;6204233540;Taip;0;1;0;1
1606;"Du gaideliai";Musyčių;6015360076;Taip;0;6;0;6
1607;"Du gaideliai";Musyčių;8047413507;Taip;8;0;0;8
1608;"Du gaideliai";MALŪNO;1968978650;Taip;2;0;0;2
1609;"Du gaideliai";MALŪNO;6762171696;Taip;6;0;0;6
1610;"Du gaideliai";MALŪNO;2100449108;Taip;0;1;0;1
1611;"Du gaideliai";MALŪNO;2905083899;Taip;8;0;0;8
1612;"Du gaideliai";MALŪNO;3019797369;Taip;6;0;0;6
1613;"Du gaideliai";MALŪNO;7575534590;Taip;1;0;0;1
1614;"Du gaideliai";MALŪNO;7726490359;Taip;5;0;2;7
1615;Eglutė;PELĖDŽIUKAI;60257242941;Taip;0;5;0;5
1616;Eglutė;PELĖDŽIUKAI;2395506996;Ne;3;0;0;3
1617;Eglutė;PELĖDŽIUKAI;43151626858;Taip;0;1;0;1
1618;Eglutė;PELĖDŽIUKAI;75731523422;Taip;0;0;2;2
1619;Eglutė;PELĖDŽIUKAI;6323002362;Taip;0;0;1;1
1620;Eglutė;PELĖDŽIUKAI;64518610112;Taip;0;0;1;1
1621;Eglutė;PELĖDŽIUKAI;1954232966;Taip;15;0;0;15
1622;Eglutė;PELĖDŽIUKAI;18202528233;Taip;11;0;2;13
1623;Eglutė;PELĖDŽIUKAI;55334393780;Taip;0;5;0;5
1624;Eglutė;PELĖDŽIUKAI;40880035310;Taip;0;5;5;10
1625;Eglutė;PELĖDŽIUKAI;5214574745;Taip;0;0;1;1
1626;Eglutė;PELĖDŽIUKAI;82988135134;Taip;0;0;2;2
1627;Eglutė;PELĖDŽIUKAI;93427464717;Taip;5;0;1;6
1628;Eglutė;PELĖDŽIUKAI;96041043843;Taip;0;9;0;9
1629;Eglutė;PELĖDŽIUKAI;37576322876;Taip;0;0;4;4
1630;Eglutė;PELĖDŽIUKAI;46002742287;Ne;0;0;1;1
1631;Eglutė;PELĖDŽIUKAI;95597529215;Taip;0;0;2;2
1632;Eglutė;PELĖDŽIUKAI;3997033;Ne;0;0;3;3
1633;Eglutė;PELĖDŽIUKAI;75229333120;Ne;0;0;2;2
1634;Eglutė;PELĖDŽIUKAI;44421461989;Taip;0;0;1;1
1635;Eglutė;PELĖDŽIUKAI;49380660477;Ne;10;0;0;10
1636;Eglutė;KAŠTONAS;7823828202;Ne;0;0;6;6
1637;Eglutė;KAŠTONAS;8523618773;Taip;0;0;2;2
1638;Eglutė;KAŠTONAS;1712276393;Ne;0;15;0;15
1639;Eglutė;KAŠTONAS;6891834971;Ne;0;9;0;9
1640;Eglutė;KAŠTONAS;8162972897;Taip;20;0;0;20
1641;Eglutė;KAŠTONAS;8364693548;Taip;0;2;0;2
1642;Eglutė;KAŠTONAS;3775081619;Taip;0;2;0;2
1643;Eglutė;KAŠTONAS;1265463853;Ne;0;1;9;10
1644;Eglutė;KAŠTONAS;3856651647;Taip;0;0;1;1
1645;Eglutė;KAŠTONAS;7307564177;Taip;0;9;3;12
1646;Eglutė;KAŠTONAS;8421062747;Taip;11;4;0;15
1647;Eglutė;KAŠTONAS;1908835124;Taip;0;0;3;3
1648;Eglutė;KAŠTONAS;1321901982;Taip;0;13;0;13
1649;Eglutė;KAŠTONAS;7354260503;Taip;0;2;0;2
1650;Eglutė;KAŠTONAS;9527732584;Taip;0;1;0;1
1651;Eglutė;KAŠTONAS;5731355126;Taip;4;0;0;4
1652;Eglutė;KAŠTONAS;9439309687;Taip;0;0;2;2
1653;Eglutė;EŽIUKAI;6570561861;Taip;0;0;1;1
1654;Eglutė;EŽIUKAI;8213137021;Taip;0;0;1;1
1655;Eglutė;EŽIUKAI;5604605766;Taip;5;0;0;5
1656;Eglutė;EŽIUKAI;4846517870;Taip;0;0;3;3
1657;Eglutė;EŽIUKAI;51884188642;Taip;0;0;8;8
1658;Eglutė;EŽIUKAI;62257831469;Taip;0;1;1;2
1659;Eglutė;EŽIUKAI;15019818974;Taip;7;1;0;8
1660;Eglutė;EŽIUKAI;3725462135;Taip;0;2;0;2
1661;Eglutė;EŽIUKAI;92489023262;Taip;0;11;2;13
1662;Eglutė;EŽIUKAI;77296894224;Taip;0;0;3;3
1663;Eglutė;EŽIUKAI;6542189095;Taip;0;7;0;7
1664;Eglutė;EŽIUKAI;1905376778;Taip;0;0;1;1
1665;Eglutė;EŽIUKAI;60500002903;Taip;0;0;2;2
1666;Eglutė;EŽIUKAI;59228063911;Taip;0;0;2;2
1667;Eglutė;EŽIUKAI;12750056416;Taip;0;6;1;7
1668;Eglutė;EŽIUKAI;4570145972;Taip;0;0;4;4
1669;Eglutė;EŽIUKAI;89786711506;Taip;0;0;1;1
1670;Eglutė;GILĖ;7148210944;Ne;8;4;0;12
1671;Eglutė;GILĖ;3616979217;Taip;0;18;0;18
1672;Eglutė;GILĖ;2638807860;Taip;7;0;12;19
1673;Eglutė;GILĖ;3203786388;Taip;0;0;6;6
1674;Eglutė;GILĖ;1209962222;Taip;0;9;0;9
1675;Eglutė;GILĖ;1004866224;Ne;1;0;0;1
1676;Eglutė;GILĖ;3275796441;Taip;3;0;0;3
1677;Eglutė;GILĖ;3178489517;Taip;4;0;0;4
1678;Eglutė;GILĖ;6518497374;Ne;0;12;0;12
1679;Eglutė;GILĖ;8606991706;Taip;1;0;0;1
1680;Eglutė;GILĖ;1324622835;Taip;6;0;0;6
1681;Eglutė;GILĖ;2082716398;Taip;0;0;12;12
1682;Eglutė;GILĖ;1510706652;Taip;5;0;0;5
1683;Eglutė;GILĖ;1695732622;Taip;5;0;0;5
1684;Eglutė;GILĖ;3393414294;Taip;0;0;1;1
1685;Eglutė;GILĖ;9488150450;Taip;0;2;0;2
1686;Eglutė;GILĖ;9066178904;Taip;7;0;0;7
1687;Eglutė;BORUŽIUKAI;3398517047;Taip;5;1;0;6
1688;Eglutė;BORUŽIUKAI;8520403894;Taip;5;0;0;5
1689;Eglutė;BORUŽIUKAI;6328900251;Taip;0;4;0;4
1690;Eglutė;BORUŽIUKAI;1531942494;Taip;0;1;9;10
1691;Aušrinė;Varpeliai;2948716989;Taip;5;5;0;10
1692;Aušrinė;Varpeliai;6525761466;Taip;7;0;0;7
1693;Aušrinė;Varpeliai;8092890260;Taip;6;2;0;8
1694;Aušrinė;Varpeliai;3998988004;Taip;5;6;0;11
1695;Aušrinė;Varpeliai;5204445760;Ne;5;0;0;5
1696;Aušrinė;Varpeliai;9641020899;Taip;5;0;1;6
1697;Aušrinė;Varpeliai;5277217733;Ne;22;0;0;22
1698;Aušrinė;Varpeliai;1502013942;Taip;0;7;2;9
1699;Aušrinė;Varpeliai;2190583964;Taip;8;0;2;10
1700;Aušrinė;Varpeliai;3920229653;Taip;5;6;2;13
1701;Aušrinė;Varpeliai;5563356449;Taip;15;0;0;15
1702;Aušrinė;Varpeliai;9501262918;Taip;10;0;0;10
1703;Aušrinė;Varpeliai;8756465854;Taip;8;0;1;9
1704;Aušrinė;Varpeliai;2304972692;Taip;20;0;0;20
1705;Aušrinė;Varpeliai;6756184787;Ne;9;1;1;11
1706;Aušrinė;Varpeliai;4288487063;Taip;11;0;3;14
1707;Aušrinė;Varpeliai;5768470608;Taip;7;0;1;8
1708;Aušrinė;Varpeliai;4969561425;Taip;5;0;3;8
1709;Aušrinė;Bitutės;17061806895;Taip;2;0;1;3
1710;Aušrinė;Bitutės;7796318812;Taip;4;2;0;6
1711;Aušrinė;Bitutės;83017543760;Ne;5;0;0;5
1712;Aušrinė;Bitutės;6318538591;Taip;7;0;0;7
1713;Aušrinė;Bitutės;5090847702;Taip;5;0;0;5
1714;Aušrinė;Bitutės;7507448059;Taip;0;8;0;8
1715;Aušrinė;Bitutės;1291308838;Ne;0;6;0;6
1716;Aušrinė;Bitutės;63299644698;Taip;8;4;0;12
1717;Aušrinė;Bitutės;5206206080;Taip;0;4;0;4
1718;Aušrinė;Bitutės;2263818210;Taip;5;2;0;7
1719;Aušrinė;Bitutės;1061646244;Ne;9;0;0;9
1720;Aušrinė;Bitutės;5738278121;Taip;6;0;0;6
1721;Aušrinė;Bitutės;4965640386;Taip;3;0;0;3
1722;Aušrinė;Bitutės;4686825392;Taip;11;0;0;11
1723;Aušrinė;Bitutės;1724192337;Taip;5;0;0;5
1724;Aušrinė;Bitutės;6608657740;Ne;0;0;1;1
1725;Aušrinė;Drugeliai;1996032555;Taip;0;0;4;4
1726;Aušrinė;Drugeliai;1343667707;Taip;0;1;0;1
1727;Aušrinė;Drugeliai;96010737590;Ne;8;6;0;14
1728;Aušrinė;Drugeliai;1133359254;Taip;15;0;1;16
1729;Aušrinė;Drugeliai;1184543607;Taip;5;0;0;5
1730;Aušrinė;Drugeliai;48118825872;Taip;7;0;7;14
1731;Aušrinė;Drugeliai;1206863546;Taip;0;0;2;2
1732;Aušrinė;Drugeliai;2022412040;Taip;9;5;0;14
1733;Aušrinė;Drugeliai;6265909152;Taip;11;0;2;13
1734;Aušrinė;Drugeliai;1532235421;Taip;5;0;0;5
1735;Aušrinė;Drugeliai;2212814026;Ne;0;0;5;5
1736;Aušrinė;Drugeliai;1927141701;Taip;8;1;0;9
1737;Aušrinė;Drugeliai;3356127625;Taip;11;0;3;14
1738;Aušrinė;Drugeliai;1151612627;Taip;0;7;0;7
1739;Aušrinė;Drugeliai;1515536619;Taip;10;0;0;10
1740;Aušrinė;Boružėlės;8364033602;Taip;10;0;2;12
1741;Aušrinė;Boružėlės;1009453682;Taip;8;5;0;13
1742;Aušrinė;Boružėlės;3544848804;Ne;0;0;3;3
1743;Aušrinė;Boružėlės;8463758715;Taip;0;0;1;1
1744;Aušrinė;Boružėlės;4579700769;Taip;10;1;0;11
1745;Aušrinė;Boružėlės;7268811782;Taip;5;3;0;8
1746;Aušrinė;Boružėlės;1831094707;Taip;18;0;0;18
1747;Aušrinė;Boružėlės;3593323270;Taip;0;1;0;1
1748;Aušrinė;Boružėlės;3795927209;Taip;0;0;3;3
1749;Aušrinė;Boružėlės;5283207520;Taip;0;0;17;17
1750;Aušrinė;Boružėlės;1116822936;Ne;5;0;2;7
1751;Aušrinė;Boružėlės;6226967695;Taip;0;0;1;1
1752;Aušrinė;Boružėlės;9226214856;Ne;12;0;0;12
1753;Aušrinė;Boružėlės;4562536818;Taip;7;0;0;7
1754;Aušrinė;Boružėlės;71379978884;Ne;7;0;4;11
1755;Aušrinė;Boružėlės;7052024709;Taip;0;3;6;9
1756;Aušrinė;Zuikučiai;8608907350;Taip;16;0;2;18
1757;Aušrinė;Zuikučiai;3291922401;Taip;6;0;0;6
1758;Aušrinė;Zuikučiai;8815055819;Taip;10;0;2;12
1759;Aušrinė;Zuikučiai;2199422694;Taip;15;0;2;17
1760;Aušrinė;Zuikučiai;1306244736;Taip;5;0;2;7
1761;Aušrinė;Zuikučiai;8186421282;Taip;8;0;0;8
1762;Aušrinė;Zuikučiai;9471287834;Taip;10;0;4;14
1763;Aušrinė;Zuikučiai;7071444498;Taip;0;4;0;4
1764;Aušrinė;Zuikučiai;6428753580;Taip;9;0;0;9
1765;Aušrinė;Zuikučiai;1336503878;Ne;10;0;0;10
1766;Aušrinė;Zuikučiai;3581180895;Taip;0;0;1;1
1767;Aušrinė;Zuikučiai;5821077318;Taip;0;0;16;16
1768;Aušrinė;Zuikučiai;9117896572;Taip;9;1;1;11
1769;Aušrinė;Zuikučiai;9612956692;Taip;10;0;0;10
1770;Aušrinė;Meškiukai;3269357241;Taip;6;0;0;6
1771;Aušrinė;Meškiukai;2583331243;Taip;0;5;0;5
1772;Aušrinė;Meškiukai;2778931038;Taip;17;0;1;18
1773;Aušrinė;Meškiukai;8465864375;Taip;0;0;1;1
1774;Aušrinė;Meškiukai;7784329873;Taip;7;0;1;8
1775;Aušrinė;Meškiukai;5043122065;Taip;0;6;1;7
1776;Aušrinė;Meškiukai;5128863532;Ne;0;0;2;2
1777;Aušrinė;Meškiukai;7194803557;Ne;0;6;0;6
1778;Aušrinė;Meškiukai;1440531672;Taip;7;0;2;9
1779;Aušrinė;Meškiukai;9967737864;Taip;0;0;5;5
1780;Aušrinė;Meškiukai;4437786689;Taip;0;0;2;2
1781;Aušrinė;Meškiukai;9726826566;Taip;3;0;1;4
1782;"Geniukų kalvė";SAULUTĖS;9557055841;Taip;20;0;0;20
1783;"Geniukų kalvė";SAULUTĖS;3111400962;Taip;15;0;0;15
1784;"Geniukų kalvė";SAULUTĖS;8932671578;Taip;10;0;1;11
1785;"Geniukų kalvė";SAULUTĖS;1910363787;Taip;0;0;10;10
1786;"Geniukų kalvė";SAULUTĖS;9522911738;Taip;9;0;1;10
1787;"Geniukų kalvė";SAULUTĖS;4603185679;Taip;5;0;0;5
1788;"Geniukų kalvė";SAULUTĖS;5348211316;Taip;10;0;0;10
1789;"Geniukų kalvė";SAULUTĖS;6384832317;Taip;5;0;2;7
1790;"Geniukų kalvė";SAULUTĖS;4946218794;Taip;0;0;5;5
1791;"Geniukų kalvė";SAULUTĖS;2087798907;Taip;0;0;10;10
1792;"Geniukų kalvė";SAULUTĖS;7289942679;Taip;5;0;1;6
1793;"Geniukų kalvė";SAULUTĖS;4745451344;Taip;0;0;7;7
1794;"Geniukų kalvė";BITUTĖS;7745656622;Ne;12;10;0;22
1795;"Geniukų kalvė";BITUTĖS;6520429663;Taip;10;0;0;10
1796;"Geniukų kalvė";BITUTĖS;6466912385;Taip;0;0;6;6
1797;"Geniukų kalvė";BITUTĖS;2718961466;Taip;5;2;0;7
1798;"Geniukų kalvė";BITUTĖS;4967513360;Taip;0;2;2;4
1799;"Geniukų kalvė";BITUTĖS;2016254460;Taip;4;5;0;9
1800;"Geniukų kalvė";BITUTĖS;5776314197;Taip;1;0;0;1
1801;"Geniukų kalvė";BITUTĖS;1897809684;Taip;0;8;4;12
1802;"Geniukų kalvė";BITUTĖS;6511955882;Taip;2;0;0;2
1803;"Geniukų kalvė";BITUTĖS;6500641378;Taip;5;5;0;10
1804;"Geniukų kalvė";BITUTĖS;2143334688;Ne;4;0;0;4
1805;"Geniukų kalvė";BITUTĖS;6498149304;Taip;4;0;0;4
1806;"Geniukų kalvė";BITUTĖS;7081093742;Taip;4;0;0;4
1807;"Geniukų kalvė";BITUTĖS;3984265624;Taip;10;0;0;10
1808;"Geniukų kalvė";BITUTĖS;4813232640;Taip;5;0;0;5
1809;"Geniukų kalvė";BITUTĖS;9676782662;Taip;6;0;0;6
1810;"Geniukų kalvė";BITUTĖS;9666918437;Taip;5;0;0;5
1811;"Geniukų kalvė";BITUTĖS;2031800114;Ne;5;0;0;5
1812;"Geniukų kalvė";BITUTĖS;5542539934;Taip;5;0;1;6
1813;"Geniukų kalvė";KIŠKUČIAI;1568133009;Ne;1;7;0;8
1814;"Geniukų kalvė";KIŠKUČIAI;7664689396;Taip;11;0;0;11
1815;"Geniukų kalvė";KIŠKUČIAI;4844734556;Taip;0;0;2;2
1816;"Geniukų kalvė";KIŠKUČIAI;2729442911;Ne;0;0;4;4
1817;"Geniukų kalvė";KIŠKUČIAI;4661051023;Taip;0;0;7;7
1818;"Geniukų kalvė";KIŠKUČIAI;23023070502;Taip;5;0;0;5
1819;"Geniukų kalvė";KIŠKUČIAI;8668696743;Ne;0;2;4;6
1820;"Geniukų kalvė";KIŠKUČIAI;2262014110;Taip;7;0;0;7
1821;"Geniukų kalvė";KIŠKUČIAI;1947173142;Taip;0;0;1;1
1822;"Geniukų kalvė";KIŠKUČIAI;43097490633;Taip;4;5;0;9
1823;"Geniukų kalvė";KIŠKUČIAI;2043786151;Taip;2;4;0;6
1824;"Geniukų kalvė";KIŠKUČIAI;1460456166;Taip;0;8;0;8
1825;"Geniukų kalvė";KIŠKUČIAI;8939171238;Ne;2;0;1;3
1826;"Geniukų kalvė";KIŠKUČIAI;7839383630;Taip;6;0;0;6
1827;"Geniukų kalvė";KIŠKUČIAI;2140334255;Taip;0;1;2;3
1828;"Geniukų kalvė";KIŠKUČIAI;2301758912;Taip;8;0;3;11
1829;"Geniukų kalvė";KIŠKUČIAI;8635708009;Taip;17;0;0;17
1830;"Geniukų kalvė";KIŠKUČIAI;9081596975;Ne;14;0;2;16
1831;"Geniukų kalvė";KIŠKUČIAI;30932565379;Taip;7;2;1;10
1832;"Geniukų kalvė";KIŠKUČIAI;2337226175;Ne;3;0;0;3
1833;"Geniukų kalvė";VYTURĖLIAI;37670000746;Taip;0;1;1;2
1834;"Geniukų kalvė";VYTURĖLIAI;14839311346;Taip;10;1;0;11
1835;"Geniukų kalvė";VYTURĖLIAI;31140342871;Taip;0;2;0;2
1836;"Geniukų kalvė";VYTURĖLIAI;70097449722;Taip;6;1;0;7
1837;"Geniukų kalvė";VYTURĖLIAI;11476134327;Taip;7;0;0;7
1838;"Geniukų kalvė";VYTURĖLIAI;68752448767;Taip;0;1;0;1
1839;"Geniukų kalvė";VYTURĖLIAI;61225085978;Taip;0;1;0;1
1840;"Geniukų kalvė";VYTURĖLIAI;83623361401;Ne;3;2;0;5
1841;"Geniukų kalvė";VYTURĖLIAI;87751274075;Taip;1;3;0;4
1842;"Geniukų kalvė";VYTURĖLIAI;71884588832;Ne;2;0;2;4
1843;"Geniukų kalvė";VYTURĖLIAI;96267794763;Ne;0;3;0;3
1844;"Geniukų kalvė";VYTURĖLIAI;91734868433;Ne;3;0;0;3
1845;"Geniukų kalvė";VYTURĖLIAI;1933003833;Taip;0;12;0;12
1846;"Geniukų kalvė";VYTURĖLIAI;1829858221;Taip;6;0;0;6
1847;"Geniukų kalvė";VYTURĖLIAI;1624933726;Taip;4;0;0;4
1848;"Geniukų kalvė";VYTURĖLIAI;1239061261;Taip;0;1;0;1
1849;"Geniukų kalvė";DRUGELIAI;33438588586;Ne;4;0;3;7
1850;"Geniukų kalvė";DRUGELIAI;30865528880;Taip;0;5;0;5
1851;"Geniukų kalvė";DRUGELIAI;66632618838;Taip;0;1;0;1
1852;"Geniukų kalvė";DRUGELIAI;35180545728;Taip;0;1;5;6
1853;"Geniukų kalvė";DRUGELIAI;88543141650;Taip;0;4;0;4
1854;"Geniukų kalvė";DRUGELIAI;96954076142;Taip;0;1;0;1
1855;"Geniukų kalvė";DRUGELIAI;27479616927;Taip;15;0;2;17
1856;"Geniukų kalvė";DRUGELIAI;26912425905;Taip;0;0;4;4
1857;"Geniukų kalvė";DRUGELIAI;38949678625;Taip;3;2;0;5
1858;"Geniukų kalvė";DRUGELIAI;80957343774;Taip;2;5;1;8
1859;"Geniukų kalvė";DRUGELIAI;50218457812;Ne;0;1;2;3
1860;"Geniukų kalvė";DRUGELIAI;7837682774;Taip;0;2;0;2
1861;"Geniukų kalvė";DRUGELIAI;8916930503;Ne;5;0;0;5
1862;"Geniukų kalvė";DRUGELIAI;2038860438;Taip;5;5;1;11
1863;"Geniukų kalvė";DRUGELIAI;1923449545;Taip;0;2;0;2
1864;"Geniukų kalvė";DRUGELIAI;1246234700;Ne;0;1;0;1
1865;"Geniukų kalvė";"SAULĖS ZUIKUČIAI";49352255237;Taip;0;1;0;1
1866;"Geniukų kalvė";"SAULĖS ZUIKUČIAI";90227736128;Taip;0;10;0;10
1867;"Geniukų kalvė";"SAULĖS ZUIKUČIAI";54856843273;Taip;6;0;2;8
1868;"Geniukų kalvė";"SAULĖS ZUIKUČIAI";1806626063;Taip;0;7;0;7
1869;"Geniukų kalvė";"SAULĖS ZUIKUČIAI";1776042329;Taip;0;0;12;12
1870;"Geniukų kalvė";"SAULĖS ZUIKUČIAI";1716204178;Ne;0;20;0;20
1871;"Geniukų kalvė";"SAULĖS ZUIKUČIAI";1774738349;Taip;1;0;0;1
1872;"Geniukų kalvė";"SAULĖS ZUIKUČIAI";2120890722;Taip;0;8;0;8
1873;"Geniukų kalvė";"SAULĖS ZUIKUČIAI";87718471880;Taip;4;0;0;4
1874;"Geniukų kalvė";"SAULĖS ZUIKUČIAI";1415719190;Ne;0;0;3;3
1875;"Geniukų kalvė";"SAULĖS ZUIKUČIAI";83443339743;Taip;0;0;5;5
1876;"Geniukų kalvė";"SAULĖS ZUIKUČIAI";26215340428;Taip;0;2;0;2
1877;"Geniukų kalvė";"SAULĖS ZUIKUČIAI";1084055203;Taip;0;0;2;2
1878;"Geniukų kalvė";"SAULĖS ZUIKUČIAI";1810973279;Taip;0;1;0;1
1879;"Geniukų kalvė";"SAULĖS ZUIKUČIAI";2094764804;Taip;0;0;3;3
1880;"Geniukų kalvė";"SAULĖS ZUIKUČIAI";3553253934;Taip;6;0;2;8
1881;"Geniukų kalvė";"SAULĖS ZUIKUČIAI";9669281441;Ne;7;0;2;9
1882;"Geniukų kalvė";"SAULĖS ZUIKUČIAI";3599151643;Taip;8;0;1;9
1883;"Geniukų kalvė";"SAULĖS ZUIKUČIAI";1818485774;Taip;13;0;0;13
1884;"Geniukų kalvė";SMALSUČIAI;44345867922;Taip;9;1;0;10
1885;"Geniukų kalvė";SMALSUČIAI;6928979691;Ne;7;0;0;7
1886;"Geniukų kalvė";SMALSUČIAI;19181427380;Taip;0;11;0;11
1887;"Geniukų kalvė";SMALSUČIAI;1684481833;Taip;4;18;0;22
1888;"Geniukų kalvė";SMALSUČIAI;14939415217;Taip;0;0;3;3
1889;"Geniukų kalvė";SMALSUČIAI;1990303616;Taip;18;0;0;18
1890;"Geniukų kalvė";SMALSUČIAI;62774512989;Ne;22;0;0;22
1891;"Geniukų kalvė";SMALSUČIAI;45542289762;Taip;0;0;5;5
1892;"Geniukų kalvė";SMALSUČIAI;23964009189;Taip;0;3;0;3
1893;"Geniukų kalvė";SMALSUČIAI;42328019754;Taip;0;6;0;6
1894;"Geniukų kalvė";SMALSUČIAI;90435684305;Taip;0;1;1;2
1895;"Geniukų kalvė";SMALSUČIAI;84974376966;Taip;0;1;0;1
1896;"Geniukų kalvė";SMALSUČIAI;97616612192;Taip;0;2;0;2
1897;"Geniukų kalvė";SMALSUČIAI;93834840514;Taip;0;1;1;2
1898;"Geniukų kalvė";SMALSUČIAI;67762121244;Ne;0;1;2;3
1899;"Geniukų kalvė";SMALSUČIAI;1663744490;Taip;7;1;1;9
1900;"Geniukų kalvė";SMALSUČIAI;1248190435;Taip;0;1;0;1
1901;"Geniukų kalvė";SMALSUČIAI;5792552722;Taip;0;0;3;3
1902;"Geniukų kalvė";SMALSUČIAI;65418822653;Taip;7;3;0;10
1903;"Geniukų kalvė";RUDNOSIUKAI;2082749897;Taip;0;9;0;9
1904;"Geniukų kalvė";RUDNOSIUKAI;7352976665;Ne;0;0;3;3
1905;"Geniukų kalvė";RUDNOSIUKAI;6728268857;Taip;5;1;0;6
1906;"Geniukų kalvė";RUDNOSIUKAI;93360165202;Taip;2;0;0;2
1907;"Geniukų kalvė";RUDNOSIUKAI;36553641202;Taip;0;11;0;11
1908;"Geniukų kalvė";RUDNOSIUKAI;36295276899;Ne;0;3;0;3
1909;"Geniukų kalvė";RUDNOSIUKAI;56705168000;Taip;0;0;3;3
1910;"Geniukų kalvė";RUDNOSIUKAI;75926614045;Taip;0;1;0;1
1911;"Geniukų kalvė";RUDNOSIUKAI;96448080708;Taip;16;0;0;16
1912;"Geniukų kalvė";RUDNOSIUKAI;1794537433;Taip;0;2;0;2
1913;"Geniukų kalvė";RUDNOSIUKAI;29353737550;Taip;0;2;0;2
1914;"Geniukų kalvė";RUDNOSIUKAI;22074236863;Taip;3;7;0;10
1915;"Geniukų kalvė";PELĖDŽIUKAI;2217221922;Taip;3;5;0;8
1916;"Geniukų kalvė";PELĖDŽIUKAI;3826265557;Taip;7;0;3;10
1917;"Geniukų kalvė";PELĖDŽIUKAI;8271041553;Taip;0;1;4;5
1918;"Geniukų kalvė";PELĖDŽIUKAI;1237228692;Taip;2;0;1;3
1919;"Geniukų kalvė";PELĖDŽIUKAI;2938446054;Taip;10;0;0;10
1920;"Geniukų kalvė";PELĖDŽIUKAI;3055777730;Taip;0;0;1;1
1921;"Geniukų kalvė";PELĖDŽIUKAI;9976423099;Taip;15;5;0;20
1922;"Geniukų kalvė";PELĖDŽIUKAI;9990243525;Taip;7;0;1;8
1923;"Geniukų kalvė";PELĖDŽIUKAI;1051563985;Taip;0;8;0;8
1924;"Geniukų kalvė";PELĖDŽIUKAI;3762178533;Taip;10;0;3;13
1925;"Geniukų kalvė";PELĖDŽIUKAI;6174114461;Taip;5;0;2;7
1926;"Geniukų kalvė";PELĖDŽIUKAI;2659298240;Taip;0;3;0;3
1927;"Geniukų kalvė";PELĖDŽIUKAI;6024288147;Taip;0;11;0;11
1928;"Geniukų kalvė";PELĖDŽIUKAI;5704223824;Taip;3;0;0;3
1929;"Geniukų kalvė";PELĖDŽIUKAI;1811866428;Taip;10;0;0;10
1930;"Geniukų kalvė";PELĖDŽIUKAI;6410008429;Taip;10;0;0;10
1931;"Geniukų kalvė";PELĖDŽIUKAI;4843411757;Taip;1;0;0;1
1932;"Geniukų kalvė";PELĖDŽIUKAI;8770345339;Taip;5;0;0;5
1933;"Geniukų kalvė";BORUŽĖLĖS;9613720001;Taip;3;0;3;6
1934;"Geniukų kalvė";BORUŽĖLĖS;4958738745;Taip;0;1;4;5
1935;"Geniukų kalvė";BORUŽĖLĖS;4271763719;Taip;9;0;8;17
1936;"Geniukų kalvė";BORUŽĖLĖS;9069256760;Taip;5;0;4;9
1937;"Geniukų kalvė";BORUŽĖLĖS;5161535756;Taip;0;12;0;12
1938;"Geniukų kalvė";BORUŽĖLĖS;3493492581;Taip;0;6;0;6
1939;"Geniukų kalvė";BORUŽĖLĖS;3085228868;Taip;0;1;0;1
1940;"Geniukų kalvė";BORUŽĖLĖS;3180116136;Taip;10;6;0;16
1941;"Geniukų kalvė";BORUŽĖLĖS;6794151223;Taip;3;0;0;3
1942;"Geniukų kalvė";BORUŽĖLĖS;4777155321;Taip;2;1;0;3
1943;"Geniukų kalvė";BORUŽĖLĖS;2180860623;Ne;5;1;0;6
1944;"Geniukų kalvė";BORUŽĖLĖS;7471964981;Ne;10;0;0;10
1945;"Geniukų kalvė";BORUŽĖLĖS;2205515766;Taip;5;0;0;5
1946;"Geniukų kalvė";BORUŽĖLĖS;8769761434;Taip;3;3;0;6
1947;"Geniukų kalvė";BORUŽĖLĖS;1891205998;Ne;0;5;0;5
1948;"Geniukų kalvė";BORUŽĖLĖS;9643242164;Ne;0;2;2;4
1949;"Geniukų kalvė";BORUŽĖLĖS;2665955524;Taip;0;4;0;4
1950;"Geniukų kalvė";PAGRANDUKAI;9696452101;Taip;0;4;0;4
1951;"Geniukų kalvė";PAGRANDUKAI;2165793561;Taip;5;2;3;10
1952;"Geniukų kalvė";PAGRANDUKAI;1229056613;Taip;4;0;4;8
1953;"Geniukų kalvė";PAGRANDUKAI;7889781552;Taip;0;0;3;3
1954;"Geniukų kalvė";PAGRANDUKAI;2839299179;Taip;3;0;0;3
1955;"Geniukų kalvė";PAGRANDUKAI;6623491459;Taip;3;1;0;4
1956;"Geniukų kalvė";PAGRANDUKAI;3852896932;Taip;5;0;0;5
1957;"Geniukų kalvė";PAGRANDUKAI;5443596677;Taip;4;0;0;4
1958;"Geniukų kalvė";PAGRANDUKAI;5205178173;Taip;10;0;0;10
1959;"Geniukų kalvė";PAGRANDUKAI;7057284039;Taip;7;2;0;9
1960;"Geniukų kalvė";NYKŠTUKAI;5245434552;Taip;18;0;0;18
1961;"Geniukų kalvė";NYKŠTUKAI;4186376527;Taip;2;0;0;2
1962;"Geniukų kalvė";NYKŠTUKAI;1375674317;Taip;0;1;0;1
1963;"Geniukų kalvė";NYKŠTUKAI;7744441981;Taip;4;0;0;4
1964;"Geniukų kalvė";NYKŠTUKAI;1209268848;Taip;4;0;0;4
1965;"Geniukų kalvė";NYKŠTUKAI;5512172533;Taip;0;6;0;6
1966;"Geniukų kalvė";NYKŠTUKAI;1499735818;Taip;0;6;7;13
1967;"Geniukų kalvė";NYKŠTUKAI;8071493871;Taip;0;2;0;2
1968;"Geniukų kalvė";NYKŠTUKAI;2816691996;Taip;0;0;4;4
1969;"Geniukų kalvė";NYKŠTUKAI;5763009912;Taip;6;0;1;7
1970;Gelvonėlis;ĄŽUOLIUKAI;7919814808;Ne;12;1;0;13
1971;Gelvonėlis;ĄŽUOLIUKAI;9323579468;Taip;6;0;0;6
1972;Gelvonėlis;ĄŽUOLIUKAI;3830940009;Taip;0;1;0;1
1973;Gelvonėlis;ĄŽUOLIUKAI;3147489259;Taip;0;12;0;12
1974;Gelvonėlis;ĄŽUOLIUKAI;2140799517;Taip;17;0;0;17
1975;Gelvonėlis;ĄŽUOLIUKAI;1284359362;Taip;0;3;0;3
1976;Gelvonėlis;ĄŽUOLIUKAI;9798684265;Taip;7;10;0;17
1977;Gelvonėlis;ĄŽUOLIUKAI;8775661719;Taip;0;0;1;1
1978;Gelvonėlis;ĄŽUOLIUKAI;21684706944;Taip;0;1;0;1
1979;Gelvonėlis;ĄŽUOLIUKAI;75676389361;Taip;12;0;1;13
1980;Gelvonėlis;ĄŽUOLIUKAI;2077783219;Taip;0;0;4;4
1981;Gelvonėlis;ĄŽUOLIUKAI;3089755141;Taip;0;7;0;7
1982;Gelvonėlis;ĄŽUOLIUKAI;1408313697;Taip;3;0;2;5
1983;Gelvonėlis;ĄŽUOLIUKAI;3670612781;Taip;0;6;0;6
1984;Gelvonėlis;ĄŽUOLIUKAI;69073786634;Taip;0;7;0;7
1985;Gelvonėlis;ĄŽUOLIUKAI;29928181395;Taip;0;7;0;7
1986;Gelvonėlis;ĄŽUOLIUKAI;6255253658;Taip;12;0;1;13
1987;Gelvonėlis;ĄŽUOLIUKAI;5511174729;Taip;0;0;7;7
1988;Gelvonėlis;ĄŽUOLIUKAI;1624125024;Taip;0;0;15;15
1989;Gelvonėlis;ĄŽUOLIUKAI;9387523651;Taip;0;4;0;4
1990;Gelvonėlis;ŽVIRBLIUKAI;1772713183;Taip;6;0;2;8
1991;Gelvonėlis;ŽVIRBLIUKAI;1801724527;Ne;0;2;0;2
1992;Gelvonėlis;ŽVIRBLIUKAI;83360239551;Taip;0;0;5;5
1993;Gelvonėlis;ŽVIRBLIUKAI;21250325232;Taip;0;0;1;1
1994;Gelvonėlis;ŽVIRBLIUKAI;23181505838;Taip;0;4;0;4
1995;Gelvonėlis;ŽVIRBLIUKAI;2997738880;Taip;0;0;2;2
1996;Gelvonėlis;ŽVIRBLIUKAI;1373771258;Taip;0;2;2;4
1997;Gelvonėlis;ŽVIRBLIUKAI;92420286100;Taip;0;5;0;5
1998;Gelvonėlis;ŽVIRBLIUKAI;41610307448;Taip;0;0;1;1
1999;Gelvonėlis;ŽVIRBLIUKAI;87746258537;Taip;0;10;0;10
2000;Gelvonėlis;ŽVIRBLIUKAI;6635285387;Taip;0;0;1;1
2001;Gelvonėlis;ŽVIRBLIUKAI;1938913528;Taip;7;0;0;7
2002;Gelvonėlis;ŽVIRBLIUKAI;2096702999;Taip;0;4;0;4
2003;Gelvonėlis;ŽVIRBLIUKAI;17044138057;Taip;0;0;4;4
2004;Gelvonėlis;ŽVIRBLIUKAI;84863800926;Taip;0;2;0;2
2005;Gelvonėlis;ŽVIRBLIUKAI;1355742622;Taip;0;7;0;7
2006;Gelvonėlis;ŽVIRBLIUKAI;1827511187;Taip;0;0;3;3
2007;Gelvonėlis;ŽVIRBLIUKAI;9784762153;Taip;0;2;6;8
2008;Gelvonėlis;ŽVIRBLIUKAI;9919860358;Taip;0;2;0;2
2009;Gelvonėlis;ŽVIRBLIUKAI;86895427397;Ne;7;0;0;7
2010;Gelvonėlis;RASELĖS;3325116198;Taip;4;0;1;5
2011;Gelvonėlis;RASELĖS;9847156800;Ne;0;9;0;9
2012;Gelvonėlis;RASELĖS;2153676615;Ne;0;4;0;4
2013;Gelvonėlis;RASELĖS;47302438188;Taip;0;0;3;3
2014;Gelvonėlis;RASELĖS;11697172905;Taip;0;3;0;3
2015;Gelvonėlis;RASELĖS;1221420212;Taip;9;3;0;12
2016;Gelvonėlis;RASELĖS;43145774484;Ne;0;0;1;1
2017;Gelvonėlis;RASELĖS;18237108866;Taip;8;2;0;10
2018;Gelvonėlis;RASELĖS;3271118581;Taip;7;0;1;8
2019;Gelvonėlis;RASELĖS;79607769503;Ne;0;1;0;1
2020;Gelvonėlis;RASELĖS;96792124844;Ne;0;1;0;1
2021;Gelvonėlis;RASELĖS;69221565557;Taip;8;0;5;13
2022;Gelvonėlis;RASELĖS;79899652046;Taip;10;0;0;10
2023;Gelvonėlis;RASELĖS;9108760720;Taip;6;6;0;12
2024;Gelvonėlis;RASELĖS;1776015014;Taip;0;1;0;1
2025;Gelvonėlis;SAULUTĖ;11807134557;Taip;0;1;0;1
2026;Gelvonėlis;SAULUTĖ;72859950160;Taip;0;1;0;1
2027;Gelvonėlis;SAULUTĖ;80973545044;Ne;0;0;2;2
2028;Gelvonėlis;SAULUTĖ;3121251271;Taip;0;5;0;5
2029;Gelvonėlis;SAULUTĖ;1750552925;Taip;0;11;0;11
2030;Gelvonėlis;SAULUTĖ;5098282548;Taip;3;3;0;6
2031;Gelvonėlis;SAULUTĖ;59592904001;Taip;0;2;0;2
2032;Gelvonėlis;SAULUTĖ;19782508652;Ne;0;2;0;2
2033;Gelvonėlis;SAULUTĖ;3859776410;Taip;3;2;0;5
2034;Gelvonėlis;SAULUTĖ;6405741006;Taip;17;0;0;17
2035;Gelvonėlis;SAULUTĖ;9595350871;Taip;0;17;0;17
2036;Gelvonėlis;SAULUTĖ;71806077882;Taip;0;7;0;7
2037;Gelvonėlis;SAULUTĖ;8475204684;Taip;0;7;0;7
2038;Gelvonėlis;SAULUTĖ;4830374546;Taip;0;6;0;6
2039;Gelvonėlis;SAULUTĖ;5759356754;Taip;0;11;0;11
2040;Gelvonėlis;SAULUTĖ;1042715433;Ne;0;8;0;8
2041;Gelvonėlis;PELĖDŽIUKAI;87693970225;Taip;0;4;0;4
2042;Gelvonėlis;PELĖDŽIUKAI;17021411833;Taip;0;0;1;1
2043;Gelvonėlis;PELĖDŽIUKAI;48593832088;Taip;7;0;0;7
2044;Gelvonėlis;PELĖDŽIUKAI;22201650331;Taip;12;0;1;13
2045;Gelvonėlis;PELĖDŽIUKAI;98009116912;Taip;0;0;1;1
2046;Gelvonėlis;PELĖDŽIUKAI;51375531815;Taip;0;0;2;2
2047;Gelvonėlis;PELĖDŽIUKAI;70550528579;Taip;0;6;1;7
2048;Gelvonėlis;PELĖDŽIUKAI;91507293029;Taip;3;0;3;6
2049;Gelvonėlis;PELĖDŽIUKAI;79847096929;Taip;7;0;0;7
2050;Gelvonėlis;PELĖDŽIUKAI;71199691102;Taip;0;7;0;7
2051;Gelvonėlis;PELĖDŽIUKAI;2218767947;Taip;0;1;0;1
2052;Gelvonėlis;PELĖDŽIUKAI;7277516341;Taip;0;0;1;1
2053;Gelvonėlis;PELĖDŽIUKAI;5393404051;Taip;0;0;1;1
2054;Gelvonėlis;PELĖDŽIUKAI;40127507796;Taip;0;0;1;1
2055;Gelvonėlis;PELĖDŽIUKAI;36610437375;Taip;0;0;2;2
2056;Gelvonėlis;PELĖDŽIUKAI;9970883470;Taip;0;8;0;8
2057;Gelvonėlis;PELĖDŽIUKAI;1902998389;Taip;0;0;3;3
2058;Gelvonėlis;PELĖDŽIUKAI;2146163687;Taip;0;0;1;1
2059;Gelvonėlis;PELĖDŽIUKAI;71076083278;Taip;10;0;7;17
2060;Gelvonėlis;DRUGELIAI;8209225630;Taip;5;1;0;6
2061;Gelvonėlis;DRUGELIAI;7936622964;Taip;5;0;0;5
2062;Gelvonėlis;DRUGELIAI;6856800484;Taip;9;0;0;9
2063;Gelvonėlis;DRUGELIAI;6554989142;Taip;0;5;0;5
2064;Gelvonėlis;DRUGELIAI;8056058298;Taip;0;2;0;2
2065;Gelvonėlis;DRUGELIAI;3926733474;Taip;11;0;0;11
2066;Gelvonėlis;DRUGELIAI;2698853686;Taip;0;6;0;6
2067;Gelvonėlis;DRUGELIAI;6585504578;Taip;16;0;0;16
2068;Gelvonėlis;DRUGELIAI;5790038422;Taip;10;0;0;10
2069;Gelvonėlis;DRUGELIAI;1587584701;Taip;0;0;4;4
2070;Gelvonėlis;DRUGELIAI;9118102469;Taip;6;0;0;6
2071;Gelvonėlis;VARPELIAI;3059903126;Taip;0;0;3;3
2072;Gelvonėlis;VARPELIAI;9149117970;Taip;2;0;1;3
2073;Gelvonėlis;VARPELIAI;3483144401;Taip;12;0;2;14
2074;Gelvonėlis;VARPELIAI;6451557430;Taip;12;2;0;14
2075;Gelvonėlis;VARPELIAI;6225854165;Taip;14;0;1;15
2076;Gelvonėlis;VARPELIAI;2791652988;Taip;9;0;0;9
2077;Gelvonėlis;VARPELIAI;2638430817;Ne;9;0;3;12
2078;Gelvonėlis;VARPELIAI;9600526942;Taip;10;2;0;12
2079;Gelvonėlis;VARPELIAI;1387948936;Taip;0;5;0;5
2080;Gelvonėlis;VARPELIAI;9650922918;Taip;0;2;0;2
2081;Gelvonėlis;VARPELIAI;1462716950;Taip;9;4;0;13
2082;Gelvonėlis;VARPELIAI;6949090250;Taip;16;0;0;16
2083;Gelvonėlis;VARPELIAI;9622818893;Taip;7;0;0;7
2084;Gelvonėlis;VARPELIAI;3446593424;Taip;15;0;0;15
2085;Gelvonėlis;VARPELIAI;6478873536;Taip;13;0;0;13
2086;Gelvonėlis;VARPELIAI;6869418701;Taip;10;0;2;12
2087;Gelvonėlis;VARPELIAI;5207153784;Taip;0;9;0;9
2088;Gelvonėlis;VARPELIAI;3730493822;Taip;6;10;0;16
2089;Gelvonėlis;VARPELIAI;9304912028;Taip;0;0;2;2
2090;Gelvonėlis;BORUŽĖLĖS;1030246127;Taip;0;4;0;4
2091;Gelvonėlis;BORUŽĖLĖS;22575527531;Taip;0;2;0;2
2092;Gelvonėlis;BORUŽĖLĖS;1163833201;Taip;10;2;0;12
2093;Gelvonėlis;BORUŽĖLĖS;3379601736;Taip;0;17;0;17
2094;Gelvonėlis;BORUŽĖLĖS;1597669426;Taip;0;5;0;5
2095;Gelvonėlis;BORUŽĖLĖS;31744699590;Taip;14;0;2;16
2096;Gelvonėlis;BORUŽĖLĖS;4917453676;Ne;6;0;1;7
2097;Gelvonėlis;BORUŽĖLĖS;9777094764;Taip;15;0;1;16
2098;Gelvonėlis;BORUŽĖLĖS;3936144045;Ne;0;2;1;3
2099;Gelvonėlis;BORUŽĖLĖS;12715604772;Taip;5;4;0;9
2100;Gelvonėlis;BORUŽĖLĖS;8050788182;Taip;10;8;0;18
2101;Gelvonėlis;BORUŽĖLĖS;91441127098;Taip;5;0;0;5
2102;Gelvonėlis;BORUŽĖLĖS;30812081628;Taip;5;0;4;9
2103;Gelvonėlis;BORUŽĖLĖS;1183745610;Taip;0;10;0;10
2104;Gelvonėlis;BORUŽĖLĖS;3284385491;Taip;1;0;4;5
2105;Gelvonėlis;BORUŽĖLĖS;1610362831;Ne;0;0;1;1
2106;Gelvonėlis;BORUŽĖLĖS;1836155450;Taip;0;11;0;11
2107;Gelvonėlis;BORUŽĖLĖS;7903272826;Taip;9;0;0;9
2108;Gelvonėlis;NYKŠTUKAI;6604992169;Taip;0;4;0;4
2109;Gelvonėlis;NYKŠTUKAI;6556472766;Taip;11;2;0;13
2110;Gelvonėlis;NYKŠTUKAI;7182180008;Taip;0;3;0;3
2111;Gelvonėlis;NYKŠTUKAI;6598178467;Taip;0;2;2;4
2112;Gelvonėlis;NYKŠTUKAI;8885088900;Taip;0;4;0;4
2113;Gelvonėlis;NYKŠTUKAI;8622621570;Taip;22;0;0;22
2114;Gelvonėlis;NYKŠTUKAI;2400289466;Taip;0;5;0;5
2115;Gelvonėlis;NYKŠTUKAI;5129492284;Taip;0;1;2;3
2116;Gelvonėlis;NYKŠTUKAI;9493536517;Taip;0;0;5;5
2117;Gelvonėlis;NYKŠTUKAI;2515471132;Taip;6;0;4;10
2118;Gelvonėlis;NYKŠTUKAI;6505814802;Taip;10;1;1;12
2119;Gelvonėlis;NYKŠTUKAI;6319058542;Ne;5;0;2;7
2120;Gelvonėlis;NYKŠTUKAI;9538571448;Taip;5;2;0;7
2121;Gelvonėlis;NYKŠTUKAI;9147186080;Taip;0;1;0;1
2122;Gelvonėlis;NYKŠTUKAI;9059244134;Taip;0;1;0;1
2123;Gelvonėlis;NYKŠTUKAI;1987204544;Taip;13;4;0;17
2124;Gelvonėlis;NYKŠTUKAI;1085845218;Taip;10;0;1;11
2125;Gelvonėlis;NYKŠTUKAI;7195164378;Taip;13;0;0;13
2126;Gelvonėlis;BITUTĖS;7759317220;Ne;0;2;0;2
2127;Gelvonėlis;BITUTĖS;2504468098;Taip;0;2;0;2
2128;Gelvonėlis;BITUTĖS;7983982378;Taip;0;3;0;3
2129;Gelvonėlis;BITUTĖS;5721858659;Taip;0;3;0;3
2130;Gelvonėlis;BITUTĖS;9667024635;Taip;0;9;0;9
2131;Gelvonėlis;BITUTĖS;2108690954;Taip;6;0;0;6
2132;Gelvonėlis;BITUTĖS;4855800131;Taip;5;6;0;11
2133;Gelvonėlis;BITUTĖS;1753617545;Taip;8;1;0;9
2134;Gelvonėlis;BITUTĖS;3843881329;Taip;8;3;0;11
2135;Gelvonėlis;BITUTĖS;9184192787;Taip;0;7;0;7
2136;Gelvonėlis;BITUTĖS;9369121356;Taip;1;0;0;1
2137;Gelvonėlis;BITUTĖS;2119550116;Taip;15;0;1;16
2138;Gelvonėlis;BITUTĖS;7826522180;Taip;5;0;0;5
2139;Gelvonėlis;BITUTĖS;9286500887;Taip;0;0;2;2
2140;Gelvonėlis;BITUTĖS;5095782784;Taip;11;0;1;12
2141;Gelvonėlis;BITUTĖS;1516164123;Taip;0;7;0;7
2142;Gelvonėlis;BITUTĖS;7226051965;Taip;8;0;1;9
2143;Gelvonėlis;BITUTĖS;3788522708;Taip;0;14;0;14
2144;Gelvonėlis;BITUTĖS;5047022305;Ne;0;0;2;2
2145;Gelvonėlis;RAMUNĖLĖS;5759407291;Taip;5;0;0;5
2146;Gelvonėlis;RAMUNĖLĖS;8766702456;Taip;0;0;1;1
2147;Gelvonėlis;RAMUNĖLĖS;1266479895;Taip;0;4;0;4
2148;Gelvonėlis;RAMUNĖLĖS;1004686756;Taip;0;0;1;1
2149;Gelvonėlis;RAMUNĖLĖS;5934077931;Taip;7;0;0;7
2150;Gelvonėlis;RAMUNĖLĖS;3271464159;Taip;0;2;0;2
2151;Gelvonėlis;RAMUNĖLĖS;2734462553;Taip;16;0;0;16
2152;Gelvonėlis;RAMUNĖLĖS;4280463938;Taip;1;1;0;2
2153;Gelvonėlis;RAMUNĖLĖS;4083370462;Taip;5;0;1;6
2154;Gelvonėlis;RAMUNĖLĖS;6068473734;Taip;5;0;0;5
2155;Gervelė;ŽIRNIUKAI;9977349707;Taip;4;0;1;5
2156;Gervelė;ŽIRNIUKAI;7317091881;Taip;0;0;2;2
2157;Gervelė;ŽIRNIUKAI;4038179503;Taip;5;9;0;14
2158;Gervelė;ŽIRNIUKAI;4295743997;Taip;0;1;0;1
2159;Gervelė;ŽIRNIUKAI;7020599764;Taip;3;0;0;3
2160;Gervelė;ŽIRNIUKAI;4394752176;Taip;0;4;0;4
2161;Gervelė;ŽIRNIUKAI;6228025635;Taip;0;0;1;1
2162;Gervelė;ŽIRNIUKAI;6951455424;Taip;3;0;2;5
2163;Gervelė;ŽIRNIUKAI;9970293084;Taip;9;2;0;11
2164;Gervelė;ŽIRNIUKAI;8012122042;Taip;0;0;1;1
2165;Gervelė;ŽIRNIUKAI;1400044294;Taip;9;0;2;11
2166;Gervelė;ŽIRNIUKAI;7935059565;Taip;7;0;0;7
2167;Gervelė;ŽIRNIUKAI;5267617723;Taip;1;0;0;1
2168;Gervelė;ŽIRNIUKAI;5953552777;Taip;0;4;0;4
2169;Gervelė;ŽIRNIUKAI;6263562066;Ne;0;1;0;1
2170;Gervelė;ŽIRNIUKAI;7050837754;Taip;22;0;0;22
2171;Gervelė;ŽIRNIUKAI;6287806975;Ne;7;0;1;8
2172;Gervelė;ŽIRNIUKAI;8016341646;Ne;0;0;6;6
2173;Gervelė;ŽIRNIUKAI;5685222621;Taip;0;0;1;1
2174;Gervelė;ŽIRNIUKAI;6987657237;Taip;5;0;0;5
2175;Gervelė;LAŠIUKAI;8062089041;Taip;6;0;0;6
2176;Gervelė;LAŠIUKAI;2551280794;Taip;0;9;0;9
2177;Gervelė;LAŠIUKAI;1616949023;Taip;11;0;0;11
2178;Gervelė;LAŠIUKAI;4943974662;Taip;5;0;2;7
2179;Gervelė;LAŠIUKAI;9515308666;Taip;0;4;0;4
2180;Gervelė;LAŠIUKAI;3427400844;Taip;3;12;0;15
2181;Gervelė;LAŠIUKAI;8152446576;Taip;5;9;0;14
2182;Gervelė;LAŠIUKAI;7302238728;Ne;0;1;1;2
2183;Gervelė;LAŠIUKAI;7697761552;Taip;0;2;0;2
2184;Gervelė;LAŠIUKAI;4560752068;Taip;0;12;0;12
2185;Gervelė;LAŠIUKAI;1704033440;Taip;11;2;0;13
2186;Gervelė;LAŠIUKAI;4705514590;Ne;1;0;0;1
2187;Gervelė;LAŠIUKAI;89076506192;Taip;10;0;0;10
2188;Gervelė;LAŠIUKAI;1991238577;Taip;3;4;0;7
2189;Gervelė;LAŠIUKAI;2167744244;Taip;7;0;0;7
2190;Gervelė;LAŠIUKAI;3525060645;Taip;11;3;0;14
2191;Gervelė;PABIRUČIAI;2019214634;Taip;7;0;0;7
2192;Gervelė;PABIRUČIAI;88273293270;Taip;2;0;0;2
2193;Gervelė;PABIRUČIAI;3278950938;Taip;0;0;17;17
2194;Gervelė;PABIRUČIAI;52142182972;Ne;0;0;2;2
2195;Gervelė;PABIRUČIAI;62782512806;Ne;0;7;0;7
2196;Gervelė;PABIRUČIAI;1921567602;Taip;0;0;1;1
2197;Gervelė;PABIRUČIAI;8454703111;Taip;0;2;0;2
2198;Gervelė;PABIRUČIAI;1492459180;Taip;0;3;0;3
2199;Gervelė;PABIRUČIAI;1617055167;Taip;0;5;0;5
2200;Gervelė;PABIRUČIAI;1697536098;Taip;3;2;0;5
2201;Gervelė;PABIRUČIAI;49013139623;Taip;3;0;0;3
2202;Gervelė;PABIRUČIAI;2632272974;Taip;3;0;0;3
2203;Gervelė;PABIRUČIAI;1860333208;Taip;0;5;0;5
2204;Gervelė;PABIRUČIAI;2798349541;Ne;0;3;0;3
2205;Gervelė;PABIRUČIAI;6349428106;Taip;5;5;0;10
2206;Gervelė;PABIRUČIAI;8035942210;Taip;0;11;0;11
2207;Gervelė;BITUTĖS;1792726318;Ne;0;11;0;11
2208;Gervelė;BITUTĖS;85689668690;Taip;0;1;0;1
2209;Gervelė;BITUTĖS;44678807307;Ne;10;0;0;10
2210;Gervelė;BITUTĖS;1371549808;Taip;0;0;2;2
2211;Gervelė;BITUTĖS;15891512215;Taip;6;0;0;6
2212;Gervelė;BITUTĖS;48497142461;Ne;0;1;0;1
2213;Gervelė;BITUTĖS;76731434799;Ne;0;0;6;6
2214;Gervelė;BITUTĖS;24724452164;Taip;4;0;0;4
2215;Gervelė;BITUTĖS;27435616549;Taip;17;0;0;17
2216;Gervelė;BITUTĖS;1303396562;Ne;12;0;3;15
2217;Gervelė;BITUTĖS;32101040739;Ne;0;0;1;1
2218;Gervelė;BITUTĖS;5085234839;Taip;3;0;1;4
2219;Gervelė;BITUTĖS;97418410809;Ne;10;0;0;10
2220;Gervelė;BITUTĖS;65751519550;Ne;8;0;1;9
2221;Gervelė;BITUTĖS;1413157604;Taip;0;0;4;4
2222;Gervelė;BITUTĖS;81112128210;Taip;0;4;0;4
2223;Gervelė;BITUTĖS;65086547895;Taip;0;12;0;12
2224;Gervelė;BITUTĖS;2017094793;Taip;0;0;1;1
2225;Gervelė;BURATINO;1815418720;Taip;0;8;0;8
2226;Gervelė;BURATINO;6168558862;Taip;0;7;0;7
2227;Gervelė;BURATINO;92859033264;Taip;2;1;0;3
2228;Gervelė;BURATINO;1083567209;Taip;0;0;3;3
2229;Gervelė;BURATINO;3946391650;Taip;0;1;0;1
2230;Gervelė;BURATINO;7620764911;Taip;11;3;0;14
2231;Gervelė;BURATINO;5440557094;Taip;0;8;0;8
2232;Gervelė;BURATINO;9202293067;Taip;8;0;0;8
2233;Gervelė;BURATINO;9909794030;Taip;0;5;0;5
2234;Gervelė;BURATINO;2646901307;Taip;0;4;0;4
2235;Gervelė;BURATINO;9564303781;Taip;0;1;0;1
2236;Gervelė;BURATINO;78122408360;Taip;13;1;0;14
2237;Gervelė;BURATINO;9771780358;Taip;6;0;0;6
2238;Gervelė;BURATINO;9239897472;Taip;13;1;0;14
2239;Gervelė;BURATINO;8997525194;Taip;10;7;0;17
2240;Gervelė;VIŠČIUKŲ;6844406500;Taip;9;2;0;11
2241;Gervelė;VIŠČIUKŲ;8157865822;Taip;12;0;0;12
2242;Gervelė;VIŠČIUKŲ;2359854614;Taip;3;0;1;4
2243;Gervelė;VIŠČIUKŲ;8533480337;Taip;6;1;0;7
2244;Gervelė;VIŠČIUKŲ;2523056808;Taip;3;0;8;11
2245;Gervelė;VIŠČIUKŲ;6145405293;Taip;0;0;3;3
2246;Gervelė;VIŠČIUKŲ;1637204236;Taip;12;0;0;12
2247;Gervelė;VIŠČIUKŲ;2413995770;Taip;6;0;2;8
2248;Gervelė;VIŠČIUKŲ;6058944385;Taip;0;9;0;9
2249;Gervelė;VIŠČIUKŲ;1323074335;Taip;6;0;0;6
2250;Gervelė;VIŠČIUKŲ;3702908570;Taip;1;0;0;1
2251;Gervelė;VIŠČIUKŲ;3449674095;Taip;0;1;0;1
2252;Gervelė;VIŠČIUKŲ;5767158743;Taip;8;4;0;12
2253;Gervelė;VIŠČIUKŲ;4846324136;Taip;5;0;9;14
2254;Gervelė;VIŠČIUKŲ;4775822341;Taip;10;0;0;10
2255;Gervelė;VIŠČIUKŲ;3723783633;Taip;15;0;0;15
2256;Gilužis;Skruzdėliukų;35511006307;Taip;10;2;0;12
2257;Gilužis;Skruzdėliukų;1671692484;Taip;3;2;0;5
2258;Gilužis;Skruzdėliukų;1615293331;Taip;0;2;0;2
2259;Gilužis;Skruzdėliukų;9474400084;Taip;0;1;0;1
2260;Gilužis;Skruzdėliukų;5161095299;Taip;0;1;0;1
2261;Gilužis;Skruzdėliukų;70959404439;Taip;0;4;0;4
2262;Gilužis;Skruzdėliukų;8120898865;Taip;0;6;0;6
2263;Gilužis;Skruzdėliukų;8840822243;Taip;22;0;0;22
2264;Gilužis;Skruzdėliukų;4611735601;Taip;5;3;0;8
2265;Gilužis;Skruzdėliukų;4747769984;Taip;0;1;0;1
2266;Gilužis;Skruzdėliukų;5920357223;Taip;0;1;0;1
2267;Gilužis;Skruzdėliukų;5365582271;Taip;5;4;2;11
2268;Gilužis;Skruzdėliukų;7364297673;Taip;0;0;1;1
2269;Gilužis;Skruzdėliukų;4362244070;Ne;5;1;0;6
2270;Gilužis;Skruzdėliukų;2042514241;Taip;0;2;0;2
2271;Gilužis;Skruzdėliukų;3216004438;Taip;0;2;0;2
2272;Gilužis;Skruzdėliukų;4777937216;Taip;0;2;0;2
2273;Gilužis;Nykštukų;3132445117;Taip;5;0;2;7
2274;Gilužis;Nykštukų;7937643339;Taip;5;0;0;5
2275;Gilužis;Nykštukų;3473889426;Taip;5;0;0;5
2276;Gilužis;Nykštukų;9362581908;Taip;5;0;0;5
2277;Gilužis;Nykštukų;2661894041;Taip;13;0;0;13
2278;Gilužis;Nykštukų;5109935385;Taip;6;2;0;8
2279;Gilužis;Nykštukų;7228498662;Taip;0;6;1;7
2280;Gilužis;Nykštukų;1459273692;Taip;0;7;0;7
2281;Gilužis;Nykštukų;6093514885;Taip;13;0;0;13
2282;Gilužis;Nykštukų;4156613717;Ne;0;0;14;14
2283;Gilužis;Nykštukų;5713786735;Ne;21;0;0;21
2284;Gilužis;Nykštukų;2784416935;Taip;5;0;0;5
2285;Gilužis;Nykštukų;6315155554;Taip;5;0;0;5
2286;Gilužis;Nykštukų;1146713023;Taip;0;3;0;3
2287;Gilužis;Nykštukų;9332056404;Taip;7;5;1;13
2288;Gilužis;Nykštukų;4541291716;Taip;2;0;0;2
2289;Gilužis;Nykštukų;8522552650;Taip;0;5;1;6
2290;Gilužis;Bitučių;7667792304;Taip;0;5;0;5
2291;Gilužis;Bitučių;33601993265;Taip;0;2;0;2
2292;Gilužis;Bitučių;36591400178;Taip;0;3;0;3
2293;Gilužis;Bitučių;86856314276;Taip;0;2;0;2
2294;Gilužis;Bitučių;6761901941;Taip;0;0;2;2
2295;Gilužis;Bitučių;66936354561;Taip;0;3;0;3
2296;Gilužis;Bitučių;31841898314;Taip;0;0;1;1
2297;Gilužis;Bitučių;37713407129;Taip;0;2;0;2
2298;Gilužis;Bitučių;75877736009;Taip;0;2;0;2
2299;Gilužis;Bitučių;98929035480;Taip;0;5;0;5
2300;Gilužis;Bitučių;16441506448;Taip;6;0;1;7
2301;Gilužis;Bitučių;60029145569;Taip;0;1;0;1
2302;Gilužis;Bitučių;6748923923;Taip;10;0;0;10
2303;Gilužis;Bitučių;84012597609;Ne;11;0;0;11
2304;Gilužis;Bitučių;44591290522;Taip;0;1;4;5
2305;Gilužis;Kačiukų;64044950817;Taip;11;4;0;15
2306;Gilužis;Kačiukų;97044945526;Taip;5;0;1;6
2307;Gilužis;Kačiukų;2452430134;Taip;0;2;0;2
2308;Gilužis;Kačiukų;97366385111;Taip;10;7;0;17
2309;Gilužis;Kačiukų;90653192774;Taip;1;8;0;9
2310;Gilužis;Kačiukų;43427840545;Taip;2;0;0;2
2311;Gilužis;Kačiukų;69179380194;Taip;4;0;0;4
2312;Gilužis;Kačiukų;93911699181;Taip;0;0;3;3
2313;Gilužis;Kačiukų;11999596704;Taip;0;2;0;2
2314;Gilužis;Kačiukų;40327951625;Ne;3;1;0;4
2315;Gilužis;Kačiukų;69814504535;Ne;0;2;0;2
2316;Gilužis;Kačiukų;2826672081;Taip;0;0;1;1
2317;Gilužis;Kačiukų;48813257365;Ne;1;0;0;1
2318;Gilužis;Kačiukų;37836645040;Taip;0;1;0;1
2319;Gilužis;Kačiukų;90150093965;Taip;0;6;0;6
2320;Gilužis;Kačiukų;88997906780;Taip;0;1;0;1
2321;Gilužis;Kačiukų;1483999429;Taip;0;1;0;1
2322;Gilužis;Kačiukų;8442202778;Taip;6;0;0;6
2323;Gilužis;Pelėdžiukų;5217748032;Ne;0;5;0;5
2324;Gilužis;Pelėdžiukų;5989314494;Taip;4;0;0;4
2325;Gilužis;Pelėdžiukų;7998695149;Taip;22;0;0;22
2326;Gilužis;Pelėdžiukų;7742783427;Taip;22;0;0;22
2327;Gilužis;Pelėdžiukų;7358572344;Taip;0;3;0;3
2328;Gilužis;Pelėdžiukų;4617259961;Taip;1;0;3;4
2329;Gilužis;Pelėdžiukų;1222370750;Ne;8;4;0;12
2330;Gilužis;Pelėdžiukų;9503516686;Taip;7;1;0;8
2331;Gilužis;Pelėdžiukų;9833451628;Taip;0;9;1;10
2332;Gilužis;Pelėdžiukų;6270071724;Taip;0;1;0;1
2333;Gilužis;Pelėdžiukų;7050440691;Taip;10;0;0;10
2334;Gilužis;Pelėdžiukų;1804218972;Taip;2;0;2;4
2335;Gilužis;Pelėdžiukų;2434419240;Taip;2;1;0;3
2336;Gilužis;Pelėdžiukų;1832039250;Taip;0;0;5;5
2337;Gilužis;Pelėdžiukų;1496943250;Ne;0;0;1;1
2338;Gilužis;Pelėdžiukų;5070988982;Taip;5;3;0;8
2339;Gilužis;Pelėdžiukų;7899274495;Taip;5;0;0;5
2340;Gilužis;Drugelių;1437220475;Taip;0;12;0;12
2341;Gilužis;Drugelių;36023384252;Taip;0;2;0;2
2342;Gilužis;Drugelių;44522730563;Taip;0;0;2;2
2343;Gilužis;Drugelių;9763902423;Ne;0;0;1;1
2344;Gilužis;Drugelių;1197884403;Ne;6;0;0;6
2345;Gilužis;Drugelių;6000255910;Taip;3;0;0;3
2346;Gilužis;Drugelių;79340379786;Ne;1;0;0;1
2347;Gilužis;Drugelių;6622443065;Ne;0;0;1;1
2348;Gilužis;Drugelių;1774912517;Taip;8;0;0;8
2349;Gilužis;Drugelių;80556519366;Taip;0;3;0;3
2350;Gilužis;Drugelių;1335467227;Taip;5;0;0;5
2351;Gilužis;Drugelių;2102777576;Taip;0;0;4;4
2352;Gilužis;Drugelių;93587767496;Taip;0;4;0;4
2353;Gilužis;Drugelių;55062344648;Taip;10;0;1;11
2354;Gilužis;Drugelių;2118119414;Ne;0;1;3;4
2355;Gilužis;Drugelių;82030031331;Taip;3;0;2;5
2356;Gilužis;Drugelių;7127446066;Ne;10;0;2;12
2357;Gilužis;Saulučių;17896774143;Taip;0;0;3;3
2358;Gilužis;Saulučių;9918995545;Taip;0;1;0;1
2359;Gilužis;Saulučių;4209000927;Taip;2;0;2;4
2360;Gilužis;Saulučių;8595551150;Taip;6;0;1;7
2361;Gilužis;Saulučių;8224691148;Taip;3;5;0;8
2362;Gilužis;Saulučių;4473810097;Taip;4;0;1;5
2363;Gilužis;Saulučių;1649256496;Taip;0;0;1;1
2364;Gilužis;Saulučių;96550272401;Taip;16;0;0;16
2365;Gilužis;Saulučių;69504888193;Taip;4;0;0;4
2366;Gilužis;Saulučių;2391630554;Taip;7;0;0;7
2367;Gilužis;Saulučių;18997894859;Taip;0;0;1;1
2368;Gilužis;Saulučių;7744997250;Ne;0;0;1;1
2369;Gilužis;Saulučių;3181765606;Taip;6;1;4;11
2370;Gilužis;Saulučių;28447690974;Ne;0;0;1;1
2371;Gilužis;Saulučių;87425898496;Taip;0;1;0;1
2372;Gilužis;Saulučių;9367673896;Taip;5;0;1;6
2373;Gilužis;Paukštelių;1911733577;Ne;0;1;0;1
2374;Gilužis;Paukštelių;2033250993;Taip;0;0;2;2
2375;Gilužis;Paukštelių;1124568431;Ne;0;1;0;1
2376;Gilužis;Paukštelių;1120628451;Taip;0;2;0;2
2377;Gilužis;Paukštelių;1772207635;Taip;0;1;0;1
2378;Gilužis;Paukštelių;9252084783;Taip;0;6;0;6
2379;Gilužis;Paukštelių;93844800610;Ne;0;0;3;3
2380;Gilužis;Paukštelių;92163197528;Taip;0;0;2;2
2381;Gilužis;Paukštelių;1962922981;Taip;2;0;2;4
2382;Gilužis;Paukštelių;2769830772;Taip;8;0;0;8
2383;Gilužis;Paukštelių;1259168003;Taip;0;1;0;1
2384;Gilužis;Paukštelių;91148708775;Taip;11;0;0;11
2385;Gilužis;Paukštelių;8933516128;Taip;0;0;1;1
2386;Gilužis;Paukštelių;49114819476;Taip;1;0;1;2
2387;Gilužis;Paukštelių;93151301892;Taip;6;0;0;6
2388;Gilužis;Paukštelių;65698608589;Taip;0;5;0;5
2389;Gilužis;Paukštelių;1413931545;Taip;5;0;0;5
2390;Gilužis;Paukštelių;4754994261;Ne;0;2;0;2
2391;Gilužis;Paukštelių;49793977825;Taip;5;0;0;5
2392;Gilužis;Obuoliukų;27834192987;Taip;4;3;0;7
2393;Gilužis;Obuoliukų;1050659357;Taip;3;2;1;6
2394;Gilužis;Obuoliukų;72582220264;Taip;4;5;0;9
2395;Gilužis;Obuoliukų;1840213846;Taip;22;0;0;22
2396;Gilužis;Obuoliukų;2134161601;Taip;0;3;1;4
2397;Gilužis;Obuoliukų;1637726675;Taip;0;2;0;2
2398;Gilužis;Obuoliukų;1404236599;Taip;0;17;0;17
2399;Gilužis;Obuoliukų;93652771548;Taip;3;2;0;5
2400;Gilužis;Obuoliukų;2031851095;Taip;0;1;0;1
2401;Gilužis;Obuoliukų;8015495924;Taip;0;0;1;1
2402;Gilužis;Obuoliukų;96799037695;Taip;6;1;0;7
2403;Gilužis;Obuoliukų;2138402546;Taip;5;0;0;5
2404;Gilužis;Obuoliukų;1923605078;Taip;3;0;0;3
2405;Gilužis;Obuoliukų;1236164928;Taip;0;1;0;1
2406;Gilužis;Obuoliukų;84834458261;Taip;0;9;1;10
2407;Gilužis;Obuoliukų;5121769570;Taip;7;0;0;7
2408;Gilužis;Obuoliukų;1428994411;Taip;3;2;0;5
2409;Gilužis;Obuoliukų;5899163275;Taip;7;0;0;7
2410;Gilužis;Obuoliukų;2126527730;Taip;0;1;0;1
2411;Gilužis;Obuoliukų;53388692764;Taip;0;1;1;2
2412;Gilužis;Obuoliukų;1067512693;Taip;5;0;0;5
2413;Gilužis;KIŠKUČIŲ;1191967409;Taip;5;9;0;14
2414;Gilužis;KIŠKUČIŲ;1025400197;Taip;0;0;1;1
2415;Gilužis;KIŠKUČIŲ;24558082285;Taip;14;2;0;16
2416;Gilužis;KIŠKUČIŲ;31157032738;Taip;0;1;0;1
2417;Gilužis;KIŠKUČIŲ;1869058578;Taip;5;0;1;6
2418;Gilužis;KIŠKUČIŲ;1464348972;Taip;4;0;0;4
2419;Gilužis;KIŠKUČIŲ;1589884646;Taip;7;0;0;7
2420;Gilužis;KIŠKUČIŲ;54636558233;Taip;7;1;0;8
2421;Gilužis;KIŠKUČIŲ;1453976300;Taip;0;1;0;1
2422;Gilužis;KIŠKUČIŲ;57074114440;Taip;0;3;0;3
2423;Gilužis;KIŠKUČIŲ;15192433393;Taip;0;0;1;1
2424;Gilužis;KIŠKUČIŲ;1307302669;Taip;0;0;3;3
2425;Gilužis;KIŠKUČIŲ;1569805585;Taip;9;0;0;9
2426;Gilužis;Meškučių;5008795520;Taip;0;10;0;10
2427;Gilužis;Meškučių;82153247890;Taip;0;8;0;8
2428;Gilužis;Meškučių;9104396905;Taip;0;2;1;3
2429;Gilužis;Meškučių;15672746324;Taip;0;0;1;1
2430;Gilužis;Meškučių;8278207628;Ne;1;0;0;1
2431;Gilužis;Meškučių;5988529284;Taip;7;0;5;12
2432;Gilužis;Meškučių;6840555273;Taip;0;2;0;2
2433;Gilužis;Meškučių;2111997678;Taip;6;0;0;6
2434;Gilužis;Meškučių;1664140841;Ne;6;0;0;6
2435;Gilužis;Meškučių;1201973661;Taip;0;8;0;8
2436;Gilužis;Meškučių;99889836604;Taip;1;0;0;1
2437;Gilužis;Meškučių;93541096118;Taip;4;1;0;5
2438;Gilužis;Meškučių;41791785706;Ne;0;22;0;22
2439;Gilužis;Meškučių;3104707033;Ne;5;1;0;6
2440;Gilužis;Meškučių;3884351522;Ne;0;5;0;5
2441;Gilužis;Meškučių;1003733551;Taip;0;0;1;1
2442;Gilužis;Meškučių;41887832166;Taip;0;1;0;1
2443;Gilužis;Meškučių;57285847418;Taip;0;2;0;2
2444;Gilužis;Meškučių;37771334557;Taip;0;13;0;13
2445;Gilužis;Meškučių;3451034791;Ne;0;22;0;22
2446;Gilužis;Meškučių;1642252063;Taip;0;2;2;4
2447;Gilužis;Pagrandukai;6966795180;Taip;7;0;0;7
2448;Gilužis;Pagrandukai;7330938312;Taip;10;0;0;10
2449;Gilužis;Pagrandukai;6571132974;Taip;0;21;0;21
2450;Gilužis;Pagrandukai;5128383851;Taip;0;0;4;4
2451;Gilužis;Pagrandukai;1582241363;Taip;8;2;0;10
2452;Gilužis;Pagrandukai;8244385001;Taip;5;0;0;5
2453;Gilužis;Pagrandukai;4909329417;Taip;0;0;1;1
2454;Gilužis;Pagrandukai;4978922821;Taip;5;2;0;7
2455;Gilužis;Pagrandukai;2945406185;Taip;5;5;0;10
2456;Gilužis;Pagrandukai;9034842169;Taip;8;0;0;8
2457;Gilužis;Pagrandukai;7001112696;Taip;4;0;0;4
2458;Gilužis;Pagrandukai;8318405114;Taip;8;0;0;8
2459;Gilužis;Pagrandukai;6786334223;Taip;3;0;0;3
2460;Gilužis;Pagrandukai;1093643746;Taip;0;7;0;7
2461;Gilužis;Boružėlių;4360261750;Taip;0;0;1;1
2462;Gilužis;Boružėlių;1634295583;Taip;0;0;1;1
2463;Gilužis;Boružėlių;6404411477;Taip;10;2;0;12
2464;Gilužis;Boružėlių;9186274541;Taip;9;0;0;9
2465;Gilužis;Boružėlių;6121625070;Taip;11;0;1;12
2466;Gilužis;Boružėlių;3419281756;Taip;10;0;0;10
2467;Gilužis;Boružėlių;4403218878;Taip;6;0;0;6
2468;Gilužis;Boružėlių;9097165155;Taip;4;0;2;6
2469;Gilužis;Boružėlių;1862524255;Taip;10;0;0;10
2470;Gilužis;Boružėlių;6960673767;Taip;7;0;0;7
2471;Gilužis;Boružėlių;4841014668;Taip;2;0;0;2
2472;Gintarėlis;PAPŪGĖLĖS;8498936096;Taip;0;2;0;2
2473;Gintarėlis;PAPŪGĖLĖS;8913652291;Taip;0;5;0;5
2474;Gintarėlis;PAPŪGĖLĖS;2485750596;Taip;0;1;0;1
2475;Gintarėlis;PAPŪGĖLĖS;1033624080;Ne;0;6;0;6
2476;Gintarėlis;PAPŪGĖLĖS;2919700367;Ne;0;21;0;21
2477;Gintarėlis;PAPŪGĖLĖS;1768789948;Taip;0;4;0;4
2478;Gintarėlis;PAPŪGĖLĖS;2595566032;Taip;0;3;0;3
2479;Gintarėlis;PAPŪGĖLĖS;9141438560;Taip;0;4;0;4
2480;Gintarėlis;PAPŪGĖLĖS;2235045173;Taip;0;3;0;3
2481;Gintarėlis;PAPŪGĖLĖS;9494521554;Taip;0;9;0;9
2482;Gintarėlis;PAPŪGĖLĖS;7494884360;Taip;0;8;0;8
2483;Gintarėlis;PAPŪGĖLĖS;7147842224;Taip;0;14;0;14
2484;Gintarėlis;PAPŪGĖLĖS;9648982613;Taip;0;3;0;3
2485;Gintarėlis;PAPŪGĖLĖS;5783939567;Ne;0;1;0;1
2486;Gintarėlis;PAPŪGĖLĖS;7674351459;Taip;0;10;0;10
2487;Gintarėlis;PAPŪGĖLĖS;6292664833;Taip;0;22;0;22
2488;Gintarėlis;PAPŪGĖLĖS;5811396263;Taip;0;9;0;9
2489;Gintarėlis;PAPŪGĖLĖS;4904966263;Taip;0;3;0;3
2490;Gintarėlis;PAPŪGĖLĖS;1648843117;Ne;0;3;0;3
2491;Gintarėlis;PAPŪGĖLĖS;1861324153;Taip;0;4;0;4
2492;Gintarėlis;PAPŪGĖLĖS;3457974670;Taip;0;7;0;7
2493;Gintarėlis;PAPŪGĖLĖS;9382662838;Taip;0;4;0;4
2494;Gintarėlis;SPINDULIUKAI;96694096944;Taip;0;4;0;4
2495;Gintarėlis;SPINDULIUKAI;88552701503;Taip;0;2;0;2
2496;Gintarėlis;SPINDULIUKAI;58118782421;Taip;0;1;0;1
2497;Gintarėlis;SPINDULIUKAI;65950042767;Taip;0;1;0;1
2498;Gintarėlis;SPINDULIUKAI;33863655816;Ne;0;3;0;3
2499;Gintarėlis;SPINDULIUKAI;11384063236;Taip;0;1;0;1
2500;Gintarėlis;SPINDULIUKAI;27532374357;Taip;0;2;0;2
2501;Gintarėlis;SPINDULIUKAI;8112379741;Ne;0;5;0;5
2502;Gintarėlis;SPINDULIUKAI;37848651606;Taip;0;9;0;9
2503;Gintarėlis;SPINDULIUKAI;56701557907;Ne;0;11;0;11
2504;Gintarėlis;SPINDULIUKAI;77140073438;Taip;0;2;0;2
2505;Gintarėlis;SPINDULIUKAI;92436759875;Taip;10;1;0;11
2506;Gintarėlis;SPINDULIUKAI;1360843628;Taip;0;6;0;6
2507;Gintarėlis;SPINDULIUKAI;63037561278;Taip;0;4;0;4
2508;Gintarėlis;SPINDULIUKAI;92996401082;Taip;0;2;0;2
2509;Gintarėlis;SPINDULIUKAI;19506557567;Ne;0;1;0;1
2510;Gintarėlis;SPINDULIUKAI;24915581271;Taip;0;10;0;10
2511;Gintarėlis;SPINDULIUKAI;18222675927;Ne;0;8;0;8
2512;Gintarėlis;SPINDULIUKAI;3035023250;Taip;0;3;0;3
2513;Gintarėlis;LAŠIUKAI;6893183889;Taip;0;12;0;12
2514;Gintarėlis;LAŠIUKAI;5880091191;Taip;0;12;0;12
2515;Gintarėlis;LAŠIUKAI;9584956349;Taip;0;22;0;22
2516;Gintarėlis;LAŠIUKAI;94354056029;Ne;0;10;0;10
2517;Gintarėlis;LAŠIUKAI;78359050717;Taip;0;3;0;3
2518;Gintarėlis;LAŠIUKAI;6457288028;Taip;0;13;0;13
2519;Gintarėlis;LAŠIUKAI;1002155392;Taip;0;7;0;7
2520;Gintarėlis;LAŠIUKAI;96416364735;Taip;0;2;0;2
2521;Gintarėlis;LAŠIUKAI;3504738389;Taip;0;5;0;5
2522;Gintarėlis;LAŠIUKAI;9130659549;Taip;0;5;0;5
2523;Gintarėlis;LAŠIUKAI;4660854883;Taip;0;4;0;4
2524;Gintarėlis;LAŠIUKAI;25210675029;Taip;0;6;0;6
2525;Gintarėlis;LAŠIUKAI;7192722296;Ne;0;8;0;8
2526;Gintarėlis;LAŠIUKAI;5024727902;Ne;0;2;0;2
2527;Gintarėlis;LAŠIUKAI;9040480798;Taip;0;3;0;3
2528;Gintarėlis;LAŠIUKAI;8055928882;Taip;0;6;0;6
2529;Gintarėlis;LAŠIUKAI;7644607132;Taip;0;2;0;2
2530;Gintarėlis;LAŠIUKAI;2088008759;Taip;0;8;0;8
2531;Gintarėlis;LAŠIUKAI;2036488789;Taip;0;2;0;2
2532;Gintarėlis;LAŠIUKAI;4205363850;Taip;0;9;0;9
2533;Gintarėlis;GAIDŽIUKAI;29645999843;Taip;0;10;0;10
2534;Gintarėlis;GAIDŽIUKAI;45480802894;Taip;0;2;0;2
2535;Gintarėlis;GAIDŽIUKAI;1539226211;Taip;0;13;0;13
2536;Gintarėlis;GAIDŽIUKAI;2043878016;Taip;0;3;0;3
2537;Gintarėlis;GAIDŽIUKAI;90891401453;Taip;0;2;0;2
2538;Gintarėlis;GAIDŽIUKAI;1770479969;Taip;0;3;0;3
2539;Gintarėlis;GAIDŽIUKAI;53971205498;Taip;0;1;0;1
2540;Gintarėlis;GAIDŽIUKAI;1441282039;Taip;0;13;0;13
2541;Gintarėlis;GAIDŽIUKAI;5835437020;Ne;0;1;0;1
2542;Gintarėlis;GAIDŽIUKAI;77591601744;Taip;0;4;0;4
2543;Gintarėlis;GAIDŽIUKAI;1076400051;Taip;0;10;0;10
2544;Gintarėlis;GAIDŽIUKAI;99077732058;Taip;0;2;0;2
2545;Gintarėlis;GAIDŽIUKAI;4660581415;Taip;0;2;0;2
2546;Gintarėlis;GAIDŽIUKAI;3794027499;Taip;0;1;0;1
2547;Gintarėlis;GAIDŽIUKAI;1327681704;Taip;0;1;0;1
2548;Gintarėlis;GAIDŽIUKAI;2203238888;Taip;0;1;0;1
2549;Gintarėlis;MEŠKUČIAI;8860898577;Taip;0;1;0;1
2550;Gintarėlis;MEŠKUČIAI;84375225995;Taip;0;2;0;2
2551;Gintarėlis;MEŠKUČIAI;29331294396;Taip;0;21;0;21
2552;Gintarėlis;MEŠKUČIAI;1230510614;Taip;3;1;0;4
2553;Gintarėlis;MEŠKUČIAI;33786299764;Ne;0;3;0;3
2554;Gintarėlis;MEŠKUČIAI;33714823189;Taip;0;2;0;2
2555;Gintarėlis;MEŠKUČIAI;12332079305;Taip;5;1;0;6
2556;Gintarėlis;MEŠKUČIAI;86948612054;Taip;0;5;0;5
2557;Gintarėlis;MEŠKUČIAI;1799002086;Taip;0;3;0;3
2558;Gintarėlis;MEŠKUČIAI;28514742083;Taip;0;10;0;10
2559;Gintarėlis;MEŠKUČIAI;8518137062;Taip;0;1;0;1
2560;Gintarėlis;MEŠKUČIAI;25360163411;Taip;0;12;0;12
2561;Gintarėlis;MEŠKUČIAI;1943647795;Ne;12;5;0;17
2562;Gintarėlis;MEŠKUČIAI;77802363719;Taip;0;1;0;1
2563;Gintarėlis;MEŠKUČIAI;2529363136;Taip;6;1;0;7
2564;Gintarėlis;MEŠKUČIAI;10771368524;Taip;0;1;0;1
2565;Gintarėlis;MEŠKUČIAI;47480197789;Taip;0;8;0;8
2566;Gintarėlis;MEŠKUČIAI;36019373990;Ne;0;2;0;2
2567;Gintarėlis;MEŠKUČIAI;76302896259;Taip;0;3;0;3
2568;Gintarėlis;DRUGELIAI;2127877544;Ne;0;4;0;4
2569;Gintarėlis;DRUGELIAI;14840692502;Ne;0;9;0;9
2570;Gintarėlis;DRUGELIAI;1462949250;Ne;0;18;0;18
2571;Gintarėlis;DRUGELIAI;6655809299;Taip;0;5;0;5
2572;Gintarėlis;DRUGELIAI;2614258442;Taip;0;10;0;10
2573;Gintarėlis;DRUGELIAI;1452402931;Ne;0;9;0;9
2574;Gintarėlis;DRUGELIAI;4217329880;Ne;0;5;0;5
2575;Gintarėlis;DRUGELIAI;1759217543;Taip;0;13;0;13
2576;Gintarėlis;DRUGELIAI;7571352126;Taip;0;22;0;22
2577;Gintarėlis;DRUGELIAI;50896429585;Taip;0;2;0;2
2578;Gintarėlis;DRUGELIAI;1042222561;Taip;0;13;0;13
2579;Gintarėlis;DRUGELIAI;9687974376;Taip;0;9;0;9
2580;Gintarėlis;DRUGELIAI;8419453060;Taip;0;1;0;1
2581;Gintarėlis;DRUGELIAI;6655645997;Taip;0;22;0;22
2582;Gintarėlis;DRUGELIAI;6080108998;Taip;0;22;0;22
2583;Gintarėlis;DRUGELIAI;7449437199;Taip;0;14;0;14
2584;Gintarėlis;DRUGELIAI;4076421692;Ne;0;7;0;7
2585;Gintarėlis;DRUGELIAI;2016067859;Taip;0;5;0;5
2586;Gintarėlis;DRUGELIAI;8116557698;Taip;0;4;0;4
2587;Gintarėlis;KAČIUKAI;5451653510;Taip;0;6;0;6
2588;Gintarėlis;KAČIUKAI;9903314418;Taip;0;2;0;2
2589;Gintarėlis;KAČIUKAI;63243392161;Taip;0;2;0;2
2590;Gintarėlis;KAČIUKAI;37612987791;Taip;0;19;0;19
2591;Gintarėlis;KAČIUKAI;26259581924;Taip;0;10;0;10
2592;Gintarėlis;KAČIUKAI;70787488885;Ne;0;4;0;4
2593;Gintarėlis;KAČIUKAI;31365533022;Ne;0;1;0;1
2594;Gintarėlis;KAČIUKAI;50715082496;Taip;0;1;0;1
2595;Gintarėlis;KAČIUKAI;1159773367;Taip;0;9;0;9
2596;Gintarėlis;KAČIUKAI;2050020230;Ne;0;4;0;4
2597;Gintarėlis;KAČIUKAI;54145290842;Taip;0;22;0;22
2598;Gintarėlis;KAČIUKAI;19813827223;Ne;0;1;0;1
2599;Gintarėlis;KAČIUKAI;98684742007;Ne;0;21;0;21
2600;Gintarėlis;KAČIUKAI;2000986290;Taip;0;12;0;12
2601;Gintarėlis;KAČIUKAI;6421537455;Ne;0;3;0;3
2602;Gintarėlis;KAČIUKAI;1595816431;Taip;0;4;0;4
2603;Gintarėlis;KAČIUKAI;63221497564;Taip;0;2;0;2
2604;Gintarėlis;KAČIUKAI;81135362098;Taip;0;2;0;2
2605;Gintarėlis;KAČIUKAI;58701768194;Taip;0;6;0;6
2606;Gintarėlis;KAČIUKAI;29480359781;Ne;0;9;0;9
2607;Gintarėlis;KAČIUKAI;7610677403;Ne;0;12;0;12
2608;Gintarėlis;KIŠKUČIAI;8665467175;Taip;0;1;0;1
2609;Gintarėlis;KIŠKUČIAI;83754732536;Taip;0;22;0;22
2610;Gintarėlis;KIŠKUČIAI;89051269756;Ne;0;3;0;3
2611;Gintarėlis;KIŠKUČIAI;1642627920;Taip;0;3;0;3
2612;Gintarėlis;KIŠKUČIAI;1593455162;Taip;0;1;0;1
2613;Gintarėlis;KIŠKUČIAI;3828845515;Taip;0;5;0;5
2614;Gintarėlis;KIŠKUČIAI;1069395570;Ne;0;2;0;2
2615;Gintarėlis;KIŠKUČIAI;19402011412;Taip;0;6;0;6
2616;Gintarėlis;KIŠKUČIAI;96211766919;Taip;0;6;0;6
2617;Gintarėlis;KIŠKUČIAI;78697777550;Taip;0;7;0;7
2618;Gintarėlis;KIŠKUČIAI;85557344192;Ne;0;5;0;5
2619;Gintarėlis;KIŠKUČIAI;4279681763;Taip;0;2;0;2
2620;Gintarėlis;KIŠKUČIAI;2032900352;Taip;0;11;0;11
2621;Gintarėlis;KIŠKUČIAI;3292572563;Taip;0;22;0;22
2622;Gintarėlis;KIŠKUČIAI;1543013649;Ne;0;6;0;6
2623;Gintarėlis;KIŠKUČIAI;24774460882;Ne;0;3;0;3
2624;Gintarėlis;KIŠKUČIAI;1028456578;Taip;0;12;0;12
2625;Gintarėlis;VYTURIUKAI;1553747935;Taip;0;20;0;20
2626;Gintarėlis;VYTURIUKAI;22394648690;Taip;0;1;0;1
2627;Gintarėlis;VYTURIUKAI;4902086873;Taip;0;4;0;4
2628;Gintarėlis;VYTURIUKAI;56124970238;Taip;0;1;0;1
2629;Gintarėlis;VYTURIUKAI;34606130829;Taip;0;9;0;9
2630;Gintarėlis;VYTURIUKAI;21658913551;Taip;0;1;0;1
2631;Gintarėlis;VYTURIUKAI;18715625324;Ne;0;10;0;10
2632;Gintarėlis;VYTURIUKAI;9740239182;Taip;0;2;0;2
2633;Gintarėlis;BORUŽĖLĖS;4971574875;Taip;0;10;0;10
2634;Gintarėlis;BORUŽĖLĖS;6277010268;Taip;0;13;0;13
2635;Gintarėlis;BORUŽĖLĖS;1771868868;Ne;0;8;0;8
2636;Gintarėlis;BORUŽĖLĖS;39372328122;Taip;0;5;0;5
2637;Gintarėlis;BORUŽĖLĖS;25451522701;Taip;0;8;0;8
2638;Gintarėlis;BORUŽĖLĖS;90216120878;Taip;0;15;0;15
2639;Gintarėlis;BORUŽĖLĖS;1929900615;Taip;0;20;0;20
2640;Gintarėlis;BORUŽĖLĖS;82344200095;Taip;0;18;0;18
2641;Gintarėlis;BORUŽĖLĖS;9255623049;Taip;0;19;0;19
2642;Gintarėlis;BORUŽĖLĖS;88451515187;Taip;0;8;0;8
2643;Gintarėlis;BORUŽĖLĖS;7703150488;Taip;0;1;0;1
2644;Gintarėlis;BORUŽĖLĖS;2145479870;Taip;0;1;0;1
2645;Gintarėlis;BORUŽĖLĖS;49506158711;Taip;0;5;0;5
2646;Gintarėlis;BORUŽĖLĖS;30066476338;Taip;0;6;0;6
2647;Gintarėlis;BORUŽĖLĖS;63146841406;Taip;0;22;0;22
2648;Gintarėlis;BORUŽĖLĖS;30334064319;Taip;0;16;0;16
2649;Gintarėlis;BORUŽĖLĖS;6426075546;Taip;0;5;0;5
2650;Gintarėlis;BORUŽĖLĖS;91798408335;Taip;0;5;0;5
2651;Gintarėlis;BORUŽĖLĖS;25684002087;Taip;0;17;0;17
2652;Gintarėlis;BORUŽĖLĖS;10826255781;Taip;0;7;0;7
2653;Gintarėlis;BORUŽĖLĖS;1505703905;Taip;0;7;0;7
2654;Gintarėlis;EŽIUKAI;1793785936;Taip;0;2;0;2
2655;Gintarėlis;EŽIUKAI;1856031326;Taip;0;11;0;11
2656;Gintarėlis;EŽIUKAI;27890184523;Ne;0;2;0;2
2657;Gintarėlis;EŽIUKAI;1841482183;Taip;0;1;0;1
2658;Gintarėlis;EŽIUKAI;8074941282;Taip;0;3;0;3
2659;Gintarėlis;EŽIUKAI;2040989572;Taip;0;2;0;2
2660;Gintarėlis;EŽIUKAI;18008015227;Taip;0;1;0;1
2661;Gintarėlis;EŽIUKAI;1312688961;Taip;13;0;0;13
2662;Gintarėlis;EŽIUKAI;1672037617;Taip;0;5;0;5
2663;Gintarėlis;EŽIUKAI;51418692259;Taip;0;1;0;1
2664;Gintarėlis;EŽIUKAI;1398810524;Taip;0;13;0;13
2665;Gintarėlis;EŽIUKAI;2732338838;Taip;0;1;0;1
2666;Gintarėlis;EŽIUKAI;83686073097;Taip;0;1;0;1
2667;Gintarėlis;EŽIUKAI;7731823367;Taip;0;1;0;1
2668;Gintarėlis;EŽIUKAI;7053099543;Taip;3;4;0;7
2669;Gintarėlis;EŽIUKAI;56834651967;Taip;0;22;0;22
2670;Gintarėlis;EŽIUKAI;13416505188;Taip;16;0;0;16
2671;Gintarėlis;EŽIUKAI;36350623756;Taip;0;3;0;3
2672;Gintarėlis;VIŠČIUKAI;5436695400;Taip;0;1;0;1
2673;Gintarėlis;VIŠČIUKAI;9963329170;Taip;0;8;0;8
2674;Gintarėlis;VIŠČIUKAI;5569843168;Taip;0;2;0;2
2675;Gintarėlis;VIŠČIUKAI;1011749698;Taip;0;6;0;6
2676;Gintarėlis;VIŠČIUKAI;8261770154;Taip;0;12;0;12
2677;Gintarėlis;VIŠČIUKAI;8547544537;Taip;0;12;0;12
2678;Gintarėlis;VIŠČIUKAI;4976069028;Taip;0;12;0;12
2679;Gintarėlis;VIŠČIUKAI;7061545258;Taip;0;6;0;6
2680;Gintarėlis;"SAULĖS ZUIKUČIAI";8287685690;Taip;0;6;0;6
2681;Gintarėlis;"SAULĖS ZUIKUČIAI";6914904213;Taip;0;4;0;4
2682;Gintarėlis;"SAULĖS ZUIKUČIAI";1696337909;Taip;0;4;0;4
2683;Gintarėlis;"SAULĖS ZUIKUČIAI";1778573935;Taip;0;5;0;5
2684;Gintarėlis;"SAULĖS ZUIKUČIAI";5796729245;Taip;0;7;0;7
2685;Gintarėlis;"SAULĖS ZUIKUČIAI";9915887420;Taip;0;10;0;10
2686;Gintarėlis;"SAULĖS ZUIKUČIAI";3398936974;Ne;0;7;0;7
2687;Gintarėlis;"SAULĖS ZUIKUČIAI";9675201979;Taip;0;4;0;4
2688;Gintarėlis;"SAULĖS ZUIKUČIAI";7971810025;Ne;0;13;0;13
2689;Gintarėlis;"SAULĖS ZUIKUČIAI";2814569415;Ne;0;5;0;5
2690;Gintarėlis;"SAULĖS ZUIKUČIAI";6862629244;Ne;0;18;0;18
2691;Gintarėlis;"SAULĖS ZUIKUČIAI";8000297636;Taip;0;15;0;15
2692;Gintarėlis;"SAULĖS ZUIKUČIAI";6142819210;Taip;0;7;0;7
2693;Gintarėlis;"SAULĖS ZUIKUČIAI";7815317644;Taip;0;6;0;6
2694;Gintarėlis;"SAULĖS ZUIKUČIAI";3814485627;Taip;0;9;0;9
2695;Gintarėlis;"SAULĖS ZUIKUČIAI";2165332442;Taip;0;14;0;14
2696;Gintarėlis;"SAULĖS ZUIKUČIAI";5919205817;Taip;0;7;0;7
2697;Gintarėlis;"SAULĖS ZUIKUČIAI";1571260478;Ne;0;21;0;21
2698;Giraitė;Aviliukas;67009533810;Ne;2;0;0;2
2699;Giraitė;Aviliukas;62525988158;Taip;7;1;0;8
2700;Giraitė;Aviliukas;68804588518;Taip;6;7;0;13
2701;Giraitė;Aviliukas;809734624;Taip;6;1;0;7
2702;Giraitė;Aviliukas;42330865487;Taip;2;0;0;2
2703;Giraitė;Aviliukas;86412433313;Ne;5;0;0;5
2704;Giraitė;Aviliukas;10778161174;Taip;4;2;0;6
2705;Giraitė;Aviliukas;37348466498;Taip;0;11;0;11
2706;Giraitė;Aviliukas;12568042778;Taip;10;0;0;10
2707;Giraitė;Aviliukas;45633008605;Taip;0;2;0;2
2708;Giraitė;Aviliukas;7868564343;Taip;0;5;0;5
2709;Giraitė;Aviliukas;5038998112;Ne;4;0;0;4
2710;Giraitė;LapiukaI;6141730004;Taip;10;0;0;10
2711;Giraitė;LapiukaI;6325909670;Taip;9;0;0;9
2712;Giraitė;LapiukaI;7831526566;Taip;10;0;0;10
2713;Giraitė;LapiukaI;2740656695;Taip;2;0;1;3
2714;Giraitė;LapiukaI;1921430434;Ne;12;0;0;12
2715;Giraitė;LapiukaI;5006156109;Taip;0;5;0;5
2716;Giraitė;LapiukaI;2393713210;Taip;5;0;0;5
2717;Giraitė;LapiukaI;4663343304;Taip;6;0;0;6
2718;Giraitė;LapiukaI;5382004098;Taip;8;0;0;8
2719;Giraitė;LapiukaI;4811513778;Taip;5;0;1;6
2720;Giraitė;LapiukaI;9768754737;Taip;7;0;0;7
2721;Giraitė;LapiukaI;4296449093;Taip;0;1;0;1
2722;Giraitė;LapiukaI;7428833348;Taip;0;0;1;1
2723;Giraitė;LapiukaI;8376809208;Taip;16;0;0;16
2724;Giraitė;LapiukaI;5532639133;Taip;5;1;0;6
2725;Giraitė;LapiukaI;5902161665;Taip;0;3;0;3
2726;Giraitė;LapiukaI;4955786826;Taip;5;1;0;6
2727;Giraitė;Voveriukai;4387282125;Taip;12;0;0;12
2728;Giraitė;Voveriukai;2699984170;Taip;11;3;0;14
2729;Giraitė;Voveriukai;6265908751;Taip;0;0;1;1
2730;Giraitė;Voveriukai;4055450300;Taip;19;0;0;19
2731;Giraitė;Voveriukai;6963656869;Ne;0;0;2;2
2732;Giraitė;Voveriukai;3875214088;Taip;1;1;0;2
2733;Giraitė;Voveriukai;5202562049;Ne;0;0;4;4
2734;Giraitė;Voveriukai;7441871219;Taip;0;0;1;1
2735;Giraitė;Voveriukai;7481895278;Taip;0;0;3;3
2736;Giraitė;Voveriukai;3607198556;Taip;0;0;1;1
2737;Giraitė;Voveriukai;1945918102;Ne;0;2;0;2
2738;Giraitė;Voveriukai;6225092500;Taip;2;0;2;4
2739;Giraitė;Voveriukai;4137699629;Taip;14;0;1;15
2740;Giraitė;Voveriukai;3896789232;Taip;5;0;0;5
2741;Giraitė;Voveriukai;7919088987;Taip;5;0;4;9
2742;Giraitė;Voveriukai;5616242311;Taip;7;0;2;9
2743;Giraitė;Grybukai;61477798910;Ne;0;2;2;4
2744;Giraitė;Grybukai;83995022535;Taip;7;0;1;8
2745;Giraitė;Grybukai;70668076883;Taip;0;0;1;1
2746;Giraitė;Grybukai;482311593;Taip;3;0;0;3
2747;Giraitė;Grybukai;1313395982;Ne;0;2;0;2
2748;Giraitė;Grybukai;20082610200;Ne;0;0;1;1
2749;Giraitė;Grybukai;2816941652;Ne;0;1;0;1
2750;Giraitė;Grybukai;98106730833;Taip;0;0;2;2
2751;Giraitė;Grybukai;10108398683;Ne;0;0;2;2
2752;Giraitė;Grybukai;5824936903;Taip;0;3;1;4
2753;Giraitė;Grybukai;1458304464;Taip;0;0;1;1
2754;Giraitė;Grybukai;68502311448;Taip;0;12;0;12
2755;Giraitė;Grybukai;2107606245;Taip;0;1;2;3
2756;Giraitė;Grybukai;1965752607;Taip;0;5;0;5
2757;Giraitė;Grybukai;70629522964;Taip;0;1;2;3
2758;Giraitė;Riešutėliai;3683700626;Taip;0;0;2;2
2759;Giraitė;Riešutėliai;5167002022;Taip;0;0;1;1
2760;Giraitė;Riešutėliai;2425354598;Ne;0;0;3;3
2761;Giraitė;Riešutėliai;9495968363;Taip;7;0;0;7
2762;Giraitė;Riešutėliai;1253151830;Taip;7;0;0;7
2763;Giraitė;Riešutėliai;4336519836;Taip;12;0;0;12
2764;Giraitė;Riešutėliai;9026736929;Taip;0;3;2;5
2765;Giraitė;Riešutėliai;9882372025;Taip;20;0;0;20
2766;Giraitė;Riešutėliai;5721669627;Taip;10;0;1;11
2767;Giraitė;Riešutėliai;5029839281;Ne;0;0;6;6
2768;Giraitė;Riešutėliai;23319979302;Taip;0;0;1;1
2769;Giraitė;Riešutėliai;4839351300;Taip;15;2;0;17
2770;Giraitė;Riešutėliai;9224845723;Taip;0;0;1;1
2771;Giraitė;Riešutėliai;4687228561;Taip;8;0;2;10
2772;Giraitė;Riešutėliai;9652807467;Taip;5;0;2;7
2773;Giraitė;Meškiukai;27501094616;Taip;0;7;0;7
2774;Giraitė;Meškiukai;2513312448;Taip;3;3;0;6
2775;Giraitė;Meškiukai;5367392810;Taip;8;5;0;13
2776;Giraitė;Meškiukai;1608876140;Taip;0;0;1;1
2777;Giraitė;Meškiukai;5461837332;Taip;0;1;2;3
2778;Giraitė;Meškiukai;1355594003;Taip;9;1;1;11
2779;Giraitė;Meškiukai;1560868105;Taip;4;0;2;6
2780;Giraitė;Meškiukai;1050699551;Taip;17;0;0;17
2781;Giraitė;Meškiukai;1876815077;Ne;4;2;0;6
2782;Giraitė;Meškiukai;1063628206;Taip;4;0;0;4
2783;Giraitė;Meškiukai;1318214394;Taip;3;4;1;8
2784;Giraitė;Meškiukai;9195735923;Ne;3;0;0;3
2785;Giraitė;Meškiukai;65251975467;Taip;0;0;1;1
2786;Giraitė;Meškiukai;1704154980;Taip;5;0;0;5
2787;Giraitė;Meškiukai;1819657811;Taip;0;1;0;1
2788;Giraitė;Meškiukai;1512384599;Taip;2;2;0;4
2789;Giraitė;Meškiukai;2571892050;Taip;15;0;0;15
2790;Giraitė;Meškiukai;5544613599;Taip;9;0;3;12
2791;Giraitė;Meškiukai;6156715234;Taip;0;0;1;1
2792;Giraitė;Meškiukai;1594965200;Taip;0;0;9;9
2793;Giraitė;Meškiukai;9723242940;Taip;0;0;1;1
2794;Giraitė;Meškiukai;5726182600;Taip;4;0;3;7
2795;Giraitė;Meškiukai;1772790396;Ne;10;0;0;10
2796;Giraitė;Uogelės;3031181239;Taip;0;2;0;2
2797;Giraitė;Uogelės;99494458394;Taip;0;2;0;2
2798;Giraitė;Uogelės;1103462199;Taip;0;1;0;1
2799;Giraitė;Uogelės;1447893912;Taip;0;1;0;1
2800;Giraitė;Uogelės;49193108666;Ne;0;3;0;3
2801;Giraitė;Uogelės;30804922053;Taip;13;6;0;19
2802;Giraitė;Uogelės;2083472940;Taip;18;0;0;18
2803;Giraitė;Uogelės;1848908894;Taip;5;0;0;5
2804;Giraitė;Uogelės;5378240128;Taip;0;8;0;8
2805;Giraitė;Uogelės;74256775397;Ne;4;0;0;4
2806;Giraitė;Uogelės;65392345188;Taip;0;1;0;1
2807;Giraitė;Uogelės;7779733510;Taip;2;0;1;3
2808;Giraitė;Uogelės;1110792632;Taip;5;0;0;5
2809;Giraitė;Uogelės;8590987283;Taip;0;0;3;3
2810;Giraitė;Šaltinėlis;66760677758;Taip;5;0;0;5
2811;Giraitė;Šaltinėlis;94197982724;Taip;0;1;0;1
2812;Giraitė;Šaltinėlis;1690407683;Taip;6;0;1;7
2813;Giraitė;Šaltinėlis;89948210310;Ne;0;4;0;4
2814;Giraitė;Šaltinėlis;26202357668;Taip;0;4;0;4
2815;Giraitė;Šaltinėlis;260305509;Taip;0;0;2;2
2816;Giraitė;Šaltinėlis;17883856522;Taip;0;0;1;1
2817;Giraitė;Šaltinėlis;1285310492;Taip;0;2;0;2
2818;Giraitė;Šaltinėlis;1424661991;Taip;4;0;1;5
2819;Giraitė;Boružėlės;5471577047;Taip;0;0;1;1
2820;Giraitė;Boružėlės;2307307454;Taip;8;0;2;10
2821;Giraitė;Boružėlės;7094750784;Taip;0;0;1;1
2822;Giraitė;Boružėlės;2102237550;Ne;0;0;1;1
2823;Giraitė;Boružėlės;1729871315;Taip;3;3;0;6
2824;Giraitė;Boružėlės;4317544803;Taip;3;0;0;3
2825;Giraitė;Boružėlės;5255040944;Taip;5;0;0;5
2826;Giraitė;Boružėlės;4843415587;Ne;8;0;0;8
2827;Giraitė;Boružėlės;9927102264;Taip;13;0;0;13
2828;Giraitė;Boružėlės;4717851198;Taip;0;0;1;1
2829;Giraitė;Gandriukai;69883334049;Taip;3;0;1;4
2830;Giraitė;Gandriukai;1025627643;Taip;3;0;3;6
2831;Giraitė;Gandriukai;26032013284;Taip;0;2;0;2
2832;Giraitė;Gandriukai;36650870278;Taip;0;2;0;2
2833;Giraitė;Gandriukai;82915040164;Taip;0;2;0;2
2834;Giraitė;Gandriukai;18968645937;Taip;2;0;3;5
2835;Giraitė;Gandriukai;64357457379;Taip;3;0;2;5
2836;Giraitė;Gandriukai;1238299747;Ne;12;0;0;12
2837;Giraitė;Gandriukai;2016939046;Taip;5;1;2;8
2838;Giraitė;Gandriukai;1111614295;Ne;7;10;0;17
2839;Giraitė;Gandriukai;9918028862;Taip;4;0;0;4
2840;Giraitė;Gandriukai;4031993742;Taip;10;0;2;12
2841;Giraitė;Gandriukai;2190246729;Ne;0;4;0;4
2842;Giraitė;Gandriukai;5810648237;Taip;7;0;1;8
2843;Giraitė;Gandriukai;5862292995;Taip;2;0;0;2
2844;Giraitė;Gandriukai;1375377927;Ne;0;0;4;4
2845;Giraitė;ŽVIRBLIUKAI;4444292550;Ne;0;19;0;19
2846;Giraitė;ŽVIRBLIUKAI;1958553421;Taip;0;8;3;11
2847;Giraitė;ŽVIRBLIUKAI;77765768952;Taip;0;4;0;4
2848;Giraitė;ŽVIRBLIUKAI;56380808064;Taip;5;4;0;9
2849;Giraitė;ŽVIRBLIUKAI;1181578380;Ne;10;10;0;20
2850;Giraitė;ŽVIRBLIUKAI;1234136698;Taip;3;12;0;15
2851;Giraitė;ŽVIRBLIUKAI;2065944230;Taip;0;0;2;2
2852;Giraitė;ŽVIRBLIUKAI;1464444782;Taip;7;0;0;7
2853;Giraitė;ŽVIRBLIUKAI;1435017557;Taip;10;0;0;10
2854;Giraitė;ŽVIRBLIUKAI;1149254911;Taip;0;2;0;2
2855;Giraitė;ŽVIRBLIUKAI;3628448974;Ne;0;9;0;9
2856;Giraitė;ŽVIRBLIUKAI;6973378079;Taip;0;0;3;3
2857;Giraitė;ŽVIRBLIUKAI;8000958461;Taip;3;0;0;3
2858;Giraitė;ŽVIRBLIUKAI;6233020671;Taip;2;0;1;3
2859;Giraitė;ŽVIRBLIUKAI;2990968206;Taip;0;5;4;9
2860;Giraitė;Kiškeliai;7551981095;Taip;5;1;0;6
2861;Giraitė;Kiškeliai;4009092043;Taip;3;1;0;4
2862;Giraitė;Kiškeliai;9392127689;Taip;10;0;1;11
2863;Giraitė;Kiškeliai;6677278422;Taip;2;0;0;2
2864;Giraitė;Kiškeliai;6715354865;Taip;0;0;1;1
2865;Giraitė;Kiškeliai;5086296808;Taip;0;0;1;1
2866;Giraitė;Kiškeliai;7395332578;Taip;4;0;1;5
2867;Giraitė;Kiškeliai;9471560738;Taip;0;0;1;1
2868;Giraitė;Kiškeliai;7230351549;Taip;0;0;4;4
2869;Giraitė;Kiškeliai;9114364139;Taip;0;0;2;2
2870;Giraitė;Kiškeliai;7678134658;Taip;0;0;1;1
2871;Giraitė;Kiškeliai;8873231715;Taip;0;0;1;1
2872;Giraitė;Kiškeliai;2416162886;Taip;3;0;3;6
2873;Gudrutis;Gandriukų;6742455931;Ne;0;0;1;1
2874;Gudrutis;Gandriukų;4193661251;Ne;13;0;0;13
2875;Gudrutis;Gandriukų;9042793284;Taip;0;2;0;2
2876;Gudrutis;Gandriukų;9797417587;Taip;0;4;0;4
2877;Gudrutis;Gandriukų;5574287734;Taip;0;10;0;10
2878;Gudrutis;Gandriukų;6747372184;Taip;7;7;1;15
2879;Gudrutis;Gandriukų;1693306014;Taip;0;6;0;6
2880;Gudrutis;Gandriukų;2074151024;Taip;16;0;0;16
2881;Gudrutis;Gandriukų;1991658503;Taip;0;8;0;8
2882;Gudrutis;Gandriukų;9841172472;Taip;8;0;2;10
2883;Gudrutis;Gandriukų;3359028602;Taip;10;0;2;12
2884;Gudrutis;Gandriukų;1445657342;Taip;11;0;0;11
2885;Gudrutis;Gandriukų;4945755164;Taip;0;3;3;6
2886;Gudrutis;Gandriukų;1190408818;Taip;0;2;9;11
2887;Gudrutis;Gandriukų;6443631536;Taip;0;7;2;9
2888;Gudrutis;"Saulės zuikučių";5720427655;Taip;0;0;8;8
2889;Gudrutis;"Saulės zuikučių";6868387598;Taip;0;0;5;5
2890;Gudrutis;"Saulės zuikučių";7773150642;Taip;2;0;1;3
2891;Gudrutis;"Saulės zuikučių";6835038962;Taip;0;0;6;6
2892;Gudrutis;"Saulės zuikučių";2118727861;Taip;0;0;2;2
2893;Gudrutis;"Saulės zuikučių";1725920873;Taip;0;0;1;1
2894;Gudrutis;"Saulės zuikučių";1901358996;Taip;7;0;0;7
2895;Gudrutis;"Saulės zuikučių";7664517480;Taip;15;5;0;20
2896;Gudrutis;"Saulės zuikučių";9701111916;Taip;5;0;2;7
2897;Gudrutis;"Saulės zuikučių";1228190677;Taip;4;0;2;6
2898;Gudrutis;"Saulės zuikučių";6198012431;Taip;10;0;2;12
2899;Gudrutis;"Saulės zuikučių";3646335609;Taip;0;0;11;11
2900;Gudrutis;"Saulės zuikučių";3625838131;Taip;0;6;0;6
2901;Gudrutis;"Saulės zuikučių";2337493193;Taip;0;15;0;15
2902;Gudrutis;"Saulės zuikučių";2764843216;Taip;0;12;0;12
2903;Gudrutis;"Saulės zuikučių";7955353991;Taip;4;0;0;4
2904;Gudrutis;"Saulės zuikučių";9847597133;Ne;0;0;1;1
2905;Gudrutis;Pelėdžiukų;1490739175;Taip;4;0;0;4
2906;Gudrutis;Pelėdžiukų;1823786522;Taip;0;1;0;1
2907;Gudrutis;Pelėdžiukų;1204945185;Taip;0;3;0;3
2908;Gudrutis;Pelėdžiukų;87981934125;Taip;0;1;0;1
2909;Gudrutis;Pelėdžiukų;1436950588;Taip;8;0;0;8
2910;Gudrutis;Pelėdžiukų;2453989647;Taip;0;0;6;6
2911;Gudrutis;Pelėdžiukų;1592255250;Taip;0;0;2;2
2912;Gudrutis;Pelėdžiukų;4392872175;Taip;0;0;1;1
2913;Gudrutis;Pelėdžiukų;1618442704;Taip;0;0;2;2
2914;Gudrutis;Pelėdžiukų;77776725399;Taip;0;8;0;8
2915;Gudrutis;Pelėdžiukų;8768627605;Taip;0;0;7;7
2916;Gudrutis;Pelėdžiukų;21494647270;Taip;0;4;0;4
2917;Gudrutis;Pelėdžiukų;18320321051;Taip;8;0;0;8
2918;Gudrutis;Pelėdžiukų;1156575830;Taip;15;0;0;15
2919;Gudrutis;Pelėdžiukų;74605225026;Taip;0;2;2;4
2920;Gudrutis;Pelėdžiukų;11383212272;Taip;3;1;0;4
2921;Gudrutis;Pelėdžiukų;1434565790;Taip;0;14;1;15
2922;Gudrutis;Pelėdžiukų;1238607523;Taip;0;1;0;1
2923;Gudrutis;Pelėdžiukų;1998630017;Taip;0;0;2;2
2924;Gudrutis;BITUČIŲ;98473509715;Taip;0;0;5;5
2925;Gudrutis;BITUČIŲ;2012092629;Taip;0;2;9;11
2926;Gudrutis;BITUČIŲ;4727651235;Ne;6;0;4;10
2927;Gudrutis;BITUČIŲ;81252457503;Taip;0;0;1;1
2928;Gudrutis;BITUČIŲ;28075147728;Ne;0;0;1;1
2929;Gudrutis;BITUČIŲ;69437346100;Ne;0;3;0;3
2930;Gudrutis;BITUČIŲ;38591847769;Taip;0;0;1;1
2931;Gudrutis;BITUČIŲ;14626533681;Taip;0;0;2;2
2932;Gudrutis;BITUČIŲ;1013150817;Taip;0;0;1;1
2933;Gudrutis;BITUČIŲ;71306450171;Ne;2;0;2;4
2934;Gudrutis;BITUČIŲ;13755502342;Taip;0;0;4;4
2935;Gudrutis;BITUČIŲ;1261390117;Ne;0;0;3;3
2936;Gudrutis;BITUČIŲ;33123804925;Taip;3;0;0;3
2937;Gudrutis;BITUČIŲ;11324963268;Taip;0;1;7;8
2938;Gudrutis;BITUČIŲ;15665148606;Taip;10;0;2;12
2939;Gudrutis;BITUČIŲ;62735575539;Taip;4;0;0;4
2940;Gudrutis;BITUČIŲ;21999129886;Taip;0;10;2;12
2941;Gudrutis;BITUČIŲ;85886111222;Ne;5;0;2;7
2942;Gudrutis;BITUČIŲ;74606626459;Taip;0;6;2;8
2943;Gudrutis;BITUČIŲ;3363640861;Taip;0;1;0;1
2944;Gudrutis;BITUČIŲ;6824283429;Taip;10;0;3;13
2945;Gudrutis;Boružėlių;7934673005;Taip;10;0;1;11
2946;Gudrutis;Boružėlių;7006545234;Ne;5;0;2;7
2947;Gudrutis;Boružėlių;2199222671;Taip;0;0;3;3
2948;Gudrutis;Boružėlių;1679709767;Taip;5;0;0;5
2949;Gudrutis;Boružėlių;4628728628;Taip;0;9;0;9
2950;Gudrutis;Boružėlių;1670550212;Taip;8;1;0;9
2951;Gudrutis;Boružėlių;5241856014;Taip;7;0;0;7
2952;Gudrutis;Boružėlių;2740093399;Ne;0;0;3;3
2953;Gudrutis;Boružėlių;8500911420;Taip;6;0;1;7
2954;Gudrutis;Boružėlių;5728436444;Taip;15;0;0;15
2955;Gudrutis;Boružėlių;9041133527;Taip;0;8;0;8
2956;Gudrutis;Boružėlių;9328365491;Taip;5;0;1;6
2957;Gudrutis;Boružėlių;2291393238;Taip;0;0;1;1
2958;Gudrutis;Boružėlių;1384696362;Taip;5;0;3;8
2959;Gudrutis;Drugeliai;7984911632;Taip;5;0;0;5
2960;Gudrutis;Drugeliai;8165828215;Taip;13;0;1;14
2961;Gudrutis;Drugeliai;1701035039;Taip;0;1;2;3
2962;Gudrutis;Drugeliai;7755882832;Taip;0;3;0;3
2963;Gudrutis;Drugeliai;8512130106;Taip;6;0;2;8
2964;Gudrutis;Drugeliai;3814794448;Taip;0;0;7;7
2965;Gudrutis;Drugeliai;9249913155;Taip;5;0;1;6
2966;Gudrutis;Drugeliai;5720427655;Taip;0;0;6;6
2967;Gudrutis;Drugeliai;2197278086;Taip;12;0;0;12
2968;Jurginėlis;Ąžuoliukai;7753784918;Ne;0;0;14;14
2969;Jurginėlis;Ąžuoliukai;4852619394;Taip;4;0;4;8
2970;Jurginėlis;Ąžuoliukai;8972814655;Taip;0;0;5;5
2971;Jurginėlis;Ąžuoliukai;1829089083;Taip;6;0;0;6
2972;Jurginėlis;Ąžuoliukai;8784076886;Taip;10;0;1;11
2973;Jurginėlis;Ąžuoliukai;47243459592;Taip;10;0;0;10
2974;Jurginėlis;Ąžuoliukai;1954364886;Taip;0;0;5;5
2975;Jurginėlis;Ąžuoliukai;3068120316;Taip;10;0;0;10
2976;Jurginėlis;Ąžuoliukai;6111863896;Taip;0;0;3;3
2977;Jurginėlis;Ąžuoliukai;4851923549;Taip;0;0;2;2
2978;Jurginėlis;Ąžuoliukai;1974388885;Ne;0;2;0;2
2979;Jurginėlis;Ąžuoliukai;8338173095;Ne;6;0;0;6
2980;Jurginėlis;Ąžuoliukai;9589394406;Taip;0;0;8;8
2981;Jurginėlis;Ąžuoliukai;3027573572;Taip;0;0;1;1
2982;Jurginėlis;Ąžuoliukai;2171115974;Taip;0;0;3;3
2983;Jurginėlis;Ąžuoliukai;8920304044;Taip;0;0;8;8
2984;Jurginėlis;Žiogeliai;5892180334;Taip;13;4;0;17
2985;Jurginėlis;Žiogeliai;8144038013;Taip;9;4;0;13
2986;Jurginėlis;Žiogeliai;7928799065;Taip;3;1;0;4
2987;Jurginėlis;Žiogeliai;2624313807;Taip;5;9;0;14
2988;Jurginėlis;Žiogeliai;1547101731;Taip;5;0;0;5
2989;Jurginėlis;Žiogeliai;5242359650;Ne;5;5;0;10
2990;Jurginėlis;Žiogeliai;903039398;Taip;0;1;0;1
2991;Jurginėlis;Žiogeliai;1759218238;Taip;4;0;0;4
2992;Jurginėlis;Žiogeliai;1102466152;Taip;0;4;0;4
2993;Jurginėlis;Žiogeliai;4806248290;Taip;0;3;0;3
2994;Jurginėlis;Žiogeliai;1082593212;Taip;0;12;0;12
2995;Jurginėlis;Žiogeliai;1175441410;Ne;0;4;0;4
2996;Jurginėlis;Žiogeliai;1983924909;Taip;0;1;0;1
2997;Jurginėlis;Žiogeliai;1586599624;Taip;5;2;0;7
2998;Jurginėlis;Žiogeliai;7297672386;Taip;0;3;0;3
2999;Jurginėlis;Žiogeliai;1787311340;Taip;0;10;0;10
3000;Jurginėlis;Žiogeliai;2535601005;Taip;5;0;0;5
3001;Jurginėlis;Žiogeliai;6413324051;Taip;4;4;0;8
3002;Jurginėlis;Žiogeliai;3708774681;Taip;3;5;0;8
3003;Jurginėlis;Pelėdžiukų;49181526821;Taip;0;2;1;3
3004;Jurginėlis;Pelėdžiukų;35653034443;Taip;0;5;0;5
3005;Jurginėlis;Pelėdžiukų;59935106302;Taip;0;0;8;8
3006;Jurginėlis;Pelėdžiukų;91317327949;Taip;0;7;0;7
3007;Jurginėlis;Pelėdžiukų;52877525045;Taip;0;3;0;3
3008;Jurginėlis;Pelėdžiukų;36829106143;Taip;0;0;1;1
3009;Jurginėlis;Pelėdžiukų;97726131559;Taip;7;0;0;7
3010;Jurginėlis;Pelėdžiukų;45200409204;Taip;0;5;0;5
3011;Jurginėlis;Pelėdžiukų;2544904907;Taip;15;1;0;16
3012;Jurginėlis;Pelėdžiukų;8414893303;Taip;5;0;0;5
3013;Jurginėlis;Pelėdžiukų;70733592257;Taip;13;0;0;13
3014;Jurginėlis;Pelėdžiukų;7449558199;Taip;10;0;0;10
3015;Jurginėlis;Pelėdžiukų;54494144846;Taip;10;8;0;18
3016;Jurginėlis;Pelėdžiukų;6072633581;Taip;0;11;0;11
3017;Jurginėlis;Pelėdžiukų;57340494605;Taip;0;1;1;2
3018;Jurginėlis;Pelėdžiukų;18273043496;Taip;0;1;0;1
3019;Jurginėlis;Pelėdžiukų;91909797332;Taip;0;1;0;1
3020;Jurginėlis;Pelėdžiukų;7278855565;Ne;2;1;0;3
3021;Jurginėlis;Pelėdžiukų;1295024976;Taip;0;0;2;2
3022;Jurginėlis;Pelėdžiukų;1416995981;Taip;0;4;1;5
3023;Jurginėlis;Boružėlių;92559573466;Ne;0;4;0;4
3024;Jurginėlis;Boružėlių;7798931951;Taip;0;7;0;7
3025;Jurginėlis;Boružėlių;59618430487;Taip;6;0;0;6
3026;Jurginėlis;Boružėlių;13085086595;Taip;0;1;0;1
3027;Jurginėlis;Boružėlių;8217773164;Taip;12;0;0;12
3028;Jurginėlis;Boružėlių;29601247012;Taip;0;7;0;7
3029;Jurginėlis;Boružėlių;75192831969;Taip;0;9;0;9
3030;Jurginėlis;Boružėlių;29155768493;Ne;0;11;0;11
3031;Jurginėlis;Boružėlių;10095155757;Taip;0;3;0;3
3032;Jurginėlis;Boružėlių;67578476769;Taip;0;6;0;6
3033;Jurginėlis;Boružėlių;64852957209;Taip;5;7;0;12
3034;Jurginėlis;Boružėlių;64641268493;Taip;3;1;0;4
3035;Jurginėlis;Boružėlių;56382554421;Taip;0;2;0;2
3036;Jurginėlis;Boružėlių;51856181602;Ne;5;3;0;8
3037;Jurginėlis;Boružėlių;23049094719;Taip;0;2;0;2
3038;Jurginėlis;Boružėlių;1742217696;Ne;0;1;0;1
3039;Jurginėlis;Boružėlių;1868080361;Taip;5;0;0;5
3040;Jurginėlis;Bitučių;2106937059;Ne;0;4;0;4
3041;Jurginėlis;Bitučių;93055778306;Taip;0;2;0;2
3042;Jurginėlis;Bitučių;92688596347;Ne;0;3;0;3
3043;Jurginėlis;Bitučių;1175198086;Taip;0;5;0;5
3044;Jurginėlis;Bitučių;96017651718;Taip;0;1;0;1
3045;Jurginėlis;Bitučių;87566883270;Ne;0;2;0;2
3046;Jurginėlis;Bitučių;84691244839;Taip;0;2;0;2
3047;Jurginėlis;Bitučių;53783266582;Taip;0;11;0;11
3048;Jurginėlis;Bitučių;2557687323;Taip;0;5;0;5
3049;Jurginėlis;Bitučių;1421681717;Ne;5;0;4;9
3050;Jurginėlis;Bitučių;24615714793;Taip;0;1;0;1
3051;Jurginėlis;Bitučių;1058274970;Taip;0;0;8;8
3052;Jurginėlis;Bitučių;64524305038;Taip;0;1;0;1
3053;Jurginėlis;Bitučių;90786336005;Taip;2;7;0;9
3054;Jurginėlis;Bitučių;1191021311;Taip;0;5;0;5
3055;Jurginėlis;Skruzdeliukų;1343532870;Ne;0;1;0;1
3056;Jurginėlis;Skruzdeliukų;92602685294;Taip;2;2;0;4
3057;Jurginėlis;Skruzdeliukų;1485725580;Taip;3;1;0;4
3058;Jurginėlis;Skruzdeliukų;51685299187;Ne;0;2;0;2
3059;Jurginėlis;Skruzdeliukų;1881790340;Taip;0;17;0;17
3060;Jurginėlis;Skruzdeliukų;94107758268;Taip;0;12;2;14
3061;Jurginėlis;Skruzdeliukų;77480957625;Taip;0;2;1;3
3062;Jurginėlis;Skruzdeliukų;1258821883;Taip;0;0;2;2
3063;Jurginėlis;Skruzdeliukų;38755774035;Taip;4;0;0;4
3064;Jurginėlis;Skruzdeliukų;68109772993;Ne;19;0;0;19
3065;Jurginėlis;Skruzdeliukų;17286700686;Ne;4;0;0;4
3066;Jurginėlis;Skruzdeliukų;1506649972;Taip;0;1;0;1
3067;Jurginėlis;Drugelių;6181547354;Taip;22;0;0;22
3068;Jurginėlis;Drugelių;2221708420;Taip;5;0;1;6
3069;Jurginėlis;Drugelių;1340689348;Taip;10;5;0;15
3070;Jurginėlis;Drugelių;2925253653;Taip;0;0;1;1
3071;Jurginėlis;Drugelių;4967548277;Taip;8;8;2;18
3072;Jurginėlis;Drugelių;8443412187;Taip;0;0;1;1
3073;Jurginėlis;Drugelių;8779807396;Ne;5;0;6;11
3074;Jurginėlis;Drugelių;9507571301;Ne;0;0;4;4
3075;Jurginėlis;Drugelių;4292932046;Ne;0;0;2;2
3076;Jurginėlis;Drugelių;6968528293;Taip;0;4;0;4
3077;Jurginėlis;Drugelių;7809274980;Taip;0;0;1;1
3078;Jurginėlis;Drugelių;9946892497;Taip;11;0;6;17
3079;Jurginėlis;Drugelių;1455749921;Taip;13;8;0;21
3080;Jurginėlis;Drugelių;3079495897;Taip;0;0;3;3
3081;Jurginėlis;Drugelių;5984893389;Taip;0;11;0;11
3082;Jurginėlis;Drugelių;2490875633;Taip;8;0;0;8
3083;Jurginėlis;Drugelių;8727844649;Taip;9;0;0;9
3084;Jurginėlis;Drugelių;8876608072;Taip;0;0;7;7
3085;Jurginėlis;Žibučių;3284464951;Taip;14;0;0;14
3086;Jurginėlis;Žibučių;4158502752;Taip;5;2;0;7
3087;Jurginėlis;Žibučių;1656335765;Taip;1;0;0;1
3088;Jurginėlis;Žibučių;7990015623;Taip;15;0;0;15
3089;Jurginėlis;Žibučių;6579565337;Taip;9;0;0;9
3090;Jurginėlis;Žibučių;5921714669;Taip;4;0;0;4
3091;Jurginėlis;Žibučių;4463258777;Taip;5;0;1;6
3092;Jurginėlis;Žibučių;4827340942;Ne;7;0;0;7
3093;Jurginėlis;Žibučių;2627736026;Taip;16;1;0;17
3094;Jurginėlis;Žibučių;2548920722;Taip;7;0;0;7
3095;Jurginėlis;Žibučių;6806704355;Taip;9;6;0;15
3096;Jurginėlis;Žibučių;9882919290;Taip;0;1;0;1
3097;Jurginėlis;Žibučių;3627487971;Taip;7;0;0;7
3098;Jurginėlis;Žibučių;1656335765;Taip;1;0;0;1
3099;Jurginėlis;Žibučių;2225892248;Taip;5;0;2;7
3100;Jurginėlis;Žibučių;1414888906;Taip;0;0;2;2
3101;Jurginėlis;Žibučių;7288921301;Ne;6;0;0;6
3102;Jurginėlis;Žibučių;3031725530;Taip;6;0;1;7
3103;Jurginėlis;Žibučių;2364890732;Taip;0;0;1;1
3104;Jurginėlis;Zuikučių;6217229672;Ne;0;2;0;2
3105;Jurginėlis;Zuikučių;1762685527;Ne;6;5;1;12
3106;Jurginėlis;Zuikučių;1649208522;Ne;0;0;1;1
3107;Jurginėlis;Zuikučių;8084970770;Taip;10;0;0;10
3108;Jurginėlis;Zuikučių;87991288027;Ne;7;0;1;8
3109;Jurginėlis;Zuikučių;1400142372;Taip;0;1;0;1
3110;Jurginėlis;Zuikučių;1656300401;Taip;5;2;0;7
3111;Jurginėlis;Zuikučių;1759031589;Taip;0;6;0;6
3112;Jurginėlis;Zuikučių;1945098580;Taip;0;1;0;1
3113;Jurginėlis;Zuikučių;1409480187;Ne;0;1;0;1
3114;Jurginėlis;Zuikučių;1780106633;Taip;0;1;0;1
3115;Jurginėlis;Zuikučių;8793129805;Taip;0;1;0;1
3116;Jurginėlis;Zuikučių;74303787465;Taip;5;3;0;8
3117;Jurginėlis;Zuikučių;9320841905;Taip;0;0;22;22
3118;Jurginėlis;Zuikučių;1434737480;Taip;3;0;0;3
3119;Jurginėlis;Zuikučių;7293372539;Ne;5;0;0;5
3120;Jurginėlis;Zuikučių;5386710069;Taip;3;0;0;3
3121;Jurginėlis;Zuikučių;7920082372;Ne;11;0;0;11
3122;Jurginėlis;Viščiukų;5734506036;Taip;0;5;0;5
3123;Jurginėlis;Viščiukų;1726968598;Taip;0;2;0;2
3124;Jurginėlis;Viščiukų;9550110246;Taip;5;1;0;6
3125;Jurginėlis;Viščiukų;9506129699;Taip;15;0;0;15
3126;Jurginėlis;Viščiukų;3038732180;Taip;18;0;0;18
3127;Jurginėlis;Viščiukų;3541542063;Taip;0;0;2;2
3128;Jurginėlis;Viščiukų;9961083854;Taip;12;7;0;19
3129;Jurginėlis;Viščiukų;3699180485;Taip;0;4;0;4
3130;Jurginėlis;Viščiukų;4536086996;Taip;0;0;1;1
3131;Jurginėlis;Viščiukų;6542567172;Taip;11;0;0;11
3132;Jurginėlis;Viščiukų;3069264952;Taip;0;0;1;1
3133;Jurginėlis;Meškiukų;9850874714;Taip;0;0;1;1
3134;Jurginėlis;Meškiukų;3530906368;Ne;0;0;1;1
3135;Jurginėlis;Meškiukų;6587382160;Taip;11;0;1;12
3136;Jurginėlis;Meškiukų;1351306981;Taip;11;0;0;11
3137;Jurginėlis;Meškiukų;5652597514;Taip;1;1;0;2
3138;Jurginėlis;Meškiukų;4432849717;Taip;0;6;0;6
3139;Jurginėlis;Meškiukų;6671759364;Taip;5;0;4;9
3140;Jurginėlis;Meškiukų;9146039217;Taip;12;0;0;12
3141;Jurginėlis;Meškiukų;3558752347;Taip;3;3;0;6
3142;Jurginėlis;Meškiukų;8161347781;Taip;0;8;0;8
3143;Jurginėlis;Gandriukų;7419836868;Taip;0;7;0;7
3144;Jurginėlis;Gandriukų;51603579121;Ne;0;5;0;5
3145;Jurginėlis;Gandriukų;87444065733;Taip;5;8;0;13
3146;Jurginėlis;Gandriukų;2179884441;Taip;0;14;6;20
3147;Jurginėlis;Gandriukų;2264351097;Taip;0;0;2;2
3148;Jurginėlis;Gandriukų;78496894090;Taip;0;14;0;14
3149;Jurginėlis;Gandriukų;99523320519;Taip;0;0;8;8
3150;Jurginėlis;Gandriukų;1498351759;Ne;0;0;1;1
3151;Jurginėlis;Gandriukų;75383941896;Taip;3;1;0;4
3152;Jurginėlis;Gandriukų;1508705709;Taip;0;2;0;2
3153;Jurginėlis;Gandriukų;1773100970;Taip;4;0;1;5
3154;Jurginėlis;Gandriukų;1500087367;Taip;4;0;1;5
3155;Jurginėlis;Gandriukų;43368987046;Taip;5;0;0;5
3156;Jurginėlis;Gandriukų;6707289955;Taip;2;0;0;2
3157;Jurginėlis;Gandriukų;1927843089;Taip;2;0;0;2
3158;Jurginėlis;Gandriukų;8178112926;Taip;4;1;0;5
3159;Jurginėlis;Gandriukų;6475508583;Taip;11;0;5;16
3160;Jurginėlis;Gandriukų;9714764714;Ne;9;0;4;13
3161;Jurginėlis;Gandriukų;5756997642;Ne;6;1;7;14
3162;Karusėlė;PAGRANDUKAS;6183785840;Taip;0;5;0;5
3163;Karusėlė;PAGRANDUKAS;3984262482;Taip;11;2;0;13
3164;Karusėlė;PAGRANDUKAS;9130534156;Taip;6;0;1;7
3165;Karusėlė;PAGRANDUKAS;3660843696;Taip;11;0;3;14
3166;Karusėlė;PAGRANDUKAS;9805481603;Taip;15;0;0;15
3167;Karusėlė;PAGRANDUKAS;1412890120;Taip;6;6;0;12
3168;Karusėlė;PAGRANDUKAS;5132581245;Taip;9;0;0;9
3169;Karusėlė;PAGRANDUKAS;2160071272;Taip;0;5;0;5
3170;Karusėlė;PAGRANDUKAS;9462242426;Taip;2;0;9;11
3171;Karusėlė;PAGRANDUKAS;2412418335;Taip;9;1;0;10
3172;Karusėlė;PAGRANDUKAS;7393434659;Taip;2;0;0;2
3173;Karusėlė;PAGRANDUKAS;6826455161;Taip;0;0;3;3
3174;Karusėlė;PAGRANDUKAS;5695697634;Taip;6;0;1;7
3175;Karusėlė;PAGRANDUKAS;8127218866;Taip;5;0;0;5
3176;Karusėlė;PAGRANDUKAS;6062361348;Taip;10;0;0;10
3177;Karusėlė;PAGRANDUKAS;3620722907;Taip;15;0;0;15
3178;Karusėlė;PAGRANDUKAS;7013765804;Taip;22;0;0;22
3179;Karusėlė;PAGRANDUKAS;3429495073;Taip;7;0;0;7
3180;Karusėlė;PAGRANDUKAS;5951045233;Taip;9;0;1;10
3181;Karusėlė;PAGRANDUKAS;6252613489;Taip;8;2;0;10
3182;Karusėlė;PAGRANDUKAS;5595950213;Taip;10;0;0;10
3183;Karusėlė;NYKŠTUKAS;82963400142;Taip;17;0;0;17
3184;Karusėlė;NYKŠTUKAS;1567290218;Taip;0;2;0;2
3185;Karusėlė;NYKŠTUKAS;77290004668;Ne;0;0;1;1
3186;Karusėlė;NYKŠTUKAS;1250530261;Taip;5;7;0;12
3187;Karusėlė;NYKŠTUKAS;1397009220;Taip;0;7;0;7
3188;Karusėlė;NYKŠTUKAS;2064301292;Taip;2;0;0;2
3189;Karusėlė;NYKŠTUKAS;96150256487;Taip;6;0;0;6
3190;Karusėlė;NYKŠTUKAS;1680275369;Taip;10;0;0;10
3191;Karusėlė;NYKŠTUKAS;17728195505;Taip;0;1;0;1
3192;Karusėlė;NYKŠTUKAS;1534689679;Taip;0;0;1;1
3193;Karusėlė;NYKŠTUKAS;1226371512;Taip;18;0;1;19
3194;Karusėlė;NYKŠTUKAS;1311631554;Ne;11;0;0;11
3195;Karusėlė;NYKŠTUKAS;5481354767;Taip;3;0;0;3
3196;Karusėlė;NYKŠTUKAS;1135386852;Taip;1;0;0;1
3197;Karusėlė;NYKŠTUKAS;8419242504;Taip;21;0;0;21
3198;Karusėlė;NYKŠTUKAS;3875204515;Taip;5;0;0;5
3199;Karusėlė;NYKŠTUKAS;45634061915;Taip;0;16;0;16
3200;Karusėlė;BITUTĖ;33892845154;Taip;4;0;0;4
3201;Karusėlė;BITUTĖ;2526585854;Taip;0;4;0;4
3202;Karusėlė;BITUTĖ;15575896909;Taip;3;1;0;4
3203;Karusėlė;BITUTĖ;1839186035;Ne;0;2;0;2
3204;Karusėlė;BITUTĖ;2653604193;Taip;11;0;0;11
3205;Karusėlė;BITUTĖ;1065703569;Taip;10;7;0;17
3206;Karusėlė;BITUTĖ;1295435839;Taip;0;10;0;10
3207;Karusėlė;BITUTĖ;1883944064;Ne;2;0;0;2
3208;Karusėlė;BITUTĖ;3870601809;Taip;7;0;0;7
3209;Karusėlė;BITUTĖ;2001623432;Taip;13;0;0;13
3210;Karusėlė;BITUTĖ;8033732937;Taip;11;0;0;11
3211;Karusėlė;BITUTĖ;1798723081;Ne;0;3;0;3
3212;Karusėlė;BITUTĖ;88371238657;Taip;5;0;0;5
3213;Karusėlė;BITUTĖ;1593728369;Taip;12;0;0;12
3214;Karusėlė;BITUTĖ;1809033214;Taip;0;5;0;5
3215;Karusėlė;BITUTĖ;9065247151;Taip;0;4;0;4
3216;Karusėlė;BITUTĖ;75574841532;Ne;4;0;0;4
3217;Karusėlė;BITUTĖ;25581881402;Taip;0;4;0;4
3218;Karusėlė;BITUTĖ;6417699445;Taip;4;0;0;4
3219;Karusėlė;BORUŽĖLĖ;1705790474;Taip;0;1;0;1
3220;Karusėlė;BORUŽĖLĖ;4890393582;Taip;7;1;0;8
3221;Karusėlė;BORUŽĖLĖ;1311907441;Taip;0;2;0;2
3222;Karusėlė;BORUŽĖLĖ;6313010762;Taip;0;11;0;11
3223;Karusėlė;BORUŽĖLĖ;5859827168;Taip;0;0;3;3
3224;Karusėlė;BORUŽĖLĖ;37349219339;Taip;8;3;0;11
3225;Karusėlė;BORUŽĖLĖ;49110267692;Taip;0;0;10;10
3226;Karusėlė;BORUŽĖLĖ;6811862463;Taip;0;10;0;10
3227;Karusėlė;BORUŽĖLĖ;5471989295;Taip;14;1;0;15
3228;Karusėlė;BORUŽĖLĖ;9753876554;Taip;14;1;0;15
3229;Karusėlė;BORUŽĖLĖ;1204919995;Taip;20;0;0;20
3230;Karusėlė;BORUŽĖLĖ;8717484092;Taip;0;0;1;1
3231;Karusėlė;BORUŽĖLĖ;5351690991;Taip;10;0;0;10
3232;Karusėlė;BORUŽĖLĖ;1994682683;Taip;0;0;1;1
3233;Karusėlė;BORUŽĖLĖ;4845558814;Taip;10;6;0;16
3234;Karusėlė;BORUŽĖLĖ;8406462155;Ne;6;0;0;6
3235;Karusėlė;BORUŽĖLĖ;6495631086;Ne;4;0;0;4
3236;Karusėlė;BORUŽĖLĖ;1183484176;Taip;0;8;0;8
3237;Karusėlė;UOGELĖ;8182071103;Taip;2;9;0;11
3238;Karusėlė;UOGELĖ;8175498192;Taip;5;0;2;7
3239;Karusėlė;UOGELĖ;3053539045;Taip;4;0;0;4
3240;Karusėlė;UOGELĖ;9992989896;Taip;0;0;1;1
3241;Karusėlė;UOGELĖ;2084276906;Taip;9;2;0;11
3242;Karusėlė;UOGELĖ;1098106063;Taip;0;0;5;5
3243;Karusėlė;UOGELĖ;8665314366;Taip;0;7;0;7
3244;Karusėlė;UOGELĖ;5651238035;Taip;3;0;0;3
3245;Karusėlė;UOGELĖ;4121668687;Taip;4;0;0;4
3246;Karusėlė;UOGELĖ;8316147204;Taip;7;2;0;9
3247;Karusėlė;UOGELĖ;5504719953;Ne;5;0;12;17
3248;Karusėlė;UOGELĖ;5919009583;Taip;22;0;0;22
3249;Karusėlė;UOGELĖ;4199597984;Taip;0;1;0;1
3250;Karusėlė;UOGELĖ;2383023280;Taip;0;8;0;8
3251;Karusėlė;UOGELĖ;1575408822;Taip;3;3;5;11
3252;Karusėlė;UOGELĖ;3917113787;Taip;0;2;0;2
3253;Karusėlė;UOGELĖ;4068106379;Taip;0;0;5;5
3254;Karusėlė;UOGELĖ;1428516421;Taip;0;0;3;3
3255;Karusėlė;UOGELĖ;3615957761;Taip;7;6;0;13
3256;Karusėlė;UOGELĖ;3514026443;Taip;7;2;0;9
3257;Karusėlė;UOGELĖ;1891147022;Taip;0;0;6;6
3258;Karusėlė;UOGELĖ;9389017016;Taip;0;0;1;1
3259;Karusėlė;GINTARĖLIS;89669425763;Taip;20;0;0;20
3260;Karusėlė;GINTARĖLIS;1058129883;Taip;10;1;0;11
3261;Karusėlė;GINTARĖLIS;1625704473;Taip;0;4;0;4
3262;Karusėlė;GINTARĖLIS;5267055924;Ne;0;1;0;1
3263;Karusėlė;GINTARĖLIS;17254955427;Taip;5;2;0;7
3264;Karusėlė;GINTARĖLIS;1467237683;Taip;0;2;0;2
3265;Karusėlė;GINTARĖLIS;33935704865;Taip;0;4;0;4
3266;Karusėlė;GINTARĖLIS;92286460424;Taip;12;6;0;18
3267;Karusėlė;GINTARĖLIS;80377577910;Taip;0;12;0;12
3268;Karusėlė;GINTARĖLIS;1302846796;Taip;10;2;0;12
3269;Karusėlė;GINTARĖLIS;6181109173;Ne;0;1;0;1
3270;Karusėlė;GINTARĖLIS;65387251381;Ne;0;2;0;2
3271;Karusėlė;GINTARĖLIS;90635580825;Taip;0;0;3;3
3272;Karusėlė;GINTARĖLIS;93635113154;Taip;0;2;1;3
3273;Karusėlė;GINTARĖLIS;2386140324;Taip;6;5;0;11
3274;Karusėlė;GINTARĖLIS;90731574209;Ne;10;1;0;11
3275;Karusėlė;GINTARĖLIS;77007130834;Taip;0;15;0;15
3276;Karusėlė;GINTARĖLIS;6596029324;Taip;9;5;0;14
3277;Karusėlė;GINTARĖLIS;1477282992;Taip;0;8;0;8
3278;Karusėlė;GINTARĖLIS;1487641646;Taip;0;5;0;5
3279;Karusėlė;SAULUTĖ;1705251019;Taip;0;1;0;1
3280;Karusėlė;SAULUTĖ;64855471225;Taip;7;2;0;9
3281;Karusėlė;SAULUTĖ;45701480267;Taip;6;0;0;6
3282;Karusėlė;SAULUTĖ;35910852843;Taip;0;1;0;1
3283;Karusėlė;SAULUTĖ;1198992954;Taip;0;7;0;7
3284;Karusėlė;SAULUTĖ;1223992311;Taip;0;2;0;2
3285;Karusėlė;SAULUTĖ;6702329224;Taip;12;0;0;12
3286;Karusėlė;SAULUTĖ;1239411995;Ne;7;0;0;7
3287;Karusėlė;SAULUTĖ;4806666157;Ne;0;2;0;2
3288;Karusėlė;SAULUTĖ;10539595272;Taip;15;0;0;15
3289;Karusėlė;SAULUTĖ;52452661421;Taip;0;2;0;2
3290;Karusėlė;SAULUTĖ;2606829789;Ne;0;1;0;1
3291;Karusėlė;SAULUTĖ;91676265927;Taip;10;0;0;10
3292;Karusėlė;SAULUTĖ;63044693440;Taip;6;0;0;6
3293;Karusėlė;SAULUTĖ;23662916408;Taip;0;7;0;7
3294;Karusėlė;SAULUTĖ;99462674291;Taip;13;0;1;14
3295;Karusėlė;SAULUTĖ;59790578013;Taip;4;0;0;4
3296;Karusėlė;SAULUTĖ;2025180617;Taip;0;1;0;1
3297;Karusėlė;SAULUTĖ;7977835762;Taip;0;22;0;22
3298;Karusėlė;SAULUTĖ;1273810363;Taip;1;2;0;3
3299;Karusėlė;SAULUTĖ;25328680614;Taip;0;1;0;1
3300;Karusėlė;TIGRIUKAS;1982126099;Taip;10;0;0;10
3301;Karusėlė;TIGRIUKAS;1292576152;Taip;10;0;0;10
3302;Karusėlė;TIGRIUKAS;18831943978;Taip;0;1;0;1
3303;Karusėlė;TIGRIUKAS;1305485683;Taip;4;2;0;6
3304;Karusėlė;TIGRIUKAS;1817869518;Taip;17;1;0;18
3305;Karusėlė;TIGRIUKAS;1193711193;Taip;0;4;0;4
3306;Karusėlė;TIGRIUKAS;1773362652;Taip;5;0;0;5
3307;Karusėlė;TIGRIUKAS;3752570475;Ne;10;1;0;11
3308;Karusėlė;TIGRIUKAS;8881750322;Taip;2;0;0;2
3309;Karusėlė;TIGRIUKAS;8946147763;Taip;3;0;0;3
3310;Karusėlė;TIGRIUKAS;3960354989;Taip;10;0;0;10
3311;Karusėlė;TIGRIUKAS;1947403400;Taip;5;0;0;5
3312;Karusėlė;TIGRIUKAS;3690179876;Ne;15;0;0;15
3313;Karusėlė;TIGRIUKAS;7947148051;Taip;10;1;0;11
3314;Karusėlė;TIGRIUKAS;8076851284;Ne;9;0;0;9
3315;Karusėlė;TIGRIUKAS;5135054911;Taip;10;0;1;11
3316;Karusėlė;TIGRIUKAS;4426462711;Taip;12;0;0;12
3317;Karusėlė;TIGRIUKAS;8656806219;Taip;6;3;0;9
3318;Karusėlė;TIGRIUKAS;6004882312;Taip;7;1;0;8
3319;Karusėlė;TIGRIUKAS;9484773068;Ne;9;0;0;9
3320;Karusėlė;TIGRIUKAS;8678437720;Taip;5;2;0;7
3321;Karusėlė;TIGRIUKAS;9868386182;Taip;5;0;0;5
3322;Karusėlė;TIGRIUKAS;1698478530;Taip;7;2;0;9
3323;Karusėlė;VAIVORYKŠTĖ;89727334417;Taip;5;9;0;14
3324;Karusėlė;VAIVORYKŠTĖ;21474974272;Taip;0;0;2;2
3325;Karusėlė;VAIVORYKŠTĖ;1629901230;Taip;0;3;0;3
3326;Karusėlė;VAIVORYKŠTĖ;2092642601;Taip;0;8;0;8
3327;Karusėlė;VAIVORYKŠTĖ;1886562437;Taip;0;6;0;6
3328;Karusėlė;VAIVORYKŠTĖ;1094853107;Taip;0;9;0;9
3329;Karusėlė;VAIVORYKŠTĖ;40499469616;Ne;0;3;0;3
3330;Karusėlė;VAIVORYKŠTĖ;94058192792;Taip;0;0;2;2
3331;Karusėlė;VAIVORYKŠTĖ;78971949838;Taip;0;12;0;12
3332;Karusėlė;VAIVORYKŠTĖ;25859211954;Taip;8;0;0;8
3333;Karusėlė;VAIVORYKŠTĖ;47751458940;Taip;0;2;0;2
3334;Karusėlė;VAIVORYKŠTĖ;4878805177;Taip;0;0;1;1
3335;Karusėlė;VAIVORYKŠTĖ;68537797465;Taip;0;7;0;7
3336;Karusėlė;VAIVORYKŠTĖ;11336671763;Ne;0;9;0;9
3337;Karusėlė;VAIVORYKŠTĖ;9482894921;Taip;0;6;0;6
3338;Karusėlė;VAIVORYKŠTĖ;6580115367;Taip;15;0;1;16
3339;Karusėlė;VAIVORYKŠTĖ;1982350605;Taip;14;0;2;16
3340;Karusėlė;"AUKSINĖ ŽUVELĖ";1289442716;Taip;4;0;2;6
3341;Karusėlė;"AUKSINĖ ŽUVELĖ";9855242602;Taip;4;0;1;5
3342;Karusėlė;"AUKSINĖ ŽUVELĖ";5627583683;Taip;5;0;1;6
3343;Karusėlė;"AUKSINĖ ŽUVELĖ";9561892809;Taip;12;0;0;12
3344;Karusėlė;"AUKSINĖ ŽUVELĖ";2894817418;Taip;21;0;0;21
3345;Karusėlė;"AUKSINĖ ŽUVELĖ";6546648346;Taip;3;6;0;9
3346;Karusėlė;"AUKSINĖ ŽUVELĖ";1581504806;Taip;6;1;0;7
3347;Karusėlė;"AUKSINĖ ŽUVELĖ";5985915835;Taip;2;0;0;2
3348;Karusėlė;"AUKSINĖ ŽUVELĖ";8063412271;Taip;9;0;0;9
3349;Karusėlė;"AUKSINĖ ŽUVELĖ";9408843254;Taip;7;0;2;9
3350;Karusėlė;"AUKSINĖ ŽUVELĖ";2242659064;Taip;10;0;0;10
3351;Karusėlė;"AUKSINĖ ŽUVELĖ";3514315636;Taip;4;0;0;4
3352;Karusėlė;"AUKSINĖ ŽUVELĖ";8085919723;Taip;4;0;0;4
3353;Karusėlė;"AUKSINĖ ŽUVELĖ";5444753290;Taip;8;0;0;8
3354;Karusėlė;RAMUNĖ;2381566229;Taip;16;1;0;17
3355;Karusėlė;RAMUNĖ;9344514262;Taip;17;0;0;17
3356;Karusėlė;RAMUNĖ;2215367063;Ne;5;10;0;15
3357;Karusėlė;RAMUNĖ;5146709341;Taip;0;1;0;1
3358;Karusėlė;RAMUNĖ;8331985564;Ne;5;1;1;7
3359;Karusėlė;RAMUNĖ;5803808409;Taip;10;0;0;10
3360;Karusėlė;RAMUNĖ;9400171357;Taip;10;3;0;13
3361;Karusėlė;RAMUNĖ;5766390337;Taip;8;3;0;11
3362;Karusėlė;RAMUNĖ;2007411601;Taip;9;4;0;13
3363;Karusėlė;RAMUNĖ;9996567374;Taip;0;10;0;10
3364;Karusėlė;RAMUNĖ;3696178849;Taip;16;0;0;16
3365;Karusėlė;RAMUNĖ;7814525717;Taip;8;0;0;8
3366;Karusėlė;RAMUNĖ;7489136297;Taip;10;0;0;10
3367;Kaštonas;NYKŠTUKAI;81834426663;Taip;8;1;0;9
3368;Kaštonas;NYKŠTUKAI;1781481896;Taip;0;6;0;6
3369;Kaštonas;NYKŠTUKAI;6701145026;Taip;5;1;0;6
3370;Kaštonas;NYKŠTUKAI;9287426151;Taip;0;3;0;3
3371;Kaštonas;NYKŠTUKAI;9168456496;Taip;0;6;0;6
3372;Kaštonas;NYKŠTUKAI;8990194475;Taip;5;11;0;16
3373;Kaštonas;NYKŠTUKAI;9702914628;Taip;5;4;0;9
3374;Kaštonas;NYKŠTUKAI;41221846403;Taip;7;4;0;11
3375;Kaštonas;NYKŠTUKAI;3773227028;Taip;0;2;0;2
3376;Kaštonas;NYKŠTUKAI;8564586014;Taip;1;12;0;13
3377;Kaštonas;NYKŠTUKAI;5099098185;Taip;0;1;0;1
3378;Kaštonas;NYKŠTUKAI;8166925991;Taip;20;0;0;20
3379;Kaštonas;NYKŠTUKAI;2417951642;Taip;1;1;0;2
3380;Kaštonas;NYKŠTUKAI;6511223066;Ne;0;4;0;4
3381;Kaštonas;NYKŠTUKAI;7519302152;Ne;0;3;0;3
3382;Kaštonas;NYKŠTUKAI;5884427036;Taip;10;0;0;10
3383;Kaštonas;DRUGELIAI;7641793210;Taip;0;3;0;3
3384;Kaštonas;DRUGELIAI;54580238237;Taip;1;1;0;2
3385;Kaštonas;DRUGELIAI;17123843027;Ne;0;15;0;15
3386;Kaštonas;DRUGELIAI;16395082273;Taip;2;1;0;3
3387;Kaštonas;DRUGELIAI;7229267783;Taip;6;0;0;6
3388;Kaštonas;DRUGELIAI;47802818774;Taip;0;1;0;1
3389;Kaštonas;DRUGELIAI;52064859848;Taip;0;2;0;2
3390;Kaštonas;DRUGELIAI;8748600333;Taip;0;7;0;7
3391;Kaštonas;DRUGELIAI;87941682538;Taip;0;1;0;1
3392;Kaštonas;DRUGELIAI;37382772659;Ne;4;2;0;6
3393;Kaštonas;DRUGELIAI;1186956315;Taip;0;1;0;1
3394;Kaštonas;DRUGELIAI;7481170301;Taip;0;4;0;4
3395;Kaštonas;DRUGELIAI;76576870173;Taip;3;0;0;3
3396;Kaštonas;DRUGELIAI;1313119270;Taip;5;0;0;5
3397;Kaštonas;DRUGELIAI;41926955433;Taip;0;1;0;1
3398;Kaštonas;DRUGELIAI;1023364928;Taip;6;0;0;6
3399;Kaštonas;DRUGELIAI;1152555202;Ne;0;4;0;4
3400;Kaštonas;DRUGELIAI;46191613797;Ne;0;6;0;6
3401;Kaštonas;DRUGELIAI;1626798162;Taip;0;6;0;6
3402;Kaštonas;DRUGELIAI;1931800904;Ne;7;2;0;9
3403;Kaštonas;DRUGELIAI;2764004779;Taip;5;9;0;14
3404;Kaštonas;DRUGELIAI;89221382880;Taip;0;4;0;4
3405;Kaštonas;KIŠKUČIAI;5610113641;Taip;13;1;0;14
3406;Kaštonas;KIŠKUČIAI;7553024183;Taip;0;22;0;22
3407;Kaštonas;KIŠKUČIAI;8151333699;Taip;0;1;0;1
3408;Kaštonas;KIŠKUČIAI;7841179083;Taip;0;22;0;22
3409;Kaštonas;KIŠKUČIAI;3649329598;Taip;5;4;0;9
3410;Kaštonas;KIŠKUČIAI;7508357392;Taip;9;1;0;10
3411;Kaštonas;KIŠKUČIAI;7956422880;Taip;0;10;0;10
3412;Kaštonas;KIŠKUČIAI;5328263421;Taip;7;1;0;8
3413;Kaštonas;KIŠKUČIAI;4033866425;Taip;0;2;0;2
3414;Kaštonas;KIŠKUČIAI;3961661158;Taip;0;3;0;3
3415;Kaštonas;KIŠKUČIAI;6251564828;Taip;6;5;0;11
3416;Kaštonas;KIŠKUČIAI;7291448857;Taip;0;5;0;5
3417;Kaštonas;KIŠKUČIAI;6175014441;Taip;9;0;0;9
3418;Kaštonas;KIŠKUČIAI;4450146424;Taip;0;20;0;20
3419;Kaštonas;KIŠKUČIAI;8257643251;Taip;0;1;0;1
3420;Kaštonas;KIŠKUČIAI;8318869054;Taip;10;1;0;11
3421;Kaštonas;KIŠKUČIAI;4215759647;Taip;12;0;0;12
3422;Kaštonas;BITUTĖS;2146285017;Taip;1;6;0;7
3423;Kaštonas;BITUTĖS;3967999408;Taip;0;1;0;1
3424;Kaštonas;BITUTĖS;39974835155;Taip;3;1;0;4
3425;Kaštonas;BITUTĖS;1162926887;Taip;6;3;0;9
3426;Kaštonas;BITUTĖS;1459614385;Taip;19;0;0;19
3427;Kaštonas;BITUTĖS;2801321116;Ne;0;4;0;4
3428;Kaštonas;BITUTĖS;9967553882;Taip;0;2;0;2
3429;Kaštonas;BITUTĖS;27082059521;Taip;0;2;0;2
3430;Kaštonas;BITUTĖS;1465714333;Taip;0;1;0;1
3431;Kaštonas;BITUTĖS;1252815477;Taip;0;6;0;6
3432;Kaštonas;BITUTĖS;9215070593;Taip;0;5;0;5
3433;Kaštonas;BITUTĖS;2149717496;Ne;22;0;0;22
3434;Kaštonas;BITUTĖS;2504312724;Taip;0;1;0;1
3435;Kaštonas;BITUTĖS;1747580231;Ne;0;11;0;11
3436;Kaštonas;BITUTĖS;4449017708;Ne;16;1;0;17
3437;Kaštonas;BITUTĖS;3638565578;Ne;0;6;0;6
3438;Kaštonas;BITUTĖS;8906976150;Taip;0;3;0;3
3439;Kaštonas;BITUTĖS;7776071299;Taip;5;1;0;6
3440;Kaštonas;BITUTĖS;3039980710;Taip;0;5;0;5
3441;Kaštonas;BITUTĖS;3507672150;Taip;0;2;0;2
3442;Kaštonas;BITUTĖS;1826015013;Taip;0;3;0;3
3443;Kaštonas;BITUTĖS;5630659056;Taip;0;6;0;6
3444;Kaštonas;BITUTĖS;2007064959;Taip;22;0;0;22
3445;Kaštonas;BITUTĖS;1859126564;Ne;9;5;0;14
3446;Kaštonas;BITUTĖS;2797443202;Taip;10;6;0;16
3447;Kaštonas;BITUTĖS;8446233414;Taip;6;3;0;9
3448;Kaštonas;MEŠKIUKAI;8042807487;Taip;5;3;0;8
3449;Kaštonas;MEŠKIUKAI;2711819539;Taip;17;0;0;17
3450;Kaštonas;MEŠKIUKAI;1367704050;Taip;0;11;0;11
3451;Kaštonas;MEŠKIUKAI;65960895249;Taip;3;5;0;8
3452;Kaštonas;MEŠKIUKAI;5722934228;Taip;0;3;0;3
3453;Kaštonas;MEŠKIUKAI;1049699735;Taip;10;4;0;14
3454;Kaštonas;MEŠKIUKAI;2760501432;Ne;0;4;0;4
3455;Kaštonas;MEŠKIUKAI;70838449788;Ne;3;1;0;4
3456;Kaštonas;MEŠKIUKAI;8797584508;Taip;7;0;0;7
3457;Kaštonas;MEŠKIUKAI;7138581709;Taip;9;1;0;10
3458;Kaštonas;MEŠKIUKAI;9965517774;Taip;9;1;0;10
3459;Kaštonas;MEŠKIUKAI;1249299633;Taip;0;1;0;1
3460;Kaštonas;MEŠKIUKAI;1196590128;Taip;2;2;0;4
3461;Kaštonas;MEŠKIUKAI;1385352925;Taip;5;4;0;9
3462;Kaštonas;MEŠKIUKAI;69883785412;Ne;0;6;0;6
3463;Kaštonas;MEŠKIUKAI;2125410714;Ne;10;0;0;10
3464;Kaštonas;MEŠKIUKAI;5478395437;Taip;15;0;0;15
3465;Kaštonas;MEŠKIUKAI;6606094891;Taip;7;0;0;7
3466;Kaštonas;MEŠKIUKAI;1364391105;Taip;7;0;0;7
3467;Kaštonas;MEŠKIUKAI;6967725663;Taip;0;17;0;17
3468;Kaštonas;MEŠKIUKAI;4956177048;Taip;10;4;0;14
3469;Kaštonas;MEŠKIUKAI;5153948802;Taip;0;11;0;11
3470;Kaštonas;MEŠKIUKAI;5157500600;Ne;9;1;0;10
3471;Kaštonas;BORUŽĖLĖS;8214699601;Taip;0;3;0;3
3472;Kaštonas;BORUŽĖLĖS;2106924435;Taip;5;0;0;5
3473;Kaštonas;BORUŽĖLĖS;8483888152;Taip;5;0;0;5
3474;Kaštonas;BORUŽĖLĖS;2877124424;Taip;10;0;0;10
3475;Kaštonas;BORUŽĖLĖS;8275673303;Taip;0;6;0;6
3476;Kaštonas;BORUŽĖLĖS;6289073634;Ne;9;0;0;9
3477;Kaštonas;BORUŽĖLĖS;8582453109;Taip;0;2;0;2
3478;Kaštonas;BORUŽĖLĖS;4616084852;Taip;5;0;0;5
3479;Kaštonas;BORUŽĖLĖS;1748975865;Taip;0;4;0;4
3480;Kaštonas;BORUŽĖLĖS;2434765663;Taip;4;0;0;4
3481;Kaštonas;BORUŽĖLĖS;7813580782;Taip;6;0;0;6
3482;Kaštonas;BORUŽĖLĖS;5659508302;Taip;0;1;0;1
3483;Krivūlė;SPINDULIUKAI;59978148537;Taip;0;9;3;12
3484;Krivūlė;SPINDULIUKAI;45328749559;Ne;10;0;0;10
3485;Krivūlė;SPINDULIUKAI;88714209343;Taip;0;0;5;5
3486;Krivūlė;SPINDULIUKAI;50715118246;Taip;0;2;0;2
3487;Krivūlė;SPINDULIUKAI;43180342657;Taip;0;6;3;9
3488;Krivūlė;SPINDULIUKAI;78895964424;Taip;0;0;5;5
3489;Krivūlė;SPINDULIUKAI;9864428506;Taip;0;0;3;3
3490;Krivūlė;SPINDULIUKAI;58431942;Taip;0;0;1;1
3491;Krivūlė;SPINDULIUKAI;49698343392;Taip;0;1;0;1
3492;Krivūlė;SPINDULIUKAI;3157698386;Taip;0;2;1;3
3493;Krivūlė;SPINDULIUKAI;26046598666;Taip;0;0;1;1
3494;Krivūlė;SPINDULIUKAI;52632731467;Taip;0;0;2;2
3495;Krivūlė;SPINDULIUKAI;1443815293;Taip;0;0;1;1
3496;Krivūlė;SPINDULIUKAI;1980001276;Taip;0;0;1;1
3497;Krivūlė;SPINDULIUKAI;1738370642;Taip;0;1;0;1
3498;Krivūlė;BORUŽĖLĖS;4969782237;Taip;0;1;0;1
3499;Krivūlė;BORUŽĖLĖS;3605506478;Taip;8;0;1;9
3500;Krivūlė;BORUŽĖLĖS;4896656209;Taip;8;0;1;9
3501;Krivūlė;BORUŽĖLĖS;4845515196;Taip;5;11;5;21
3502;Krivūlė;BORUŽĖLĖS;6935969502;Taip;5;0;0;5
3503;Krivūlė;BORUŽĖLĖS;4972360440;Taip;5;0;0;5
3504;Krivūlė;BORUŽĖLĖS;7318064702;Taip;8;0;0;8
3505;Krivūlė;BORUŽĖLĖS;3912620138;Taip;0;0;5;5
3506;Krivūlė;BORUŽĖLĖS;5531566792;Taip;5;0;1;6
3507;Krivūlė;BORUŽĖLĖS;2386053480;Taip;2;5;3;10
3508;Krivūlė;BORUŽĖLĖS;8586287004;Taip;20;0;0;20
3509;Krivūlė;BORUŽĖLĖS;4540069843;Taip;5;0;2;7
3510;Krivūlė;BORUŽĖLĖS;4297876008;Taip;5;0;0;5
3511;Krivūlė;BORUŽĖLĖS;2138125571;Taip;0;0;3;3
3512;Krivūlė;BORUŽĖLĖS;4177660973;Taip;0;1;0;1
3513;Krivūlė;BORUŽĖLĖS;2517785727;Taip;3;0;4;7
3514;Krivūlė;BORUŽĖLĖS;2711010212;Taip;0;0;6;6
3515;Krivūlė;BORUŽĖLĖS;4025821636;Taip;5;0;0;5
3516;Krivūlė;DRUGELIŲ;1414837177;Taip;7;0;1;8
3517;Krivūlė;DRUGELIŲ;3594180341;Ne;4;0;0;4
3518;Krivūlė;DRUGELIŲ;50967415904;Ne;0;0;12;12
3519;Krivūlė;DRUGELIŲ;1265788772;Taip;0;12;0;12
3520;Krivūlė;DRUGELIŲ;8463621294;Taip;0;0;2;2
3521;Krivūlė;DRUGELIŲ;88645409146;Taip;0;0;1;1
3522;Krivūlė;DRUGELIŲ;98620856056;Taip;0;4;0;4
3523;Krivūlė;DRUGELIŲ;4824008306;Taip;4;0;2;6
3524;Krivūlė;DRUGELIŲ;8500798014;Taip;0;5;0;5
3525;Krivūlė;DRUGELIŲ;5825154729;Taip;0;0;1;1
3526;Krivūlė;"BITUTĖS (VALDOFRO)";46337826378;Taip;0;3;2;5
3527;Krivūlė;"BITUTĖS (VALDOFRO)";1588621536;Taip;0;0;1;1
3528;Krivūlė;"BITUTĖS (VALDOFRO)";97075230746;Taip;0;0;1;1
3529;Krivūlė;"BITUTĖS (VALDOFRO)";97859012083;Taip;3;1;1;5
3530;Krivūlė;"BITUTĖS (VALDOFRO)";2425023811;Taip;0;0;2;2
3531;Krivūlė;"BITUTĖS (VALDOFRO)";4838666934;Taip;0;2;0;2
3532;Krivūlė;"BITUTĖS (VALDOFRO)";3994278221;Taip;0;2;0;2
3533;Krivūlė;"BITUTĖS (VALDOFRO)";18486357195;Taip;6;0;1;7
3534;Krivūlė;"BITUTĖS (VALDOFRO)";3769812444;Taip;0;0;1;1
3535;Krivūlė;"BITUTĖS (VALDOFRO)";5128760019;Taip;0;0;1;1
3536;Krivūlė;"BITUTĖS (VALDOFRO)";1851097789;Taip;13;0;0;13
3537;Krivūlė;"BITUTĖS (VALDOFRO)";7789248863;Taip;4;0;0;4
3538;Krivūlė;"BITUTĖS (VALDOFRO)";5113297248;Taip;4;1;2;7
3539;Krivūlė;"BITUTĖS (VALDOFRO)";7848471009;Taip;7;0;2;9
3540;Krivūlė;EŽIUKAI;10433396718;Taip;0;0;1;1
3541;Krivūlė;EŽIUKAI;2302809484;Taip;0;15;2;17
3542;Krivūlė;EŽIUKAI;44741515819;Taip;0;0;1;1
3543;Krivūlė;EŽIUKAI;2099607493;Taip;5;1;0;6
3544;Krivūlė;EŽIUKAI;1290759541;Taip;7;0;6;13
3545;Krivūlė;EŽIUKAI;1590383390;Taip;0;5;3;8
3546;Krivūlė;EŽIUKAI;1699961817;Taip;10;0;1;11
3547;Krivūlė;EŽIUKAI;2125078552;Taip;0;0;1;1
3548;Krivūlė;EŽIUKAI;6753080815;Taip;0;0;6;6
3549;Krivūlė;EŽIUKAI;2903062788;Ne;0;0;2;2
3550;Krivūlė;EŽIUKAI;1039316424;Taip;5;0;0;5
3551;Krivūlė;NYKŠTUKAI;37502093836;Taip;0;1;8;9
3552;Krivūlė;NYKŠTUKAI;83840444975;Taip;0;1;8;9
3553;Krivūlė;NYKŠTUKAI;701438210;Taip;9;0;0;9
3554;Krivūlė;NYKŠTUKAI;3015266398;Taip;0;0;3;3
3555;Krivūlė;NYKŠTUKAI;2109315338;Taip;6;0;1;7
3556;Krivūlė;NYKŠTUKAI;7873123757;Taip;0;1;4;5
3557;Krivūlė;NYKŠTUKAI;97398901468;Taip;16;0;0;16
3558;Krivūlė;NYKŠTUKAI;1217856292;Ne;5;0;3;8
3559;Krivūlė;NYKŠTUKAI;9311270695;Taip;0;10;0;10
3560;Krivūlė;NYKŠTUKAI;6861483854;Ne;4;0;4;8
3561;Krivūlė;NYKŠTUKAI;3694497590;Taip;0;0;2;2
3562;Krivūlė;NYKŠTUKAI;7052198958;Taip;0;6;0;6
3563;Krivūlė;NYKŠTUKAI;5818988913;Taip;3;0;0;3
3564;Krivūlė;NYKŠTUKAI;5759145600;Taip;1;0;0;1
3565;Kodėlčiukas;Saulutės;6517880481;Taip;7;0;0;7
3566;Kodėlčiukas;Saulutės;7080578299;Taip;14;0;2;16
3567;Kodėlčiukas;Saulutės;1725624698;Taip;0;2;1;3
3568;Kodėlčiukas;Saulutės;2464972409;Taip;20;0;1;21
3569;Kodėlčiukas;Saulutės;8393893311;Taip;0;1;0;1
3570;Kodėlčiukas;Saulutės;7509476161;Taip;2;0;2;4
3571;Kodėlčiukas;Saulutės;7327247516;Taip;0;0;1;1
3572;Kodėlčiukas;Saulutės;1645680526;Taip;0;0;1;1
3573;Kodėlčiukas;Saulutės;8992265000;Taip;7;0;1;8
3574;Kodėlčiukas;Saulutės;6285018663;Taip;5;0;2;7
3575;Kodėlčiukas;Saulutės;1033969800;Ne;15;0;0;15
3576;Kodėlčiukas;Saulutės;4179140476;Taip;14;0;0;14
3577;Kodėlčiukas;Saulutės;2433094435;Ne;7;0;0;7
3578;Kodėlčiukas;Saulutės;9042404309;Taip;5;0;0;5
3579;Kodėlčiukas;Saulutės;9476376350;Taip;2;0;0;2
3580;Kodėlčiukas;Saulutės;3141225891;Taip;0;0;3;3
3581;Kodėlčiukas;Saulutės;3315824027;Taip;0;0;9;9
3582;Kodėlčiukas;Saulutės;7611485881;Taip;2;2;0;4
3583;Kodėlčiukas;Nežiniukai;6045564826;Taip;16;0;0;16
3584;Kodėlčiukas;Nežiniukai;7282579315;Taip;8;0;1;9
3585;Kodėlčiukas;Nežiniukai;6905424567;Taip;0;0;4;4
3586;Kodėlčiukas;Nežiniukai;1233880820;Ne;14;0;1;15
3587;Kodėlčiukas;Nežiniukai;5443377251;Ne;10;0;0;10
3588;Kodėlčiukas;Nežiniukai;7626940433;Taip;0;5;0;5
3589;Kodėlčiukas;Nežiniukai;9803206596;Taip;6;0;0;6
3590;Kodėlčiukas;Nežiniukai;4917910801;Taip;10;0;0;10
3591;Kodėlčiukas;Nežiniukai;6248137523;Taip;0;5;3;8
3592;Kodėlčiukas;Nežiniukai;1699358514;Taip;0;5;1;6
3593;Kodėlčiukas;Nežiniukai;3473981974;Taip;0;0;5;5
3594;Kodėlčiukas;Nežiniukai;4038168647;Taip;5;0;5;10
3595;Kodėlčiukas;Nežiniukai;8378295683;Taip;12;2;0;14
3596;Kodėlčiukas;Nežiniukai;6000831611;Taip;0;2;0;2
3597;Kodėlčiukas;Nežiniukai;7286497455;Taip;10;0;4;14
3598;Kodėlčiukas;Nežiniukai;1603752483;Taip;10;0;1;11
3599;Kodėlčiukas;Nežiniukai;6074758814;Ne;0;2;0;2
3600;Kodėlčiukas;Gintarėliai;58406224468;Taip;5;0;7;12
3601;Kodėlčiukas;Gintarėliai;1485012710;Taip;10;8;0;18
3602;Kodėlčiukas;Gintarėliai;2062878300;Taip;7;0;4;11
3603;Kodėlčiukas;Gintarėliai;20084022099;Taip;0;5;0;5
3604;Kodėlčiukas;Gintarėliai;1950934087;Taip;10;0;7;17
3605;Kodėlčiukas;Gintarėliai;9686497547;Taip;6;0;0;6
3606;Kodėlčiukas;Gintarėliai;4884104023;Taip;1;6;0;7
3607;Kodėlčiukas;Gintarėliai;4944791330;Taip;0;3;3;6
3608;Kodėlčiukas;Gintarėliai;8219424737;Taip;3;0;1;4
3609;Kodėlčiukas;Gintarėliai;4849314647;Taip;0;0;2;2
3610;Kodėlčiukas;Gintarėliai;3758606327;Taip;0;0;1;1
3611;Kodėlčiukas;Gintarėliai;8647609373;Taip;10;0;0;10
3612;Kodėlčiukas;Gintarėliai;5093139270;Taip;0;0;3;3
3613;Kodėlčiukas;Gintarėliai;4738357524;Taip;1;0;3;4
3614;Kodėlčiukas;Gintarėliai;8075591032;Taip;0;0;2;2
3615;Kodėlčiukas;Gintarėliai;8873629130;Taip;10;0;0;10
3616;Kodėlčiukas;Gintarėliai;2765869141;Taip;0;0;7;7
3617;Kodėlčiukas;Šnekučiai;1844016431;Taip;4;0;1;5
3618;Kodėlčiukas;Šnekučiai;1550915654;Taip;0;0;1;1
3619;Kodėlčiukas;Šnekučiai;1935757837;Taip;5;2;0;7
3620;Kodėlčiukas;Šnekučiai;8114859362;Taip;14;0;4;18
3621;Kodėlčiukas;Šnekučiai;1666743304;Ne;1;0;0;1
3622;Kodėlčiukas;Šnekučiai;1432342305;Taip;0;1;0;1
3623;Kodėlčiukas;Šnekučiai;1584936719;Taip;7;0;0;7
3624;Kodėlčiukas;Šnekučiai;9178209049;Taip;0;0;3;3
3625;Kodėlčiukas;Šnekučiai;5988863934;Taip;7;7;0;14
3626;Kodėlčiukas;Šnekučiai;2742365461;Taip;0;0;1;1
3627;Kodėlčiukas;Šnekučiai;76164689333;Ne;17;0;3;20
3628;Kodėlčiukas;Šnekučiai;5386820408;Taip;0;0;7;7
3629;Kodėlčiukas;Šnekučiai;6194726931;Taip;2;10;1;13
3630;Kodėlčiukas;Šnekučiai;5782600824;Taip;8;0;1;9
3631;Kodėlčiukas;Šnekučiai;7074381835;Ne;0;8;5;13
3632;Kodėlčiukas;Šnekučiai;7757494295;Taip;4;0;10;14
3633;Kodėlčiukas;Šnekučiai;2988674717;Taip;8;6;1;15
3634;Kodėlčiukas;Šnekučiai;4273202718;Taip;2;0;0;2
3635;Kodėlčiukas;Pabiručiai;7630180473;Taip;10;0;4;14
3636;Kodėlčiukas;Pabiručiai;8140940288;Taip;5;0;0;5
3637;Kodėlčiukas;Pabiručiai;7246243975;Ne;10;2;0;12
3638;Kodėlčiukas;Pabiručiai;1600501494;Taip;3;5;0;8
3639;Kodėlčiukas;Pabiručiai;3782714343;Taip;3;0;1;4
3640;Kodėlčiukas;Pabiručiai;4818678923;Ne;13;0;0;13
3641;Kodėlčiukas;Pabiručiai;9589692031;Taip;2;0;0;2
3642;Kodėlčiukas;Pabiručiai;1906128091;Taip;0;0;1;1
3643;Kodėlčiukas;Pabiručiai;8302606312;Taip;0;0;3;3
3644;Kodėlčiukas;Pabiručiai;9460792167;Taip;8;0;0;8
3645;Kodėlčiukas;Pabiručiai;1218904283;Taip;10;0;0;10
3646;Kodėlčiukas;Pabiručiai;2929946390;Taip;0;12;0;12
3647;Kodėlčiukas;Pabiručiai;7324303899;Taip;2;0;0;2
3648;Kodėlčiukas;Pabiručiai;1256650715;Taip;3;0;0;3
3649;Kodėlčiukas;Pabiručiai;1052656432;Taip;0;3;0;3
3650;Kodėlčiukas;Pabiručiai;9794875862;Taip;0;4;1;5
3651;Kodėlčiukas;Pabiručiai;9528997865;Taip;17;2;0;19
3652;Kodėlčiukas;Pabiručiai;2593524511;Taip;4;4;1;9
3653;Kodėlčiukas;Pabiručiai;8879977943;Taip;0;11;0;11
3654;Kodėlčiukas;Smalsučiai;49317624340;Taip;10;1;1;12
3655;Kodėlčiukas;Smalsučiai;41477530966;Taip;0;10;0;10
3656;Kodėlčiukas;Smalsučiai;69860272843;Taip;8;3;0;11
3657;Kodėlčiukas;Smalsučiai;52040715568;Taip;0;11;0;11
3658;Kodėlčiukas;Smalsučiai;37852137155;Taip;0;0;1;1
3659;Kodėlčiukas;Smalsučiai;86134523927;Taip;0;1;0;1
3660;Kodėlčiukas;Smalsučiai;46307870009;Taip;0;0;4;4
3661;Kodėlčiukas;Smalsučiai;35337024913;Taip;0;2;0;2
3662;Kodėlčiukas;Smalsučiai;33432780322;Taip;7;0;2;9
3663;Kodėlčiukas;Smalsučiai;96270550335;Taip;0;2;0;2
3664;Kodėlčiukas;Smalsučiai;50234358109;Taip;0;0;1;1
3665;Kodėlčiukas;Smalsučiai;1518135854;Ne;0;0;4;4
3666;Kodėlčiukas;Smalsučiai;93698504377;Taip;0;0;9;9
3667;Kodėlčiukas;Smalsučiai;1951603132;Taip;0;0;3;3
3668;Kodėlčiukas;Smalsučiai;1614088526;Taip;0;0;3;3
3669;Kodėlčiukas;Smalsučiai;41664027247;Taip;0;7;0;7
3670;Kodėlčiukas;Giliukai;26010333641;Taip;0;2;1;3
3671;Kodėlčiukas;Giliukai;97902789189;Taip;2;0;1;3
3672;Kodėlčiukas;Giliukai;99164081259;Taip;0;0;2;2
3673;Kodėlčiukas;Giliukai;93684599166;Taip;2;1;0;3
3674;Kodėlčiukas;Giliukai;88371652763;Ne;0;0;2;2
3675;Kodėlčiukas;Giliukai;80767435810;Taip;8;0;2;10
3676;Kodėlčiukas;Giliukai;1825630143;Taip;10;0;11;21
3677;Kodėlčiukas;Giliukai;11130172902;Taip;10;0;1;11
3678;Kodėlčiukas;Giliukai;29830674331;Taip;0;0;2;2
3679;Kodėlčiukas;Giliukai;84905680496;Taip;13;0;1;14
3680;Kodėlčiukas;Giliukai;58893099621;Taip;0;0;4;4
3681;Kodėlčiukas;Giliukai;2637712514;Taip;0;0;1;1
3682;Kodėlčiukas;Giliukai;45393129631;Taip;7;0;5;12
3683;Kodėlčiukas;Giliukai;47667750562;Ne;10;0;0;10
3684;Kodėlčiukas;Giliukai;8204069897;Taip;2;4;0;6
3685;Kodėlčiukas;Giliukai;1938753417;Taip;0;0;2;2
3686;Kodėlčiukas;Giliukai;29319461634;Taip;0;1;2;3
3687;Kodėlčiukas;Gudručiai;20467065338;Ne;5;0;2;7
3688;Kodėlčiukas;Gudručiai;32318234528;Ne;0;0;3;3
3689;Kodėlčiukas;Gudručiai;18557158044;Taip;0;0;3;3
3690;Kodėlčiukas;Gudručiai;3542081571;Ne;10;0;5;15
3691;Kodėlčiukas;Gudručiai;84450296241;Taip;0;1;0;1
3692;Kodėlčiukas;Gudručiai;1234971388;Taip;0;0;2;2
3693;Kodėlčiukas;Gudručiai;1048653620;Ne;0;2;0;2
3694;Kodėlčiukas;Gudručiai;1662717348;Taip;5;0;0;5
3695;Kodėlčiukas;Gudručiai;1978279511;Taip;6;0;5;11
3696;Kodėlčiukas;Gudručiai;1251970125;Taip;0;2;3;5
3697;Kodėlčiukas;Gudručiai;70940790491;Taip;10;0;2;12
3698;Kodėlčiukas;Gudručiai;6168432879;Taip;0;0;2;2
3699;Kodėlčiukas;Gudručiai;1106092960;Taip;0;0;2;2
3700;Kodėlčiukas;Gudručiai;8393750817;Taip;0;0;7;7
3701;Kodėlčiukas;Gudručiai;2061169442;Taip;0;0;1;1
3702;Kodėlčiukas;Gudručiai;1115828736;Taip;0;0;2;2
3703;Kodėlčiukas;Gudručiai;1723716524;Taip;10;1;2;13
3704;Kodėlčiukas;Gudručiai;87784905691;Taip;4;0;0;4
3705;Kodėlčiukas;Žirniukai;6988515253;Taip;12;0;5;17
3706;Kodėlčiukas;Žirniukai;3385551650;Taip;14;0;0;14
3707;Kodėlčiukas;Žirniukai;7430239198;Taip;6;0;0;6
3708;Kodėlčiukas;Žirniukai;7116594055;Taip;0;0;7;7
3709;Kodėlčiukas;Žirniukai;8890987483;Taip;0;10;0;10
3710;Kodėlčiukas;Žirniukai;4687333060;Taip;3;0;0;3
3711;Kodėlčiukas;Žirniukai;1491160730;Taip;2;0;0;2
3712;Kodėlčiukas;Žirniukai;2216791610;Taip;9;0;1;10
3713;Kodėlčiukas;Žirniukai;8400610717;Taip;0;0;2;2
3714;Kodėlčiukas;Žirniukai;9483378853;Ne;5;0;1;6
3715;Kodėlčiukas;Žirniukai;1191430672;Taip;4;0;0;4
3716;Kodėlčiukas;Žirniukai;4543838852;Taip;5;0;2;7
3717;Kodėlčiukas;Žirniukai;9865803714;Ne;0;0;11;11
3718;Kodėlčiukas;Žirniukai;1801366890;Taip;4;0;0;4
3719;Kodėlčiukas;Žirniukai;6985788287;Taip;5;0;5;10
3720;Kodėlčiukas;Katinėliai;2987907651;Taip;4;0;2;6
3721;Kodėlčiukas;Katinėliai;3413659259;Taip;0;0;4;4
3722;Kodėlčiukas;Katinėliai;9899236780;Taip;0;0;4;4
3723;Kodėlčiukas;Katinėliai;8784531004;Taip;7;0;0;7
3724;Kodėlčiukas;Katinėliai;7318196860;Taip;16;0;0;16
3725;Kodėlčiukas;Katinėliai;6014084915;Taip;0;6;2;8
3726;Kodėlčiukas;Katinėliai;1588132166;Taip;13;0;0;13
3727;Kodėlčiukas;Katinėliai;1180399735;Taip;7;0;3;10
3728;Kodėlčiukas;Katinėliai;8189938439;Taip;0;12;5;17
3729;Kodėlčiukas;Katinėliai;1039982141;Taip;0;0;1;1
3730;Kodėlčiukas;Katinėliai;8427457478;Taip;6;0;0;6
3731;Kodėlčiukas;Nykštukai;3315862631;Taip;5;0;0;5
3732;Kodėlčiukas;Nykštukai;9645987751;Taip;17;0;0;17
3733;Kodėlčiukas;Nykštukai;5860975805;Taip;5;0;1;6
3734;Kodėlčiukas;Nykštukai;8104220950;Taip;8;0;0;8
3735;Kodėlčiukas;Nykštukai;2005453189;Taip;9;0;0;9
3736;Kodėlčiukas;Nykštukai;3442449482;Taip;11;0;1;12
3737;Kodėlčiukas;Nykštukai;8563412043;Taip;7;0;0;7
3738;Kodėlčiukas;Nykštukai;1683506414;Taip;8;0;2;10
3739;Kodėlčiukas;Nykštukai;7946010973;Taip;0;0;2;2
3740;Kodėlčiukas;Nykštukai;8971395173;Taip;14;0;0;14
3741;Kodėlčiukas;Nykštukai;5896726125;Taip;9;0;0;9
3742;Kodėlčiukas;Nykštukai;3168418461;Taip;12;0;0;12
3743;Kodėlčiukas;Nykštukai;3068084704;Taip;16;0;1;17
3744;Kodėlčiukas;Nykštukai;1889809198;Taip;0;0;2;2
3745;Kodėlčiukas;ŽIOGELIAI;2921181385;Taip;10;0;1;11
3746;Kodėlčiukas;ŽIOGELIAI;8263945732;Taip;8;0;0;8
3747;Kodėlčiukas;ŽIOGELIAI;4218096561;Taip;0;0;9;9
3748;Kodėlčiukas;ŽIOGELIAI;2169307879;Taip;8;0;0;8
3749;Kodėlčiukas;ŽIOGELIAI;8910195286;Taip;9;0;0;9
3750;Kodėlčiukas;ŽIOGELIAI;4585226357;Taip;10;0;3;13
3751;Kodėlčiukas;ŽIOGELIAI;4884233329;Taip;0;0;5;5
3752;Kodėlčiukas;ŽIOGELIAI;4937929385;Taip;0;0;2;2
3753;Kodėlčiukas;ŽIOGELIAI;4165123345;Taip;7;0;0;7
3754;Kodėlčiukas;ŽIOGELIAI;5513530983;Taip;10;0;7;17
3755;Kodėlčiukas;ŽIOGELIAI;1289342844;Taip;0;10;5;15
3756;Kodėlčiukas;ŽIOGELIAI;6476445296;Taip;4;0;1;5
3757;Kodėlčiukas;ŽIOGELIAI;7612531087;Taip;0;0;2;2
3758;Kodėlčiukas;ŽIOGELIAI;6714818379;Taip;5;0;3;8
3759;Kodėlčiukas;ŽIOGELIAI;2808361570;Taip;4;0;1;5
3760;Kodėlčiukas;BITUTĖS;3240221130;Taip;3;1;0;4
3761;Kodėlčiukas;BITUTĖS;5772071707;Taip;8;0;0;8
3762;Kodėlčiukas;BITUTĖS;5577154148;Taip;4;1;0;5
3763;Kodėlčiukas;BITUTĖS;1149682376;Taip;7;0;0;7
3764;Kodėlčiukas;BITUTĖS;9139424911;Taip;0;0;3;3
3765;Kodėlčiukas;BITUTĖS;5197946954;Taip;5;0;2;7
3766;Kodėlčiukas;BITUTĖS;7587203481;Taip;0;0;1;1
3767;Kodėlčiukas;BITUTĖS;4777496709;Taip;12;0;0;12
3768;Kodėlčiukas;BITUTĖS;7714816675;Taip;10;0;0;10
3769;Kodėlčiukas;BITUTĖS;3267687337;Taip;2;0;0;2
3770;Kodėlčiukas;BITUTĖS;4202423480;Taip;0;1;0;1
3771;Kodėlčiukas;BITUTĖS;9664432781;Taip;6;0;0;6
3772;Kodėlčiukas;BITUTĖS;8547039654;Taip;2;0;0;2
3773;Kodėlčiukas;BITUTĖS;5505788210;Taip;4;1;0;5
3774;Kodėlčiukas;BITUTĖS;6106526012;Taip;0;16;0;16
3775;Kodėlčiukas;VYŠNIUKAI;4116192711;Taip;0;0;12;12
3776;Kodėlčiukas;VYŠNIUKAI;9664029038;Taip;0;0;1;1
3777;Kodėlčiukas;VYŠNIUKAI;2162480212;Taip;0;0;4;4
3778;Kodėlčiukas;VYŠNIUKAI;3482802557;Taip;4;0;6;10
3779;Kodėlčiukas;VYŠNIUKAI;3778271049;Ne;9;0;7;16
3780;Kodėlčiukas;VYŠNIUKAI;1074477043;Ne;0;0;9;9
3781;Kodėlčiukas;VYŠNIUKAI;3470151604;Taip;1;0;1;2
3782;Kodėlčiukas;VYŠNIUKAI;7510273691;Ne;7;0;1;8
3783;Kodėlčiukas;VYŠNIUKAI;6761903865;Ne;0;0;1;1
3784;Kodėlčiukas;VYŠNIUKAI;9527296531;Taip;0;0;2;2
3785;Kodėlčiukas;VYŠNIUKAI;2351468626;Taip;13;1;0;14
3786;Kodėlčiukas;VYŠNIUKAI;6764015170;Ne;9;0;0;9
3787;Kodėlčiukas;VYŠNIUKAI;8447045958;Taip;8;0;4;12
3788;Kodėlčiukas;VYŠNIUKAI;7647582987;Ne;0;0;1;1
3789;Kodėlčiukas;VYŠNIUKAI;3403889915;Taip;12;0;4;16
3790;Kodėlčiukas;VYŠNIUKAI;1160612316;Taip;10;0;0;10
3791;Kodėlčiukas;VYŠNIUKAI;8606551477;Taip;12;0;0;12
3792;Kodėlčiukas;BORUŽĖLĖS;9169500252;Ne;6;0;0;6
3793;Kodėlčiukas;BORUŽĖLĖS;9724373368;Taip;5;3;0;8
3794;Kodėlčiukas;BORUŽĖLĖS;5075801618;Taip;9;0;1;10
3795;Kodėlčiukas;BORUŽĖLĖS;2819860331;Taip;1;0;0;1
3796;Kodėlčiukas;BORUŽĖLĖS;4941186694;Taip;8;0;0;8
3797;Kodėlčiukas;BORUŽĖLĖS;5952121209;Taip;7;1;0;8
3798;Kodėlčiukas;BORUŽĖLĖS;4230906452;Ne;6;0;0;6
3799;Kodėlčiukas;BORUŽĖLĖS;5985806014;Taip;5;3;0;8
3800;Kodėlčiukas;BORUŽĖLĖS;9208137169;Ne;0;0;9;9
3801;Kodėlčiukas;BORUŽĖLĖS;5876187643;Taip;5;0;2;7
3802;Kodėlčiukas;BORUŽĖLĖS;1206798597;Taip;0;7;7;14
3803;Kodėlčiukas;BORUŽĖLĖS;1827752731;Taip;5;0;0;5
3804;Kodėlčiukas;BORUŽĖLĖS;1005178052;Taip;10;0;0;10
3805;Kodėlčiukas;BORUŽĖLĖS;9252478832;Taip;5;0;0;5
3806;Kodėlčiukas;VYTURĖLIAI;42540143229;Taip;6;1;0;7
3807;Kodėlčiukas;VYTURĖLIAI;14611425618;Taip;0;2;0;2
3808;Kodėlčiukas;VYTURĖLIAI;43335982030;Taip;6;0;2;8
3809;Kodėlčiukas;VYTURĖLIAI;23065888472;Taip;0;1;0;1
3810;Kodėlčiukas;VYTURĖLIAI;98738524708;Taip;0;0;1;1
3811;Kodėlčiukas;VYTURĖLIAI;1905426469;Taip;0;1;1;2
3812;Kodėlčiukas;VYTURĖLIAI;1730913401;Taip;0;5;1;6
3813;Kodėlčiukas;VYTURĖLIAI;66109277013;Taip;0;1;0;1
3814;Kodėlčiukas;VYTURĖLIAI;1608321100;Taip;6;2;0;8
3815;Kodėlčiukas;VYTURĖLIAI;45910018746;Taip;0;1;0;1
3816;Kodėlčiukas;VYTURĖLIAI;48669541733;Taip;0;2;0;2
3817;Kodėlčiukas;VYTURĖLIAI;1290630625;Taip;0;0;1;1
3818;Kodėlčiukas;VYTURĖLIAI;9323563664;Taip;0;3;0;3
3819;Kodėlčiukas;VYTURĖLIAI;79090323340;Taip;0;1;0;1
3820;Kodėlčiukas;VYTURĖLIAI;49784617790;Taip;0;1;0;1
3821;Kodėlčiukas;DRUGELIAI;1850261935;Taip;0;0;7;7
3822;Kodėlčiukas;DRUGELIAI;6612336444;Taip;0;2;2;4
3823;Kodėlčiukas;DRUGELIAI;1645423279;Taip;0;0;5;5
3824;Kodėlčiukas;DRUGELIAI;1215911875;Taip;0;0;4;4
3825;Kodėlčiukas;DRUGELIAI;7479165635;Taip;0;7;0;7
3826;Kodėlčiukas;DRUGELIAI;56907458719;Ne;0;0;8;8
3827;Kodėlčiukas;DRUGELIAI;9645382151;Taip;0;5;0;5
3828;Kodėlčiukas;DRUGELIAI;1208194459;Taip;8;0;2;10
3829;Kodėlčiukas;DRUGELIAI;1111723773;Taip;8;0;2;10
3830;Kodėlčiukas;DRUGELIAI;1550337708;Ne;0;0;1;1
3831;Kodėlčiukas;DRUGELIAI;24138056567;Taip;0;0;3;3
3832;Kodėlčiukas;DRUGELIAI;44431255380;Taip;0;0;6;6
3833;Kodėlčiukas;DRUGELIAI;93275059990;Taip;7;6;0;13
3834;Kodėlčiukas;DRUGELIAI;50411894014;Ne;0;0;3;3
3835;Kodėlčiukas;DRUGELIAI;1782784297;Taip;0;6;0;6
3836;Klevelis;Gėlytės;1953918266;Taip;5;0;4;9
3837;Klevelis;Gėlytės;68457250471;Ne;0;12;0;12
3838;Klevelis;Gėlytės;7309676894;Taip;8;10;0;18
3839;Klevelis;Gėlytės;1942666372;Taip;0;17;0;17
3840;Klevelis;Gėlytės;50441219517;Taip;0;2;0;2
3841;Klevelis;Gėlytės;8154620920;Ne;2;0;3;5
3842;Klevelis;Gėlytės;5075314234;Taip;4;0;0;4
3843;Klevelis;Gėlytės;8584120396;Taip;3;0;2;5
3844;Klevelis;Gėlytės;23520576240;Taip;0;3;0;3
3845;Klevelis;Gėlytės;1851385706;Taip;5;8;0;13
3846;Klevelis;Gėlytės;5024289280;Taip;5;1;0;6
3847;Klevelis;Gėlytės;1685710938;Taip;0;3;0;3
3848;Klevelis;Gėlytės;5354831337;Ne;6;0;6;12
3849;Klevelis;Gėlytės;2744433344;Taip;2;0;1;3
3850;Klevelis;Gėlytės;1606294984;Taip;0;0;4;4
3851;Klevelis;Gėlytės;2043650571;Ne;3;4;1;8
3852;Klevelis;Paukšteliai;7855598075;Taip;2;4;0;6
3853;Klevelis;Paukšteliai;5402403433;Taip;12;0;0;12
3854;Klevelis;Paukšteliai;1749117711;Taip;11;1;0;12
3855;Klevelis;Paukšteliai;3873345138;Ne;5;6;0;11
3856;Klevelis;Paukšteliai;9291855374;Taip;10;2;0;12
3857;Klevelis;Paukšteliai;7115198351;Taip;5;9;0;14
3858;Klevelis;Paukšteliai;8357021249;Taip;4;0;5;9
3859;Klevelis;Paukšteliai;4051246539;Ne;0;5;0;5
3860;Klevelis;Paukšteliai;4144247242;Ne;3;0;1;4
3861;Klevelis;Paukšteliai;5518309115;Taip;10;0;0;10
3862;Klevelis;Paukšteliai;4832348492;Taip;9;0;0;9
3863;Klevelis;Paukšteliai;9865628172;Ne;4;0;2;6
3864;Klevelis;Paukšteliai;8777858708;Ne;0;0;5;5
3865;Klevelis;Paukšteliai;6172016747;Taip;11;0;1;12
3866;Klevelis;Paukšteliai;4930308435;Taip;0;1;0;1
3867;Klevelis;Paukšteliai;3408705916;Taip;0;7;0;7
3868;Klevelis;Paukšteliai;2555810841;Taip;6;0;0;6
3869;Klevelis;Paukšteliai;6209223745;Ne;0;0;2;2
3870;Klevelis;Paukšteliai;4895554383;Taip;4;0;0;4
3871;Klevelis;Spindulėliai;36733972781;Ne;0;7;0;7
3872;Klevelis;Spindulėliai;71637673796;Taip;7;0;2;9
3873;Klevelis;Spindulėliai;85910214189;Ne;0;0;2;2
3874;Klevelis;Spindulėliai;27776527268;Ne;0;6;0;6
3875;Klevelis;Spindulėliai;1299222411;Taip;0;22;0;22
3876;Klevelis;Spindulėliai;2041814549;Taip;0;1;1;2
3877;Klevelis;Spindulėliai;30473769754;Taip;0;0;1;1
3878;Klevelis;Spindulėliai;1608781752;Taip;0;3;0;3
3879;Klevelis;Spindulėliai;32063805512;Taip;7;4;0;11
3880;Klevelis;Spindulėliai;5786557195;Taip;1;0;0;1
3881;Klevelis;Spindulėliai;1980755137;Taip;0;9;0;9
3882;Klevelis;Spindulėliai;88565114332;Taip;9;0;1;10
3883;Klevelis;Spindulėliai;2207041148;Taip;2;8;0;10
3884;Klevelis;Spindulėliai;58302265771;Ne;7;0;0;7
3885;Klevelis;Spindulėliai;4733970252;Taip;0;0;3;3
3886;Klevelis;Spindulėliai;9125827523;Taip;0;10;0;10
3887;Klevelis;Spindulėliai;3397741232;Ne;3;5;1;9
3888;Klevelis;Spindulėliai;1520846063;Taip;0;0;3;3
3889;Klevelis;Spindulėliai;4558350854;Ne;0;0;1;1
3890;Klevelis;Spindulėliai;1020095914;Taip;0;8;0;8
3891;Klevelis;Spindulėliai;5705915729;Taip;4;0;0;4
3892;Klevelis;BORUŽĖLĖS;5966215998;Taip;4;0;0;4
3893;Klevelis;BORUŽĖLĖS;4347007911;Taip;3;0;0;3
3894;Klevelis;BORUŽĖLĖS;2418583962;Taip;15;0;0;15
3895;Klevelis;BORUŽĖLĖS;5887929703;Taip;9;0;1;10
3896;Klevelis;BORUŽĖLĖS;5028027797;Taip;7;0;1;8
3897;Klevelis;BORUŽĖLĖS;9585785202;Taip;9;0;0;9
3898;Klevelis;BORUŽĖLĖS;7463376031;Taip;0;4;0;4
3899;Klevelis;BORUŽĖLĖS;6822089289;Taip;10;0;0;10
3900;Klevelis;BORUŽĖLĖS;6736740055;Taip;11;0;0;11
3901;Klevelis;BORUŽĖLĖS;6241611652;Taip;9;0;1;10
3902;Klevelis;BORUŽĖLĖS;3567687304;Taip;13;0;0;13
3903;Klevelis;BORUŽĖLĖS;6372245141;Taip;5;0;0;5
3904;Klevelis;BORUŽĖLĖS;2031118410;Taip;5;0;0;5
3905;Klevelis;BORUŽĖLĖS;6488139414;Taip;11;0;0;11
3906;Klevelis;BORUŽĖLĖS;7559183263;Taip;0;1;0;1
3907;Kurpaitė;Viščiukų;6568580994;Taip;0;4;0;4
3908;Kurpaitė;Viščiukų;1223396469;Taip;12;0;0;12
3909;Kurpaitė;Viščiukų;1095697246;Taip;0;1;0;1
3910;Kurpaitė;Viščiukų;4426311033;Taip;0;1;0;1
3911;Kurpaitė;Viščiukų;3627418555;Taip;0;2;0;2
3912;Kurpaitė;Viščiukų;5220314051;Taip;5;0;0;5
3913;Kurpaitė;Viščiukų;4188925256;Taip;0;16;0;16
3914;Kurpaitė;Viščiukų;8831080716;Taip;15;0;0;15
3915;Kurpaitė;Viščiukų;4592795281;Taip;0;10;0;10
3916;Kurpaitė;Viščiukų;8868415451;Taip;2;3;0;5
3917;Kurpaitė;Viščiukų;4684525618;Taip;16;0;0;16
3918;Kurpaitė;Gėlyčių;3003517700;Taip;2;0;0;2
3919;Kurpaitė;Gėlyčių;7897713994;Taip;8;0;0;8
3920;Kurpaitė;Gėlyčių;1660650556;Taip;0;13;0;13
3921;Kurpaitė;Gėlyčių;1457318954;Taip;0;5;0;5
3922;Kurpaitė;Gėlyčių;9063294667;Ne;0;2;0;2
3923;Kurpaitė;Gėlyčių;9062514113;Taip;5;0;0;5
3924;Kurpaitė;Gėlyčių;4964063637;Taip;3;0;0;3
3925;Kurpaitė;Gėlyčių;7546409044;Taip;0;20;0;20
3926;Kurpaitė;Gėlyčių;5609161523;Taip;12;0;0;12
3927;Kurpaitė;Gėlyčių;8669676262;Taip;0;10;0;10
3928;Kurpaitė;Gėlyčių;9480290430;Taip;0;1;0;1
3929;Kurpaitė;Gėlyčių;4519369081;Taip;5;0;0;5
3930;Kurpaitė;Gėlyčių;9655585527;Taip;0;13;0;13
3931;Kurpaitė;Gėlyčių;3634641300;Taip;7;6;0;13
3932;Kurpaitė;Gėlyčių;9915241987;Taip;7;0;0;7
3933;Kurpaitė;Gėlyčių;2827617670;Taip;10;0;0;10
3934;Kurpaitė;Gėlyčių;4602268315;Taip;18;0;0;18
3935;Kurpaitė;Gėlyčių;4168882748;Taip;1;0;0;1
3936;Kurpaitė;Drugelių;1236147310;Taip;5;0;0;5
3937;Kurpaitė;Drugelių;1202869338;Taip;0;0;1;1
3938;Kurpaitė;Drugelių;24410351286;Ne;0;12;0;12
3939;Kurpaitė;Drugelių;58127430940;Taip;0;6;0;6
3940;Kurpaitė;Drugelių;1606617694;Ne;0;14;0;14
3941;Kurpaitė;Drugelių;2359555461;Taip;2;2;0;4
3942;Kurpaitė;Drugelių;65434834152;Taip;0;15;0;15
3943;Kurpaitė;Drugelių;72710210157;Taip;0;4;0;4
3944;Kurpaitė;Drugelių;1218040871;Taip;0;16;0;16
3945;Kurpaitė;Drugelių;3660687688;Taip;0;9;0;9
3946;Kurpaitė;Drugelių;7431793716;Taip;0;8;0;8
3947;Kurpaitė;Drugelių;1505783589;Taip;0;6;0;6
3948;Kurpaitė;Drugelių;7249931704;Taip;0;5;0;5
3949;Kurpaitė;Drugelių;3102257512;Taip;8;4;0;12
3950;Kurpaitė;Pelyčių;5442955475;Taip;0;1;0;1
3951;Kurpaitė;Pelyčių;53385228310;Ne;5;1;0;6
3952;Kurpaitė;Pelyčių;28569380108;Taip;0;13;0;13
3953;Kurpaitė;Pelyčių;1936055251;Taip;0;3;0;3
3954;Kurpaitė;Pelyčių;5902371603;Taip;0;5;0;5
3955;Kurpaitė;Pelyčių;54840686231;Taip;0;8;0;8
3956;Kurpaitė;Pelyčių;49970457589;Ne;0;15;0;15
3957;Kurpaitė;Pelyčių;48526842780;Taip;0;7;0;7
3958;Kurpaitė;Pelyčių;38605683298;Taip;0;2;0;2
3959;Kurpaitė;Pelyčių;85698687930;Taip;2;0;0;2
3960;Kurpaitė;Pelyčių;1730735673;Taip;0;3;0;3
3961;Kurpaitė;Pelyčių;52852801754;Taip;8;0;0;8
3962;Kurpaitė;Pelyčių;43247754405;Taip;0;16;0;16
3963;Kurpaitė;Pelyčių;31201788860;Taip;5;0;0;5
3964;Kurpaitė;Pelyčių;5394176979;Taip;14;0;0;14
3965;Kūlverstukas;Saulutės;74829986958;Ne;2;2;2;6
3966;Kūlverstukas;Saulutės;7440474403;Taip;5;0;1;6
3967;Kūlverstukas;Saulutės;2072009099;Taip;5;0;3;8
3968;Kūlverstukas;Saulutės;1000393691;Taip;0;0;6;6
3969;Kūlverstukas;Saulutės;6577897961;Taip;7;0;1;8
3970;Kūlverstukas;Saulutės;3162189859;Taip;0;5;10;15
3971;Kūlverstukas;Saulutės;1452422691;Taip;5;0;0;5
3972;Kūlverstukas;Saulutės;2130099456;Taip;2;0;0;2
3973;Kūlverstukas;Saulutės;1226883894;Taip;5;7;1;13
3974;Kūlverstukas;Saulutės;37991935289;Taip;10;8;0;18
3975;Kūlverstukas;Saulutės;1699783763;Taip;5;0;0;5
3976;Kūlverstukas;Saulutės;3991821717;Ne;10;0;0;10
3977;Kūlverstukas;Saulutės;5488011852;Taip;3;0;1;4
3978;Kūlverstukas;Saulutės;8891671739;Taip;0;0;1;1
3979;Kūlverstukas;Saulutės;4396230034;Taip;0;0;1;1
3980;Kūlverstukas;Saulutės;6975324309;Taip;2;0;3;5
3981;Kūlverstukas;Peledžiukai;21138396996;Taip;0;2;2;4
3982;Kūlverstukas;Peledžiukai;4028937969;Taip;1;5;1;7
3983;Kūlverstukas;Peledžiukai;85330859485;Taip;7;0;0;7
3984;Kūlverstukas;Peledžiukai;2179050825;Taip;4;0;0;4
3985;Kūlverstukas;Peledžiukai;46254945540;Taip;0;1;1;2
3986;Kūlverstukas;Peledžiukai;1260193245;Taip;3;0;0;3
3987;Kūlverstukas;Peledžiukai;89179106633;Ne;0;2;0;2
3988;Kūlverstukas;Peledžiukai;79760811110;Taip;0;4;0;4
3989;Kūlverstukas;Peledžiukai;46862868133;Taip;0;1;0;1
3990;Kūlverstukas;Peledžiukai;1816105412;Taip;2;3;0;5
3991;Kūlverstukas;Peledžiukai;1570383265;Taip;0;6;0;6
3992;Kūlverstukas;Peledžiukai;3737085009;Taip;0;10;0;10
3993;Kūlverstukas;Peledžiukai;49788909084;Taip;22;0;0;22
3994;Kūlverstukas;Peledžiukai;1109035765;Taip;8;2;0;10
3995;Kūlverstukas;Peledžiukai;1396533792;Taip;5;0;2;7
3996;Kūlverstukas;Peledžiukai;1009117653;Taip;15;0;0;15
3997;Kūlverstukas;Peledžiukai;8362459952;Taip;10;3;0;13
3998;Kūlverstukas;Gelytės;2716194746;Taip;0;22;0;22
3999;Kūlverstukas;Gelytės;2101490038;Taip;11;0;2;13
4000;Kūlverstukas;Gelytės;2450625415;Taip;11;0;2;13
4001;Kūlverstukas;Gelytės;8092104136;Taip;0;12;2;14
4002;Kūlverstukas;Gelytės;5372936730;Taip;7;1;0;8
4003;Kūlverstukas;Gelytės;7359354944;Taip;7;0;0;7
4004;Kūlverstukas;Gelytės;8243342948;Ne;0;2;0;2
4005;Kūlverstukas;Gelytės;8853848991;Taip;3;0;0;3
4006;Kūlverstukas;Gelytės;4285624305;Taip;3;17;0;20
4007;Kūlverstukas;Gelytės;4073233921;Ne;5;0;0;5
4008;Kūlverstukas;Gelytės;1932066021;Ne;0;0;3;3
4009;Kūlverstukas;Gelytės;5488852698;Taip;3;6;0;9
4010;Kūlverstukas;Gelytės;3069047204;Taip;8;5;2;15
4011;Kūlverstukas;Gelytės;5345423038;Taip;2;2;0;4
4012;Kūlverstukas;Gelytės;3270176280;Taip;5;0;0;5
4013;Kūlverstukas;Bitutės;9427388681;Taip;0;9;0;9
4014;Kūlverstukas;Bitutės;4532151103;Taip;8;0;0;8
4015;Kūlverstukas;Bitutės;5103259175;Taip;0;0;4;4
4016;Kūlverstukas;Bitutės;9167460438;Taip;4;9;0;13
4017;Kūlverstukas;Bitutės;1898905623;Taip;6;0;16;22
4018;Kūlverstukas;Bitutės;2762230590;Taip;0;0;1;1
4019;Kūlverstukas;Bitutės;8319255735;Taip;0;0;11;11
4020;Kūlverstukas;Bitutės;6598688551;Taip;8;0;0;8
4021;Kūlverstukas;Bitutės;8556086501;Taip;4;0;0;4
4022;Kūlverstukas;Bitutės;3162808486;Taip;2;0;1;3
4023;Lakštingala;Saulutės;5692087454;Taip;0;0;1;1
4024;Lakštingala;Saulutės;95489864230;Taip;0;2;1;3
4025;Lakštingala;Saulutės;31221126819;Taip;0;0;2;2
4026;Lakštingala;Saulutės;57836156450;Taip;0;1;0;1
4027;Lakštingala;Saulutės;3426133948;Taip;5;4;1;10
4028;Lakštingala;Saulutės;10653315095;Ne;3;0;1;4
4029;Lakštingala;Saulutės;50868279016;Taip;0;6;0;6
4030;Lakštingala;Saulutės;2430795418;Ne;0;0;1;1
4031;Lakštingala;Saulutės;96792864646;Taip;3;0;1;4
4032;Lakštingala;Saulutės;74001349345;Taip;0;0;4;4
4033;Lakštingala;Saulutės;37722153251;Taip;3;2;1;6
4034;Lakštingala;Saulutės;98717827320;Taip;0;1;0;1
4035;Lakštingala;Saulutės;79583726414;Taip;5;0;0;5
4036;Lakštingala;Saulutės;68037499606;Taip;0;0;1;1
4037;Lakštingala;Saulutės;51586922715;Taip;0;8;0;8
4038;Lakštingala;Saulutės;62866040506;Taip;0;6;0;6
4039;Lakštingala;Nykštukai;4700135106;Taip;0;4;0;4
4040;Lakštingala;Nykštukai;1863034132;Taip;5;0;3;8
4041;Lakštingala;Nykštukai;9879064676;Ne;4;1;0;5
4042;Lakštingala;Nykštukai;2941128360;Taip;5;1;0;6
4043;Lakštingala;Nykštukai;8284565948;Taip;0;0;1;1
4044;Lakštingala;Nykštukai;2423651716;Taip;0;1;0;1
4045;Lakštingala;Nykštukai;9912622093;Taip;0;6;0;6
4046;Lakštingala;Nykštukai;9489982241;Taip;0;3;0;3
4047;Lakštingala;Nykštukai;4032030375;Taip;6;9;0;15
4048;Lakštingala;Nykštukai;3993759015;Taip;0;11;0;11
4049;Lakštingala;Nykštukai;3724324861;Ne;0;1;1;2
4050;Lakštingala;Nykštukai;2652305131;Taip;0;5;0;5
4051;Lakštingala;Nykštukai;9725851433;Taip;0;6;0;6
4052;Lakštingala;Nykštukai;6332498461;Taip;7;0;2;9
4053;Lakštingala;Nykštukai;1655202909;Taip;7;0;2;9
4054;Lakštingala;Nykštukai;9375002191;Taip;0;2;0;2
4055;Lakštingala;Nykštukai;4857448665;Taip;0;0;3;3
4056;Lakštingala;Nykštukai;2304340938;Taip;0;0;2;2
4057;Lakštingala;Nykštukai;8217315818;Taip;0;0;1;1
4058;Lakštingala;Nykštukai;6292331193;Taip;0;0;2;2
4059;Lakštingala;Nykštukai;7994475429;Taip;9;0;0;9
4060;Lakštingala;Bitutės;3544861594;Taip;0;6;0;6
4061;Lakštingala;Bitutės;1422696792;Taip;4;0;1;5
4062;Lakštingala;Bitutės;16039738423;Taip;3;0;0;3
4063;Lakštingala;Bitutės;95149875628;Taip;0;6;0;6
4064;Lakštingala;Bitutės;2106666739;Taip;11;0;1;12
4065;Lakštingala;Bitutės;91158318909;Taip;5;0;0;5
4066;Lakštingala;Bitutės;92129853333;Taip;0;0;1;1
4067;Lakštingala;Bitutės;14826956710;Ne;10;0;2;12
4068;Lakštingala;Bitutės;63698553352;Taip;0;4;0;4
4069;Lakštingala;Bitutės;19356167631;Taip;0;2;1;3
4070;Lakštingala;Bitutės;45199150020;Taip;0;3;0;3
4071;Lakštingala;Bitutės;24905526995;Taip;0;1;1;2
4072;Lakštingala;Bitutės;1056248263;Taip;6;0;0;6
4073;Lakštingala;Bitutės;56646163756;Taip;0;0;1;1
4074;Lakštingala;Bitutės;7860949054;Taip;0;1;2;3
4075;Lakštingala;Bitutės;82319560992;Taip;0;10;0;10
4076;Lakštingala;Bitutės;2138306323;Taip;0;0;3;3
4077;Lakštingala;Pūkeliai;5598711072;Taip;2;0;1;3
4078;Lakštingala;Pūkeliai;8171357606;Taip;12;4;0;16
4079;Lakštingala;Pūkeliai;9774836470;Taip;2;0;2;4
4080;Lakštingala;Pūkeliai;1958696382;Taip;0;0;4;4
4081;Lakštingala;Pūkeliai;3811230983;Taip;0;0;3;3
4082;Lakštingala;Pūkeliai;4542992319;Taip;15;1;0;16
4083;Lakštingala;Pūkeliai;9346986726;Taip;0;0;1;1
4084;Lakštingala;Pūkeliai;2593030897;Taip;7;0;0;7
4085;Lakštingala;Pūkeliai;7929034243;Taip;0;2;2;4
4086;Lakštingala;Pūkeliai;5854794141;Taip;3;0;0;3
4087;Lakštingala;Pūkeliai;2130192341;Taip;11;0;1;12
4088;Lakštingala;Pūkeliai;8165998647;Taip;12;0;4;16
4089;Lakštingala;Pūkeliai;1458348357;Taip;13;0;2;15
4090;Lakštingala;Pūkeliai;9516403737;Taip;10;0;3;13
4091;Lakštingala;Pūkeliai;4465752871;Taip;0;5;0;5
4092;Lakštingala;Pūkeliai;2430891944;Taip;0;0;1;1
4093;Lakštingala;Pūkeliai;5379344261;Taip;0;0;3;3
4094;Lakštingala;Pūkeliai;4722328994;Taip;0;0;4;4
4095;Lakštingala;Aitvariukai;3872205876;Taip;0;0;7;7
4096;Lakštingala;Aitvariukai;4996777116;Taip;0;0;14;14
4097;Lakštingala;Aitvariukai;7448598447;Taip;0;0;6;6
4098;Lakštingala;Aitvariukai;9390342572;Taip;2;0;7;9
4099;Lakštingala;Aitvariukai;7918688955;Taip;14;0;0;14
4100;Lakštingala;Aitvariukai;6701912968;Taip;0;0;16;16
4101;Lakštingala;Aitvariukai;3509165175;Ne;5;0;0;5
4102;Lakštingala;Aitvariukai;4179366572;Taip;10;0;0;10
4103;Lakštingala;Aitvariukai;5949665703;Taip;8;0;1;9
4104;Lakštingala;Aitvariukai;8679582358;Taip;8;0;1;9
4105;Lakštingala;Aitvariukai;9147821017;Taip;0;0;7;7
4106;Lakštingala;Aitvariukai;5445945319;Taip;1;0;0;1
4107;Lakštingala;Aitvariukai;6597540627;Taip;0;0;9;9
4108;Lakštingala;Aitvariukai;2266870318;Taip;12;0;0;12
4109;Lakštingala;Aitvariukai;3791118736;Taip;8;0;0;8
4110;Lakštingala;Aitvariukai;6565318145;Taip;10;2;3;15
4111;Lakštingala;Aitvariukai;4384468922;Ne;0;1;0;1
4112;Lakštingala;Aitvariukai;5162605666;Taip;10;0;2;12
4113;Lakštingala;Aitvariukai;2073818724;Taip;0;0;2;2
4114;Lakštingala;Aitvariukai;2423761155;Taip;6;0;1;7
4115;Lakštingala;Boružiukai;3280380015;Taip;0;4;1;5
4116;Lakštingala;Boružiukai;9004336424;Ne;7;0;3;10
4117;Lakštingala;Boružiukai;87470014156;Taip;0;0;2;2
4118;Lakštingala;Boružiukai;8820053026;Taip;0;2;0;2
4119;Lakštingala;Boružiukai;2072883878;Taip;9;0;2;11
4120;Lakštingala;Boružiukai;8873445262;Taip;4;0;2;6
4121;Lakštingala;Boružiukai;4811759034;Taip;6;0;0;6
4122;Lakštingala;Boružiukai;1898853302;Ne;0;6;4;10
4123;Lakštingala;Boružiukai;2792618575;Taip;0;16;0;16
4124;Lakštingala;Boružiukai;55720630870;Taip;5;0;2;7
4125;Lakštingala;Boružiukai;4766547534;Taip;0;0;4;4
4126;Lakštingala;Boružiukai;4818524423;Taip;0;5;1;6
4127;Lakštingala;Boružiukai;1444534032;Taip;0;0;2;2
4128;Lakštingala;Boružiukai;6150013105;Taip;0;0;4;4
4129;Lakštingala;Boružiukai;9724531753;Ne;0;0;9;9
4130;Lakštingala;Boružiukai;3602820204;Taip;0;0;3;3
4131;Lakštingala;"KIŠKUČIAI (SAV.)";64992551832;Taip;0;4;0;4
4132;Lakštingala;"KIŠKUČIAI (SAV.)";1169891428;Taip;0;3;0;3
4133;Lakštingala;"KIŠKUČIAI (SAV.)";1409132656;Taip;5;0;0;5
4134;Lakštingala;"KIŠKUČIAI (SAV.)";1236087612;Taip;7;1;0;8
4135;Lakštingala;"KIŠKUČIAI (SAV.)";80762133625;Taip;3;2;0;5
4136;Lakštingala;"KIŠKUČIAI (SAV.)";1128658722;Taip;10;7;0;17
4137;Lakštingala;"KIŠKUČIAI (SAV.)";77712279907;Taip;0;6;0;6
4138;Lakštingala;"KIŠKUČIAI (SAV.)";2083229761;Taip;0;2;3;5
4139;Lakštingala;"KIŠKUČIAI (SAV.)";40853872375;Taip;0;2;0;2
4140;Lakštingala;"KIŠKUČIAI (SAV.)";1716046309;Ne;6;0;2;8
4141;Lakštingala;"KIŠKUČIAI (SAV.)";7038977283;Ne;3;0;0;3
4142;Lakštingala;"KIŠKUČIAI (SAV.)";80142440362;Taip;0;2;1;3
4143;Lakštingala;"KIŠKUČIAI (SAV.)";7623300327;Taip;5;7;0;12
4144;Lakštingala;"KIŠKUČIAI (SAV.)";2241000661;Taip;5;7;0;12
4145;Lakštingala;"KIŠKUČIAI (SAV.)";78648398334;Ne;14;0;3;17
4146;Lakštingala;"KIŠKUČIAI (SAV.)";709506281;Taip;0;0;1;1
4147;Lakštingala;"KIŠKUČIAI (SAV.)";1408127186;Taip;11;1;2;14
4148;Lakštingala;"KIŠKUČIAI (SAV.)";8645237294;Taip;0;1;0;1
4149;Lakštingala;Žiogeliai;9689911725;Taip;0;0;1;1
4150;Lakštingala;Žiogeliai;1832608585;Taip;0;2;0;2
4151;Lakštingala;Žiogeliai;9958821769;Ne;5;0;0;5
4152;Lakštingala;Žiogeliai;7953724873;Taip;0;2;0;2
4153;Lakštingala;Žiogeliai;9800992468;Taip;0;0;1;1
4154;Lakštingala;Žiogeliai;8944088082;Taip;0;1;2;3
4155;Lakštingala;Žiogeliai;9897713625;Taip;0;1;2;3
4156;Lakštingala;Žiogeliai;70798601578;Taip;0;8;0;8
4157;Lakštingala;Žiogeliai;1736130324;Taip;0;0;2;2
4158;Lakštingala;Žiogeliai;2039579203;Taip;0;0;2;2
4159;Lakštingala;Žiogeliai;6576202365;Taip;0;0;8;8
4160;Lakštingala;Žiogeliai;7900597697;Taip;0;3;1;4
4161;Lakštingala;Žiogeliai;9497327995;Taip;0;0;1;1
4162;Lakštingala;Žiogeliai;8470575927;Taip;0;0;2;2
4163;Lakštingala;Žiogeliai;1265027238;Taip;0;9;0;9
4164;Lakštingala;SPINDULIUKAI;601001178;Taip;0;2;2;4
4165;Lakštingala;SPINDULIUKAI;42012300013;Taip;0;1;9;10
4166;Lakštingala;SPINDULIUKAI;2002196654;Taip;0;1;0;1
4167;Lakštingala;SPINDULIUKAI;4261431738;Taip;0;0;2;2
4168;Lakštingala;SPINDULIUKAI;5033145687;Taip;0;1;3;4
4169;Lakštingala;SPINDULIUKAI;26288159700;Ne;4;1;2;7
4170;Lakštingala;SPINDULIUKAI;11399672681;Taip;0;0;2;2
4171;Lakštingala;SPINDULIUKAI;95832669291;Taip;0;9;0;9
4172;Lakštingala;SPINDULIUKAI;4183492894;Taip;0;0;4;4
4173;Lakštingala;SPINDULIUKAI;48160996499;Ne;10;1;0;11
4174;Lakštingala;SPINDULIUKAI;70748679017;Taip;0;0;2;2
4175;Lakštingala;SPINDULIUKAI;4770775472;Taip;0;0;1;1
4176;Lakštingala;SPINDULIUKAI;7448175606;Taip;0;6;0;6
4177;Lakštingala;SPINDULIUKAI;73039119839;Taip;5;0;0;5
4178;Lakštingala;Pėledžiukai;98609129644;Taip;0;7;0;7
4179;Lakštingala;Pėledžiukai;7325183642;Taip;12;0;0;12
4180;Lakštingala;Pėledžiukai;1297637335;Taip;0;0;1;1
4181;Lakštingala;Pėledžiukai;1271455798;Taip;5;0;0;5
4182;Lakštingala;Pėledžiukai;1868573076;Taip;0;7;2;9
4183;Lakštingala;Pėledžiukai;14410791110;Taip;0;0;1;1
4184;Lakštingala;Pėledžiukai;30840899725;Taip;10;0;2;12
4185;Lakštingala;Pėledžiukai;1676655778;Taip;14;0;4;18
4186;Lakštingala;Pėledžiukai;15430318196;Taip;0;0;22;22
4187;Lakštingala;Pėledžiukai;9381815353;Taip;0;0;6;6
4188;Lakštingala;Pėledžiukai;25449089230;Taip;0;5;0;5
4189;Lakštingala;Pėledžiukai;36367286465;Taip;0;0;4;4
4190;Lakštingala;Pėledžiukai;91671174585;Taip;0;0;2;2
4191;Lakštingala;Pėledžiukai;1347480198;Ne;0;1;1;2
4192;Lakštingala;Pėledžiukai;88947243829;Taip;19;0;0;19
4193;Lakštingala;Pėledžiukai;6329787217;Taip;0;0;10;10
4194;Lakštingala;Pėledžiukai;58056130761;Taip;0;11;0;11
4195;Lakštingala;Pėledžiukai;1310400524;Taip;0;0;4;4
4196;Lakštingala;Pėledžiukai;2013216779;Taip;0;0;1;1
4197;Lakštingala;Pėledžiukai;8890852891;Taip;0;0;1;1
4198;Lakštingala;Pėledžiukai;9998322501;Taip;0;0;18;18
4199;Lašelis;VIŠČIUKAI;8324581018;Ne;10;0;0;10
4200;Lašelis;VIŠČIUKAI;6977000987;Taip;5;3;0;8
4201;Lašelis;VIŠČIUKAI;1268330178;Taip;15;2;0;17
4202;Lašelis;VIŠČIUKAI;1417989409;Taip;7;0;0;7
4203;Lašelis;VIŠČIUKAI;6090290046;Taip;0;1;0;1
4204;Lašelis;VIŠČIUKAI;1578956182;Taip;0;6;0;6
4205;Lašelis;VIŠČIUKAI;2500332755;Taip;5;1;0;6
4206;Lašelis;VIŠČIUKAI;1739797553;Taip;5;2;0;7
4207;Lašelis;VIŠČIUKAI;2113295854;Ne;10;0;0;10
4208;Lašelis;VIŠČIUKAI;65174922062;Ne;0;5;0;5
4209;Lašelis;VIŠČIUKAI;5046619730;Taip;4;2;0;6
4210;Lašelis;VIŠČIUKAI;1193336600;Taip;0;12;0;12
4211;Lašelis;VIŠČIUKAI;3741905080;Taip;0;12;0;12
4212;Lašelis;VIŠČIUKAI;6492909546;Ne;14;1;0;15
4213;Lašelis;VIŠČIUKAI;7471332824;Taip;0;14;0;14
4214;Lašelis;VIŠČIUKAI;4599789649;Ne;5;5;0;10
4215;Lašelis;ŠYPSENA;2204859014;Taip;9;0;0;9
4216;Lašelis;ŠYPSENA;3144718477;Taip;10;0;0;10
4217;Lašelis;ŠYPSENA;8809471063;Taip;7;0;1;8
4218;Lašelis;ŠYPSENA;7998812497;Taip;16;0;0;16
4219;Lašelis;ŠYPSENA;3982877012;Taip;18;0;0;18
4220;Lašelis;ŠYPSENA;6669130831;Taip;14;0;0;14
4221;Lašelis;ŠYPSENA;7802622810;Taip;8;0;2;10
4222;Lašelis;ŠYPSENA;1886540733;Taip;5;0;1;6
4223;Lašelis;ŠYPSENA;6553762186;Taip;0;11;0;11
4224;Lašelis;ŠYPSENA;1085400709;Taip;0;8;0;8
4225;Lašelis;ŠYPSENA;6127747445;Taip;9;4;0;13
4226;Lašelis;ŠYPSENA;2912232814;Taip;13;0;2;15
4227;Lašelis;ŠYPSENA;4151582358;Taip;11;3;0;14
4228;Lašelis;ŠYPSENA;1646912457;Taip;10;4;0;14
4229;Lašelis;ŠYPSENA;6080664872;Taip;7;0;0;7
4230;Lašelis;ŠYPSENA;6829438486;Taip;4;0;0;4
4231;Lašelis;NYKŠTUKAI;60394164372;Taip;8;0;2;10
4232;Lašelis;NYKŠTUKAI;1584708183;Taip;0;2;0;2
4233;Lašelis;NYKŠTUKAI;2118500745;Taip;0;0;2;2
4234;Lašelis;NYKŠTUKAI;14934740494;Ne;0;4;0;4
4235;Lašelis;NYKŠTUKAI;7349722463;Taip;0;0;4;4
4236;Lašelis;NYKŠTUKAI;175310584;Taip;0;3;0;3
4237;Lašelis;NYKŠTUKAI;8332516807;Taip;0;0;1;1
4238;Lašelis;NYKŠTUKAI;10694830733;Ne;0;15;0;15
4239;Lašelis;NYKŠTUKAI;82073061357;Taip;0;5;0;5
4240;Lašelis;NYKŠTUKAI;5437008837;Taip;4;0;1;5
4241;Lašelis;NYKŠTUKAI;8873895533;Taip;0;0;1;1
4242;Lašelis;NYKŠTUKAI;2429224297;Taip;0;9;0;9
4243;Lašelis;NYKŠTUKAI;1383759549;Taip;7;0;2;9
4244;Lašelis;NYKŠTUKAI;86191407652;Taip;0;0;5;5
4245;Lašelis;NYKŠTUKAI;9391594216;Taip;2;11;0;13
4246;Lašelis;NYKŠTUKAI;1987591278;Taip;8;0;1;9
4247;Lašelis;SAULUTĖ;1171647193;Taip;8;0;0;8
4248;Lašelis;SAULUTĖ;29417065142;Taip;0;11;0;11
4249;Lašelis;SAULUTĖ;37726695989;Taip;5;1;0;6
4250;Lašelis;SAULUTĖ;87745170593;Taip;6;0;3;9
4251;Lašelis;SAULUTĖ;28071639285;Taip;4;2;0;6
4252;Lašelis;SAULUTĖ;85641710509;Taip;0;0;2;2
4253;Lašelis;SAULUTĖ;1635550414;Taip;0;3;0;3
4254;Lašelis;SAULUTĖ;1833121579;Taip;0;1;0;1
4255;Lašelis;SAULUTĖ;1917927039;Taip;0;19;0;19
4256;Lašelis;SAULUTĖ;38601962350;Taip;0;1;0;1
4257;Lašelis;SAULUTĖ;1099685342;Taip;0;10;0;10
4258;Lašelis;SAULUTĖ;1534313851;Taip;0;1;0;1
4259;Lašelis;SAULUTĖ;34947111596;Taip;0;0;1;1
4260;Lašelis;BORUŽĖLĖS;2886967297;Taip;15;0;2;17
4261;Lašelis;BORUŽĖLĖS;8132517365;Taip;2;1;1;4
4262;Lašelis;BORUŽĖLĖS;1175045927;Taip;4;0;0;4
4263;Lašelis;BORUŽĖLĖS;2401058384;Ne;8;0;5;13
4264;Lašelis;BORUŽĖLĖS;1244168190;Taip;0;9;0;9
4265;Lašelis;BORUŽĖLĖS;2034007263;Taip;5;0;2;7
4266;Lašelis;BORUŽĖLĖS;7367305924;Taip;9;0;1;10
4267;Lašelis;BORUŽĖLĖS;3297005183;Ne;6;0;1;7
4268;Lašelis;BORUŽĖLĖS;8318512396;Taip;16;2;0;18
4269;Lašelis;BORUŽĖLĖS;7657786815;Taip;7;0;0;7
4270;Lašelis;BORUŽĖLĖS;7107685761;Taip;11;0;0;11
4271;Lašelis;BORUŽĖLĖS;3495676199;Taip;6;0;0;6
4272;Lašelis;BORUŽĖLĖS;3843163586;Taip;3;0;0;3
4273;Lašelis;BORUŽĖLĖS;6304391719;Taip;10;0;0;10
4274;Lašelis;SKRUZDELIUKAI;3564781987;Taip;3;0;0;3
4275;Lašelis;SKRUZDELIUKAI;5392759654;Ne;5;1;0;6
4276;Lašelis;SKRUZDELIUKAI;7137348151;Taip;5;0;0;5
4277;Lašelis;SKRUZDELIUKAI;3995905195;Taip;10;0;0;10
4278;Lašelis;SKRUZDELIUKAI;6227091658;Taip;4;3;0;7
4279;Lašelis;SKRUZDELIUKAI;2223293390;Ne;4;0;0;4
4280;Lazdynėlis;BITUTĖS;4881322530;Taip;0;16;0;16
4281;Lazdynėlis;BITUTĖS;6643600680;Taip;8;0;0;8
4282;Lazdynėlis;BITUTĖS;5182241318;Ne;1;0;0;1
4283;Lazdynėlis;BITUTĖS;6762312809;Taip;2;10;0;12
4284;Lazdynėlis;BITUTĖS;8008332680;Taip;5;7;0;12
4285;Lazdynėlis;BITUTĖS;1748260780;Taip;0;22;0;22
4286;Lazdynėlis;BITUTĖS;4462819848;Taip;0;0;2;2
4287;Lazdynėlis;BITUTĖS;1574847460;Taip;0;0;1;1
4288;Lazdynėlis;BITUTĖS;5030400578;Taip;0;0;4;4
4289;Lazdynėlis;BITUTĖS;8159928299;Taip;6;0;4;10
4290;Lazdynėlis;BITUTĖS;7911328294;Taip;0;2;0;2
4291;Lazdynėlis;BITUTĖS;1450181711;Taip;7;0;2;9
4292;Lazdynėlis;BITUTĖS;2044188250;Taip;0;3;0;3
4293;Lazdynėlis;BITUTĖS;4142277927;Taip;19;0;0;19
4294;Lazdynėlis;BITUTĖS;2032759165;Taip;0;0;1;1
4295;Lazdynėlis;BITUTĖS;2802505435;Taip;0;0;3;3
4296;Lazdynėlis;BITUTĖS;6038907328;Ne;5;0;1;6
4297;Lazdynėlis;BITUTĖS;2586187455;Taip;6;0;1;7
4298;Lazdynėlis;BITUTĖS;2013752858;Taip;5;3;3;11
4299;Lazdynėlis;BITUTĖS;4545757725;Taip;0;0;1;1
4300;Lazdynėlis;EŽIUKAI;6086766393;Taip;0;14;0;14
4301;Lazdynėlis;EŽIUKAI;3091067158;Taip;0;1;0;1
4302;Lazdynėlis;EŽIUKAI;1593314326;Taip;11;0;0;11
4303;Lazdynėlis;EŽIUKAI;2041709821;Taip;0;22;0;22
4304;Lazdynėlis;EŽIUKAI;32856469893;Taip;0;3;0;3
4305;Lazdynėlis;EŽIUKAI;6542840562;Taip;0;2;0;2
4306;Lazdynėlis;EŽIUKAI;8975341347;Taip;7;0;0;7
4307;Lazdynėlis;EŽIUKAI;5301460250;Taip;0;0;10;10
4308;Lazdynėlis;EŽIUKAI;1265404063;Taip;4;12;0;16
4309;Lazdynėlis;EŽIUKAI;83586382037;Taip;0;2;1;3
4310;Lazdynėlis;EŽIUKAI;10727984477;Taip;0;1;0;1
4311;Lazdynėlis;EŽIUKAI;9081770664;Taip;0;0;5;5
4312;Lazdynėlis;EŽIUKAI;1479568714;Taip;11;0;1;12
4313;Lazdynėlis;EŽIUKAI;8271766964;Ne;0;17;0;17
4314;Lazdynėlis;EŽIUKAI;9668839027;Ne;12;0;0;12
4315;Lazdynėlis;EŽIUKAI;47861078891;Taip;0;0;8;8
4316;Lazdynėlis;EŽIUKAI;2841262230;Taip;0;22;0;22
4317;Lazdynėlis;EŽIUKAI;7499322078;Taip;10;1;0;11
4318;Lazdynėlis;EŽIUKAI;48860174942;Taip;8;1;0;9
4319;Lazdynėlis;EŽIUKAI;92889991874;Taip;7;0;0;7
4320;Lazdynėlis;EŽIUKAI;65806780298;Taip;0;4;1;5
4321;Lazdynėlis;EŽIUKAI;91720096560;Taip;6;2;1;9
4322;Lazdynėlis;EŽIUKAI;4842228703;Taip;3;8;1;12
4323;Lazdynėlis;BORUŽIUKAI;4961149717;Taip;0;4;2;6
4324;Lazdynėlis;BORUŽIUKAI;99475014554;Taip;0;0;3;3
4325;Lazdynėlis;BORUŽIUKAI;6156638726;Ne;0;11;0;11
4326;Lazdynėlis;BORUŽIUKAI;1321841783;Taip;0;1;0;1
4327;Lazdynėlis;BORUŽIUKAI;9570299877;Taip;0;22;0;22
4328;Lazdynėlis;BORUŽIUKAI;50390821034;Taip;0;1;0;1
4329;Lazdynėlis;BORUŽIUKAI;2112064241;Taip;3;1;1;5
4330;Lazdynėlis;BORUŽIUKAI;57448939020;Taip;0;1;0;1
4331;Lazdynėlis;BORUŽIUKAI;1789237348;Taip;0;15;0;15
4332;Lazdynėlis;BORUŽIUKAI;2105998927;Taip;0;1;0;1
4333;Lazdynėlis;BORUŽIUKAI;29288665418;Taip;22;0;0;22
4334;Lazdynėlis;BORUŽIUKAI;11379612306;Taip;0;8;0;8
4335;Lazdynėlis;BORUŽIUKAI;1650738939;Taip;2;0;0;2
4336;Lazdynėlis;BORUŽIUKAI;7237629135;Taip;13;1;0;14
4337;Lazdynėlis;BORUŽIUKAI;8945282683;Taip;0;2;1;3
4338;Lazdynėlis;BORUŽIUKAI;6230420677;Taip;0;9;0;9
4339;Lazdynėlis;KAČIUKAI;66134107213;Taip;6;9;0;15
4340;Lazdynėlis;KAČIUKAI;52949287680;Taip;0;1;0;1
4341;Lazdynėlis;KAČIUKAI;97795271362;Taip;8;1;1;10
4342;Lazdynėlis;KAČIUKAI;56747379453;Taip;0;1;1;2
4343;Lazdynėlis;KAČIUKAI;1634936961;Taip;22;0;0;22
4344;Lazdynėlis;KAČIUKAI;65438421685;Taip;0;1;0;1
4345;Lazdynėlis;KAČIUKAI;78302777769;Taip;13;1;0;14
4346;Lazdynėlis;KAČIUKAI;85340642919;Taip;0;9;11;20
4347;Lazdynėlis;KAČIUKAI;77950321376;Taip;0;5;0;5
4348;Lazdynėlis;KAČIUKAI;5068598385;Taip;0;1;1;2
4349;Lazdynėlis;KAČIUKAI;2491872016;Taip;0;1;0;1
4350;Lazdynėlis;KAČIUKAI;2740122426;Taip;10;1;1;12
4351;Lazdynėlis;KAČIUKAI;79847018203;Taip;0;1;3;4
4352;Lazdynėlis;KAČIUKAI;1126756897;Ne;0;1;1;2
4353;Lazdynėlis;KAČIUKAI;79583491543;Taip;0;1;2;3
4354;Lazdynėlis;KAČIUKAI;1878157118;Taip;0;0;4;4
4355;Lazdynėlis;KAČIUKAI;7242681767;Taip;0;1;0;1
4356;Lazdynėlis;VOVERIUKAI;4928593615;Taip;0;0;1;1
4357;Lazdynėlis;VOVERIUKAI;6684940385;Taip;15;0;2;17
4358;Lazdynėlis;VOVERIUKAI;9187681789;Taip;5;0;3;8
4359;Lazdynėlis;VOVERIUKAI;14427234202;Taip;10;0;3;13
4360;Lazdynėlis;VOVERIUKAI;25596458181;Taip;0;22;0;22
4361;Lazdynėlis;VOVERIUKAI;18498032472;Taip;0;0;1;1
4362;Lazdynėlis;VOVERIUKAI;158059657;Taip;0;0;6;6
4363;Lazdynėlis;VOVERIUKAI;1852865534;Taip;11;0;0;11
4364;Lazdynėlis;VOVERIUKAI;3902772678;Taip;0;0;3;3
4365;Lazdynėlis;VOVERIUKAI;8822378464;Ne;8;0;1;9
4366;Lazdynėlis;VOVERIUKAI;1386686123;Taip;0;0;1;1
4367;Lazdynėlis;VOVERIUKAI;2587142646;Taip;0;0;6;6
4368;Lazdynėlis;VOVERIUKAI;2603427970;Taip;16;0;3;19
4369;Lazdynėlis;VOVERIUKAI;2441835588;Taip;0;0;5;5
4370;Lazdynėlis;VOVERIUKAI;44510351979;Taip;0;0;11;11
4371;Lazdynėlis;VOVERIUKAI;1424382629;Taip;2;0;2;4
4372;Lazdynėlis;RIEŠUTĖLIAI;53141612488;Taip;0;1;0;1
4373;Lazdynėlis;RIEŠUTĖLIAI;11830560488;Taip;0;10;0;10
4374;Lazdynėlis;RIEŠUTĖLIAI;24433496244;Taip;0;13;0;13
4375;Lazdynėlis;RIEŠUTĖLIAI;95091154108;Taip;0;1;0;1
4376;Lazdynėlis;RIEŠUTĖLIAI;95539787778;Taip;0;12;0;12
4377;Lazdynėlis;RIEŠUTĖLIAI;3000783343;Taip;0;1;0;1
4378;Lazdynėlis;RIEŠUTĖLIAI;66392058189;Taip;0;1;0;1
4379;Lazdynėlis;RIEŠUTĖLIAI;93311489447;Taip;3;5;0;8
4380;Lazdynėlis;RIEŠUTĖLIAI;1213657708;Taip;0;7;0;7
4381;Lazdynėlis;RIEŠUTĖLIAI;1169424024;Taip;0;1;0;1
4382;Lazdynėlis;RIEŠUTĖLIAI;1257093165;Taip;0;1;0;1
4383;Lazdynėlis;RIEŠUTĖLIAI;42460029042;Taip;5;0;0;5
4384;Lazdynėlis;RIEŠUTĖLIAI;58985240094;Taip;0;10;0;10
4385;Lazdynėlis;RIEŠUTĖLIAI;9186165264;Taip;17;0;0;17
4386;Lazdynėlis;ANČIUKAI;5557752248;Taip;7;0;1;8
4387;Lazdynėlis;ANČIUKAI;5888646355;Taip;5;0;8;13
4388;Lazdynėlis;ANČIUKAI;8295967906;Taip;0;0;5;5
4389;Lazdynėlis;ANČIUKAI;7076664657;Taip;4;0;1;5
4390;Lazdynėlis;ANČIUKAI;7864896721;Taip;8;0;0;8
4391;Lazdynėlis;ANČIUKAI;8435203145;Taip;22;0;0;22
4392;Lazdynėlis;ANČIUKAI;4779025603;Taip;0;20;0;20
4393;Lazdynėlis;ANČIUKAI;1335000592;Ne;8;0;1;9
4394;Lazdynėlis;ANČIUKAI;8314002741;Taip;0;0;9;9
4395;Lazdynėlis;ANČIUKAI;2998606948;Taip;19;0;0;19
4396;Lazdynėlis;ANČIUKAI;9886856760;Taip;19;0;0;19
4397;Lazdynėlis;ANČIUKAI;3062408541;Ne;15;0;1;16
4398;Lazdynėlis;ANČIUKAI;7941793866;Taip;0;20;0;20
4399;Lazdynėlis;ANČIUKAI;5796381191;Taip;0;0;5;5
4400;Lazdynėlis;ANČIUKAI;5708643953;Taip;0;0;1;1
4401;Lazdynėlis;ANČIUKAI;9582702244;Taip;5;12;0;17
4402;Lazdynėlis;ANČIUKAI;9231049001;Taip;2;0;3;5
4403;Lazdynėlis;GUDRUČIAI;46106429615;Taip;0;2;1;3
4404;Lazdynėlis;GUDRUČIAI;11183641643;Taip;0;8;1;9
4405;Lazdynėlis;GUDRUČIAI;1543682603;Taip;0;0;6;6
4406;Lazdynėlis;GUDRUČIAI;6079498859;Ne;0;0;6;6
4407;Lazdynėlis;GUDRUČIAI;16456265624;Taip;0;8;0;8
4408;Lazdynėlis;GUDRUČIAI;44974714364;Taip;0;0;1;1
4409;Lazdynėlis;GUDRUČIAI;57304690488;Taip;0;0;1;1
4410;Lazdynėlis;GUDRUČIAI;57619129301;Taip;0;0;2;2
4411;Lazdynėlis;GUDRUČIAI;64086512959;Taip;0;1;1;2
4412;Lazdynėlis;GUDRUČIAI;56719158862;Taip;0;1;0;1
4413;Lazdynėlis;GUDRUČIAI;41094911675;Taip;0;1;1;2
4414;Lazdynėlis;GUDRUČIAI;70505428445;Taip;0;0;5;5
4415;Lazdynėlis;GUDRUČIAI;1349582895;Ne;0;0;1;1
4416;Lazdynėlis;GUDRUČIAI;47140772153;Taip;0;0;2;2
4417;Lazdynėlis;GUDRUČIAI;34657435789;Taip;0;9;0;9
4418;Lazdynėlis;GUDRUČIAI;34619798427;Taip;0;1;1;2
4419;Lazdynėlis;GUDRUČIAI;2496563388;Taip;0;0;4;4
4420;Lazdynėlis;GUDRUČIAI;28670815274;Taip;0;0;1;1
4421;Lazdynėlis;GUDRUČIAI;8704566189;Taip;0;0;1;1
4422;Lazdynėlis;MEŠKIUKAI;3667994076;Taip;18;0;0;18
4423;Lazdynėlis;MEŠKIUKAI;5346485534;Taip;0;19;0;19
4424;Lazdynėlis;MEŠKIUKAI;1325204410;Taip;0;0;9;9
4425;Lazdynėlis;MEŠKIUKAI;3604282352;Taip;0;0;6;6
4426;Lazdynėlis;MEŠKIUKAI;8179584161;Taip;0;17;0;17
4427;Lazdynėlis;MEŠKIUKAI;8942906327;Ne;0;22;0;22
4428;Lazdynėlis;MEŠKIUKAI;9810842975;Taip;10;0;2;12
4429;Lazdynėlis;MEŠKIUKAI;7523052754;Taip;0;22;0;22
4430;Lazdynėlis;MEŠKIUKAI;8248185061;Taip;15;0;1;16
4431;Lazdynėlis;MEŠKIUKAI;8627994583;Taip;0;22;0;22
4432;Lazdynėlis;MEŠKIUKAI;9548653584;Taip;0;22;0;22
4433;Lazdynėlis;MEŠKIUKAI;8337458289;Taip;0;21;0;21
4434;Lazdynėlis;MEŠKIUKAI;3040417651;Taip;0;21;0;21
4435;Linelis;Giliukai;79543604124;Taip;0;0;3;3
4436;Linelis;Giliukai;3300710386;Taip;4;0;5;9
4437;Linelis;Giliukai;1505058152;Ne;5;0;0;5
4438;Linelis;Giliukai;4644771654;Taip;15;2;0;17
4439;Linelis;Giliukai;1270931913;Taip;0;0;5;5
4440;Linelis;Giliukai;1237521453;Ne;0;0;1;1
4441;Linelis;Giliukai;1270843542;Taip;0;0;4;4
4442;Linelis;Giliukai;5903547677;Taip;0;0;1;1
4443;Linelis;Giliukai;37069004807;Taip;0;0;2;2
4444;Linelis;Giliukai;5075219728;Taip;0;0;5;5
4445;Linelis;Giliukai;5302605429;Taip;6;0;3;9
4446;Linelis;Giliukai;1891722948;Taip;14;0;2;16
4447;Linelis;Giliukai;71647031404;Ne;6;0;1;7
4448;Linelis;Giliukai;38426234048;Taip;3;0;0;3
4449;Linelis;Giliukai;1148540808;Taip;0;0;1;1
4450;Linelis;Giliukai;46788785414;Taip;10;0;0;10
4451;Linelis;Giliukai;3483401448;Ne;0;0;9;9
4452;Linelis;Giliukai;61862257310;Taip;0;0;8;8
4453;Linelis;Giliukai;1526473615;Ne;0;0;9;9
4454;Linelis;Saulutė;1374116898;Ne;0;11;0;11
4455;Linelis;Saulutė;76034696439;Taip;0;1;3;4
4456;Linelis;Saulutė;77154624822;Taip;0;1;0;1
4457;Linelis;Saulutė;54594020356;Ne;5;0;8;13
4458;Linelis;Saulutė;4425214681;Taip;4;0;0;4
4459;Linelis;Saulutė;68038417200;Taip;12;0;2;14
4460;Linelis;Saulutė;13522521866;Taip;0;1;2;3
4461;Linelis;Saulutė;92658776822;Taip;0;2;0;2
4462;Linelis;Saulutė;29074930927;Ne;10;0;0;10
4463;Linelis;Saulutė;1539102468;Taip;7;0;2;9
4464;Linelis;Saulutė;68089107580;Taip;0;0;7;7
4465;Linelis;Saulutė;1646521870;Ne;10;0;3;13
4466;Linelis;Saulutė;87947273588;Taip;4;0;1;5
4467;Linelis;Saulutė;93959783827;Taip;0;0;2;2
4468;Linelis;Saulutė;73386013083;Taip;6;0;3;9
4469;Linelis;Saulutė;32821891070;Ne;11;1;0;12
4470;Linelis;Saulutė;1908259203;Taip;0;0;4;4
4471;Linelis;Nykštukai;8339073780;Taip;5;0;5;10
4472;Linelis;Nykštukai;1194624252;Taip;12;0;0;12
4473;Linelis;Nykštukai;2391319590;Taip;11;0;1;12
4474;Linelis;Nykštukai;9666785036;Ne;8;0;0;8
4475;Linelis;Nykštukai;8095635609;Ne;4;0;0;4
4476;Linelis;Nykštukai;1887737859;Taip;0;2;0;2
4477;Linelis;Nykštukai;4253571334;Taip;0;4;0;4
4478;Linelis;Nykštukai;4126444564;Taip;9;0;0;9
4479;Linelis;Nykštukai;8837847094;Taip;7;0;3;10
4480;Linelis;Nykštukai;4738909947;Ne;5;0;0;5
4481;Linelis;Nykštukai;3189188757;Taip;10;0;1;11
4482;Linelis;Nykštukai;1351957198;Taip;0;0;6;6
4483;Linelis;Nykštukai;3682550072;Taip;6;0;0;6
4484;Linelis;Nykštukai;2857645329;Ne;0;0;1;1
4485;Linelis;Nykštukai;6130634131;Taip;0;0;6;6
4486;Linelis;Nykštukai;8654487151;Taip;3;0;1;4
4487;Linelis;Nykštukai;6160295507;Taip;5;0;0;5
4488;Linelis;Nykštukai;6374352500;Taip;12;0;0;12
4489;Linelis;Daigiukai;9775865557;Taip;0;0;2;2
4490;Linelis;Daigiukai;4456549120;Taip;0;0;8;8
4491;Linelis;Daigiukai;7320085613;Taip;10;0;0;10
4492;Linelis;Daigiukai;6460217912;Taip;0;0;9;9
4493;Linelis;Daigiukai;1612049897;Taip;0;0;9;9
4494;Linelis;Daigiukai;2228682366;Taip;0;4;0;4
4495;Linelis;Daigiukai;5650957826;Taip;0;0;3;3
4496;Linelis;Daigiukai;7011836009;Taip;5;0;3;8
4497;Linelis;Daigiukai;6735037523;Taip;0;0;7;7
4498;Linelis;Daigiukai;7881263225;Taip;12;6;0;18
4499;Linelis;Daigiukai;9920959446;Taip;6;5;1;12
4500;Linelis;Daigiukai;8623441952;Taip;0;0;2;2
4501;Linelis;Daigiukai;9154573489;Taip;0;0;1;1
4502;Linelis;Daigiukai;9024362190;Taip;0;0;9;9
4503;Linelis;Daigiukai;8609248429;Taip;0;0;7;7
4504;Markučiai;Žirniukų;4934200922;Taip;0;4;0;4
4505;Markučiai;Žirniukų;89393452327;Ne;4;0;1;5
4506;Markučiai;Žirniukų;61354140820;Taip;0;1;0;1
4507;Markučiai;Žirniukų;59514770545;Taip;0;4;0;4
4508;Markučiai;Žirniukų;68178936347;Taip;0;1;0;1
4509;Markučiai;Žirniukų;62276512687;Taip;0;0;2;2
4510;Markučiai;Žirniukų;95776655287;Taip;3;0;0;3
4511;Markučiai;Žirniukų;47122307518;Taip;0;2;0;2
4512;Markučiai;Žirniukų;1193600084;Taip;0;7;0;7
4513;Markučiai;Žirniukų;3498150320;Taip;0;0;1;1
4514;Markučiai;Žirniukų;1150675918;Taip;0;0;12;12
4515;Markučiai;Žirniukų;95347461846;Taip;4;0;0;4
4516;Markučiai;Žirniukų;1986626575;Taip;6;0;2;8
4517;Markučiai;Žirniukų;2397953983;Taip;10;0;1;11
4518;Markučiai;Nykštukų;46647877230;Taip;0;2;0;2
4519;Markučiai;Nykštukų;37101160556;Taip;0;1;0;1
4520;Markučiai;Nykštukų;92394309416;Taip;0;0;3;3
4521;Markučiai;Nykštukų;81140027425;Taip;0;0;1;1
4522;Markučiai;Nykštukų;6915912992;Taip;0;0;3;3
4523;Markučiai;Nykštukų;88304161598;Taip;0;7;0;7
4524;Markučiai;Nykštukų;76003071176;Taip;0;15;0;15
4525;Markučiai;Nykštukų;1464123752;Taip;1;0;0;1
4526;Markučiai;Nykštukų;9985442003;Taip;0;6;0;6
4527;Markučiai;Nykštukų;1507368475;Taip;12;1;0;13
4528;Markučiai;Nykštukų;1817367317;Taip;8;0;0;8
4529;Markučiai;Nykštukų;5954207590;Taip;1;0;0;1
4530;Markučiai;Pelėdžiukų;3386071459;Taip;4;0;0;4
4531;Markučiai;Pelėdžiukų;4653663237;Ne;15;0;1;16
4532;Markučiai;Pelėdžiukų;6260010822;Taip;10;0;4;14
4533;Markučiai;Pelėdžiukų;5727655114;Taip;5;0;2;7
4534;Markučiai;Pelėdžiukų;6740434675;Taip;10;0;0;10
4535;Markučiai;Pelėdžiukų;6707310242;Taip;18;0;0;18
4536;Markučiai;Pelėdžiukų;2256262371;Taip;17;1;0;18
4537;Markučiai;Pelėdžiukų;7947287013;Taip;7;0;0;7
4538;Markučiai;Pelėdžiukų;2543313198;Taip;4;0;0;4
4539;Markučiai;Pelėdžiukų;4418580273;Taip;9;0;5;14
4540;Markučiai;Pelėdžiukų;5522654429;Taip;13;0;0;13
4541;Markučiai;Pelėdžiukų;4860961508;Taip;3;0;2;5
4542;Markučiai;Pelėdžiukų;9219710045;Ne;0;0;7;7
4543;Markučiai;Boružėlių;9059302464;Taip;4;0;2;6
4544;Markučiai;Boružėlių;9220749889;Taip;6;0;1;7
4545;Markučiai;Boružėlių;2962530721;Taip;2;5;2;9
4546;Markučiai;Boružėlių;6574037877;Taip;1;0;0;1
4547;Markučiai;Boružėlių;5752762229;Taip;7;0;0;7
4548;Markučiai;Boružėlių;4383421917;Taip;0;0;1;1
4549;Markučiai;Boružėlių;9789274040;Taip;0;0;1;1
4550;Markučiai;Boružėlių;1171899107;Taip;6;0;2;8
4551;Markučiai;Boružėlių;8092642447;Ne;0;0;1;1
4552;Markučiai;Boružėlių;8078777204;Taip;7;0;0;7
4553;Markučiai;Boružėlių;8605357678;Taip;0;1;3;4
4554;Markučiai;Boružėlių;3755794133;Taip;8;1;6;15
4555;Markučiai;Boružėlių;8244065962;Ne;5;3;0;8
4556;Markučiai;Boružėlių;5902165968;Taip;6;0;0;6
4557;Markučiai;Boružėlių;4356736070;Taip;8;0;0;8
4558;Markučiai;Boružėlių;6055058096;Taip;17;0;0;17
4559;Markučiai;Boružėlių;5981692282;Taip;3;0;0;3
4560;Markučiai;Boružėlių;3739566642;Taip;20;0;0;20
4561;Markučiai;Boružėlių;6868394315;Taip;0;0;5;5
4562;Markučiai;Bitučių;1720541082;Ne;5;0;1;6
4563;Markučiai;Bitučių;8792524832;Taip;9;0;0;9
4564;Markučiai;Bitučių;1717624510;Taip;9;0;1;10
4565;Markučiai;Bitučių;9518247571;Taip;6;0;1;7
4566;Markučiai;Bitučių;4836298058;Taip;0;0;5;5
4567;Markučiai;Bitučių;9027071539;Taip;0;1;3;4
4568;Markučiai;Bitučių;8748794886;Taip;0;0;5;5
4569;Markučiai;Bitučių;7387460586;Taip;9;0;0;9
4570;Markučiai;Bitučių;8950442843;Taip;10;0;2;12
4571;Markučiai;Bitučių;2840564082;Ne;2;0;4;6
4572;Markučiai;Bitučių;3926993383;Taip;6;0;4;10
4573;Markučiai;Bitučių;6530101961;Taip;11;0;4;15
4574;Markučiai;Bitučių;1908302738;Taip;4;0;1;5
4575;Markučiai;Bitučių;7056367646;Taip;4;0;0;4
4576;Markučiai;Bitučių;2049497686;Taip;17;0;0;17
4577;Markučiai;Bitučių;9303448709;Taip;0;11;6;17
4578;Markučiai;Bitučių;8541042547;Taip;19;0;0;19
4579;Markučiai;Bitučių;1447116821;Taip;10;0;2;12
4580;Markučiai;Bitučių;6600535396;Taip;6;0;3;9
4581;Markučiai;Drugelių;2851424931;Taip;0;0;6;6
4582;Markučiai;Drugelių;63211076619;Taip;0;0;7;7
4583;Markučiai;Drugelių;2608111078;Taip;5;0;6;11
4584;Markučiai;Drugelių;4573605085;Ne;10;0;0;10
4585;Markučiai;Drugelių;19415636420;Taip;0;0;3;3
4586;Markučiai;Drugelių;24315961901;Taip;8;0;0;8
4587;Markučiai;Drugelių;45698891062;Taip;0;0;1;1
4588;Markučiai;Drugelių;9028932081;Taip;0;12;0;12
4589;Markučiai;Drugelių;11203825718;Taip;0;0;3;3
4590;Markučiai;Drugelių;7194049189;Taip;5;0;1;6
4591;Markučiai;Drugelių;1964223995;Taip;4;0;2;6
4592;Markučiai;Drugelių;23081602011;Ne;0;0;10;10
4593;Markučiai;Drugelių;9295954145;Taip;0;0;3;3
4594;Markučiai;Skruzdėliukų;1471334430;Taip;7;0;5;12
4595;Markučiai;Skruzdėliukų;9825799013;Ne;0;1;0;1
4596;Markučiai;Skruzdėliukų;8803226424;Ne;0;0;6;6
4597;Markučiai;Skruzdėliukų;55093673733;Taip;0;7;0;7
4598;Markučiai;Skruzdėliukų;39971140989;Taip;0;0;3;3
4599;Markučiai;Skruzdėliukų;54732351634;Taip;0;0;2;2
4600;Markučiai;Skruzdėliukų;1419433247;Taip;15;5;1;21
4601;Markučiai;Skruzdėliukų;1089500743;Taip;0;13;0;13
4602;Markučiai;Skruzdėliukų;2939795063;Taip;0;1;1;2
4603;Markučiai;Skruzdėliukų;9285037135;Taip;19;0;0;19
4604;Markučiai;Skruzdėliukų;1699369138;Ne;0;0;9;9
4605;Markučiai;Skruzdėliukų;1881218133;Taip;3;1;0;4
4606;Markučiai;Skruzdėliukų;1200278823;Ne;0;0;8;8
4607;Markučiai;Skruzdėliukų;8863238710;Taip;0;0;9;9
4608;Markučiai;Skruzdėliukų;68193563408;Taip;0;3;0;3
4609;Markučiai;Skruzdėliukų;92854605649;Taip;0;0;6;6
4610;Markučiai;Skruzdėliukų;1529531638;Taip;0;0;2;2
4611;Markučiai;Skruzdėliukų;4511936094;Taip;7;0;0;7
4612;Markučiai;ZUIKUČIŲ;82320812575;Taip;0;0;2;2
4613;Markučiai;ZUIKUČIŲ;4861535057;Taip;0;0;1;1
4614;Markučiai;ZUIKUČIŲ;1482203905;Taip;0;0;2;2
4615;Markučiai;ZUIKUČIŲ;2045207175;Taip;0;3;0;3
4616;Markučiai;ZUIKUČIŲ;11751635395;Taip;0;2;0;2
4617;Markučiai;ZUIKUČIŲ;1184908076;Taip;8;4;0;12
4618;Markučiai;ZUIKUČIŲ;7729045227;Taip;5;0;2;7
4619;Markučiai;ZUIKUČIŲ;8061880631;Taip;11;0;0;11
4620;Markučiai;ZUIKUČIŲ;1392582514;Taip;9;1;0;10
4621;Markučiai;ZUIKUČIŲ;7691410556;Taip;0;9;0;9
4622;Markučiai;ZUIKUČIŲ;7969520467;Taip;12;0;0;12
4623;Markučiai;ZUIKUČIŲ;6453095915;Taip;1;0;0;1
4624;Markučiai;ZUIKUČIŲ;6808291628;Taip;10;8;0;18
4625;Markučiai;ZUIKUČIŲ;5387571295;Taip;6;0;2;8
4626;Markučiai;ZUIKUČIŲ;3794643964;Taip;0;2;0;2
4627;Markučiai;ZUIKUČIŲ;91228262895;Taip;5;17;0;22
4628;Markučiai;ZUIKUČIŲ;7481923902;Taip;0;0;1;1
4629;Markučiai;ZUIKUČIŲ;1025406111;Taip;0;15;0;15
4630;Markučiai;ZUIKUČIŲ;5749873170;Taip;0;0;4;4
4631;Markučiai;ŽIOGELIŲ;5099997904;Taip;4;0;7;11
4632;Markučiai;ŽIOGELIŲ;3163226803;Taip;5;0;0;5
4633;Markučiai;ŽIOGELIŲ;1244026489;Taip;15;0;0;15
4634;Markučiai;ŽIOGELIŲ;76025616287;Taip;5;0;0;5
4635;Markučiai;ŽIOGELIŲ;54892037118;Taip;6;0;1;7
4636;Markučiai;ŽIOGELIŲ;1054802708;Taip;10;0;0;10
4637;Markučiai;ŽIOGELIŲ;67074776419;Taip;6;0;0;6
4638;Markučiai;ŽIOGELIŲ;1007919702;Taip;0;3;0;3
4639;Markučiai;ŽIOGELIŲ;1923521405;Taip;0;0;3;3
4640;Markučiai;ŽIOGELIŲ;1164386108;Taip;0;0;3;3
4641;Markučiai;ŽIOGELIŲ;2169583290;Taip;0;13;0;13
4642;Markučiai;ŽIOGELIŲ;3340385503;Ne;4;0;4;8
4643;Markučiai;ŽIOGELIŲ;4152184290;Taip;0;0;9;9
4644;Markučiai;ŽIOGELIŲ;23267867195;Taip;7;0;0;7
4645;Markučiai;Ežiukių;1827829954;Taip;11;2;0;13
4646;Markučiai;Ežiukių;4925856706;Taip;0;5;0;5
4647;Markučiai;Ežiukių;6570638672;Taip;7;2;0;9
4648;Markučiai;Ežiukių;3771563320;Taip;11;0;0;11
4649;Markučiai;Ežiukių;1648283497;Taip;6;11;0;17
4650;Markučiai;Ežiukių;4186684938;Taip;10;0;0;10
4651;Markučiai;Ežiukių;5975331223;Taip;0;0;1;1
4652;Markučiai;Ežiukių;2687320408;Ne;10;0;0;10
4653;Markučiai;Ežiukių;1309122110;Taip;5;1;3;9
4654;Markučiai;Ežiukių;8990923872;Taip;11;0;0;11
4655;Markučiai;Ežiukių;2738553283;Taip;0;20;2;22
4656;Markučiai;Ežiukių;5246980173;Ne;9;0;0;9
4657;Markučiai;Ežiukių;6308368050;Ne;12;0;0;12
4658;Markučiai;Ežiukių;4249158803;Taip;5;0;0;5
4659;Markučiai;Ežiukių;5958705106;Taip;10;0;4;14
4660;Markučiai;Ežiukių;3770972703;Ne;5;0;0;5
4661;Markučiai;Ežiukių;1769984489;Taip;0;0;1;1
4662;Mažylis;"2 DARŽELIO GR.";2979849055;Ne;0;0;1;1
4663;Mažylis;"2 DARŽELIO GR.";4503734408;Taip;8;0;2;10
4664;Mažylis;"2 DARŽELIO GR.";6162880220;Taip;6;0;0;6
4665;Mažylis;"2 DARŽELIO GR.";9362249595;Taip;0;0;3;3
4666;Mažylis;"2 DARŽELIO GR.";1077493584;Taip;3;0;1;4
4667;Mažylis;"2 DARŽELIO GR.";6854350717;Taip;0;0;5;5
4668;Mažylis;"2 DARŽELIO GR.";2704741847;Taip;0;0;2;2
4669;Mažylis;"2 DARŽELIO GR.";5870983755;Taip;0;0;3;3
4670;Mažylis;"2 DARŽELIO GR.";7185347381;Taip;0;0;2;2
4671;Mažylis;"2 DARŽELIO GR.";3327673298;Ne;0;0;6;6
4672;Mažylis;"2 DARŽELIO GR.";4280547746;Taip;0;0;3;3
4673;Mažylis;"2 DARŽELIO GR.";9447747294;Taip;0;0;2;2
4674;Mažylis;"2 DARŽELIO GR.";2126108232;Taip;0;0;9;9
4675;Mažylis;"2 DARŽELIO GR.";9382248260;Taip;20;0;1;21
4676;Mažylis;"2 DARŽELIO GR.";2672500259;Taip;0;0;1;1
4677;Mažylis;"2 DARŽELIO GR.";8135596731;Taip;0;0;3;3
4678;Mažylis;"2 DARŽELIO GR.";8866980930;Taip;7;0;0;7
4679;Mažylis;"2 DARŽELIO GR.";4553092508;Taip;16;0;0;16
4680;Mažylis;"2 DARŽELIO GR.";4542742002;Taip;0;0;3;3
4681;Mažylis;"4 PRIEŠMOKYKLINĖ GR.";38333694019;Taip;0;0;8;8
4682;Mažylis;"4 PRIEŠMOKYKLINĖ GR.";4899739075;Taip;0;0;8;8
4683;Mažylis;"4 PRIEŠMOKYKLINĖ GR.";1217081615;Taip;0;0;9;9
4684;Mažylis;"4 PRIEŠMOKYKLINĖ GR.";71414598607;Taip;0;0;2;2
4685;Mažylis;"4 PRIEŠMOKYKLINĖ GR.";2249845212;Taip;0;0;2;2
4686;Mažylis;"4 PRIEŠMOKYKLINĖ GR.";10093289570;Ne;5;0;0;5
4687;Mažylis;"4 PRIEŠMOKYKLINĖ GR.";99612915803;Taip;0;0;12;12
4688;Mažylis;"4 PRIEŠMOKYKLINĖ GR.";72018918082;Taip;3;0;2;5
4689;Mažylis;"4 PRIEŠMOKYKLINĖ GR.";34677678888;Ne;0;4;0;4
4690;Mažylis;"4 PRIEŠMOKYKLINĖ GR.";44917962136;Taip;12;0;1;13
4691;Mažylis;"4 PRIEŠMOKYKLINĖ GR.";1023886258;Ne;0;0;7;7
4692;Mažylis;"4 PRIEŠMOKYKLINĖ GR.";68630915872;Taip;0;0;2;2
4693;Mažylis;"4 PRIEŠMOKYKLINĖ GR.";1418120714;Taip;13;0;0;13
4694;Mažylis;"4 PRIEŠMOKYKLINĖ GR.";1381948803;Taip;8;0;1;9
4695;Mažylis;"4 PRIEŠMOKYKLINĖ GR.";1355103006;Taip;0;10;0;10
4696;Mažylis;"5 DARŽ.GR.";7774469604;Taip;0;0;6;6
4697;Mažylis;"5 DARŽ.GR.";71577274183;Ne;7;0;2;9
4698;Mažylis;"5 DARŽ.GR.";9095049088;Taip;4;0;1;5
4699;Mažylis;"5 DARŽ.GR.";1692808423;Taip;0;0;4;4
4700;Mažylis;"5 DARŽ.GR.";76814348181;Taip;0;5;0;5
4701;Mažylis;"5 DARŽ.GR.";18640177395;Taip;3;0;2;5
4702;Mažylis;"5 DARŽ.GR.";37676161966;Ne;10;0;1;11
4703;Mažylis;"5 DARŽ.GR.";91436869919;Taip;0;0;5;5
4704;Mažylis;"5 DARŽ.GR.";36307201422;Ne;0;0;1;1
4705;Mažylis;"5 DARŽ.GR.";9958976870;Taip;9;0;0;9
4706;Mažylis;"5 DARŽ.GR.";56438009944;Ne;0;9;0;9
4707;Mažylis;"5 DARŽ.GR.";11471986928;Taip;0;0;4;4
4708;Mažylis;"5 DARŽ.GR.";1391395429;Taip;0;0;5;5
4709;Mažylis;"5 DARŽ.GR.";43986953632;Ne;0;8;0;8
4710;Mažylis;"5 DARŽ.GR.";3436690709;Taip;6;0;0;6
4711;Mažylis;"5 DARŽ.GR.";8318476578;Taip;8;0;0;8
4712;Mažylis;"5 DARŽ.GR.";8490035231;Taip;0;16;0;16
4713;Mažylis;"3 DARŽELIO GR.";98057700570;Taip;4;0;0;4
4714;Mažylis;"3 DARŽELIO GR.";1643460270;Taip;0;0;1;1
4715;Mažylis;"3 DARŽELIO GR.";24303144913;Taip;0;0;5;5
4716;Mažylis;"3 DARŽELIO GR.";69238700097;Taip;0;0;2;2
4717;Mažylis;"3 DARŽELIO GR.";50868656860;Taip;0;0;1;1
4718;Mažylis;"3 DARŽELIO GR.";2070067356;Ne;0;0;7;7
4719;Mažylis;"3 DARŽELIO GR.";81907805809;Taip;0;0;12;12
4720;Mažylis;"3 DARŽELIO GR.";1999937720;Taip;7;0;1;8
4721;Mažylis;"3 DARŽELIO GR.";98251642256;Taip;0;0;4;4
4722;Mažylis;"3 DARŽELIO GR.";90336289067;Ne;0;0;1;1
4723;Mažylis;"3 DARŽELIO GR.";1021183555;Taip;0;0;2;2
4724;Mažylis;"3 DARŽELIO GR.";1910064549;Taip;0;0;2;2
4725;Mažylis;"3 DARŽELIO GR.";2520667095;Taip;0;0;2;2
4726;Mažylis;"3 DARŽELIO GR.";2299288258;Taip;0;0;3;3
4727;Mažylis;"3 DARŽELIO GR.";5479496104;Taip;10;0;0;10
4728;Mažylis;"3 DARŽELIO GR.";1520251270;Taip;0;0;9;9
4729;Mažylis;"6 DARŽELIO GR.";9411559447;Taip;8;0;2;10
4730;Mažylis;"6 DARŽELIO GR.";79181926145;Taip;11;0;0;11
4731;Mažylis;"6 DARŽELIO GR.";45148418456;Taip;0;0;1;1
4732;Mažylis;"6 DARŽELIO GR.";8352202912;Taip;0;0;6;6
4733;Mažylis;"6 DARŽELIO GR.";38277640135;Taip;9;0;0;9
4734;Mažylis;"6 DARŽELIO GR.";8899463988;Taip;0;0;1;1
4735;Mažylis;"6 DARŽELIO GR.";1663347167;Ne;18;0;0;18
4736;Mažylis;"6 DARŽELIO GR.";5063094678;Taip;0;0;6;6
4737;Mažylis;"6 DARŽELIO GR.";6920129837;Ne;11;0;0;11
4738;Mažylis;"6 DARŽELIO GR.";1460572347;Taip;4;0;0;4
4739;Mažylis;"6 DARŽELIO GR.";3860760654;Taip;9;0;3;12
4740;Mažylis;"6 DARŽELIO GR.";6851169340;Taip;1;3;0;4
4741;Mažylis;"6 DARŽELIO GR.";4486742281;Ne;0;0;13;13
4742;Mažylis;"6 DARŽELIO GR.";4252408251;Ne;6;0;3;9
4743;Mažylis;"6 DARŽELIO GR.";3217527771;Taip;5;0;0;5
4744;Mažylis;"6 DARŽELIO GR.";6134051712;Taip;0;0;1;1
4745;Mažylis;"6 DARŽELIO GR.";7416381505;Ne;10;0;2;12
4746;Mažylis;"6 DARŽELIO GR.";1514640197;Taip;0;0;4;4
4747;Mažylis;"6 DARŽELIO GR.";1002832487;Taip;5;0;0;5
4748;Mažylis;"6 DARŽELIO GR.";9608529135;Taip;0;0;5;5
4749;Mažylis;"1 NAUJA (LOPŠELIS)";5685988186;Taip;6;0;0;6
4750;Mažylis;"1 NAUJA (LOPŠELIS)";7754956214;Taip;0;0;2;2
4751;Mažylis;"1 NAUJA (LOPŠELIS)";8589124394;Taip;6;0;0;6
4752;Mažylis;"1 NAUJA (LOPŠELIS)";8639480781;Taip;4;0;0;4
4753;Mažylis;"1 NAUJA (LOPŠELIS)";2672864291;Taip;7;0;0;7
4754;Mažylis;"1 NAUJA (LOPŠELIS)";9401388775;Taip;0;0;6;6
4755;Mažylis;"1 NAUJA (LOPŠELIS)";6009637985;Taip;5;0;1;6
4756;Mažylis;"1 NAUJA (LOPŠELIS)";3400122626;Taip;4;0;2;6
4757;Mažylis;"1 NAUJA (LOPŠELIS)";6809320247;Taip;4;0;2;6
4758;Mažylis;"1 NAUJA (LOPŠELIS)";7052112957;Taip;0;0;9;9
4759;Mažylis;"1 NAUJA (LOPŠELIS)";9341935211;Taip;0;0;4;4
4760;Mažylis;"1 NAUJA (LOPŠELIS)";4817146074;Taip;0;0;4;4
4761;Mažylis;"1 NAUJA (LOPŠELIS)";2656290898;Taip;0;0;1;1
4762;Medynėlis;BITUTĖS;1721728772;Taip;0;6;0;6
4763;Medynėlis;BITUTĖS;1870621987;Taip;4;0;0;4
4764;Medynėlis;BITUTĖS;51942577095;Taip;0;1;0;1
4765;Medynėlis;BITUTĖS;46570048371;Taip;0;2;0;2
4766;Medynėlis;BITUTĖS;57858019710;Ne;0;0;1;1
4767;Medynėlis;BITUTĖS;78341557395;Taip;2;0;5;7
4768;Medynėlis;BITUTĖS;38838111813;Taip;20;1;0;21
4769;Medynėlis;BITUTĖS;72334464245;Ne;0;10;0;10
4770;Medynėlis;BITUTĖS;44971270687;Taip;0;0;1;1
4771;Medynėlis;BITUTĖS;39476010274;Ne;11;0;0;11
4772;Medynėlis;BITUTĖS;43383127907;Taip;4;0;0;4
4773;Medynėlis;BITUTĖS;7522506857;Taip;1;0;0;1
4774;Medynėlis;BITUTĖS;2055140361;Taip;0;9;2;11
4775;Medynėlis;BITUTĖS;1663988144;Taip;0;8;0;8
4776;Medynėlis;DRUGELIAI;29673282359;Taip;0;3;0;3
4777;Medynėlis;DRUGELIAI;77267420461;Taip;7;2;0;9
4778;Medynėlis;DRUGELIAI;64020246327;Taip;0;1;0;1
4779;Medynėlis;DRUGELIAI;82368415455;Ne;0;1;0;1
4780;Medynėlis;DRUGELIAI;22422832248;Taip;5;4;0;9
4781;Medynėlis;DRUGELIAI;1673034349;Ne;0;2;0;2
4782;Medynėlis;DRUGELIAI;22845549109;Taip;7;1;0;8
4783;Medynėlis;DRUGELIAI;20592655649;Taip;0;9;0;9
4784;Medynėlis;DRUGELIAI;64603154583;Taip;7;0;0;7
4785;Medynėlis;DRUGELIAI;68940537831;Taip;0;4;0;4
4786;Medynėlis;DRUGELIAI;75083011184;Taip;22;0;0;22
4787;Medynėlis;DRUGELIAI;5748498291;Ne;0;5;0;5
4788;Medynėlis;DRUGELIAI;76282032727;Taip;0;2;0;2
4789;Medynėlis;DRUGELIAI;1828684971;Taip;10;0;0;10
4790;Medynėlis;DRUGELIAI;30399789674;Taip;15;2;0;17
4791;Medynėlis;SKRUZDĖLIUKAI;4024866819;Taip;12;10;0;22
4792;Medynėlis;SKRUZDĖLIUKAI;2418225089;Taip;3;6;0;9
4793;Medynėlis;SKRUZDĖLIUKAI;9413309043;Taip;0;0;3;3
4794;Medynėlis;SKRUZDĖLIUKAI;4581683292;Taip;15;1;0;16
4795;Medynėlis;SKRUZDĖLIUKAI;4137297035;Taip;7;0;5;12
4796;Medynėlis;SKRUZDĖLIUKAI;9009316740;Taip;0;1;1;2
4797;Medynėlis;SKRUZDĖLIUKAI;1795479738;Taip;0;14;0;14
4798;Medynėlis;SKRUZDĖLIUKAI;5530782065;Taip;0;0;2;2
4799;Medynėlis;SKRUZDĖLIUKAI;5269927048;Taip;0;0;7;7
4800;Medynėlis;SKRUZDĖLIUKAI;2427349194;Taip;3;0;0;3
4801;Medynėlis;SKRUZDĖLIUKAI;8948133343;Taip;0;1;0;1
4802;Medynėlis;SKRUZDĖLIUKAI;7633674694;Ne;0;2;0;2
4803;Medynėlis;SKRUZDĖLIUKAI;7244497661;Ne;0;0;4;4
4804;Medynėlis;SKRUZDĖLIUKAI;5995034919;Taip;1;0;5;6
4805;Medynėlis;SKRUZDĖLIUKAI;8775219704;Taip;7;8;0;15
4806;Medynėlis;SKRUZDĖLIUKAI;1658457155;Taip;0;0;2;2
4807;Medynėlis;SKRUZDĖLIUKAI;33981260502;Taip;0;10;0;10
4808;Medynėlis;SKRUZDĖLIUKAI;3773215372;Taip;0;1;0;1
4809;Medynėlis;SKRUZDĖLIUKAI;6343851636;Ne;8;0;0;8
4810;Medynėlis;VOVERIUKAI;2834559432;Taip;8;0;2;10
4811;Medynėlis;VOVERIUKAI;2310200034;Ne;0;2;0;2
4812;Medynėlis;VOVERIUKAI;90556319090;Taip;0;1;0;1
4813;Medynėlis;VOVERIUKAI;6999562417;Taip;0;0;3;3
4814;Medynėlis;VOVERIUKAI;5586407412;Taip;4;9;5;18
4815;Medynėlis;VOVERIUKAI;7108619017;Taip;0;7;0;7
4816;Medynėlis;VOVERIUKAI;8441104709;Taip;0;2;0;2
4817;Medynėlis;VOVERIUKAI;1820113382;Taip;0;4;0;4
4818;Medynėlis;VOVERIUKAI;5982453884;Taip;6;0;3;9
4819;Medynėlis;VOVERIUKAI;6406459222;Taip;12;1;0;13
4820;Medynėlis;VOVERIUKAI;2335108073;Ne;12;0;0;12
4821;Medynėlis;VOVERIUKAI;4985243068;Taip;6;0;2;8
4822;Medynėlis;VOVERIUKAI;9073514151;Taip;0;6;0;6
4823;Medynėlis;VOVERIUKAI;4238860287;Ne;0;0;1;1
4824;Medynėlis;VOVERIUKAI;1750775033;Taip;0;0;2;2
4825;Medynėlis;VOVERIUKAI;9800678364;Taip;0;0;10;10
4826;Medynėlis;VOVERIUKAI;1237589979;Taip;10;0;0;10
4827;Medynėlis;MEŠKIUKAI;1434648803;Taip;5;12;0;17
4828;Medynėlis;MEŠKIUKAI;1975763240;Ne;0;0;2;2
4829;Medynėlis;MEŠKIUKAI;5347745655;Ne;5;6;0;11
4830;Medynėlis;MEŠKIUKAI;1781906016;Taip;0;4;0;4
4831;Medynėlis;MEŠKIUKAI;91658912153;Taip;0;8;0;8
4832;Medynėlis;MEŠKIUKAI;1269734734;Taip;0;6;0;6
4833;Medynėlis;MEŠKIUKAI;46445461622;Taip;5;0;3;8
4834;Medynėlis;MEŠKIUKAI;7226012217;Taip;14;0;1;15
4835;Medynėlis;MEŠKIUKAI;5007624930;Ne;5;5;0;10
4836;Medynėlis;MEŠKIUKAI;8629622922;Ne;8;0;1;9
4837;Medynėlis;MEŠKIUKAI;1479759021;Taip;5;7;0;12
4838;Medynėlis;MEŠKIUKAI;2389345601;Taip;11;0;1;12
4839;Medynėlis;MEŠKIUKAI;1635649525;Ne;0;2;0;2
4840;Medynėlis;MEŠKIUKAI;6479758789;Taip;5;0;0;5
4841;Medynėlis;MEŠKIUKAI;12287981032;Taip;4;0;3;7
4842;Medynėlis;MEŠKIUKAI;12812096047;Taip;15;0;2;17
4843;Medynėlis;MEŠKIUKAI;2326848026;Taip;0;0;6;6
4844;Medynėlis;MEŠKIUKAI;5924711043;Taip;0;10;1;11
4845;Medynėlis;MEŠKIUKAI;8143370943;Taip;5;0;8;13
4846;Medynėlis;MEŠKIUKAI;32683798983;Taip;5;0;0;5
4847;Medynėlis;MEŠKIUKAI;99799126572;Taip;0;2;0;2
4848;Medynėlis;PELĖDŽIUKAI;1379827887;Taip;13;0;3;16
4849;Medynėlis;PELĖDŽIUKAI;1829338208;Ne;4;10;1;15
4850;Medynėlis;PELĖDŽIUKAI;88240380945;Taip;7;0;0;7
4851;Medynėlis;PELĖDŽIUKAI;1129265551;Taip;6;0;1;7
4852;Medynėlis;PELĖDŽIUKAI;76668029492;Taip;10;0;0;10
4853;Medynėlis;PELĖDŽIUKAI;1080058205;Taip;7;0;3;10
4854;Medynėlis;PELĖDŽIUKAI;1968892466;Taip;0;5;0;5
4855;Medynėlis;PELĖDŽIUKAI;1194247621;Taip;0;0;3;3
4856;Medynėlis;PELĖDŽIUKAI;1755767517;Taip;0;10;0;10
4857;Medynėlis;PELĖDŽIUKAI;37435525923;Taip;5;0;1;6
4858;Medynėlis;PELĖDŽIUKAI;1415208530;Taip;4;1;0;5
4859;Medynėlis;PELĖDŽIUKAI;7804751416;Ne;10;2;0;12
4860;Medynėlis;PELĖDŽIUKAI;6182500688;Ne;0;0;5;5
4861;Medynėlis;PELĖDŽIUKAI;2831484614;Taip;0;7;0;7
4862;Medynėlis;PELĖDŽIUKAI;8122944228;Taip;5;0;3;8
4863;Medynėlis;PELĖDŽIUKAI;53914093216;Taip;0;2;0;2
4864;Medynėlis;PELĖDŽIUKAI;12150004702;Ne;1;1;0;2
4865;Medynėlis;BORUŽIUKAI;1657676226;Taip;0;1;0;1
4866;Medynėlis;BORUŽIUKAI;1314163134;Taip;2;2;0;4
4867;Medynėlis;BORUŽIUKAI;1010025777;Taip;0;2;0;2
4868;Medynėlis;BORUŽIUKAI;96544597673;Taip;8;0;0;8
4869;Medynėlis;BORUŽIUKAI;79786316561;Taip;0;2;1;3
4870;Medynėlis;BORUŽIUKAI;1563329598;Taip;0;4;0;4
4871;Medynėlis;BORUŽIUKAI;1611512841;Taip;0;6;0;6
4872;Medynėlis;BORUŽIUKAI;55848491611;Taip;10;0;2;12
4873;Medynėlis;BORUŽIUKAI;1192592678;Ne;11;1;0;12
4874;Medynėlis;BORUŽIUKAI;7628899696;Taip;15;0;0;15
4875;Medynėlis;BORUŽIUKAI;48636516521;Taip;0;1;0;1
4876;Medynėlis;EŽIUKAI;1409464952;Taip;0;0;1;1
4877;Medynėlis;EŽIUKAI;3398294520;Taip;0;2;0;2
4878;Medynėlis;EŽIUKAI;2026582294;Taip;0;8;0;8
4879;Medynėlis;EŽIUKAI;1437000615;Taip;0;13;0;13
4880;Medynėlis;EŽIUKAI;1995078812;Taip;0;4;0;4
4881;Medynėlis;EŽIUKAI;1208227740;Taip;0;3;0;3
4882;Medynėlis;EŽIUKAI;56154878520;Taip;0;5;0;5
4883;Medynėlis;EŽIUKAI;3165639252;Ne;0;0;5;5
4884;Medynėlis;EŽIUKAI;1882919126;Taip;3;1;0;4
4885;Medynėlis;EŽIUKAI;1472082682;Ne;0;1;0;1
4886;Medynėlis;EŽIUKAI;61158254770;Taip;7;1;0;8
4887;Medynėlis;EŽIUKAI;1216195798;Taip;0;3;0;3
4888;Medynėlis;EŽIUKAI;3225662051;Taip;7;0;0;7
4889;Medynėlis;EŽIUKAI;1915791061;Taip;0;0;2;2
4890;Medynėlis;EŽIUKAI;1036752305;Taip;11;2;0;13
4891;Medynėlis;ZUIKUČIAI;6706028300;Taip;2;0;0;2
4892;Medynėlis;ZUIKUČIAI;9438854582;Taip;0;0;8;8
4893;Medynėlis;ZUIKUČIAI;9079900803;Taip;6;0;10;16
4894;Medynėlis;ZUIKUČIAI;8276864168;Ne;6;0;1;7
4895;Medynėlis;ZUIKUČIAI;8074251036;Taip;0;0;1;1
4896;Medynėlis;ZUIKUČIAI;2932544910;Taip;7;0;0;7
4897;Medynėlis;ZUIKUČIAI;6955467123;Taip;0;0;2;2
4898;Medynėlis;ZUIKUČIAI;1621499650;Taip;0;0;1;1
4899;Medynėlis;ZUIKUČIAI;4222917765;Taip;0;0;1;1
4900;Medynėlis;ZUIKUČIAI;4323515017;Taip;0;0;2;2
4901;Medynėlis;ZUIKUČIAI;5571641847;Taip;14;0;0;14
4902;Medynėlis;ZUIKUČIAI;6073797962;Taip;0;1;2;3
4903;Medynėlis;ZUIKUČIAI;1901805808;Taip;6;0;1;7
4904;Medynėlis;ZUIKUČIAI;5784691118;Taip;6;0;1;7
4905;Medynėlis;KAČIUKAI;7740591575;Taip;0;1;0;1
4906;Medynėlis;KAČIUKAI;3761845905;Taip;0;0;1;1
4907;Medynėlis;KAČIUKAI;3761845905;Taip;0;0;1;1
4908;Medynėlis;KAČIUKAI;1475701065;Taip;5;4;0;9
4909;Medynėlis;KAČIUKAI;7638618099;Ne;4;0;0;4
4910;Medynėlis;KAČIUKAI;2627655353;Ne;0;0;9;9
4911;Medynėlis;KAČIUKAI;2086963376;Taip;4;4;0;8
4912;Medynėlis;KAČIUKAI;1587899391;Ne;0;0;3;3
4913;Medynėlis;KAČIUKAI;1056744101;Taip;0;4;10;14
4914;Medynėlis;KAČIUKAI;7455041214;Taip;7;0;0;7
4915;Medynėlis;KAČIUKAI;5267128750;Ne;8;0;0;8
4916;Medynėlis;KAČIUKAI;3554823424;Taip;5;0;3;8
4917;Medynėlis;KAČIUKAI;7272017225;Taip;3;0;0;3
4918;Medynėlis;KAČIUKAI;4092824377;Taip;9;1;0;10
4919;Medynėlis;KAČIUKAI;6826790492;Taip;5;5;1;11
4920;Medynėlis;KAČIUKAI;4488439037;Taip;5;1;2;8
4921;Medynėlis;KAČIUKAI;6485314750;Taip;5;0;1;6
4922;Medynėlis;KAČIUKAI;6101613567;Ne;0;0;2;2
4923;Medynėlis;KAČIUKAI;2234994999;Taip;0;7;0;7
4924;Medynėlis;PELIUKAI;9314893329;Taip;4;2;0;6
4925;Medynėlis;PELIUKAI;9764215406;Taip;0;3;0;3
4926;Medynėlis;PELIUKAI;3787172254;Taip;0;0;1;1
4927;Medynėlis;PELIUKAI;5051773825;Taip;5;0;2;7
4928;Medynėlis;PELIUKAI;1525185037;Ne;0;1;1;2
4929;Medynėlis;PELIUKAI;1344240019;Taip;4;0;0;4
4930;Medynėlis;PELIUKAI;6218943275;Taip;0;1;2;3
4931;Medynėlis;PELIUKAI;1406029765;Taip;10;0;1;11
4932;Medynėlis;PELIUKAI;1162859552;Taip;0;4;0;4
4933;Medynėlis;PELIUKAI;6032067904;Ne;3;0;0;3
4934;Medynėlis;PELIUKAI;9919108302;Taip;10;3;0;13
4935;Medynėlis;PELIUKAI;1463263793;Taip;9;3;0;12
4936;Medynėlis;PELIUKAI;1333848517;Taip;0;5;2;7
4937;Medynėlis;PELIUKAI;3270413614;Ne;10;0;0;10
4938;Medynėlis;PELIUKAI;5532880670;Taip;0;0;9;9
4939;Medynėlis;PELIUKAI;7651663404;Taip;5;0;2;7
4940;Medynėlis;PELIUKAI;5446430319;Taip;0;0;2;2
4941;Medynėlis;PELIUKAI;4315717555;Taip;8;0;1;9
4942;Molinukas;NYKŠTUKAI;3103270131;Taip;0;0;3;3
4943;Molinukas;NYKŠTUKAI;5876669121;Taip;8;0;0;8
4944;Molinukas;NYKŠTUKAI;6087698882;Taip;10;8;0;18
4945;Molinukas;NYKŠTUKAI;2211909678;Taip;10;0;0;10
4946;Molinukas;NYKŠTUKAI;8053608348;Taip;0;0;1;1
4947;Molinukas;NYKŠTUKAI;6014990150;Ne;5;0;0;5
4948;Molinukas;NYKŠTUKAI;7623051674;Ne;6;0;0;6
4949;Molinukas;NYKŠTUKAI;9448910819;Taip;9;2;0;11
4950;Molinukas;NYKŠTUKAI;1651650182;Taip;0;8;1;9
4951;Molinukas;NYKŠTUKAI;5580968328;Ne;8;0;2;10
4952;Molinukas;NYKŠTUKAI;7602239077;Taip;4;0;3;7
4953;Molinukas;NYKŠTUKAI;1849018608;Taip;0;0;2;2
4954;Molinukas;NYKŠTUKAI;4171978721;Taip;4;0;0;4
4955;Molinukas;NYKŠTUKAI;9293819449;Taip;0;3;0;3
4956;Molinukas;NYKŠTUKAI;9244598883;Taip;10;0;0;10
4957;Molinukas;ZUIKUČIŲ;5387818175;Ne;0;0;4;4
4958;Molinukas;ZUIKUČIŲ;6326031969;Taip;7;3;11;21
4959;Molinukas;ZUIKUČIŲ;7377137582;Taip;0;0;2;2
4960;Molinukas;ZUIKUČIŲ;4534279257;Ne;12;0;0;12
4961;Molinukas;ZUIKUČIŲ;8688180482;Ne;12;3;0;15
4962;Molinukas;ZUIKUČIŲ;1686122652;Taip;0;1;0;1
4963;Molinukas;ZUIKUČIŲ;2324578741;Taip;0;6;5;11
4964;Molinukas;ZUIKUČIŲ;4918181437;Taip;0;0;7;7
4965;Molinukas;ZUIKUČIŲ;8604288346;Taip;4;0;0;4
4966;Molinukas;ZUIKUČIŲ;8297662673;Taip;8;0;1;9
4967;Molinukas;ZUIKUČIŲ;1856269656;Taip;7;0;0;7
4968;Molinukas;ZUIKUČIŲ;6636118069;Taip;0;8;0;8
4969;Molinukas;ZUIKUČIŲ;2774371800;Ne;10;10;0;20
4970;Molinukas;ZUIKUČIŲ;8913137310;Ne;0;3;3;6
4971;Molinukas;ZUIKUČIŲ;8416644024;Taip;4;0;2;6
4972;Molinukas;SRAIGIUKŲ;25761685637;Taip;4;0;1;5
4973;Molinukas;SRAIGIUKŲ;24664585525;Taip;0;1;0;1
4974;Molinukas;SRAIGIUKŲ;96140904528;Taip;0;2;0;2
4975;Molinukas;SRAIGIUKŲ;62719013867;Taip;3;0;2;5
4976;Molinukas;SRAIGIUKŲ;81968957100;Taip;0;0;1;1
4977;Molinukas;SRAIGIUKŲ;96366441416;Taip;3;0;3;6
4978;Molinukas;SRAIGIUKŲ;41890709428;Taip;4;0;1;5
4979;Molinukas;SRAIGIUKŲ;19007912410;Taip;0;0;2;2
4980;Molinukas;SRAIGIUKŲ;78219816965;Taip;0;0;2;2
4981;Molinukas;SRAIGIUKŲ;94725766823;Taip;10;3;0;13
4982;Molinukas;SRAIGIUKŲ;46887752521;Taip;0;0;4;4
4983;Molinukas;SRAIGIUKŲ;25562159395;Taip;0;4;2;6
4984;Molinukas;SRAIGIUKŲ;81952213381;Taip;0;0;1;1
4985;Molinukas;SRAIGIUKŲ;74040038141;Taip;10;5;3;18
4986;Molinukas;SRAIGIUKŲ;21462500359;Ne;0;0;2;2
4987;Molinukas;SRAIGIUKŲ;10647191823;Taip;0;0;2;2
4988;Molinukas;SRAIGIUKŲ;95409535650;Taip;0;1;0;1
4989;Molinukas;SRAIGIUKŲ;73542178867;Taip;0;0;2;2
4990;Molinukas;SRAIGIUKŲ;6155259547;Taip;0;2;0;2
4991;Molinukas;SRAIGIUKŲ;11787953136;Taip;0;5;0;5
4992;Molinukas;SRAIGIUKŲ;81983716075;Taip;0;2;0;2
4993;Molinukas;SRAIGIUKŲ;2048642721;Taip;0;3;0;3
4994;Molinukas;SRAIGIUKŲ;2041132581;Taip;10;0;1;11
4995;Molinukas;VOVERIUKAI;99537506556;Taip;12;0;0;12
4996;Molinukas;VOVERIUKAI;49733379099;Taip;0;5;0;5
4997;Molinukas;VOVERIUKAI;7991320348;Taip;0;2;0;2
4998;Molinukas;VOVERIUKAI;1293862946;Taip;7;0;0;7
4999;Molinukas;VOVERIUKAI;8674220663;Taip;0;4;0;4
5000;Molinukas;VOVERIUKAI;1151672597;Taip;17;0;0;17
5001;Molinukas;VOVERIUKAI;13856993048;Taip;5;0;1;6
5002;Molinukas;VOVERIUKAI;41153045448;Taip;3;0;1;4
5003;Molinukas;VOVERIUKAI;43651915331;Taip;5;0;10;15
5004;Molinukas;VOVERIUKAI;12208955611;Taip;0;1;0;1
5005;Molinukas;VOVERIUKAI;91913856999;Taip;0;0;1;1
5006;Molinukas;VOVERIUKAI;1241069188;Taip;0;3;0;3
5007;Molinukas;VOVERIUKAI;44399175317;Taip;5;0;0;5
5008;Molinukas;VOVERIUKAI;10482714545;Taip;3;5;0;8
5009;Molinukas;VOVERIUKAI;1880434477;Taip;4;0;1;5
5010;Molinukas;VOVERIUKAI;54948831792;Taip;0;0;1;1
5011;Molinukas;VOVERIUKAI;45801826827;Taip;0;0;3;3
5012;Molinukas;VOVERIUKAI;1538778372;Taip;5;0;0;5
5013;Molinukas;VOVERIUKAI;2931616290;Taip;5;0;1;6
5014;Molinukas;VOVERIUKAI;7987658567;Ne;0;3;0;3
5015;Molinukas;ŽVIRBLIUKŲ;9318837973;Taip;0;0;3;3
5016;Molinukas;ŽVIRBLIUKŲ;4957226547;Taip;3;0;3;6
5017;Molinukas;ŽVIRBLIUKŲ;6832647220;Taip;0;0;5;5
5018;Molinukas;ŽVIRBLIUKŲ;4950808381;Taip;0;3;0;3
5019;Molinukas;ŽVIRBLIUKŲ;8865966572;Taip;10;0;0;10
5020;Molinukas;ŽVIRBLIUKŲ;6795839380;Taip;0;0;14;14
5021;Molinukas;ŽVIRBLIUKŲ;4209143136;Taip;15;0;0;15
5022;Molinukas;ŽVIRBLIUKŲ;5648861702;Taip;15;0;0;15
5023;Molinukas;KAČIUKŲ;5685582215;Taip;4;1;2;7
5024;Molinukas;KAČIUKŲ;2356814145;Taip;0;0;3;3
5025;Molinukas;KAČIUKŲ;7446607510;Taip;0;0;1;1
5026;Molinukas;KAČIUKŲ;9413396859;Taip;0;0;2;2
5027;Molinukas;KAČIUKŲ;2286586693;Taip;10;0;3;13
5028;Molinukas;KAČIUKŲ;6898958282;Taip;0;0;15;15
5029;Molinukas;KAČIUKŲ;8516451290;Taip;11;0;0;11
5030;Naminukas;Drugeliai;6776805494;Taip;0;1;0;1
5031;Naminukas;Drugeliai;2395070574;Taip;0;0;1;1
5032;Naminukas;Drugeliai;5801695390;Taip;0;1;0;1
5033;Naminukas;Drugeliai;5534073614;Taip;0;2;0;2
5034;Naminukas;Drugeliai;7347998152;Taip;0;1;2;3
5035;Naminukas;Drugeliai;2606742144;Taip;4;0;0;4
5036;Naminukas;Drugeliai;2132345627;Taip;5;0;0;5
5037;Naminukas;Drugeliai;3320805432;Taip;0;1;0;1
5038;Naminukas;Drugeliai;9312058190;Taip;0;0;3;3
5039;Naminukas;Drugeliai;1302119260;Taip;0;0;3;3
5040;Naminukas;Drugeliai;8760638670;Taip;7;0;0;7
5041;Naminukas;Drugeliai;2864905392;Taip;0;8;2;10
5042;Naminukas;Drugeliai;7406775925;Taip;5;0;0;5
5043;Naminukas;Drugeliai;1333462200;Taip;0;0;1;1
5044;Naminukas;Drugeliai;5468218968;Taip;5;0;0;5
5045;Naminukas;Drugeliai;5713661641;Ne;5;0;2;7
5046;Naminukas;Drugeliai;8299305464;Taip;0;0;3;3
5047;Naminukas;Drugeliai;8929071623;Taip;2;0;0;2
5048;Naminukas;Bitutės;4419568254;Taip;11;0;0;11
5049;Naminukas;Bitutės;1956749138;Taip;7;2;0;9
5050;Naminukas;Bitutės;6503569633;Taip;10;0;4;14
5051;Naminukas;Bitutės;3192885665;Taip;15;0;3;18
5052;Naminukas;Bitutės;9530232649;Taip;10;0;2;12
5053;Naminukas;Bitutės;8131328042;Taip;0;13;0;13
5054;Naminukas;Bitutės;2769848640;Taip;0;0;6;6
5055;Naminukas;Bitutės;7176287699;Taip;2;0;3;5
5056;Naminukas;Bitutės;7888950723;Taip;0;0;10;10
5057;Naminukas;Bitutės;1710002948;Taip;2;4;0;6
5058;Naminukas;Bitutės;3994190066;Taip;0;7;0;7
5059;Naminukas;Bitutės;6526207235;Taip;5;1;0;6
5060;Naminukas;Bitutės;9600303816;Taip;0;2;0;2
5061;Naminukas;Bitutės;5244682030;Taip;0;2;0;2
5062;Naminukas;Bitutės;5195078101;Taip;2;0;0;2
5063;Naminukas;Bitutės;9501202207;Taip;0;8;0;8
5064;Naminukas;Bitutės;9541388086;Taip;2;2;0;4
5065;Naminukas;Paukšteliai;37525846039;Taip;0;0;1;1
5066;Naminukas;Paukšteliai;2126182508;Taip;0;9;0;9
5067;Naminukas;Paukšteliai;3603079488;Ne;0;0;5;5
5068;Naminukas;Paukšteliai;1870907311;Taip;0;0;1;1
5069;Naminukas;Paukšteliai;69952843049;Taip;4;0;1;5
5070;Naminukas;Paukšteliai;1946057668;Taip;8;3;0;11
5071;Naminukas;Paukšteliai;93648945843;Taip;4;0;0;4
5072;Naminukas;Paukšteliai;2100371376;Taip;0;7;0;7
5073;Naminukas;Paukšteliai;1439033627;Taip;4;0;0;4
5074;Naminukas;Paukšteliai;15748906161;Taip;0;0;1;1
5075;Naminukas;Paukšteliai;70836957729;Taip;5;2;1;8
5076;Naminukas;Paukšteliai;7386776624;Taip;0;2;3;5
5077;Naminukas;Paukšteliai;9039313646;Taip;0;2;3;5
5078;Naminukas;Paukšteliai;92882855386;Taip;2;4;0;6
5079;Naminukas;"NYKŠTUKAI ";1509433995;Ne;0;2;0;2
5080;Naminukas;"NYKŠTUKAI ";59020433000;Taip;0;3;0;3
5081;Naminukas;"NYKŠTUKAI ";2544422668;Taip;0;0;2;2
5082;Naminukas;"NYKŠTUKAI ";3029310084;Taip;0;0;2;2
5083;Naminukas;"NYKŠTUKAI ";16946991001;Taip;0;1;0;1
5084;Naminukas;"NYKŠTUKAI ";46665774314;Taip;0;0;7;7
5085;Naminukas;"NYKŠTUKAI ";1490712871;Taip;0;0;4;4
5086;Naminukas;"NYKŠTUKAI ";1252481328;Ne;13;0;0;13
5087;Naminukas;"NYKŠTUKAI ";5918430817;Taip;3;0;0;3
5088;Naminukas;"NYKŠTUKAI ";1499464511;Ne;0;1;0;1
5089;Naminukas;"NYKŠTUKAI ";6501046678;Taip;0;0;1;1
5090;Naminukas;"NYKŠTUKAI ";6029194403;Ne;9;6;4;19
5091;Naminukas;"NYKŠTUKAI ";70281612245;Taip;2;0;0;2
5092;Naminukas;"NYKŠTUKAI ";74291965804;Taip;0;0;9;9
5093;Naminukas;"NYKŠTUKAI ";90045007984;Taip;0;1;0;1
5094;Naminukas;"NYKŠTUKAI ";6273977588;Ne;3;11;1;15
5095;Neries;DEBESĖLIŲ;25015347703;Taip;0;16;0;16
5096;Neries;DEBESĖLIŲ;6994378824;Taip;0;1;0;1
5097;Neries;DEBESĖLIŲ;2093218810;Taip;15;0;0;15
5098;Neries;DEBESĖLIŲ;4648003100;Ne;0;23;1;24
5099;Neries;DEBESĖLIŲ;1046385778;Taip;0;0;1;1
5100;Neries;DEBESĖLIŲ;6373805301;Ne;0;2;0;2
5101;Neries;DEBESĖLIŲ;14071513289;Taip;3;0;0;3
5102;Neries;DEBESĖLIŲ;5189351158;Ne;0;0;3;3
5103;Neries;DEBESĖLIŲ;1355661922;Taip;0;8;3;11
5104;Neries;DEBESĖLIŲ;40762091796;Taip;0;8;0;8
5105;Neries;DEBESĖLIŲ;42514000113;Ne;0;1;2;3
5106;Neries;DEBESĖLIŲ;4112888398;Taip;0;1;1;2
5107;Neries;DEBESĖLIŲ;2003536788;Taip;0;10;0;10
5108;Neries;DEBESĖLIŲ;1300411811;Taip;0;10;0;10
5109;Neries;PUMPURĖLIŲ;2823401633;Taip;10;0;2;12
5110;Neries;PUMPURĖLIŲ;5283566263;Ne;0;1;0;1
5111;Neries;PUMPURĖLIŲ;6449332338;Taip;0;1;0;1
5112;Neries;PUMPURĖLIŲ;1381923971;Taip;0;18;0;18
5113;Neries;PUMPURĖLIŲ;2293472716;Taip;0;1;9;10
5114;Neries;PUMPURĖLIŲ;4033317616;Taip;15;0;0;15
5115;Neries;PUMPURĖLIŲ;7054808979;Taip;0;1;4;5
5116;Neries;PUMPURĖLIŲ;1554081754;Taip;15;0;0;15
5117;Neries;PUMPURĖLIŲ;6513417505;Taip;17;1;0;18
5118;Neries;PUMPURĖLIŲ;5605084046;Taip;0;1;0;1
5119;Neries;PUMPURĖLIŲ;6284140548;Taip;8;1;0;9
5120;Neries;PUMPURĖLIŲ;4286864865;Taip;13;0;0;13
5121;Neries;PUMPURĖLIŲ;9568647033;Taip;3;10;0;13
5122;Neries;PUMPURĖLIŲ;3357092509;Taip;20;0;0;20
5123;Neries;PUMPURĖLIŲ;8015545426;Taip;0;0;9;9
5124;Nykštukas;SMAGURIAI;8120626738;Taip;13;4;0;17
5125;Nykštukas;SMAGURIAI;9842748132;Taip;8;1;0;9
5126;Nykštukas;SMAGURIAI;4830484167;Taip;3;1;0;4
5127;Nykštukas;SMAGURIAI;1902253981;Taip;18;1;0;19
5128;Nykštukas;SMAGURIAI;4949895196;Taip;5;1;0;6
5129;Nykštukas;SMAGURIAI;9713859038;Taip;9;1;0;10
5130;Nykštukas;SMAGURIAI;7954996421;Taip;0;11;0;11
5131;Nykštukas;SMAGURIAI;6139988523;Taip;0;6;0;6
5132;Nykštukas;SMAGURIAI;5190754451;Taip;12;1;0;13
5133;Nykštukas;SMAGURIAI;1707956308;Taip;6;1;0;7
5134;Nykštukas;SMAGURIAI;8635571067;Taip;0;1;0;1
5135;Nykštukas;SMAGURIAI;9326131725;Taip;10;0;0;10
5136;Nykštukas;SMAGURIAI;2000207070;Taip;12;0;0;12
5137;Nykštukas;SMAGURIAI;5421090978;Taip;15;0;0;15
5138;Nykštukas;SMAGURIAI;2826079911;Taip;0;1;3;4
5139;Nykštukas;SMAGURIAI;7911842707;Taip;11;1;2;14
5140;Nykštukas;SMALSIUKAI;1213461702;Taip;0;2;0;2
5141;Nykštukas;SMALSIUKAI;5121027981;Taip;0;4;0;4
5142;Nykštukas;SMALSIUKAI;6958596223;Taip;6;0;0;6
5143;Nykštukas;SMALSIUKAI;4612171029;Taip;0;0;3;3
5144;Nykštukas;SMALSIUKAI;3120577264;Taip;0;13;0;13
5145;Nykštukas;SMALSIUKAI;2696384135;Taip;5;0;2;7
5146;Nykštukas;SMALSIUKAI;9532956150;Taip;5;0;0;5
5147;Nykštukas;SMALSIUKAI;3273579005;Taip;3;2;1;6
5148;Nykštukas;SMALSIUKAI;4040123876;Taip;3;5;0;8
5149;Nykštukas;SMALSIUKAI;3985610575;Taip;10;0;2;12
5150;Nykštukas;SMALSIUKAI;8948554271;Taip;7;3;0;10
5151;Nykštukas;SMALSIUKAI;1102555964;Taip;3;0;0;3
5152;Nykštukas;SMALSIUKAI;4331906712;Taip;5;0;0;5
5153;Nykštukas;SMALSIUKAI;6112448299;Taip;0;7;0;7
5154;Nykštukas;SMALSIUKAI;1930357859;Taip;10;0;0;10
5155;Nykštukas;SMALSIUKAI;9100510105;Taip;5;0;0;5
5156;Nykštukas;SMALSIUKAI;2143857296;Ne;5;0;0;5
5157;Nykštukas;SMALSIUKAI;9303832542;Taip;0;0;2;2
5158;Nykštukas;AITVARIUKAI;1144228064;Ne;20;0;0;20
5159;Nykštukas;AITVARIUKAI;6787279403;Taip;0;5;0;5
5160;Nykštukas;AITVARIUKAI;2002197530;Taip;5;0;0;5
5161;Nykštukas;AITVARIUKAI;2113361929;Taip;7;4;0;11
5162;Nykštukas;AITVARIUKAI;1555891900;Taip;0;1;0;1
5163;Nykštukas;AITVARIUKAI;4256675710;Taip;5;4;0;9
5164;Nykštukas;AITVARIUKAI;1209871301;Taip;5;0;0;5
5165;Nykštukas;AITVARIUKAI;1642172676;Taip;5;3;0;8
5166;Nykštukas;AITVARIUKAI;1603960759;Ne;0;4;0;4
5167;Nykštukas;AITVARIUKAI;4487291454;Taip;0;1;0;1
5168;Nykštukas;AITVARIUKAI;6274009442;Taip;6;2;0;8
5169;Nykštukas;AITVARIUKAI;5772758127;Taip;0;5;0;5
5170;Nykštukas;AITVARIUKAI;9229795383;Ne;10;2;0;12
5171;Nykštukas;AITVARIUKAI;3479582264;Taip;0;1;0;1
5172;Nykštukas;AITVARIUKAI;1643843455;Taip;8;0;0;8
5173;Nykštukas;AITVARIUKAI;1965559069;Taip;0;3;0;3
5174;Nykštukas;AITVARIUKAI;6480026426;Taip;0;6;0;6
5175;Nykštukas;DAINORĖLIAI;1505896987;Ne;0;0;2;2
5176;Nykštukas;DAINORĖLIAI;1070086244;Taip;0;2;0;2
5177;Nykštukas;DAINORĖLIAI;67968815055;Taip;0;4;0;4
5178;Nykštukas;DAINORĖLIAI;8027860617;Taip;11;7;1;19
5179;Nykštukas;DAINORĖLIAI;7498721887;Taip;5;1;1;7
5180;Nykštukas;DAINORĖLIAI;7660848578;Taip;4;1;0;5
5181;Nykštukas;DAINORĖLIAI;2284266953;Taip;0;0;4;4
5182;Nykštukas;DAINORĖLIAI;8370864547;Taip;0;2;0;2
5183;Nykštukas;DAINORĖLIAI;4720226790;Taip;5;0;2;7
5184;Nykštukas;DAINORĖLIAI;7546263542;Taip;4;0;4;8
5185;Nykštukas;DAINORĖLIAI;9778271272;Taip;6;0;0;6
5186;Nykštukas;DAINORĖLIAI;7150793310;Taip;9;5;0;14
5187;Nykštukas;DAINORĖLIAI;7584220414;Taip;10;0;0;10
5188;Nykštukas;DAINORĖLIAI;8323439041;Ne;10;0;7;17
5189;Nykštukas;DAINORĖLIAI;7615678714;Taip;0;1;0;1
5190;Nykštukas;DAINORĖLIAI;9567571526;Taip;6;0;3;9
5191;Nykštukas;DAINORĖLIAI;3970413055;Taip;9;0;1;10
5192;Nykštukas;DAINORĖLIAI;1755944368;Taip;6;0;0;6
5193;Nykštukas;DAINORĖLIAI;8781148130;Taip;0;0;2;2
5194;Nykštukas;DAINORĖLIAI;3904901392;Taip;7;10;0;17
5195;Nykštukas;POKŠTUKAI;40765421180;Ne;0;4;0;4
5196;Nykštukas;POKŠTUKAI;18018106215;Taip;0;4;0;4
5197;Nykštukas;POKŠTUKAI;74234678869;Taip;0;5;0;5
5198;Nykštukas;POKŠTUKAI;28276934404;Ne;0;2;0;2
5199;Nykštukas;POKŠTUKAI;50854821473;Taip;5;0;0;5
5200;Nykštukas;POKŠTUKAI;7598045357;Taip;0;2;0;2
5201;Nykštukas;POKŠTUKAI;51448568141;Taip;0;6;0;6
5202;Nykštukas;POKŠTUKAI;26248363243;Ne;0;1;0;1
5203;Nykštukas;POKŠTUKAI;60979950727;Taip;0;1;0;1
5204;Nykštukas;POKŠTUKAI;9779645295;Taip;0;8;0;8
5205;Nykštukas;POKŠTUKAI;50160103840;Taip;0;1;0;1
5206;Nykštukas;POKŠTUKAI;87609458114;Taip;2;0;0;2
5207;Nykštukas;POKŠTUKAI;2018631335;Taip;0;0;1;1
5208;Nykštukas;POKŠTUKAI;62768852397;Taip;0;1;0;1
5209;Nykštukas;POKŠTUKAI;26952411744;Ne;3;0;0;3
5210;Nykštukas;KODĖLČIUKAI;22907267392;Taip;0;1;1;2
5211;Nykštukas;KODĖLČIUKAI;51839683425;Taip;0;3;0;3
5212;Nykštukas;KODĖLČIUKAI;49403159088;Taip;0;0;1;1
5213;Nykštukas;KODĖLČIUKAI;279882740;Taip;0;1;0;1
5214;Nykštukas;KODĖLČIUKAI;65431970524;Taip;0;0;2;2
5215;Nykštukas;KODĖLČIUKAI;74269403579;Taip;10;1;0;11
5216;Nykštukas;KODĖLČIUKAI;57158850838;Taip;0;4;0;4
5217;Nykštukas;KODĖLČIUKAI;67215878528;Taip;0;1;0;1
5218;Nykštukas;KODĖLČIUKAI;45998334166;Taip;0;1;0;1
5219;Nykštukas;KODĖLČIUKAI;40507821302;Taip;0;1;0;1
5220;Nykštukas;KODĖLČIUKAI;21793281327;Taip;0;0;1;1
5221;Nykštukas;KODĖLČIUKAI;73015157334;Taip;9;0;0;9
5222;Nykštukas;PASAKORIAI;84548941865;Taip;0;6;3;9
5223;Nykštukas;PASAKORIAI;27650304509;Taip;0;0;1;1
5224;Nykštukas;PASAKORIAI;1754697121;Taip;5;0;1;6
5225;Nykštukas;PASAKORIAI;86393328886;Taip;0;2;0;2
5226;Nykštukas;PASAKORIAI;67433137766;Taip;0;0;1;1
5227;Nykštukas;PASAKORIAI;12777395170;Taip;0;7;0;7
5228;Nykštukas;PASAKORIAI;59971592045;Taip;0;0;1;1
5229;Nykštukas;PASAKORIAI;29414650504;Taip;6;0;0;6
5230;Nykštukas;PASAKORIAI;1412282356;Taip;0;2;0;2
5231;Nykštukas;PASAKORIAI;77231391186;Taip;0;1;0;1
5232;Nykštukas;PASAKORIAI;67209958343;Taip;0;13;0;13
5233;Nykštukas;PASAKORIAI;40012664626;Taip;0;7;0;7
5234;Nykštukas;PASAKORIAI;2106464061;Ne;0;4;0;4
5235;Nykštukas;PASAKORIAI;368045639;Ne;0;2;0;2
5236;Nykštukas;PASAKORIAI;53994799769;Taip;0;2;0;2
5237;Nykštukas;PASAKORIAI;88757197161;Taip;0;7;0;7
5238;Nykštukas;PASAKORIAI;301318033;Taip;10;12;0;22
5239;Nykštukas;PASAKORIAI;25431679881;Taip;19;0;0;19
5240;Nykštukas;PASAKORIAI;22318910984;Taip;7;0;2;9
5241;Nykštukas;PASAKORIAI;6154158870;Taip;9;0;2;11
5242;Nykštukas;PASAKORIAI;9728270999;Ne;0;2;0;2
5243;Nykštukas;PASAKORIAI;45917705129;Taip;6;0;1;7
5244;Nykštukas;PASAKORIAI;5185856324;Taip;0;0;4;4
5245;Nykštukas;GUDRUČIAI;90969634936;Taip;11;1;0;12
5246;Nykštukas;GUDRUČIAI;66071060125;Taip;5;0;0;5
5247;Nykštukas;GUDRUČIAI;53603222817;Taip;0;0;1;1
5248;Nykštukas;GUDRUČIAI;23684742279;Taip;0;3;0;3
5249;Nykštukas;GUDRUČIAI;84800943947;Taip;0;7;0;7
5250;Nykštukas;GUDRUČIAI;30508998297;Taip;0;6;0;6
5251;Nykštukas;GUDRUČIAI;25097193002;Taip;3;0;0;3
5252;Nykštukas;GUDRUČIAI;1448977214;Taip;2;2;1;5
5253;Nykštukas;GUDRUČIAI;2109799405;Ne;5;3;0;8
5254;Nykštukas;GUDRUČIAI;83322635443;Taip;5;0;0;5
5255;Nykštukas;GUDRUČIAI;9041364129;Ne;0;5;0;5
5256;Nykštukas;GUDRUČIAI;7098812765;Taip;17;2;0;19
5257;Nykštukas;GUDRUČIAI;48718365302;Taip;0;4;0;4
5258;Nykštukas;GUDRUČIAI;40386182073;Taip;4;2;0;6
5259;Nykštukas;GUDRUČIAI;54607001703;Taip;0;3;0;3
5260;Nykštukas;GUDRUČIAI;7356168681;Taip;5;12;1;18
5261;Nykštukas;GUDRUČIAI;27701482167;Ne;0;1;0;1
5262;Nykštukas;GUDRUČIAI;56267408803;Taip;0;1;1;2
5263;Nykštukas;GUDRUČIAI;26154640888;Taip;10;0;1;11
5264;Nykštukas;GUDRUČIAI;92898851752;Taip;0;11;0;11
5265;Nykštukas;GUDRUČIAI;85663477778;Taip;4;2;0;6
5266;Nykštukas;GUDRUČIAI;52614843907;Taip;0;1;1;2
5267;Nykštukas;GUDRUČIAI;94426618018;Taip;0;1;0;1
5268;Nykštukas;GUDRUČIAI;7325852578;Taip;5;3;0;8
5269;Nykštukas;NAMINUKAI;1856534241;Ne;10;0;0;10
5270;Nykštukas;NAMINUKAI;34930388032;Ne;5;0;1;6
5271;Nykštukas;NAMINUKAI;1178437485;Taip;0;10;0;10
5272;Nykštukas;NAMINUKAI;1608057875;Taip;0;0;1;1
5273;Nykštukas;NAMINUKAI;1994080785;Taip;6;0;1;7
5274;Nykštukas;NAMINUKAI;37253009284;Taip;5;0;0;5
5275;Nykštukas;NAMINUKAI;1350373348;Taip;0;2;0;2
5276;Nykštukas;NAMINUKAI;27896604498;Taip;7;2;0;9
5277;Nykštukas;NAMINUKAI;9422129964;Taip;0;4;0;4
5278;Nykštukas;NAMINUKAI;7836485289;Taip;5;0;0;5
5279;Nykštukas;NAMINUKAI;30762220262;Taip;2;7;1;10
5280;Nykštukas;NAMINUKAI;9184265280;Taip;10;0;0;10
5281;Nykštukas;NAMINUKAI;1687759661;Taip;10;0;0;10
5282;Nykštukas;NAMINUKAI;61896011340;Taip;0;6;0;6
5283;Nykštukas;NAMINUKAI;4191728865;Taip;0;3;0;3
5284;Nykštukas;NAMINUKAI;7645589206;Taip;0;0;2;2
5285;Nykštukas;NAMINUKAI;5270008748;Taip;5;6;0;11
5286;Nykštukas;NAMINUKAI;45693477409;Taip;0;0;7;7
5287;Nykštukas;NAMINUKAI;44921552171;Taip;0;16;0;16
5288;Nykštukas;NAMINUKAI;1978974359;Ne;0;0;2;2
5289;Nykštukas;KŪLVERSTUKAI;4064016871;Taip;0;0;1;1
5290;Nykštukas;KŪLVERSTUKAI;9575291096;Taip;0;7;0;7
5291;Nykštukas;KŪLVERSTUKAI;2205400512;Taip;4;1;1;6
5292;Nykštukas;KŪLVERSTUKAI;6106373554;Taip;0;0;1;1
5293;Nykštukas;KŪLVERSTUKAI;4925214655;Taip;0;6;0;6
5294;Nykštukas;KŪLVERSTUKAI;9686815141;Taip;12;3;0;15
5295;Nykštukas;KŪLVERSTUKAI;7976689381;Taip;11;2;0;13
5296;Nykštukas;KŪLVERSTUKAI;9054070492;Taip;0;2;0;2
5297;Nykštukas;KŪLVERSTUKAI;5439925385;Ne;9;0;1;10
5298;Nykštukas;KŪLVERSTUKAI;8625793820;Ne;9;0;1;10
5299;Nykštukas;KŪLVERSTUKAI;4503830456;Taip;2;0;0;2
5300;Nykštukas;KŪLVERSTUKAI;7176519994;Ne;6;0;0;6
5301;Nykštukas;KŪLVERSTUKAI;6338717583;Taip;3;0;2;5
5302;Nykštukas;KŪLVERSTUKAI;2440574056;Taip;16;0;0;16
5303;Nykštukas;KŪLVERSTUKAI;5032283848;Ne;0;1;0;1
5304;Nykštukas;KŪLVERSTUKAI;2988856911;Taip;4;0;0;4
5305;Nykštukas;TREPSIUKAI;4795301170;Taip;0;6;0;6
5306;Nykštukas;TREPSIUKAI;2661110617;Taip;13;0;0;13
5307;Nykštukas;TREPSIUKAI;5504584349;Taip;5;0;0;5
5308;Nykštukas;TREPSIUKAI;9714310539;Taip;0;4;0;4
5309;Nykštukas;TREPSIUKAI;8640715657;Taip;5;0;0;5
5310;Nykštukas;TREPSIUKAI;7828733135;Taip;4;0;2;6
5311;Nykštukas;TREPSIUKAI;3026598985;Taip;5;0;0;5
5312;Nykštukas;TREPSIUKAI;4480184458;Taip;6;0;0;6
5313;Nykštukas;TREPSIUKAI;9413198245;Taip;0;0;2;2
5314;Nykštukas;TREPSIUKAI;2914822445;Taip;9;0;0;9
5315;Ozas;Smalsučiai;2641398988;Taip;0;9;0;9
5316;Ozas;Smalsučiai;9227939420;Taip;0;1;0;1
5317;Ozas;Smalsučiai;7917100888;Taip;0;9;0;9
5318;Ozas;Smalsučiai;87218067796;Taip;16;0;0;16
5319;Ozas;Smalsučiai;4397034031;Taip;0;7;0;7
5320;Ozas;Smalsučiai;1974320330;Taip;0;1;0;1
5321;Ozas;Smalsučiai;1173284700;Ne;0;1;0;1
5322;Ozas;Smalsučiai;67987032400;Taip;0;1;0;1
5323;Ozas;Smalsučiai;71695973592;Taip;8;0;1;9
5324;Ozas;Smalsučiai;57069047630;Taip;0;3;0;3
5325;Ozas;Smalsučiai;9595277597;Taip;0;4;0;4
5326;Ozas;Smalsučiai;1893257809;Taip;7;5;0;12
5327;Ozas;Smalsučiai;6540803077;Taip;12;0;0;12
5328;Ozas;Smalsučiai;8072802467;Taip;14;1;0;15
5329;Ozas;Smalsučiai;1248092034;Ne;0;4;0;4
5330;Ozas;Smalsučiai;43381497677;Ne;19;0;0;19
5331;Ozas;Smalsučiai;7351651916;Taip;0;1;0;1
5332;Ozas;Smalsučiai;3286170280;Taip;5;0;0;5
5333;Ozas;Smalsučiai;9521048381;Taip;5;0;2;7
5334;Ozas;Smalsučiai;9905575489;Taip;5;2;0;7
5335;Ozas;Smalsučiai;5342394742;Taip;0;4;0;4
5336;Ozas;Drugeliai;1655808777;Taip;0;6;0;6
5337;Ozas;Drugeliai;7802699257;Taip;0;0;1;1
5338;Ozas;Drugeliai;8176840834;Ne;0;9;10;19
5339;Ozas;Drugeliai;6668470892;Taip;0;5;1;6
5340;Ozas;Drugeliai;2302999759;Taip;0;0;2;2
5341;Ozas;Drugeliai;8088330187;Taip;0;0;1;1
5342;Ozas;Drugeliai;9073973849;Taip;5;0;2;7
5343;Ozas;Drugeliai;9322806566;Taip;14;2;1;17
5344;Ozas;Drugeliai;2676747542;Taip;0;0;5;5
5345;Ozas;Drugeliai;2812687451;Taip;11;0;0;11
5346;Ozas;Drugeliai;8289643065;Taip;5;0;0;5
5347;Ozas;Drugeliai;9987863302;Ne;5;14;0;19
5348;Ozas;Drugeliai;5503766544;Taip;0;5;0;5
5349;Ozas;Drugeliai;2980799420;Taip;7;0;6;13
5350;Ozas;Drugeliai;4935698806;Taip;6;4;0;10
5351;Ozas;Drugeliai;1793692289;Taip;0;1;0;1
5352;Ozas;Drugeliai;8318380547;Taip;0;10;0;10
5353;Ozas;Drugeliai;4884054504;Taip;11;0;1;12
5354;Ozas;Drugeliai;2825614921;Taip;22;0;0;22
5355;Ozas;Drugeliai;43660054250;Taip;6;12;0;18
5356;Ozas;Drugeliai;7565002863;Taip;0;0;1;1
5357;Ozas;Drugeliai;9307204253;Taip;0;0;9;9
5358;Ozas;Boružėlės;1348960421;Taip;0;0;9;9
5359;Ozas;Boružėlės;1375643969;Ne;5;0;11;16
5360;Ozas;Boružėlės;63852147122;Taip;13;0;0;13
5361;Ozas;Boružėlės;8190314087;Taip;9;1;3;13
5362;Ozas;Boružėlės;3803998816;Taip;0;10;0;10
5363;Ozas;Boružėlės;1212358423;Taip;15;2;1;18
5364;Ozas;Boružėlės;7615907271;Taip;0;0;3;3
5365;Ozas;Boružėlės;1560342499;Taip;9;1;1;11
5366;Ozas;Boružėlės;8529654920;Taip;0;0;1;1
5367;Ozas;Boružėlės;60194872867;Taip;11;0;0;11
5368;Ozas;Boružėlės;7172573921;Taip;0;0;3;3
5369;Ozas;Boružėlės;2527574646;Taip;0;2;0;2
5370;Ozas;Boružėlės;9773251894;Taip;4;0;8;12
5371;Ozas;Boružėlės;36523514229;Taip;4;2;0;6
5372;Ozas;Boružėlės;1367050160;Taip;9;0;4;13
5373;Ozas;Boružėlės;68364031736;Taip;0;2;0;2
5374;Ozas;Boružėlės;2678629892;Taip;0;0;4;4
5375;Ozas;Boružėlės;1109113859;Ne;13;0;1;14
5376;Ozas;Boružėlės;1826499734;Taip;0;1;1;2
5377;Ozas;Boružėlės;6432357144;Taip;22;0;0;22
5378;Ozas;Boružėlės;1498656201;Taip;14;3;2;19
5379;Ozas;Boružėlės;8979747150;Taip;5;12;4;21
5380;Ozas;Boružėlės;1217496635;Taip;0;0;7;7
5381;Ozas;Boružėlės;1682529482;Taip;0;0;1;1
5382;Ozas;Boružėlės;9130645878;Taip;17;0;0;17
5383;Ozas;Žiogeliai;3631049449;Taip;0;0;1;1
5384;Ozas;Žiogeliai;6257625501;Taip;0;1;2;3
5385;Ozas;Žiogeliai;7402290524;Taip;10;4;0;14
5386;Ozas;Žiogeliai;1562277866;Taip;0;0;2;2
5387;Ozas;Žiogeliai;4571583671;Taip;9;6;0;15
5388;Ozas;Žiogeliai;1837947633;Taip;0;0;1;1
5389;Ozas;Žiogeliai;5682027094;Taip;0;22;0;22
5390;Ozas;Žiogeliai;4966355020;Taip;0;0;1;1
5391;Ozas;Žiogeliai;6950802941;Taip;22;0;0;22
5392;Ozas;Žiogeliai;3770045761;Taip;0;0;4;4
5393;Ozas;Žiogeliai;9324647606;Taip;11;0;1;12
5394;Ozas;Žiogeliai;9392526836;Taip;0;0;1;1
5395;Ozas;Žiogeliai;5850824864;Taip;6;0;0;6
5396;Ozas;Žiogeliai;8676986286;Ne;10;0;3;13
5397;Ozas;Žiogeliai;2345112767;Taip;5;0;6;11
5398;Ozas;Žiogeliai;5420952391;Taip;4;1;0;5
5399;Ozas;Žiogeliai;5156383727;Taip;0;5;2;7
5400;Ozas;Žiogeliai;9929822317;Taip;0;2;0;2
5401;Ozas;Žiogeliai;2837228320;Taip;0;8;4;12
5402;Ozas;Žiogeliai;7264789334;Taip;0;0;1;1
5403;Ozas;Žiogeliai;2617258206;Ne;10;0;0;10
5404;Ozas;Bitutės;4220780257;Taip;12;5;0;17
5405;Ozas;Bitutės;1161776624;Taip;0;0;1;1
5406;Ozas;Bitutės;4227555342;Taip;10;0;0;10
5407;Ozas;Bitutės;7499756171;Taip;0;17;0;17
5408;Ozas;Bitutės;7494307084;Taip;11;0;0;11
5409;Ozas;Bitutės;1475005204;Taip;0;1;0;1
5410;Ozas;Bitutės;2369544599;Taip;3;5;1;9
5411;Ozas;Bitutės;3329391600;Taip;5;0;1;6
5412;Ozas;Bitutės;4207160323;Taip;5;0;0;5
5413;Ozas;Bitutės;8416839037;Taip;7;1;0;8
5414;Ozas;Bitutės;4254601638;Taip;0;0;7;7
5415;Ozas;Bitutės;4699369567;Taip;0;0;2;2
5416;Ozas;Bitutės;8304671844;Taip;0;0;2;2
5417;Ozas;Bitutės;5968428143;Taip;7;0;0;7
5418;Ozas;Bitutės;5381187291;Taip;8;1;0;9
5419;Ozas;Bitutės;9772085405;Taip;12;0;0;12
5420;Ozas;Bitutės;7051699003;Taip;5;0;2;7
5421;Ozas;Bitutės;7817387800;Taip;5;0;1;6
5422;Ozas;Bitutės;5383877034;Taip;0;0;1;1
5423;Ozas;Bitutės;1117208248;Taip;0;0;3;3
5424;Ozas;Bitutės;9050174230;Taip;0;0;14;14
5425;Ozas;Bitutės;6811181735;Taip;5;0;0;5
5426;Ozas;Aitvarėliai;1653285671;Taip;0;8;0;8
5427;Ozas;Aitvarėliai;65979490151;Taip;0;0;1;1
5428;Ozas;Aitvarėliai;36897118363;Taip;0;2;0;2
5429;Ozas;Aitvarėliai;25660709486;Taip;0;5;0;5
5430;Ozas;Aitvarėliai;87500216376;Taip;0;1;0;1
5431;Ozas;Aitvarėliai;62542133064;Taip;0;1;0;1
5432;Ozas;Aitvarėliai;77935174855;Taip;0;0;3;3
5433;Ozas;Aitvarėliai;74709964983;Taip;0;1;0;1
5434;Ozas;Aitvarėliai;28736160618;Taip;0;1;0;1
5435;Ozas;Aitvarėliai;31810796132;Taip;0;2;0;2
5436;Ozas;Aitvarėliai;49556201469;Taip;0;1;0;1
5437;Ozas;Aitvarėliai;81692407050;Taip;0;1;0;1
5438;Ozas;Aitvarėliai;3222282556;Taip;0;3;0;3
5439;Ozas;Aitvarėliai;46679332069;Taip;17;0;0;17
5440;Ozas;Aitvarėliai;1556404162;Taip;5;1;0;6
5441;Ozas;Aitvarėliai;20944134865;Taip;0;2;0;2
5442;Ozas;Aitvarėliai;2087307495;Taip;0;0;1;1
5443;Ozas;Aitvarėliai;56927777775;Taip;0;1;9;10
5444;Ozas;Aitvarėliai;84378491220;Taip;0;0;2;2
5445;Ozas;Aitvarėliai;53609618421;Ne;0;1;0;1
5446;Ozas;Aitvarėliai;71286685759;Taip;5;1;0;6
5447;Ozas;Aitvarėliai;83249479846;Taip;0;8;0;8
5448;Ozas;Aitvarėliai;1182573257;Taip;0;1;0;1
5449;Ozas;Aitvarėliai;85075096111;Taip;11;2;0;13
5450;Ozas;Voveraitės;89115682092;Taip;7;2;3;12
5451;Ozas;Voveraitės;97875471586;Taip;0;16;0;16
5452;Ozas;Voveraitės;42030629149;Taip;0;1;0;1
5453;Ozas;Voveraitės;8817179462;Taip;8;3;0;11
5454;Ozas;Voveraitės;87683044622;Taip;5;1;4;10
5455;Ozas;Voveraitės;94576453630;Taip;9;1;0;10
5456;Ozas;Voveraitės;26834809068;Taip;0;1;0;1
5457;Ozas;Voveraitės;88508505247;Taip;0;3;0;3
5458;Ozas;Voveraitės;47574756201;Taip;0;2;1;3
5459;Ozas;Voveraitės;24088059514;Taip;1;1;0;2
5460;Ozas;Voveraitės;29411948493;Taip;10;1;0;11
5461;Ozas;Voveraitės;27655773887;Taip;0;1;0;1
5462;Ozas;Voveraitės;62608717700;Taip;8;0;0;8
5463;Ozas;Voveraitės;88837027397;Taip;16;0;0;16
5464;Ozas;Voveraitės;46431348128;Taip;0;1;0;1
5465;Ozas;Voveraitės;66463185196;Taip;0;3;0;3
5466;Ozas;Voveraitės;93882562685;Taip;0;5;0;5
5467;Ozas;Voveraitės;37505558259;Taip;0;1;0;1
5468;Ozas;Voveraitės;90020306864;Taip;5;2;0;7
5469;Ozas;Voveraitės;34723844399;Taip;20;0;0;20
5470;Ozas;Voveraitės;16101439010;Taip;0;0;2;2
5471;Ozas;Voveraitės;5637273299;Taip;6;0;8;14
5472;Ozas;Voveraitės;1637437696;Ne;14;1;1;16
5473;Ozas;Kodelčiukai;2808066733;Taip;0;17;0;17
5474;Ozas;Kodelčiukai;71351371644;Taip;0;4;0;4
5475;Ozas;Kodelčiukai;13077342836;Taip;0;3;0;3
5476;Ozas;Kodelčiukai;1746778441;Taip;0;2;0;2
5477;Ozas;Kodelčiukai;1110232715;Taip;7;3;0;10
5478;Ozas;Kodelčiukai;28273919775;Taip;0;1;0;1
5479;Ozas;Kodelčiukai;88618151766;Taip;0;1;1;2
5480;Ozas;Kodelčiukai;3637786952;Taip;12;1;0;13
5481;Ozas;Kodelčiukai;39003781970;Taip;0;13;0;13
5482;Ozas;Kodelčiukai;1243205832;Taip;10;1;0;11
5483;Ozas;Kodelčiukai;1235925750;Taip;0;3;0;3
5484;Ozas;Kodelčiukai;91774614891;Taip;0;8;0;8
5485;Ozas;Kodelčiukai;1230455881;Taip;7;0;0;7
5486;Ozas;Kodelčiukai;9664748034;Taip;5;2;0;7
5487;Ozas;Kodelčiukai;1684454071;Taip;3;2;1;6
5488;Ozas;Kodelčiukai;1008366446;Ne;6;0;1;7
5489;Ozas;Kodelčiukai;1995302672;Taip;0;1;0;1
5490;Ozas;Kodelčiukai;1288477637;Taip;8;0;0;8
5491;Ozas;Kodelčiukai;82373453244;Taip;4;2;0;6
5492;Ozas;Kodelčiukai;94673981368;Taip;5;1;0;6
5493;Ozas;Kodelčiukai;19284606277;Taip;0;9;0;9
5494;Ozas;Pelėdžiukai;1462541264;Ne;0;6;0;6
5495;Ozas;Pelėdžiukai;3439351594;Taip;0;13;0;13
5496;Ozas;Pelėdžiukai;41795363180;Taip;0;2;0;2
5497;Ozas;Pelėdžiukai;60743195418;Ne;0;12;0;12
5498;Ozas;Pelėdžiukai;64778552590;Taip;2;0;1;3
5499;Ozas;Pelėdžiukai;1755283948;Taip;0;0;13;13
5500;Ozas;Pelėdžiukai;13375413701;Taip;0;2;0;2
5501;Ozas;Pelėdžiukai;16523707810;Taip;6;0;4;10
5502;Ozas;Pelėdžiukai;47291376629;Taip;5;1;0;6
5503;Ozas;Pelėdžiukai;34330362446;Taip;13;0;2;15
5504;Ozas;Pelėdžiukai;2140385280;Taip;0;0;2;2
5505;Ozas;Pelėdžiukai;1450257399;Taip;0;2;1;3
5506;Ozas;Pelėdžiukai;88159158596;Taip;4;0;0;4
5507;Ozas;Pelėdžiukai;4765249675;Taip;0;2;1;3
5508;Ozas;Pelėdžiukai;1814400303;Taip;16;0;1;17
5509;Ozas;Pelėdžiukai;1889249743;Taip;0;8;1;9
5510;Ozas;Pelėdžiukai;1099026003;Taip;0;0;1;1
5511;Ozas;Pelėdžiukai;15885510365;Taip;0;0;2;2
5512;Ozas;Pelėdžiukai;2058548464;Taip;3;0;0;3
5513;Ozas;"Kačiukai ";75077443996;Taip;8;0;0;8
5514;Ozas;"Kačiukai ";95179927759;Taip;0;2;3;5
5515;Ozas;"Kačiukai ";6618249243;Taip;11;4;0;15
5516;Ozas;"Kačiukai ";2114612776;Taip;5;5;1;11
5517;Ozas;"Kačiukai ";60155732637;Taip;0;5;0;5
5518;Ozas;"Kačiukai ";37159754070;Taip;5;0;2;7
5519;Ozas;"Kačiukai ";61398533877;Taip;3;0;1;4
5520;Ozas;"Kačiukai ";1580501935;Ne;0;0;2;2
5521;Ozas;"Kačiukai ";1210902341;Taip;0;0;1;1
5522;Ozas;"Kačiukai ";1316758924;Ne;3;0;3;6
5523;Ozas;"Kačiukai ";2018398634;Ne;0;0;5;5
5524;Ozas;"Kačiukai ";84277015523;Taip;0;0;4;4
5525;Ozas;"Kačiukai ";1822377180;Taip;0;0;10;10
5526;Ozas;"Kačiukai ";1551028882;Taip;0;0;2;2
5527;Ozas;"Kačiukai ";14760258125;Taip;0;0;1;1
5528;Ozas;"Kačiukai ";4400619617;Taip;0;0;4;4
5529;Ozas;"Kačiukai ";9345447142;Taip;14;0;3;17
5530;Ozas;"Kačiukai ";1681367373;Taip;0;7;0;7
5531;Ozas;"Kačiukai ";8248732706;Taip;9;0;0;9
5532;Ozas;"Kačiukai ";84845624912;Ne;10;0;1;11
5533;Ozas;Ančiukų;2635045515;Taip;9;0;2;11
5534;Ozas;Ančiukų;5822871838;Taip;0;5;0;5
5535;Ozas;Ančiukų;1997125531;Taip;13;0;0;13
5536;Ozas;Ančiukų;6666591428;Taip;5;0;0;5
5537;Ozas;Ančiukų;8874823029;Taip;6;4;0;10
5538;Ozas;Ančiukų;8178298861;Taip;6;0;0;6
5539;Ozas;Ančiukų;1564826076;Taip;15;0;0;15
5540;Ozas;Ančiukų;5016547315;Taip;20;0;0;20
5541;Ozas;Ančiukų;6088757991;Taip;0;9;0;9
5542;Ozas;Ančiukų;2991511872;Taip;0;3;0;3
5543;Ozas;Ančiukų;6053885086;Taip;5;2;0;7
5544;Ozas;Ančiukų;2511477658;Taip;6;2;0;8
5545;Ozas;Ančiukų;6499549095;Taip;0;0;2;2
5546;Ozas;Ančiukų;7978092840;Taip;0;0;12;12
5547;Ozas;Ančiukų;6263062055;Ne;2;1;0;3
5548;Ozas;Nykškukų;2773182934;Taip;5;0;2;7
5549;Ozas;Nykškukų;5102704846;Taip;8;0;2;10
5550;Ozas;Nykškukų;5642468671;Taip;11;0;0;11
5551;Ozas;Nykškukų;4583818638;Taip;6;0;0;6
5552;Ozas;Nykškukų;1073755384;Taip;22;0;0;22
5553;Ozas;Nykškukų;7686706482;Taip;5;2;1;8
5554;Ozas;Nykškukų;5769870711;Taip;5;0;0;5
5555;Ozas;Nykškukų;1543683077;Taip;6;0;0;6
5556;Ozas;Nykškukų;2922370952;Taip;6;0;0;6
5557;Ozas;Nykškukų;2395567376;Taip;3;0;0;3
5558;Ozas;Nykškukų;8987796218;Taip;5;1;0;6
5559;Ozas;Nykškukų;4357737538;Taip;0;0;8;8
5560;Ozas;Nykškukų;5744027226;Ne;5;0;0;5
5561;Ozas;Nykškukų;2544858937;Taip;5;0;0;5
5562;Ozas;Nykškukų;1045890394;Taip;3;1;5;9
5563;Pabiručiai;Voveriukų;2349337471;Taip;0;1;0;1
5564;Pabiručiai;Voveriukų;4069564285;Taip;0;7;0;7
5565;Pabiručiai;Voveriukų;7278334800;Ne;15;0;0;15
5566;Pabiručiai;Voveriukų;9468698553;Taip;5;0;0;5
5567;Pabiručiai;Voveriukų;5232678556;Ne;15;0;0;15
5568;Pabiručiai;Voveriukų;7066037017;Taip;0;3;0;3
5569;Pabiručiai;Voveriukų;4040533883;Taip;10;0;0;10
5570;Pabiručiai;Voveriukų;2514312233;Taip;0;5;0;5
5571;Pabiručiai;Voveriukų;7606274875;Taip;0;4;0;4
5572;Pabiručiai;Voveriukų;9356327400;Taip;2;3;0;5
5573;Pabiručiai;Voveriukų;7846758352;Taip;13;0;0;13
5574;Pabiručiai;Voveriukų;1498738549;Taip;0;7;0;7
5575;Pabiručiai;Voveriukų;4312364951;Taip;5;2;0;7
5576;Pabiručiai;Voveriukų;2446697763;Taip;7;0;1;8
5577;Pabiručiai;Voveriukų;4813206044;Taip;2;7;0;9
5578;Pabiručiai;Voveriukų;3936426174;Taip;5;0;0;5
5579;Pabiručiai;Voveriukų;2989580886;Taip;10;0;0;10
5580;Pabiručiai;Voveriukų;7985360502;Taip;10;0;0;10
5581;Pabiručiai;Voveriukų;7403996266;Taip;5;0;0;5
5582;Pabiručiai;Boružiukų;6401188653;Taip;0;0;2;2
5583;Pabiručiai;Boružiukų;1673473814;Taip;9;0;2;11
5584;Pabiručiai;Boružiukų;5686769648;Taip;0;14;0;14
5585;Pabiručiai;Boružiukų;7524993271;Taip;0;1;0;1
5586;Pabiručiai;Boružiukų;5708597471;Taip;0;6;0;6
5587;Pabiručiai;Boružiukų;4006783343;Taip;14;0;1;15
5588;Pabiručiai;Boružiukų;7046122545;Taip;0;4;0;4
5589;Pabiručiai;Boružiukų;3096466200;Taip;0;7;0;7
5590;Pabiručiai;Boružiukų;4301904533;Taip;8;1;0;9
5591;Pabiručiai;Boružiukų;8175565139;Taip;10;0;0;10
5592;Pabiručiai;Boružiukų;8106446562;Taip;8;4;0;12
5593;Pabiručiai;Boružiukų;8236964683;Taip;0;13;0;13
5594;Pabiručiai;Boružiukų;1240057541;Taip;0;7;0;7
5595;Pabiručiai;Boružiukų;1671027282;Ne;9;0;1;10
5596;Pabiručiai;Boružiukų;3759350345;Taip;0;15;0;15
5597;Pabiručiai;Boružiukų;9299393363;Taip;10;1;0;11
5598;Pabiručiai;Boružiukų;1484291546;Taip;4;0;0;4
5599;Pabiručiai;Boružiukų;2771769336;Taip;6;3;0;9
5600;Pabiručiai;Boružiukų;2853659708;Taip;13;0;1;14
5601;Pabiručiai;Katinėlių;1670938208;Taip;4;0;1;5
5602;Pabiručiai;Katinėlių;1224986101;Ne;10;0;1;11
5603;Pabiručiai;Katinėlių;3756365293;Taip;5;0;0;5
5604;Pabiručiai;Katinėlių;6283372742;Taip;5;0;0;5
5605;Pabiručiai;Katinėlių;1749155319;Ne;9;1;3;13
5606;Pabiručiai;Katinėlių;34883375155;Taip;0;3;0;3
5607;Pabiručiai;Katinėlių;1705085006;Taip;4;0;0;4
5608;Pabiručiai;Katinėlių;58112415466;Taip;0;16;0;16
5609;Pabiručiai;Katinėlių;42877891797;Taip;10;1;0;11
5610;Pabiručiai;Katinėlių;6285940478;Taip;0;5;0;5
5611;Pabiručiai;Katinėlių;8284711578;Taip;7;0;0;7
5612;Pabiručiai;Katinėlių;8710389714;Taip;0;7;0;7
5613;Pabiručiai;Katinėlių;4501176225;Taip;0;3;0;3
5614;Pabiručiai;Katinėlių;8503177793;Ne;5;0;4;9
5615;Pabiručiai;Katinėlių;95695057362;Taip;0;4;0;4
5616;Pabiručiai;Katinėlių;4339607826;Taip;0;20;0;20
5617;Pabiručiai;Katinėlių;8306688649;Taip;0;0;1;1
5618;Pabiručiai;Katinėlių;2572570925;Taip;12;0;2;14
5619;Pabiručiai;Katinėlių;6994301415;Taip;0;0;22;22
5620;Pabiručiai;Katinėlių;4205107384;Taip;17;0;0;17
5621;Pabiručiai;Žiogelių;3272576627;Taip;15;0;0;15
5622;Pabiručiai;Žiogelių;5522447437;Taip;12;0;0;12
5623;Pabiručiai;Žiogelių;7974345478;Taip;0;2;0;2
5624;Pabiručiai;Žiogelių;8367889753;Taip;0;2;0;2
5625;Pabiručiai;Žiogelių;8421025940;Taip;0;1;0;1
5626;Pabiručiai;Žiogelių;3028063887;Taip;0;2;0;2
5627;Pabiručiai;Žiogelių;1642658060;Ne;0;5;0;5
5628;Pabiručiai;Žiogelių;3206962828;Taip;0;0;1;1
5629;Pabiručiai;Žiogelių;3355875364;Taip;6;5;0;11
5630;Pabiručiai;Žiogelių;7085036701;Taip;0;14;0;14
5631;Pabiručiai;Žiogelių;8736658575;Taip;2;0;0;2
5632;Pabiručiai;Žiogelių;1311650644;Taip;0;2;0;2
5633;Pabiručiai;Žiogelių;5480714322;Taip;7;0;0;7
5634;Pabiručiai;Žiogelių;3585198013;Taip;0;4;0;4
5635;Pabiručiai;Žiogelių;2356833740;Taip;0;6;5;11
5636;Pabiručiai;Žiogelių;5311762824;Taip;6;11;0;17
5637;Pabiručiai;Žiogelių;1587905929;Taip;3;2;0;5
5638;Pabiručiai;Žiogelių;5761888906;Taip;10;6;0;16
5639;Pabiručiai;Žiogelių;4667769378;Taip;0;6;0;6
5640;Pabiručiai;Smalsiukai;77665506359;Taip;0;2;0;2
5641;Pabiručiai;Smalsiukai;99245902550;Ne;0;5;0;5
5642;Pabiručiai;Smalsiukai;72030186300;Taip;8;3;0;11
5643;Pabiručiai;Smalsiukai;1461544209;Taip;7;0;2;9
5644;Pabiručiai;Smalsiukai;1749795353;Taip;11;0;2;13
5645;Pabiručiai;Smalsiukai;83758151778;Ne;0;2;0;2
5646;Pabiručiai;Smalsiukai;46891762701;Taip;0;1;0;1
5647;Pabiručiai;Smalsiukai;88469372129;Taip;0;1;0;1
5648;Pabiručiai;Smalsiukai;1052844376;Taip;0;7;0;7
5649;Pabiručiai;Smalsiukai;55812858767;Taip;0;2;0;2
5650;Pabiručiai;Smalsiukai;97516241743;Taip;7;7;0;14
5651;Pabiručiai;Smalsiukai;37299891873;Taip;5;0;0;5
5652;Pabiručiai;Smalsiukai;99612002248;Taip;0;2;2;4
5653;Pabiručiai;Smalsiukai;67029008630;Taip;0;4;0;4
5654;Pabiručiai;Smalsiukai;84458450123;Taip;0;3;0;3
5655;Pabiručiai;Smalsiukai;8690290547;Taip;4;9;0;13
5656;Pabiručiai;Smalsiukai;1961336031;Ne;6;3;0;9
5657;Pabiručiai;Kiškučiai;23334247840;Ne;13;0;0;13
5658;Pabiručiai;Kiškučiai;78055744911;Taip;7;0;0;7
5659;Pabiručiai;Kiškučiai;9756328087;Ne;7;6;0;13
5660;Pabiručiai;Kiškučiai;16153916925;Ne;0;2;0;2
5661;Pabiručiai;Kiškučiai;62817645726;Taip;0;3;0;3
5662;Pabiručiai;Kiškučiai;25986912111;Taip;0;1;0;1
5663;Pabiručiai;Kiškučiai;99405892035;Taip;0;9;0;9
5664;Pabiručiai;Kiškučiai;31043795418;Taip;0;4;0;4
5665;Pabiručiai;Kiškučiai;1189209435;Taip;0;1;0;1
5666;Pabiručiai;Kiškučiai;58410416452;Taip;0;2;0;2
5667;Pabiručiai;Kiškučiai;1457799587;Taip;0;1;0;1
5668;Pabiručiai;Kiškučiai;93595653770;Taip;0;4;0;4
5669;Pabiručiai;Kiškučiai;4463663862;Taip;6;0;0;6
5670;Pabiručiai;Kiškučiai;1780827082;Taip;0;2;0;2
5671;Pabiručiai;Kiškučiai;3767061583;Taip;0;8;0;8
5672;Pabiručiai;Kiškučiai;37991862437;Taip;0;4;0;4
5673;Pabiručiai;Kiškučiai;5327687404;Taip;0;2;0;2
5674;Pabiručiai;Kiškučiai;52281960273;Taip;0;1;0;1
5675;Pabiručiai;"Pėledžiukai ";7457099536;Taip;0;3;0;3
5676;Pabiručiai;"Pėledžiukai ";77273870334;Taip;10;4;0;14
5677;Pabiručiai;"Pėledžiukai ";80756439543;Taip;3;2;2;7
5678;Pabiručiai;"Pėledžiukai ";75098378597;Taip;0;2;2;4
5679;Pabiručiai;"Pėledžiukai ";40295012430;Taip;0;2;0;2
5680;Pabiručiai;"Pėledžiukai ";90849312010;Taip;11;0;1;12
5681;Pabiručiai;"Pėledžiukai ";6112244077;Taip;0;3;0;3
5682;Pabiručiai;"Pėledžiukai ";18356992277;Taip;0;6;0;6
5683;Pabiručiai;"Pėledžiukai ";55197056543;Taip;6;7;0;13
5684;Pabiručiai;"Pėledžiukai ";42627202407;Taip;0;10;0;10
5685;Pabiručiai;"Pėledžiukai ";28121667845;Taip;0;6;0;6
5686;Pabiručiai;"Pėledžiukai ";1591342751;Ne;0;15;0;15
5687;Pabiručiai;"Pėledžiukai ";1701727758;Taip;16;0;0;16
5688;Pabiručiai;"Pėledžiukai ";1078387167;Taip;8;0;0;8
5689;Pabiručiai;"Pėledžiukai ";3733576400;Taip;0;1;0;1
5690;Pabiručiai;"Pėledžiukai ";4568554097;Taip;0;0;1;1
5691;Pabiručiai;"Pėledžiukai ";34215100257;Taip;0;3;0;3
5692;Pabiručiai;"Pėledžiukai ";26940925728;Taip;0;4;0;4
5693;Pabiručiai;"Pėledžiukai ";2944433375;Taip;0;9;0;9
5694;Pabiručiai;"Kodelčiūkai ";1819457592;Ne;0;10;0;10
5695;Pabiručiai;"Kodelčiūkai ";38142737487;Taip;0;12;0;12
5696;Pabiručiai;"Kodelčiūkai ";62923769489;Taip;0;20;0;20
5697;Pabiručiai;"Kodelčiūkai ";65267728282;Taip;2;0;1;3
5698;Pabiručiai;"Kodelčiūkai ";81307674221;Taip;2;0;0;2
5699;Pabiručiai;"Kodelčiūkai ";15948930587;Taip;12;0;0;12
5700;Pabiručiai;"Kodelčiūkai ";6696186733;Taip;0;2;0;2
5701;Pabiručiai;"Kodelčiūkai ";78798062773;Taip;0;13;0;13
5702;Pabiručiai;"Kodelčiūkai ";66085180057;Ne;0;16;0;16
5703;Pabiručiai;"Kodelčiūkai ";1901455947;Taip;0;0;1;1
5704;Pabiručiai;"Kodelčiūkai ";1718014001;Taip;0;5;0;5
5705;Pabiručiai;"Kodelčiūkai ";2143676810;Taip;0;4;0;4
5706;Pabiručiai;"Kodelčiūkai ";46251218463;Taip;0;6;0;6
5707;Pabiručiai;"Kodelčiūkai ";1236499374;Taip;12;7;0;19
5708;Pabiručiai;"Kodelčiūkai ";8344476830;Taip;0;2;0;2
5709;Pabiručiai;"Kodelčiūkai ";4634305371;Taip;0;11;0;11
5710;Pabiručiai;"Kodelčiūkai ";4901977623;Taip;10;0;0;10
5711;Pabiručiai;"Peliukų ";1028312285;Taip;0;7;2;9
5712;Pabiručiai;"Peliukų ";9417138573;Taip;5;0;0;5
5713;Pabiručiai;"Peliukų ";1515270273;Taip;2;0;0;2
5714;Pabiručiai;"Peliukų ";2688728915;Taip;13;0;0;13
5715;Pabiručiai;"Peliukų ";5166525832;Taip;7;0;0;7
5716;Pabiručiai;"Peliukų ";7639362434;Taip;5;0;4;9
5717;Pabiručiai;"Peliukų ";8409455566;Taip;5;0;1;6
5718;Pabiručiai;"Viščiukų ";7090116276;Taip;0;1;8;9
5719;Pabiručiai;"Viščiukų ";8897462614;Taip;0;0;2;2
5720;Pabiručiai;"Viščiukų ";1663953648;Taip;0;3;0;3
5721;Pabiručiai;"Viščiukų ";2869383175;Taip;5;0;0;5
5722;Pabiručiai;"Viščiukų ";5790737929;Taip;5;0;0;5
5723;Pabiručiai;"Viščiukų ";7677235214;Taip;4;0;1;5
5724;Pabiručiai;"Viščiukų ";9676561758;Taip;4;3;0;7
5725;Pabiručiai;"Viščiukų ";7632969321;Ne;5;0;0;5
5726;Pabiručiai;"Viščiukų ";3700401383;Taip;10;0;1;11
5727;Pabiručiai;"Viščiukų ";9093137227;Taip;5;0;0;5
5728;Pabiručiai;"Viščiukų ";6935913132;Ne;5;0;0;5
5729;Pabiručiai;"Viščiukų ";7663581089;Taip;10;0;2;12
5730;Pabiručiai;"Viščiukų ";7248314871;Taip;9;0;0;9
5731;Pabiručiai;"Viščiukų ";9610623364;Taip;5;7;0;12
5732;Pabiručiai;"Viščiukų ";1344711015;Ne;0;16;0;16
5733;Pabiručiai;"Drugelių ";4462744848;Taip;0;1;0;1
5734;Pabiručiai;"Drugelių ";9589005897;Taip;4;1;4;9
5735;Pabiručiai;"Drugelių ";5497318373;Taip;17;0;0;17
5736;Pabiručiai;"Drugelių ";4408666547;Taip;0;8;0;8
5737;Pabiručiai;"Drugelių ";6697518151;Taip;0;2;0;2
5738;Pabiručiai;"Drugelių ";3497466298;Taip;10;1;0;11
5739;Pabiručiai;"Drugelių ";3368607302;Taip;5;0;0;5
5740;Pabiručiai;"Drugelių ";9353062804;Taip;15;0;0;15
5741;Pabiručiai;"Drugelių ";6421623010;Taip;16;0;0;16
5742;Pabiručiai;"Drugelių ";5621183663;Taip;7;2;0;9
5743;Pagrandukas;Saulytės;73747309137;Taip;0;6;0;6
5744;Pagrandukas;Saulytės;73094500140;Taip;0;1;0;1
5745;Pagrandukas;Saulytės;25042144265;Taip;0;4;0;4
5746;Pagrandukas;Saulytės;17860708643;Taip;0;1;0;1
5747;Pagrandukas;Saulytės;10275994267;Taip;0;6;0;6
5748;Pagrandukas;Saulytės;1735088719;Taip;0;2;0;2
5749;Pagrandukas;Saulytės;2240690677;Taip;0;1;0;1
5750;Pagrandukas;Saulytės;23836053268;Taip;0;2;0;2
5751;Pagrandukas;Saulytės;82076379343;Taip;0;2;0;2
5752;Pagrandukas;Saulytės;90244057040;Ne;0;7;0;7
5753;Pagrandukas;Saulytės;5179694773;Taip;0;2;0;2
5754;Pagrandukas;Saulytės;1432860651;Taip;0;2;0;2
5755;Pagrandukas;Saulytės;4550081974;Taip;0;2;0;2
5756;Pagrandukas;Zuikučiai;7834436515;Taip;0;0;5;5
5757;Pagrandukas;Zuikučiai;8417942459;Taip;0;0;1;1
5758;Pagrandukas;Zuikučiai;7435609306;Taip;0;0;2;2
5759;Pagrandukas;Zuikučiai;5903416384;Taip;11;0;0;11
5760;Pagrandukas;Zuikučiai;2439891231;Taip;10;0;0;10
5761;Pagrandukas;Zuikučiai;6710887776;Taip;10;0;0;10
5762;Pagrandukas;Zuikučiai;5649084353;Taip;7;0;1;8
5763;Pagrandukas;Zuikučiai;7665811353;Taip;7;0;0;7
5764;Pagrandukas;Zuikučiai;2212787835;Taip;0;0;3;3
5765;Pagrandukas;Zuikučiai;6449029299;Taip;9;0;1;10
5766;Pagrandukas;Zuikučiai;1405820070;Taip;5;0;1;6
5767;Pagrandukas;Zuikučiai;1054107640;Ne;8;0;0;8
5768;Pagrandukas;Zuikučiai;2822538227;Taip;0;0;4;4
5769;Pagrandukas;Boružėlių;3398225200;Taip;0;8;0;8
5770;Pagrandukas;Boružėlių;5752454925;Taip;6;2;0;8
5771;Pagrandukas;Boružėlių;3587941684;Ne;9;0;0;9
5772;Pagrandukas;Boružėlių;3953844737;Taip;0;3;0;3
5773;Pagrandukas;Boružėlių;7271589727;Taip;6;0;0;6
5774;Pagrandukas;Boružėlių;7064391685;Taip;6;0;0;6
5775;Pagrandukas;Boružėlių;5640182548;Taip;11;0;0;11
5776;Pagrandukas;Boružėlių;1403569615;Ne;0;6;0;6
5777;Pagrandukas;Boružėlių;1998073387;Taip;0;1;0;1
5778;Pagrandukas;Boružėlių;5511396314;Taip;8;4;0;12
5779;Pagrandukas;Boružėlių;5648658237;Taip;13;0;0;13
5780;Pagrandukas;Boružėlių;6911951786;Taip;7;6;0;13
5781;Pagrandukas;Boružėlių;2926077771;Taip;0;1;2;3
5782;Pagrandukas;Boružėlių;5741021524;Taip;5;0;0;5
5783;Pagrandukas;Boružėlių;2361829423;Taip;5;0;0;5
5784;Pagrandukas;Bitutės;22146063631;Taip;0;14;0;14
5785;Pagrandukas;Bitutės;1654566158;Taip;0;4;0;4
5786;Pagrandukas;Bitutės;44029972943;Taip;0;1;1;2
5787;Pagrandukas;Bitutės;47836927832;Taip;0;1;0;1
5788;Pagrandukas;Bitutės;91591094393;Taip;0;2;1;3
5789;Pagrandukas;Bitutės;1503479321;Taip;6;2;0;8
5790;Pagrandukas;Bitutės;9313380552;Taip;0;2;4;6
5791;Pagrandukas;Bitutės;51982253355;Taip;0;6;0;6
5792;Pagrandukas;Bitutės;73259512452;Taip;0;17;0;17
5793;Pagrandukas;Bitutės;80939233319;Taip;0;17;0;17
5794;Pagrandukas;Bitutės;3227066520;Taip;6;2;0;8
5795;Pagrandukas;Bitutės;1813676320;Taip;0;0;6;6
5796;Pagrandukas;Bitutės;57471531440;Taip;0;9;0;9
5797;Pagrandukas;Bitutės;6315627367;Taip;10;0;0;10
5798;Pagrandukas;Bitutės;8529974367;Taip;0;1;0;1
5799;Pagrandukas;Pelėdžiukai;1590309916;Taip;0;6;0;6
5800;Pagrandukas;Pelėdžiukai;1964310988;Taip;0;6;0;6
5801;Pagrandukas;Pelėdžiukai;44044284874;Taip;0;13;0;13
5802;Pagrandukas;Pelėdžiukai;33750135077;Taip;4;2;0;6
5803;Pagrandukas;Pelėdžiukai;2066377478;Taip;12;0;0;12
5804;Pagrandukas;Pelėdžiukai;1189453012;Taip;0;5;0;5
5805;Pagrandukas;Pelėdžiukai;4391887554;Taip;8;0;0;8
5806;Pagrandukas;Pelėdžiukai;33909593470;Taip;0;2;0;2
5807;Pagrandukas;Pelėdžiukai;2068155037;Taip;0;3;4;7
5808;Pagrandukas;Pelėdžiukai;5818020587;Taip;0;0;2;2
5809;Pagrandukas;Pelėdžiukai;21544489661;Taip;2;0;0;2
5810;Pagrandukas;Pelėdžiukai;93036151205;Ne;0;1;1;2
5811;Pagrandukas;Pelėdžiukai;1232460221;Taip;5;0;0;5
5812;Pagrandukas;Pelėdžiukai;7611916563;Taip;0;1;0;1
5813;Pagrandukas;Pelėdžiukai;1451503127;Taip;6;0;0;6
5814;Pagrandukas;Žvaigždutė;1904462840;Taip;5;3;0;8
5815;Pagrandukas;Žvaigždutė;9329518124;Taip;2;2;0;4
5816;Pagrandukas;Žvaigždutė;75080308291;Taip;0;11;0;11
5817;Pagrandukas;Žvaigždutė;7876029445;Ne;0;2;0;2
5818;Pagrandukas;Žvaigždutė;1313716840;Taip;0;2;0;2
5819;Pagrandukas;Žvaigždutė;14043704729;Taip;0;1;2;3
5820;Pagrandukas;Žvaigždutė;51692261484;Ne;5;6;0;11
5821;Pagrandukas;Žvaigždutė;35830862363;Ne;2;1;0;3
5822;Pagrandukas;Žvaigždutė;4724383814;Taip;0;0;4;4
5823;Pagrandukas;Žvaigždutė;8879549409;Taip;0;6;0;6
5824;Pagrandukas;Žvaigždutė;6299298199;Taip;0;2;0;2
5825;Pagrandukas;Žvaigždutė;7543795007;Taip;0;4;0;4
5826;Pagrandukas;Žvaigždutė;3860781857;Taip;0;5;0;5
5827;Pagrandukas;Žvaigždutė;24287759126;Taip;3;0;0;3
5828;Pagrandukas;Žvaigždutė;9522269582;Taip;0;11;0;11
5829;Pagrandukas;Žvaigždutė;2461803626;Taip;8;1;0;9
5830;Pakalnutė;Pagrandukai;22735454739;Taip;0;0;13;13
5831;Pakalnutė;Pagrandukai;1621947670;Ne;0;1;0;1
5832;Pakalnutė;Pagrandukai;2930341121;Taip;0;0;3;3
5833;Pakalnutė;Pagrandukai;18927141423;Ne;0;0;2;2
5834;Pakalnutė;Pagrandukai;86458592440;Taip;8;0;0;8
5835;Pakalnutė;Pagrandukai;46144634381;Taip;0;1;0;1
5836;Pakalnutė;Pagrandukai;85764245101;Taip;0;1;0;1
5837;Pakalnutė;Pagrandukai;97346486902;Taip;0;0;1;1
5838;Pakalnutė;Pagrandukai;24840895951;Taip;0;0;2;2
5839;Pakalnutė;Pagrandukai;89329905839;Taip;0;0;2;2
5840;Pakalnutė;Pagrandukai;7535589010;Ne;0;0;2;2
5841;Pakalnutė;Pagrandukai;1210432627;Taip;0;3;0;3
5842;Pakalnutė;Pagrandukai;3987920952;Ne;0;15;0;15
5843;Pakalnutė;Pagrandukai;28398386463;Taip;0;0;1;1
5844;Pakalnutė;Pagrandukai;1970792910;Ne;0;0;2;2
5845;Pakalnutė;"Pelėdžiukų ";7110858765;Taip;9;0;1;10
5846;Pakalnutė;"Pelėdžiukų ";8553182620;Taip;0;0;1;1
5847;Pakalnutė;"Pelėdžiukų ";3840499737;Taip;6;0;1;7
5848;Pakalnutė;"Pelėdžiukų ";6577255841;Taip;7;0;1;8
5849;Pakalnutė;"Pelėdžiukų ";7151877991;Taip;0;0;1;1
5850;Pakalnutė;"Pelėdžiukų ";3919560072;Ne;0;0;6;6
5851;Pakalnutė;"Pelėdžiukų ";2992768162;Taip;9;0;0;9
5852;Pakalnutė;"Pelėdžiukų ";9505524183;Taip;15;0;0;15
5853;Pakalnutė;"Pelėdžiukų ";3792697409;Taip;11;0;0;11
5854;Pakalnutė;"Pelėdžiukų ";8823232039;Taip;10;0;0;10
5855;Pakalnutė;"Pelėdžiukų ";8900756351;Taip;0;14;0;14
5856;Pakalnutė;"Pelėdžiukų ";2035060922;Taip;1;0;1;2
5857;Pakalnutė;"Pelėdžiukų ";7325137583;Taip;6;8;0;14
5858;Pakalnutė;"Pelėdžiukų ";4220368864;Ne;0;0;2;2
5859;Pakalnutė;"Pelėdžiukų ";1330092247;Taip;10;0;0;10
5860;Pakalnutė;Ežiukai;5058727058;Taip;0;0;5;5
5861;Pakalnutė;Ežiukai;5355198213;Taip;15;2;0;17
5862;Pakalnutė;Ežiukai;2714905466;Taip;5;0;0;5
5863;Pakalnutė;Ežiukai;3650483589;Taip;6;0;1;7
5864;Pakalnutė;Ežiukai;1070172991;Taip;0;0;6;6
5865;Pakalnutė;Ežiukai;3660195990;Taip;12;0;0;12
5866;Pakalnutė;Ežiukai;9323200833;Taip;8;0;1;9
5867;Pakalnutė;Ežiukai;4153294595;Taip;5;0;0;5
5868;Pakalnutė;Ežiukai;8155327668;Taip;13;0;1;14
5869;Pakalnutė;Ežiukai;9781993614;Taip;11;0;0;11
5870;Pakalnutė;Ežiukai;9256219647;Taip;0;5;0;5
5871;Pakalnutė;Ežiukai;7853479591;Ne;0;3;0;3
5872;Pakalnutė;Skruzdėliukų;4033813807;Taip;1;9;0;10
5873;Pakalnutė;Skruzdėliukų;9382160515;Taip;1;2;0;3
5874;Pakalnutė;Skruzdėliukų;7503936754;Taip;9;0;0;9
5875;Pakalnutė;Skruzdėliukų;5409476517;Taip;12;1;0;13
5876;Pakalnutė;Skruzdėliukų;2670302354;Taip;5;0;0;5
5877;Pakalnutė;Skruzdėliukų;7105369111;Taip;10;0;0;10
5878;Pakalnutė;Skruzdėliukų;6944726166;Ne;12;0;0;12
5879;Pakalnutė;Skruzdėliukų;1195872320;Taip;5;1;0;6
5880;Pakalnutė;Skruzdėliukų;3211633472;Taip;9;0;0;9
5881;Pakalnutė;Skruzdėliukų;4423348418;Taip;6;0;0;6
5882;Pakalnutė;Skruzdėliukų;6934760468;Taip;14;0;0;14
5883;Pakalnutė;Skruzdėliukų;5911381706;Taip;0;2;0;2
5884;Pakalnutė;Skruzdėliukų;8797870379;Taip;5;1;0;6
5885;Pakalnutė;Skruzdėliukų;6055727963;Taip;4;0;0;4
5886;Pakalnutė;Bitučių;2993145079;Taip;0;3;0;3
5887;Pakalnutė;Bitučių;2765220889;Taip;6;3;0;9
5888;Pakalnutė;Bitučių;9445909071;Ne;14;0;0;14
5889;Pakalnutė;Bitučių;5532458706;Taip;10;8;0;18
5890;Pakalnutė;Bitučių;7526989580;Taip;0;0;1;1
5891;Pakalnutė;Bitučių;5941955322;Taip;0;0;1;1
5892;Pakalnutė;Bitučių;3306334576;Taip;10;9;0;19
5893;Pakalnutė;Bitučių;2095540372;Taip;7;6;0;13
5894;Pakalnutė;Bitučių;2932205226;Taip;2;0;0;2
5895;Pakalnutė;Bitučių;1238121406;Taip;0;5;0;5
5896;Pakalnutė;Bitučių;6117542654;Ne;10;0;1;11
5897;Pakalnutė;Bitučių;5464143742;Taip;10;3;0;13
5898;Pakalnutė;Bitučių;6351193702;Ne;0;5;0;5
5899;Pakalnutė;Bitučių;3965390135;Taip;5;0;0;5
5900;Pakalnutė;Boružiukų;5120176374;Taip;0;1;0;1
5901;Pakalnutė;Boružiukų;6798939288;Taip;0;2;0;2
5902;Pakalnutė;Boružiukų;7357431226;Taip;0;3;0;3
5903;Pakalnutė;Boružiukų;4934095931;Taip;10;1;0;11
5904;Pakalnutė;Boružiukų;6575909478;Taip;0;0;1;1
5905;Pakalnutė;Boružiukų;2040992265;Taip;22;0;0;22
5906;Pakalnutė;Boružiukų;2835611316;Taip;11;0;0;11
5907;Pakalnutė;Boružiukų;4950195858;Taip;10;0;0;10
5908;Pakalnutė;Boružiukų;1870528568;Taip;9;0;0;9
5909;Pakalnutė;Boružiukų;4927086034;Taip;10;0;0;10
5910;Pakalnutė;Boružiukų;6557165567;Ne;12;0;0;12
5911;Pakalnutė;Boružiukų;3677709759;Taip;7;0;0;7
5912;Pakalnutė;Boružiukų;2597900983;Taip;7;0;1;8
5913;Pakalnutė;Boružiukų;2062721289;Taip;13;0;0;13
5914;Pakalnutė;Boružiukų;1340022702;Ne;17;0;0;17
5915;Pakalnutė;Meškiukų;41008813511;Ne;7;0;0;7
5916;Pakalnutė;Meškiukų;64706392096;Ne;5;12;0;17
5917;Pakalnutė;Meškiukų;2202341545;Taip;20;0;0;20
5918;Pakalnutė;Meškiukų;7487278074;Taip;0;0;1;1
5919;Pakalnutė;Meškiukų;9355380341;Taip;0;0;7;7
5920;Pakalnutė;Meškiukų;7324846434;Taip;0;0;4;4
5921;Pakalnutė;Meškiukų;1396367371;Taip;3;0;4;7
5922;Pakalnutė;Meškiukų;2666441234;Taip;1;0;0;1
5923;Pakalnutė;Meškiukų;4256222944;Taip;0;9;0;9
5924;Pakalnutė;Meškiukų;2101821362;Taip;1;0;11;12
5925;Pakalnutė;Meškiukų;9001185744;Taip;0;0;1;1
5926;Pakalnutė;Meškiukų;4317305712;Taip;5;0;0;5
5927;Pakalnutė;Meškiukų;4818901769;Taip;6;3;0;9
5928;Pakalnutė;Meškiukų;2755412687;Taip;14;0;0;14
5929;Pakalnutė;Nykštukai;6769352325;Taip;0;11;0;11
5930;Pakalnutė;Nykštukai;1202301707;Ne;0;0;1;1
5931;Pakalnutė;Nykštukai;11183301096;Taip;13;2;0;15
5932;Pakalnutė;Nykštukai;19773872429;Taip;0;10;0;10
5933;Pakalnutė;Nykštukai;16651154416;Taip;0;1;0;1
5934;Pakalnutė;Nykštukai;7452656662;Taip;0;1;0;1
5935;Pakalnutė;Nykštukai;7389600659;Taip;0;1;0;1
5936;Pakalnutė;Nykštukai;5309195407;Taip;0;3;0;3
5937;Pakalnutė;Nykštukai;1849396954;Taip;2;0;0;2
5938;Pakalnutė;Nykštukai;81963663668;Taip;7;5;0;12
5939;Pakalnutė;Nykštukai;76382908561;Taip;0;4;1;5
5940;Pakalnutė;Nykštukai;99344331316;Taip;9;0;0;9
5941;Pakalnutė;Nykštukai;33667858388;Taip;0;12;0;12
5942;Pakalnutė;Nykštukai;2815093249;Ne;0;5;0;5
5943;Pakalnutė;Nykštukai;1372722843;Taip;0;1;0;1
5944;Pakalnutė;Nykštukai;61712002384;Taip;0;6;0;6
5945;Pakalnutė;Nykštukai;9647325689;Taip;7;8;0;15
5946;Pakalnutė;"Zuikučių ";1198230323;Taip;0;0;2;2
5947;Pakalnutė;"Zuikučių ";3609982613;Ne;0;1;0;1
5948;Pakalnutė;"Zuikučių ";5958653847;Taip;0;7;0;7
5949;Pakalnutė;"Zuikučių ";8513260520;Taip;3;0;0;3
5950;Pakalnutė;"Zuikučių ";2159430356;Taip;0;6;0;6
5951;Pakalnutė;"Zuikučių ";1147843795;Ne;0;0;4;4
5952;Pakalnutė;"Zuikučių ";3555822605;Taip;5;0;1;6
5953;Pakalnutė;"Zuikučių ";1583462733;Taip;4;0;0;4
5954;Pakalnutė;"Zuikučių ";6377564215;Taip;2;0;0;2
5955;Pakalnutė;"Zuikučių ";3306670221;Taip;0;0;9;9
5956;Pakalnutė;"Zuikučių ";1159312512;Taip;22;0;0;22
5957;Pakalnutė;"Zuikučių ";1610847242;Taip;1;2;0;3
5958;Pakalnutė;"Zuikučių ";8813262660;Ne;8;0;0;8
5959;Pakalnutė;"Zuikučių ";5102345686;Taip;5;1;0;6
5960;Pakalnutė;"Zuikučių ";7949588551;Ne;1;5;0;6
5961;Pakalnutė;"Zuikučių ";81578522887;Ne;0;2;0;2
5962;Pakalnutė;"Zuikučių ";5949298584;Taip;6;0;0;6
5963;Pakalnutė;"Drugelių ";4046820545;Taip;0;2;0;2
5964;Pakalnutė;"Drugelių ";5973972464;Taip;10;0;0;10
5965;Pakalnutė;"Drugelių ";4742424647;Taip;10;0;4;14
5966;Pakalnutė;"Drugelių ";2075865543;Taip;0;0;2;2
5967;Pakalnutė;"Drugelių ";9562957603;Taip;0;1;0;1
5968;Pakalnutė;"Drugelių ";5435336235;Taip;0;5;3;8
5969;Pakalnutė;"Drugelių ";2050880681;Taip;0;3;1;4
5970;Pakalnutė;"Drugelių ";4514642887;Taip;6;0;0;6
5971;Pakalnutė;"Drugelių ";9274456755;Taip;0;1;0;1
5972;Pakalnutė;"Drugelių ";2721810040;Taip;0;0;3;3
5973;Pakalnutė;"Drugelių ";80818670065;Taip;0;2;6;8
5974;Pakalnutė;"Drugelių ";2049079012;Ne;14;2;0;16
5975;Pakalnutė;"Drugelių ";4681267749;Taip;22;0;0;22
5976;Pakalnutė;"Drugelių ";85356812538;Ne;0;1;1;2
5977;Pakalnutė;"Drugelių ";6771510589;Taip;4;0;2;6
5978;Pakalnutė;"Drugelių ";4264260466;Taip;6;1;1;8
5979;Pakalnutė;"Drugelių ";58670351468;Ne;12;0;0;12
5980;Pakalnutė;"Drugelių ";2901031642;Taip;22;0;0;22
5981;Panerių;Rūtelė;21661667266;Taip;0;0;4;4
5982;Panerių;Rūtelė;7324873912;Taip;0;0;1;1
5983;Panerių;Rūtelė;8388744329;Taip;0;0;1;1
5984;Panerių;Rūtelė;68313730462;Taip;0;0;3;3
5985;Panerių;Rūtelė;84672957234;Ne;7;2;0;9
5986;Panerių;Rūtelė;60738239005;Taip;0;0;2;2
5987;Panerių;Rūtelė;1017100748;Taip;0;5;0;5
5988;Panerių;Rūtelė;68231938043;Ne;0;0;1;1
5989;Panerių;Rūtelė;78838685571;Taip;0;0;1;1
5990;Panerių;Rūtelė;53384267657;Taip;0;0;1;1
5991;Panerių;Rūtelė;8666159951;Taip;0;0;6;6
5992;Panerių;Rūtelė;7753488216;Taip;2;0;1;3
5993;Panerių;Rūtelė;6227583229;Taip;0;0;4;4
5994;Panerių;Rūtelė;1303873524;Taip;0;0;10;10
5995;Panerių;Rūtelė;75034220223;Ne;2;0;0;2
5996;Panerių;Rūtelė;18963190527;Taip;0;0;1;1
5997;Panerių;Rūtelė;4103412131;Taip;22;0;0;22
5998;Panerių;Rūtelė;2786775879;Taip;0;12;0;12
5999;Panerių;Rūtelė;9004468035;Taip;0;0;1;1
6000;Panerių;Gėlytės;9268558715;Ne;11;0;3;14
6001;Panerių;Gėlytės;9604335101;Taip;15;0;1;16
6002;Panerių;Gėlytės;2189532651;Taip;0;0;3;3
6003;Panerių;Gėlytės;1066011221;Taip;15;0;0;15
6004;Panerių;Gėlytės;3843500717;Taip;5;0;1;6
6005;Panerių;Gėlytės;3631150576;Ne;0;6;0;6
6006;Panerių;Gėlytės;5001921323;Taip;0;12;1;13
6007;Panerių;Gėlytės;2608386063;Taip;5;0;7;12
6008;Panerių;Gėlytės;2195332401;Taip;0;0;9;9
6009;Panerių;Gėlytės;4023257875;Taip;16;0;3;19
6010;Panerių;Gėlytės;4689913361;Taip;6;0;0;6
6011;Panerių;Gėlytės;8299189235;Taip;9;10;0;19
6012;Panerių;Gėlytės;2571561865;Taip;11;4;0;15
6013;Panerių;Gėlytės;6908487075;Taip;0;0;2;2
6014;Panerių;Gėlytės;6411372006;Taip;0;22;0;22
6015;Panerių;Gėlytės;1419817211;Ne;5;0;0;5
6016;Panerių;Boružė;6583134855;Taip;10;0;1;11
6017;Panerių;Boružė;6468190149;Taip;0;0;3;3
6018;Panerių;Boružė;3550194241;Taip;10;2;0;12
6019;Panerių;Boružė;4646173276;Taip;7;0;0;7
6020;Panerių;Boružė;3913395809;Taip;0;0;9;9
6021;Panerių;Boružė;7239773684;Taip;10;0;0;10
6022;Panerių;Boružė;8514805919;Taip;2;0;1;3
6023;Panerių;Boružė;4867297993;Taip;4;0;1;5
6024;Panerių;Boružė;9630302749;Taip;2;0;0;2
6025;Panerių;Boružė;2308739823;Taip;10;0;1;11
6026;Panerių;Boružė;9631684972;Taip;0;0;5;5
6027;Panerių;Boružė;3057714143;Taip;0;1;0;1
6028;Panerių;Boružė;9506008651;Taip;12;0;1;13
6029;Panerių;Boružė;8693113275;Taip;11;3;0;14
6030;Panerių;Boružė;3346395516;Taip;0;0;4;4
6031;Papartis;ZUIKUČIAI;1065234123;Taip;5;0;2;7
6032;Papartis;ZUIKUČIAI;2412700197;Taip;0;5;0;5
6033;Papartis;ZUIKUČIAI;1554777403;Taip;5;0;1;6
6034;Papartis;ZUIKUČIAI;7703070601;Taip;0;4;0;4
6035;Papartis;ZUIKUČIAI;7902130389;Taip;2;0;1;3
6036;Papartis;ZUIKUČIAI;4992305227;Taip;0;3;0;3
6037;Papartis;ZUIKUČIAI;4346817695;Taip;5;0;2;7
6038;Papartis;ZUIKUČIAI;2447926422;Taip;0;6;0;6
6039;Papartis;ZUIKUČIAI;3182457453;Taip;6;3;0;9
6040;Papartis;ZUIKUČIAI;8190458132;Taip;0;0;1;1
6041;Papartis;ZUIKUČIAI;8952917454;Taip;0;0;2;2
6042;Papartis;ZUIKUČIAI;5410369044;Taip;5;0;3;8
6043;Papartis;ZUIKUČIAI;6126912448;Taip;0;0;3;3
6044;Papartis;ZUIKUČIAI;5675537250;Ne;4;1;0;5
6045;Papartis;ZUIKUČIAI;1065128993;Ne;0;8;4;12
6046;Papartis;ZUIKUČIAI;3895487270;Taip;22;0;0;22
6047;Papartis;ZUIKUČIAI;1527263538;Taip;0;7;0;7
6048;Papartis;DRUGELIAI;4508053349;Taip;5;3;1;9
6049;Papartis;DRUGELIAI;7387281720;Taip;0;6;0;6
6050;Papartis;DRUGELIAI;3243869451;Ne;0;0;3;3
6051;Papartis;DRUGELIAI;2778629398;Taip;7;0;5;12
6052;Papartis;DRUGELIAI;3475745012;Ne;17;0;1;18
6053;Papartis;DRUGELIAI;2535412635;Taip;0;0;1;1
6054;Papartis;DRUGELIAI;6797687614;Taip;0;0;3;3
6055;Papartis;DRUGELIAI;7606939822;Taip;0;5;0;5
6056;Papartis;DRUGELIAI;9719465384;Ne;9;0;0;9
6057;Papartis;DRUGELIAI;8148483438;Taip;4;0;2;6
6058;Papartis;DRUGELIAI;5265293240;Taip;0;1;5;6
6059;Papartis;DRUGELIAI;7590170146;Taip;0;5;0;5
6060;Papartis;DRUGELIAI;9134335737;Taip;0;1;5;6
6061;Papartis;DRUGELIAI;1836914270;Taip;2;0;1;3
6062;Papartis;DRUGELIAI;4935694347;Taip;0;0;2;2
6063;Papartis;DRUGELIAI;1672028156;Taip;0;0;6;6
6064;Papartis;DRUGELIAI;4634683589;Ne;3;5;0;8
6065;Papartis;DRUGELIAI;3267416367;Taip;0;0;5;5
6066;Papartis;DRUGELIAI;3107106078;Taip;0;0;1;1
6067;Papartis;DRUGELIAI;1205854439;Ne;0;4;1;5
6068;Papartis;DRUGELIAI;7067369268;Taip;9;0;6;15
6069;Papartis;DRUGELIAI;6746279237;Taip;0;0;22;22
6070;Papartis;DRUGELIAI;42803013754;Taip;2;3;0;5
6071;Papartis;ŽVIRBLIUKAI;19544040390;Taip;10;0;2;12
6072;Papartis;ŽVIRBLIUKAI;32352993438;Taip;3;0;0;3
6073;Papartis;ŽVIRBLIUKAI;67237428983;Taip;4;0;1;5
6074;Papartis;ŽVIRBLIUKAI;89486863055;Taip;8;0;0;8
6075;Papartis;ŽVIRBLIUKAI;4139884005;Taip;0;0;5;5
6076;Papartis;ŽVIRBLIUKAI;87519747220;Ne;0;7;0;7
6077;Papartis;ŽVIRBLIUKAI;25990216006;Taip;9;0;0;9
6078;Papartis;ŽVIRBLIUKAI;26912851152;Taip;0;1;0;1
6079;Papartis;ŽVIRBLIUKAI;60706816641;Taip;0;0;3;3
6080;Papartis;ŽVIRBLIUKAI;77686722867;Taip;0;0;1;1
6081;Papartis;ŽVIRBLIUKAI;1973027294;Taip;0;0;1;1
6082;Papartis;ŽVIRBLIUKAI;1403114386;Taip;3;3;1;7
6083;Papartis;ŽVIRBLIUKAI;2146286089;Taip;0;0;2;2
6084;Papartis;ŽVIRBLIUKAI;1876543445;Taip;2;0;0;2
6085;Papartis;ŽVIRBLIUKAI;7308118576;Taip;5;0;2;7
6086;Papartis;ŽVIRBLIUKAI;45289621684;Taip;0;1;0;1
6087;Papartis;PELĖDŽIUKAI;37759125130;Taip;22;0;0;22
6088;Papartis;PELĖDŽIUKAI;20862839950;Taip;1;1;0;2
6089;Papartis;PELĖDŽIUKAI;84260015363;Taip;0;3;0;3
6090;Papartis;PELĖDŽIUKAI;67226404925;Taip;13;6;0;19
6091;Papartis;PELĖDŽIUKAI;41330436046;Taip;2;0;0;2
6092;Papartis;PELĖDŽIUKAI;83927324420;Taip;10;1;0;11
6093;Papartis;PELĖDŽIUKAI;51857496843;Taip;2;0;0;2
6094;Papartis;PELĖDŽIUKAI;81006952163;Taip;0;9;0;9
6095;Papartis;PELĖDŽIUKAI;46076659264;Ne;0;1;0;1
6096;Papartis;PELĖDŽIUKAI;1727771667;Taip;0;1;0;1
6097;Papartis;PELĖDŽIUKAI;18164175829;Taip;0;1;2;3
6098;Papartis;PELĖDŽIUKAI;1045629158;Taip;5;0;0;5
6099;Papartis;PELĖDŽIUKAI;1903219436;Ne;0;1;2;3
6100;Papartis;PELĖDŽIUKAI;8958062862;Taip;2;1;0;3
6101;Papartis;SAULUTĖS;1246604915;Taip;0;1;0;1
6102;Papartis;SAULUTĖS;48182233276;Taip;0;3;1;4
6103;Papartis;SAULUTĖS;23218268605;Ne;5;0;0;5
6104;Papartis;SAULUTĖS;18124337938;Taip;6;0;0;6
6105;Papartis;SAULUTĖS;22443998204;Taip;0;1;0;1
6106;Papartis;SAULUTĖS;30982681803;Taip;0;4;0;4
6107;Papartis;SAULUTĖS;95139517078;Taip;0;8;0;8
6108;Papartis;SAULUTĖS;14978429821;Taip;0;2;0;2
6109;Papartis;SAULUTĖS;55573140983;Taip;0;1;0;1
6110;Papartis;SAULUTĖS;50090482473;Taip;0;2;0;2
6111;Papartis;SAULUTĖS;10078570352;Taip;6;8;1;15
6112;Papartis;SAULUTĖS;88700503601;Taip;0;1;2;3
6113;Papartis;SAULUTĖS;21963930874;Taip;0;10;0;10
6114;Papartis;SAULUTĖS;15207322802;Taip;0;2;0;2
6115;Papartis;SAULUTĖS;67966766974;Taip;0;0;1;1
6116;Papartis;SAULUTĖS;50658624766;Ne;4;2;0;6
6117;Papartis;SAULUTĖS;79080758672;Taip;0;5;0;5
6118;Papartis;GANDRIUKAI;4878190663;Taip;11;0;0;11
6119;Papartis;GANDRIUKAI;9900023788;Taip;8;0;1;9
6120;Papartis;GANDRIUKAI;2783708905;Taip;11;0;0;11
6121;Papartis;GANDRIUKAI;6883101103;Taip;3;0;0;3
6122;Papartis;GANDRIUKAI;2868899342;Taip;13;0;0;13
6123;Papartis;GANDRIUKAI;7768672610;Ne;0;0;2;2
6124;Papartis;GANDRIUKAI;9384670351;Taip;5;0;5;10
6125;Papartis;GANDRIUKAI;9968072478;Ne;0;0;4;4
6126;Papartis;GANDRIUKAI;2215846642;Taip;18;0;0;18
6127;Papartis;GANDRIUKAI;3320524073;Taip;0;0;1;1
6128;Papartis;GANDRIUKAI;9704930584;Taip;0;10;0;10
6129;Papartis;GANDRIUKAI;9804863902;Taip;0;0;1;1
6130;Papartis;GANDRIUKAI;1974159967;Taip;8;0;0;8
6131;Papartis;GANDRIUKAI;5732853976;Taip;4;0;2;6
6132;Papartis;GANDRIUKAI;7859096984;Taip;0;0;3;3
6133;Papartis;GANDRIUKAI;7252265838;Taip;0;0;1;1
6134;Papartis;GANDRIUKAI;4279580382;Taip;5;3;0;8
6135;Papartis;GANDRIUKAI;9978625382;Taip;16;0;0;16
6136;Papartis;AITVARELIAI;82454730189;Taip;0;2;0;2
6137;Papartis;AITVARELIAI;2398385967;Taip;0;7;1;8
6138;Papartis;AITVARELIAI;89525856173;Taip;3;2;0;5
6139;Papartis;AITVARELIAI;4216398263;Taip;3;6;2;11
6140;Papartis;AITVARELIAI;72182866449;Taip;8;1;0;9
6141;Papartis;AITVARELIAI;1406820323;Taip;0;9;0;9
6142;Papartis;AITVARELIAI;10659508171;Taip;0;2;3;5
6143;Papartis;AITVARELIAI;2067304804;Taip;13;1;0;14
6144;Papartis;AITVARELIAI;88418552221;Taip;0;3;0;3
6145;Papartis;AITVARELIAI;74972133115;Taip;0;0;6;6
6146;Papartis;AITVARELIAI;1322826573;Taip;0;6;1;7
6147;Papartis;AITVARELIAI;88722771438;Taip;15;1;1;17
6148;Papartis;AITVARELIAI;74734443304;Taip;1;2;1;4
6149;Papartis;AITVARELIAI;63087155760;Taip;0;0;2;2
6150;Papartis;AITVARELIAI;26193472997;Taip;0;2;2;4
6151;Papartis;AITVARELIAI;68478260102;Ne;0;3;0;3
6152;Papartis;SMALSUČIAI;6266095782;Taip;7;0;0;7
6153;Papartis;SMALSUČIAI;3054883426;Taip;9;0;1;10
6154;Papartis;SMALSUČIAI;1191546794;Taip;9;6;0;15
6155;Papartis;SMALSUČIAI;6073970691;Taip;18;0;0;18
6156;Papartis;SMALSUČIAI;8447326505;Taip;0;1;1;2
6157;Papartis;SMALSUČIAI;1919362027;Taip;4;0;3;7
6158;Papartis;SMALSUČIAI;9375751990;Taip;0;0;1;1
6159;Papartis;SMALSUČIAI;5786648402;Ne;11;0;0;11
6160;Papartis;SMALSUČIAI;5776038830;Taip;5;0;1;6
6161;Papartis;SMALSUČIAI;8808902528;Taip;0;1;1;2
6162;Papartis;SMALSUČIAI;5361925390;Taip;0;0;1;1
6163;Papartis;SMALSUČIAI;4640068595;Taip;6;0;0;6
6164;Papartis;SMALSUČIAI;5579899922;Taip;8;0;0;8
6165;Papartis;"ŽIRNIUKAI ";44833872631;Taip;5;0;4;9
6166;Papartis;"ŽIRNIUKAI ";1944730492;Taip;4;0;2;6
6167;Papartis;"ŽIRNIUKAI ";12406782910;Taip;0;1;0;1
6168;Papartis;"ŽIRNIUKAI ";1271303103;Taip;10;0;1;11
6169;Papartis;"ŽIRNIUKAI ";7845277151;Taip;0;11;0;11
6170;Papartis;"ŽIRNIUKAI ";30041894006;Taip;0;0;1;1
6171;Papartis;"ŽIRNIUKAI ";3630377970;Taip;6;0;0;6
6172;Papartis;"ŽIRNIUKAI ";38896771062;Taip;4;0;0;4
6173;Papartis;"ŽIRNIUKAI ";86735273559;Taip;0;2;0;2
6174;Papartis;"ŽIRNIUKAI ";29789530287;Taip;0;0;2;2
6175;Papartis;"ŽIRNIUKAI ";22570313128;Taip;11;0;1;12
6176;Papartis;"ŽIRNIUKAI ";51588027659;Taip;5;4;0;9
6177;Papartis;"ŽIRNIUKAI ";1703232380;Taip;5;4;0;9
6178;Papartis;"ŽIRNIUKAI ";64345875780;Ne;0;2;0;2
6179;Papartis;"ŽIRNIUKAI ";2598688561;Taip;14;0;1;15
6180;Papartis;"ŽIRNIUKAI ";53040207725;Taip;14;1;0;15
6181;Papartis;"ŽIRNIUKAI ";3991709974;Taip;0;4;0;4
6182;Papartis;"ŽIRNIUKAI ";3367009621;Taip;0;6;0;6
6183;Papartis;"ŽIRNIUKAI ";7102350653;Taip;0;1;0;1
6184;Papartis;"ŽIRNIUKAI ";3408756311;Taip;0;18;4;22
6185;Papartis;BORUŽĖLĖS;7018190169;Taip;8;0;0;8
6186;Papartis;BORUŽĖLĖS;4918854899;Taip;5;5;0;10
6187;Papartis;BORUŽĖLĖS;6889782462;Ne;10;0;2;12
6188;Papartis;BORUŽĖLĖS;5252947502;Taip;10;0;1;11
6189;Papartis;BORUŽĖLĖS;4261270064;Taip;5;0;0;5
6190;Papartis;BORUŽĖLĖS;6136213985;Taip;16;0;0;16
6191;Papartis;BORUŽĖLĖS;7107692314;Taip;16;0;0;16
6192;Papartis;BORUŽĖLĖS;5736456872;Taip;6;2;0;8
6193;Papartis;BORUŽĖLĖS;3040269026;Taip;6;2;0;8
6194;Papartis;BORUŽĖLĖS;8891856856;Taip;4;0;0;4
6195;Papartis;BORUŽĖLĖS;1916222143;Taip;5;6;0;11
6196;Papartis;BORUŽĖLĖS;3100013570;Taip;8;0;0;8
6197;Papartis;BORUŽĖLĖS;7803854703;Taip;0;2;0;2
6198;Papartis;VARPELIAI;6585372451;Taip;5;4;4;13
6199;Papartis;VARPELIAI;6977513472;Taip;0;0;2;2
6200;Papartis;VARPELIAI;5070767260;Taip;6;0;0;6
6201;Papartis;VARPELIAI;1231594320;Taip;0;0;1;1
6202;Papartis;VARPELIAI;6734567714;Taip;5;0;0;5
6203;Papartis;VARPELIAI;4570512336;Taip;8;0;6;14
6204;Papartis;VARPELIAI;5538433120;Taip;5;0;3;8
6205;Papartis;VARPELIAI;3209491491;Taip;7;0;5;12
6206;Papartis;VARPELIAI;6931780900;Taip;7;0;5;12
6207;Papartis;VARPELIAI;3539507686;Taip;9;0;0;9
6208;Papartis;NYKŠTUKAI;5652769035;Taip;5;0;0;5
6209;Papartis;NYKŠTUKAI;5942160584;Taip;10;0;0;10
6210;Papartis;NYKŠTUKAI;9922091482;Ne;12;0;1;13
6211;Papartis;NYKŠTUKAI;1680412204;Taip;12;0;0;12
6212;Papartis;NYKŠTUKAI;6903057774;Ne;0;0;2;2
6213;Papartis;NYKŠTUKAI;9502229005;Taip;4;2;0;6
6214;Papartis;NYKŠTUKAI;6949120693;Taip;0;11;0;11
6215;Papartis;NYKŠTUKAI;6794076631;Taip;15;0;0;15
6216;Papartis;NYKŠTUKAI;5957889361;Taip;1;0;0;1
6217;Papartis;NYKŠTUKAI;5608868738;Ne;0;4;0;4
6218;Papartis;NYKŠTUKAI;4203241118;Taip;8;1;1;10
6219;Papartis;NYKŠTUKAI;4806652727;Taip;11;0;1;12
6220;Papartis;NYKŠTUKAI;3324647852;Taip;10;0;3;13
6221;Papartis;NYKŠTUKAI;5218101579;Ne;5;1;0;6
6222;Papartis;NYKŠTUKAI;6423401656;Taip;3;0;0;3
6223;Papartis;NYKŠTUKAI;8932290803;Taip;17;0;0;17
6224;Papartis;NYKŠTUKAI;5652560002;Taip;0;1;0;1
6225;Pasaka;Drugelių;19053961847;Taip;0;1;0;1
6226;Pasaka;Drugelių;60248064750;Taip;0;0;2;2
6227;Pasaka;Drugelių;1237568934;Taip;5;0;0;5
6228;Pasaka;Drugelių;57075224058;Taip;6;0;1;7
6229;Pasaka;Drugelių;66315088164;Ne;0;2;1;3
6230;Pasaka;Drugelių;44488699090;Taip;9;0;3;12
6231;Pasaka;Drugelių;5459272292;Taip;0;1;0;1
6232;Pasaka;Drugelių;55254934245;Taip;0;0;1;1
6233;Pasaka;Drugelių;91499940063;Taip;0;6;0;6
6234;Pasaka;Drugelių;40182594961;Taip;3;0;0;3
6235;Pasaka;Drugelių;2332865106;Taip;0;0;2;2
6236;Pasaka;Drugelių;5901704055;Taip;0;0;1;1
6237;Pasaka;Nykštukų;5665758011;Taip;0;2;0;2
6238;Pasaka;Nykštukų;8166051272;Taip;0;1;0;1
6239;Pasaka;Nykštukų;91546084785;Taip;5;2;5;12
6240;Pasaka;Nykštukų;7040953491;Taip;0;1;0;1
6241;Pasaka;Nykštukų;1333499160;Taip;0;1;0;1
6242;Pasaka;Nykštukų;6893044575;Taip;5;1;0;6
6243;Pasaka;Nykštukų;4071643754;Taip;9;0;0;9
6244;Pasaka;Nykštukų;4773893970;Taip;11;1;0;12
6245;Pasaka;Nykštukų;5438303030;Taip;0;1;0;1
6246;Pasaka;Nykštukų;1313576071;Taip;4;0;0;4
6247;Pasaka;Nykštukų;7455544922;Ne;2;2;0;4
6248;Pasaka;Nykštukų;1630083619;Taip;5;1;0;6
6249;Pasaka;Nykštukų;5027755073;Taip;0;1;0;1
6250;Pasaka;Nykštukų;2874308781;Taip;15;0;0;15
6251;Pasaka;Montesori;42973327518;Taip;0;0;1;1
6252;Pasaka;Montesori;1450566193;Ne;0;0;1;1
6253;Pasaka;Montesori;79583667868;Taip;0;0;1;1
6254;Pasaka;Montesori;69250064506;Taip;0;0;1;1
6255;Pasaka;Montesori;81598865451;Taip;0;0;1;1
6256;Pasaka;Montesori;1564467627;Taip;0;0;9;9
6257;Pasaka;Montesori;1514381003;Taip;0;0;7;7
6258;Pasaka;Montesori;8996941733;Taip;10;0;0;10
6259;Pasaka;Montesori;93994995081;Taip;5;0;0;5
6260;Pasaka;Montesori;47140322803;Taip;0;0;3;3
6261;Pasaka;Žirniukų;9722435751;Taip;5;2;1;8
6262;Pasaka;Žirniukų;7648503006;Taip;5;0;1;6
6263;Pasaka;Žirniukų;2697014098;Taip;0;1;0;1
6264;Pasaka;Žirniukų;73703706115;Taip;4;0;4;8
6265;Pasaka;Žirniukų;2018620389;Taip;0;2;0;2
6266;Pasaka;Žirniukų;6441884677;Taip;5;0;0;5
6267;Pasaka;Žirniukų;5651452381;Taip;5;0;0;5
6268;Pasaka;Žirniukų;1720511696;Taip;7;0;0;7
6269;Pasaka;Žirniukų;7286419663;Taip;0;0;1;1
6270;Pasaka;Žirniukų;2788679885;Taip;0;1;0;1
6271;Pasaka;Žirniukų;1565873178;Ne;0;0;1;1
6272;Pasaka;Žirniukų;7445696309;Taip;0;1;0;1
6273;Pasaka;Žirniukų;2400455036;Ne;16;0;3;19
6274;Pasaka;Žirniukų;79170702319;Taip;12;0;3;15
6275;Pasaka;Žirniukų;5973028582;Taip;0;0;2;2
6276;Pasaka;"Voveriukų ";15051078156;Taip;0;1;0;1
6277;Pasaka;"Voveriukų ";50319234551;Taip;4;0;2;6
6278;Pasaka;"Voveriukų ";15500820772;Taip;17;0;0;17
6279;Pasaka;"Voveriukų ";12951124853;Taip;0;2;0;2
6280;Pasaka;"Voveriukų ";53523660848;Taip;0;1;0;1
6281;Pasaka;"Voveriukų ";89376142045;Taip;5;6;1;12
6282;Pasaka;"Voveriukų ";52135673503;Taip;2;0;1;3
6283;Pasaka;"Voveriukų ";59491538033;Taip;0;0;4;4
6284;Pasaka;"Voveriukų ";20358771509;Taip;0;4;0;4
6285;Pasaka;"Voveriukų ";94514447596;Taip;8;0;0;8
6286;Pasaka;"Voveriukų ";35718732394;Taip;0;1;1;2
6287;Pasaka;"Voveriukų ";71316589358;Taip;0;1;1;2
6288;Pasaka;"Voveriukų ";61091610394;Taip;0;0;4;4
6289;Pasaka;"Voveriukų ";4344243194;Taip;4;0;0;4
6290;Pasaka;"Voveriukų ";8122815158;Ne;0;0;3;3
6291;Pasaka;"Voveriukų ";1719236931;Taip;0;0;3;3
6292;Pasaka;"Voveriukų ";1268530885;Taip;0;4;3;7
6293;Pasaka;"VALDOFRO 12";7865658875;Taip;0;0;4;4
6294;Pasaka;"VALDOFRO 12";2141354232;Taip;0;0;2;2
6295;Pasaka;"VALDOFRO 12";4271029223;Taip;0;0;8;8
6296;Pasaka;"VALDOFRO 12";8042135600;Taip;0;0;1;1
6297;Pasaka;"VALDOFRO 12";73057603223;Taip;0;0;1;1
6298;Pasaka;"VALDOFRO 12";3367120837;Ne;0;0;6;6
6299;Pasaka;"VALDOFRO 12";7010681103;Taip;0;8;0;8
6300;Pasaka;"VALDOFRO 12";1155273197;Taip;0;8;0;8
6301;Pasaka;"VALDOFRO 12";56766427323;Ne;0;0;2;2
6302;Pasaka;"VALDOFRO 12";4680456848;Taip;0;0;1;1
6303;Pasaka;"VALDOFRO 12";5141156728;Taip;0;0;1;1
6304;Pasaka;"VALDOFRO 12";2268625523;Taip;2;0;0;2
6305;Pasaka;"VALDOFRO 12";8976424908;Taip;0;0;2;2
6306;Pasaka;"VALDOFRO 12";2721121903;Taip;0;0;3;3
6307;Pasaka;"VALDORFO 2";48295303497;Taip;0;0;6;6
6308;Pasaka;"VALDORFO 2";27035873367;Ne;5;0;0;5
6309;Pasaka;"VALDORFO 2";27496232796;Ne;3;0;1;4
6310;Pasaka;"VALDORFO 2";95494862542;Taip;0;0;3;3
6311;Pasaka;"VALDORFO 2";25283698668;Taip;0;0;2;2
6312;Pasaka;"VALDORFO 2";2077818693;Taip;3;0;1;4
6313;Pasaka;"VALDORFO 2";71365777764;Taip;3;0;0;3
6314;Pasaka;"VALDORFO 2";1741935840;Taip;5;0;2;7
6315;Pasaka;"VALDORFO 2";77904202630;Taip;0;0;1;1
6316;Pasaka;"VALDORFO 2";4752117533;Taip;0;0;1;1
6317;Pasaka;"VALDORFO 2";7432241898;Taip;0;0;2;2
6318;Pasaka;"VALDORFO 2";10616073718;Ne;0;0;2;2
6319;Pasaka;"VALDORFO 2";8590385693;Taip;0;5;2;7
6320;Pasaka;"VALDORFO 2";4620573687;Ne;2;0;2;4
6321;Pasaka;"VALDORFO 2";4825373152;Taip;3;0;2;5
6322;Pasaka;"VALDORFO 2";9462745431;Taip;5;5;0;10
6323;Pasaka;"VALDORFO 2";5399148997;Taip;0;0;1;1
6324;Pasaka;Gudručiai;8821776109;Ne;0;0;2;2
6325;Pasaka;Gudručiai;4895994309;Taip;0;0;2;2
6326;Pasaka;Gudručiai;62051806386;Taip;0;2;1;3
6327;Pasaka;Gudručiai;14080980324;Taip;0;1;0;1
6328;Pasaka;Gudručiai;76560015870;Taip;0;1;0;1
6329;Pasaka;Gudručiai;72878659455;Taip;0;1;0;1
6330;Pasaka;Gudručiai;76899232405;Taip;0;0;2;2
6331;Pasaka;Gudručiai;45850914548;Ne;6;3;0;9
6332;Pasaka;Gudručiai;97012371435;Ne;6;3;0;9
6333;Pasaka;Gudručiai;45184972933;Taip;0;1;0;1
6334;Pasaka;Gudručiai;1979028353;Taip;0;0;5;5
6335;Pasaka;Gudručiai;1920564803;Ne;0;0;2;2
6336;Pasaka;Bitelių;8651165520;Taip;6;0;6;12
6337;Pasaka;Bitelių;8132829016;Taip;6;0;5;11
6338;Pasaka;Bitelių;5351364328;Taip;6;0;4;10
6339;Pasaka;Bitelių;4635912654;Taip;6;0;4;10
6340;Pasaka;Bitelių;4137222204;Taip;9;0;2;11
6341;Pasaka;Bitelių;7248640367;Taip;6;5;1;12
6342;Pasaka;Bitelių;8277245475;Taip;0;0;2;2
6343;Pasaka;Bitelių;6868519179;Taip;0;0;6;6
6344;Pasaka;Bitelių;6759415053;Taip;0;0;5;5
6345;Pasaka;Bitelių;5723970763;Taip;7;1;5;13
6346;Pasaka;Bitelių;9136521759;Taip;12;0;0;12
6347;Pasaka;Bitelių;7685589423;Taip;0;0;2;2
6348;Pasaka;Bitelių;9737445077;Taip;9;0;0;9
6349;Pasaka;Bitelių;2638182985;Taip;0;0;5;5
6350;Pasaka;Bitelių;2293613528;Taip;5;0;0;5
6351;Pasaka;Bitelių;3367346582;Taip;10;0;0;10
6352;Pasaka;Bitelių;5371046207;Taip;7;4;3;14
6353;Pasaka;Bitelių;1335408890;Ne;0;0;1;1
6354;Pasaka;"Pabiručių ";7176272684;Taip;0;8;0;8
6355;Pasaka;"Pabiručių ";4466963221;Taip;2;0;0;2
6356;Pasaka;"Pabiručių ";1950145441;Taip;0;0;1;1
6357;Pasaka;"Pabiručių ";1512874567;Taip;0;0;8;8
6358;Pasaka;"Pabiručių ";3606141216;Taip;0;2;0;2
6359;Pasaka;"Pabiručių ";5217688848;Taip;0;2;0;2
6360;Pasaka;"Pabiručių ";3536862796;Taip;5;0;1;6
6361;Pasaka;"Pabiručių ";8899289832;Taip;5;0;1;6
6362;Pasaka;"Pabiručių ";4171004263;Taip;5;0;0;5
6363;Pasaka;"Pabiručių ";1488711275;Taip;0;0;7;7
6364;Pasaka;Šnekučių;31896116591;Taip;0;15;6;21
6365;Pasaka;Šnekučių;49626651411;Taip;10;0;1;11
6366;Pasaka;Šnekučių;34897359060;Taip;0;0;1;1
6367;Pasaka;Šnekučių;52912333520;Ne;5;0;0;5
6368;Pasaka;Šnekučių;49520139946;Taip;7;0;6;13
6369;Pasaka;Šnekučių;9973758979;Taip;0;0;1;1
6370;Pasaka;Šnekučių;1693530160;Taip;0;0;1;1
6371;Pasaka;Šnekučių;62303770229;Taip;0;5;0;5
6372;Pasaka;Šnekučių;23132755276;Taip;0;0;1;1
6373;Pasaka;Šnekučių;7082166681;Taip;4;0;1;5
6374;Pasaka;Šnekučių;8615661704;Ne;1;3;0;4
6375;Pasaka;Šnekučių;4178679491;Ne;0;3;0;3
6376;Pasaka;Šnekučių;56983167265;Taip;0;0;8;8
6377;Pasaka;Šnekučių;5021568651;Taip;6;0;0;6
6378;Pasaka;Šnekučių;10055061537;Ne;0;1;4;5
6379;Pasaka;Šnekučių;51500606207;Taip;0;22;0;22
6380;Paslaptis;Priešmokyklinė;1259942408;Taip;0;0;14;14
6381;Paslaptis;Priešmokyklinė;36229769543;Taip;7;0;2;9
6382;Paslaptis;Priešmokyklinė;87862241593;Taip;22;0;0;22
6383;Paslaptis;Priešmokyklinė;1982955007;Ne;10;1;0;11
6384;Paslaptis;Priešmokyklinė;1273662366;Taip;0;0;1;1
6385;Paslaptis;Priešmokyklinė;99228588629;Ne;4;0;0;4
6386;Paslaptis;Priešmokyklinė;57773958059;Taip;0;7;0;7
6387;Paslaptis;Priešmokyklinė;1950287365;Taip;10;0;3;13
6388;Paslaptis;Priešmokyklinė;1094068061;Taip;0;0;2;2
6389;Paslaptis;Priešmokyklinė;1195616749;Taip;0;1;2;3
6390;Paslaptis;Priešmokyklinė;8522925854;Taip;6;5;3;14
6391;Paslaptis;Priešmokyklinė;1445974659;Taip;7;0;1;8
6392;Paslaptis;Priešmokyklinė;2578713065;Ne;6;1;0;7
6393;Paslaptis;Priešmokyklinė;1868248793;Taip;0;0;9;9
6394;Paslaptis;Priešmokyklinė;1938288335;Taip;0;1;1;2
6395;Paslaptis;Priešmokyklinė;1127602652;Taip;0;0;1;1
6396;Paslaptis;Priešmokyklinė;4674623065;Taip;0;0;2;2
6397;Paslaptis;Priešmokyklinė;40283689721;Taip;0;5;0;5
6398;Paslaptis;Priešmokyklinė;4731417201;Taip;10;0;0;10
6399;Paslaptis;Priešmokyklinė;3461773781;Taip;0;8;0;8
6400;Paslaptis;"Darželio mišraus amžiaus grupė";6375966771;Taip;11;4;0;15
6401;Paslaptis;"Darželio mišraus amžiaus grupė";2474900044;Taip;0;8;3;11
6402;Paslaptis;"Darželio mišraus amžiaus grupė";3170216428;Ne;0;1;1;2
6403;Paslaptis;"Darželio mišraus amžiaus grupė";3093280943;Taip;5;0;0;5
6404;Paslaptis;"Darželio mišraus amžiaus grupė";2705751628;Taip;0;5;1;6
6405;Paslaptis;"Darželio mišraus amžiaus grupė";8280740387;Taip;0;0;7;7
6406;Paslaptis;"Darželio mišraus amžiaus grupė";2891547963;Taip;0;1;0;1
6407;Paslaptis;"Darželio mišraus amžiaus grupė";3415869190;Taip;6;0;0;6
6408;Paslaptis;"Darželio mišraus amžiaus grupė";1983773762;Taip;0;1;2;3
6409;Paslaptis;"Darželio mišraus amžiaus grupė";5557019619;Taip;0;1;1;2
6410;Paslaptis;"Darželio mišraus amžiaus grupė";1782398974;Taip;7;0;0;7
6411;Paslaptis;"Darželio mišraus amžiaus grupė";4109288950;Taip;1;0;0;1
6412;Paslaptis;"Darželio mišraus amžiaus grupė";8083478190;Taip;0;0;7;7
6413;Paslaptis;"Darželio mišraus amžiaus grupė";2089780119;Taip;5;9;0;14
6414;Paslaptis;"Darželio mišraus amžiaus grupė";1029321312;Taip;3;0;0;3
6415;Paslaptis;"Darželio mišraus amžiaus grupė";9941731250;Taip;0;0;3;3
6416;Paslaptis;"Darželio mišraus amžiaus grupė";6131831325;Taip;8;1;2;11
6417;Paslaptis;"Darželio mišraus amžiaus grupė";2879752620;Taip;5;9;0;14
6418;Paslaptis;"Darželio mišraus amžiaus grupė";3243226933;Taip;0;0;4;4
6419;Paslaptis;"Darželio mišraus amžiaus grupė";5852939221;Taip;0;1;1;2
6420;Paslaptis;"Darželio mišraus amžiaus grupė";2693910134;Taip;6;1;0;7
6421;Paslaptis;"Darželio mišraus amžiaus grupė";3104525540;Taip;13;0;0;13
6422;Paslaptis;"Darželio mišraus amžiaus grupė";8895770223;Ne;8;1;0;9
6423;Paslaptis;"Darželio mišraus amžiaus grupė";5206529350;Taip;0;8;0;8
6424;Paslaptis;"Darželio mišraus amžiaus grupė";8239855620;Taip;6;0;0;6
6425;Paslaptis;"Darželio mišraus amžiaus grupė";8146824196;Taip;0;1;2;3
6426;Paslaptis;"Darželio mišraus amžiaus grupė";3398729758;Taip;0;8;0;8
6427;Paslaptis;"Darželio mišraus amžiaus grupė";1033910097;Taip;7;1;0;8
6428;Paslaptis;"NAUJA (LOPŠELIS)";5406800599;Taip;10;0;0;10
6429;Paslaptis;"NAUJA (LOPŠELIS)";4810686225;Taip;5;0;1;6
6430;Paslaptis;"NAUJA (LOPŠELIS)";3081951678;Taip;6;0;0;6
6431;Paslaptis;"NAUJA (LOPŠELIS)";6098345982;Taip;3;0;1;4
6432;Paslaptis;"NAUJA (LOPŠELIS)";6686352764;Taip;12;0;0;12
6433;Paslaptis;"NAUJA (LOPŠELIS)";1557783684;Taip;0;1;0;1
6434;Paslaptis;"NAUJA (LOPŠELIS)";5646806136;Taip;3;1;1;5
6435;Paslaptis;"NAUJA (LOPŠELIS)";9540612585;Taip;12;0;0;12
6436;Paslaptis;"NAUJA (LOPŠELIS)";7638521198;Taip;0;1;1;2
6437;Paslaptis;"NAUJA (LOPŠELIS)";9100003209;Ne;11;0;0;11
6438;Paslaptis;"NAUJA (LOPŠELIS)";5456011928;Taip;11;4;0;15
6439;Paslaptis;"NAUJA (LOPŠELIS)";5756338103;Taip;9;1;0;10
6440;Paslaptis;"NAUJA (LOPŠELIS)";5886364670;Taip;7;0;2;9
6441;Paslaptis;"NAUJA (LOPŠELIS)";3844066232;Taip;10;3;0;13
6442;Paslaptis;"NAUJA (LOPŠELIS)";2675089401;Taip;12;1;0;13
6443;Paslaptis;"NAUJA (LOPŠELIS)";4130010071;Taip;10;0;0;10
6444;Pasakaitė;Vieversėlių;7746580858;Taip;6;6;0;12
6445;Pasakaitė;Vieversėlių;7685647972;Taip;6;1;1;8
6446;Pasakaitė;Vieversėlių;9587489514;Taip;0;0;3;3
6447;Pasakaitė;Vieversėlių;3444442287;Taip;6;0;0;6
6448;Pasakaitė;Vieversėlių;5485965486;Taip;8;0;0;8
6449;Pasakaitė;Vieversėlių;2563725297;Taip;0;0;5;5
6450;Pasakaitė;Vieversėlių;7963057831;Taip;0;0;1;1
6451;Pasakaitė;Vieversėlių;9543991684;Taip;3;6;0;9
6452;Pasakaitė;Vieversėlių;7020773169;Taip;2;0;13;15
6453;Pasakaitė;Vieversėlių;3680596008;Taip;0;0;6;6
6454;Pasakaitė;Vieversėlių;4882856664;Taip;0;10;3;13
6455;Pasakaitė;Vieversėlių;5948958906;Taip;5;2;0;7
6456;Pasakaitė;Vieversėlių;1060914693;Taip;0;1;0;1
6457;Pasakaitė;Vieversėlių;7761162338;Taip;15;0;1;16
6458;Pasakaitė;Vieversėlių;8463220257;Taip;0;0;4;4
6459;Pasakaitė;Vieversėlių;9018830962;Taip;11;0;1;12
6460;Pasakaitė;Spindulėlių;8638071584;Ne;0;0;2;2
6461;Pasakaitė;Spindulėlių;75361056418;Taip;7;0;0;7
6462;Pasakaitė;Spindulėlių;4680949976;Taip;8;1;0;9
6463;Pasakaitė;Spindulėlių;3734935229;Ne;0;16;0;16
6464;Pasakaitė;Spindulėlių;2523842161;Taip;7;10;0;17
6465;Pasakaitė;Spindulėlių;4267488049;Taip;7;0;0;7
6466;Pasakaitė;Spindulėlių;7152349570;Taip;0;9;0;9
6467;Pasakaitė;Spindulėlių;1220619991;Taip;7;0;0;7
6468;Pasakaitė;Spindulėlių;7526264241;Taip;0;0;5;5
6469;Pasakaitė;Spindulėlių;3606601644;Taip;8;0;0;8
6470;Pasakaitė;Spindulėlių;3541877287;Taip;7;0;0;7
6471;Pasakaitė;Spindulėlių;3579498202;Taip;8;1;0;9
6472;Pasakaitė;Spindulėlių;3400305768;Taip;5;0;0;5
6473;Pasakaitė;Spindulėlių;6568538767;Taip;10;3;0;13
6474;Pasakaitė;Pasagėlių;3165658822;Taip;0;22;0;22
6475;Pasakaitė;Pasagėlių;61230317080;Ne;0;9;0;9
6476;Pasakaitė;Pasagėlių;1740419218;Taip;5;5;0;10
6477;Pasakaitė;Pasagėlių;5378855541;Taip;10;1;0;11
6478;Pasakaitė;Pasagėlių;9680682204;Taip;2;1;0;3
6479;Pasakaitė;Pasagėlių;4703375416;Taip;0;0;5;5
6480;Pasakaitė;Pasagėlių;8466086339;Taip;10;0;1;11
6481;Pasakaitė;Pasagėlių;1019010454;Taip;0;1;0;1
6482;Pasakaitė;Pasagėlių;4959175420;Taip;0;10;0;10
6483;Pasakaitė;Pasagėlių;83018133588;Taip;10;0;2;12
6484;Pasakaitė;Pasagėlių;4013900094;Taip;0;0;1;1
6485;Pasakaitė;Pasagėlių;1791015854;Taip;5;0;0;5
6486;Pasakaitė;Pasagėlių;39853246609;Taip;5;0;0;5
6487;Pasakaitė;Pasagėlių;1707428977;Taip;12;0;4;16
6488;Pasakaitė;Pasagėlių;5467179333;Taip;0;12;0;12
6489;Pasakaitė;Švyturėlių;24096031951;Taip;0;0;4;4
6490;Pasakaitė;Švyturėlių;11001677712;Taip;8;0;8;16
6491;Pasakaitė;Švyturėlių;9914689534;Taip;5;0;2;7
6492;Pasakaitė;Švyturėlių;75785125455;Taip;7;0;0;7
6493;Pasakaitė;Švyturėlių;88077831193;Taip;15;0;1;16
6494;Pasakaitė;Švyturėlių;8225188274;Taip;0;14;0;14
6495;Pasakaitė;Švyturėlių;73957497029;Taip;0;2;0;2
6496;Pasakaitė;Švyturėlių;1070409611;Taip;5;0;1;6
6497;Pasakaitė;Švyturėlių;2331486690;Taip;8;0;6;14
6498;Pasakaitė;Švyturėlių;8469043564;Taip;4;0;4;8
6499;Pasakaitė;Švyturėlių;5436985035;Ne;0;8;0;8
6500;Pasakaitė;Švyturėlių;4008826950;Taip;0;13;0;13
6501;Pasakaitė;Švyturėlių;2721048424;Taip;3;0;3;6
6502;Pasakaitė;Švyturėlių;1513903341;Taip;5;0;3;8
6503;Pasakaitė;Švyturėlių;8578521969;Taip;15;0;1;16
6504;Pasakaitė;Švyturėlių;8390366303;Ne;0;0;3;3
6505;Pasakaitė;Švyturėlių;3778906698;Taip;0;0;1;1
6506;Pasakaitė;Švyturėlių;1278198989;Taip;12;0;3;15
6507;Pasakaitė;Švyturėlių;22071058323;Taip;13;8;0;21
6508;Pasakaitė;Švyturėlių;1940545723;Ne;0;6;0;6
6509;Pasakaitė;Kodėlčiukų;82138492327;Taip;6;0;0;6
6510;Pasakaitė;Kodėlčiukų;94317654094;Taip;7;0;0;7
6511;Pasakaitė;Kodėlčiukų;1121139222;Ne;0;0;1;1
6512;Pasakaitė;Kodėlčiukų;2017823264;Taip;0;0;1;1
6513;Pasakaitė;Kodėlčiukų;72093762601;Taip;4;0;0;4
6514;Pasakaitė;Kodėlčiukų;11006810461;Taip;3;3;0;6
6515;Pasakaitė;Kodėlčiukų;1553678838;Taip;0;0;1;1
6516;Pasakaitė;Kodėlčiukų;92762645558;Ne;0;0;2;2
6517;Pasakaitė;Kodėlčiukų;93907096625;Taip;15;0;0;15
6518;Pasakaitė;Kodėlčiukų;4974486850;Ne;0;0;4;4
6519;Pasakaitė;Kodėlčiukų;9746401498;Ne;0;0;4;4
6520;Pasakaitė;Kodėlčiukų;6839399035;Ne;4;0;1;5
6521;Pasakaitė;Kodėlčiukų;99352468512;Taip;0;12;0;12
6522;Pasakaitė;Kodėlčiukų;1809383469;Taip;0;12;0;12
6523;Pasakaitė;Kodėlčiukų;2742595829;Taip;0;0;2;2
6524;Pasakaitė;Kodėlčiukų;1592521766;Taip;3;0;0;3
6525;Pasakaitė;Kodėlčiukų;6983619733;Taip;0;0;4;4
6526;Pasakaitė;Kodėlčiukų;9506178305;Taip;10;0;0;10
6527;Pasakaitė;Kodėlčiukų;4583679144;Taip;8;0;0;8
6528;Pasakaitė;Gudručių;70802215290;Taip;0;14;0;14
6529;Pasakaitė;Gudručių;48421643700;Taip;0;0;1;1
6530;Pasakaitė;Gudručių;6909280007;Taip;3;0;0;3
6531;Pasakaitė;Gudručių;82272856075;Taip;0;0;1;1
6532;Pasakaitė;Gudručių;1537944476;Taip;0;0;1;1
6533;Pasakaitė;Gudručių;1631919806;Ne;10;0;0;10
6534;Pasakaitė;Gudručių;1696228992;Ne;10;0;0;10
6535;Pasakaitė;Gudručių;18419655194;Taip;0;2;2;4
6536;Pasakaitė;Gudručių;1917342472;Ne;0;0;7;7
6537;Pasakaitė;Gudručių;91751201397;Taip;7;0;5;12
6538;Pasakaitė;Gudručių;23103636206;Taip;0;7;0;7
6539;Pasakaitė;Gudručių;35147041377;Taip;0;0;4;4
6540;Pasakaitė;Gudručių;725988513;Taip;0;2;0;2
6541;Pasakaitė;Gudručių;39926553926;Taip;0;0;6;6
6542;Pasakaitė;Gudručių;1139554564;Taip;10;5;0;15
6543;Pasakaitė;Čiulbonėlių;39762990812;Taip;0;3;18;21
6544;Pasakaitė;Čiulbonėlių;30460033968;Taip;0;1;0;1
6545;Pasakaitė;Čiulbonėlių;32235101944;Taip;0;6;0;6
6546;Pasakaitė;Čiulbonėlių;1159523006;Taip;0;0;5;5
6547;Pasakaitė;Čiulbonėlių;26826144324;Taip;0;0;1;1
6548;Pasakaitė;Čiulbonėlių;74338375162;Taip;0;0;1;1
6549;Pasakaitė;Čiulbonėlių;72232008007;Taip;8;0;10;18
6550;Pasakaitė;Čiulbonėlių;21872672491;Taip;0;0;3;3
6551;Pasakaitė;Čiulbonėlių;21284070194;Taip;0;0;1;1
6552;Pasakaitė;Čiulbonėlių;13787417933;Ne;0;0;2;2
6553;Pasakaitė;Čiulbonėlių;20667371334;Taip;0;0;9;9
6554;Pasakaitė;Čiulbonėlių;52127092749;Taip;0;0;2;2
6555;Pasakaitė;Čiulbonėlių;15644259897;Taip;0;0;1;1
6556;Pasakaitė;Čiulbonėlių;88951595986;Ne;0;0;1;1
6557;Pasakaitė;Čiulbonėlių;1381307997;Taip;0;13;0;13
6558;Pasakaitė;"Verpstelių ";12092268542;Taip;0;3;0;3
6559;Pasakaitė;"Verpstelių ";26031226748;Taip;0;5;0;5
6560;Pasakaitė;"Verpstelių ";1407277414;Taip;5;0;1;6
6561;Pasakaitė;"Verpstelių ";17218793370;Taip;6;5;0;11
6562;Pasakaitė;"Verpstelių ";33418184802;Ne;0;8;1;9
6563;Pasakaitė;"Verpstelių ";46873849992;Taip;0;4;0;4
6564;Pasakaitė;"Verpstelių ";96648719544;Taip;6;5;0;11
6565;Pasakaitė;"Verpstelių ";82475369612;Taip;0;2;0;2
6566;Pasakaitė;"Verpstelių ";51040024089;Taip;0;0;1;1
6567;Pasakaitė;"Verpstelių ";88885227604;Taip;0;12;0;12
6568;Pasakaitė;"Verpstelių ";2210519019;Taip;8;0;0;8
6569;Pasakaitė;"Verpstelių ";18105216772;Taip;0;6;0;6
6570;Pasakaitė;"Verpstelių ";50537059387;Taip;0;0;2;2
6571;Pasakaitė;"Verpstelių ";29699532850;Taip;0;14;0;14
6572;Pasakaitė;"Verpstelių ";45157801238;Taip;0;0;1;1
6573;Pasakaitė;Smalsučiai;5556362727;Taip;0;0;5;5
6574;Pasakaitė;Smalsučiai;7759051761;Taip;5;0;0;5
6575;Pasakaitė;Smalsučiai;2404448954;Taip;5;0;1;6
6576;Pasakaitė;Smalsučiai;3710143250;Taip;0;0;1;1
6577;Pasakaitė;Smalsučiai;7621306769;Taip;5;0;0;5
6578;Pasakaitė;Smalsučiai;1744216870;Taip;8;0;0;8
6579;Pasakaitė;Smalsučiai;1533259056;Ne;2;4;2;8
6580;Pasakaitė;Smalsučiai;1425166722;Taip;4;0;3;7
6581;Pasakaitė;Smalsučiai;8315840473;Taip;9;1;0;10
6582;Pasakaitė;Smalsučiai;9821617981;Taip;0;0;1;1
6583;Pasakaitė;"Čiauškučiai ";6714500298;Taip;0;0;1;1
6584;Pasakaitė;"Čiauškučiai ";1962693480;Taip;6;0;1;7
6585;Pasakaitė;"Čiauškučiai ";1963102227;Taip;0;0;1;1
6586;Pasakaitė;"Čiauškučiai ";4758073190;Taip;4;0;0;4
6587;Pasakaitė;"Čiauškučiai ";7813221735;Taip;0;0;2;2
6588;Pasakaitė;"Čiauškučiai ";8267725352;Taip;5;0;0;5
6589;Pasakaitė;"Čiauškučiai ";1184513606;Taip;0;0;9;9
6590;Pasakaitė;"Čiauškučiai ";9166649594;Taip;0;0;1;1
6591;Pasakaitė;"Čiauškučiai ";2751828639;Taip;0;1;0;1
6592;Pasakaitė;"Čiauškučiai ";8223662339;Taip;17;0;0;17
6593;Pasakaitė;"Čiauškučiai ";6858356868;Taip;7;0;3;10
6594;Pasakaitė;Pabiručiai;1827070201;Taip;8;0;0;8
6595;Pasakaitė;Pabiručiai;9175612991;Taip;0;0;1;1
6596;Pasakaitė;Pabiručiai;26714845001;Taip;10;0;1;11
6597;Pasakaitė;Pabiručiai;46891856500;Taip;5;2;0;7
6598;Pasakaitė;Pabiručiai;3397132786;Ne;0;5;0;5
6599;Pasakaitė;Pabiručiai;1769070351;Taip;0;1;0;1
6600;Pasakaitė;Pabiručiai;49117693773;Taip;0;1;0;1
6601;Pasakaitė;Pabiručiai;1320898756;Taip;0;0;5;5
6602;Pasakaitė;Pabiručiai;1027136050;Taip;14;0;0;14
6603;Pasakaitė;Pabiručiai;1198248619;Taip;0;11;0;11
6604;Pasakaitė;Pabiručiai;1595057434;Taip;5;0;4;9
6605;Pasakaitė;Pabiručiai;1032113089;Taip;0;7;0;7
6606;Pasakaitė;Pabiručiai;21252086256;Taip;5;0;1;6
6607;Pasakaitė;Pabiručiai;6134483994;Taip;0;4;0;4
6608;Pasakaitė;Pabiručiai;1673576868;Taip;0;16;0;16
6609;Pasakaitė;Pabiručiai;2017275984;Taip;0;8;0;8
6610;Pasakaitė;Pabiručiai;27702516199;Taip;0;0;2;2
6611;Pasakaitė;Pabiručiai;6346678827;Ne;0;0;2;2
6612;Pelenė;Varpelis;93009343319;Taip;0;0;2;2
6613;Pelenė;Varpelis;59795549508;Taip;0;7;0;7
6614;Pelenė;Varpelis;83359560510;Taip;0;6;0;6
6615;Pelenė;Varpelis;70335326964;Taip;0;4;0;4
6616;Pelenė;Varpelis;3245982902;Taip;0;0;2;2
6617;Pelenė;Varpelis;32716320977;Taip;0;5;0;5
6618;Pelenė;Varpelis;1733433768;Taip;0;0;6;6
6619;Pelenė;Varpelis;40968963343;Taip;0;1;0;1
6620;Pelenė;Varpelis;29587640966;Taip;0;8;0;8
6621;Pelenė;Varpelis;55350714718;Taip;0;0;4;4
6622;Pelenė;Varpelis;120966603;Taip;2;7;0;9
6623;Pelenė;Varpelis;33408520827;Taip;3;0;0;3
6624;Pelenė;Varpelis;62615483649;Taip;9;0;0;9
6625;Pelenė;Varpelis;35657264407;Ne;3;0;1;4
6626;Pelenė;Varpelis;12400151337;Taip;5;0;2;7
6627;Pelenė;Saulutės;99849461351;Taip;0;1;0;1
6628;Pelenė;Saulutės;12170216844;Taip;0;0;2;2
6629;Pelenė;Saulutės;1321060587;Taip;4;0;0;4
6630;Pelenė;Saulutės;89623266364;Taip;0;0;1;1
6631;Pelenė;Saulutės;72216942887;Taip;5;0;2;7
6632;Pelenė;Saulutės;96121315210;Ne;5;0;1;6
6633;Pelenė;Saulutės;1289416312;Taip;0;4;0;4
6634;Pelenė;Saulutės;29900302904;Taip;0;0;1;1
6635;Pelenė;Saulutės;96840961754;Taip;2;0;0;2
6636;Pelenė;Saulutės;52690820;Taip;0;0;1;1
6637;Pelenė;Saulutės;78648474464;Ne;7;0;3;10
6638;Pelenė;Saulutės;4178071578;Taip;0;3;0;3
6639;Pelenė;Saulutės;8813044848;Taip;0;0;6;6
6640;Pelenė;Saulutės;1807037374;Taip;0;0;9;9
6641;Pelenė;Saulutės;6559830470;Taip;0;0;1;1
6642;Pelenė;Saulutės;6937587856;Taip;7;0;0;7
6643;Pelenė;Raktelis;9019827941;Taip;0;0;2;2
6644;Pelenė;Raktelis;3465518545;Taip;4;4;3;11
6645;Pelenė;Raktelis;4386060612;Ne;5;0;7;12
6646;Pelenė;Raktelis;1418000665;Taip;6;0;3;9
6647;Pelenė;Raktelis;3299454566;Taip;0;0;1;1
6648;Pelenė;Raktelis;1127657620;Taip;0;1;0;1
6649;Pelenė;Raktelis;17572291941;Taip;0;1;0;1
6650;Pelenė;Raktelis;28622286194;Taip;0;0;1;1
6651;Pelenė;Raktelis;1050272821;Taip;0;2;0;2
6652;Pelenė;Raktelis;51979406888;Taip;0;3;0;3
6653;Pelenė;Raktelis;89920419797;Taip;3;0;2;5
6654;Pelenė;Raktelis;45589326259;Ne;0;0;4;4
6655;Pelenė;Raktelis;26010775076;Taip;10;4;0;14
6656;Pelenė;Raktelis;1483843416;Taip;0;12;0;12
6657;Pelenė;Raktelis;2677995903;Ne;0;0;2;2
6658;Pelenė;Raktelis;6289619123;Taip;0;0;1;1
6659;Pelenė;Žvaigždutės;1336431888;Taip;0;0;12;12
6660;Pelenė;Žvaigždutės;1114786936;Taip;5;0;0;5
6661;Pelenė;Žvaigždutės;1781704945;Taip;3;0;0;3
6662;Pelenė;Žvaigždutės;1140030742;Taip;0;0;1;1
6663;Pelenė;Žvaigždutės;3497915398;Taip;0;4;0;4
6664;Pelenė;Žvaigždutės;2154553741;Taip;0;4;0;4
6665;Pelenė;Žvaigždutės;8598498275;Taip;6;10;0;16
6666;Pelenė;Žvaigždutės;39705461573;Ne;14;0;0;14
6667;Pelenė;Žvaigždutės;5804848640;Taip;0;7;0;7
6668;Pelenė;Žvaigždutės;1710249888;Taip;0;4;0;4
6669;Pelenė;Žvaigždutės;61012202440;Taip;5;0;2;7
6670;Pelenė;Žvaigždutės;34765342495;Taip;4;4;0;8
6671;Pelenė;Žvaigždutės;45410683361;Ne;0;0;6;6
6672;Pelenė;Žvaigždutės;62484999314;Taip;5;0;7;12
6673;Pelenė;Nykštukas;7144616734;Ne;8;0;0;8
6674;Pelenė;Nykštukas;3296147024;Taip;0;12;0;12
6675;Pelenė;Nykštukas;3189305906;Taip;0;9;0;9
6676;Pelenė;Nykštukas;8607110629;Taip;0;7;0;7
6677;Pelenė;Nykštukas;9584503078;Taip;0;0;2;2
6678;Pelenė;Nykštukas;10457480694;Taip;3;0;2;5
6679;Pelenė;Nykštukas;1750366978;Taip;3;0;1;4
6680;Pelenė;Nykštukas;2092775878;Taip;0;6;0;6
6681;Pelenė;Nykštukas;8675348688;Taip;5;0;0;5
6682;Pelenė;Nykštukas;7254981715;Ne;0;0;1;1
6683;Pelenė;Nykštukas;7836778389;Taip;0;3;0;3
6684;Pelenė;Nykštukas;8721423900;Taip;0;0;6;6
6685;Pelenė;Nykštukas;6579504852;Taip;0;0;2;2
6686;Pelenė;Nykštukas;6021833025;Taip;0;3;0;3
6687;Pelenė;Nykštukas;1978481168;Taip;18;0;0;18
6688;Pelenė;Nykštukas;3596386480;Taip;0;3;0;3
6689;Pelenė;Nykštukas;7205437280;Taip;0;0;2;2
6690;Pelenė;Nykštukas;3385568839;Taip;0;11;0;11
6691;Pelenė;Nykštukas;5081903157;Taip;0;3;0;3
6692;Pelenė;Žirniukai;4315677064;Taip;9;0;0;9
6693;Pelenė;Žirniukai;4624325473;Taip;11;1;0;12
6694;Pelenė;Žirniukai;1775717256;Ne;13;0;0;13
6695;Pelenė;Žirniukai;6632188229;Taip;0;8;0;8
6696;Pelenė;Žirniukai;5356756237;Ne;11;0;0;11
6697;Pelenė;Žirniukai;7587887488;Ne;5;0;6;11
6698;Pelenė;Žirniukai;8716395810;Taip;0;8;0;8
6699;Pelenė;Žirniukai;6191899254;Ne;10;0;0;10
6700;Pelenė;Žirniukai;2737277656;Taip;10;5;1;16
6701;Pelenė;Žirniukai;6481466282;Taip;10;0;0;10
6702;Pelenė;Žirniukai;5389865440;Ne;11;0;0;11
6703;Pelenė;Žirniukai;1902314385;Taip;0;0;2;2
6704;Pelenė;Žirniukai;6707167720;Taip;10;0;2;12
6705;Pelenė;Žirniukai;9009271610;Taip;0;5;0;5
6706;Pelenė;Žirniukai;5325176433;Taip;7;6;0;13
6707;Pelenė;Žirniukai;9186679454;Taip;2;0;0;2
6708;Pelenė;Žirniukai;8414727016;Taip;2;0;0;2
6709;Pelenė;Lašeliai;4591637887;Taip;0;5;0;5
6710;Pelenė;Lašeliai;1067737206;Taip;0;11;0;11
6711;Pelenė;Lašeliai;6038229659;Taip;0;0;1;1
6712;Pelenė;Lašeliai;4090532624;Ne;6;0;0;6
6713;Pelenė;Lašeliai;7589978427;Taip;3;7;0;10
6714;Pelenė;Lašeliai;9075193730;Ne;7;0;0;7
6715;Pelenė;Lašeliai;6419661741;Taip;0;0;4;4
6716;Pelenė;Lašeliai;8123162647;Taip;0;5;0;5
6717;Pelenė;Lašeliai;4366940539;Taip;8;3;0;11
6718;Pelenė;Lašeliai;7114993398;Ne;5;0;2;7
6719;Pelenė;Lašeliai;7659625628;Taip;2;0;1;3
6720;Pelenė;Lašeliai;2210314952;Taip;1;0;0;1
6721;Pelenė;Lašeliai;9063588699;Taip;0;7;0;7
6722;Pelenė;Lašeliai;7088493729;Taip;5;0;0;5
6723;Pelenė;Lašeliai;3573543545;Taip;5;4;0;9
6724;Pelenė;Lašeliai;4089199552;Taip;11;0;0;11
6725;Pelenė;Lašeliai;4546285993;Taip;0;0;22;22
6726;Pelenė;Lašeliai;4541391191;Taip;5;0;2;7
6727;Pelenė;Lašeliai;9195113444;Taip;0;13;0;13
6728;Pelenė;Lašeliai;7880284433;Taip;5;0;5;10
6729;Pelenė;Lašeliai;3238807604;Ne;0;5;0;5
6730;Pelenė;Lašeliai;6375060159;Taip;1;0;1;2
6731;Pelenė;Lašeliai;5063098703;Taip;0;6;0;6
6732;Pelenė;Lašeliai;5780697554;Taip;0;16;0;16
6733;Pelenė;Grūdelis;55160554683;Taip;0;0;1;1
6734;Pelenė;Grūdelis;1283843474;Taip;1;0;5;6
6735;Pelenė;Grūdelis;3189769456;Taip;1;7;0;8
6736;Pelenė;Grūdelis;8483195434;Taip;0;0;1;1
6737;Pelenė;Grūdelis;66474157416;Taip;0;4;3;7
6738;Pelenė;Grūdelis;77504082241;Taip;5;9;0;14
6739;Pelenė;Grūdelis;1599336930;Taip;7;0;0;7
6740;Pelenė;Grūdelis;93234992958;Taip;12;0;0;12
6741;Pelenė;Grūdelis;2393068606;Taip;0;12;0;12
6742;Pelenė;Grūdelis;62544766703;Taip;0;0;1;1
6743;Pelenė;Grūdelis;43686344645;Ne;0;0;6;6
6744;Pelenė;Grūdelis;71274664713;Taip;0;6;0;6
6745;Pelenė;Grūdelis;1542958753;Taip;6;0;4;10
6746;Pelenė;Grūdelis;1516249890;Taip;0;5;0;5
6747;Pelenė;Grūdelis;1846536895;Taip;0;8;0;8
6748;Pelenė;Braškytė;8038559319;Taip;1;0;0;1
6749;Pelenė;Braškytė;5697826755;Taip;0;0;1;1
6750;Pelenė;Braškytė;6864263698;Taip;6;0;0;6
6751;Pelenė;Braškytė;9447223913;Taip;0;0;1;1
6752;Pelenė;Braškytė;4004975235;Taip;10;0;0;10
6753;Pelenė;Braškytė;8790613872;Taip;10;0;0;10
6754;Pelenė;Braškytė;2647876561;Taip;6;0;2;8
6755;Pelenė;Braškytė;8239650471;Taip;2;0;1;3
6756;Pelenė;Braškytė;3174009848;Taip;11;0;0;11
6757;Pelenė;Braškytė;6524101295;Taip;2;0;0;2
6758;Pelenė;Braškytė;7164790060;Taip;0;1;0;1
6759;Pelenė;Braškytė;4376033711;Taip;5;0;0;5
6760;Pelenė;Braškytė;6894978459;Taip;5;1;0;6
6761;Pelenė;Braškytė;4321705575;Taip;5;7;0;12
6762;Pelenė;Braškytė;2103177773;Taip;0;0;1;1
6763;Pelenė;Boružėlės;9218868317;Taip;0;0;4;4
6764;Pelenė;Boružėlės;6221703608;Taip;7;0;0;7
6765;Pelenė;Boružėlės;7565331966;Taip;10;0;1;11
6766;Pelenė;Boružėlės;9810123679;Taip;0;3;0;3
6767;Pelenė;Boružėlės;1048899958;Taip;10;0;0;10
6768;Pelenė;Boružėlės;2540405047;Taip;3;0;0;3
6769;Pelenė;Boružėlės;6469409776;Taip;9;0;0;9
6770;Pelenė;Boružėlės;1274729537;Taip;5;0;0;5
6771;Pelenė;Boružėlės;2322908067;Taip;0;22;0;22
6772;Pelenė;Boružėlės;5084452088;Taip;12;0;1;13
6773;Pelenė;Saldainiukai;2040256240;Taip;7;0;0;7
6774;Pelenė;Saldainiukai;8623480143;Ne;0;0;1;1
6775;Pelenė;Saldainiukai;2765650058;Taip;1;0;0;1
6776;Pelenė;Saldainiukai;1632490481;Taip;0;0;11;11
6777;Pelenė;Saldainiukai;7578318198;Taip;5;0;0;5
6778;Pelenė;Saldainiukai;7714061272;Taip;0;6;0;6
6779;Pipiras;EŽIUKAI;12489971559;Taip;0;4;0;4
6780;Pipiras;EŽIUKAI;56241147614;Taip;0;1;0;1
6781;Pipiras;EŽIUKAI;1112327896;Taip;0;2;13;15
6782;Pipiras;EŽIUKAI;52968399382;Taip;0;2;0;2
6783;Pipiras;EŽIUKAI;76685499613;Taip;0;1;1;2
6784;Pipiras;EŽIUKAI;24414917430;Taip;0;6;0;6
6785;Pipiras;EŽIUKAI;43500610422;Taip;0;0;1;1
6786;Pipiras;EŽIUKAI;71881026465;Ne;0;1;1;2
6787;Pipiras;EŽIUKAI;32958963027;Taip;0;1;1;2
6788;Pipiras;EŽIUKAI;95904922548;Taip;0;1;0;1
6789;Pipiras;EŽIUKAI;55466909230;Taip;0;0;2;2
6790;Pipiras;EŽIUKAI;53468621826;Taip;0;3;1;4
6791;Pipiras;EŽIUKAI;9858798452;Taip;0;1;0;1
6792;Pipiras;EŽIUKAI;1213972436;Taip;0;6;0;6
6793;Pipiras;EŽIUKAI;4564046164;Ne;3;2;0;5
6794;Pipiras;EŽIUKAI;35225328018;Ne;0;1;1;2
6795;Pipiras;EŽIUKAI;1129409620;Taip;0;1;8;9
6796;Pipiras;EŽIUKAI;1061415778;Taip;10;0;0;10
6797;Pipiras;EŽIUKAI;1095731795;Taip;0;1;18;19
6798;Pipiras;BITUTĖS;3554786173;Taip;8;0;0;8
6799;Pipiras;BITUTĖS;5725956659;Taip;4;0;1;5
6800;Pipiras;BITUTĖS;7934365114;Taip;4;1;0;5
6801;Pipiras;BITUTĖS;9840040112;Taip;0;9;0;9
6802;Pipiras;BITUTĖS;3852848863;Taip;5;1;0;6
6803;Pipiras;BITUTĖS;5235868332;Taip;0;1;0;1
6804;Pipiras;BITUTĖS;6780333972;Taip;5;8;0;13
6805;Pipiras;BITUTĖS;7350131214;Taip;11;0;0;11
6806;Pipiras;BITUTĖS;5225533488;Taip;5;2;0;7
6807;Pipiras;BITUTĖS;5622119207;Taip;0;2;0;2
6808;Pipiras;BITUTĖS;6792777396;Taip;6;2;0;8
6809;Pipiras;BITUTĖS;1784839485;Taip;0;3;0;3
6810;Pipiras;BITUTĖS;3775916247;Taip;0;5;0;5
6811;Pipiras;BITUTĖS;5845498558;Taip;18;2;0;20
6812;Pipiras;BITUTĖS;4177166475;Taip;0;7;0;7
6813;Pipiras;BITUTĖS;9157870634;Taip;0;7;0;7
6814;Pipiras;BITUTĖS;3882437376;Taip;5;1;0;6
6815;Pipiras;BITUTĖS;9770780973;Taip;11;0;0;11
6816;Pipiras;NYKŠTUKAI;1045583136;Taip;0;15;0;15
6817;Pipiras;NYKŠTUKAI;4811029230;Taip;5;1;0;6
6818;Pipiras;NYKŠTUKAI;8140314304;Taip;0;4;0;4
6819;Pipiras;NYKŠTUKAI;6791495556;Taip;2;0;0;2
6820;Pipiras;NYKŠTUKAI;5422547144;Taip;0;8;0;8
6821;Pipiras;NYKŠTUKAI;6363349541;Taip;2;1;0;3
6822;Pipiras;NYKŠTUKAI;4266424785;Ne;0;8;0;8
6823;Pipiras;NYKŠTUKAI;2315614501;Taip;11;2;0;13
6824;Pipiras;NYKŠTUKAI;1242260242;Taip;5;2;0;7
6825;Pipiras;NYKŠTUKAI;6685567970;Taip;8;7;0;15
6826;Pipiras;NYKŠTUKAI;8520454289;Taip;17;0;0;17
6827;Pipiras;NYKŠTUKAI;4426479971;Taip;0;12;0;12
6828;Pipiras;NYKŠTUKAI;2267192782;Taip;0;6;0;6
6829;Pipiras;NYKŠTUKAI;3421769229;Taip;12;4;0;16
6830;Pipiras;NYKŠTUKAI;5445858240;Taip;3;0;0;3
6831;Pipiras;NYKŠTUKAI;4725221169;Taip;9;0;0;9
6832;Pipiras;PELĖDŽIUKAI;4428216634;Taip;6;0;2;8
6833;Pipiras;PELĖDŽIUKAI;6694920607;Taip;14;0;0;14
6834;Pipiras;PELĖDŽIUKAI;3325511140;Taip;15;0;0;15
6835;Pipiras;PELĖDŽIUKAI;3341850450;Ne;14;0;0;14
6836;Pipiras;PELĖDŽIUKAI;7870521230;Taip;0;1;6;7
6837;Pipiras;PELĖDŽIUKAI;5778300856;Taip;8;0;0;8
6838;Pipiras;PELĖDŽIUKAI;3888552150;Taip;3;12;0;15
6839;Pipiras;PELĖDŽIUKAI;7026118693;Taip;5;2;0;7
6840;Pipiras;PELĖDŽIUKAI;1391682850;Taip;0;9;0;9
6841;Pipiras;PELĖDŽIUKAI;87924002679;Taip;19;0;0;19
6842;Pipiras;PELĖDŽIUKAI;6136423200;Taip;0;0;1;1
6843;Pipiras;PELĖDŽIUKAI;6805620664;Taip;0;0;3;3
6844;Pipiras;PELĖDŽIUKAI;7912217889;Ne;10;1;0;11
6845;Pipiras;PELĖDŽIUKAI;5502001191;Taip;12;0;0;12
6846;Pipiras;PELĖDŽIUKAI;9275905384;Taip;5;0;0;5
6847;Pipiras;PELĖDŽIUKAI;4496076326;Taip;0;0;3;3
6848;Pipiras;PELĖDŽIUKAI;3141822820;Taip;0;14;0;14
6849;Pipiras;PELĖDŽIUKAI;2044498561;Taip;0;4;3;7
6850;Pipiras;PELĖDŽIUKAI;2240865490;Taip;0;0;2;2
6851;Pipiras;PELĖDŽIUKAI;3357866319;Ne;6;0;0;6
6852;Pipiras;DRUGELIAI;41585818819;Taip;14;1;0;15
6853;Pipiras;DRUGELIAI;5577759167;Taip;4;8;0;12
6854;Pipiras;DRUGELIAI;7799786844;Taip;4;4;0;8
6855;Pipiras;DRUGELIAI;5014457985;Ne;5;0;0;5
6856;Pipiras;DRUGELIAI;4927845000;Ne;0;6;0;6
6857;Pipiras;DRUGELIAI;1904376366;Taip;0;10;0;10
6858;Pipiras;DRUGELIAI;1128674099;Taip;0;10;0;10
6859;Pipiras;DRUGELIAI;3422170541;Taip;0;3;0;3
6860;Pipiras;DRUGELIAI;1391958633;Taip;16;4;0;20
6861;Pipiras;DRUGELIAI;7784343130;Taip;5;1;1;7
6862;Pipiras;DRUGELIAI;3622164823;Taip;0;10;0;10
6863;Pipiras;DRUGELIAI;3008358842;Taip;0;4;0;4
6864;Pipiras;DRUGELIAI;2024777430;Taip;7;0;0;7
6865;Pipiras;DRUGELIAI;4959823035;Taip;0;2;0;2
6866;Pipiras;DRUGELIAI;6339186940;Taip;7;2;0;9
6867;Pipiras;DRUGELIAI;3314276870;Taip;5;9;0;14
6868;Pipiras;DRUGELIAI;5637557921;Taip;0;0;1;1
6869;Pipiras;DRUGELIAI;1050430252;Ne;7;0;0;7
6870;Pipiras;DRUGELIAI;2914156353;Taip;0;0;6;6
6871;Pipiras;GĖLYTĖS;48059975861;Taip;0;0;2;2
6872;Pipiras;GĖLYTĖS;81335131932;Taip;0;7;0;7
6873;Pipiras;GĖLYTĖS;23377947863;Taip;0;16;0;16
6874;Pipiras;GĖLYTĖS;87831792882;Taip;0;0;2;2
6875;Pipiras;GĖLYTĖS;1417855241;Taip;4;2;0;6
6876;Pipiras;GĖLYTĖS;1791226869;Taip;8;6;0;14
6877;Pipiras;GĖLYTĖS;60652954862;Taip;0;4;0;4
6878;Pipiras;GĖLYTĖS;27808576289;Taip;0;0;2;2
6879;Pipiras;GĖLYTĖS;5114553619;Taip;0;0;7;7
6880;Pipiras;GĖLYTĖS;1780531222;Taip;0;0;2;2
6881;Pipiras;GĖLYTĖS;18211174874;Taip;0;5;0;5
6882;Pipiras;GĖLYTĖS;4246712256;Ne;6;0;0;6
6883;Pipiras;GĖLYTĖS;25000181631;Taip;0;4;1;5
6884;Pipiras;GĖLYTĖS;2473644942;Ne;0;18;0;18
6885;Pipiras;GĖLYTĖS;1650661825;Taip;0;7;0;7
6886;Pipiras;GĖLYTĖS;56822466210;Taip;0;7;0;7
6887;Pipiras;GĖLYTĖS;23663823688;Taip;0;5;0;5
6888;Pipiras;GĖLYTĖS;6481320053;Ne;0;6;0;6
6889;Pipiras;BORUŽĖLĖS;68636458010;Taip;0;0;1;1
6890;Pipiras;BORUŽĖLĖS;20456702162;Taip;1;0;1;2
6891;Pipiras;BORUŽĖLĖS;57459408180;Taip;0;17;0;17
6892;Pipiras;BORUŽĖLĖS;7354253729;Ne;0;6;0;6
6893;Pipiras;BORUŽĖLĖS;99551392640;Taip;0;0;2;2
6894;Pipiras;BORUŽĖLĖS;9423015002;Taip;0;8;0;8
6895;Pipiras;BORUŽĖLĖS;68235713574;Taip;0;17;0;17
6896;Pipiras;BORUŽĖLĖS;63605758339;Taip;0;0;1;1
6897;Pipiras;BORUŽĖLĖS;23794561369;Taip;0;9;0;9
6898;Pipiras;BORUŽĖLĖS;46165404909;Ne;0;0;6;6
6899;Pipiras;BORUŽĖLĖS;92764472620;Taip;0;2;0;2
6900;Pipiras;BORUŽĖLĖS;6804964469;Taip;0;6;0;6
6901;Pipiras;BORUŽĖLĖS;81817710888;Taip;0;0;4;4
6902;Pipiras;BORUŽĖLĖS;7448924569;Taip;0;0;2;2
6903;Pipiras;BORUŽĖLĖS;1676986127;Taip;1;1;0;2
6904;Pipiras;BORUŽĖLĖS;1334584865;Taip;12;0;0;12
6905;Pipiras;BORUŽĖLĖS;9673674008;Taip;0;0;2;2
6906;Pipiras;BORUŽĖLĖS;1657721144;Taip;0;7;2;9
6907;Pipiras;BORUŽĖLĖS;6766596656;Taip;0;0;6;6
6908;Pipiras;SKRUZDĖLIUKAI;76840668343;Taip;16;0;1;17
6909;Pipiras;SKRUZDĖLIUKAI;1975780209;Taip;9;0;2;11
6910;Pipiras;SKRUZDĖLIUKAI;50739918812;Ne;0;2;0;2
6911;Pipiras;SKRUZDĖLIUKAI;75153377410;Taip;0;0;14;14
6912;Pipiras;SKRUZDĖLIUKAI;53426269440;Taip;0;1;0;1
6913;Pipiras;SKRUZDĖLIUKAI;7196519583;Taip;0;2;0;2
6914;Pipiras;SKRUZDĖLIUKAI;53180156021;Taip;0;1;1;2
6915;Pipiras;SKRUZDĖLIUKAI;96711811784;Taip;0;13;0;13
6916;Pipiras;SKRUZDĖLIUKAI;85339674885;Taip;11;5;0;16
6917;Pipiras;SKRUZDĖLIUKAI;84791674090;Ne;0;3;0;3
6918;Pipiras;SKRUZDĖLIUKAI;49361002482;Taip;0;0;4;4
6919;Pipiras;SKRUZDĖLIUKAI;53377928276;Taip;0;2;0;2
6920;Pipiras;SKRUZDĖLIUKAI;57731282074;Taip;0;9;0;9
6921;Pipiras;SKRUZDĖLIUKAI;1450882528;Taip;0;0;1;1
6922;Pipiras;SKRUZDĖLIUKAI;65132324180;Taip;0;1;0;1
6923;Pipiras;SKRUZDĖLIUKAI;71790101454;Taip;0;5;0;5
6924;Pipiras;SKRUZDĖLIUKAI;73564428514;Ne;0;22;0;22
6925;Pipiras;SKRUZDĖLIUKAI;3867978800;Ne;0;3;0;3
6926;Pipiras;ŽVIRBLIUKŲ;70940029154;Taip;3;0;0;3
6927;Pipiras;ŽVIRBLIUKŲ;1232620336;Taip;10;1;5;16
6928;Pipiras;ŽVIRBLIUKŲ;1549121029;Taip;0;5;0;5
6929;Pipiras;ŽVIRBLIUKŲ;37087220885;Taip;4;1;0;5
6930;Pipiras;ŽVIRBLIUKŲ;1700856741;Taip;11;4;0;15
6931;Pipiras;ŽVIRBLIUKŲ;1757192919;Taip;13;2;0;15
6932;Pipiras;ŽVIRBLIUKŲ;1417086043;Taip;0;13;0;13
6933;Pipiras;ŽVIRBLIUKŲ;1441590033;Ne;0;0;1;1
6934;Pipiras;ŽVIRBLIUKŲ;1008228932;Taip;4;1;0;5
6935;Pipiras;ŽVIRBLIUKŲ;2030665851;Taip;4;2;0;6
6936;Pipiras;ŽVIRBLIUKŲ;1182415963;Taip;0;4;0;4
6937;Pipiras;ŽVIRBLIUKŲ;8657924258;Taip;0;5;1;6
6938;Pipiras;ŽVIRBLIUKŲ;10750695428;Taip;2;6;0;8
6939;Pipiras;ŽVIRBLIUKŲ;66816368717;Ne;0;10;0;10
6940;Pipiras;ŽVIRBLIUKŲ;22190236403;Ne;0;1;0;1
6941;Pipiras;ŽVIRBLIUKŲ;7736031786;Taip;0;0;4;4
6942;Pipiras;ZUIKUČIŲ;2016718354;Taip;0;0;4;4
6943;Pipiras;ZUIKUČIŲ;4017042461;Taip;0;10;0;10
6944;Pipiras;ZUIKUČIŲ;5141447649;Taip;3;1;3;7
6945;Pipiras;ZUIKUČIŲ;5908707752;Taip;0;7;0;7
6946;Pipiras;ZUIKUČIŲ;8422419380;Taip;0;1;0;1
6947;Pipiras;ZUIKUČIŲ;9892201598;Taip;7;0;0;7
6948;Pipiras;ZUIKUČIŲ;9499869533;Taip;6;0;0;6
6949;Pipiras;ZUIKUČIŲ;3980950261;Taip;7;0;0;7
6950;Pipiras;ZUIKUČIŲ;6696824728;Ne;0;0;1;1
6951;Pipiras;ZUIKUČIŲ;9372109848;Taip;10;7;0;17
6952;Pipiras;ZUIKUČIŲ;5137132420;Ne;5;1;0;6
6953;Pipiras;VARLIUKŲ;6810906239;Taip;16;0;0;16
6954;Pipiras;VARLIUKŲ;3465024013;Taip;16;0;0;16
6955;Pipiras;VARLIUKŲ;7969837759;Taip;14;1;0;15
6956;Pipiras;VARLIUKŲ;9625933545;Taip;0;1;7;8
6957;Pipiras;VARLIUKŲ;8819018248;Taip;3;0;1;4
6958;Pipiras;VARLIUKŲ;3768825314;Taip;10;0;0;10
6959;Pipiras;VARLIUKŲ;2296702730;Taip;0;2;0;2
6960;Pipiras;VARLIUKŲ;4510888337;Taip;12;0;0;12
6961;Pipiras;VARLIUKŲ;1711168196;Taip;9;0;0;9
6962;Pipiras;VARLIUKŲ;9968182443;Taip;7;1;0;8
6963;Pipiras;VARLIUKŲ;4309096743;Taip;10;0;0;10
6964;Pipiras;VARLIUKŲ;2483867901;Taip;0;1;0;1
6965;Pipiras;VARLIUKŲ;5059203266;Taip;6;0;0;6
6966;Pipiras;ŽIOGELIŲ;2096009051;Taip;0;15;0;15
6967;Pipiras;ŽIOGELIŲ;71283505646;Ne;0;7;1;8
6968;Pipiras;ŽIOGELIŲ;1485565125;Ne;4;0;3;7
6969;Pipiras;ŽIOGELIŲ;2061168407;Taip;12;0;0;12
6970;Pipiras;ŽIOGELIŲ;2030170020;Ne;4;3;0;7
6971;Pipiras;ŽIOGELIŲ;2637950013;Taip;22;0;0;22
6972;Pipiras;ŽIOGELIŲ;3652741639;Taip;15;1;0;16
6973;Pipiras;ŽIOGELIŲ;1082396096;Ne;0;9;0;9
6974;Pipiras;ŽIOGELIŲ;1324680675;Taip;0;3;0;3
6975;Pipiras;ŽIOGELIŲ;1371141047;Taip;0;4;0;4
6976;Pipiras;ŽIOGELIŲ;1293250996;Taip;0;4;0;4
6977;Pipiras;ŽIOGELIŲ;1751427121;Taip;0;4;0;4
6978;Pipiras;ŽIOGELIŲ;1114377378;Taip;0;5;0;5
6979;Pipiras;ŽIOGELIŲ;1694848410;Taip;5;9;0;14
6980;Pipiras;ŽIOGELIŲ;8088285579;Taip;0;16;0;16
6981;"Prie pasakų parko";ZUIKUČIAI;6963058612;Taip;16;0;3;19
6982;"Prie pasakų parko";ZUIKUČIAI;8451877584;Taip;9;0;3;12
6983;"Prie pasakų parko";ZUIKUČIAI;5030871828;Taip;0;0;3;3
6984;"Prie pasakų parko";ZUIKUČIAI;6280870972;Taip;4;0;1;5
6985;"Prie pasakų parko";ZUIKUČIAI;7858530013;Taip;0;3;0;3
6986;"Prie pasakų parko";ZUIKUČIAI;1738732866;Taip;0;12;0;12
6987;"Prie pasakų parko";ZUIKUČIAI;3795705735;Taip;0;8;0;8
6988;"Prie pasakų parko";ZUIKUČIAI;7320049068;Taip;0;0;2;2
6989;"Prie pasakų parko";ZUIKUČIAI;6606867989;Ne;13;0;0;13
6990;"Prie pasakų parko";ZUIKUČIAI;9750688419;Taip;0;11;0;11
6991;"Prie pasakų parko";ZUIKUČIAI;3120671593;Taip;5;0;1;6
6992;"Prie pasakų parko";ZUIKUČIAI;5901884512;Taip;5;0;3;8
6993;"Prie pasakų parko";"ŽVAIGŽDUTĖS  (SPEC)";2224744461;Taip;10;0;1;11
6994;"Prie pasakų parko";"ŽVAIGŽDUTĖS  (SPEC)";3045247119;Ne;0;0;5;5
6995;"Prie pasakų parko";"ŽVAIGŽDUTĖS  (SPEC)";7341054382;Ne;10;0;0;10
6996;"Prie pasakų parko";"ŽVAIGŽDUTĖS  (SPEC)";1118596267;Taip;3;0;1;4
6997;"Prie pasakų parko";"ŽVAIGŽDUTĖS  (SPEC)";89327404290;Taip;0;0;2;2
6998;"Prie pasakų parko";"ŽVAIGŽDUTĖS  (SPEC)";1828638638;Taip;0;0;3;3
6999;"Prie pasakų parko";"ŽVAIGŽDUTĖS  (SPEC)";5356005675;Taip;14;0;0;14
7000;"Prie pasakų parko";"EŽIUKŲ (SPEC)";5641148690;Taip;0;6;0;6
7001;"Prie pasakų parko";SAULYTĖS;4501408366;Taip;0;3;0;3
7002;"Prie pasakų parko";SAULYTĖS;5593546668;Taip;0;0;1;1
7003;"Prie pasakų parko";SAULYTĖS;6361878877;Taip;11;0;0;11
7004;"Prie pasakų parko";SAULYTĖS;6762267582;Taip;0;0;3;3
7005;"Prie pasakų parko";SAULYTĖS;3453119286;Taip;5;0;2;7
7006;"Prie pasakų parko";SAULYTĖS;5169736542;Taip;0;11;11;22
7007;"Prie pasakų parko";SAULYTĖS;5494350183;Taip;0;0;3;3
7008;"Prie pasakų parko";SAULYTĖS;5102718403;Taip;5;0;3;8
7009;"Prie pasakų parko";SAULYTĖS;8285260113;Taip;4;8;0;12
7010;"Prie pasakų parko";SAULYTĖS;5438716880;Taip;0;0;8;8
7011;"Prie pasakų parko";SAULYTĖS;7459673719;Taip;0;0;1;1
7012;"Prie pasakų parko";SAULYTĖS;2023309512;Ne;8;0;0;8
7013;"Prie pasakų parko";SAULYTĖS;8324750958;Ne;0;0;1;1
7014;"Prie pasakų parko";SAULYTĖS;1371318901;Taip;0;9;0;9
7015;"Prie pasakų parko";SAULYTĖS;4351705573;Taip;0;0;5;5
7016;"Prie pasakų parko";SAULYTĖS;3042409414;Taip;0;7;0;7
7017;Pumpurėlis;RAMUNĖLIŲ;7610949816;Taip;0;8;0;8
7018;Pumpurėlis;RAMUNĖLIŲ;6165833101;Taip;0;2;0;2
7019;Pumpurėlis;RAMUNĖLIŲ;9431295796;Taip;11;0;2;13
7020;Pumpurėlis;RAMUNĖLIŲ;1395380236;Taip;0;0;4;4
7021;Pumpurėlis;RAMUNĖLIŲ;9424449290;Ne;0;16;0;16
7022;Pumpurėlis;RAMUNĖLIŲ;6955168163;Taip;0;15;0;15
7023;Pumpurėlis;RAMUNĖLIŲ;5171198109;Taip;8;3;0;11
7024;Pumpurėlis;RAMUNĖLIŲ;9726028397;Taip;22;0;0;22
7025;Pumpurėlis;RAMUNĖLIŲ;7229289985;Taip;10;0;0;10
7026;Pumpurėlis;RAMUNĖLIŲ;2969734731;Ne;11;0;0;11
7027;Pumpurėlis;RAMUNĖLIŲ;5663147778;Taip;0;0;2;2
7028;Pumpurėlis;RAMUNĖLIŲ;7559071945;Taip;0;1;1;2
7029;Pumpurėlis;RAMUNĖLIŲ;8373105196;Taip;6;1;1;8
7030;Pumpurėlis;RAMUNĖLIŲ;3953103488;Taip;4;0;1;5
7031;Pumpurėlis;RAMUNĖLIŲ;6511527480;Taip;5;1;0;6
7032;Pumpurėlis;RAMUNĖLIŲ;3838705973;Taip;4;4;0;8
7033;Pumpurėlis;RAMUNĖLIŲ;6726875853;Taip;0;0;2;2
7034;Pumpurėlis;RAMUNĖLIŲ;7996736781;Taip;0;12;1;13
7035;Pumpurėlis;VARPELIŲ;7160091629;Taip;0;17;0;17
7036;Pumpurėlis;VARPELIŲ;3101133244;Ne;3;12;0;15
7037;Pumpurėlis;VARPELIŲ;3893768713;Taip;0;6;0;6
7038;Pumpurėlis;VARPELIŲ;5023658988;Ne;0;11;0;11
7039;Pumpurėlis;VARPELIŲ;2668855786;Taip;5;8;0;13
7040;Pumpurėlis;VARPELIŲ;8258560345;Taip;0;0;3;3
7041;Pumpurėlis;VARPELIŲ;9612924972;Taip;0;2;0;2
7042;Pumpurėlis;VARPELIŲ;9884099545;Taip;16;1;0;17
7043;Pumpurėlis;VARPELIŲ;1687770779;Ne;0;22;0;22
7044;Pumpurėlis;VARPELIŲ;4451898302;Taip;5;13;0;18
7045;Pumpurėlis;VARPELIŲ;3733509497;Taip;3;3;0;6
7046;Pumpurėlis;VARPELIŲ;4508966729;Taip;0;12;0;12
7047;Pumpurėlis;VARPELIŲ;9552913910;Taip;5;1;0;6
7048;Pumpurėlis;VARPELIŲ;5196733185;Taip;3;8;0;11
7049;Pumpurėlis;VARPELIŲ;4928495108;Taip;0;2;0;2
7050;Pumpurėlis;VARPELIŲ;8886730333;Taip;4;10;0;14
7051;Pumpurėlis;VARPELIŲ;2247300456;Taip;1;0;0;1
7052;Pumpurėlis;VARPELIŲ;5564680653;Taip;0;0;2;2
7053;Pumpurėlis;VARPELIŲ;6726772655;Taip;12;0;0;12
7054;Pumpurėlis;DRUGELIŲ;25029630023;Taip;0;1;0;1
7055;Pumpurėlis;DRUGELIŲ;1230058211;Taip;0;11;0;11
7056;Pumpurėlis;DRUGELIŲ;1225377038;Taip;10;0;1;11
7057;Pumpurėlis;DRUGELIŲ;1397924008;Ne;1;0;3;4
7058;Pumpurėlis;DRUGELIŲ;6230500803;Ne;0;5;0;5
7059;Pumpurėlis;DRUGELIŲ;2129779614;Ne;0;6;4;10
7060;Pumpurėlis;DRUGELIŲ;2102427499;Ne;2;0;0;2
7061;Pumpurėlis;DRUGELIŲ;9317495169;Taip;0;6;0;6
7062;Pumpurėlis;DRUGELIŲ;6535398274;Taip;0;7;2;9
7063;Pumpurėlis;DRUGELIŲ;9733380187;Taip;0;7;0;7
7064;Pumpurėlis;DRUGELIŲ;83388662869;Ne;0;7;0;7
7065;Pumpurėlis;DRUGELIŲ;1690424790;Ne;0;12;0;12
7066;Pumpurėlis;DRUGELIŲ;4192641015;Ne;2;0;0;2
7067;Pumpurėlis;DRUGELIŲ;7519369167;Taip;0;0;2;2
7068;Pumpurėlis;DRUGELIŲ;1248017244;Ne;5;0;2;7
7069;Pumpurėlis;KODĖLČIUKŲ;9224879966;Taip;12;0;2;14
7070;Pumpurėlis;KODĖLČIUKŲ;1188314397;Taip;0;2;0;2
7071;Pumpurėlis;KODĖLČIUKŲ;8830261792;Taip;0;1;0;1
7072;Pumpurėlis;KODĖLČIUKŲ;9583257172;Taip;0;4;0;4
7073;Pumpurėlis;KODĖLČIUKŲ;7533555059;Taip;0;9;0;9
7074;Pumpurėlis;KODĖLČIUKŲ;6669327226;Taip;0;9;0;9
7075;Pumpurėlis;KODĖLČIUKŲ;87061817106;Taip;0;11;0;11
7076;Pumpurėlis;KODĖLČIUKŲ;1835168438;Ne;1;2;0;3
7077;Pumpurėlis;KODĖLČIUKŲ;5615260965;Taip;0;14;0;14
7078;Pumpurėlis;KODĖLČIUKŲ;4344595328;Taip;0;6;0;6
7079;Pumpurėlis;KODĖLČIUKŲ;3298821054;Ne;1;1;0;2
7080;Pumpurėlis;KODĖLČIUKŲ;8806961007;Taip;10;0;0;10
7081;Pumpurėlis;KODĖLČIUKŲ;5964953923;Taip;2;2;0;4
7082;Pumpurėlis;KODĖLČIUKŲ;1492810528;Taip;0;0;2;2
7083;Pumpurėlis;LINELIS;44982629856;Taip;0;1;0;1
7084;Pumpurėlis;LINELIS;1754102092;Taip;0;4;0;4
7085;Pumpurėlis;LINELIS;5901659879;Taip;0;1;0;1
7086;Pumpurėlis;LINELIS;11052382671;Taip;0;2;0;2
7087;Pumpurėlis;LINELIS;46386981131;Taip;7;1;0;8
7088;Pumpurėlis;LINELIS;77110003421;Taip;1;2;2;5
7089;Pumpurėlis;LINELIS;56351492623;Taip;0;2;2;4
7090;Pumpurėlis;LINELIS;70522541316;Taip;0;1;0;1
7091;Pumpurėlis;LINELIS;465606233;Taip;0;2;0;2
7092;Pumpurėlis;LINELIS;57426850391;Ne;0;12;0;12
7093;Pumpurėlis;LINELIS;28759758744;Taip;0;1;2;3
7094;Pumpurėlis;LINELIS;36645787745;Taip;0;1;0;1
7095;Pumpurėlis;LINELIS;15256433275;Taip;0;9;0;9
7096;Pumpurėlis;LINELIS;47596248180;Taip;0;1;0;1
7097;Pumpurėlis;LINELIS;97145389284;Taip;10;0;0;10
7098;Pumpurėlis;LINELIS;1645287832;Taip;0;2;13;15
7099;Pumpurėlis;LINELIS;6025998706;Taip;3;10;0;13
7100;Pumpurėlis;LINELIS;89695456583;Taip;0;4;0;4
7101;Pumpurėlis;SAULUTĖS;6215273976;Taip;0;7;0;7
7102;Pumpurėlis;SAULUTĖS;1366801299;Ne;5;1;0;6
7103;Pumpurėlis;SAULUTĖS;1524688901;Ne;5;1;0;6
7104;Pumpurėlis;SAULUTĖS;1021043951;Taip;7;2;0;9
7105;Pumpurėlis;SAULUTĖS;1631951556;Taip;2;1;0;3
7106;Pumpurėlis;SAULUTĖS;9041599264;Ne;10;0;0;10
7107;Pumpurėlis;SAULUTĖS;45279361421;Taip;5;4;1;10
7108;Pumpurėlis;SAULUTĖS;1085633311;Taip;0;2;1;3
7109;Pumpurėlis;SAULUTĖS;66672997420;Taip;0;7;0;7
7110;Pumpurėlis;SAULUTĖS;27361939846;Taip;0;6;0;6
7111;Pumpurėlis;SAULUTĖS;2671657094;Taip;0;2;0;2
7112;Pumpurėlis;SAULUTĖS;61297074638;Taip;0;5;0;5
7113;Pumpurėlis;SAULUTĖS;24681852477;Taip;0;1;0;1
7114;Pumpurėlis;SAULUTĖS;33847164571;Taip;0;7;1;8
7115;Pumpurėlis;SAULUTĖS;20093100251;Taip;4;1;0;5
7116;Pumpurėlis;SAULUTĖS;87813594933;Ne;0;2;0;2
7117;Pumpurėlis;SAULUTĖS;15096075268;Taip;0;7;0;7
7118;Pumpurėlis;SAULUTĖS;72455192748;Taip;0;2;0;2
7119;Pumpurėlis;SAULUTĖS;7015779224;Taip;0;7;0;7
7120;Pumpurėlis;SAULUTĖS;16656067942;Taip;0;10;0;10
7121;Pumpurėlis;SAULUTĖS;91612536967;Taip;0;2;0;2
7122;Pumpurėlis;BITUTĖS;2028515310;Ne;4;7;0;11
7123;Pumpurėlis;BITUTĖS;1333429949;Taip;7;0;0;7
7124;Pumpurėlis;BITUTĖS;8747439652;Taip;5;10;0;15
7125;Pumpurėlis;BITUTĖS;92238719397;Taip;0;1;0;1
7126;Pumpurėlis;BITUTĖS;1400057487;Taip;15;0;0;15
7127;Pumpurėlis;BITUTĖS;1274293175;Ne;4;3;3;10
7128;Pumpurėlis;BITUTĖS;93809482039;Ne;0;1;0;1
7129;Pumpurėlis;BITUTĖS;1640573725;Taip;8;0;0;8
7130;Pumpurėlis;BITUTĖS;1473237607;Taip;0;0;8;8
7131;Pumpurėlis;BITUTĖS;71979455611;Ne;0;8;0;8
7132;Pumpurėlis;BITUTĖS;26859673794;Taip;4;8;0;12
7133;Pumpurėlis;BITUTĖS;72719147901;Taip;0;0;5;5
7134;Pumpurėlis;BITUTĖS;1527144198;Ne;2;7;0;9
7135;Pumpurėlis;BITUTĖS;57949968899;Taip;0;0;1;1
7136;Pumpurėlis;BITUTĖS;1255753542;Ne;9;0;0;9
7137;Pumpurėlis;DOBILIUKAI;1273831078;Taip;0;4;0;4
7138;Pumpurėlis;DOBILIUKAI;1264017142;Ne;7;0;2;9
7139;Pumpurėlis;DOBILIUKAI;1439043505;Taip;0;6;0;6
7140;Pumpurėlis;DOBILIUKAI;1287902351;Taip;0;8;0;8
7141;Pumpurėlis;DOBILIUKAI;1867989314;Taip;0;1;0;1
7142;Pumpurėlis;DOBILIUKAI;40267078306;Taip;5;0;3;8
7143;Pumpurėlis;DOBILIUKAI;51793437519;Taip;0;5;0;5
7144;Pumpurėlis;DOBILIUKAI;1921332565;Taip;2;0;1;3
7145;Pumpurėlis;DOBILIUKAI;1055683170;Taip;0;2;0;2
7146;Pumpurėlis;DOBILIUKAI;1620037477;Taip;0;9;0;9
7147;Pumpurėlis;DOBILIUKAI;1511761574;Ne;0;4;0;4
7148;Pumpurėlis;DOBILIUKAI;1346602122;Taip;11;1;0;12
7149;Pumpurėlis;DOBILIUKAI;88732170322;Taip;0;2;0;2
7150;Pumpurėlis;DOBILIUKAI;94636926281;Ne;5;0;0;5
7151;Pumpurėlis;DOBILIUKAI;1027125361;Taip;0;2;0;2
7152;Pumpurėlis;PUPYČIŲ;2028068230;Taip;5;0;1;6
7153;Pumpurėlis;PUPYČIŲ;5587118874;Taip;5;0;1;6
7154;Pumpurėlis;PUPYČIŲ;7825190756;Taip;8;0;3;11
7155;Pumpurėlis;PUPYČIŲ;9058493247;Taip;0;0;1;1
7156;Pumpurėlis;PUPYČIŲ;3374174445;Taip;0;6;0;6
7157;Pumpurėlis;PUPYČIŲ;6307988067;Taip;7;0;1;8
7158;Pumpurėlis;PUPYČIŲ;1961282282;Taip;4;0;0;4
7159;Pumpurėlis;PUPYČIŲ;9509051946;Taip;5;2;1;8
7160;Pumpurėlis;PUPYČIŲ;5444879430;Taip;10;3;0;13
7161;Pumpurėlis;PUPYČIŲ;7276322999;Taip;11;0;0;11
7162;Pumpurėlis;PUPYČIŲ;1438740562;Taip;11;0;0;11
7163;Pumpurėlis;PUPYČIŲ;5438584331;Taip;0;1;0;1
7164;Pumpurėlis;ŽIRNIUKŲ;1768239820;Taip;4;0;0;4
7165;Pumpurėlis;ŽIRNIUKŲ;7363814444;Taip;0;6;0;6
7166;Pumpurėlis;ŽIRNIUKŲ;1130280140;Taip;5;0;3;8
7167;Pumpurėlis;ŽIRNIUKŲ;9612924316;Taip;0;2;0;2
7168;Pumpurėlis;ŽIRNIUKŲ;2687583764;Taip;0;0;4;4
7169;Pumpurėlis;ŽIRNIUKŲ;8655389224;Taip;12;0;1;13
7170;Pumpurėlis;ŽIRNIUKŲ;4985045047;Taip;11;0;0;11
7171;Pumpurėlis;ŽIRNIUKŲ;3405169131;Taip;5;0;2;7
7172;Pumpurėlis;ŽIRNIUKŲ;2566557351;Taip;4;0;2;6
7173;Pumpurėlis;ŽIRNIUKŲ;5559833356;Taip;4;1;0;5
7174;Pumpurėlis;BORUŽĖLIŲ;42611228425;Ne;0;1;0;1
7175;Pumpurėlis;BORUŽĖLIŲ;68035717481;Taip;0;0;2;2
7176;Pumpurėlis;BORUŽĖLIŲ;1594436797;Taip;0;0;1;1
7177;Pumpurėlis;BORUŽĖLIŲ;1568701327;Ne;0;0;4;4
7178;Pumpurėlis;BORUŽĖLIŲ;1842097360;Ne;0;0;4;4
7179;Pumpurėlis;BORUŽĖLIŲ;82659096039;Taip;1;14;0;15
7180;Pumpurėlis;BORUŽĖLIŲ;1098875585;Ne;0;2;0;2
7181;Pumpurėlis;BORUŽĖLIŲ;1034745510;Taip;0;0;1;1
7182;Pumpurėlis;BORUŽĖLIŲ;5364345261;Taip;0;3;0;3
7183;Pumpurėlis;BORUŽĖLIŲ;1617303626;Taip;0;0;2;2
7184;Pumpurėlis;BORUŽĖLIŲ;1306102772;Taip;11;0;0;11
7185;Pumpurėlis;BORUŽĖLIŲ;1436627913;Taip;0;4;0;4
7186;Pumpurėlis;BORUŽĖLIŲ;1075914140;Ne;0;0;2;2
7187;Pumpurėlis;BORUŽĖLIŲ;2345116167;Taip;0;2;0;2
7188;Pumpurėlis;BORUŽĖLIŲ;63610860077;Taip;0;7;0;7
7189;Pumpurėlis;BORUŽĖLIŲ;1257222112;Ne;5;0;2;7
7190;Pumpurėlis;BORUŽĖLIŲ;1508245418;Ne;8;0;1;9
7191;Pumpurėlis;BORUŽĖLIŲ;81595634697;Taip;7;3;0;10
7192;Pumpurėlis;BORUŽĖLIŲ;1061975374;Taip;0;1;0;1
7193;Puriena;Ančiukų;5026857195;Taip;0;2;6;8
7194;Puriena;Ančiukų;88588968229;Taip;0;2;6;8
7195;Puriena;Ančiukų;1758690169;Taip;8;1;0;9
7196;Puriena;Ančiukų;25112307864;Taip;0;4;0;4
7197;Puriena;Ančiukų;1240190350;Taip;4;1;0;5
7198;Puriena;Ančiukų;19157486407;Taip;0;2;0;2
7199;Puriena;Ančiukų;1557814435;Taip;10;2;0;12
7200;Puriena;Ančiukų;87523460146;Taip;0;6;0;6
7201;Puriena;Ančiukų;61241768982;Taip;0;6;0;6
7202;Puriena;Ančiukų;26980342372;Taip;0;4;0;4
7203;Puriena;Ančiukų;4260334053;Taip;0;7;0;7
7204;Puriena;Ančiukų;71778035373;Taip;0;17;0;17
7205;Puriena;Ančiukų;1184946421;Taip;6;2;0;8
7206;Puriena;Ančiukų;59193676476;Taip;7;4;0;11
7207;Puriena;Ančiukų;61117212576;Taip;0;0;3;3
7208;Puriena;Ančiukų;91069175088;Taip;8;0;1;9
7209;Puriena;Ančiukų;16572830524;Taip;2;2;2;6
7210;Puriena;Ančiukų;18592085188;Taip;7;2;0;9
7211;Puriena;Ančiukų;1418776789;Ne;5;2;0;7
7212;Puriena;Ančiukų;3327714361;Taip;5;0;3;8
7213;Puriena;Ančiukų;41863686552;Taip;7;0;2;9
7214;Puriena;Drugeliai;83821680276;Taip;12;0;0;12
7215;Puriena;Drugeliai;7337038503;Taip;4;1;0;5
7216;Puriena;Drugeliai;47316276655;Taip;0;14;1;15
7217;Puriena;Drugeliai;48468411549;Taip;5;0;1;6
7218;Puriena;Drugeliai;20286870431;Ne;0;5;0;5
7219;Puriena;Drugeliai;63196502622;Taip;14;0;1;15
7220;Puriena;Drugeliai;11497629767;Taip;5;2;0;7
7221;Puriena;Drugeliai;2146036332;Taip;12;0;3;15
7222;Puriena;Drugeliai;1142929858;Taip;0;0;3;3
7223;Puriena;Drugeliai;1703078658;Taip;12;2;0;14
7224;Puriena;Drugeliai;2083071198;Taip;8;8;0;16
7225;Puriena;Drugeliai;8213725698;Taip;22;0;0;22
7226;Puriena;Drugeliai;2378865002;Taip;6;5;0;11
7227;Puriena;Drugeliai;5891404983;Ne;0;2;2;4
7228;Puriena;Drugeliai;9239618299;Taip;0;0;12;12
7229;Puriena;Drugeliai;2089174669;Taip;0;2;0;2
7230;Puriena;Drugeliai;2131343339;Taip;0;2;1;3
7231;Puriena;Drugeliai;1748337587;Taip;5;2;0;7
7232;Puriena;Drugeliai;8618298134;Taip;12;0;0;12
7233;Puriena;Drugeliai;1820719083;Taip;10;0;2;12
7234;Puriena;Pelėdžiukai;11431481909;Taip;13;0;0;13
7235;Puriena;Pelėdžiukai;53451774513;Taip;11;0;0;11
7236;Puriena;Pelėdžiukai;12499791115;Taip;4;3;0;7
7237;Puriena;Pelėdžiukai;54048579160;Taip;0;2;0;2
7238;Puriena;Pelėdžiukai;43490363874;Taip;3;1;0;4
7239;Puriena;Pelėdžiukai;34689084311;Taip;0;1;0;1
7240;Puriena;Pelėdžiukai;21611180390;Taip;0;2;0;2
7241;Puriena;Pelėdžiukai;15016729899;Taip;0;2;0;2
7242;Puriena;Pelėdžiukai;11677252767;Taip;0;1;0;1
7243;Puriena;Pelėdžiukai;16437608299;Taip;0;10;0;10
7244;Puriena;Pelėdžiukai;69494886505;Taip;0;1;0;1
7245;Puriena;Pelėdžiukai;95972862152;Taip;0;4;0;4
7246;Puriena;Pelėdžiukai;81806945761;Taip;0;10;0;10
7247;Puriena;Pelėdžiukai;90508354565;Ne;7;0;0;7
7248;Puriena;Pelėdžiukai;95822432988;Taip;4;1;0;5
7249;Puriena;Pelėdžiukai;45627148409;Taip;0;2;0;2
7250;Puriena;Pelėdžiukai;2011809589;Taip;0;1;0;1
7251;Puriena;Voveriukai;6285846517;Taip;0;1;0;1
7252;Puriena;Voveriukai;5501308683;Ne;7;2;0;9
7253;Puriena;Voveriukai;1263637124;Taip;5;4;0;9
7254;Puriena;Voveriukai;1290933817;Taip;2;11;0;13
7255;Puriena;Voveriukai;7429832136;Taip;10;0;0;10
7256;Puriena;Voveriukai;2663832596;Taip;5;2;0;7
7257;Puriena;Voveriukai;2203259310;Taip;0;5;0;5
7258;Puriena;Voveriukai;40573980976;Taip;0;7;0;7
7259;Puriena;Voveriukai;1381379515;Taip;0;2;0;2
7260;Puriena;Voveriukai;6057477307;Taip;13;4;0;17
7261;Puriena;Voveriukai;1290962809;Taip;9;3;0;12
7262;Puriena;Voveriukai;11242620566;Ne;0;2;1;3
7263;Puriena;Voveriukai;9139110598;Ne;0;3;0;3
7264;Puriena;Voveriukai;8112003551;Taip;0;0;1;1
7265;Puriena;Voveriukai;9106525954;Taip;0;2;1;3
7266;Puriena;Voveriukai;5999564879;Ne;5;6;0;11
7267;Puriena;Voveriukai;6053657231;Taip;0;1;0;1
7268;Puriena;Voveriukai;9146447088;Taip;3;0;1;4
7269;Puriena;Voveriukai;8478901457;Taip;1;0;0;1
7270;Puriena;Voveriukai;5257713434;Taip;0;3;0;3
7271;Puriena;Voveriukai;4647433927;Taip;0;3;0;3
7272;Puriena;Bitučių;71773966341;Taip;0;2;6;8
7273;Puriena;Bitučių;1945542034;Taip;0;8;0;8
7274;Puriena;Bitučių;79194353091;Taip;4;1;0;5
7275;Puriena;Bitučių;1629458651;Taip;4;2;1;7
7276;Puriena;Bitučių;91735621242;Taip;0;2;0;2
7277;Puriena;Bitučių;1116529845;Taip;0;0;4;4
7278;Puriena;Bitučių;98967026878;Taip;5;0;1;6
7279;Puriena;Bitučių;5284316470;Taip;0;1;0;1
7280;Puriena;Bitučių;84527348236;Ne;12;1;0;13
7281;Puriena;Bitučių;8719239663;Taip;0;1;0;1
7282;Puriena;Bitučių;95153406240;Taip;0;2;0;2
7283;Puriena;Bitučių;1125102675;Ne;7;3;0;10
7284;Puriena;Bitučių;29217326976;Taip;0;13;5;18
7285;Puriena;Bitučių;1507059980;Taip;10;2;0;12
7286;Puriena;Bitučių;85334594528;Taip;0;2;2;4
7287;Puriena;Zylutės;1892751625;Taip;0;2;1;3
7288;Puriena;Zylutės;37213422962;Ne;2;1;0;3
7289;Puriena;Zylutės;29931607789;Ne;2;1;0;3
7290;Puriena;Zylutės;14052847763;Taip;10;0;0;10
7291;Puriena;Zylutės;46510003255;Taip;11;1;0;12
7292;Puriena;Zylutės;64733952400;Ne;10;1;0;11
7293;Puriena;Zylutės;1993142891;Ne;9;0;0;9
7294;Puriena;Zylutės;6539425730;Taip;0;3;0;3
7295;Puriena;Zylutės;88483773966;Taip;5;2;0;7
7296;Puriena;Zylutės;61706928693;Taip;2;1;0;3
7297;Puriena;Zylutės;45128021817;Ne;12;0;0;12
7298;Puriena;Zylutės;7285127722;Ne;6;6;0;12
7299;Puriena;Zylutės;50199557129;Taip;5;0;0;5
7300;Puriena;Zylutės;88595039240;Ne;3;5;0;8
7301;Puriena;Zylutės;14780389529;Taip;0;3;0;3
7302;Puriena;Zylutės;54604607448;Taip;0;3;0;3
7303;Puriena;Zylutės;1994224209;Taip;0;1;0;1
7304;Puriena;Zylutės;27546501673;Taip;0;7;0;7
7305;Puriena;Meškučių;9251058353;Ne;12;0;2;14
7306;Puriena;Meškučių;1030958414;Taip;6;0;1;7
7307;Puriena;Meškučių;7967288875;Taip;4;0;5;9
7308;Puriena;Meškučių;6158842119;Taip;15;2;2;19
7309;Puriena;Meškučių;3557013127;Taip;0;1;0;1
7310;Puriena;Meškučių;3681811493;Taip;5;1;0;6
7311;Puriena;Meškučių;4060087185;Taip;3;0;0;3
7312;Puriena;Meškučių;3033562627;Taip;13;0;0;13
7313;Puriena;Meškučių;5777076971;Taip;6;2;0;8
7314;Puriena;Meškučių;8310231540;Taip;12;0;0;12
7315;Puriena;Meškučių;4460575818;Taip;8;0;1;9
7316;Puriena;Meškučių;8120597514;Taip;7;6;0;13
7317;Puriena;Meškučių;5336923102;Taip;5;0;1;6
7318;Puriena;Meškučių;4605662701;Taip;7;5;0;12
7319;Puriena;Meškučių;1819876614;Taip;8;0;0;8
7320;Puriena;Meškučių;4776745276;Taip;5;0;4;9
7321;Puriena;Meškučių;7769252165;Taip;4;1;0;5
7322;Puriena;Meškučių;2170025682;Taip;0;0;2;2
7323;Puriena;Meškučių;3772941726;Taip;5;1;0;6
7324;Puriena;Meškučių;1428098802;Taip;5;1;0;6
7325;Puriena;Nykštukų;1295692895;Taip;0;0;2;2
7326;Puriena;Nykštukų;8416003733;Taip;0;2;2;4
7327;Puriena;Nykštukų;5224135638;Taip;10;0;4;14
7328;Puriena;Nykštukų;9209209113;Taip;9;0;1;10
7329;Puriena;Nykštukų;4017644414;Ne;0;2;0;2
7330;Puriena;Nykštukų;6780164845;Taip;20;0;0;20
7331;Puriena;Nykštukų;1398572100;Taip;3;0;1;4
7332;Puriena;Nykštukų;9962011647;Taip;0;0;1;1
7333;Puriena;Nykštukų;1339162214;Taip;5;1;0;6
7334;Puriena;Nykštukų;7573536525;Taip;5;2;0;7
7335;Puriena;Nykštukų;5395382717;Taip;10;4;0;14
7336;Puriena;Nykštukų;4444523140;Taip;5;2;11;18
7337;Puriena;Nykštukų;7622407056;Taip;0;5;0;5
7338;Puriena;Nykštukų;6813480086;Taip;7;1;0;8
7339;Puriena;Nykštukų;9854244405;Taip;4;2;0;6
7340;Puriena;Nykštukų;4498919764;Taip;2;2;1;5
7341;Puriena;Ežiukai;1900570261;Taip;0;1;0;1
7342;Puriena;Ežiukai;1704296685;Taip;0;6;0;6
7343;Puriena;Ežiukai;1174355613;Taip;0;2;0;2
7344;Puriena;Ežiukai;2255508780;Taip;4;2;1;7
7345;Puriena;Ežiukai;35226601932;Taip;0;2;0;2
7346;Puriena;Ežiukai;2072874096;Taip;2;11;0;13
7347;Puriena;Ežiukai;11011727269;Taip;11;0;0;11
7348;Puriena;Ežiukai;87416314075;Taip;10;0;1;11
7349;Puriena;Ežiukai;1134539790;Taip;0;2;0;2
7350;Puriena;Ežiukai;9471669903;Taip;5;1;0;6
7351;Puriena;Ežiukai;1707413291;Taip;8;3;5;16
7352;Puriena;Ežiukai;1773431155;Taip;12;2;1;15
7353;Puriena;Ežiukai;1379084331;Taip;0;5;1;6
7354;Puriena;Ežiukai;1710087159;Taip;0;1;0;1
7355;Puriena;Ežiukai;21180207545;Taip;0;0;2;2
7356;Puriena;Ežiukai;1762395617;Taip;0;2;0;2
7357;Puriena;Ežiukai;2560477213;Taip;0;10;0;10
7358;Puriena;Ežiukai;1786569222;Taip;0;2;6;8
7359;Puriena;"Boružiukų ";5619637663;Taip;2;0;0;2
7360;Puriena;"Boružiukų ";4858971990;Taip;10;2;2;14
7361;Puriena;"Boružiukų ";2701942325;Taip;10;2;0;12
7362;Puriena;"Boružiukų ";4608801156;Taip;0;3;0;3
7363;Puriena;"Boružiukų ";6463129806;Taip;0;2;3;5
7364;Puriena;"Boružiukų ";4501239330;Taip;0;0;5;5
7365;Puriena;"Boružiukų ";6197840105;Taip;11;0;0;11
7366;Puriena;"Boružiukų ";3175917649;Taip;0;0;3;3
7367;Puriena;"Boružiukų ";6786694796;Taip;13;0;0;13
7368;Puriena;"Boružiukų ";1417566073;Taip;13;0;0;13
7369;Puriena;"Boružiukų ";3671297035;Taip;10;0;3;13
7370;Puriena;"Boružiukų ";6352605894;Ne;5;0;2;7
7371;Puriena;"Boružiukų ";2579402981;Taip;11;0;0;11
7372;Puriena;"Boružiukų ";2267225709;Taip;0;0;2;2
7373;Puriena;"Boružiukų ";6413337915;Taip;6;0;4;10
7374;Puriena;"Boružiukų ";5341228269;Taip;10;0;0;10
7375;Puriena;"Zuikučių ";6883573289;Taip;6;0;12;18
7376;Puriena;"Zuikučių ";7120683581;Taip;5;0;0;5
7377;Puriena;"Zuikučių ";8144488922;Taip;9;0;0;9
7378;Puriena;"Zuikučių ";4283608124;Taip;6;0;0;6
7379;Puriena;"Zuikučių ";8130975863;Taip;0;2;0;2
7380;Puriena;"Zuikučių ";2813562677;Taip;3;0;1;4
7381;Puriena;"Zuikučių ";3542374463;Taip;4;2;1;7
7382;Puriena;"Zuikučių ";1933733714;Taip;9;5;0;14
7383;Puriena;"Zuikučių ";6150437624;Taip;6;5;0;11
7384;Puriena;"Zuikučių ";3627403517;Taip;5;0;0;5
7385;Puriena;"Zuikučių ";4653085762;Taip;0;3;0;3
7386;Puriena;"Zuikučių ";8952508230;Taip;5;0;0;5
7387;Puriena;"Zuikučių ";7169054113;Taip;0;16;0;16
7388;Puriena;"Zuikučių ";8476986855;Taip;7;0;0;7
7389;Pušaitė;Kodėlčiukai;62054870153;Taip;8;1;0;9
7390;Pušaitė;Kodėlčiukai;92087943993;Ne;0;1;2;3
7391;Pušaitė;Kodėlčiukai;79462284429;Taip;0;1;0;1
7392;Pušaitė;Kodėlčiukai;51875651426;Taip;2;1;1;4
7393;Pušaitė;Kodėlčiukai;35587797387;Taip;0;5;5;10
7394;Pušaitė;Kodėlčiukai;12300222260;Ne;0;1;2;3
7395;Pušaitė;Kodėlčiukai;10955132610;Taip;0;0;6;6
7396;Pušaitė;Kodėlčiukai;7680945149;Taip;0;1;0;1
7397;Pušaitė;Kodėlčiukai;89687717250;Taip;0;1;2;3
7398;Pušaitė;Kodėlčiukai;36677285052;Taip;0;1;0;1
7399;Pušaitė;Kodėlčiukai;3554790718;Taip;0;12;1;13
7400;Pušaitė;Kodėlčiukai;1912176781;Taip;0;3;0;3
7401;Pušaitė;Kodėlčiukai;20960105409;Taip;0;5;0;5
7402;Pušaitė;Saulutės;1918948738;Taip;0;6;0;6
7403;Pušaitė;Saulutės;36646217833;Taip;0;1;1;2
7404;Pušaitė;Saulutės;40449072854;Taip;1;2;1;4
7405;Pušaitė;Saulutės;46097491628;Taip;0;4;0;4
7406;Pušaitė;Saulutės;2066639203;Taip;0;1;0;1
7407;Pušaitė;Saulutės;99740435577;Ne;0;1;0;1
7408;Pušaitė;Saulutės;34324686486;Taip;0;2;1;3
7409;Pušaitė;Saulutės;88286687854;Taip;0;7;0;7
7410;Pušaitė;Saulutės;1302087452;Taip;0;1;0;1
7411;Pušaitė;Saulutės;61624123734;Taip;5;1;0;6
7412;Pušaitė;Saulutės;10115195053;Taip;0;0;3;3
7413;Pušaitė;Saulutės;81155033460;Taip;4;3;0;7
7414;Pušaitė;Saulutės;1389123203;Taip;11;0;1;12
7415;Pušaitė;Saulutės;2030939996;Ne;0;1;0;1
7416;Pušaitė;Saulutės;1444313482;Taip;0;4;0;4
7417;Pušaitė;Zuikučiai;2115591523;Taip;0;0;3;3
7418;Pušaitė;Zuikučiai;8738827821;Taip;0;0;2;2
7419;Pušaitė;Zuikučiai;2181510181;Taip;0;7;1;8
7420;Pušaitė;Zuikučiai;7477429922;Taip;0;3;0;3
7421;Pušaitė;Zuikučiai;6306133416;Taip;2;0;0;2
7422;Pušaitė;Zuikučiai;2099169654;Taip;0;0;1;1
7423;Pušaitė;Zuikučiai;9389544351;Taip;0;22;0;22
7424;Pušaitė;Zuikučiai;1296700534;Taip;0;0;2;2
7425;Pušaitė;Zuikučiai;51500717235;Taip;0;22;0;22
7426;Pušaitė;Zuikučiai;2125574493;Ne;1;0;3;4
7427;Pušaitė;Zuikučiai;5398532705;Taip;0;7;4;11
7428;Pušaitė;Zuikučiai;8309000712;Taip;14;2;0;16
7429;Pušaitė;Zuikučiai;4881689337;Taip;0;0;1;1
7430;Pušaitė;Zuikučiai;3718196299;Taip;0;0;17;17
7431;Pušaitė;Zuikučiai;1295203136;Taip;5;3;0;8
7432;Pušaitė;Zuikučiai;3813761666;Ne;0;0;16;16
7433;Pušaitė;Zuikučiai;4762094720;Taip;0;2;1;3
7434;Pušaitė;Zuikučiai;6600314608;Taip;5;0;3;8
7435;Pušaitė;Zuikučiai;2130767942;Taip;0;21;0;21
7436;Pušaitė;Vėžliukai;1386420328;Taip;0;0;6;6
7437;Pušaitė;Vėžliukai;1863885754;Taip;6;3;1;10
7438;Pušaitė;Vėžliukai;4050198577;Taip;10;0;3;13
7439;Pušaitė;Vėžliukai;1412632976;Taip;0;0;3;3
7440;Pušaitė;Vėžliukai;8361761447;Taip;10;0;1;11
7441;Pušaitė;Vėžliukai;4490041906;Taip;0;0;5;5
7442;Pušaitė;Vėžliukai;97738851561;Taip;9;0;2;11
7443;Pušaitė;Vėžliukai;1502634518;Taip;10;0;0;10
7444;Pušaitė;Vėžliukai;57025420993;Taip;10;0;4;14
7445;Pušaitė;Vėžliukai;73291156409;Taip;0;0;2;2
7446;Pušaitė;Vėžliukai;5262505407;Ne;0;0;1;1
7447;Pušaitė;Vėžliukai;1569413876;Taip;22;0;0;22
7448;Pušaitė;Vėžliukai;2892138891;Taip;0;0;11;11
7449;Pušaitė;Vėžliukai;3745881982;Taip;0;0;3;3
7450;Pušaitė;Vėžliukai;71218084687;Taip;0;0;2;2
7451;Pušaitė;Vėžliukai;6752676513;Taip;0;0;2;2
7452;Pušaitė;Vėžliukai;1972872969;Taip;0;22;0;22
7453;Pušaitė;Vėžliukai;2856902024;Taip;0;22;0;22
7454;Pušaitė;"Linksmieji nykštukai";9265357004;Taip;0;13;0;13
7455;Pušaitė;"Linksmieji nykštukai";3150144924;Taip;6;0;0;6
7456;Pušaitė;"Linksmieji nykštukai";7520393710;Taip;6;0;1;7
7457;Pušaitė;"Linksmieji nykštukai";4517181474;Ne;5;1;0;6
7458;Pušaitė;"Linksmieji nykštukai";9033615485;Taip;0;0;2;2
7459;Pušaitė;"Linksmieji nykštukai";3130824742;Taip;2;0;0;2
7460;Pušaitė;"Linksmieji nykštukai";4605161267;Taip;7;3;1;11
7461;Pušaitė;"Linksmieji nykštukai";6160825713;Taip;0;1;0;1
7462;Pušaitė;"Linksmieji nykštukai";1781601521;Taip;2;0;1;3
7463;Pušaitė;"Linksmieji nykštukai";1024996364;Taip;2;0;0;2
7464;Pušaitė;"Linksmieji nykštukai";4662871524;Taip;3;0;0;3
7465;Pušaitė;"Linksmieji nykštukai";8438652029;Taip;0;0;3;3
7466;Pušaitė;"Linksmieji nykštukai";6578483902;Taip;0;0;7;7
7467;Pušaitė;"Linksmieji nykštukai";3350461304;Ne;0;4;5;9
7468;Pušaitė;"Linksmieji nykštukai";4175909754;Taip;0;14;1;15
7469;Pušaitė;"Linksmieji nykštukai";3788392895;Taip;10;0;0;10
7470;Pušaitė;"Linksmieji nykštukai";3195191374;Taip;0;1;1;2
7471;Pušaitė;"Linksmieji nykštukai";9127444013;Taip;5;9;0;14
7472;Pušaitė;"Linksmieji nykštukai";5422784898;Taip;7;0;2;9
7473;Pušaitė;"Linksmieji nykštukai";5104111840;Taip;5;0;0;5
7474;Pušaitė;"Linksmieji nykštukai";9866431097;Taip;8;0;0;8
7475;Pušaitė;"Kačiukų trobelė";3695016765;Taip;16;0;0;16
7476;Pušaitė;"Kačiukų trobelė";5415680731;Taip;0;22;0;22
7477;Pušaitė;"Kačiukų trobelė";7983115812;Taip;0;1;0;1
7478;Pušaitė;"Kačiukų trobelė";7614475216;Taip;0;0;1;1
7479;Pušaitė;"Kačiukų trobelė";1122112207;Taip;0;2;1;3
7480;Pušaitė;"Kačiukų trobelė";1635528919;Taip;0;0;3;3
7481;Pušaitė;"Kačiukų trobelė";2837439334;Taip;5;0;0;5
7482;Pušaitė;"Kačiukų trobelė";7014914682;Ne;4;0;0;4
7483;Pušaitė;"Kačiukų trobelė";1624587173;Taip;0;2;10;12
7484;Pušaitė;"Kačiukų trobelė";8793102437;Ne;3;17;0;20
7485;Pušaitė;"Kačiukų trobelė";9056933586;Taip;12;2;0;14
7486;Pušaitė;"Kačiukų trobelė";7898355721;Taip;5;0;6;11
7487;Pušaitė;"Kačiukų trobelė";4374232593;Taip;0;1;2;3
7488;Pušaitė;"Kačiukų trobelė";6323180798;Taip;3;0;0;3
7489;Pušaitė;"Kačiukų trobelė";5191894075;Taip;7;0;5;12
7490;Pušaitė;"Kačiukų trobelė";1161519408;Taip;0;22;0;22
7491;Pušaitė;"Kačiukų trobelė";8822285103;Taip;5;0;0;5
7492;Pušaitė;"Kačiukų trobelė";9313564235;Taip;5;5;0;10
7493;Pušaitė;"Kačiukų trobelė";5564338170;Taip;10;0;0;10
7494;Pušaitė;"Kačiukų trobelė";9291306449;Taip;6;0;3;9
7495;Pušaitė;Ežiukai;2090143259;Taip;0;0;1;1
7496;Pušaitė;Ežiukai;2951618391;Taip;0;1;0;1
7497;Pušaitė;Ežiukai;7305350540;Ne;0;22;0;22
7498;Pušaitė;Ežiukai;1111143593;Taip;5;2;0;7
7499;Pušaitė;Ežiukai;5394378197;Taip;0;5;0;5
7500;Pušaitė;Ežiukai;15270671089;Taip;0;2;0;2
7501;Pušaitė;Ežiukai;69869396094;Taip;0;2;1;3
7502;Pušaitė;Ežiukai;3359574190;Taip;0;1;0;1
7503;Pušaitė;Ežiukai;1143122778;Taip;0;1;5;6
7504;Pušaitė;Ežiukai;9461292576;Taip;10;2;1;13
7505;Pušaitė;Ežiukai;5185787803;Taip;8;0;0;8
7506;Pušaitė;Ežiukai;4671293211;Taip;0;8;0;8
7507;Pušaitė;Ežiukai;8958364766;Taip;5;0;0;5
7508;Pušaitė;Ežiukai;2983890410;Taip;0;1;0;1
7509;Pušaitė;Ežiukai;7575143890;Taip;0;1;0;1
7510;Pušaitė;Ežiukai;7808186865;Taip;0;2;4;6
7511;Pušaitė;Ežiukai;4842783897;Taip;0;1;4;5
7512;Pušaitė;Ežiukai;8021494509;Taip;0;22;0;22
7513;Pušaitė;Ežiukai;2172342063;Taip;0;5;0;5
7514;Pušaitė;"Gudručių šalis";6470721291;Taip;4;0;0;4
7515;Pušaitė;"Gudručių šalis";24768657107;Taip;0;3;0;3
7516;Pušaitė;"Gudručių šalis";55304000825;Taip;0;0;1;1
7517;Pušaitė;"Gudručių šalis";15550007793;Taip;0;1;5;6
7518;Pušaitė;"Gudručių šalis";4386242143;Taip;0;2;6;8
7519;Pušaitė;"Gudručių šalis";9997642887;Taip;0;6;0;6
7520;Pušaitė;"Gudručių šalis";15546035138;Taip;0;0;1;1
7521;Pušaitė;"Gudručių šalis";1275885492;Taip;0;2;6;8
7522;Pušaitė;"Gudručių šalis";40886746431;Taip;0;6;0;6
7523;Pušaitė;"Gudručių šalis";66025911973;Taip;6;2;1;9
7524;Pušaitė;"Gudručių šalis";90178990466;Taip;0;0;4;4
7525;Pušaitė;"Gudručių šalis";89985930634;Taip;12;1;0;13
7526;Pušaitė;"Gudručių šalis";4266368627;Ne;0;2;8;10
7527;Pušaitė;"Gudručių šalis";49973513385;Taip;0;2;0;2
7528;Pušaitė;"Gudručių šalis";66238819356;Taip;0;0;1;1
7529;Pušaitė;"Gudručių šalis";89212112638;Taip;0;2;8;10
7530;Pušaitė;"Gudručių šalis";11297426946;Taip;15;0;1;16
7531;Pušaitė;"Gudručių šalis";35947321028;Taip;0;22;0;22
7532;Pušaitė;"Gudručių šalis";1459628106;Taip;0;1;0;1
7533;Pušaitė;"Gudručių šalis";87504481892;Ne;5;2;1;8
7534;Pušaitė;"Gudručių šalis";6915619931;Ne;10;0;1;11
7535;Pušaitė;"Gudručių šalis";41026183089;Taip;0;2;3;5
7536;Pušaitė;"Lapučių mokyklėlė";1102988768;Taip;0;1;2;3
7537;Pušaitė;"Lapučių mokyklėlė";53211427399;Taip;0;1;0;1
7538;Pušaitė;"Lapučių mokyklėlė";40417586835;Taip;0;3;2;5
7539;Pušaitė;"Lapučių mokyklėlė";91960884985;Taip;0;0;2;2
7540;Pušaitė;"Lapučių mokyklėlė";60394388920;Taip;1;0;4;5
7541;Pušaitė;"Lapučių mokyklėlė";2044213583;Taip;0;22;0;22
7542;Pušaitė;"Lapučių mokyklėlė";97778827111;Ne;0;2;1;3
7543;Pušaitė;"Lapučių mokyklėlė";77082825248;Taip;6;0;0;6
7544;Pušaitė;"Lapučių mokyklėlė";53766202712;Taip;5;9;0;14
7545;Pušaitė;"Lapučių mokyklėlė";3231637165;Taip;2;2;8;12
7546;Pušaitė;"Lapučių mokyklėlė";6542917863;Taip;0;3;7;10
7547;Pušaitė;"Lapučių mokyklėlė";9179757395;Taip;4;0;1;5
7548;Pušaitė;"Lapučių mokyklėlė";8470059012;Ne;0;0;1;1
7549;Pušaitė;"Lapučių mokyklėlė";1798044901;Ne;0;8;1;9
7550;Pušaitė;"Lapučių mokyklėlė";7251064118;Taip;0;3;0;3
7551;Pušaitė;"Lapučių mokyklėlė";1878172874;Ne;0;0;2;2
7552;Pušaitė;"VOVERIUKAI ";1978339054;Taip;2;0;0;2
7553;Pušaitė;"VOVERIUKAI ";5569407817;Taip;3;0;0;3
7554;Pušaitė;"VOVERIUKAI ";8775608339;Taip;0;0;3;3
7555;Pušaitė;"VOVERIUKAI ";5161142520;Taip;0;0;3;3
7556;Pušaitė;"VOVERIUKAI ";3014867515;Taip;0;0;2;2
7557;Pušaitė;"VOVERIUKAI ";9527253696;Taip;0;0;2;2
7558;Pušaitė;"VOVERIUKAI ";3485234259;Taip;0;0;5;5
7559;Pušaitė;"VOVERIUKAI ";6739253961;Taip;0;0;1;1
7560;Pušaitė;MEŠKUČIAI;3014180020;Taip;5;5;1;11
7561;Pušaitė;MEŠKUČIAI;2253477550;Taip;0;8;0;8
7562;Pušaitė;MEŠKUČIAI;4198571222;Taip;5;0;0;5
7563;Pušaitė;MEŠKUČIAI;7117784038;Taip;8;0;0;8
7564;Pušaitė;MEŠKUČIAI;9470667227;Taip;10;0;0;10
7565;Pušaitė;MEŠKUČIAI;8412276797;Taip;0;0;2;2
7566;Pušaitė;MEŠKUČIAI;3832434608;Taip;6;0;0;6
7567;Pušaitė;MEŠKUČIAI;9391350218;Taip;6;0;0;6
7568;Pušaitė;PELIUKAI;3698808100;Ne;15;0;0;15
7569;Pušaitė;PELIUKAI;6445790780;Taip;0;0;7;7
7570;Pušaitė;PELIUKAI;2004615252;Taip;6;0;0;6
7571;Pušaitė;PELIUKAI;5296435012;Taip;0;0;2;2
7572;Pušaitė;PELIUKAI;8399589954;Taip;5;0;0;5
7573;Pušaitė;PELIUKAI;4615270419;Taip;5;1;0;6
7574;Pušaitė;PELIUKAI;7652706756;Taip;7;0;0;7
7575;Pušaitė;PELIUKAI;4743105731;Taip;4;0;0;4
7576;Pušaitė;PELIUKAI;7945713337;Taip;5;1;0;6
7577;Pušaitė;PELIUKAI;1935059739;Taip;4;0;0;4
7578;Pušaitė;PELIUKAI;9364887123;Taip;7;0;0;7
7579;Pušaitė;PELIUKAI;6180888008;Taip;8;3;0;11
7580;Pušynėlis;PUMPURĖLIAI;7177725663;Taip;0;9;0;9
7581;Pušynėlis;PUMPURĖLIAI;1891728904;Ne;0;1;2;3
7582;Pušynėlis;PUMPURĖLIAI;7887716737;Taip;0;0;16;16
7583;Pušynėlis;PUMPURĖLIAI;3100230874;Taip;2;0;10;12
7584;Pušynėlis;PUMPURĖLIAI;1102029570;Taip;0;0;3;3
7585;Pušynėlis;PUMPURĖLIAI;4030500100;Taip;5;5;0;10
7586;Pušynėlis;PUMPURĖLIAI;8172450090;Taip;5;5;0;10
7587;Pušynėlis;PUMPURĖLIAI;9039274775;Taip;15;0;2;17
7588;Pušynėlis;PUMPURĖLIAI;6077698697;Taip;0;0;2;2
7589;Pušynėlis;PUMPURĖLIAI;7046421581;Taip;16;0;0;16
7590;Pušynėlis;PUMPURĖLIAI;7729392498;Taip;0;6;0;6
7591;Pušynėlis;PUMPURĖLIAI;4380948433;Taip;0;0;3;3
7592;Pušynėlis;PUMPURĖLIAI;1610132076;Taip;0;0;5;5
7593;Pušynėlis;PUMPURĖLIAI;2793982816;Ne;0;15;1;16
7594;Pušynėlis;PUMPURĖLIAI;4920818548;Taip;0;0;13;13
7595;Pušynėlis;PUMPURĖLIAI;2508640229;Taip;9;0;2;11
7596;Pušynėlis;PUMPURĖLIAI;5236219294;Taip;7;0;6;13
7597;Pušynėlis;PUMPURĖLIAI;4052132379;Taip;7;0;0;7
7598;Pušynėlis;PUMPURĖLIAI;8451160808;Ne;2;0;1;3
7599;Pušynėlis;PUMPURĖLIAI;2141785580;Ne;5;8;0;13
7600;Pušynėlis;SAULUTĖS;48050606382;Taip;0;4;0;4
7601;Pušynėlis;SAULUTĖS;74952593070;Taip;4;1;0;5
7602;Pušynėlis;SAULUTĖS;1610449906;Taip;5;7;0;12
7603;Pušynėlis;SAULUTĖS;51835639636;Ne;0;4;0;4
7604;Pušynėlis;SAULUTĖS;1811758590;Taip;13;0;0;13
7605;Pušynėlis;SAULUTĖS;25261143142;Taip;5;4;0;9
7606;Pušynėlis;SAULUTĖS;6549217377;Taip;17;0;0;17
7607;Pušynėlis;SAULUTĖS;2048377076;Taip;0;2;0;2
7608;Pušynėlis;SAULUTĖS;9466109315;Taip;4;0;2;6
7609;Pušynėlis;SAULUTĖS;23816147491;Ne;6;7;0;13
7610;Pušynėlis;SAULUTĖS;2012089695;Taip;3;6;0;9
7611;Pušynėlis;SAULUTĖS;1284674882;Taip;0;14;0;14
7612;Pušynėlis;SAULUTĖS;35538053975;Taip;5;10;0;15
7613;Pušynėlis;SAULUTĖS;76597184985;Taip;0;0;1;1
7614;Pušynėlis;SAULUTĖS;3510202379;Ne;5;0;0;5
7615;Pušynėlis;SAULUTĖS;1817179601;Taip;1;7;0;8
7616;Pušynėlis;SAULUTĖS;6716726918;Taip;10;0;0;10
7617;Pušynėlis;SAULUTĖS;9665845150;Ne;5;10;0;15
7618;Pušynėlis;PRIEŠMOKYKLINĖ;3527543120;Ne;0;0;1;1
7619;Pušynėlis;PRIEŠMOKYKLINĖ;6862900911;Taip;0;0;3;3
7620;Pušynėlis;PRIEŠMOKYKLINĖ;4291894982;Taip;0;0;6;6
7621;Pušynėlis;PRIEŠMOKYKLINĖ;16192036601;Taip;0;0;5;5
7622;Pušynėlis;PRIEŠMOKYKLINĖ;93484950406;Ne;7;0;2;9
7623;Pušynėlis;PRIEŠMOKYKLINĖ;1955967062;Taip;0;6;0;6
7624;Pušynėlis;PRIEŠMOKYKLINĖ;79386112020;Taip;0;0;1;1
7625;Pušynėlis;PRIEŠMOKYKLINĖ;1253953853;Ne;5;0;0;5
7626;Pušynėlis;PRIEŠMOKYKLINĖ;2042833795;Taip;0;3;0;3
7627;Pušynėlis;PRIEŠMOKYKLINĖ;58252435610;Taip;0;0;9;9
7628;Pušynėlis;PRIEŠMOKYKLINĖ;51866074822;Taip;0;0;3;3
7629;Pušynėlis;PRIEŠMOKYKLINĖ;75716791245;Taip;2;0;0;2
7630;Pušynėlis;PRIEŠMOKYKLINĖ;39796631884;Taip;22;0;0;22
7631;Pušynėlis;PRIEŠMOKYKLINĖ;1863758087;Taip;5;10;0;15
7632;Pušynėlis;PRIEŠMOKYKLINĖ;91759717760;Taip;0;11;0;11
7633;Pušynėlis;PRIEŠMOKYKLINĖ;40478713455;Taip;11;4;0;15
7634;Pušynėlis;PRIEŠMOKYKLINĖ;1415916851;Taip;17;0;0;17
7635;Pušynėlis;PRIEŠMOKYKLINĖ;1367922475;Taip;16;0;0;16
7636;Pušynėlis;PRIEŠMOKYKLINĖ;1585572669;Taip;0;6;0;6
7637;Pušynėlis;LOPŠELIS;2718421498;Taip;7;1;0;8
7638;Pušynėlis;LOPŠELIS;8218331977;Taip;5;5;0;10
7639;Pušynėlis;LOPŠELIS;1251787066;Ne;0;0;7;7
7640;Pušynėlis;LOPŠELIS;7896617995;Taip;4;0;0;4
7641;Pušynėlis;LOPŠELIS;9483417104;Taip;8;0;0;8
7642;Pušynėlis;LOPŠELIS;9081582524;Taip;5;0;1;6
7643;Pušynėlis;LOPŠELIS;3882064516;Taip;5;0;0;5
7644;Pušynėlis;LOPŠELIS;1034336110;Taip;0;10;0;10
7645;Pušynėlis;LOPŠELIS;1164201286;Taip;0;6;0;6
7646;Pušynėlis;LOPŠELIS;6709692748;Taip;6;2;0;8
7647;Pušynėlis;LOPŠELIS;8799095053;Taip;0;3;0;3
7648;Pušynėlis;LOPŠELIS;5318223378;Taip;0;3;0;3
7649;Pušynėlis;LOPŠELIS;7401066252;Taip;7;0;0;7
7650;Raktelis;LAŠIUKAI;55504358470;Ne;0;3;0;3
7651;Raktelis;LAŠIUKAI;1453259901;Taip;0;0;2;2
7652;Raktelis;LAŠIUKAI;30483797110;Taip;0;1;0;1
7653;Raktelis;LAŠIUKAI;5430563880;Taip;0;5;0;5
7654;Raktelis;LAŠIUKAI;874585350;Taip;0;1;0;1
7655;Raktelis;LAŠIUKAI;82549894936;Taip;3;3;0;6
7656;Raktelis;LAŠIUKAI;24160611392;Taip;5;2;0;7
7657;Raktelis;LAŠIUKAI;25504804011;Ne;0;1;0;1
7658;Raktelis;LAŠIUKAI;79301972646;Taip;5;1;2;8
7659;Raktelis;LAŠIUKAI;54361317676;Taip;5;2;0;7
7660;Raktelis;LAŠIUKAI;12333424396;Taip;0;1;0;1
7661;Raktelis;LAŠIUKAI;61636842808;Taip;0;0;1;1
7662;Raktelis;LAŠIUKAI;1224477393;Ne;5;0;0;5
7663;Raktelis;LAŠIUKAI;76758476679;Taip;7;0;2;9
7664;Raktelis;LAŠIUKAI;83366206408;Taip;2;0;0;2
7665;Raktelis;LAŠIUKAI;38068336379;Taip;7;0;1;8
7666;Raktelis;LAŠIUKAI;68578915107;Taip;0;3;0;3
7667;Raktelis;LAŠIUKAI;49216690763;Taip;0;0;2;2
7668;Raktelis;LAŠIUKAI;1586157196;Taip;8;0;0;8
7669;Raktelis;LAŠIUKAI;62754553467;Taip;5;0;0;5
7670;Raktelis;LAŠIUKAI;78841101231;Taip;4;0;5;9
7671;Raktelis;BITUTĖS;37587869107;Taip;0;2;3;5
7672;Raktelis;BITUTĖS;1544882634;Taip;0;3;0;3
7673;Raktelis;BITUTĖS;63051817818;Taip;0;2;0;2
7674;Raktelis;BITUTĖS;5663304735;Ne;0;1;0;1
7675;Raktelis;BITUTĖS;8559758812;Taip;10;1;0;11
7676;Raktelis;BITUTĖS;5627179884;Taip;0;7;0;7
7677;Raktelis;BITUTĖS;5405322552;Taip;7;0;0;7
7678;Raktelis;BITUTĖS;5492437864;Taip;7;1;0;8
7679;Raktelis;BITUTĖS;3880578523;Taip;3;0;0;3
7680;Raktelis;BITUTĖS;8796557675;Taip;5;11;0;16
7681;Raktelis;BITUTĖS;24323703041;Ne;0;0;1;1
7682;Raktelis;BITUTĖS;53034039807;Taip;3;0;5;8
7683;Raktelis;BITUTĖS;5711863758;Ne;5;0;0;5
7684;Raktelis;BITUTĖS;1747834520;Taip;7;0;3;10
7685;Raktelis;BITUTĖS;5000264125;Taip;0;12;0;12
7686;Raktelis;BITUTĖS;1820583792;Taip;22;0;0;22
7687;Raktelis;BITUTĖS;5802689482;Taip;0;10;0;10
7688;Raktelis;BITUTĖS;17270742947;Taip;0;0;13;13
7689;Raktelis;BITUTĖS;5392514118;Taip;11;2;4;17
7690;Raktelis;BITUTĖS;7048022562;Taip;0;1;0;1
7691;Raktelis;BITUTĖS;9774706725;Taip;7;3;0;10
7692;Raktelis;BITUTĖS;1455550617;Taip;0;0;4;4
7693;Raktelis;BORUŽĖLĖS;8117871963;Taip;16;0;4;20
7694;Raktelis;BORUŽĖLĖS;5031703240;Taip;6;0;0;6
7695;Raktelis;BORUŽĖLĖS;95104355224;Taip;5;2;0;7
7696;Raktelis;BORUŽĖLĖS;6049420030;Ne;8;0;0;8
7697;Raktelis;BORUŽĖLĖS;9313156299;Taip;0;2;0;2
7698;Raktelis;BORUŽĖLĖS;54221331553;Taip;7;2;0;9
7699;Raktelis;BORUŽĖLĖS;2070196225;Taip;7;1;0;8
7700;Raktelis;BORUŽĖLĖS;2303286473;Taip;3;0;2;5
7701;Raktelis;BORUŽĖLĖS;1192775994;Taip;9;2;0;11
7702;Raktelis;BORUŽĖLĖS;3345708690;Taip;5;0;0;5
7703;Raktelis;BORUŽĖLĖS;8245310502;Ne;12;1;0;13
7704;Raktelis;BORUŽĖLĖS;7487507324;Ne;0;1;0;1
7705;Raktelis;BORUŽĖLĖS;93271260871;Taip;0;7;0;7
7706;Raktelis;BORUŽĖLĖS;6779413882;Taip;11;0;0;11
7707;Raktelis;BORUŽĖLĖS;9584164290;Taip;6;7;0;13
7708;Raktelis;BORUŽĖLĖS;2055530718;Taip;5;0;0;5
7709;Raktelis;BORUŽĖLĖS;8410301417;Taip;0;1;0;1
7710;Raktelis;BORUŽĖLĖS;6854111162;Ne;0;2;0;2
7711;Raktelis;BORUŽĖLĖS;9348898875;Taip;0;2;0;2
7712;Raktelis;BORUŽĖLĖS;3762141936;Taip;10;1;0;11
7713;Raktelis;BORUŽĖLĖS;3713386556;Taip;17;0;0;17
7714;Raktelis;BORUŽĖLĖS;9230053040;Taip;5;2;0;7
7715;Raktelis;BORUŽĖLĖS;4671391106;Taip;5;1;0;6
7716;Raktelis;KAČIUKAI;8579864696;Ne;0;6;0;6
7717;Raktelis;KAČIUKAI;1393351147;Taip;0;2;2;4
7718;Raktelis;KAČIUKAI;27084497916;Taip;1;1;0;2
7719;Raktelis;KAČIUKAI;1063413424;Ne;6;5;0;11
7720;Raktelis;KAČIUKAI;4449411816;Taip;4;10;0;14
7721;Raktelis;KAČIUKAI;89139880068;Taip;12;1;0;13
7722;Raktelis;KAČIUKAI;1468915955;Taip;0;1;0;1
7723;Raktelis;KAČIUKAI;87211875672;Taip;6;0;0;6
7724;Raktelis;KAČIUKAI;21063882404;Ne;2;1;0;3
7725;Raktelis;KAČIUKAI;78145437124;Taip;4;4;0;8
7726;Raktelis;KAČIUKAI;2143998936;Taip;0;2;0;2
7727;Raktelis;KAČIUKAI;1957572199;Taip;1;1;0;2
7728;Raktelis;KAČIUKAI;4906678347;Ne;7;1;0;8
7729;Raktelis;KAČIUKAI;1567546511;Taip;0;9;0;9
7730;Raktelis;KAČIUKAI;86883305675;Taip;3;2;0;5
7731;Raktelis;KAČIUKAI;9380332489;Taip;5;2;0;7
7732;Raktelis;KAČIUKAI;26727657814;Taip;9;0;0;9
7733;Raktelis;KAČIUKAI;30092089456;Taip;0;6;0;6
7734;Raktelis;KAČIUKAI;50372098009;Taip;3;2;0;5
7735;Raktelis;KAČIUKAI;1378192491;Taip;0;1;0;1
7736;Raktelis;KAČIUKAI;1046075234;Taip;1;2;0;3
7737;Raktelis;KAČIUKAI;1457880868;Ne;2;1;2;5
7738;Raktelis;KAČIUKAI;4071338645;Taip;0;6;0;6
7739;Raktelis;KIŠKUČIAI;1983808547;Taip;9;0;0;9
7740;Raktelis;KIŠKUČIAI;4317705126;Taip;2;0;0;2
7741;Raktelis;KIŠKUČIAI;1843086151;Taip;0;8;0;8
7742;Raktelis;KIŠKUČIAI;2295251060;Taip;0;1;0;1
7743;Raktelis;KIŠKUČIAI;4160091258;Taip;14;0;0;14
7744;Raktelis;KIŠKUČIAI;5042538956;Taip;10;0;0;10
7745;Raktelis;KIŠKUČIAI;4471813998;Taip;2;0;0;2
7746;Raktelis;KIŠKUČIAI;3775306030;Taip;12;0;0;12
7747;Raktelis;KIŠKUČIAI;4009105487;Taip;13;0;0;13
7748;Raktelis;KIŠKUČIAI;7260767942;Taip;4;0;1;5
7749;Raktelis;KIŠKUČIAI;6265489540;Taip;0;3;0;3
7750;Raktelis;KIŠKUČIAI;4187804340;Taip;10;0;0;10
7751;Raktelis;NYKŠTUKAI;4933650089;Taip;0;0;6;6
7752;Raktelis;NYKŠTUKAI;4622683599;Taip;6;0;0;6
7753;Raktelis;NYKŠTUKAI;5270430511;Ne;0;2;0;2
7754;Raktelis;NYKŠTUKAI;4979657165;Taip;4;0;1;5
7755;Raktelis;NYKŠTUKAI;6007823584;Taip;3;0;0;3
7756;Raktelis;NYKŠTUKAI;4676213966;Taip;9;0;2;11
7757;Raktelis;NYKŠTUKAI;3733786043;Taip;3;2;0;5
7758;Raktelis;NYKŠTUKAI;4319176525;Taip;3;0;2;5
7759;Raktelis;NYKŠTUKAI;8456082594;Taip;3;1;0;4
7760;Raktelis;NYKŠTUKAI;6929358401;Taip;0;4;4;8
7761;Raktelis;NYKŠTUKAI;7630501672;Taip;6;4;1;11
7762;Raktelis;NYKŠTUKAI;9965855682;Taip;5;1;0;6
7763;Raktelis;NYKŠTUKAI;2700148968;Taip;11;0;0;11
7764;Raktelis;NYKŠTUKAI;4631375439;Taip;2;0;0;2
7765;Raktelis;PELIUKAI;2967941870;Taip;4;0;0;4
7766;Raktelis;PELIUKAI;8146076115;Taip;6;0;0;6
7767;Raktelis;PELIUKAI;2731096860;Taip;0;0;1;1
7768;Raktelis;PELIUKAI;2809458453;Taip;11;0;0;11
7769;Raktelis;PELIUKAI;6892006495;Taip;3;0;3;6
7770;Raktelis;PELIUKAI;3884068578;Taip;0;1;0;1
7771;Raktelis;PELIUKAI;1322912585;Taip;5;0;0;5
7772;Raktelis;PELIUKAI;4228614834;Taip;10;2;0;12
7773;Raktelis;PELIUKAI;4755892641;Taip;0;5;0;5
7774;Raktelis;PELIUKAI;8353427144;Ne;12;10;0;22
7775;Raktelis;PELIUKAI;7869495911;Taip;8;6;0;14
7776;Raktelis;PELIUKAI;4167194960;Taip;0;0;4;4
7777;Raktelis;PELIUKAI;3395720463;Taip;4;10;0;14
7778;Raktelis;PELIUKAI;9151796053;Taip;10;0;1;11
7779;Raktelis;PELIUKAI;7142823740;Taip;2;1;0;3
7780;Raktelis;PELIUKAI;7055894770;Taip;6;0;0;6
7781;Raktelis;AGUONOS;6102196040;Taip;4;2;1;7
7782;Raktelis;AGUONOS;1622504968;Taip;4;0;0;4
7783;Raktelis;AGUONOS;6199212999;Taip;12;1;0;13
7784;Raktelis;AGUONOS;7334310944;Taip;9;0;0;9
7785;Raktelis;AGUONOS;6281687751;Taip;3;5;0;8
7786;Raktelis;AGUONOS;3661917922;Taip;6;0;1;7
7787;Raktelis;AGUONOS;1975411457;Ne;7;0;2;9
7788;Raktelis;AGUONOS;6877934219;Taip;5;0;0;5
7789;Raktelis;AGUONOS;6367875352;Taip;0;7;0;7
7790;Raktelis;AGUONOS;7170546710;Taip;15;5;0;20
7791;Raktelis;AGUONOS;4905982507;Taip;0;4;0;4
7792;Raktelis;AGUONOS;6014726741;Taip;2;2;0;4
7793;Raktelis;AGUONOS;9779789133;Taip;4;2;1;7
7794;Raktelis;AGUONOS;2219712757;Ne;7;1;0;8
7795;Raktelis;AGUONOS;9593639791;Taip;5;3;0;8
7796;Raktelis;AGUONOS;1392036584;Taip;0;1;0;1
7797;Raktelis;AGUONOS;6608224825;Taip;14;0;0;14
7798;Raktelis;AGUONOS;4658530212;Taip;6;0;0;6
7799;Raktelis;AGUONOS;4335378625;Taip;5;0;0;5
7800;Raktelis;AGUONOS;8873203690;Taip;0;4;0;4
7801;Raktelis;AGUONOS;9357757604;Taip;10;6;0;16
7802;Raktelis;AGUONOS;8459980712;Taip;12;1;2;15
7803;Raktelis;AGUONOS;7973137015;Taip;11;0;2;13
7804;Raktelis;AGUONOS;5218387088;Taip;4;2;1;7
7805;Raktelis;AGUONOS;9591285702;Taip;7;2;0;9
7806;Raktelis;AGUONOS;9210856228;Taip;5;8;3;16
7807;Raktelis;LAPIUKŲ;7962509432;Taip;10;0;1;11
7808;Raktelis;LAPIUKŲ;9501202273;Taip;0;1;0;1
7809;Raktelis;LAPIUKŲ;98616285680;Taip;0;1;0;1
7810;Raktelis;LAPIUKŲ;4569798381;Taip;19;0;0;19
7811;Raktelis;LAPIUKŲ;67304194087;Taip;4;2;0;6
7812;Raktelis;LAPIUKŲ;15583558585;Taip;9;3;0;12
7813;Raktelis;LAPIUKŲ;2753402906;Taip;10;1;0;11
7814;Raktelis;LAPIUKŲ;4583377785;Taip;6;2;0;8
7815;Raktelis;LAPIUKŲ;5082785025;Taip;0;7;0;7
7816;Raktelis;LAPIUKŲ;9130613710;Taip;5;6;0;11
7817;Raktelis;LAPIUKŲ;1453677708;Taip;10;1;0;11
7818;Raktelis;LAPIUKŲ;2282754345;Taip;0;4;0;4
7819;Raktelis;LAPIUKŲ;1109105359;Ne;0;2;0;2
7820;Raktelis;LAPIUKŲ;5768653399;Taip;0;22;0;22
7821;Raktelis;LAPIUKŲ;5595087767;Ne;0;1;0;1
7822;Raktelis;LAPIUKŲ;6385127914;Taip;0;4;0;4
7823;Raktelis;LAPIUKŲ;3423529085;Taip;0;1;0;1
7824;Raktelis;LAPIUKŲ;5925441742;Taip;5;1;0;6
7825;Raktelis;LAPIUKŲ;9053427316;Taip;0;1;0;1
7826;Raktelis;PELĖDŽIUKAI;2985254060;Taip;7;0;0;7
7827;Raktelis;PELĖDŽIUKAI;68390568000;Taip;9;0;0;9
7828;Raktelis;PELĖDŽIUKAI;68570148753;Taip;0;2;0;2
7829;Raktelis;PELĖDŽIUKAI;27403835292;Taip;3;0;0;3
7830;Raktelis;PELĖDŽIUKAI;25141529581;Taip;0;1;0;1
7831;Raktelis;PELĖDŽIUKAI;43500434912;Taip;0;6;0;6
7832;Raktelis;PELĖDŽIUKAI;45028887854;Taip;0;2;0;2
7833;Raktelis;PELĖDŽIUKAI;5943583254;Taip;0;2;0;2
7834;Raktelis;PELĖDŽIUKAI;15159708127;Taip;0;2;0;2
7835;Raktelis;PELĖDŽIUKAI;53270411090;Ne;0;2;0;2
7836;Raktelis;PELĖDŽIUKAI;92373834478;Ne;10;3;0;13
7837;Raktelis;PELĖDŽIUKAI;95357638985;Taip;5;0;0;5
7838;Raktelis;PELĖDŽIUKAI;1819514057;Ne;3;0;0;3
7839;Raktelis;PELĖDŽIUKAI;86120193313;Taip;0;0;3;3
7840;Raktelis;PELĖDŽIUKAI;67378900057;Ne;0;0;1;1
7841;Raktelis;PELĖDŽIUKAI;40006848965;Taip;5;0;0;5
7842;Raktelis;PELĖDŽIUKAI;38001876942;Taip;0;3;0;3
7843;Raktelis;PELĖDŽIUKAI;67756822733;Taip;3;1;0;4
7844;Raktelis;PELĖDŽIUKAI;1197826066;Taip;2;0;0;2
7845;Rasa;Nykštukai;3664125930;Ne;8;5;0;13
7846;Rasa;Nykštukai;5176175108;Taip;10;0;2;12
7847;Rasa;Nykštukai;3979273111;Taip;0;3;0;3
7848;Rasa;Nykštukai;4847544355;Taip;12;2;0;14
7849;Rasa;Nykštukai;9723040721;Taip;15;0;1;16
7850;Rasa;Nykštukai;7004232909;Taip;6;0;3;9
7851;Rasa;Nykštukai;1223962374;Taip;0;8;0;8
7852;Rasa;Nykštukai;3200377629;Ne;7;15;0;22
7853;Rasa;Nykštukai;1336291828;Taip;0;2;0;2
7854;Rasa;Nykštukai;5861229664;Taip;25;0;0;25
7855;Rasa;Nykštukai;1386880644;Taip;0;0;4;4
7856;Rasa;Nykštukai;7228037580;Taip;6;1;0;7
7857;Rasa;Nykštukai;2093263887;Taip;9;0;0;9
7858;Rasa;Nykštukai;2540124793;Taip;11;0;0;11
7859;Rasa;Nykštukai;5363748728;Taip;4;0;2;6
7860;Rasa;Nykštukai;2977737634;Taip;8;1;0;9
7861;Rasa;Nykštukai;8310400946;Taip;1;1;0;2
7862;Rasa;Nykštukai;7520665472;Taip;4;6;0;10
7863;Rasa;Meškiukai;8278928396;Taip;11;0;2;13
7864;Rasa;Meškiukai;8052120247;Taip;7;0;0;7
7865;Rasa;Meškiukai;1013865195;Taip;0;0;1;1
7866;Rasa;Meškiukai;63673920646;Taip;3;0;1;4
7867;Rasa;Meškiukai;52913880917;Ne;0;9;0;9
7868;Rasa;Meškiukai;5932187584;Taip;18;0;0;18
7869;Rasa;Meškiukai;5145978804;Ne;21;1;0;22
7870;Rasa;Meškiukai;6356448094;Taip;0;0;25;25
7871;Rasa;Meškiukai;2683897055;Taip;14;2;0;16
7872;Rasa;Meškiukai;4790859112;Taip;4;0;0;4
7873;Rasa;Meškiukai;7534548604;Taip;6;0;0;6
7874;Rasa;Meškiukai;5606722133;Taip;0;0;1;1
7875;Rasa;Meškiukai;7565880116;Taip;14;0;0;14
7876;Rasa;Meškiukai;7544963724;Taip;0;1;0;1
7877;Rasa;Meškiukai;3567565920;Ne;13;0;3;16
7878;Rasa;Meškiukai;4837280374;Ne;0;0;1;1
7879;Rasa;Sauliukai;3001023535;Ne;1;1;0;2
7880;Rasa;Sauliukai;1067614202;Ne;3;2;0;5
7881;Rasa;Sauliukai;29141190550;Taip;0;4;0;4
7882;Rasa;Sauliukai;59695217278;Taip;2;3;0;5
7883;Rasa;Sauliukai;87310376118;Taip;8;0;0;8
7884;Rasa;Sauliukai;36336738780;Taip;0;6;0;6
7885;Rasa;Sauliukai;1549153022;Taip;0;1;0;1
7886;Rasa;Sauliukai;1846631921;Taip;9;0;0;9
7887;Rasa;Sauliukai;96518910021;Taip;11;0;0;11
7888;Rasa;Sauliukai;59127440556;Taip;1;7;0;8
7889;Rasa;Sauliukai;26384431360;Taip;0;15;0;15
7890;Rasa;Sauliukai;1004116597;Taip;3;0;0;3
7891;Rasa;Sauliukai;1916783052;Ne;5;0;0;5
7892;Rasa;Sauliukai;6795591746;Ne;4;1;0;5
7893;Rasa;Smalsučiai;3281315532;Taip;0;1;1;2
7894;Rasa;Smalsučiai;13135367451;Taip;0;1;5;6
7895;Rasa;Smalsučiai;91941960564;Taip;0;0;1;1
7896;Rasa;Smalsučiai;4601657045;Taip;0;1;0;1
7897;Rasa;Smalsučiai;1339376048;Taip;0;0;3;3
7898;Rasa;Smalsučiai;5201341227;Taip;0;0;2;2
7899;Rasa;Smalsučiai;2879767810;Taip;3;0;2;5
7900;Rasa;Smalsučiai;1267340581;Taip;0;0;3;3
7901;Rasa;Smalsučiai;88779978297;Taip;0;4;0;4
7902;Rasa;Smalsučiai;13286984288;Taip;7;0;0;7
7903;Rasa;Smalsučiai;1558712079;Taip;0;5;0;5
7904;Rasa;Smalsučiai;99911904705;Taip;0;10;1;11
7905;Rasa;Smalsučiai;79439306932;Taip;4;0;0;4
7906;Rasa;Smalsučiai;9890493148;Taip;0;2;3;5
7907;Rasa;Smalsučiai;25918582395;Ne;0;2;3;5
7908;Rasa;Smalsučiai;1311346161;Taip;19;1;0;20
7909;Rasa;Smalsučiai;77589878141;Taip;2;1;2;5
7910;Rasa;Smalsučiai;1581241275;Taip;1;0;3;4
7911;Rasa;Smalsučiai;1803769089;Taip;2;0;5;7
7912;Rasa;"Pelėdžiukai ";1176606744;Taip;3;1;0;4
7913;Rasa;"Pelėdžiukai ";2121070882;Taip;0;0;17;17
7914;Rasa;"Pelėdžiukai ";1457384318;Taip;0;0;4;4
7915;Rasa;"Pelėdžiukai ";3884105235;Taip;22;0;0;22
7916;Rasa;"Pelėdžiukai ";6704162447;Taip;0;1;0;1
7917;Rasa;"Pelėdžiukai ";7558966891;Taip;5;0;6;11
7918;Rasa;"Pelėdžiukai ";6773004268;Taip;0;6;7;13
7919;Rasa;"Pelėdžiukai ";8953448462;Ne;4;0;0;4
7920;Rasa;"Pelėdžiukai ";5325275053;Taip;4;6;0;10
7921;Rasa;"Pelėdžiukai ";4542122478;Taip;15;0;4;19
7922;Rasa;"Pelėdžiukai ";2962815301;Taip;5;0;2;7
7923;Rasa;"Pelėdžiukai ";8398961969;Taip;6;0;0;6
7924;Rasa;"Pelėdžiukai ";8912031554;Taip;6;0;1;7
7925;Rasa;"Pelėdžiukai ";3091012313;Taip;6;0;5;11
7926;Rasa;Katinėliai;5885520521;Taip;12;0;1;13
7927;Rasa;Katinėliai;7730322729;Taip;3;0;4;7
7928;Rasa;Katinėliai;3657956842;Ne;13;0;0;13
7929;Rasa;Katinėliai;6891623055;Taip;0;0;1;1
7930;Rasa;Katinėliai;9010812748;Taip;5;0;0;5
7931;Rasa;Katinėliai;7220007488;Taip;6;1;0;7
7932;Rasa;Katinėliai;8235869241;Taip;4;0;0;4
7933;Rasa;Katinėliai;3135828190;Ne;0;6;2;8
7934;Rasa;Katinėliai;2984661168;Taip;2;0;0;2
7935;Rasa;Katinėliai;7142481458;Taip;10;0;0;10
7936;Rasa;Katinėliai;7314537168;Taip;3;0;1;4
7937;Rasa;Katinėliai;5596874303;Taip;7;0;0;7
7938;Rasa;Katinėliai;4734775151;Taip;7;0;5;12
7939;Rasa;Katinėliai;4758138905;Taip;1;0;4;5
7940;Rasa;Katinėliai;9447346901;Taip;0;0;1;1
7941;Rasa;Ančiukai;7185331699;Ne;7;2;0;9
7942;Rasa;Ančiukai;1060810039;Ne;7;2;0;9
7943;Rasa;Ančiukai;9599510902;Taip;12;0;0;12
7944;Rasa;Ančiukai;7037958994;Taip;14;1;0;15
7945;Rasa;Ančiukai;9668538340;Taip;9;8;0;17
7946;Rasa;Ančiukai;4795339259;Taip;2;1;0;3
7947;Rasa;Ančiukai;6019853365;Taip;20;0;2;22
7948;Rasa;Ančiukai;4694111253;Taip;3;0;2;5
7949;Rasa;Ančiukai;7028605422;Taip;15;2;0;17
7950;Rasa;Ančiukai;2711923397;Taip;13;0;0;13
7951;Rasa;Ančiukai;2800420481;Taip;6;0;0;6
7952;Rasa;Ančiukai;5869253167;Taip;17;0;0;17
7953;Rasa;Ančiukai;3475601049;Taip;7;0;3;10
7954;Rasa;Ančiukai;6887471189;Taip;15;0;0;15
7955;Rasa;"Vyturiukai ";1210203141;Taip;2;0;2;4
7956;Rasa;"Vyturiukai ";7575833127;Taip;0;0;15;15
7957;Rasa;"Vyturiukai ";27131705540;Taip;3;0;0;3
7958;Rasa;"Vyturiukai ";1823276800;Taip;7;1;1;9
7959;Rasa;"Vyturiukai ";1940633287;Taip;0;0;1;1
7960;Rasa;"Vyturiukai ";66103644564;Taip;1;0;2;3
7961;Rasa;"Vyturiukai ";73115061371;Taip;0;12;0;12
7962;Rasa;"Vyturiukai ";1049242346;Taip;0;0;4;4
7963;Rasa;"Vyturiukai ";1179402963;Taip;0;6;0;6
7964;Rasa;"Vyturiukai ";1210340955;Taip;0;7;0;7
7965;Rasa;"Vyturiukai ";83227920971;Ne;0;5;0;5
7966;Rasa;"Vyturiukai ";34934099958;Taip;0;3;0;3
7967;Rasa;"Vyturiukai ";84161884493;Taip;0;0;9;9
7968;Rasa;"Vyturiukai ";1214055260;Taip;0;4;0;4
7969;Rasa;"Vyturiukai ";2041098301;Taip;5;7;0;12
7970;Rasa;"Vyturiukai ";71420694152;Ne;5;14;1;20
7971;Rasa;"Vyturiukai ";1477555365;Taip;10;9;0;19
7972;Rasa;"Vyturiukai ";9438727789;Taip;0;0;8;8
7973;Rasa;Voveriukai;1728275988;Taip;0;0;1;1
7974;Rasa;Voveriukai;74744565967;Taip;4;0;0;4
7975;Rasa;Voveriukai;1452467682;Taip;0;0;1;1
7976;Rasa;Voveriukai;1093723298;Ne;0;2;1;3
7977;Rasa;Voveriukai;2158444381;Taip;5;8;0;13
7978;Rasa;Voveriukai;5589971159;Taip;0;10;1;11
7979;Rasa;Voveriukai;2980868154;Ne;5;3;0;8
7980;Rasa;Voveriukai;8749177123;Ne;0;10;0;10
7981;Rasa;Voveriukai;4065614217;Taip;3;4;0;7
7982;Rasa;Voveriukai;15257986685;Taip;0;3;0;3
7983;Rasa;Voveriukai;1900027524;Ne;2;0;0;2
7984;Rasa;Voveriukai;2349860704;Taip;4;0;2;6
7985;Rasa;Voveriukai;1704518157;Taip;6;0;0;6
7986;Rasa;"DRUGELIAI ";9140875020;Ne;12;0;0;12
7987;Rasa;"DRUGELIAI ";9229817861;Ne;5;0;4;9
7988;Rasa;"DRUGELIAI ";2191720088;Taip;9;0;1;10
7989;Rasa;"DRUGELIAI ";3233000497;Taip;9;0;1;10
7990;Rasa;"DRUGELIAI ";6535561634;Taip;0;0;8;8
7991;Rasa;"DRUGELIAI ";1206005039;Taip;9;0;0;9
7992;Rasa;"DRUGELIAI ";9788282861;Taip;9;0;0;9
7993;Rasa;"DRUGELIAI ";6311322617;Taip;0;12;0;12
7994;Rasa;"DRUGELIAI ";3073804713;Taip;0;0;3;3
7995;Rasa;"DRUGELIAI ";9677810607;Taip;10;0;2;12
7996;Rasa;"DRUGELIAI ";1466616814;Taip;8;0;0;8
7997;Rasa;"DRUGELIAI ";5165588335;Taip;7;0;0;7
7998;Rasa;Zuikučiai;4554377449;Taip;0;3;0;3
7999;Rasa;Zuikučiai;2137321989;Taip;0;6;0;6
8000;Rasa;Zuikučiai;1993471951;Taip;12;1;3;16
8001;Rasa;Zuikučiai;1860462451;Taip;17;0;0;17
8002;Rasa;Zuikučiai;42609897431;Taip;4;0;2;6
8003;Rasa;Zuikučiai;55374082940;Taip;0;18;0;18
8004;Rasa;Zuikučiai;2114613635;Taip;0;1;4;5
8005;Rasa;Zuikučiai;56016538926;Taip;0;0;2;2
8006;Rasa;Zuikučiai;13297122928;Taip;13;1;0;14
8007;Rasa;Zuikučiai;6108187043;Taip;0;4;0;4
8008;Rasa;Zuikučiai;1131418692;Taip;0;3;0;3
8009;Rasa;Zuikučiai;7065597550;Ne;4;0;0;4
8010;Rasa;Zuikučiai;9432880035;Taip;0;9;0;9
8011;Rasa;Širdelė;56168039878;Taip;0;7;0;7
8012;Rasa;Širdelė;8424049317;Taip;15;0;0;15
8013;Rasa;Širdelė;5599182715;Taip;0;7;0;7
8014;Rasa;Širdelė;9648034081;Taip;0;9;0;9
8015;Rasa;Širdelė;33479419656;Taip;5;1;2;8
8016;Rasa;Širdelė;8236464670;Taip;0;6;0;6
8017;Rasa;Širdelė;1271820053;Ne;0;0;4;4
8018;Rasa;Širdelė;2626361958;Taip;13;0;0;13
8019;Rasa;Širdelė;5426981046;Taip;0;0;5;5
8020;Rasa;Širdelė;2840872613;Taip;0;5;0;5
8021;Rasa;Širdelė;23600769349;Taip;0;2;0;2
8022;Rasa;Širdelė;6976298054;Taip;1;0;0;1
8023;Rasa;Širdelė;91931863004;Taip;0;8;0;8
8024;Rasa;Širdelė;3668598028;Taip;0;8;0;8
8025;Rasa;Širdelė;58858081077;Taip;0;9;0;9
8026;Rasa;Širdelė;2132535297;Taip;7;0;1;8
8027;Rasa;Širdelė;2133989183;Taip;0;1;1;2
8028;Rasa;Širdelė;8866896989;Taip;0;19;0;19
8029;Rasa;Širdelė;9938280570;Taip;0;1;0;1
8030;Rasa;Širdelė;2333938367;Taip;12;0;0;12
8031;Riešutėlis;Viščiukų;1782544949;Taip;0;2;0;2
8032;Riešutėlis;Viščiukų;91799192513;Taip;12;0;1;13
8033;Riešutėlis;Viščiukų;50427986973;Taip;7;2;0;9
8034;Riešutėlis;Viščiukų;4098825502;Taip;4;1;0;5
8035;Riešutėlis;Viščiukų;28855582790;Taip;5;0;0;5
8036;Riešutėlis;Viščiukų;41275727334;Taip;7;0;2;9
8037;Riešutėlis;Viščiukų;98456292572;Taip;0;2;0;2
8038;Riešutėlis;Viščiukų;63919369801;Taip;8;1;0;9
8039;Riešutėlis;Viščiukų;2146831972;Ne;0;1;0;1
8040;Riešutėlis;Viščiukų;61571638960;Taip;4;0;0;4
8041;Riešutėlis;Viščiukų;8857939937;Ne;5;0;0;5
8042;Riešutėlis;Viščiukų;1957794151;Taip;9;1;0;10
8043;Riešutėlis;Viščiukų;1743324657;Ne;7;1;0;8
8044;Riešutėlis;Viščiukų;1792212841;Taip;12;0;1;13
8045;Riešutėlis;Viščiukų;86455801201;Taip;2;0;0;2
8046;Riešutėlis;Viščiukų;1532275496;Taip;6;0;0;6
8047;Riešutėlis;Viščiukų;4311016578;Taip;9;5;0;14
8048;Riešutėlis;Viščiukų;8927730307;Taip;10;0;1;11
8049;Riešutėlis;Viščiukų;6855553238;Taip;0;6;2;8
8050;Riešutėlis;Viščiukų;1930481567;Taip;0;0;2;2
8051;Riešutėlis;"Riešutėliai ";8077135868;Ne;14;0;0;14
8052;Riešutėlis;"Riešutėliai ";84116863778;Ne;12;0;0;12
8053;Riešutėlis;"Riešutėliai ";1077680441;Ne;0;1;2;3
8054;Riešutėlis;"Riešutėliai ";55620350407;Taip;5;8;1;14
8055;Riešutėlis;"Riešutėliai ";57437627642;Ne;0;2;0;2
8056;Riešutėlis;"Riešutėliai ";2035669978;Taip;0;5;0;5
8057;Riešutėlis;"Riešutėliai ";1105598415;Taip;6;0;3;9
8058;Riešutėlis;"Riešutėliai ";11913461630;Taip;0;0;2;2
8059;Riešutėlis;"Riešutėliai ";1674871670;Taip;0;7;1;8
8060;Riešutėlis;"Riešutėliai ";1853283967;Taip;10;0;0;10
8061;Riešutėlis;"Riešutėliai ";49061075792;Taip;0;12;0;12
8062;Riešutėlis;"Riešutėliai ";16308059025;Taip;11;0;0;11
8063;Riešutėlis;"Riešutėliai ";9023304543;Taip;8;1;0;9
8064;Riešutėlis;"Riešutėliai ";1941869661;Taip;0;1;0;1
8065;Riešutėlis;"Riešutėliai ";4404544549;Taip;15;5;0;20
8066;Riešutėlis;"Riešutėliai ";85356230208;Taip;0;1;0;1
8067;Riešutėlis;"Riešutėliai ";85066293475;Taip;0;1;0;1
8068;Riešutėlis;Ežiukai;9750713954;Taip;6;5;0;11
8069;Riešutėlis;Ežiukai;9476688736;Taip;11;0;0;11
8070;Riešutėlis;Ežiukai;7601776182;Taip;0;0;1;1
8071;Riešutėlis;Ežiukai;7381623086;Taip;1;0;0;1
8072;Riešutėlis;Ežiukai;9964688413;Taip;8;0;0;8
8073;Riešutėlis;Ežiukai;1548585448;Taip;6;0;2;8
8074;Riešutėlis;Ežiukai;9088123796;Taip;0;0;20;20
8075;Riešutėlis;Ežiukai;8954127616;Taip;0;0;1;1
8076;Riešutėlis;Ežiukai;2092933906;Taip;0;4;0;4
8077;Riešutėlis;Ežiukai;6813024366;Taip;2;0;1;3
8078;Riešutėlis;Ežiukai;7913381005;Taip;0;3;0;3
8079;Riešutėlis;Ežiukai;8480059272;Ne;10;0;1;11
8080;Riešutėlis;Ežiukai;5728858361;Ne;0;2;1;3
8081;Riešutėlis;Ežiukai;8721736343;Taip;10;5;0;15
8082;Riešutėlis;Ežiukai;5327627748;Taip;0;3;2;5
8083;Riešutėlis;Ežiukai;2397854323;Taip;12;0;0;12
8084;Riešutėlis;Ežiukai;6194259707;Taip;0;2;0;2
8085;Riešutėlis;Pelėdžiukai;7198434243;Taip;0;6;0;6
8086;Riešutėlis;Pelėdžiukai;1457008581;Taip;0;0;1;1
8087;Riešutėlis;Pelėdžiukai;8012201566;Taip;11;2;0;13
8088;Riešutėlis;Pelėdžiukai;8751571852;Taip;7;0;0;7
8089;Riešutėlis;Pelėdžiukai;9839084885;Taip;4;0;3;7
8090;Riešutėlis;Pelėdžiukai;6928558714;Ne;4;1;0;5
8091;Riešutėlis;Pelėdžiukai;9040123535;Ne;0;10;0;10
8092;Riešutėlis;Pelėdžiukai;6405116059;Taip;0;0;6;6
8093;Riešutėlis;Pelėdžiukai;5995176001;Taip;0;5;0;5
8094;Riešutėlis;Pelėdžiukai;4451419273;Taip;10;0;2;12
8095;Riešutėlis;Pelėdžiukai;1638021880;Taip;10;0;1;11
8096;Riešutėlis;Pelėdžiukai;5598052531;Taip;0;0;1;1
8097;Riešutėlis;Meškiukai;4004669930;Taip;11;1;0;12
8098;Riešutėlis;Meškiukai;3920525584;Taip;10;0;0;10
8099;Riešutėlis;Meškiukai;6721758785;Taip;0;0;3;3
8100;Riešutėlis;Meškiukai;5753609922;Taip;10;0;0;10
8101;Riešutėlis;Meškiukai;1748151109;Ne;0;7;0;7
8102;Riešutėlis;Meškiukai;3320402459;Taip;12;0;2;14
8103;Riešutėlis;Meškiukai;8738716660;Taip;5;0;5;10
8104;Riešutėlis;Meškiukai;1528972517;Taip;5;3;0;8
8105;Riešutėlis;Meškiukai;7177632315;Taip;0;2;2;4
8106;Riešutėlis;Meškiukai;6292679662;Taip;0;0;6;6
8107;Riešutėlis;Meškiukai;3077468722;Ne;3;0;4;7
8108;Riešutėlis;Meškiukai;4828635362;Taip;0;0;4;4
8109;Riešutėlis;Kiškučiai;90088217854;Ne;10;0;0;10
8110;Riešutėlis;Kiškučiai;92159110899;Taip;10;0;0;10
8111;Riešutėlis;Kiškučiai;1623455993;Taip;0;11;0;11
8112;Riešutėlis;Kiškučiai;4464545735;Taip;0;1;0;1
8113;Riešutėlis;Kiškučiai;96066602684;Ne;0;2;0;2
8114;Riešutėlis;Kiškučiai;55715445788;Taip;1;0;0;1
8115;Riešutėlis;Kiškučiai;1747328573;Taip;18;0;0;18
8116;Riešutėlis;Kiškučiai;1250209796;Ne;6;6;0;12
8117;Riešutėlis;Kiškučiai;1526573984;Taip;2;0;0;2
8118;Riešutėlis;Kiškučiai;50338275044;Taip;0;1;0;1
8119;Riešutėlis;Kiškučiai;35876952602;Taip;0;1;1;2
8120;Riešutėlis;Kiškučiai;1748738558;Taip;0;1;0;1
8121;Riešutėlis;Kiškučiai;93192056557;Taip;0;0;1;1
8122;Riešutėlis;Kiškučiai;2973908247;Taip;0;6;0;6
8123;Riešutėlis;Kiškučiai;2163433983;Taip;0;0;12;12
8124;Riešutėlis;Kiškučiai;4916885450;Taip;0;22;0;22
8125;Riešutėlis;Kiškučiai;8864100655;Taip;0;1;0;1
8126;Riešutėlis;Kiškučiai;6149891188;Taip;3;0;0;3
8127;Riešutėlis;Voveriukų;6130980726;Taip;0;6;0;6
8128;Riešutėlis;Voveriukų;6500567162;Taip;0;4;0;4
8129;Riešutėlis;Voveriukų;9081486438;Taip;10;1;0;11
8130;Riešutėlis;Voveriukų;1212829190;Taip;3;0;0;3
8131;Riešutėlis;Voveriukų;59279444190;Taip;0;2;0;2
8132;Riešutėlis;Voveriukų;31417468379;Taip;1;2;0;3
8133;Riešutėlis;Voveriukų;36176126840;Taip;0;1;0;1
8134;Riešutėlis;Voveriukų;26053212952;Taip;0;1;0;1
8135;Riešutėlis;Voveriukų;51840071269;Taip;0;1;0;1
8136;Riešutėlis;Voveriukų;70549617521;Taip;0;2;0;2
8137;Riešutėlis;Voveriukų;46444683383;Taip;0;2;0;2
8138;Riešutėlis;Voveriukų;92166220283;Taip;1;2;0;3
8139;Riešutėlis;Voveriukų;2163248156;Taip;5;3;0;8
8140;Riešutėlis;Voveriukų;65629075580;Taip;0;4;0;4
8141;Riešutėlis;Voveriukų;50971787753;Taip;9;2;0;11
8142;Riešutėlis;Voveriukų;89384403521;Taip;0;11;0;11
8143;Riešutėlis;Voveriukų;6701821406;Taip;0;4;0;4
8144;Riešutėlis;Voveriukų;64736615832;Ne;15;0;0;15
8145;Riešutėlis;Voveriukų;29751938918;Taip;18;0;0;18
8146;Riešutėlis;Saulutės;2111280879;Taip;0;1;0;1
8147;Riešutėlis;Saulutės;1190403952;Taip;2;1;0;3
8148;Riešutėlis;Saulutės;1160573638;Taip;0;2;0;2
8149;Riešutėlis;Saulutės;1056034480;Ne;6;2;0;8
8150;Riešutėlis;Saulutės;1136025173;Taip;0;0;22;22
8151;Riešutėlis;Saulutės;2097580659;Taip;0;0;2;2
8152;Riešutėlis;Saulutės;2112179980;Ne;10;0;0;10
8153;Riešutėlis;Saulutės;2851186469;Taip;0;10;0;10
8154;Riešutėlis;Saulutės;8749505821;Taip;0;8;1;9
8155;Riešutėlis;Saulutės;1169051233;Ne;0;1;0;1
8156;Riešutėlis;Saulutės;24776322315;Taip;0;0;3;3
8157;Riešutėlis;Saulutės;7912773569;Taip;4;0;0;4
8158;Riešutėlis;Saulutės;2655848313;Taip;0;0;2;2
8159;Riešutėlis;Saulutės;4898775561;Taip;0;3;0;3
8160;Riešutėlis;Saulutės;6402032861;Taip;5;0;1;6
8161;Riešutėlis;Saulutės;5717194707;Taip;0;1;0;1
8162;Riešutėlis;Saulutės;8271632629;Taip;2;0;0;2
8163;Riešutėlis;"Boruželės ";56117509354;Taip;2;6;0;8
8164;Riešutėlis;"Boruželės ";1936519033;Taip;2;0;2;4
8165;Riešutėlis;"Boruželės ";2611705234;Taip;5;9;0;14
8166;Riešutėlis;"Boruželės ";4131218911;Taip;2;0;0;2
8167;Riešutėlis;"Boruželės ";1455509576;Taip;3;12;1;16
8168;Riešutėlis;"Boruželės ";4701887030;Taip;0;1;0;1
8169;Riešutėlis;"Boruželės ";3577669231;Taip;3;0;0;3
8170;Riešutėlis;"Boruželės ";9670912357;Taip;0;0;1;1
8171;Riešutėlis;"Boruželės ";26781529460;Taip;0;0;7;7
8172;Riešutėlis;"Boruželės ";5097410462;Taip;6;0;2;8
8173;Riešutėlis;"Boruželės ";4344185375;Taip;0;0;1;1
8174;Riešutėlis;"Boruželės ";8936419431;Taip;0;5;0;5
8175;Riešutėlis;"Boruželės ";4041498684;Taip;3;4;1;8
8176;Riešutėlis;"Boruželės ";8087180983;Taip;3;0;8;11
8177;Riešutėlis;"Boruželės ";4276034784;Taip;7;0;0;7
8178;Riešutėlis;"Boruželės ";2566084613;Taip;12;0;4;16
8179;Riešutėlis;"Boruželės ";1640383686;Taip;6;0;2;8
8180;Riešutėlis;"Boruželės ";3851000866;Taip;0;0;17;17
8181;Riešutėlis;"Boruželės ";3982030863;Taip;0;0;1;1
8182;Riešutėlis;"Boruželės ";1818130297;Taip;0;0;1;1
8183;Riešutėlis;"Bitutės ";1000408690;Taip;10;2;3;15
8184;Riešutėlis;"Bitutės ";3149710709;Taip;4;0;0;4
8185;Riešutėlis;"Bitutės ";54011982803;Taip;0;1;0;1
8186;Riešutėlis;"Bitutės ";4366097328;Taip;12;0;0;12
8187;Riešutėlis;"Bitutės ";2395648260;Taip;0;0;20;20
8188;Riešutėlis;"Bitutės ";4188823834;Ne;11;0;0;11
8189;Riešutėlis;"Bitutės ";59796628656;Taip;3;0;0;3
8190;Riešutėlis;"Bitutės ";6852846350;Taip;0;11;0;11
8191;Riešutėlis;"Bitutės ";13815744901;Taip;6;0;0;6
8192;Riešutėlis;"Bitutės ";91430094368;Taip;0;2;0;2
8193;Riešutėlis;"Bitutės ";4897379979;Taip;5;0;1;6
8194;Riešutėlis;"Bitutės ";65873300738;Taip;12;2;0;14
8195;Riešutėlis;"Bitutės ";8313605541;Taip;0;1;0;1
8196;Riešutėlis;"Bitutės ";1921241349;Taip;0;2;3;5
8197;Riešutėlis;"Bitutės ";7987368969;Taip;0;10;0;10
8198;Riešutėlis;"Bitutės ";85564700996;Taip;0;5;0;5
8199;Riešutėlis;Drugelių;8266735624;Taip;0;2;0;2
8200;Riešutėlis;Drugelių;4776231497;Taip;0;2;0;2
8201;Riešutėlis;Drugelių;8578903763;Taip;0;3;0;3
8202;Riešutėlis;Drugelių;5811657782;Taip;3;0;0;3
8203;Riešutėlis;Drugelių;4221375847;Taip;0;2;0;2
8204;Riešutėlis;Drugelių;1075842434;Taip;0;0;3;3
8205;Riešutėlis;Drugelių;8845709386;Taip;5;5;0;10
8206;Riešutėlis;Drugelių;8128352818;Taip;0;0;1;1
8207;Riešutėlis;Drugelių;8352146446;Taip;5;0;0;5
8208;Riešutėlis;Drugelių;8180618419;Ne;10;0;0;10
8209;Riešutėlis;Drugelių;5412882446;Taip;0;0;7;7
8210;Riešutėlis;Drugelių;8020533200;Taip;8;3;0;11
8211;Riešutėlis;Drugelių;1164273595;Ne;7;0;6;13
8212;Riešutėlis;Drugelių;8918753084;Taip;0;5;0;5
8213;Riešutėlis;Drugelių;3836374000;Taip;0;2;1;3
8214;Riešutėlis;Drugelių;8016820352;Taip;13;0;0;13
8215;Riešutėlis;Drugelių;3975091711;Taip;0;0;3;3
8216;Riešutėlis;Drugelių;3071643137;Taip;0;0;1;1
8217;Riešutėlis;Drugelių;2599147931;Taip;0;0;1;1
8218;Ramunėlė;SAULUTĖS;19664665864;Ne;0;15;0;15
8219;Ramunėlė;SAULUTĖS;44016905818;Taip;0;9;0;9
8220;Ramunėlė;SAULUTĖS;19784681244;Ne;0;9;0;9
8221;Ramunėlė;SAULUTĖS;9266024764;Taip;0;11;0;11
8222;Ramunėlė;SAULUTĖS;94707638226;Taip;0;7;0;7
8223;Ramunėlė;SAULUTĖS;69367849602;Taip;0;7;0;7
8224;Ramunėlė;SAULUTĖS;27163734018;Ne;7;9;0;16
8225;Ramunėlė;SAULUTĖS;2089805114;Taip;0;7;2;9
8226;Ramunėlė;SAULUTĖS;1079295964;Ne;0;8;0;8
8227;Ramunėlė;SAULUTĖS;26568396284;Ne;0;9;0;9
8228;Ramunėlė;SAULUTĖS;1982905923;Taip;0;9;5;14
8229;Ramunėlė;SAULUTĖS;16577268434;Taip;0;8;0;8
8230;Ramunėlė;SAULUTĖS;3599929268;Taip;0;9;0;9
8231;Ramunėlė;SAULUTĖS;80319760551;Taip;6;7;0;13
8232;Ramunėlė;SAULUTĖS;43737882488;Taip;0;7;0;7
8233;Ramunėlė;SAULUTĖS;72681762872;Taip;0;12;0;12
8234;Ramunėlė;SAULUTĖS;37338389480;Taip;0;7;0;7
8235;Ramunėlė;SAULUTĖS;7736649569;Taip;0;7;0;7
8236;Ramunėlė;SAULUTĖS;97944093065;Taip;0;7;0;7
8237;Ramunėlė;SAULUTĖS;85972695257;Taip;0;8;0;8
8238;Ramunėlė;SAULUTĖS;99807372989;Taip;5;8;0;13
8239;Ramunėlė;SAULUTĖS;42746084302;Taip;5;8;0;13
8240;Ramunėlė;SAULUTĖS;18362159086;Taip;0;8;0;8
8241;Ramunėlė;ŽIBUTĖ;2127262855;Taip;0;8;0;8
8242;Ramunėlė;ŽIBUTĖ;71451001033;Taip;0;7;0;7
8243;Ramunėlė;ŽIBUTĖ;8943746426;Taip;0;7;0;7
8244;Ramunėlė;ŽIBUTĖ;57697488265;Taip;5;9;0;14
8245;Ramunėlė;ŽIBUTĖ;4103951942;Taip;0;11;0;11
8246;Ramunėlė;ŽIBUTĖ;37227575121;Ne;0;10;0;10
8247;Ramunėlė;ŽIBUTĖ;9615607625;Taip;0;11;0;11
8248;Ramunėlė;ŽIBUTĖ;24395304267;Ne;10;8;0;18
8249;Ramunėlė;ŽIBUTĖ;41210974793;Taip;0;7;0;7
8250;Ramunėlė;ŽIBUTĖ;78632810141;Taip;0;7;4;11
8251;Ramunėlė;ŽIBUTĖ;8826277893;Taip;0;9;0;9
8252;Ramunėlė;ŽIBUTĖ;573414969;Taip;4;7;0;11
8253;Ramunėlė;ŽIBUTĖ;1686559920;Taip;0;12;0;12
8254;Ramunėlė;ŽIBUTĖ;1383896021;Taip;0;9;7;16
8255;Ramunėlė;ŽIBUTĖ;1898089064;Ne;13;9;0;22
8256;Ramunėlė;ŽIBUTĖ;6126971384;Taip;8;7;0;15
8257;Ramunėlė;ŽIBUTĖ;21178777924;Taip;0;9;0;9
8258;Ramunėlė;ŽIBUTĖ;1845973626;Taip;0;7;0;7
8259;Ramunėlė;ŽIBUTĖ;1575204445;Ne;0;9;0;9
8260;Ramunėlė;ŽIBUTĖ;2069380818;Taip;0;7;2;9
8261;Ramunėlė;ŽIBUTĖ;1511271386;Ne;0;9;0;9
8262;Ramunėlė;ŽIRNIUKAI;11512621396;Taip;0;6;0;6
8263;Ramunėlė;ŽIRNIUKAI;3973083939;Taip;0;6;0;6
8264;Ramunėlė;ŽIRNIUKAI;53748116108;Taip;0;7;0;7
8265;Ramunėlė;ŽIRNIUKAI;1028730863;Taip;0;6;0;6
8266;Ramunėlė;ŽIRNIUKAI;1085668968;Taip;0;6;0;6
8267;Ramunėlė;ŽIRNIUKAI;2075485387;Taip;0;8;3;11
8268;Ramunėlė;ŽIRNIUKAI;2036562086;Taip;0;8;0;8
8269;Ramunėlė;ŽIRNIUKAI;85179822339;Taip;7;6;0;13
8270;Ramunėlė;ŽIRNIUKAI;57963557951;Taip;5;6;0;11
8271;Ramunėlė;ŽIRNIUKAI;1485876800;Taip;0;6;0;6
8272;Ramunėlė;ŽIRNIUKAI;9924675250;Taip;0;2;0;2
8273;Ramunėlė;ŽIRNIUKAI;1386186515;Taip;0;11;0;11
8274;Ramunėlė;ŽIRNIUKAI;1364997950;Taip;0;8;0;8
8275;Ramunėlė;ŽIRNIUKAI;1171170929;Taip;0;9;0;9
8276;Ramunėlė;ŽIRNIUKAI;10677635919;Taip;0;10;0;10
8277;Ramunėlė;ŽIRNIUKAI;1397784717;Taip;0;1;0;1
8278;Ramunėlė;ŽIRNIUKAI;17292085814;Taip;0;7;0;7
8279;Ramunėlė;ŽIRNIUKAI;1500685962;Ne;0;11;0;11
8280;Ramunėlė;ŽIRNIUKAI;4814208279;Ne;0;7;0;7
8281;Ramunėlė;ŽIRNIUKAI;8254302108;Taip;0;6;0;6
8282;Ramunėlė;BITUTĖS;23095478847;Taip;0;22;0;22
8283;Ramunėlė;BITUTĖS;1866642357;Ne;0;10;0;10
8284;Ramunėlė;BITUTĖS;95100104105;Ne;6;8;1;15
8285;Ramunėlė;BITUTĖS;32249506035;Ne;5;8;0;13
8286;Ramunėlė;BITUTĖS;42582811243;Taip;0;8;0;8
8287;Ramunėlė;BITUTĖS;3683430430;Taip;0;8;0;8
8288;Ramunėlė;BITUTĖS;4101387438;Taip;0;7;0;7
8289;Ramunėlė;BITUTĖS;16357824257;Taip;2;12;0;14
8290;Ramunėlė;BITUTĖS;1012658900;Taip;0;12;0;12
8291;Ramunėlė;BITUTĖS;1485483496;Taip;0;10;0;10
8292;Ramunėlė;BITUTĖS;1090204906;Taip;0;8;0;8
8293;Ramunėlė;BITUTĖS;9961229084;Taip;10;7;0;17
8294;Ramunėlė;BITUTĖS;8098492540;Taip;6;10;0;16
8295;Ramunėlė;BITUTĖS;17201639406;Taip;0;7;4;11
8296;Ramunėlė;BITUTĖS;3065727741;Taip;10;7;0;17
8297;Ramunėlė;BITUTĖS;19420482998;Ne;0;11;0;11
8298;Ramunėlė;BITUTĖS;9130637883;Taip;0;19;0;19
8299;Ramunėlė;BITUTĖS;8016643568;Taip;0;9;0;9
8300;Ramunėlė;BITUTĖS;6217540064;Ne;0;9;1;10
8301;Ramunėlė;BITUTĖS;4990982790;Taip;10;7;0;17
8302;Ramunėlė;BITUTĖS;9171690612;Taip;0;9;7;16
8303;Ramunėlė;BITUTĖS;3271832822;Ne;10;7;0;17
8304;Ramunėlė;DRUGELIAI;15310034187;Taip;0;9;0;9
8305;Ramunėlė;DRUGELIAI;25346770513;Ne;3;9;3;15
8306;Ramunėlė;DRUGELIAI;28838673166;Ne;0;7;0;7
8307;Ramunėlė;DRUGELIAI;1253351354;Taip;0;8;6;14
8308;Ramunėlė;DRUGELIAI;13195968349;Taip;0;12;0;12
8309;Ramunėlė;DRUGELIAI;84319432445;Ne;0;9;0;9
8310;Ramunėlė;DRUGELIAI;26152001976;Ne;0;12;0;12
8311;Ramunėlė;DRUGELIAI;22306706669;Taip;0;12;0;12
8312;Ramunėlė;DRUGELIAI;76947701645;Taip;0;7;2;9
8313;Ramunėlė;DRUGELIAI;1175561112;Taip;2;7;0;9
8314;Ramunėlė;DRUGELIAI;1478538572;Taip;0;9;0;9
8315;Ramunėlė;DRUGELIAI;72620475723;Ne;6;7;0;13
8316;Ramunėlė;DRUGELIAI;92929314036;Taip;0;8;0;8
8317;Ramunėlė;DRUGELIAI;9017349382;Taip;0;6;2;8
8318;Ramunėlė;DRUGELIAI;1376538015;Ne;0;5;0;5
8319;Ramunėlė;DRUGELIAI;1783572058;Taip;0;8;0;8
8320;Ramunėlė;DRUGELIAI;30907738272;Ne;0;9;1;10
8321;Ramunėlė;DRUGELIAI;1083479451;Taip;3;0;0;3
8322;Ramunėlė;DRUGELIAI;1891454355;Ne;9;8;0;17
8323;Ramunėlė;DRUGELIAI;1814199950;Taip;0;6;0;6
8324;Ramunėlė;DRUGELIAI;1199690327;Taip;0;7;0;7
8325;Ramunėlė;DRUGELIAI;1988109236;Taip;0;8;0;8
8326;Ramunėlė;DRUGELIAI;52168460247;Taip;0;7;0;7
8327;Ramunėlė;DRUGELIAI;66630134164;Taip;6;7;0;13
8328;Ramunėlė;NEUŽMIRŠTUOLĖS;7220407572;Taip;3;0;0;3
8329;Ramunėlė;NEUŽMIRŠTUOLĖS;7307307882;Taip;0;3;0;3
8330;Ramunėlė;NEUŽMIRŠTUOLĖS;5975101402;Taip;8;2;2;12
8331;Ramunėlė;NEUŽMIRŠTUOLĖS;8940763540;Taip;0;7;3;10
8332;Ramunėlė;NEUŽMIRŠTUOLĖS;5822045625;Taip;2;7;0;9
8333;Ramunėlė;NEUŽMIRŠTUOLĖS;2225787182;Taip;0;18;0;18
8334;Ramunėlė;NEUŽMIRŠTUOLĖS;6329943991;Taip;5;7;0;12
8335;Ramunėlė;NEUŽMIRŠTUOLĖS;8086994543;Taip;0;7;0;7
8336;Ramunėlė;OBUOLIUKAI;67836032797;Taip;0;13;0;13
8337;Ramunėlė;OBUOLIUKAI;7228065409;Taip;8;7;1;16
8338;Ramunėlė;OBUOLIUKAI;8402889872;Taip;5;7;1;13
8339;Ramunėlė;OBUOLIUKAI;1745170057;Taip;0;9;3;12
8340;Ramunėlė;OBUOLIUKAI;5170325023;Taip;0;7;1;8
8341;Ramunėlė;OBUOLIUKAI;8768539595;Taip;0;11;0;11
8342;Ramunėlė;OBUOLIUKAI;2055332353;Taip;8;7;1;16
8343;Ramunėlė;OBUOLIUKAI;2567264851;Taip;0;7;7;14
8344;Ramunėlė;OBUOLIUKAI;9584620339;Taip;10;7;0;17
8345;Ramunėlė;OBUOLIUKAI;6930505887;Taip;0;8;0;8
8346;Ramunėlė;OBUOLIUKAI;1199673371;Taip;4;7;0;11
8347;Ramunėlė;OBUOLIUKAI;3617897977;Taip;0;7;0;7
8348;Ramunėlė;OBUOLIUKAI;7955507702;Taip;0;0;2;2
8349;Ramunėlė;OBUOLIUKAI;58573425792;Taip;0;7;2;9
8350;Ramunėlė;OBUOLIUKAI;67836032797;Taip;0;13;0;13
8351;Ramunėlė;OBUOLIUKAI;1078618047;Taip;0;20;0;20
8352;Ramunėlė;OBUOLIUKAI;6348171102;Taip;0;7;0;7
8353;Ramunėlė;OBUOLIUKAI;4392309015;Taip;0;7;0;7
8354;Ramunėlė;OBUOLIUKAI;5049415445;Taip;0;7;10;17
8355;Ramunėlė;OBUOLIUKAI;1800967823;Taip;0;1;0;1
8356;Ramunėlė;OBUOLIUKAI;8656417794;Taip;7;7;1;15
8357;Ramunėlė;OBUOLIUKAI;8205893352;Taip;0;9;0;9
8358;Ramunėlė;SAULĖGRĄŽA;9927068798;Taip;6;7;0;13
8359;Ramunėlė;SAULĖGRĄŽA;8762832644;Ne;7;0;0;7
8360;Ramunėlė;SAULĖGRĄŽA;3852734401;Taip;0;7;0;7
8361;Ramunėlė;SAULĖGRĄŽA;1483391590;Taip;0;9;0;9
8362;Ramunėlė;SAULĖGRĄŽA;8929122197;Taip;0;1;0;1
8363;Ramunėlė;SAULĖGRĄŽA;7219400182;Taip;0;7;0;7
8364;Ramunėlė;SAULĖGRĄŽA;5605444408;Taip;0;7;0;7
8365;Ramunėlė;SAULĖGRĄŽA;4575123456;Taip;5;9;8;22
8366;Ramunėlė;SAULĖGRĄŽA;1192743154;Taip;8;7;0;15
8367;Ramunėlė;SAULĖGRĄŽA;5562960498;Taip;0;15;0;15
8368;Ramunėlė;SAULĖGRĄŽA;6134554678;Taip;11;11;0;22
8369;Ramunėlė;SAULĖGRĄŽA;8726443989;Taip;0;15;0;15
8370;Ramunėlė;SAULĖGRĄŽA;1599595174;Taip;0;8;0;8
8371;Ramunėlė;SAULĖGRĄŽA;3779769727;Taip;0;10;0;10
8372;Ramunėlė;SAULĖGRĄŽA;8323020864;Taip;0;7;0;7
8373;Ramunėlė;SAULĖGRĄŽA;8912978935;Taip;0;9;0;9
8374;Ramunėlė;SAULĖGRĄŽA;5420360864;Taip;11;8;0;19
8375;Ramunėlė;SAULĖGRĄŽA;7902931560;Taip;5;9;0;14
8376;Ramunėlė;SAULĖGRĄŽA;5714771643;Taip;0;1;0;1
8377;Ramunėlė;BORUŽĖLĖS;82024687579;Taip;0;10;0;10
8378;Ramunėlė;BORUŽĖLĖS;1563618796;Taip;6;2;0;8
8379;Ramunėlė;BORUŽĖLĖS;1946639898;Taip;6;7;0;13
8380;Ramunėlė;BORUŽĖLĖS;63470398650;Taip;5;7;0;12
8381;Ramunėlė;BORUŽĖLĖS;1827657363;Taip;0;8;0;8
8382;Ramunėlė;BORUŽĖLĖS;1642082135;Taip;0;7;0;7
8383;Ramunėlė;BORUŽĖLĖS;1176835101;Taip;0;7;0;7
8384;Ramunėlė;BORUŽĖLĖS;1341351994;Taip;0;13;0;13
8385;Ramunėlė;BORUŽĖLĖS;1041998279;Taip;0;9;2;11
8386;Ramunėlė;BORUŽĖLĖS;2859202237;Taip;10;7;0;17
8387;Ramunėlė;BORUŽĖLĖS;1709795078;Taip;9;8;0;17
8388;Ramunėlė;BORUŽĖLĖS;1077068878;Taip;0;9;1;10
8389;Ramunėlė;BORUŽĖLĖS;1207455851;Taip;0;7;0;7
8390;Ramunėlė;BORUŽĖLĖS;1405532116;Taip;5;7;0;12
8391;Ramunėlė;BORUŽĖLĖS;76195144469;Taip;0;7;0;7
8392;Ramunėlė;BORUŽĖLĖS;1690224857;Taip;0;7;3;10
8393;Ramunėlė;BORUŽĖLĖS;1058243928;Taip;10;8;0;18
8394;Ramunėlė;BORUŽĖLĖS;93125217886;Taip;5;7;0;12
8395;Ramunėlė;BORUŽĖLĖS;17273267465;Taip;0;8;0;8
8396;Ramunėlė;BORUŽĖLĖS;1033548164;Taip;0;3;0;3
8397;Ramunėlė;BORUŽĖLĖS;1439962940;Taip;0;7;0;7
8398;Ramunėlė;NYKŠTUKAS;7250951221;Taip;4;0;0;4
8399;Ramunėlė;NYKŠTUKAS;2427399083;Taip;0;1;0;1
8400;Ramunėlė;NYKŠTUKAS;5316468106;Taip;0;0;2;2
8401;Ramunėlė;NYKŠTUKAS;4233978236;Taip;5;0;0;5
8402;Ramunėlė;NYKŠTUKAS;7622952406;Taip;0;2;1;3
8403;Ramunėlė;NYKŠTUKAS;6156792400;Taip;0;1;0;1
8404;Ramunėlė;NYKŠTUKAS;2422656007;Taip;0;0;2;2
8405;Ramunėlė;NYKŠTUKAS;5465647281;Taip;0;11;0;11
8406;Ramunėlė;NYKŠTUKAS;6809164145;Taip;0;7;0;7
8407;Ramunėlė;NYKŠTUKAS;9984243153;Taip;0;8;0;8
8408;Ramunėlė;NYKŠTUKAS;6184872126;Taip;0;7;0;7
8409;Ramunėlė;NYKŠTUKAS;7829765488;Taip;4;7;2;13
8410;Ramunėlė;NYKŠTUKAS;9217815657;Taip;6;0;0;6
8411;Ramunėlė;UOGELĖ;3996453947;Taip;0;3;0;3
8412;Ramunėlė;UOGELĖ;2591052434;Taip;0;4;0;4
8413;Ramunėlė;UOGELĖ;6389008823;Taip;4;0;0;4
8414;Ramunėlė;UOGELĖ;1671759939;Taip;5;0;0;5
8415;Ramunėlė;UOGELĖ;5315953299;Taip;10;7;0;17
8416;Ramunėlė;UOGELĖ;9136437288;Taip;7;0;0;7
8417;Ramunėlė;UOGELĖ;5801760033;Taip;0;2;0;2
8418;Ramunėlė;UOGELĖ;6627399830;Taip;0;6;0;6
8419;Ramunėlė;UOGELĖ;2605941371;Taip;0;1;0;1
8420;Ramunėlė;UOGELĖ;3525444906;Taip;0;1;0;1
8421;Ramunėlė;UOGELĖ;1916520056;Taip;8;0;0;8
8422;Ramunėlė;UOGELĖ;8055844166;Taip;3;0;0;3
8423;Ramunėlė;UOGELĖ;5650659504;Taip;0;7;0;7
8424;Ramunėlė;UOGELĖ;4715809064;Taip;0;9;0;9
8425;Ramunėlė;UOGELĖ;5650659504;Taip;0;7;0;7
8426;Ramunėlė;VARPELIAI;1534723406;Taip;0;7;0;7
8427;Ramunėlė;VARPELIAI;6837072361;Taip;0;8;0;8
8428;Ramunėlė;VARPELIAI;3566074517;Taip;0;11;0;11
8429;Ramunėlė;VARPELIAI;3685786758;Taip;0;11;0;11
8430;Ramunėlė;VARPELIAI;2007790746;Taip;0;7;0;7
8431;Ramunėlė;VARPELIAI;6310921755;Taip;0;7;0;7
8432;Ramunėlė;VARPELIAI;1303053333;Taip;0;7;0;7
8433;Ramunėlė;VARPELIAI;4349250416;Taip;0;12;0;12
8434;Ramunėlė;VARPELIAI;4677819736;Taip;0;12;0;12
8435;Ramunėlė;VARPELIAI;2499280049;Taip;0;13;0;13
8436;Ramunėlė;VARPELIAI;9448369796;Taip;0;7;1;8
8437;Ramunėlė;VARPELIAI;7750405604;Taip;5;8;0;13
8438;Ramunėlė;VARPELIAI;6695672297;Taip;2;7;0;9
8439;Ramunėlė;VARPELIAI;7825538259;Taip;0;17;0;17
8440;Ramunėlė;VARPELIAI;58028743912;Taip;12;7;0;19
8441;Ramunėlė;VARPELIAI;6612728883;Taip;0;7;0;7
8442;Ramunėlė;VARPELIAI;1567537525;Taip;0;9;1;10
8443;Ramunėlė;VARPELIAI;1216101539;Taip;0;19;0;19
8444;Ramunėlė;VARPELIAI;7638038269;Taip;0;8;0;8
8445;Ramunėlė;VARPELIAI;3554787356;Ne;5;7;1;13
8446;Ramunėlė;VARPELIAI;8496322672;Taip;0;7;2;9
8447;Rūta;SMALSUČIAI;14391882157;Taip;0;1;0;1
8448;Rūta;SMALSUČIAI;18117978189;Ne;0;0;2;2
8449;Rūta;SMALSUČIAI;77285178781;Taip;5;2;1;8
8450;Rūta;SMALSUČIAI;89046897963;Taip;0;3;0;3
8451;Rūta;SMALSUČIAI;26152518052;Taip;14;0;0;14
8452;Rūta;SMALSUČIAI;68107516536;Ne;0;2;0;2
8453;Rūta;SMALSUČIAI;87692898919;Taip;0;0;2;2
8454;Rūta;SMALSUČIAI;1937805277;Taip;5;0;0;5
8455;Rūta;SMALSUČIAI;3874247966;Taip;0;0;1;1
8456;Rūta;SMALSUČIAI;8604212304;Taip;0;4;0;4
8457;Rūta;SMALSUČIAI;50814418724;Ne;0;8;0;8
8458;Rūta;SMALSUČIAI;1364470800;Taip;0;0;1;1
8459;Rūta;SMALSUČIAI;1996690514;Taip;7;1;0;8
8460;Rūta;SMALSUČIAI;59694891781;Taip;5;4;0;9
8461;Rūta;SMALSUČIAI;83473072263;Taip;5;0;0;5
8462;Rūta;KŪLVERSTUKAI;80410156050;Taip;0;7;0;7
8463;Rūta;KŪLVERSTUKAI;1150292834;Ne;2;13;0;15
8464;Rūta;KŪLVERSTUKAI;56171468735;Taip;0;9;0;9
8465;Rūta;KŪLVERSTUKAI;88159609117;Taip;0;3;0;3
8466;Rūta;KŪLVERSTUKAI;2084379688;Taip;0;4;0;4
8467;Rūta;KŪLVERSTUKAI;1807332522;Taip;0;1;0;1
8468;Rūta;KŪLVERSTUKAI;1674584707;Taip;0;12;0;12
8469;Rūta;KŪLVERSTUKAI;2079429418;Taip;0;7;0;7
8470;Rūta;KŪLVERSTUKAI;1972150300;Taip;0;4;0;4
8471;Rūta;KŪLVERSTUKAI;99777522247;Taip;0;5;0;5
8472;Rūta;KŪLVERSTUKAI;1971925569;Taip;0;5;2;7
8473;Rūta;KŪLVERSTUKAI;56470874552;Taip;1;5;0;6
8474;Rūta;KŪLVERSTUKAI;17349566042;Taip;11;6;0;17
8475;Rūta;KŪLVERSTUKAI;1043614414;Taip;0;5;0;5
8476;Rūta;KŪLVERSTUKAI;1703148668;Taip;4;0;0;4
8477;Rūta;KODĖLČIUKAI;2546023973;Taip;0;0;8;8
8478;Rūta;KODĖLČIUKAI;1775029025;Taip;5;0;1;6
8479;Rūta;KODĖLČIUKAI;8958880558;Taip;9;0;0;9
8480;Rūta;KODĖLČIUKAI;2263820829;Taip;8;0;1;9
8481;Rūta;KODĖLČIUKAI;2485048971;Taip;6;0;2;8
8482;Rūta;KODĖLČIUKAI;5109138407;Taip;8;0;2;10
8483;Rūta;KODĖLČIUKAI;2286358230;Taip;0;0;10;10
8484;Rūta;KODĖLČIUKAI;8599313527;Taip;10;0;1;11
8485;Rūta;KODĖLČIUKAI;6186413364;Taip;0;0;1;1
8486;Rūta;KODĖLČIUKAI;6458458913;Taip;6;0;0;6
8487;Rūta;BORUŽĖLĖS;8273644943;Taip;0;0;8;8
8488;Rūta;BORUŽĖLĖS;4293920701;Taip;0;1;0;1
8489;Rūta;BORUŽĖLĖS;9419809946;Taip;0;2;0;2
8490;Rūta;BORUŽĖLĖS;3454881685;Taip;0;6;0;6
8491;Rūta;BORUŽĖLĖS;1510268514;Taip;0;5;0;5
8492;Rūta;BORUŽĖLĖS;2702537976;Taip;0;0;5;5
8493;Rūta;BORUŽĖLĖS;4044349935;Taip;0;9;0;9
8494;Rūta;BORUŽĖLĖS;7936198171;Taip;0;0;4;4
8495;Rūta;BORUŽĖLĖS;9243332756;Taip;0;0;9;9
8496;Rūta;BORUŽĖLĖS;2772130413;Taip;0;0;4;4
8497;Rūta;VYTURĖLIAI;69788516459;Taip;0;0;2;2
8498;Rūta;VYTURĖLIAI;78925728976;Ne;3;0;3;6
8499;Rūta;VYTURĖLIAI;44365150696;Taip;15;0;0;15
8500;Rūta;VYTURĖLIAI;10957816153;Ne;0;1;1;2
8501;Rūta;VYTURĖLIAI;2033577529;Taip;0;1;0;1
8502;Rūta;VYTURĖLIAI;79762491266;Taip;0;0;4;4
8503;Rūta;VYTURĖLIAI;76831234529;Taip;0;0;2;2
8504;Rūta;VYTURĖLIAI;24211514845;Taip;0;6;0;6
8505;Rūta;VYTURĖLIAI;48213220767;Ne;0;6;0;6
8506;Rūta;VYTURĖLIAI;28158130932;Taip;0;0;2;2
8507;Rūta;VYTURĖLIAI;50266063379;Ne;0;1;3;4
8508;Rūta;VYTURĖLIAI;28676981495;Taip;0;3;0;3
8509;Rūta;VYTURĖLIAI;91072621203;Taip;0;9;0;9
8510;Rūta;VYTURĖLIAI;34935546673;Taip;0;2;3;5
8511;Rūta;VYTURĖLIAI;47869128534;Taip;0;2;4;6
8512;Rūta;VYTURĖLIAI;67740925555;Taip;11;0;0;11
8513;Rūta;"PABIRUČIAI (LOGOPEDINĖ)";1489564914;Taip;0;15;0;15
8514;Rūta;"PABIRUČIAI (LOGOPEDINĖ)";6891385410;Ne;0;0;1;1
8515;Rūta;"PABIRUČIAI (LOGOPEDINĖ)";3055294324;Ne;0;0;4;4
8516;Rūta;"PABIRUČIAI (LOGOPEDINĖ)";3247709788;Taip;0;3;0;3
8517;Rūta;"PABIRUČIAI (LOGOPEDINĖ)";1035527190;Taip;0;0;1;1
8518;Rūta;"PABIRUČIAI (LOGOPEDINĖ)";6136733410;Taip;0;0;5;5
8519;Rūta;GUDRUČIAI;1967141665;Ne;5;0;0;5
8520;Rūta;GUDRUČIAI;3873876608;Taip;3;0;0;3
8521;Rūta;GUDRUČIAI;8851591109;Taip;12;0;2;14
8522;Rūta;GUDRUČIAI;1180144866;Taip;1;0;2;3
8523;Rūta;GUDRUČIAI;3478456813;Taip;0;2;0;2
8524;Rūta;GUDRUČIAI;8889388348;Taip;0;0;1;1
8525;Rūta;GUDRUČIAI;2116581815;Taip;2;0;6;8
8526;Rūta;GUDRUČIAI;4363571135;Taip;0;13;0;13
8527;Rūta;GUDRUČIAI;6006094035;Taip;0;1;0;1
8528;Rūta;GUDRUČIAI;1521231573;Ne;13;0;2;15
8529;Rūta;GUDRUČIAI;7552644990;Taip;3;0;2;5
8530;Rūta;GUDRUČIAI;8673942478;Taip;0;0;10;10
8531;Rūta;GUDRUČIAI;4078957924;Taip;0;0;4;4
8532;Rūta;GUDRUČIAI;4754142240;Taip;5;0;2;7
8533;Rūta;GUDRUČIAI;1565896222;Taip;0;0;5;5
8534;Rūta;GUDRUČIAI;8704594038;Taip;7;0;3;10
8535;Rūta;GUDRUČIAI;7631229177;Taip;6;0;1;7
8536;Rūta;SEKLYTĖLĖ;1800198849;Taip;0;8;0;8
8537;Rūta;SEKLYTĖLĖ;54140704807;Taip;0;5;0;5
8538;Rūta;SEKLYTĖLĖ;26830853793;Taip;7;0;0;7
8539;Rūta;SEKLYTĖLĖ;75322385068;Taip;0;10;0;10
8540;Rūta;SEKLYTĖLĖ;76518034714;Taip;0;3;0;3
8541;Rūta;SEKLYTĖLĖ;79192262053;Ne;10;1;0;11
8542;Rūta;SEKLYTĖLĖ;42791864630;Taip;0;7;0;7
8543;Rūta;SEKLYTĖLĖ;20967345257;Taip;0;10;0;10
8544;Rūta;SEKLYTĖLĖ;50734030014;Taip;4;0;1;5
8545;Rūta;SEKLYTĖLĖ;29240858006;Taip;5;0;5;10
8546;Rūta;SEKLYTĖLĖ;75730421646;Ne;0;5;0;5
8547;Rūta;SEKLYTĖLĖ;2711671531;Taip;0;0;3;3
8548;Rūta;SEKLYTĖLĖ;9994442882;Taip;0;3;0;3
8549;Rūta;SEKLYTĖLĖ;29483136582;Taip;0;5;0;5
8550;Rūta;SEKLYTĖLĖ;1545183162;Ne;0;0;2;2
8551;Rūta;SEKLYTĖLĖ;5733023163;Taip;0;0;1;1
8552;Rūta;SEKLYTĖLĖ;7061384784;Taip;0;0;5;5
8553;Rūta;"VARPELIAI (LOGOPEDINĖ)";8657192724;Taip;9;0;0;9
8554;Rūta;"VARPELIAI (LOGOPEDINĖ)";70608720189;Taip;0;5;0;5
8555;Rūta;"VARPELIAI (LOGOPEDINĖ)";97812491022;Taip;3;0;0;3
8556;Rūta;"VARPELIAI (LOGOPEDINĖ)";57805651069;Taip;5;0;4;9
8557;Rūta;"VARPELIAI (LOGOPEDINĖ)";58313529531;Taip;12;0;0;12
8558;Rūta;KIŠKUČIŲ;4297300799;Taip;0;13;0;13
8559;Rūta;KIŠKUČIŲ;6207902435;Taip;0;6;0;6
8560;Rūta;KIŠKUČIŲ;9791861646;Taip;0;0;3;3
8561;Rūta;KIŠKUČIŲ;7434152435;Ne;0;0;1;1
8562;Rūta;KIŠKUČIŲ;8182243701;Taip;0;13;5;18
8563;Rūta;KIŠKUČIŲ;4728904136;Taip;0;11;0;11
8564;Rūta;KIŠKUČIŲ;6316768460;Taip;10;0;0;10
8565;Rūta;KIŠKUČIŲ;2928803089;Taip;5;2;0;7
8566;Rūta;KIŠKUČIŲ;3875136625;Taip;10;0;0;10
8567;Rūta;KIŠKUČIŲ;5899860543;Taip;0;0;5;5
8568;Rūta;KIŠKUČIŲ;8378318357;Ne;9;0;3;12
8569;Rūta;KIŠKUČIŲ;9603105651;Taip;9;0;2;11
8570;Rūta;KIŠKUČIŲ;6285841968;Taip;2;0;0;2
8571;Rūta;KIŠKUČIŲ;1951202550;Taip;8;0;2;10
8572;Rūta;KIŠKUČIŲ;9911151238;Taip;0;7;2;9
8573;Rūta;ŽVIRBLIUKAI;3499727608;Taip;8;7;0;15
8574;Rūta;ŽVIRBLIUKAI;9765301038;Taip;8;7;0;15
8575;Rūta;ŽVIRBLIUKAI;8277677952;Taip;7;0;0;7
8576;Rūta;ŽVIRBLIUKAI;9638495757;Taip;17;0;0;17
8577;Rūta;ŽVIRBLIUKAI;3956912957;Ne;5;0;1;6
8578;Rūta;ŽVIRBLIUKAI;3055345528;Taip;6;4;0;10
8579;Rūta;ŽVIRBLIUKAI;4423305209;Ne;0;2;0;2
8580;Rūta;ŽVIRBLIUKAI;2890569107;Taip;0;0;6;6
8581;Rūta;ŽVIRBLIUKAI;3964922552;Taip;13;0;0;13
8582;Rūta;ŽVIRBLIUKAI;1216786487;Taip;11;6;0;17
8583;Rūta;ŽVIRBLIUKAI;9736567509;Taip;0;0;1;1
8584;Rūta;ŽVIRBLIUKAI;2474991135;Taip;0;0;3;3
8585;Rūta;ŽVIRBLIUKAI;7519931138;Taip;0;0;2;2
8586;Rūta;ŽVIRBLIUKAI;9400586178;Taip;0;0;5;5
8587;Rūta;ŽVIRBLIUKAI;8395765508;Taip;0;0;1;1
8588;Rūta;ŽVIRBLIUKAI;7222494215;Taip;0;0;8;8
8589;Rūta;ŽVIRBLIUKAI;5264690055;Taip;0;0;6;6
8590;Rūta;ŽVIRBLIUKAI;1962172243;Taip;3;0;5;8
8591;Rūta;ŽVIRBLIUKAI;7553844890;Taip;0;0;8;8
8592;Rūta;ŽVIRBLIUKAI;8605070655;Taip;0;0;5;5
8593;Rūta;SAULUTĖS;1186493111;Taip;0;5;0;5
8594;Rūta;SAULUTĖS;9675482322;Ne;0;7;1;8
8595;Rūta;SAULUTĖS;1415664888;Taip;4;0;7;11
8596;Rūta;SAULUTĖS;4426456302;Taip;5;0;2;7
8597;Rūta;SAULUTĖS;6982618655;Ne;0;3;0;3
8598;Rūta;SAULUTĖS;4282074540;Taip;6;0;2;8
8599;Rūta;SAULUTĖS;8607455403;Taip;0;1;0;1
8600;Rūta;SAULUTĖS;4168356825;Taip;0;0;4;4
8601;Rūta;SAULUTĖS;9569447586;Taip;0;2;0;2
8602;Rūta;SAULUTĖS;1579573872;Taip;0;0;1;1
8603;Rūta;SAULUTĖS;2677062861;Taip;9;0;0;9
8604;Rūta;SAULUTĖS;1390207547;Taip;0;1;1;2
8605;Rūta;SAULUTĖS;32004750783;Taip;0;0;7;7
8606;Rūta;SAULUTĖS;5866619097;Taip;0;0;2;2
8607;Sadutė;Kiškučiai;38918375280;Taip;0;11;0;11
8608;Sadutė;Kiškučiai;42447771280;Taip;0;1;0;1
8609;Sadutė;Kiškučiai;62408324442;Taip;1;0;0;1
8610;Sadutė;Kiškučiai;12421864073;Taip;0;1;1;2
8611;Sadutė;Kiškučiai;98527988102;Taip;0;5;0;5
8612;Sadutė;Kiškučiai;62077575922;Ne;0;0;2;2
8613;Sadutė;Kiškučiai;75149739907;Taip;0;1;0;1
8614;Sadutė;Kiškučiai;48298497;Taip;2;0;0;2
8615;Sadutė;Kiškučiai;61357382189;Taip;3;1;0;4
8616;Sadutė;Kiškučiai;1433422421;Taip;0;0;3;3
8617;Sadutė;Kiškučiai;73649870571;Taip;10;10;0;20
8618;Sadutė;Kiškučiai;1092421263;Taip;3;0;0;3
8619;Sadutė;Kiškučiai;1291782232;Taip;0;0;3;3
8620;Sadutė;Kiškučiai;5586949339;Taip;9;0;3;12
8621;Sadutė;Kiškučiai;9883685724;Taip;4;2;0;6
8622;Sadutė;Kiškučiai;4525909977;Taip;8;0;0;8
8623;Sadutė;Kiškučiai;1533081218;Taip;0;9;5;14
8624;Sadutė;Kiškučiai;3400524440;Taip;0;0;2;2
8625;Sadutė;Boružėlės;31020557647;Taip;6;0;0;6
8626;Sadutė;Boružėlės;30046732620;Taip;5;0;1;6
8627;Sadutė;Boružėlės;70505797915;Taip;0;0;2;2
8628;Sadutė;Boružėlės;48817619537;Taip;5;1;0;6
8629;Sadutė;Boružėlės;76464399248;Taip;0;0;3;3
8630;Sadutė;Boružėlės;47883796567;Taip;0;1;0;1
8631;Sadutė;Boružėlės;48327367042;Taip;0;0;5;5
8632;Sadutė;Boružėlės;4064111008;Taip;0;0;1;1
8633;Sadutė;Boružėlės;35237170892;Taip;0;1;0;1
8634;Sadutė;Boružėlės;45569403734;Taip;0;6;0;6
8635;Sadutė;Boružėlės;15950584691;Taip;5;0;1;6
8636;Sadutė;Boružėlės;2414632774;Taip;2;0;0;2
8637;Sadutė;Boružėlės;16493384211;Taip;5;0;3;8
8638;Sadutė;Boružėlės;71576294118;Ne;0;0;3;3
8639;Sadutė;Boružėlės;21011440269;Ne;0;0;3;3
8640;Sadutė;Boružėlės;39222963335;Ne;2;0;1;3
8641;Sadutė;Boružėlės;4695479762;Taip;0;0;3;3
8642;Sadutė;Boružėlės;1920496059;Taip;10;1;1;12
8643;Sadutė;Bitutės;1759479328;Taip;0;2;3;5
8644;Sadutė;Bitutės;1873928395;Taip;0;10;0;10
8645;Sadutė;Bitutės;8140354445;Taip;0;1;0;1
8646;Sadutė;Bitutės;9107727583;Ne;3;0;0;3
8647;Sadutė;Bitutės;4479315578;Taip;5;0;0;5
8648;Sadutė;Bitutės;2020766695;Taip;14;0;0;14
8649;Sadutė;Bitutės;5011320850;Taip;3;0;0;3
8650;Sadutė;Bitutės;5169694660;Taip;0;1;2;3
8651;Sadutė;Drugeliai;1552350084;Taip;2;1;0;3
8652;Sadutė;Drugeliai;7910380894;Taip;0;0;1;1
8653;Sadutė;Drugeliai;2467800545;Taip;4;0;1;5
8654;Sadutė;Drugeliai;4402558234;Taip;0;2;0;2
8655;Sadutė;Drugeliai;8713575864;Taip;0;2;0;2
8656;Sadutė;Drugeliai;6994547344;Taip;0;0;1;1
8657;Sadutė;Drugeliai;1782594187;Ne;1;2;0;3
8658;Sadutė;Drugeliai;5816844295;Taip;2;0;0;2
8659;Sadutė;Drugeliai;2095914442;Ne;3;0;0;3
8660;Sadutė;Drugeliai;8803249656;Taip;9;0;2;11
8661;Sadutė;Drugeliai;4901634532;Taip;0;5;0;5
8662;Sadutė;Drugeliai;6196282159;Taip;10;0;2;12
8663;Sadutė;Drugeliai;8953107298;Taip;17;0;0;17
8664;Sadutė;Drugeliai;5139219626;Taip;0;0;3;3
8665;Sadutė;Drugeliai;1735450955;Taip;0;2;0;2
8666;Sadutė;Drugeliai;2064784580;Taip;0;2;0;2
8667;Sadutė;Drugeliai;2883991326;Taip;0;3;0;3
8668;Sadutė;Drugeliai;7731164484;Taip;5;0;0;5
8669;Sadutė;Drugeliai;2014660237;Taip;7;0;2;9
8670;Sadutė;Drugeliai;6124376554;Taip;5;0;1;6
8671;Sadutė;Pėledžiukai;50662732693;Taip;0;0;12;12
8672;Sadutė;Pėledžiukai;26761581977;Taip;0;2;0;2
8673;Sadutė;Pėledžiukai;1885941594;Taip;0;8;0;8
8674;Sadutė;Pėledžiukai;4933574100;Taip;8;0;2;10
8675;Sadutė;Pėledžiukai;6105924871;Taip;5;0;2;7
8676;Sadutė;Pėledžiukai;8870465478;Ne;7;5;0;12
8677;Sadutė;Pėledžiukai;64835095908;Taip;4;0;1;5
8678;Sadutė;Pėledžiukai;3619323573;Taip;0;8;2;10
8679;Sadutė;Pėledžiukai;14962142857;Taip;5;4;0;9
8680;Sadutė;Pėledžiukai;92111253012;Taip;0;0;1;1
8681;Sadutė;Pėledžiukai;1594844154;Ne;0;0;1;1
8682;Sadutė;Pėledžiukai;1005751811;Taip;10;0;0;10
8683;Sadutė;Pėledžiukai;45981672295;Taip;5;0;1;6
8684;Sadutė;Pėledžiukai;5864572784;Taip;0;0;2;2
8685;Sadutė;Pėledžiukai;8667620186;Taip;0;0;2;2
8686;Sadutė;Pėledžiukai;9946417453;Ne;0;4;0;4
8687;Sadutė;Pėledžiukai;48818906299;Ne;0;0;4;4
8688;Sadutė;Pėledžiukai;1190667513;Taip;5;6;0;11
8689;Sadutė;Pėledžiukai;1988169256;Taip;0;7;0;7
8690;Sadutė;Kačiukų;1507052440;Taip;0;0;9;9
8691;Sadutė;Kačiukų;1903961488;Taip;0;0;1;1
8692;Sadutė;Kačiukų;2890916313;Taip;0;0;6;6
8693;Sadutė;Kačiukų;2733633163;Taip;0;0;1;1
8694;Sadutė;Kačiukų;3993181500;Taip;0;0;1;1
8695;Sadutė;Kačiukų;1871236869;Taip;0;2;0;2
8696;Sadutė;Kačiukų;8835627470;Taip;6;0;1;7
8697;Sadutė;Kačiukų;2466024649;Taip;3;0;0;3
8698;Sadutė;Kačiukų;6253351299;Taip;0;0;2;2
8699;Sadutė;Kačiukų;2426974464;Taip;4;3;1;8
8700;Sadutė;Kačiukų;5438448926;Taip;0;0;1;1
8701;Sadutė;Kačiukų;8974374101;Taip;5;1;2;8
8702;Sadutė;Kačiukų;4401870028;Taip;0;0;1;1
8703;Sadutė;Kačiukų;8714168144;Taip;0;0;1;1
8704;Sadutė;Kačiukų;8770727233;Taip;8;0;0;8
8705;Sakalėlis;GIRINUKŲ;9566176151;Ne;13;0;0;13
8706;Sakalėlis;GIRINUKŲ;2895663259;Taip;5;0;0;5
8707;Sakalėlis;GIRINUKŲ;5405669698;Ne;10;0;0;10
8708;Sakalėlis;GIRINUKŲ;2474164013;Ne;10;0;2;12
8709;Sakalėlis;GIRINUKŲ;9493905856;Taip;10;0;4;14
8710;Sakalėlis;GIRINUKŲ;5496044442;Taip;15;0;2;17
8711;Sakalėlis;GIRINUKŲ;3165387995;Taip;0;0;2;2
8712;Sakalėlis;GIRINUKŲ;6603105354;Ne;10;0;0;10
8713;Sakalėlis;GIRINUKŲ;3418702674;Taip;0;0;2;2
8714;Sakalėlis;GIRINUKŲ;6700169944;Taip;5;0;3;8
8715;Sakalėlis;GIRINUKŲ;3333037807;Taip;0;2;0;2
8716;Sakalėlis;GIRINUKŲ;8667155756;Ne;8;0;0;8
8717;Sakalėlis;GIRINUKŲ;4596727938;Taip;0;0;1;1
8718;Sakalėlis;GIRINUKŲ;6706466627;Taip;0;7;0;7
8719;Sakalėlis;GIRINUKŲ;8790189865;Taip;5;0;0;5
8720;Sakalėlis;GIRINUKŲ;4458071075;Taip;8;5;0;13
8721;Sakalėlis;GIRINUKŲ;2780141413;Taip;0;8;0;8
8722;Sakalėlis;GIRINUKŲ;1347171934;Taip;22;0;0;22
8723;Sakalėlis;GIRINUKŲ;9823633774;Taip;3;0;4;7
8724;Sakalėlis;VYTURIUKŲ;7852180045;Taip;0;5;2;7
8725;Sakalėlis;VYTURIUKŲ;27291131963;Taip;0;1;3;4
8726;Sakalėlis;VYTURIUKŲ;25558438129;Taip;0;2;2;4
8727;Sakalėlis;VYTURIUKŲ;33360718659;Taip;0;0;1;1
8728;Sakalėlis;VYTURIUKŲ;99937511623;Taip;0;0;2;2
8729;Sakalėlis;VYTURIUKŲ;14495611614;Taip;0;0;1;1
8730;Sakalėlis;VYTURIUKŲ;32956243898;Taip;0;0;1;1
8731;Sakalėlis;VYTURIUKŲ;87806505145;Taip;0;0;2;2
8732;Sakalėlis;VYTURIUKŲ;59067963901;Taip;0;0;3;3
8733;Sakalėlis;VYTURIUKŲ;1371469574;Taip;0;9;0;9
8734;Sakalėlis;VYTURIUKŲ;60351276074;Taip;0;0;1;1
8735;Sakalėlis;VYTURIUKŲ;74622921410;Taip;0;0;5;5
8736;Sakalėlis;VYTURIUKŲ;13953070987;Taip;4;0;1;5
8737;Sakalėlis;VYTURIUKŲ;12474715312;Taip;0;0;7;7
8738;Sakalėlis;VYTURIUKŲ;80747256105;Taip;0;0;4;4
8739;Sakalėlis;VYTURIUKŲ;77801416034;Taip;0;11;5;16
8740;Sakalėlis;VYTURIUKŲ;12601081196;Ne;0;0;2;2
8741;Sakalėlis;DRUGELIŲ;97259304899;Taip;5;0;3;8
8742;Sakalėlis;DRUGELIŲ;1605682818;Taip;0;4;0;4
8743;Sakalėlis;DRUGELIŲ;68379930730;Taip;0;0;1;1
8744;Sakalėlis;DRUGELIŲ;57477662126;Taip;0;0;2;2
8745;Sakalėlis;DRUGELIŲ;78050507580;Taip;0;7;3;10
8746;Sakalėlis;DRUGELIŲ;11432510669;Taip;0;1;0;1
8747;Sakalėlis;DRUGELIŲ;19456041826;Taip;0;1;7;8
8748;Sakalėlis;DRUGELIŲ;28930740067;Taip;0;6;0;6
8749;Sakalėlis;DRUGELIŲ;88344653299;Taip;0;4;0;4
8750;Sakalėlis;DRUGELIŲ;87950904971;Taip;6;1;1;8
8751;Sakalėlis;DRUGELIŲ;44702801581;Taip;0;0;2;2
8752;Sakalėlis;DRUGELIŲ;1075787529;Taip;0;0;5;5
8753;Sakalėlis;DRUGELIŲ;1421038685;Taip;0;7;0;7
8754;Sakalėlis;DRUGELIŲ;2124748537;Ne;0;7;3;10
8755;Sakalėlis;DRUGELIŲ;1538847469;Taip;0;0;1;1
8756;Sakalėlis;DRUGELIŲ;9634589602;Taip;5;0;3;8
8757;Sakalėlis;DRUGELIŲ;4583569438;Taip;0;0;5;5
8758;Sakalėlis;DRUGELIŲ;23064985127;Taip;10;0;0;10
8759;Sakalėlis;GENIUKŲ;1526540031;Ne;0;7;0;7
8760;Sakalėlis;GENIUKŲ;4763858893;Taip;0;0;8;8
8761;Sakalėlis;GENIUKŲ;3337299648;Taip;0;12;4;16
8762;Sakalėlis;GENIUKŲ;9830907922;Taip;0;2;0;2
8763;Sakalėlis;GENIUKŲ;43677485606;Taip;0;15;0;15
8764;Sakalėlis;GENIUKŲ;5717022080;Taip;5;0;1;6
8765;Sakalėlis;GENIUKŲ;4515180509;Taip;0;5;0;5
8766;Sakalėlis;GENIUKŲ;1027765680;Ne;12;0;0;12
8767;Sakalėlis;GENIUKŲ;81681433432;Taip;0;0;1;1
8768;Sakalėlis;GENIUKŲ;96053733139;Taip;0;7;0;7
8769;Sakalėlis;GENIUKŲ;4612388683;Taip;10;10;0;20
8770;Sakalėlis;GENIUKŲ;7159705304;Taip;2;0;0;2
8771;Sakalėlis;GENIUKŲ;69916351348;Taip;8;0;0;8
8772;Sakalėlis;GENIUKŲ;6727251397;Taip;0;9;0;9
8773;Sakalėlis;GENIUKŲ;1552929452;Taip;12;0;0;12
8774;Sakalėlis;GENIUKŲ;8936933971;Taip;0;11;3;14
8775;Sakalėlis;GENIUKŲ;2829386777;Taip;0;1;1;2
8776;Sakalėlis;GENIUKŲ;3371763993;Taip;13;0;0;13
8777;Sakalėlis;GENIUKŲ;7085108710;Taip;5;0;3;8
8778;Sakalėlis;VOVERIUKŲ;4430763418;Taip;0;5;0;5
8779;Sakalėlis;VOVERIUKŲ;6190741162;Ne;8;0;0;8
8780;Sakalėlis;VOVERIUKŲ;1702964714;Taip;15;0;0;15
8781;Sakalėlis;VOVERIUKŲ;1839096675;Ne;0;0;3;3
8782;Sakalėlis;VOVERIUKŲ;3962436122;Taip;0;1;0;1
8783;Sakalėlis;VOVERIUKŲ;1946531018;Taip;7;0;1;8
8784;Sakalėlis;VOVERIUKŲ;2796230671;Taip;5;0;1;6
8785;Sakalėlis;VOVERIUKŲ;1210451022;Taip;0;0;1;1
8786;Sakalėlis;VOVERIUKŲ;8662137531;Taip;5;0;0;5
8787;Sakalėlis;VOVERIUKŲ;46629941288;Taip;0;5;0;5
8788;Sakalėlis;VOVERIUKŲ;3678172501;Taip;0;5;0;5
8789;Sakalėlis;VOVERIUKŲ;1133377117;Taip;0;0;2;2
8790;Sakalėlis;VOVERIUKŲ;5782214279;Taip;0;7;3;10
8791;Sakalėlis;VOVERIUKŲ;22614338778;Taip;5;0;0;5
8792;Sakalėlis;VOVERIUKŲ;34464485043;Taip;12;0;0;12
8793;Sakalėlis;VOVERIUKŲ;7567476424;Taip;6;0;2;8
8794;Sakalėlis;VOVERIUKŲ;6180987643;Taip;0;0;1;1
8795;Sakalėlis;VOVERIUKŲ;8852001037;Taip;0;0;7;7
8796;Sakalėlis;PĖLEDŽIUKŲ;1974955778;Taip;0;0;4;4
8797;Sakalėlis;PĖLEDŽIUKŲ;69254656227;Ne;3;0;1;4
8798;Sakalėlis;PĖLEDŽIUKŲ;4573623341;Taip;7;0;6;13
8799;Sakalėlis;PĖLEDŽIUKŲ;1359444361;Taip;0;0;1;1
8800;Sakalėlis;PĖLEDŽIUKŲ;3781188811;Taip;2;0;2;4
8801;Sakalėlis;PĖLEDŽIUKŲ;32890764904;Taip;0;0;2;2
8802;Sakalėlis;PĖLEDŽIUKŲ;89579043958;Taip;0;4;0;4
8803;Sakalėlis;PĖLEDŽIUKŲ;54902207576;Taip;0;6;0;6
8804;Sakalėlis;PĖLEDŽIUKŲ;81593611262;Taip;0;0;3;3
8805;Sakalėlis;PĖLEDŽIUKŲ;33825546706;Taip;0;0;3;3
8806;Sakalėlis;PĖLEDŽIUKŲ;1790571847;Taip;0;10;0;10
8807;Sakalėlis;PĖLEDŽIUKŲ;81361557297;Taip;0;6;14;20
8808;Sakalėlis;PĖLEDŽIUKŲ;39504139934;Taip;9;0;0;9
8809;Sakalėlis;PĖLEDŽIUKŲ;67193921335;Taip;0;1;5;6
8810;Sakalėlis;PĖLEDŽIUKŲ;6301366135;Taip;3;0;0;3
8811;Sakalėlis;PĖLEDŽIUKŲ;49947049847;Taip;0;0;1;1
8812;Sakalėlis;PĖLEDŽIUKŲ;36670171187;Taip;0;0;1;1
8813;Sakalėlis;PĖLEDŽIUKŲ;4364341933;Taip;5;0;1;6
8814;Sakalėlis;PĖLEDŽIUKŲ;79413947806;Taip;0;0;1;1
8815;Sakalėlis;"BITUČIŲ (LOGOPEDINĖ)";4649447372;Taip;0;0;9;9
8816;Sakalėlis;"BITUČIŲ (LOGOPEDINĖ)";1219441890;Taip;0;0;1;1
8817;Sakalėlis;"BITUČIŲ (LOGOPEDINĖ)";4086981816;Ne;0;0;15;15
8818;Sakalėlis;"BITUČIŲ (LOGOPEDINĖ)";4716949191;Taip;5;0;2;7
8819;Sakalėlis;"BITUČIŲ (LOGOPEDINĖ)";7241416465;Ne;0;0;2;2
8820;Sakalėlis;"BITUČIŲ (LOGOPEDINĖ)";6321575268;Taip;5;0;1;6
8821;Sakalėlis;"BITUČIŲ (LOGOPEDINĖ)";4857211754;Taip;7;0;0;7
8822;Sakalėlis;"BITUČIŲ (LOGOPEDINĖ)";5377250664;Ne;0;0;3;3
8823;Sakalėlis;"BITUČIŲ (LOGOPEDINĖ)";1384225025;Ne;9;0;2;11
8824;Sakalėlis;"BITUČIŲ (LOGOPEDINĖ)";46481555688;Taip;15;0;2;17
8825;Sakalėlis;"BITUČIŲ (LOGOPEDINĖ)";5018151097;Taip;9;0;2;11
8826;Sakalėlis;"BORUŽIUKŲ (LOGOPEDINĖ)";92557587855;Ne;12;0;0;12
8827;Sakalėlis;"BORUŽIUKŲ (LOGOPEDINĖ)";22863239773;Taip;8;0;2;10
8828;Sakalėlis;"BORUŽIUKŲ (LOGOPEDINĖ)";9452901338;Taip;0;1;0;1
8829;Sakalėlis;"BORUŽIUKŲ (LOGOPEDINĖ)";4514546151;Ne;5;2;0;7
8830;Sakalėlis;"BORUŽIUKŲ (LOGOPEDINĖ)";50037388220;Taip;0;17;0;17
8831;Sakalėlis;"BORUŽIUKŲ (LOGOPEDINĖ)";9740003273;Taip;0;0;1;1
8832;Sakalėlis;"BORUŽIUKŲ (LOGOPEDINĖ)";2074868084;Taip;0;22;0;22
8833;Sakalėlis;MEŠKUČIŲ;4136266629;Taip;0;0;5;5
8834;Sakalėlis;MEŠKUČIŲ;6840368824;Taip;5;0;0;5
8835;Sakalėlis;MEŠKUČIŲ;6250400609;Taip;1;0;1;2
8836;Sakalėlis;MEŠKUČIŲ;3927487265;Taip;5;0;0;5
8837;Sakalėlis;MEŠKUČIŲ;1742362136;Taip;7;0;1;8
8838;Sakalėlis;MEŠKUČIŲ;9322351120;Taip;0;0;19;19
8839;Sakalėlis;MEŠKUČIŲ;7672947538;Taip;11;0;0;11
8840;Sakalėlis;MEŠKUČIŲ;5233697077;Taip;12;0;0;12
8841;Sakalėlis;MEŠKUČIŲ;3680732318;Ne;0;10;0;10
8842;Sakalėlis;MEŠKUČIŲ;4862004373;Ne;10;0;0;10
8843;Sakalėlis;MEŠKUČIŲ;6579827280;Taip;12;0;0;12
8844;Sakalėlis;MEŠKUČIŲ;6806170544;Taip;5;0;0;5
8845;Sakalėlis;MEŠKUČIŲ;2539006620;Taip;0;22;0;22
8846;Sakalėlis;MEŠKUČIŲ;8381310908;Taip;10;0;0;10
8847;Sakalėlis;MEŠKUČIŲ;5795250727;Taip;0;10;0;10
8848;Sakalėlis;MEŠKUČIŲ;2985239904;Taip;0;1;0;1
8849;Sakalėlis;MEŠKUČIŲ;3351218789;Ne;0;0;7;7
8850;Sakalėlis;MEŠKUČIŲ;4986131090;Taip;0;1;0;1
8851;Sakalėlis;MEŠKUČIŲ;3927363997;Taip;14;2;0;16
8852;Sakalėlis;MEŠKUČIŲ;9120873899;Taip;0;22;0;22
8853;Sakalėlis;MEŠKUČIŲ;2352118061;Taip;7;0;3;10
8854;Sakalėlis;KIŠKUČIŲ;1201086815;Taip;0;0;1;1
8855;Sakalėlis;KIŠKUČIŲ;4918228191;Taip;6;0;0;6
8856;Sakalėlis;KIŠKUČIŲ;9272347788;Taip;0;5;0;5
8857;Sakalėlis;KIŠKUČIŲ;1117800518;Taip;15;0;0;15
8858;Sakalėlis;KIŠKUČIŲ;6515519140;Taip;13;0;0;13
8859;Sakalėlis;KIŠKUČIŲ;8095359035;Taip;9;0;0;9
8860;Sakalėlis;KIŠKUČIŲ;7542322748;Taip;17;0;0;17
8861;Sakalėlis;KIŠKUČIŲ;3934295338;Taip;10;0;0;10
8862;Sakalėlis;SVIRPLIUKŲ;3574956316;Taip;6;0;0;6
8863;Sakalėlis;SVIRPLIUKŲ;7602249339;Taip;15;0;0;15
8864;Sakalėlis;SVIRPLIUKŲ;6027680514;Taip;13;0;0;13
8865;Sakalėlis;SVIRPLIUKŲ;1403384561;Taip;5;0;0;5
8866;Sakalėlis;SVIRPLIUKŲ;4358313171;Taip;15;0;0;15
8867;Sakalėlis;SVIRPLIUKŲ;3936986473;Taip;0;0;10;10
8868;Sakalėlis;SVIRPLIUKŲ;6414564366;Taip;4;0;5;9
8869;Sakalėlis;SVIRPLIUKŲ;1833573491;Taip;5;0;1;6
8870;Sakalėlis;SVIRPLIUKŲ;1200252225;Taip;10;0;0;10
8871;Sakalėlis;SVIRPLIUKŲ;2531146677;Taip;15;0;0;15
8872;Sakalėlis;SVIRPLIUKŲ;8133985842;Taip;0;0;2;2
8873;Sakalėlis;SVIRPLIUKŲ;7280513854;Taip;9;2;0;11
8874;Sakalėlis;SVIRPLIUKŲ;6778987483;Taip;7;0;5;12
8875;Salininkų;BORUŽIUKAI;2467926286;Taip;0;8;3;11
8876;Salininkų;BORUŽIUKAI;8774984357;Taip;0;0;4;4
8877;Salininkų;BORUŽIUKAI;6577237672;Taip;0;0;1;1
8878;Salininkų;BORUŽIUKAI;6125152143;Taip;3;0;1;4
8879;Salininkų;BORUŽIUKAI;2095952937;Taip;3;0;0;3
8880;Salininkų;BORUŽIUKAI;7115888747;Taip;0;0;3;3
8881;Salininkų;BORUŽIUKAI;6551489987;Taip;10;3;0;13
8882;Salininkų;BORUŽIUKAI;1928897962;Taip;1;0;0;1
8883;Salininkų;BORUŽIUKAI;5582091833;Taip;0;0;1;1
8884;Salininkų;BORUŽIUKAI;9996809930;Taip;7;0;2;9
8885;Salininkų;BORUŽIUKAI;4480303856;Taip;10;0;0;10
8886;Salininkų;BORUŽIUKAI;3915336062;Taip;13;0;0;13
8887;Salininkų;BORUŽIUKAI;2073939432;Ne;6;0;1;7
8888;Salininkų;GĖLYTĖS;3015863723;Taip;11;5;0;16
8889;Salininkų;GĖLYTĖS;3323233525;Taip;11;5;0;16
8890;Salininkų;GĖLYTĖS;1832393272;Taip;0;7;0;7
8891;Salininkų;GĖLYTĖS;7665409499;Taip;4;0;2;6
8892;Salininkų;GĖLYTĖS;9890660815;Taip;8;0;5;13
8893;Salininkų;GĖLYTĖS;6850925495;Taip;2;0;3;5
8894;Salininkų;GĖLYTĖS;3585435095;Taip;5;0;0;5
8895;Salininkų;GĖLYTĖS;2760231414;Taip;12;1;0;13
8896;Salininkų;GĖLYTĖS;9724367035;Taip;10;0;0;10
8897;Salininkų;GĖLYTĖS;1658695150;Taip;0;0;9;9
8898;Salininkų;GĖLYTĖS;7383557807;Taip;5;6;0;11
8899;Salininkų;GĖLYTĖS;9344614003;Taip;3;3;0;6
8900;Salininkų;GĖLYTĖS;2808778763;Taip;0;10;0;10
8901;Salininkų;GĖLYTĖS;6656578271;Ne;3;0;3;6
8902;Salininkų;GĖLYTĖS;8995565864;Taip;10;4;0;14
8903;Salininkų;GĖLYTĖS;8394582546;Taip;0;4;0;4
8904;Salininkų;GĖLYTĖS;6327046935;Taip;3;0;0;3
8905;Salininkų;GĖLYTĖS;4323257798;Taip;0;2;0;2
8906;Salininkų;GĖLYTĖS;5427013789;Taip;0;5;0;5
8907;Salininkų;GĖLYTĖS;3100499807;Taip;0;4;0;4
8908;Salininkų;GĖLYTĖS;7782972361;Taip;0;1;0;1
8909;Salininkų;GĖLYTĖS;7737045952;Taip;5;0;0;5
8910;Salininkų;DRUGELIAI;1641123436;Taip;17;0;0;17
8911;Salininkų;DRUGELIAI;1910467994;Taip;0;1;0;1
8912;Salininkų;DRUGELIAI;2812554783;Taip;5;0;1;6
8913;Salininkų;DRUGELIAI;14626363996;Taip;12;0;0;12
8914;Salininkų;DRUGELIAI;1948988168;Taip;4;0;3;7
8915;Salininkų;DRUGELIAI;1868857584;Ne;0;0;4;4
8916;Salininkų;DRUGELIAI;5434294777;Taip;0;0;1;1
8917;Salininkų;DRUGELIAI;1815368137;Taip;8;0;1;9
8918;Salininkų;DRUGELIAI;8157811781;Taip;0;12;0;12
8919;Salininkų;DRUGELIAI;1963139815;Ne;10;0;0;10
8920;Salininkų;DRUGELIAI;45194646218;Taip;0;12;0;12
8921;Salininkų;DRUGELIAI;6125334614;Taip;4;0;0;4
8922;Salininkų;DRUGELIAI;15199054558;Ne;0;7;0;7
8923;Salininkų;DRUGELIAI;8081095896;Ne;0;0;3;3
8924;Salininkų;DRUGELIAI;1568780329;Taip;0;8;2;10
8925;Salininkų;DRUGELIAI;30123603107;Ne;10;0;0;10
8926;Salininkų;DRUGELIAI;9074440999;Taip;5;5;1;11
8927;Salininkų;DRUGELIAI;8410624264;Taip;0;5;0;5
8928;Salininkų;ŽIRNIUKAI;5063792784;Taip;5;0;3;8
8929;Salininkų;ŽIRNIUKAI;73016259669;Taip;0;2;0;2
8930;Salininkų;ŽIRNIUKAI;76449285846;Taip;0;2;4;6
8931;Salininkų;ŽIRNIUKAI;1180792335;Taip;3;0;0;3
8932;Salininkų;ŽIRNIUKAI;22167560908;Taip;0;2;0;2
8933;Salininkų;ŽIRNIUKAI;9513785510;Taip;12;0;0;12
8934;Salininkų;ŽIRNIUKAI;2292919406;Taip;12;4;0;16
8935;Salininkų;ŽIRNIUKAI;10335028421;Taip;2;0;2;4
8936;Salininkų;ŽIRNIUKAI;8488127476;Taip;0;0;3;3
8937;Salininkų;ŽIRNIUKAI;46867660097;Taip;10;3;0;13
8938;Salininkų;ŽIRNIUKAI;4269202761;Taip;12;0;4;16
8939;Salininkų;ŽIRNIUKAI;3692008687;Taip;0;14;0;14
8940;Salininkų;ŽIRNIUKAI;1065549119;Taip;5;0;0;5
8941;Salininkų;ŽIRNIUKAI;8288199783;Taip;0;7;0;7
8942;Salininkų;ŽIRNIUKAI;1460694577;Taip;3;1;0;4
8943;Salininkų;PAUKŠČIUKAI;1202154135;Taip;0;0;2;2
8944;Salininkų;PAUKŠČIUKAI;1521333219;Taip;0;1;0;1
8945;Salininkų;PAUKŠČIUKAI;95919160139;Taip;20;0;0;20
8946;Salininkų;PAUKŠČIUKAI;67593920224;Ne;0;6;0;6
8947;Salininkų;PAUKŠČIUKAI;81888649482;Taip;2;0;0;2
8948;Salininkų;PAUKŠČIUKAI;1153455356;Taip;0;10;0;10
8949;Salininkų;PAUKŠČIUKAI;1470744233;Taip;0;10;0;10
8950;Salininkų;PAUKŠČIUKAI;2031724954;Taip;6;3;0;9
8951;Salininkų;PAUKŠČIUKAI;52499970010;Taip;3;0;0;3
8952;Salininkų;PAUKŠČIUKAI;18178857793;Taip;0;5;0;5
8953;Salininkų;PAUKŠČIUKAI;1439852031;Taip;10;3;0;13
8954;Salininkų;PAUKŠČIUKAI;20609963605;Taip;5;0;0;5
8955;Salininkų;PAUKŠČIUKAI;52194170807;Taip;5;9;0;14
8956;Salininkų;PAUKŠČIUKAI;86019335524;Taip;5;9;0;14
8957;Salininkų;PAUKŠČIUKAI;1586012117;Taip;0;3;0;3
8958;Salininkų;PAUKŠČIUKAI;2415539904;Taip;0;2;0;2
8959;Salininkų;PAUKŠČIUKAI;29341671329;Taip;0;5;0;5
8960;Salininkų;PAUKŠČIUKAI;3878896109;Taip;7;10;0;17
8961;Salininkų;PAUKŠČIUKAI;16967442608;Taip;7;4;0;11
8962;Salininkų;PAUKŠČIUKAI;7918995181;Taip;0;0;1;1
8963;Salvija;Daigelis(šatil);1261005294;Taip;5;0;0;5
8964;Salvija;Daigelis(šatil);3424917706;Ne;10;4;0;14
8965;Salvija;Daigelis(šatil);4152602039;Taip;10;0;0;10
8966;Salvija;Daigelis(šatil);7546216874;Taip;5;6;0;11
8967;Salvija;Daigelis(šatil);3856351749;Taip;4;14;0;18
8968;Salvija;Daigelis(šatil);1653831148;Taip;0;6;0;6
8969;Salvija;Daigelis(šatil);8013023311;Taip;0;0;2;2
8970;Salvija;Daigelis(šatil);8023422294;Taip;0;22;0;22
8971;Salvija;Daigelis(šatil);7449993309;Taip;5;13;0;18
8972;Salvija;Daigelis(šatil);8158680641;Taip;5;0;0;5
8973;Salvija;Daigelis(šatil);3487446998;Taip;5;0;0;5
8974;Salvija;Daigelis(šatil);6706565915;Taip;0;11;0;11
8975;Salvija;Daigelis(šatil);5723168506;Ne;7;2;0;9
8976;Salvija;Daigelis(šatil);8853389268;Taip;0;7;0;7
8977;Salvija;"Pienė (savjon)";22615390885;Taip;9;8;1;18
8978;Salvija;"Pienė (savjon)";9168718017;Taip;14;8;0;22
8979;Salvija;"Pienė (savjon)";4167467237;Taip;9;0;0;9
8980;Salvija;"Pienė (savjon)";1641242817;Taip;0;7;0;7
8981;Salvija;"Pienė (savjon)";58888784609;Taip;0;4;0;4
8982;Salvija;"Pienė (savjon)";4845744417;Taip;0;5;0;5
8983;Salvija;"Pienė (savjon)";5494438837;Taip;0;0;2;2
8984;Salvija;"Pienė (savjon)";8798739147;Taip;8;0;1;9
8985;Salvija;"Pienė (savjon)";1103379012;Taip;0;6;0;6
8986;Salvija;"Pienė (savjon)";7361435128;Taip;0;0;3;3
8987;Salvija;"Pienė (savjon)";1777783229;Taip;0;3;0;3
8988;Salvija;"Pienė (savjon)";1396698456;Ne;0;4;0;4
8989;Salvija;"Pienė (savjon)";1478775998;Taip;22;0;0;22
8990;Salvija;"Pienė (savjon)";8802891478;Ne;10;0;1;11
8991;Salvija;"Pienė (savjon)";24038366791;Taip;9;0;1;10
8992;Salvija;"Pienė (savjon)";5784594015;Taip;6;0;0;6
8993;Salvija;"Pienė (savjon)";1517130961;Ne;11;0;0;11
8994;Salvija;"Pienė (savjon)";8725965215;Taip;0;0;1;1
8995;Salvija;"Pienė (savjon)";9908473681;Taip;0;0;7;7
8996;Saulėtekis;BERŽELIS;37001834066;Taip;5;0;1;6
8997;Saulėtekis;BERŽELIS;29935189464;Ne;0;0;1;1
8998;Saulėtekis;BERŽELIS;95214907923;Taip;0;1;0;1
8999;Saulėtekis;BERŽELIS;49102885577;Taip;0;6;0;6
9000;Saulėtekis;BERŽELIS;18801492293;Taip;3;0;0;3
9001;Saulėtekis;BERŽELIS;43809213927;Taip;0;1;0;1
9002;Saulėtekis;BERŽELIS;17046444483;Taip;0;0;1;1
9003;Saulėtekis;BERŽELIS;14357681543;Taip;0;0;1;1
9004;Saulėtekis;BERŽELIS;27109020149;Taip;0;3;0;3
9005;Saulėtekis;BERŽELIS;42952333477;Taip;3;0;0;3
9006;Saulėtekis;BERŽELIS;19786161536;Taip;0;1;0;1
9007;Saulėtekis;BERŽELIS;55975992548;Taip;0;7;0;7
9008;Saulėtekis;BERŽELIS;49746307178;Taip;0;0;4;4
9009;Saulėtekis;BERŽELIS;9632257866;Taip;0;0;1;1
9010;Saulėtekis;BERŽELIS;24403133622;Taip;0;4;0;4
9011;Saulėtekis;BERŽELIS;7440287746;Taip;0;3;0;3
9012;Saulėtekis;BERŽELIS;19209281962;Taip;0;0;3;3
9013;Saulėtekis;BERŽELIS;2096996257;Taip;5;0;1;6
9014;Saulėtekis;ŠYPSENA;1720125332;Taip;0;1;0;1
9015;Saulėtekis;ŠYPSENA;9972687066;Taip;8;2;0;10
9016;Saulėtekis;ŠYPSENA;7346852524;Ne;13;0;5;18
9017;Saulėtekis;ŠYPSENA;1902333363;Taip;5;5;0;10
9018;Saulėtekis;ŠYPSENA;7893982893;Taip;3;0;0;3
9019;Saulėtekis;ŠYPSENA;7505040675;Taip;8;0;0;8
9020;Saulėtekis;ŠYPSENA;6501250875;Taip;2;0;0;2
9021;Saulėtekis;ŠYPSENA;9791926936;Taip;9;5;0;14
9022;Saulėtekis;ŠYPSENA;8620689981;Taip;0;3;0;3
9023;Saulėtekis;ŠYPSENA;8143793642;Taip;8;3;0;11
9024;Saulėtekis;ŠYPSENA;9783450998;Taip;0;1;0;1
9025;Saulėtekis;ŠYPSENA;4909850069;Taip;0;4;0;4
9026;Saulėtekis;ŠYPSENA;7673965242;Taip;7;0;0;7
9027;Saulėtekis;ŠYPSENA;3166959569;Taip;12;0;0;12
9028;Saulėtekis;ŠYPSENA;9661075465;Taip;6;0;0;6
9029;Saulėtekis;ŠYPSENA;2154590089;Ne;5;4;0;9
9030;Saulėtekis;ŠYPSENA;9383567339;Taip;7;2;0;9
9031;Saulėtekis;ŠYPSENA;4610536784;Ne;0;7;0;7
9032;Saulėtekis;NYKŠTUKAI;81074197598;Taip;5;2;0;7
9033;Saulėtekis;NYKŠTUKAI;87539304992;Taip;0;1;0;1
9034;Saulėtekis;NYKŠTUKAI;75818502835;Taip;5;0;0;5
9035;Saulėtekis;NYKŠTUKAI;1623791240;Taip;4;4;0;8
9036;Saulėtekis;NYKŠTUKAI;46936348504;Taip;0;3;0;3
9037;Saulėtekis;NYKŠTUKAI;47570401883;Taip;7;2;0;9
9038;Saulėtekis;NYKŠTUKAI;1288313734;Taip;0;3;0;3
9039;Saulėtekis;NYKŠTUKAI;1267706132;Ne;4;5;0;9
9040;Saulėtekis;NYKŠTUKAI;9333073549;Taip;7;1;0;8
9041;Saulėtekis;NYKŠTUKAI;75785868657;Taip;0;1;0;1
9042;Saulėtekis;NYKŠTUKAI;45284061866;Taip;1;0;0;1
9043;Saulėtekis;NYKŠTUKAI;1064355395;Taip;0;7;0;7
9044;Saulėtekis;NYKŠTUKAI;1691667254;Taip;8;5;0;13
9045;Saulėtekis;NYKŠTUKAI;6736441901;Taip;0;5;0;5
9046;Saulėtekis;NYKŠTUKAI;1466627555;Taip;0;3;0;3
9047;Saulėtekis;NYKŠTUKAI;29552225924;Taip;2;0;0;2
9048;Saulėtekis;NYKŠTUKAI;1111323783;Taip;0;5;0;5
9049;Saulėtekis;NYKŠTUKAI;21569877958;Taip;5;0;0;5
9050;Saulėtekis;NYKŠTUKAI;5104259667;Taip;14;0;0;14
9051;Saulėtekis;PAGRANDUKAS;8102360466;Taip;10;0;0;10
9052;Saulėtekis;PAGRANDUKAS;2371396923;Taip;8;0;0;8
9053;Saulėtekis;PAGRANDUKAS;4152255439;Taip;0;5;0;5
9054;Saulėtekis;PAGRANDUKAS;2209156661;Taip;0;0;6;6
9055;Saulėtekis;PAGRANDUKAS;3220993253;Taip;13;0;0;13
9056;Saulėtekis;PAGRANDUKAS;5552614092;Taip;2;0;0;2
9057;Saulėtekis;PAGRANDUKAS;9497129509;Taip;5;6;0;11
9058;Saulėtekis;PAGRANDUKAS;9918219913;Taip;4;0;1;5
9059;Saulėtekis;PAGRANDUKAS;8517049464;Taip;12;0;1;13
9060;Saulėtekis;PAGRANDUKAS;7186085219;Taip;4;11;0;15
9061;Saulėtekis;PAGRANDUKAS;1020209414;Taip;12;0;0;12
9062;Saulėtekis;PAGRANDUKAS;8745921541;Taip;12;0;0;12
9063;Saulėtekis;PAGRANDUKAS;2728836108;Taip;0;1;0;1
9064;Saulėtekis;PAGRANDUKAS;8390615573;Ne;6;0;0;6
9065;Saulėtekis;PAGRANDUKAS;2698535938;Taip;0;1;0;1
9066;Saulėtekis;PAGRANDUKAS;2656659133;Taip;0;9;0;9
9067;Saulėtekis;PAGRANDUKAS;7164579375;Taip;5;1;0;6
9068;Saulėtekis;PAGRANDUKAS;5678858566;Taip;6;3;0;9
9069;Saulėtekis;PAGRANDUKAS;4101644021;Taip;0;9;0;9
9070;Saulėtekis;PAGRANDUKAS;3366064429;Taip;0;0;2;2
9071;Saulėtekis;PAGRANDUKAS;8574702901;Taip;5;0;1;6
9072;Saulėtekis;RAMUNĖLIŲ;70948000188;Taip;0;1;0;1
9073;Saulėtekis;RAMUNĖLIŲ;23797246535;Taip;3;0;0;3
9074;Saulėtekis;RAMUNĖLIŲ;16450627896;Ne;0;0;3;3
9075;Saulėtekis;RAMUNĖLIŲ;77630031851;Taip;0;0;2;2
9076;Saulėtekis;RAMUNĖLIŲ;31291807930;Ne;5;1;0;6
9077;Saulėtekis;RAMUNĖLIŲ;42485505048;Ne;0;1;0;1
9078;Saulėtekis;RAMUNĖLIŲ;86593254070;Taip;0;0;2;2
9079;Saulėtekis;RAMUNĖLIŲ;40093795729;Taip;0;0;2;2
9080;Saulėtekis;RAMUNĖLIŲ;10524532865;Taip;10;2;0;12
9081;Saulėtekis;RAMUNĖLIŲ;1219435678;Taip;0;5;0;5
9082;Saulėtekis;RAMUNĖLIŲ;29662148323;Taip;0;1;0;1
9083;Saulėtekis;RAMUNĖLIŲ;3394231244;Taip;22;0;0;22
9084;Saulėtekis;RAMUNĖLIŲ;7544912614;Taip;5;5;0;10
9085;Saulėtekis;RAMUNĖLIŲ;1349303787;Taip;3;0;1;4
9086;Saulėtekis;RAMUNĖLIŲ;9611990012;Taip;0;0;1;1
9087;Saulėtekis;PASAKAITĖ;5086871001;Taip;10;5;0;15
9088;Saulėtekis;PASAKAITĖ;9012655883;Ne;0;0;3;3
9089;Saulėtekis;PASAKAITĖ;6979741482;Taip;5;0;0;5
9090;Saulėtekis;PASAKAITĖ;6063956790;Taip;0;0;2;2
9091;Saulėtekis;PASAKAITĖ;4437540996;Taip;5;0;0;5
9092;Saulėtekis;PASAKAITĖ;7407451018;Taip;5;0;1;6
9093;Saulėtekis;PASAKAITĖ;9226317303;Taip;5;0;1;6
9094;Saulėtekis;PASAKAITĖ;6670590135;Taip;6;0;1;7
9095;Saulėtekis;PASAKAITĖ;6720758829;Taip;0;0;4;4
9096;Saulėtekis;VARPELIAI;94326821425;Taip;0;12;0;12
9097;Saulėtekis;VARPELIAI;1069782559;Taip;0;0;2;2
9098;Saulėtekis;VARPELIAI;1339984127;Taip;11;0;0;11
9099;Saulėtekis;VARPELIAI;68563453302;Taip;0;12;0;12
9100;Saulėtekis;VARPELIAI;77901730057;Taip;0;6;0;6
9101;Saulėtekis;VARPELIAI;43127755042;Taip;8;0;0;8
9102;Saulėtekis;VARPELIAI;1154284625;Taip;0;2;0;2
9103;Saulėtekis;VARPELIAI;1335149249;Taip;0;1;0;1
9104;Saulėtekis;VARPELIAI;1108321396;Taip;0;0;1;1
9105;Saulėtekis;VARPELIAI;891603633;Taip;0;3;0;3
9106;Saulėtekis;VARPELIAI;36605502570;Taip;6;0;1;7
9107;Saulėtekis;VARPELIAI;2075281680;Taip;8;0;6;14
9108;Saulėtekis;VARPELIAI;1213567219;Ne;11;0;0;11
9109;Saulėtekis;VARPELIAI;61118132521;Ne;13;0;0;13
9110;Saulėtekis;VARPELIAI;7464965841;Taip;0;0;3;3
9111;Saulėtekis;VARPELIAI;6671771491;Taip;0;2;0;2
9112;Saulėtekis;VARPELIAI;8752857993;Taip;0;0;4;4
9113;Saulėtekis;VARPELIAI;2641849320;Ne;5;0;1;6
9114;Saulėtekis;GRŪDELIS;20794781914;Taip;3;0;0;3
9115;Saulėtekis;GRŪDELIS;9132383069;Taip;7;0;2;9
9116;Saulėtekis;GRŪDELIS;67951758325;Ne;14;0;0;14
9117;Saulėtekis;GRŪDELIS;70230805151;Taip;0;0;1;1
9118;Saulėtekis;GRŪDELIS;41775536104;Ne;0;4;0;4
9119;Saulėtekis;GRŪDELIS;12954283491;Taip;0;2;0;2
9120;Saulėtekis;GRŪDELIS;21376960952;Ne;0;2;0;2
9121;Saulėtekis;GRŪDELIS;4027823257;Taip;2;0;0;2
9122;Saulėtekis;GRŪDELIS;86804497954;Taip;0;4;0;4
9123;Saulėtekis;GRŪDELIS;1180197203;Taip;5;0;0;5
9124;Saulėtekis;GRŪDELIS;1066191639;Taip;0;12;0;12
9125;Saulėtekis;GRŪDELIS;98936544904;Taip;5;0;0;5
9126;Saulėtekis;GRŪDELIS;1865278537;Taip;5;2;0;7
9127;Saulėtekis;GRŪDELIS;1220962473;Taip;5;4;0;9
9128;Saulėtekis;GRŪDELIS;20534872540;Taip;8;0;0;8
9129;Saulėtekis;GRŪDELIS;53906058088;Taip;0;0;1;1
9130;Saulėtekis;GRŪDELIS;1646943569;Taip;11;0;1;12
9131;Saulėtekis;GRŪDELIS;1456140823;Taip;0;0;2;2
9132;Saulėtekis;GRŪDELIS;49053923177;Taip;0;0;4;4
9133;Saulėtekis;JONVABALIS;5003645081;Ne;0;0;1;1
9134;Saulėtekis;JONVABALIS;1715634399;Ne;0;8;0;8
9135;Saulėtekis;JONVABALIS;1897872021;Taip;5;4;0;9
9136;Saulėtekis;JONVABALIS;1010906684;Taip;0;6;0;6
9137;Saulėtekis;JONVABALIS;97037457833;Taip;0;3;0;3
9138;Saulėtekis;JONVABALIS;84492261206;Taip;4;5;0;9
9139;Saulėtekis;JONVABALIS;72559769416;Taip;0;1;0;1
9140;Saulėtekis;JONVABALIS;1611009868;Taip;16;0;0;16
9141;Saulėtekis;JONVABALIS;4613040294;Taip;0;3;0;3
9142;Saulėtekis;JONVABALIS;1655720839;Ne;6;2;0;8
9143;Saulėtekis;JONVABALIS;5249014111;Taip;12;2;0;14
9144;Saulėtekis;JONVABALIS;2101902207;Taip;12;1;0;13
9145;Saulėtekis;JONVABALIS;3166181835;Taip;6;0;0;6
9146;Saulėtekis;JONVABALIS;6599452886;Taip;0;4;0;4
9147;Saulėtekis;JONVABALIS;8896065807;Taip;16;0;0;16
9148;Saulėtekis;JONVABALIS;1702638461;Taip;5;6;0;11
9149;Saulėtekis;JONVABALIS;3207128776;Taip;9;0;0;9
9150;Saulėtekis;JONVABALIS;2311184444;Taip;6;1;0;7
9151;Saulėtekis;SMALSUČIAI;40877542045;Taip;0;10;0;10
9152;Saulėtekis;SMALSUČIAI;9095968376;Taip;0;4;0;4
9153;Saulėtekis;SMALSUČIAI;86524549051;Taip;5;0;0;5
9154;Saulėtekis;SMALSUČIAI;7030227903;Taip;16;1;0;17
9155;Saulėtekis;SMALSUČIAI;81118611780;Taip;0;4;0;4
9156;Saulėtekis;SMALSUČIAI;32771808648;Taip;0;3;0;3
9157;Saulėtekis;SMALSUČIAI;38762730531;Ne;0;13;0;13
9158;Saulėtekis;SMALSUČIAI;1808644850;Taip;9;7;0;16
9159;Saulėtekis;SMALSUČIAI;1642031589;Taip;15;1;0;16
9160;Saulėtekis;SMALSUČIAI;29472863931;Taip;5;7;0;12
9161;Saulėtekis;SMALSUČIAI;1568300232;Ne;0;1;0;1
9162;Saulėtekis;SMALSUČIAI;97771948184;Taip;15;3;0;18
9163;Saulėtekis;SMALSUČIAI;7621094096;Taip;0;6;0;6
9164;Saulėtekis;SMALSUČIAI;13451381485;Taip;0;5;0;5
9165;Saulėtekis;SMALSUČIAI;19605249139;Taip;12;0;0;12
9166;Saulėtekis;SMALSUČIAI;1619134034;Taip;0;4;0;4
9167;Saulėtekis;SMALSUČIAI;8673024996;Taip;6;1;0;7
9168;Saulėtekis;SMALSUČIAI;1456865685;Taip;4;5;0;9
9169;Saulėtekis;SMALSUČIAI;32658647272;Taip;6;3;0;9
9170;Saulėtekis;SMALSUČIAI;92060861583;Taip;0;2;0;2
9171;Saulėtekis;BITUTĖS;7766084857;Taip;5;0;0;5
9172;Saulėtekis;BITUTĖS;60462712074;Taip;5;0;0;5
9173;Saulėtekis;BITUTĖS;9945647968;Taip;8;2;0;10
9174;Saulėtekis;BITUTĖS;1962914764;Taip;11;0;3;14
9175;Saulėtekis;BITUTĖS;1481503733;Taip;11;0;0;11
9176;Saulėtekis;BITUTĖS;2593106154;Taip;11;0;1;12
9177;Saulėtekis;BITUTĖS;2813949848;Taip;5;4;0;9
9178;Saulėtekis;BITUTĖS;6643388548;Taip;0;2;0;2
9179;Saulėtekis;BITUTĖS;9983577817;Taip;10;5;0;15
9180;Saulėtekis;BITUTĖS;7986712728;Taip;7;0;0;7
9181;Saulėtekis;BITUTĖS;6087170055;Taip;5;5;0;10
9182;Saulėtekis;BITUTĖS;7027103276;Taip;0;3;0;3
9183;Saulėtekis;BITUTĖS;7758268674;Taip;6;0;0;6
9184;Saulėtekis;BITUTĖS;2077976415;Taip;10;0;0;10
9185;Saulėtekis;BITUTĖS;9605052795;Taip;0;0;2;2
9186;Saulėtekis;BITUTĖS;7075757274;Taip;9;0;3;12
9187;Saulėtekis;BITUTĖS;2639872637;Taip;0;1;0;1
9188;Saulėtekis;BITUTĖS;1209960122;Taip;2;0;0;2
9189;Saulėtekis;RIEŠUTĖLIAI;3337160930;Taip;4;12;0;16
9190;Saulėtekis;RIEŠUTĖLIAI;2021901593;Taip;9;2;0;11
9191;Saulėtekis;RIEŠUTĖLIAI;7842280836;Taip;2;6;0;8
9192;Saulėtekis;RIEŠUTĖLIAI;2407911405;Taip;0;0;1;1
9193;Saulėtekis;RIEŠUTĖLIAI;5954194843;Taip;0;1;0;1
9194;Saulėtekis;RIEŠUTĖLIAI;6102064617;Taip;0;4;0;4
9195;Saulėtekis;RIEŠUTĖLIAI;2238947856;Taip;0;10;5;15
9196;Saulėtekis;RIEŠUTĖLIAI;84982517658;Taip;3;1;0;4
9197;Saulėtekis;RIEŠUTĖLIAI;3541535891;Taip;7;0;3;10
9198;Saulėtekis;RIEŠUTĖLIAI;8231869593;Taip;0;22;0;22
9199;Saulėtekis;RIEŠUTĖLIAI;36003078842;Taip;0;4;0;4
9200;Saulėtekis;RIEŠUTĖLIAI;4663268649;Taip;0;2;0;2
9201;Saulėtekis;RIEŠUTĖLIAI;25199011812;Taip;11;0;4;15
9202;Saulėtekis;RIEŠUTĖLIAI;81153273188;Taip;3;3;0;6
9203;Saulėtekis;RIEŠUTĖLIAI;7051608858;Taip;12;1;0;13
9204;Saulėtekis;RIEŠUTĖLIAI;9634949452;Taip;5;0;1;6
9205;Saulėtekis;RIEŠUTĖLIAI;4338502152;Taip;5;0;0;5
9206;Saulėtekis;RIEŠUTĖLIAI;8002806189;Taip;12;0;1;13
9207;Saulėtekis;RIEŠUTĖLIAI;9657195627;Taip;0;4;0;4
9208;Skroblinukas;SVIRPLIUKŲ;56496090956;Ne;0;0;3;3
9209;Skroblinukas;SVIRPLIUKŲ;70884771171;Taip;2;0;0;2
9210;Skroblinukas;SVIRPLIUKŲ;27948464942;Taip;2;1;1;4
9211;Skroblinukas;SVIRPLIUKŲ;92096423589;Taip;4;8;0;12
9212;Skroblinukas;SVIRPLIUKŲ;2020866728;Taip;0;1;2;3
9213;Skroblinukas;SVIRPLIUKŲ;1059137398;Taip;0;6;0;6
9214;Skroblinukas;SVIRPLIUKŲ;91070212533;Taip;2;9;0;11
9215;Skroblinukas;SVIRPLIUKŲ;60291417607;Taip;0;1;0;1
9216;Skroblinukas;SVIRPLIUKŲ;31484348317;Taip;0;0;1;1
9217;Skroblinukas;SVIRPLIUKŲ;88601994922;Taip;0;6;0;6
9218;Skroblinukas;SVIRPLIUKŲ;72829437831;Taip;0;8;2;10
9219;Skroblinukas;SVIRPLIUKŲ;1364608720;Taip;0;2;0;2
9220;Skroblinukas;SVIRPLIUKŲ;31670763980;Taip;0;0;2;2
9221;Skroblinukas;SVIRPLIUKŲ;89356084678;Ne;0;8;0;8
9222;Skroblinukas;SVIRPLIUKŲ;30925721180;Taip;0;0;1;1
9223;Skroblinukas;SVIRPLIUKŲ;87902801288;Taip;0;0;1;1
9224;Skroblinukas;SVIRPLIUKŲ;1462404838;Ne;0;3;0;3
9225;Skroblinukas;SVIRPLIUKŲ;23551272822;Ne;2;1;2;5
9226;Skroblinukas;SVIRPLIUKŲ;2105394649;Taip;2;0;0;2
9227;Skroblinukas;GANDRIUKŲ;2197158518;Taip;7;0;0;7
9228;Skroblinukas;GANDRIUKŲ;2097758483;Taip;7;3;0;10
9229;Skroblinukas;GANDRIUKŲ;7921251819;Taip;0;8;2;10
9230;Skroblinukas;GANDRIUKŲ;9045708140;Taip;5;0;0;5
9231;Skroblinukas;GANDRIUKŲ;2406619611;Taip;2;0;0;2
9232;Skroblinukas;GANDRIUKŲ;6640062847;Taip;19;0;1;20
9233;Skroblinukas;GANDRIUKŲ;5546256869;Taip;2;0;0;2
9234;Skroblinukas;GANDRIUKŲ;9572912046;Taip;0;10;10;20
9235;Skroblinukas;GANDRIUKŲ;9377215921;Taip;4;0;0;4
9236;Skroblinukas;GANDRIUKŲ;6266609965;Ne;0;5;0;5
9237;Skroblinukas;GANDRIUKŲ;6489976163;Taip;14;0;1;15
9238;Skroblinukas;GANDRIUKŲ;1159546580;Taip;0;3;0;3
9239;Skroblinukas;GANDRIUKŲ;2630699296;Taip;0;0;1;1
9240;Skroblinukas;GANDRIUKŲ;4571530482;Taip;0;0;5;5
9241;Skroblinukas;GANDRIUKŲ;2310750833;Taip;10;2;0;12
9242;Skroblinukas;GANDRIUKŲ;9888115079;Taip;16;0;0;16
9243;Skroblinukas;GANDRIUKŲ;9475514959;Ne;0;9;0;9
9244;Skroblinukas;VYTURIUKŲ;40320573258;Taip;8;0;0;8
9245;Skroblinukas;VYTURIUKŲ;94897926442;Ne;0;0;4;4
9246;Skroblinukas;VYTURIUKŲ;7416993749;Ne;0;0;2;2
9247;Skroblinukas;VYTURIUKŲ;1935381164;Taip;3;0;0;3
9248;Skroblinukas;VYTURIUKŲ;58000101216;Taip;0;0;1;1
9249;Skroblinukas;VYTURIUKŲ;85704624097;Taip;0;10;0;10
9250;Skroblinukas;VYTURIUKŲ;72528180087;Taip;0;0;1;1
9251;Skroblinukas;VYTURIUKŲ;40602768192;Taip;0;4;0;4
9252;Skroblinukas;VYTURIUKŲ;1175660577;Taip;0;0;2;2
9253;Skroblinukas;VYTURIUKŲ;1446835893;Taip;4;0;1;5
9254;Skroblinukas;VYTURIUKŲ;1710559060;Taip;6;0;0;6
9255;Skroblinukas;VYTURIUKŲ;21862553841;Taip;12;4;0;16
9256;Skroblinukas;VYTURIUKŲ;1611685585;Taip;11;5;0;16
9257;Skroblinukas;VYTURIUKŲ;1631945330;Taip;4;0;5;9
9258;Skroblinukas;VYTURIUKŲ;42252673755;Taip;9;2;0;11
9259;Skroblinukas;VYTURIUKŲ;7896922448;Taip;0;2;0;2
9260;Skroblinukas;VYTURIUKŲ;91409992058;Taip;0;0;2;2
9261;Skroblinukas;GENIUKŲ;48655837755;Taip;0;1;0;1
9262;Skroblinukas;GENIUKŲ;4393041946;Taip;0;0;1;1
9263;Skroblinukas;GENIUKŲ;1325903217;Taip;2;0;5;7
9264;Skroblinukas;GENIUKŲ;8380073853;Taip;12;0;1;13
9265;Skroblinukas;GENIUKŲ;5766702969;Ne;0;10;5;15
9266;Skroblinukas;GENIUKŲ;1905085978;Taip;11;0;1;12
9267;Skroblinukas;GENIUKŲ;1557733803;Taip;5;4;0;9
9268;Skroblinukas;GENIUKŲ;9433465007;Taip;5;11;0;16
9269;Skroblinukas;GENIUKŲ;1395950886;Ne;3;0;0;3
9270;Skroblinukas;GENIUKŲ;9777300890;Taip;14;0;0;14
9271;Skroblinukas;GENIUKŲ;9846569195;Taip;0;0;1;1
9272;Skroblinukas;GENIUKŲ;3746278003;Ne;22;0;0;22
9273;Skroblinukas;GENIUKŲ;4773576465;Taip;0;0;2;2
9274;Skroblinukas;GENIUKŲ;2704157855;Taip;0;9;3;12
9275;Skroblinukas;GENIUKŲ;6129591146;Taip;0;0;1;1
9276;Skroblinukas;GENIUKŲ;3128337104;Ne;0;0;2;2
9277;Skroblinukas;GENIUKŲ;4272941994;Taip;0;0;3;3
9278;Skroblinukas;BITUČIŲ;1255323441;Taip;0;0;5;5
9279;Skroblinukas;BITUČIŲ;1934804499;Taip;17;0;0;17
9280;Skroblinukas;BITUČIŲ;2134821488;Taip;20;0;0;20
9281;Skroblinukas;BITUČIŲ;2071447940;Taip;22;0;0;22
9282;Skroblinukas;BITUČIŲ;1659335142;Taip;5;4;0;9
9283;Skroblinukas;BITUČIŲ;6604496585;Ne;0;4;0;4
9284;Skroblinukas;BITUČIŲ;3736883850;Taip;2;0;0;2
9285;Skroblinukas;BITUČIŲ;7191689856;Taip;10;6;0;16
9286;Skroblinukas;BITUČIŲ;8277152812;Taip;3;1;0;4
9287;Skroblinukas;BITUČIŲ;8374103872;Taip;3;2;0;5
9288;Skroblinukas;BITUČIŲ;8618587013;Taip;6;10;0;16
9289;Skroblinukas;BITUČIŲ;4945107862;Ne;0;7;2;9
9290;Skroblinukas;BITUČIŲ;9594078223;Ne;0;2;0;2
9291;Skroblinukas;BITUČIŲ;9075266818;Ne;15;2;0;17
9292;Skroblinukas;BITUČIŲ;1432694920;Taip;7;6;0;13
9293;Skroblinukas;BITUČIŲ;1967305501;Taip;3;0;3;6
9294;Skroblinukas;BITUČIŲ;1688990637;Taip;9;2;0;11
9295;Skroblinukas;BITUČIŲ;1000804920;Taip;6;0;0;6
9296;Skroblinukas;BITUČIŲ;1544346282;Ne;0;12;0;12
9297;Skroblinukas;BITUČIŲ;1711568129;Taip;0;1;4;5
9298;Skroblinukas;BORUŽĖLIŲ;9661609284;Taip;0;0;1;1
9299;Skroblinukas;BORUŽĖLIŲ;5665463557;Taip;8;0;0;8
9300;Skroblinukas;BORUŽĖLIŲ;3292517112;Taip;7;0;0;7
9301;Skroblinukas;BORUŽĖLIŲ;2481980627;Taip;11;0;1;12
9302;Skroblinukas;BORUŽĖLIŲ;2978284436;Taip;5;0;2;7
9303;Skroblinukas;BORUŽĖLIŲ;6293879765;Taip;0;0;1;1
9304;Skroblinukas;BORUŽĖLIŲ;8946940285;Taip;0;4;5;9
9305;Skroblinukas;BORUŽĖLIŲ;3461165182;Taip;0;0;6;6
9306;Skroblinukas;BORUŽĖLIŲ;6433636135;Taip;11;2;0;13
9307;Skroblinukas;BORUŽĖLIŲ;7068452970;Taip;5;0;2;7
9308;Skroblinukas;SKRUZDĖLIUKŲ;9634311146;Taip;0;2;0;2
9309;Skroblinukas;SKRUZDĖLIUKŲ;5688453546;Taip;0;2;3;5
9310;Skroblinukas;SKRUZDĖLIUKŲ;6890306112;Taip;0;5;2;7
9311;Skroblinukas;SKRUZDĖLIUKŲ;6445065388;Taip;15;0;0;15
9312;Skroblinukas;SKRUZDĖLIUKŲ;3006521657;Taip;0;1;0;1
9313;Skroblinukas;SKRUZDĖLIUKŲ;3771045336;Ne;0;3;0;3
9314;Skroblinukas;SKRUZDĖLIUKŲ;4424763028;Taip;3;3;0;6
9315;Skroblinukas;SKRUZDĖLIUKŲ;9353353289;Taip;10;1;0;11
9316;Skroblinukas;SKRUZDĖLIUKŲ;1970738675;Taip;15;0;6;21
9317;Skroblinukas;SKRUZDĖLIUKŲ;7493915017;Taip;6;0;0;6
9318;Skroblinukas;SKRUZDĖLIUKŲ;5157913924;Taip;0;2;10;12
9319;Skroblinukas;SKRUZDĖLIUKŲ;9368764758;Taip;8;1;0;9
9320;Skroblinukas;SKRUZDĖLIUKŲ;9958188318;Taip;7;1;0;8
9321;Skroblinukas;SKRUZDĖLIUKŲ;8576448571;Taip;9;0;0;9
9322;Skroblinukas;SKRUZDĖLIUKŲ;1002570367;Taip;0;1;0;1
9323;Skroblinukas;SKRUZDĖLIUKŲ;3290115134;Taip;11;2;0;13
9324;Skroblinukas;SKRUZDĖLIUKŲ;9813249677;Taip;9;0;0;9
9325;Skroblinukas;SKRUZDĖLIUKŲ;2101748012;Taip;4;0;3;7
9326;Skroblinukas;SKRUZDĖLIUKŲ;2706526326;Taip;3;0;2;5
9327;Skroblinukas;SKRUZDĖLIUKŲ;5915278745;Taip;3;0;0;3
9328;Skroblinukas;ŽVIRBLIUKŲ;3271736540;Taip;0;9;0;9
9329;Skroblinukas;ŽVIRBLIUKŲ;3065235192;Taip;5;0;1;6
9330;Skroblinukas;ŽVIRBLIUKŲ;5902713448;Taip;10;2;0;12
9331;Skroblinukas;ŽVIRBLIUKŲ;2071093890;Taip;0;0;1;1
9332;Skroblinukas;ŽVIRBLIUKŲ;6879979868;Taip;0;0;1;1
9333;Skroblinukas;ŽVIRBLIUKŲ;3954228349;Taip;4;0;1;5
9334;Skroblinukas;ŽVIRBLIUKŲ;4560580022;Taip;0;8;3;11
9335;Skroblinukas;ŽVIRBLIUKŲ;8206063106;Taip;0;0;2;2
9336;Skroblinukas;ŽIOGELIŲ;8283516422;Taip;7;0;0;7
9337;Skroblinukas;ŽIOGELIŲ;1449037968;Taip;7;1;0;8
9338;Skroblinukas;ŽIOGELIŲ;9828486832;Taip;5;0;0;5
9339;Skroblinukas;ŽIOGELIŲ;1924714755;Taip;0;0;6;6
9340;Skroblinukas;ŽIOGELIŲ;8064713969;Taip;5;0;0;5
9341;Skroblinukas;ŽIOGELIŲ;8622930871;Taip;0;0;1;1
9342;Skroblinukas;ŽIOGELIŲ;4266945644;Taip;5;0;1;6
9343;Skroblinukas;ŽIOGELIŲ;7675772872;Taip;0;0;2;2
9344;Skroblinukas;ŽIOGELIŲ;7761972818;Taip;0;4;0;4
9345;Skroblinukas;ŽIOGELIŲ;6461678336;Taip;7;0;0;7
9346;Skroblinukas;ŽIOGELIŲ;7216760382;Taip;0;0;5;5
9347;Skroblinukas;ŽIOGELIŲ;5154111867;Taip;0;2;0;2
9348;Skroblinukas;ŽIOGELIŲ;4861971439;Taip;7;0;2;9
9349;Skroblinukas;ŽIOGELIŲ;9003855190;Taip;0;8;2;10
9350;Skroblinukas;STRAZDELIŲ;5433647187;Taip;7;0;1;8
9351;Skroblinukas;STRAZDELIŲ;9915130747;Taip;13;4;2;19
9352;Skroblinukas;STRAZDELIŲ;1669610397;Taip;3;5;2;10
9353;Skroblinukas;STRAZDELIŲ;5566457656;Ne;10;0;0;10
9354;Skroblinukas;STRAZDELIŲ;6254811026;Taip;0;0;3;3
9355;Skroblinukas;STRAZDELIŲ;4960825597;Taip;7;0;2;9
9356;Skroblinukas;STRAZDELIŲ;2195112297;Taip;0;0;2;2
9357;Skroblinukas;STRAZDELIŲ;8958893525;Taip;1;0;4;5
9358;Skroblinukas;STRAZDELIŲ;7750501815;Taip;10;0;1;11
9359;Skroblinukas;STRAZDELIŲ;6574558658;Taip;8;0;0;8
9360;Skroblinukas;STRAZDELIŲ;1544598440;Taip;0;0;1;1
9361;Skroblinukas;DRUGELIŲ;1792672886;Taip;10;0;1;11
9362;Skroblinukas;DRUGELIŲ;1979723351;Taip;0;7;3;10
9363;Skroblinukas;DRUGELIŲ;1964529755;Taip;0;18;4;22
9364;Skroblinukas;DRUGELIŲ;23687553212;Taip;10;4;0;14
9365;Skroblinukas;DRUGELIŲ;4532268875;Taip;0;14;8;22
9366;Skroblinukas;DRUGELIŲ;86542450905;Taip;8;0;4;12
9367;Skroblinukas;DRUGELIŲ;54750454175;Taip;0;0;1;1
9368;Skroblinukas;DRUGELIŲ;2019575002;Taip;7;0;0;7
9369;Skroblinukas;DRUGELIŲ;3636028890;Taip;10;0;3;13
9370;Skroblinukas;DRUGELIŲ;2079452635;Taip;0;0;1;1
9371;Skroblinukas;DRUGELIŲ;1510927547;Taip;0;0;1;1
9372;Skroblinukas;DRUGELIŲ;2325940694;Taip;16;0;2;18
9373;Skroblinukas;DRUGELIŲ;3580045988;Taip;11;3;0;14
9374;Skroblinukas;DRUGELIŲ;1005726705;Taip;5;0;0;5
9375;Skroblinukas;DRUGELIŲ;1388763405;Taip;6;0;0;6
9376;Skroblinukas;DRUGELIŲ;1791669956;Taip;10;1;1;12
9377;Skroblinukas;DRUGELIŲ;7184817010;Taip;0;0;4;4
9378;Skroblinukas;DRUGELIŲ;1109895463;Ne;0;2;0;2
9379;Skroblinukas;DRUGELIŲ;60061213883;Taip;6;0;0;6
9380;Skroblinukas;DRUGELIŲ;2116630768;Taip;0;4;2;6
9381;Skroblinukas;DRUGELIŲ;18955401411;Taip;7;0;0;7
9382;Skroblinukas;PELĖDŽIUKŲ;5975039463;Taip;7;0;1;8
9383;Skroblinukas;PELĖDŽIUKŲ;63514584063;Taip;0;15;0;15
9384;Skroblinukas;PELĖDŽIUKŲ;1000422430;Taip;0;7;0;7
9385;Skroblinukas;PELĖDŽIUKŲ;1556675902;Taip;5;0;1;6
9386;Skroblinukas;PELĖDŽIUKŲ;7666122737;Taip;0;0;1;1
9387;Skroblinukas;PELĖDŽIUKŲ;3864043251;Taip;0;0;4;4
9388;Skroblinukas;PELĖDŽIUKŲ;1759830058;Taip;0;11;0;11
9389;Skroblinukas;PELĖDŽIUKŲ;1471842192;Taip;0;2;0;2
9390;Skroblinukas;PELĖDŽIUKŲ;1382981497;Taip;0;2;0;2
9391;Skroblinukas;PELĖDŽIUKŲ;29908502973;Taip;13;1;0;14
9392;Skroblinukas;PELĖDŽIUKŲ;1220311458;Taip;0;2;0;2
9393;Skroblinukas;PELĖDŽIUKŲ;1599112927;Taip;0;2;0;2
9394;Skroblinukas;PELĖDŽIUKŲ;95946607624;Ne;0;3;0;3
9395;Skroblinukas;PELĖDŽIUKŲ;8150037173;Taip;1;0;0;1
9396;Skroblinukas;PELĖDŽIUKŲ;1898486832;Taip;10;0;0;10
9397;Skroblinukas;PELĖDŽIUKŲ;1515227489;Ne;0;4;2;6
9398;Skroblinukas;PELĖDŽIUKŲ;76523308405;Ne;0;4;0;4
9399;Skroblinukas;PELĖDŽIUKŲ;1602978649;Taip;0;1;0;1
9400;Skroblinukas;PELĖDŽIUKŲ;1258044022;Taip;9;2;1;12
9401;Skroblinukas;PELĖDŽIUKŲ;39209870512;Taip;0;0;4;4
9402;Skroblinukas;PELĖDŽIUKŲ;1847074960;Taip;4;0;4;8
9403;Skroblinukas;PELĖDŽIUKŲ;87741312158;Taip;0;1;1;2
9404;Skroblinukas;PELĖDŽIUKŲ;3858891097;Taip;0;0;5;5
9405;Smalsučiai;Žibuoklės;46376560575;Ne;0;2;0;2
9406;Smalsučiai;Žibuoklės;27034024515;Ne;0;0;1;1
9407;Smalsučiai;Žibuoklės;68726523946;Ne;8;2;0;10
9408;Smalsučiai;Žibuoklės;85358131888;Taip;0;0;5;5
9409;Smalsučiai;Žibuoklės;51889095612;Taip;0;1;2;3
9410;Smalsučiai;Žibuoklės;4258713607;Taip;0;1;0;1
9411;Smalsučiai;Žibuoklės;68097436766;Taip;0;3;0;3
9412;Smalsučiai;Žibuoklės;40922293471;Taip;0;7;0;7
9413;Smalsučiai;Žibuoklės;1023262986;Ne;0;11;0;11
9414;Smalsučiai;Žibuoklės;83033796468;Taip;5;2;1;8
9415;Smalsučiai;Žibuoklės;62767756842;Taip;0;0;2;2
9416;Smalsučiai;Žibuoklės;2099765750;Taip;0;17;0;17
9417;Smalsučiai;Žibuoklės;9512217842;Taip;0;2;0;2
9418;Smalsučiai;Žibuoklės;56779125767;Taip;5;2;2;9
9419;Smalsučiai;Žibuoklės;97809921080;Taip;0;1;0;1
9420;Smalsučiai;Žibuoklės;2021640036;Taip;0;0;6;6
9421;Smalsučiai;Aitvarų;2638709634;Taip;0;1;0;1
9422;Smalsučiai;Aitvarų;5441966713;Taip;0;1;0;1
9423;Smalsučiai;Aitvarų;8306946163;Taip;0;4;0;4
9424;Smalsučiai;Aitvarų;6469044880;Taip;6;1;0;7
9425;Smalsučiai;Aitvarų;2136420967;Taip;0;0;3;3
9426;Smalsučiai;Aitvarų;2059832436;Ne;0;11;0;11
9427;Smalsučiai;Aitvarų;4795138729;Taip;0;17;0;17
9428;Smalsučiai;Aitvarų;1316590100;Taip;0;7;0;7
9429;Smalsučiai;Aitvarų;1997966082;Taip;0;6;0;6
9430;Smalsučiai;Aitvarų;1372591510;Taip;0;2;0;2
9431;Smalsučiai;Aitvarų;4585930202;Taip;0;0;2;2
9432;Smalsučiai;Aitvarų;8810690546;Taip;0;6;0;6
9433;Smalsučiai;Aitvarų;1775539505;Taip;0;4;0;4
9434;Smalsučiai;Aitvarų;5761169841;Taip;0;8;0;8
9435;Smalsučiai;Aitvarų;4909226602;Taip;0;11;3;14
9436;Smalsučiai;Aitvarų;6536165801;Taip;6;5;1;12
9437;Smalsučiai;Aitvarų;3644256220;Taip;0;0;2;2
9438;Smalsučiai;Sraigiukų;1156210876;Taip;0;0;1;1
9439;Smalsučiai;Sraigiukų;5631758578;Taip;0;2;0;2
9440;Smalsučiai;Sraigiukų;76405732236;Taip;0;1;0;1
9441;Smalsučiai;Sraigiukų;48426272721;Taip;0;0;7;7
9442;Smalsučiai;Sraigiukų;26007606072;Taip;0;2;0;2
9443;Smalsučiai;Sraigiukų;31748074403;Taip;0;1;0;1
9444;Smalsučiai;Sraigiukų;67243805772;Ne;0;0;9;9
9445;Smalsučiai;Sraigiukų;68897306811;Taip;0;4;0;4
9446;Smalsučiai;Sraigiukų;1417945043;Ne;0;2;0;2
9447;Smalsučiai;Sraigiukų;45731306499;Ne;10;1;0;11
9448;Smalsučiai;Sraigiukų;70181610962;Ne;0;1;0;1
9449;Smalsučiai;Sraigiukų;71839472863;Taip;0;0;3;3
9450;Smalsučiai;Sraigiukų;97665693700;Taip;0;2;0;2
9451;Smalsučiai;Sraigiukų;95501158334;Taip;0;1;0;1
9452;Smalsučiai;Sraigiukų;1095159887;Taip;2;0;0;2
9453;Smalsučiai;Sraigiukų;1424532027;Ne;3;7;1;11
9454;Smalsučiai;Saulučių;2112871055;Taip;2;0;0;2
9455;Smalsučiai;Saulučių;50085798686;Taip;10;0;1;11
9456;Smalsučiai;Saulučių;1025164832;Taip;0;5;1;6
9457;Smalsučiai;Saulučių;52829213579;Taip;0;1;0;1
9458;Smalsučiai;Saulučių;1594035039;Taip;0;3;0;3
9459;Smalsučiai;Saulučių;8542926346;Taip;10;0;1;11
9460;Smalsučiai;Saulučių;4042979105;Taip;8;0;0;8
9461;Smalsučiai;Saulučių;1760728524;Taip;8;6;0;14
9462;Smalsučiai;Saulučių;28055409190;Taip;0;3;0;3
9463;Smalsučiai;Saulučių;7450298541;Taip;0;0;1;1
9464;Smalsučiai;Saulučių;44888860122;Ne;0;0;3;3
9465;Smalsučiai;Saulučių;1567576834;Ne;0;5;0;5
9466;Smalsučiai;Saulučių;1673246147;Taip;0;0;6;6
9467;Smalsučiai;Saulučių;62387945180;Taip;0;0;5;5
9468;Smalsučiai;Viščiukų;13763655324;Taip;0;0;1;1
9469;Smalsučiai;Viščiukų;2802867649;Taip;0;5;0;5
9470;Smalsučiai;Viščiukų;30592434971;Taip;0;0;2;2
9471;Smalsučiai;Viščiukų;18717627431;Taip;0;4;0;4
9472;Smalsučiai;Viščiukų;63575906792;Taip;4;3;0;7
9473;Smalsučiai;Viščiukų;27727844778;Taip;0;1;0;1
9474;Smalsučiai;Viščiukų;1514166474;Taip;0;8;0;8
9475;Smalsučiai;Viščiukų;37702522563;Taip;2;1;0;3
9476;Smalsučiai;Viščiukų;96002139110;Taip;0;4;0;4
9477;Smalsučiai;Viščiukų;1893910089;Taip;6;1;0;7
9478;Smalsučiai;Viščiukų;55385713527;Taip;5;0;0;5
9479;Smalsučiai;Viščiukų;78496301809;Taip;0;2;0;2
9480;Smalsučiai;Viščiukų;92961881271;Taip;7;2;3;12
9481;Smalsučiai;Viščiukų;6264082741;Taip;11;7;0;18
9482;Smalsučiai;Viščiukų;30464130912;Taip;0;0;2;2
9483;Smalsučiai;Boružėlių;2208462326;Taip;0;8;0;8
9484;Smalsučiai;Boružėlių;6643253926;Taip;0;5;0;5
9485;Smalsučiai;Boružėlių;1473016908;Ne;14;0;0;14
9486;Smalsučiai;Boružėlių;6610166355;Taip;2;0;1;3
9487;Smalsučiai;Boružėlių;7226242747;Taip;0;0;5;5
9488;Smalsučiai;Boružėlių;6085020049;Taip;0;8;0;8
9489;Smalsučiai;Boružėlių;8340768848;Ne;5;0;1;6
9490;Smalsučiai;Boružėlių;6578328053;Taip;0;0;2;2
9491;Smalsučiai;Boružėlių;69450514879;Ne;0;5;0;5
9492;Smalsučiai;Boružėlių;4046718551;Taip;3;0;0;3
9493;Smalsučiai;Boružėlių;7364431725;Taip;11;7;0;18
9494;Smalsučiai;Boružėlių;2671403814;Taip;0;5;0;5
9495;Smalsučiai;Boružėlių;2737886714;Taip;0;7;0;7
9496;Smalsučiai;Boružėlių;4858914868;Taip;11;0;1;12
9497;Smalsučiai;Boružėlių;8523742213;Taip;5;1;0;6
9498;Smalsučiai;Zuikių;3792738445;Taip;3;1;4;8
9499;Smalsučiai;Zuikių;1453463899;Taip;5;0;2;7
9500;Smalsučiai;Zuikių;92129554371;Taip;0;1;0;1
9501;Smalsučiai;Zuikių;1830368274;Taip;0;0;7;7
9502;Smalsučiai;Zuikių;1968415573;Taip;0;3;0;3
9503;Smalsučiai;Zuikių;87920436781;Taip;2;0;0;2
9504;Smalsučiai;Zuikių;1597721199;Taip;0;0;1;1
9505;Smalsučiai;Zuikių;2036701320;Ne;0;0;3;3
9506;Smalsučiai;Zuikių;18980466605;Taip;0;2;0;2
9507;Smalsučiai;Zuikių;7243102874;Ne;5;0;0;5
9508;Smalsučiai;Zuikių;2057177596;Taip;10;0;2;12
9509;Smalsučiai;Nykštukų;2327930850;Taip;0;16;0;16
9510;Smalsučiai;Nykštukų;3787937467;Taip;0;12;0;12
9511;Smalsučiai;Nykštukų;4134975456;Taip;10;0;0;10
9512;Smalsučiai;Nykštukų;9155011285;Taip;0;7;0;7
9513;Smalsučiai;Nykštukų;9582225178;Ne;5;1;0;6
9514;Smalsučiai;Nykštukų;4566816316;Taip;0;1;0;1
9515;Smalsučiai;Nykštukų;1471941426;Taip;0;2;0;2
9516;Smalsučiai;Nykštukų;1458544456;Taip;5;1;0;6
9517;Smalsučiai;Nykštukų;6469604093;Taip;0;6;0;6
9518;Smalsučiai;Nykštukų;6358800570;Taip;5;7;0;12
9519;Smalsučiai;Nykštukų;5184903287;Taip;0;1;0;1
9520;Smalsučiai;Nykštukų;7933302912;Taip;0;13;0;13
9521;Smalsučiai;Nykštukų;3757955200;Taip;10;3;0;13
9522;Smalsučiai;Nykštukų;5406430393;Taip;5;3;0;8
9523;Smalsučiai;Nykštukų;6899040199;Taip;0;1;1;2
9524;Smalsučiai;Nykštukų;4824786207;Taip;3;0;0;3
9525;Smalsučiai;Nykštukų;4629526320;Taip;0;0;1;1
9526;Smalsučiai;Nykštukų;9604182559;Taip;7;0;2;9
9527;Smalsučiai;Nykštukų;3831088965;Taip;0;10;0;10
9528;Smalsučiai;Katinėlių;8259056296;Taip;0;0;5;5
9529;Smalsučiai;Katinėlių;9864518144;Taip;3;0;0;3
9530;Smalsučiai;Katinėlių;2958335372;Taip;5;0;0;5
9531;Smalsučiai;Katinėlių;6090391818;Taip;5;4;0;9
9532;Smalsučiai;Katinėlių;7396172351;Taip;0;7;0;7
9533;Smalsučiai;Katinėlių;8977651419;Taip;8;0;0;8
9534;Smalsučiai;Katinėlių;6006832443;Ne;0;5;0;5
9535;Smalsučiai;Katinėlių;8128348060;Taip;12;7;0;19
9536;Smalsučiai;Katinėlių;4847584492;Taip;0;0;4;4
9537;Smalsučiai;Katinėlių;6415906523;Taip;6;0;0;6
9538;Smalsučiai;Katinėlių;9732075162;Taip;2;2;0;4
9539;Smalsučiai;Katinėlių;7023531176;Taip;6;0;0;6
9540;Smalsučiai;Katinėlių;4565479092;Taip;0;0;2;2
9541;Smalsučiai;Katinėlių;7256557310;Taip;0;0;11;11
9542;Smalsučiai;PELĖDŽIUKAI;63886240982;Taip;0;2;0;2
9543;Smalsučiai;PELĖDŽIUKAI;98196404299;Taip;0;4;0;4
9544;Smalsučiai;PELĖDŽIUKAI;25838645404;Taip;0;0;1;1
9545;Smalsučiai;PELĖDŽIUKAI;66154228179;Taip;0;0;2;2
9546;Smalsučiai;PELĖDŽIUKAI;16418705168;Taip;0;1;0;1
9547;Smalsučiai;PELĖDŽIUKAI;55812291804;Taip;2;0;1;3
9548;Smalsučiai;PELĖDŽIUKAI;81834985961;Taip;2;1;4;7
9549;Smalsučiai;PELĖDŽIUKAI;513516143;Ne;0;2;0;2
9550;Smalsučiai;PELĖDŽIUKAI;54610929862;Taip;0;1;1;2
9551;Smalsučiai;PELĖDŽIUKAI;32382108578;Taip;11;0;0;11
9552;Smalsučiai;PELĖDŽIUKAI;73899364649;Taip;0;0;6;6
9553;Smalsučiai;PELĖDŽIUKAI;1575017231;Taip;5;0;0;5
9554;Smalsučiai;PELĖDŽIUKAI;1653798728;Taip;0;1;0;1
9555;Smalsučiai;Pingvinukai;4288788194;Taip;5;0;0;5
9556;Smalsučiai;Pingvinukai;3309134310;Taip;0;5;0;5
9557;Smalsučiai;Pingvinukai;5402027714;Taip;0;3;1;4
9558;Smalsučiai;Pingvinukai;2326167599;Taip;0;0;1;1
9559;Smalsučiai;Pingvinukai;4094037708;Taip;0;0;2;2
9560;Smalsučiai;Pingvinukai;5482692473;Taip;0;5;0;5
9561;Smalsučiai;Pingvinukai;4379372200;Taip;0;0;2;2
9562;Smalsučiai;Pingvinukai;7070240693;Ne;0;0;2;2
9563;Smalsučiai;Pingvinukai;3071594259;Taip;4;0;5;9
9564;Smalsučiai;Pingvinukai;7107126092;Taip;4;0;5;9
9565;Smalsučiai;Pingvinukai;3877274360;Taip;2;0;0;2
9566;Smalsučiai;Voverikų;7713078413;Taip;0;6;0;6
9567;Smalsučiai;Voverikų;3607226859;Taip;0;3;0;3
9568;Smalsučiai;Voverikų;22791221635;Taip;0;2;0;2
9569;Smalsučiai;Voverikų;1467603676;Taip;0;19;0;19
9570;Smalsučiai;Voverikų;1982046497;Taip;0;1;0;1
9571;Smalsučiai;Voverikų;1181574676;Taip;0;13;0;13
9572;Smalsučiai;Voverikų;1599488035;Taip;0;6;0;6
9573;Smalsučiai;Voverikų;6207026048;Taip;0;2;6;8
9574;Smalsučiai;Voverikų;19592364606;Taip;5;7;0;12
9575;Smalsučiai;Voverikų;1824321380;Taip;0;0;2;2
9576;Smalsučiai;Voverikų;5611487967;Taip;0;7;0;7
9577;Smalsučiai;Voverikų;8520753848;Ne;0;14;0;14
9578;Smalsučiai;Voverikų;4145769042;Taip;0;0;3;3
9579;Smalsučiai;Voverikų;6529889121;Taip;17;0;0;17
9580;Smalsučiai;Voverikų;3627324317;Taip;0;5;0;5
9581;Spindulėlis;SAULUTĖS;6449284856;Ne;5;0;17;22
9582;Spindulėlis;SAULUTĖS;1180176295;Taip;0;1;2;3
9583;Spindulėlis;SAULUTĖS;1730248631;Taip;0;0;4;4
9584;Spindulėlis;SAULUTĖS;4353031174;Ne;5;0;5;10
9585;Spindulėlis;SAULUTĖS;1424288192;Taip;0;0;1;1
9586;Spindulėlis;SAULUTĖS;1346035733;Taip;0;2;0;2
9587;Spindulėlis;SAULUTĖS;9903990297;Taip;0;0;2;2
9588;Spindulėlis;SAULUTĖS;4077985773;Taip;8;0;1;9
9589;Spindulėlis;SAULUTĖS;6592057292;Taip;11;0;0;11
9590;Spindulėlis;SAULUTĖS;2890377876;Taip;0;0;6;6
9591;Spindulėlis;SAULUTĖS;9511051386;Taip;5;0;1;6
9592;Spindulėlis;SAULUTĖS;8141324449;Taip;7;0;1;8
9593;Spindulėlis;SAULUTĖS;9244494109;Taip;0;0;1;1
9594;Spindulėlis;SAULUTĖS;8923393066;Taip;0;0;5;5
9595;Spindulėlis;SAULUTĖS;5288557629;Taip;2;0;2;4
9596;Spindulėlis;SAULUTĖS;7099787230;Taip;15;2;5;22
9597;Spindulėlis;SAULUTĖS;4929866385;Taip;0;0;7;7
9598;Spindulėlis;SAULUTĖS;5233044803;Taip;0;0;2;2
9599;Spindulėlis;SAULUTĖS;3088386659;Taip;0;6;0;6
9600;Spindulėlis;DRUGELIAI;1528496272;Taip;0;0;1;1
9601;Spindulėlis;DRUGELIAI;2988630379;Taip;1;1;1;3
9602;Spindulėlis;DRUGELIAI;55250330957;Taip;0;0;4;4
9603;Spindulėlis;DRUGELIAI;80331157814;Taip;5;1;0;6
9604;Spindulėlis;DRUGELIAI;60956380679;Taip;1;0;2;3
9605;Spindulėlis;DRUGELIAI;2131409282;Taip;0;0;1;1
9606;Spindulėlis;DRUGELIAI;9348576749;Taip;0;0;3;3
9607;Spindulėlis;DRUGELIAI;63344816879;Taip;3;0;4;7
9608;Spindulėlis;DRUGELIAI;9145337789;Taip;16;0;0;16
9609;Spindulėlis;DRUGELIAI;96365393879;Taip;0;5;0;5
9610;Spindulėlis;DRUGELIAI;7757264510;Taip;0;0;3;3
9611;Spindulėlis;DRUGELIAI;5050019035;Taip;0;1;0;1
9612;Spindulėlis;DRUGELIAI;1821231102;Taip;4;0;4;8
9613;Spindulėlis;DRUGELIAI;21152690883;Taip;0;0;5;5
9614;Spindulėlis;DRUGELIAI;1514479696;Taip;15;2;5;22
9615;Spindulėlis;DRUGELIAI;1391226466;Taip;0;0;1;1
9616;Spindulėlis;DRUGELIAI;27408123487;Taip;0;15;0;15
9617;Spindulėlis;DRUGELIAI;1694423628;Taip;0;5;0;5
9618;Spindulėlis;DRUGELIAI;1679106754;Taip;0;5;0;5
9619;Spindulėlis;DRUGELIAI;72997461686;Taip;0;0;3;3
9620;Spindulėlis;DRUGELIAI;92417802345;Taip;3;5;0;8
9621;Spindulėlis;DRUGELIAI;4194714698;Taip;0;0;2;2
9622;Spindulėlis;DRUGELIAI;9977569249;Ne;6;0;3;9
9623;Spindulėlis;DRUGELIAI;6435045068;Taip;0;0;2;2
9624;Spindulėlis;BITUTĖS;83785970474;Taip;0;2;0;2
9625;Spindulėlis;BITUTĖS;92803008887;Taip;0;4;0;4
9626;Spindulėlis;BITUTĖS;4539792030;Ne;5;0;0;5
9627;Spindulėlis;BITUTĖS;16045001090;Taip;0;5;0;5
9628;Spindulėlis;BITUTĖS;1399847362;Ne;0;0;1;1
9629;Spindulėlis;BITUTĖS;3986191435;Taip;5;0;1;6
9630;Spindulėlis;BITUTĖS;97661389553;Taip;0;1;0;1
9631;Spindulėlis;BITUTĖS;2137229669;Ne;0;3;0;3
9632;Spindulėlis;BITUTĖS;19541905006;Taip;3;0;1;4
9633;Spindulėlis;BITUTĖS;27928352319;Taip;7;5;0;12
9634;Spindulėlis;BITUTĖS;18443825776;Taip;3;0;1;4
9635;Spindulėlis;BITUTĖS;1033202443;Taip;0;0;1;1
9636;Spindulėlis;BITUTĖS;30036722764;Ne;0;5;9;14
9637;Spindulėlis;BITUTĖS;1763306358;Taip;0;0;6;6
9638;Spindulėlis;BITUTĖS;29747353664;Taip;0;2;1;3
9639;Spindulėlis;BITUTĖS;1939526832;Taip;5;0;3;8
9640;Spindulėlis;VARPELIAI;7184471307;Taip;3;0;0;3
9641;Spindulėlis;VARPELIAI;4116151797;Taip;1;0;1;2
9642;Spindulėlis;VARPELIAI;3276656641;Taip;7;0;2;9
9643;Spindulėlis;VARPELIAI;8039086094;Taip;5;0;1;6
9644;Spindulėlis;VARPELIAI;3329587401;Taip;5;0;0;5
9645;Spindulėlis;VARPELIAI;6633031473;Taip;0;0;9;9
9646;Spindulėlis;VARPELIAI;6880075874;Taip;12;0;0;12
9647;Spindulėlis;VARPELIAI;4152722583;Taip;5;0;5;10
9648;Spindulėlis;VARPELIAI;6949857110;Taip;5;0;1;6
9649;Spindulėlis;VARPELIAI;2511267939;Ne;3;0;1;4
9650;Spindulėlis;VARPELIAI;4171789569;Taip;0;0;10;10
9651;Spindulėlis;VARPELIAI;1454039572;Taip;7;0;0;7
9652;Spindulėlis;VARPELIAI;9740815635;Taip;6;0;0;6
9653;Spindulėlis;VARPELIAI;4308169582;Taip;15;0;1;16
9654;Spragtukas;NYKŠTUKAI;8623311748;Taip;7;15;0;22
9655;Spragtukas;NYKŠTUKAI;9805841777;Taip;0;3;0;3
9656;Spragtukas;NYKŠTUKAI;2943832694;Taip;0;1;0;1
9657;Spragtukas;NYKŠTUKAI;8460527225;Taip;8;2;0;10
9658;Spragtukas;NYKŠTUKAI;8297700739;Taip;5;2;0;7
9659;Spragtukas;NYKŠTUKAI;9595221494;Ne;13;0;0;13
9660;Spragtukas;NYKŠTUKAI;6185016824;Taip;12;2;0;14
9661;Spragtukas;NYKŠTUKAI;8715073512;Taip;11;0;0;11
9662;Spragtukas;NYKŠTUKAI;6162830167;Taip;14;2;0;16
9663;Spragtukas;NYKŠTUKAI;2076126173;Taip;0;2;0;2
9664;Spragtukas;NYKŠTUKAI;8698492694;Taip;0;2;0;2
9665;Spragtukas;NYKŠTUKAI;4493810276;Taip;0;1;0;1
9666;Spragtukas;NYKŠTUKAI;8288793522;Taip;0;4;0;4
9667;Spragtukas;SAULUTĖ;89749837388;Ne;6;0;1;7
9668;Spragtukas;SAULUTĖ;3392224465;Taip;0;9;0;9
9669;Spragtukas;SAULUTĖ;1174566363;Taip;3;0;0;3
9670;Spragtukas;SAULUTĖ;10998123453;Taip;0;11;0;11
9671;Spragtukas;SAULUTĖ;48934106998;Ne;0;1;0;1
9672;Spragtukas;SAULUTĖ;34989165939;Ne;0;2;0;2
9673;Spragtukas;SAULUTĖ;53375921406;Ne;3;0;0;3
9674;Spragtukas;SAULUTĖ;50653432030;Taip;0;4;0;4
9675;Spragtukas;SAULUTĖ;4321780080;Taip;0;1;0;1
9676;Spragtukas;SAULUTĖ;51889437335;Taip;5;0;0;5
9677;Spragtukas;SAULUTĖ;94483480424;Taip;3;2;0;5
9678;Spragtukas;SAULUTĖ;42635888133;Taip;0;1;0;1
9679;Spragtukas;SAULUTĖ;80790750169;Taip;0;3;0;3
9680;Spragtukas;SAULUTĖ;96435499947;Taip;3;0;1;4
9681;Spragtukas;SAULUTĖ;91767288727;Taip;7;0;0;7
9682;Spragtukas;SAULUTĖ;94418271961;Taip;0;16;0;16
9683;Spragtukas;SPINDULĖLIAI;94650801877;Taip;0;3;0;3
9684;Spragtukas;SPINDULĖLIAI;1983906683;Taip;0;1;0;1
9685;Spragtukas;SPINDULĖLIAI;4004275398;Taip;6;0;1;7
9686;Spragtukas;SPINDULĖLIAI;4216521988;Taip;3;0;0;3
9687;Spragtukas;SPINDULĖLIAI;1029392579;Taip;0;1;0;1
9688;Spragtukas;SPINDULĖLIAI;6417098461;Taip;0;1;0;1
9689;Spragtukas;SPINDULĖLIAI;1336973131;Taip;0;8;0;8
9690;Spragtukas;SPINDULĖLIAI;65692358082;Taip;4;3;0;7
9691;Spragtukas;SPINDULĖLIAI;6052538605;Taip;0;6;0;6
9692;Spragtukas;SPINDULĖLIAI;2138152514;Taip;4;2;0;6
9693;Spragtukas;SPINDULĖLIAI;1305123801;Taip;0;1;0;1
9694;Spragtukas;SPINDULĖLIAI;4485715299;Taip;6;0;1;7
9695;Spragtukas;SPINDULĖLIAI;81928765016;Taip;6;0;1;7
9696;Spragtukas;SPINDULĖLIAI;8415429693;Ne;0;6;0;6
9697;Spragtukas;GINTARĖLIAI;60731415960;Taip;4;3;0;7
9698;Spragtukas;GINTARĖLIAI;15208696709;Taip;7;0;0;7
9699;Spragtukas;GINTARĖLIAI;32290835176;Taip;4;10;0;14
9700;Spragtukas;GINTARĖLIAI;68059396649;Ne;12;0;0;12
9701;Spragtukas;GINTARĖLIAI;39962240237;Taip;0;3;0;3
9702;Spragtukas;GINTARĖLIAI;8554047390;Taip;12;2;0;14
9703;Spragtukas;GINTARĖLIAI;16927181370;Taip;0;4;0;4
9704;Spragtukas;GINTARĖLIAI;69086864157;Taip;9;4;0;13
9705;Spragtukas;ČIPOLINO;2371848091;Taip;0;9;0;9
9706;Spragtukas;ČIPOLINO;6582680700;Taip;15;2;0;17
9707;Spragtukas;ČIPOLINO;1599958343;Taip;0;3;0;3
9708;Spragtukas;ČIPOLINO;1547670082;Taip;5;10;0;15
9709;Spragtukas;ČIPOLINO;7504632314;Taip;0;1;0;1
9710;Spragtukas;ČIPOLINO;1597988501;Taip;11;0;0;11
9711;Spragtukas;ČIPOLINO;6526633051;Taip;11;0;0;11
9712;Spragtukas;ČIPOLINO;1058970799;Taip;0;3;0;3
9713;Spragtukas;ČIPOLINO;45661532130;Taip;0;2;0;2
9714;Spragtukas;ČIPOLINO;3045382299;Taip;0;1;0;1
9715;Spragtukas;ČIPOLINO;7640805299;Taip;0;5;0;5
9716;Spragtukas;ČIPOLINO;1365907314;Taip;10;1;0;11
9717;Spragtukas;ČIPOLINO;4941531443;Taip;10;1;0;11
9718;Spragtukas;ČIPOLINO;3566797064;Taip;0;1;0;1
9719;Spragtukas;ČIPOLINO;1827458781;Taip;10;0;0;10
9720;Spragtukas;ČIPOLINO;3798118695;Taip;0;14;0;14
9721;Spragtukas;ČIPOLINO;69114720307;Taip;5;6;0;11
9722;Spragtukas;ČIPOLINO;9789977863;Taip;10;5;0;15
9723;Spragtukas;ČIPOLINO;1044112039;Taip;4;2;0;6
9724;Spragtukas;ČIPOLINO;5707084920;Taip;13;1;0;14
9725;Spragtukas;BORUŽĖLĖS;2356476212;Taip;11;1;0;12
9726;Spragtukas;BORUŽĖLĖS;8429135626;Taip;10;8;0;18
9727;Spragtukas;BORUŽĖLĖS;8287102733;Taip;8;6;0;14
9728;Spragtukas;BORUŽĖLĖS;5844437769;Ne;11;1;0;12
9729;Spragtukas;BORUŽĖLĖS;6584145176;Taip;0;1;0;1
9730;Spragtukas;BORUŽĖLĖS;8226921630;Ne;14;2;0;16
9731;Spragtukas;BORUŽĖLĖS;2946297529;Ne;15;0;0;15
9732;Spragtukas;BORUŽĖLĖS;9860876807;Taip;0;6;0;6
9733;Spragtukas;BORUŽĖLĖS;5633883897;Ne;0;3;0;3
9734;Spragtukas;BORUŽĖLĖS;1570206034;Taip;12;3;0;15
9735;Spragtukas;BORUŽĖLĖS;9965087132;Taip;0;8;0;8
9736;Spragtukas;BORUŽĖLĖS;7806145224;Taip;5;3;0;8
9737;Spragtukas;BORUŽĖLĖS;2909322678;Taip;8;2;0;10
9738;Spragtukas;BORUŽĖLĖS;5236797574;Taip;0;4;0;4
9739;Spragtukas;BORUŽĖLĖS;1306663967;Taip;5;6;0;11
9740;Spragtukas;BORUŽĖLĖS;4069044269;Taip;0;1;0;1
9741;Spragtukas;BORUŽĖLĖS;5150028968;Taip;0;3;0;3
9742;Spragtukas;BORUŽĖLĖS;9754594384;Ne;8;8;0;16
9743;Spragtukas;DRUGELIAI;41147623084;Taip;0;1;2;3
9744;Spragtukas;DRUGELIAI;1138975383;Taip;0;1;0;1
9745;Spragtukas;DRUGELIAI;32858776091;Taip;0;2;0;2
9746;Spragtukas;DRUGELIAI;2118272247;Taip;0;3;4;7
9747;Spragtukas;DRUGELIAI;46794033116;Taip;0;8;0;8
9748;Spragtukas;DRUGELIAI;1418494757;Taip;0;0;1;1
9749;Spragtukas;DRUGELIAI;82801263312;Taip;0;7;2;9
9750;Spragtukas;DRUGELIAI;2032107153;Ne;0;1;1;2
9751;Spragtukas;DRUGELIAI;1731215395;Taip;0;0;2;2
9752;Spragtukas;DRUGELIAI;67679737675;Taip;6;0;0;6
9753;Spragtukas;DRUGELIAI;1953368351;Taip;0;0;4;4
9754;Spragtukas;DRUGELIAI;1030688447;Taip;4;0;1;5
9755;Spragtukas;DRUGELIAI;38120721944;Taip;0;11;0;11
9756;Spragtukas;DRUGELIAI;20279570129;Ne;2;0;1;3
9757;Spragtukas;GAIDELIAI;7569802487;Taip;0;2;0;2
9758;Spragtukas;GAIDELIAI;71081903240;Taip;0;2;0;2
9759;Spragtukas;GAIDELIAI;79237309377;Taip;0;1;0;1
9760;Spragtukas;GAIDELIAI;54099559107;Taip;0;2;0;2
9761;Spragtukas;GAIDELIAI;1203266608;Taip;10;0;0;10
9762;Spragtukas;GAIDELIAI;11849369985;Taip;10;0;0;10
9763;Spragtukas;GAIDELIAI;2042294168;Taip;0;1;0;1
9764;Spragtukas;GAIDELIAI;1030566027;Taip;6;2;0;8
9765;Spragtukas;GAIDELIAI;8150653485;Taip;0;5;0;5
9766;Spragtukas;GAIDELIAI;1247838976;Taip;3;0;0;3
9767;Spragtukas;GAIDELIAI;2061441977;Taip;7;0;0;7
9768;Spragtukas;GAIDELIAI;8163990681;Taip;3;0;2;5
9769;Spragtukas;GAIDELIAI;4209118353;Taip;3;0;2;5
9770;Spragtukas;GAIDELIAI;9658469152;Taip;5;0;0;5
9771;Spragtukas;GAIDELIAI;2848207417;Taip;12;0;2;14
9772;Spragtukas;GAIDELIAI;1210698072;Taip;0;11;0;11
9773;Spragtukas;GAIDELIAI;1070119148;Taip;15;0;0;15
9774;Spragtukas;GAIDELIAI;9235972927;Taip;4;3;0;7
9775;Spragtukas;ŽUVELĖS;8652973900;Taip;6;2;0;8
9776;Spragtukas;ŽUVELĖS;3261213140;Taip;1;1;0;2
9777;Spragtukas;ŽUVELĖS;5689392663;Taip;0;1;1;2
9778;Spragtukas;ŽUVELĖS;9592271053;Taip;0;1;0;1
9779;Spragtukas;ŽUVELĖS;1272075883;Taip;0;1;0;1
9780;Spragtukas;ŽUVELĖS;6465991136;Taip;2;1;0;3
9781;Spragtukas;ŽUVELĖS;9282940430;Taip;3;13;0;16
9782;Spragtukas;ŽUVELĖS;6503842956;Taip;0;2;0;2
9783;Spragtukas;ŽUVELĖS;2578400770;Taip;0;1;0;1
9784;Spragtukas;ŽUVELĖS;6757604305;Taip;8;0;0;8
9785;Spragtukas;ŽUVELĖS;3139748724;Taip;3;0;0;3
9786;Spragtukas;ŽUVELĖS;8640877497;Taip;2;0;0;2
9787;Spragtukas;ŽUVELĖS;2025314314;Taip;0;0;3;3
9788;Spragtukas;ŽUVELĖS;4848647219;Ne;2;1;0;3
9789;Spragtukas;ŽUVELĖS;3491418162;Taip;4;0;0;4
9790;Spragtukas;ŽUVELĖS;5836788916;Taip;0;1;1;2
9791;Spragtukas;ŽUVELĖS;5704941595;Taip;7;0;0;7
9792;Spragtukas;ŽUVELĖS;6545866812;Taip;8;0;2;10
9793;Spragtukas;ŽUVELĖS;3286456855;Taip;0;1;0;1
9794;Spragtukas;ŽUVELĖS;9662188102;Taip;0;1;0;1
9795;Spragtukas;ŽUVELĖS;2539660577;Ne;0;1;2;3
9796;Spragtukas;ŽUVELĖS;4331948700;Taip;0;0;1;1
9797;Spragtukas;RIEŠUTĖLIAI;8444759709;Taip;0;7;0;7
9798;Spragtukas;RIEŠUTĖLIAI;1384812263;Taip;2;2;0;4
9799;Spragtukas;RIEŠUTĖLIAI;8463747761;Taip;0;1;0;1
9800;Spragtukas;RIEŠUTĖLIAI;4131998934;Taip;3;2;0;5
9801;Spragtukas;RIEŠUTĖLIAI;1690400583;Taip;0;3;0;3
9802;Spragtukas;RIEŠUTĖLIAI;6419503965;Taip;0;9;0;9
9803;Spragtukas;RIEŠUTĖLIAI;8246512283;Ne;0;4;0;4
9804;Spragtukas;RIEŠUTĖLIAI;1326603216;Taip;3;1;0;4
9805;Spragtukas;RIEŠUTĖLIAI;72636559695;Ne;0;6;0;6
9806;Spragtukas;RIEŠUTĖLIAI;5306883933;Ne;4;2;0;6
9807;Spragtukas;RIEŠUTĖLIAI;1849644444;Taip;0;6;0;6
9808;Spragtukas;RIEŠUTĖLIAI;9045185920;Taip;10;0;0;10
9809;Spragtukas;RIEŠUTĖLIAI;1800927281;Taip;13;0;0;13
9810;Spragtukas;RIEŠUTĖLIAI;1514277186;Taip;0;3;0;3
9811;Spragtukas;RIEŠUTĖLIAI;4427123314;Taip;10;3;0;13
9812;Spragtukas;RIEŠUTĖLIAI;6322121173;Taip;5;2;0;7
9813;Spragtukas;RIEŠUTĖLIAI;9314811354;Taip;0;11;0;11
9814;Spragtukas;VIŠČIUKAI;6493380877;Taip;0;0;2;2
9815;Spragtukas;VIŠČIUKAI;5556920140;Taip;0;0;1;1
9816;Spragtukas;VIŠČIUKAI;2255007161;Taip;0;0;5;5
9817;Spragtukas;VIŠČIUKAI;3471355267;Taip;0;0;5;5
9818;Spragtukas;VIŠČIUKAI;5427116799;Taip;7;0;1;8
9819;Spragtukas;VIŠČIUKAI;6121388208;Taip;7;0;2;9
9820;Spragtukas;VIŠČIUKAI;1747417905;Taip;10;0;0;10
9821;Spragtukas;VIŠČIUKAI;8339926929;Taip;3;0;2;5
9822;Spragtukas;VIŠČIUKAI;5724874569;Taip;0;0;8;8
9823;Spragtukas;VIŠČIUKAI;8698469979;Taip;0;0;9;9
9824;Spragtukas;VIŠČIUKAI;9664130733;Taip;5;0;2;7
9825;Spragtukas;VIŠČIUKAI;1430632638;Taip;5;0;0;5
9826;Spragtukas;VIŠČIUKAI;1525489137;Taip;1;0;2;3
9827;Spragtukas;VIŠČIUKAI;5697451914;Taip;0;0;1;1
9828;Spragtukas;MEŠKIUKAI;6192381779;Taip;2;8;0;10
9829;Spragtukas;MEŠKIUKAI;5687853390;Taip;0;8;0;8
9830;Spragtukas;MEŠKIUKAI;8235791891;Taip;9;2;0;11
9831;Spragtukas;MEŠKIUKAI;3948232692;Taip;8;0;0;8
9832;Spragtukas;MEŠKIUKAI;2879077913;Ne;3;3;0;6
9833;Spragtukas;MEŠKIUKAI;4669257062;Taip;6;0;0;6
9834;Spragtukas;MEŠKIUKAI;3968434618;Taip;0;2;0;2
9835;Spragtukas;MEŠKIUKAI;1150727381;Taip;9;3;0;12
9836;Spragtukas;MEŠKIUKAI;9191831532;Taip;0;17;0;17
9837;Spragtukas;MEŠKIUKAI;3189741449;Taip;5;1;1;7
9838;Spragtukas;MEŠKIUKAI;4344537391;Taip;2;9;2;13
9839;Spragtukas;MEŠKIUKAI;7859959104;Taip;12;0;0;12
9840;Spragtukas;MEŠKIUKAI;4548945364;Taip;14;3;0;17
9841;Spragtukas;MEŠKIUKAI;1865253659;Taip;11;0;0;11
9842;Spragtukas;MEŠKIUKAI;3692960591;Taip;10;0;0;10
9843;Spragtukas;MEŠKIUKAI;3337355440;Taip;0;1;0;1
9844;Spragtukas;MEŠKIUKAI;2987638580;Taip;0;1;0;1
9845;Spragtukas;MEŠKIUKAI;7511680722;Taip;5;1;0;6
9846;Spragtukas;MEŠKIUKAI;6679886985;Taip;5;0;0;5
9847;Spragtukas;MEŠKIUKAI;6347164708;Taip;7;0;0;7
9848;Strazdelis;Žiogelių;59969322783;Taip;7;7;0;14
9849;Strazdelis;Žiogelių;48052363003;Taip;0;5;0;5
9850;Strazdelis;Žiogelių;12739940649;Taip;8;0;0;8
9851;Strazdelis;Žiogelių;79443961061;Taip;0;7;0;7
9852;Strazdelis;Žiogelių;84548133061;Taip;0;6;0;6
9853;Strazdelis;Žiogelių;5449465531;Taip;17;0;0;17
9854;Strazdelis;Žiogelių;57514782479;Taip;11;3;0;14
9855;Strazdelis;Žiogelių;50984917126;Taip;0;0;1;1
9856;Strazdelis;Žiogelių;1058210612;Taip;8;0;0;8
9857;Strazdelis;Žiogelių;2110092578;Taip;0;2;0;2
9858;Strazdelis;Žiogelių;1858519255;Ne;8;4;0;12
9859;Strazdelis;Žiogelių;20845810823;Taip;0;9;1;10
9860;Strazdelis;Žiogelių;2086723106;Taip;9;0;1;10
9861;Strazdelis;Žiogelių;64076729200;Taip;0;5;0;5
9862;Strazdelis;Žiogelių;98433672584;Taip;0;2;1;3
9863;Strazdelis;Žiogelių;90936509570;Taip;1;0;0;1
9864;Strazdelis;Žiogelių;43128715501;Taip;7;2;0;9
9865;Strazdelis;Šeimynėlės;3662217925;Taip;5;4;0;9
9866;Strazdelis;Šeimynėlės;8274897977;Taip;1;17;0;18
9867;Strazdelis;Šeimynėlės;29586826889;Ne;4;4;0;8
9868;Strazdelis;Šeimynėlės;43314069648;Taip;0;1;0;1
9869;Strazdelis;Šeimynėlės;4697537943;Taip;0;8;0;8
9870;Strazdelis;Šeimynėlės;3943578036;Ne;9;2;0;11
9871;Strazdelis;Šeimynėlės;2802486859;Ne;0;2;0;2
9872;Strazdelis;Šeimynėlės;4791752179;Taip;5;0;1;6
9873;Strazdelis;Šeimynėlės;7215063033;Taip;0;1;0;1
9874;Strazdelis;Šeimynėlės;1665134387;Taip;0;5;0;5
9875;Strazdelis;Šeimynėlės;1481671624;Taip;0;2;0;2
9876;Strazdelis;Šeimynėlės;6014213362;Taip;0;5;0;5
9877;Strazdelis;Šeimynėlės;45083023033;Taip;8;2;0;10
9878;Strazdelis;Šeimynėlės;4454199703;Ne;0;8;0;8
9879;Strazdelis;Šeimynėlės;4698566091;Ne;0;2;0;2
9880;Strazdelis;Šeimynėlės;5698472204;Taip;6;0;0;6
9881;Strazdelis;Šeimynėlės;6528024720;Taip;0;4;0;4
9882;Strazdelis;Šeimynėlės;9835716116;Ne;0;3;0;3
9883;Strazdelis;Šeimynėlės;7149827850;Taip;0;12;0;12
9884;Strazdelis;Šeimynėlės;4633366779;Taip;0;1;0;1
9885;Strazdelis;Šeimynėlės;4929828091;Taip;0;2;0;2
9886;Strazdelis;Genelio;8038163444;Taip;0;2;0;2
9887;Strazdelis;Genelio;8754275576;Ne;0;1;0;1
9888;Strazdelis;Genelio;7216768880;Taip;0;2;0;2
9889;Strazdelis;Genelio;1540973269;Taip;0;1;0;1
9890;Strazdelis;Genelio;50350281905;Taip;8;4;0;12
9891;Strazdelis;Genelio;1187534672;Taip;0;2;0;2
9892;Strazdelis;Genelio;9198429790;Taip;0;3;0;3
9893;Strazdelis;Genelio;2871673641;Taip;9;2;0;11
9894;Strazdelis;Genelio;6147183190;Taip;5;1;0;6
9895;Strazdelis;Genelio;2078150337;Taip;0;3;0;3
9896;Strazdelis;Genelio;18461074207;Taip;0;1;0;1
9897;Strazdelis;Genelio;8801420992;Taip;0;12;0;12
9898;Strazdelis;Genelio;8634815556;Taip;0;0;1;1
9899;Strazdelis;Genelio;9904719582;Taip;7;0;0;7
9900;Strazdelis;Genelio;4655931716;Taip;0;9;0;9
9901;Strazdelis;Genelio;8182994112;Ne;10;3;0;13
9902;Strazdelis;Genelio;5371939820;Taip;0;3;0;3
9903;Strazdelis;Genelio;1362428967;Taip;0;2;0;2
9904;Strazdelis;Genelio;5981747175;Taip;5;0;2;7
9905;Strazdelis;Genelio;1847733888;Taip;10;0;1;11
9906;Strazdelis;Vikruolių;91962766970;Taip;0;1;0;1
9907;Strazdelis;Vikruolių;23376659452;Taip;0;6;0;6
9908;Strazdelis;Vikruolių;13220421668;Taip;10;1;0;11
9909;Strazdelis;Vikruolių;54050062292;Taip;0;6;0;6
9910;Strazdelis;Vikruolių;16453584376;Taip;0;3;0;3
9911;Strazdelis;Vikruolių;77589342371;Taip;4;4;0;8
9912;Strazdelis;Vikruolių;56012252629;Taip;0;4;0;4
9913;Strazdelis;Vikruolių;87689168341;Taip;5;0;0;5
9914;Strazdelis;Vikruolių;44566447637;Taip;0;1;0;1
9915;Strazdelis;Vikruolių;9065275674;Taip;0;7;0;7
9916;Strazdelis;Vikruolių;66254701944;Taip;0;8;0;8
9917;Strazdelis;Vikruolių;24001445236;Taip;0;2;0;2
9918;Strazdelis;Vikruolių;47547568043;Ne;0;1;0;1
9919;Strazdelis;Vikruolių;6523307315;Taip;12;2;0;14
9920;Strazdelis;Vikruolių;15920566059;Taip;0;4;0;4
9921;Strazdelis;Vikruolių;33123804487;Ne;0;6;0;6
9922;Strazdelis;Vyturėlių;13625184061;Taip;0;3;0;3
9923;Strazdelis;Vyturėlių;72069723016;Taip;0;3;0;3
9924;Strazdelis;Vyturėlių;18595696353;Taip;0;1;0;1
9925;Strazdelis;Vyturėlių;1426195737;Taip;0;5;0;5
9926;Strazdelis;Vyturėlių;2502465398;Taip;3;1;0;4
9927;Strazdelis;Vyturėlių;86957187003;Ne;0;6;0;6
9928;Strazdelis;Vyturėlių;1707225898;Ne;0;6;0;6
9929;Strazdelis;Vyturėlių;39502125227;Taip;0;5;0;5
9930;Strazdelis;Vyturėlių;43722400626;Taip;3;4;0;7
9931;Strazdelis;Vyturėlių;54646720821;Taip;8;0;0;8
9932;Strazdelis;Vyturėlių;47899514138;Taip;1;12;0;13
9933;Strazdelis;Vyturėlių;17045991832;Taip;0;1;0;1
9934;Strazdelis;Vyturėlių;49277241025;Taip;0;8;0;8
9935;Strazdelis;Vyturėlių;1535288878;Taip;0;4;0;4
9936;Strazdelis;Vyturėlių;58143176237;Taip;5;0;0;5
9937;Strazdelis;Vyturėlių;58440671129;Taip;12;1;0;13
9938;Strazdelis;Vyturėlių;83919699672;Taip;0;13;0;13
9939;Strazdelis;Vyturėlių;96062922228;Taip;0;2;0;2
9940;Strazdelis;Varpelio;8415383526;Taip;0;5;0;5
9941;Strazdelis;Varpelio;2580733127;Taip;0;1;0;1
9942;Strazdelis;Varpelio;2662549392;Taip;0;1;0;1
9943;Strazdelis;Varpelio;9502341478;Taip;3;2;0;5
9944;Strazdelis;Varpelio;6931726275;Ne;9;2;0;11
9945;Strazdelis;Varpelio;9401101407;Ne;0;6;0;6
9946;Strazdelis;Varpelio;1955166372;Taip;6;2;0;8
9947;Strazdelis;Varpelio;4873707286;Ne;15;2;0;17
9948;Strazdelis;Varpelio;6527855940;Taip;6;2;0;8
9949;Strazdelis;Varpelio;4076266466;Taip;0;22;0;22
9950;Strazdelis;Varpelio;2824416350;Taip;0;3;0;3
9951;Strazdelis;Varpelio;3610250359;Taip;6;3;0;9
9952;Strazdelis;Varpelio;2766970956;Taip;6;0;0;6
9953;Strazdelis;Varpelio;2329522074;Taip;0;10;0;10
9954;Strazdelis;Varpelio;7393083827;Taip;0;1;0;1
9955;Strazdelis;Varpelio;6555803164;Taip;0;3;0;3
9956;Strazdelis;Varpelio;1021364759;Taip;10;0;0;10
9957;Strazdelis;Varpelio;1706026100;Ne;3;7;0;10
9958;Strazdelis;Pelėdžiukų;1901641517;Taip;10;1;0;11
9959;Strazdelis;Pelėdžiukų;8637386316;Taip;0;2;0;2
9960;Strazdelis;Pelėdžiukų;1704292727;Taip;0;7;0;7
9961;Strazdelis;Pelėdžiukų;4617237063;Taip;0;7;0;7
9962;Strazdelis;Pelėdžiukų;3036380561;Taip;0;7;0;7
9963;Strazdelis;Pelėdžiukų;8371999002;Ne;0;2;0;2
9964;Strazdelis;Pelėdžiukų;8287554571;Taip;2;0;0;2
9965;Strazdelis;Pelėdžiukų;4448556404;Taip;7;0;0;7
9966;Strazdelis;Pelėdžiukų;8854150040;Taip;0;12;0;12
9967;Strazdelis;Pelėdžiukų;4004930488;Taip;5;0;0;5
9968;Strazdelis;Pelėdžiukų;5768674837;Taip;5;2;0;7
9969;Strazdelis;Pelėdžiukų;7349106795;Taip;0;2;0;2
9970;Strazdelis;Pelėdžiukų;9761595867;Taip;10;0;0;10
9971;Strazdelis;Pelėdžiukų;8089585177;Taip;0;1;0;1
9972;Strazdelis;Pelėdžiukų;7876385010;Taip;5;2;0;7
9973;Strazdelis;Pelėdžiukų;2848984531;Taip;7;0;0;7
9974;Strazdelis;Pelėdžiukų;7471890377;Taip;5;1;0;6
9975;Strazdelis;Saulutės;1474503932;Taip;10;0;0;10
9976;Strazdelis;Saulutės;27177757900;Taip;0;2;3;5
9977;Strazdelis;Saulutės;40932140069;Taip;7;0;0;7
9978;Strazdelis;Saulutės;1523471662;Taip;0;13;0;13
9979;Strazdelis;Saulutės;2854642875;Taip;8;0;2;10
9980;Strazdelis;Saulutės;7578229276;Taip;0;1;0;1
9981;Strazdelis;Saulutės;6614184499;Taip;11;0;0;11
9982;Strazdelis;Saulutės;4129957131;Taip;2;1;0;3
9983;Strazdelis;Saulutės;3425430317;Taip;0;1;0;1
9984;Strazdelis;Saulutės;5059832307;Taip;0;2;0;2
9985;Strazdelis;Saulutės;7081517417;Taip;0;1;0;1
9986;Strazdelis;Saulutės;67641340859;Taip;1;2;0;3
9987;Strazdelis;Saulutės;15298412755;Ne;8;4;0;12
9988;Strazdelis;Saulutės;1802092125;Taip;6;1;0;7
9989;Strazdelis;Saulutės;1391009140;Taip;10;2;0;12
9990;Strazdelis;Saulutės;6779352728;Taip;11;0;0;11
9991;Strazdelis;Saulutės;12713270671;Taip;8;2;0;10
9992;Strazdelis;Saulutės;6113491562;Taip;3;0;0;3
9993;Strazdelis;Saulutės;1693309238;Taip;0;3;0;3
9994;Strazdelis;Bitutės;24669852216;Taip;6;3;0;9
9995;Strazdelis;Bitutės;51702469375;Taip;3;0;0;3
9996;Strazdelis;Bitutės;59837435595;Ne;0;14;0;14
9997;Strazdelis;Bitutės;90089166514;Taip;0;5;0;5
9998;Strazdelis;Bitutės;96077591556;Taip;0;2;0;2
9999;Strazdelis;Bitutės;14459771394;Taip;0;2;0;2
10000;Strazdelis;Bitutės;34644143572;Taip;0;12;0;12
10001;Strazdelis;Bitutės;61820727992;Taip;0;1;0;1
10002;Strazdelis;Bitutės;7812253305;Taip;0;2;0;2
10003;Strazdelis;Bitutės;1140100663;Taip;0;2;0;2
10004;Strazdelis;Bitutės;60128913543;Taip;0;5;0;5
10005;Strazdelis;Bitutės;76361365558;Ne;5;0;0;5
10006;Strazdelis;Bitutės;1735868807;Taip;0;2;5;7
10007;Strazdelis;Bitutės;2350690409;Taip;0;2;0;2
10008;Strazdelis;Bitutės;29225108934;Taip;0;4;0;4
10009;Strazdelis;Bitutės;68605763183;Taip;0;22;0;22
10010;Strazdelis;Bitutės;1785962711;Taip;10;7;0;17
10011;Strazdelis;Mažylių;8753316532;Taip;7;0;1;8
10012;Strazdelis;Mažylių;2081538505;Taip;8;0;0;8
10013;Strazdelis;Mažylių;3043580835;Taip;7;1;0;8
10014;Strazdelis;Mažylių;4369569609;Taip;0;8;5;13
10015;Strazdelis;Mažylių;1005082012;Ne;11;0;0;11
10016;Strazdelis;Mažylių;5232064496;Taip;10;1;0;11
10017;Strazdelis;Mažylių;4784401449;Ne;10;0;0;10
10018;Strazdelis;Mažylių;4020547762;Taip;2;1;0;3
10019;Strazdelis;Mažylių;3149930355;Taip;4;0;2;6
10020;Strazdelis;Mažylių;9435593972;Ne;0;0;2;2
10021;Strazdelis;Mažylių;8485509145;Taip;0;5;0;5
10022;Strazdelis;Mažylių;1539984888;Taip;4;2;0;6
10023;Strazdelis;Mažylių;4400849922;Taip;5;1;0;6
10024;Strazdelis;Mažylių;6508933324;Taip;6;0;0;6
10025;Strazdelis;Pabiručių;7913526787;Taip;6;8;0;14
10026;Strazdelis;Pabiručių;8277333786;Taip;6;1;0;7
10027;Strazdelis;Pabiručių;8686828982;Taip;5;0;0;5
10028;Strazdelis;Pabiručių;8581533423;Taip;7;0;0;7
10029;Strazdelis;Pabiručių;7425818775;Taip;0;0;1;1
10030;Strazdelis;Pabiručių;1194918926;Taip;0;4;0;4
10031;Strazdelis;Pabiručių;6370912320;Taip;0;0;7;7
10032;Strazdelis;Pabiručių;9933042249;Taip;4;6;0;10
10033;Strazdelis;Pabiručių;1141752802;Taip;2;0;1;3
10034;Strazdelis;Pabiručių;9567476872;Ne;11;0;0;11
10035;Strazdelis;Pabiručių;1683900907;Taip;0;1;0;1
10036;Strazdelis;Pabiručių;6651360492;Taip;7;0;0;7
10037;Šermukšnėlė;MOLINUKAI;68060386099;Taip;0;5;2;7
10038;Šermukšnėlė;MOLINUKAI;61809452162;Taip;0;5;0;5
10039;Šermukšnėlė;MOLINUKAI;60863269031;Taip;0;4;0;4
10040;Šermukšnėlė;MOLINUKAI;39534021804;Taip;0;1;2;3
10041;Šermukšnėlė;MOLINUKAI;54312555311;Taip;0;0;6;6
10042;Šermukšnėlė;MOLINUKAI;3873114056;Taip;0;0;1;1
10043;Šermukšnėlė;MOLINUKAI;1561527473;Taip;0;0;4;4
10044;Šermukšnėlė;MOLINUKAI;83487643143;Taip;4;0;0;4
10045;Šermukšnėlė;MOLINUKAI;2012112541;Ne;0;1;5;6
10046;Šermukšnėlė;MOLINUKAI;1411650732;Ne;17;0;0;17
10047;Šermukšnėlė;MOLINUKAI;7830792252;Taip;9;0;2;11
10048;Šermukšnėlė;MOLINUKAI;8333291496;Ne;0;0;6;6
10049;Šermukšnėlė;MOLINUKAI;1756161106;Taip;3;0;3;6
10050;Šermukšnėlė;MOLINUKAI;1105249315;Ne;5;0;2;7
10051;Šermukšnėlė;MOLINUKAI;1543336828;Ne;0;0;3;3
10052;Šermukšnėlė;MOLINUKAI;2050855662;Ne;4;0;0;4
10053;Šermukšnėlė;MOLINUKAI;2561033248;Taip;0;7;0;7
10054;Šermukšnėlė;ŠIAUDINUKAI;85959255744;Taip;0;0;3;3
10055;Šermukšnėlė;ŠIAUDINUKAI;16859553972;Taip;6;0;2;8
10056;Šermukšnėlė;ŠIAUDINUKAI;99444734331;Taip;0;0;1;1
10057;Šermukšnėlė;ŠIAUDINUKAI;3851927973;Taip;13;0;1;14
10058;Šermukšnėlė;ŠIAUDINUKAI;31537402750;Taip;0;0;7;7
10059;Šermukšnėlė;ŠIAUDINUKAI;87587621833;Taip;10;0;0;10
10060;Šermukšnėlė;ŠIAUDINUKAI;1738008915;Taip;2;0;1;3
10061;Šermukšnėlė;ŠIAUDINUKAI;28087351377;Taip;7;0;0;7
10062;Šermukšnėlė;ŠIAUDINUKAI;87315703379;Taip;0;4;0;4
10063;Šermukšnėlė;ŠIAUDINUKAI;82928987881;Taip;0;6;0;6
10064;Šermukšnėlė;ŠIAUDINUKAI;1367964100;Taip;2;6;0;8
10065;Šermukšnėlė;ŠIAUDINUKAI;2100740973;Taip;6;0;0;6
10066;Šermukšnėlė;TOŠINUKAI;1290319484;Taip;0;4;0;4
10067;Šermukšnėlė;TOŠINUKAI;1846720859;Taip;0;0;2;2
10068;Šermukšnėlė;TOŠINUKAI;1559325175;Taip;5;5;0;10
10069;Šermukšnėlė;TOŠINUKAI;2137141949;Taip;8;0;0;8
10070;Šermukšnėlė;TOŠINUKAI;1858862320;Taip;8;5;0;13
10071;Šermukšnėlė;TOŠINUKAI;42127117636;Taip;5;0;0;5
10072;Šermukšnėlė;TOŠINUKAI;85018940292;Ne;9;0;3;12
10073;Šermukšnėlė;TOŠINUKAI;92414041480;Taip;0;0;1;1
10074;Šermukšnėlė;TOŠINUKAI;1112022308;Taip;13;0;0;13
10075;Šermukšnėlė;TOŠINUKAI;1828510990;Taip;8;0;0;8
10076;Šermukšnėlė;ODINUKAI;2176788727;Taip;5;0;1;6
10077;Šermukšnėlė;ODINUKAI;3148857617;Taip;0;12;0;12
10078;Šermukšnėlė;ODINUKAI;5575518612;Taip;15;0;1;16
10079;Šermukšnėlė;ODINUKAI;3322053946;Taip;0;9;0;9
10080;Šermukšnėlė;ODINUKAI;5733540837;Taip;0;11;1;12
10081;Šermukšnėlė;ODINUKAI;5159461963;Taip;0;7;0;7
10082;Šermukšnėlė;ODINUKAI;5354978646;Taip;3;0;3;6
10083;Šermukšnėlė;ODINUKAI;1882432812;Taip;3;0;2;5
10084;Šermukšnėlė;ODINUKAI;5151843494;Taip;2;0;0;2
10085;Šermukšnėlė;ODINUKAI;5242187638;Ne;0;7;0;7
10086;Šermukšnėlė;ODINUKAI;1148559284;Taip;0;5;2;7
10087;Šermukšnėlė;ODINUKAI;3949629658;Taip;6;0;0;6
10088;Šermukšnėlė;ODINUKAI;6105915822;Taip;0;0;1;1
10089;Šermukšnėlė;ODINUKAI;7667114310;Taip;0;0;3;3
10090;Šermukšnėlė;ODINUKAI;7245206247;Taip;0;0;5;5
10091;Šermukšnėlė;ODINUKAI;5397385093;Taip;8;0;1;9
10092;Šermukšnėlė;KRIAUKLELĖS;8123096990;Taip;4;6;0;10
10093;Šermukšnėlė;KRIAUKLELĖS;1110375562;Taip;0;3;0;3
10094;Šermukšnėlė;KRIAUKLELĖS;8511421692;Taip;0;0;4;4
10095;Šermukšnėlė;KRIAUKLELĖS;6896990721;Taip;0;2;0;2
10096;Šermukšnėlė;KRIAUKLELĖS;3639954786;Taip;0;0;1;1
10097;Šermukšnėlė;KRIAUKLELĖS;5757405893;Taip;0;0;1;1
10098;Šermukšnėlė;KRIAUKLELĖS;1902848560;Taip;5;0;1;6
10099;Šermukšnėlė;KRIAUKLELĖS;8407947566;Ne;0;0;1;1
10100;Šermukšnėlė;KRIAUKLELĖS;7843128263;Ne;8;0;0;8
10101;Šermukšnėlė;KRIAUKLELĖS;3513568460;Taip;11;0;3;14
10102;Šermukšnėlė;KRIAUKLELĖS;6067298318;Taip;6;0;0;6
10103;Šermukšnėlė;KRIAUKLELĖS;4230698872;Taip;0;5;0;5
10104;Šermukšnėlė;KRIAUKLELĖS;4569484117;Taip;3;3;0;6
10105;Šermukšnėlė;KRIAUKLELĖS;8064473083;Taip;12;0;0;12
10106;Šermukšnėlė;KRIAUKLELĖS;2837099502;Taip;0;0;2;2
10107;Šermukšnėlė;KRIAUKLELĖS;7548637091;Ne;10;0;1;11
10108;Šermukšnėlė;VYTINUKAI;97906920174;Ne;0;0;5;5
10109;Šermukšnėlė;VYTINUKAI;1523361932;Taip;0;3;0;3
10110;Šermukšnėlė;VYTINUKAI;25189813939;Taip;0;12;0;12
10111;Šermukšnėlė;VYTINUKAI;33936407625;Taip;0;0;7;7
10112;Šermukšnėlė;VYTINUKAI;83123267733;Taip;0;4;0;4
10113;Šermukšnėlė;VYTINUKAI;20028832329;Taip;0;2;0;2
10114;Šermukšnėlė;VYTINUKAI;3959795064;Taip;0;0;2;2
10115;Šermukšnėlė;VYTINUKAI;8498288021;Ne;0;1;0;1
10116;Šermukšnėlė;VYTINUKAI;3751769136;Taip;2;0;2;4
10117;Šermukšnėlė;VYTINUKAI;5905000902;Taip;6;0;2;8
10118;Šermukšnėlė;VYTINUKAI;6291531570;Taip;8;0;0;8
10119;Šermukšnėlė;VYTINUKAI;1244964311;Ne;0;2;2;4
10120;Šermukšnėlė;VYTINUKAI;83882579952;Taip;0;6;0;6
10121;Šermukšnėlė;VYTINUKAI;60840526220;Taip;0;0;2;2
10122;Šermukšnėlė;VYTINUKAI;1519623099;Taip;0;15;0;15
10123;Šermukšnėlė;VYTINUKAI;7106405983;Ne;0;0;3;3
10124;Šermukšnėlė;VYTINUKAI;9654198217;Ne;0;0;4;4
10125;Šermukšnėlė;VYTINUKAI;1670047548;Taip;9;0;2;11
10126;Šermukšnėlė;GINTARĖLIAI;3147809450;Taip;0;0;2;2
10127;Šermukšnėlė;GINTARĖLIAI;1167696952;Taip;0;0;3;3
10128;Šermukšnėlė;GINTARĖLIAI;85062380771;Taip;15;0;0;15
10129;Šermukšnėlė;GINTARĖLIAI;35389950541;Taip;0;0;2;2
10130;Šermukšnėlė;GINTARĖLIAI;1944687724;Taip;10;0;2;12
10131;Šermukšnėlė;GINTARĖLIAI;1013698297;Taip;13;0;2;15
10132;Šermukšnėlė;GINTARĖLIAI;2094932013;Ne;11;0;1;12
10133;Šermukšnėlė;GINTARĖLIAI;1851549466;Taip;5;0;4;9
10134;Šermukšnėlė;GINTARĖLIAI;3697936074;Taip;11;0;0;11
10135;Šermukšnėlė;GINTARĖLIAI;2686950289;Ne;9;1;0;10
10136;Šermukšnėlė;GINTARĖLIAI;27183547828;Ne;0;0;6;6
10137;Šermukšnėlė;GINTARĖLIAI;10728235594;Ne;10;0;2;12
10138;Šermukšnėlė;GINTARĖLIAI;42477406335;Taip;3;11;0;14
10139;Šermukšnėlė;GINTARĖLIAI;61300763004;Taip;0;2;1;3
10140;Šermukšnėlė;GINTARĖLIAI;1425285365;Taip;2;0;2;4
10141;Šermukšnėlė;GINTARĖLIAI;6279210465;Taip;5;0;4;9
10142;Šermukšnėlė;GINTARĖLIAI;1562494176;Taip;0;7;0;7
10143;Šermukšnėlė;AKMENUKAI;95089450234;Ne;0;0;2;2
10144;Šermukšnėlė;AKMENUKAI;27139089487;Taip;0;2;0;2
10145;Šermukšnėlė;AKMENUKAI;42520543068;Taip;2;10;0;12
10146;Šermukšnėlė;AKMENUKAI;76682206033;Taip;2;0;1;3
10147;Šermukšnėlė;AKMENUKAI;3628734426;Taip;0;4;0;4
10148;Šermukšnėlė;AKMENUKAI;82161996761;Taip;6;0;0;6
10149;Šermukšnėlė;AKMENUKAI;98850511500;Taip;7;15;0;22
10150;Šermukšnėlė;AKMENUKAI;48653098796;Taip;0;6;0;6
10151;Šermukšnėlė;AKMENUKAI;26775257484;Taip;0;0;3;3
10152;Šermukšnėlė;AKMENUKAI;82028252228;Taip;2;0;3;5
10153;Šermukšnėlė;AKMENUKAI;23434568160;Taip;3;0;0;3
10154;Šermukšnėlė;AKMENUKAI;3543061360;Taip;0;3;0;3
10155;Šermukšnėlė;AKMENUKAI;6255671190;Taip;0;0;3;3
10156;Šermukšnėlė;AKMENUKAI;7564745299;Taip;12;2;0;14
10157;Šermukšnėlė;AKMENUKAI;9617044855;Ne;0;7;0;7
10158;Šermukšnėlė;AKMENUKAI;1856012121;Taip;0;0;1;1
10159;Šermukšnėlė;SIŪLINUKAI;32417473492;Taip;3;2;0;5
10160;Šermukšnėlė;SIŪLINUKAI;35508499818;Taip;3;2;0;5
10161;Šermukšnėlė;SIŪLINUKAI;30853722796;Taip;0;0;2;2
10162;Šermukšnėlė;SIŪLINUKAI;41661711151;Taip;5;0;3;8
10163;Šermukšnėlė;SIŪLINUKAI;62420710883;Taip;0;0;4;4
10164;Šermukšnėlė;SIŪLINUKAI;57211490716;Taip;9;0;0;9
10165;Šermukšnėlė;SIŪLINUKAI;88123535614;Taip;13;0;0;13
10166;Šermukšnėlė;SIŪLINUKAI;61911120798;Taip;0;0;1;1
10167;Šermukšnėlė;SIŪLINUKAI;3089008915;Taip;0;0;1;1
10168;Šermukšnėlė;SIŪLINUKAI;20160146304;Taip;0;0;1;1
10169;Šermukšnėlė;SIŪLINUKAI;1330471614;Taip;0;0;1;1
10170;Šermukšnėlė;SIŪLINUKAI;1127786451;Taip;0;1;0;1
10171;Šermukšnėlė;SIŪLINUKAI;18799838453;Taip;0;1;1;2
10172;Šermukšnėlė;SIŪLINUKAI;1891818706;Taip;0;0;1;1
10173;Šermukšnėlė;SIŪLINUKAI;78916223877;Taip;10;0;0;10
10174;Šermukšnėlė;SIŪLINUKAI;45632551657;Ne;0;2;2;4
10175;Šermukšnėlė;MEDINUKAi;2380988728;Ne;10;1;0;11
10176;Šermukšnėlė;MEDINUKAi;2529526401;Ne;10;0;1;11
10177;Šermukšnėlė;MEDINUKAi;8956573129;Ne;5;5;0;10
10178;Šermukšnėlė;MEDINUKAi;3222466449;Taip;12;0;1;13
10179;Šermukšnėlė;MEDINUKAi;5096946133;Taip;2;8;0;10
10180;Šermukšnėlė;MEDINUKAi;8279692394;Taip;8;0;0;8
10181;Šermukšnėlė;MEDINUKAi;78341448188;Taip;1;0;2;3
10182;Šermukšnėlė;MEDINUKAi;1661977128;Ne;3;0;6;9
10183;Šermukšnėlė;MEDINUKAi;6430627501;Taip;0;1;0;1
10184;Šermukšnėlė;MEDINUKAi;5832072195;Taip;0;16;0;16
10185;Šermukšnėlė;MEDINUKAi;9035625467;Taip;0;3;0;3
10186;Šermukšnėlė;MEDINUKAi;7038705221;Taip;12;0;0;12
10187;Šermukšnėlė;MEDINUKAi;3081548524;Ne;0;2;1;3
10188;Šermukšnėlė;MEDINUKAi;5140264695;Ne;0;2;0;2
10189;Šermukšnėlė;MEDINUKAi;3994316729;Taip;0;15;0;15
10190;Šermukšnėlė;MEDINUKAi;6413821285;Taip;5;0;1;6
10191;Šermukšnėlė;MEDINUKAi;4981204674;Taip;0;0;1;1
10192;Šermukšnėlė;SKUDURINUKAI;6351841889;Taip;12;0;0;12
10193;Šermukšnėlė;SKUDURINUKAI;2989011150;Taip;10;0;0;10
10194;Šermukšnėlė;SKUDURINUKAI;5069572637;Taip;3;0;0;3
10195;Šermukšnėlė;SKUDURINUKAI;1636944853;Taip;5;0;0;5
10196;Šermukšnėlė;SKUDURINUKAI;3747531232;Taip;6;0;0;6
10197;Šermukšnėlė;SKUDURINUKAI;1994737857;Taip;8;0;0;8
10198;Šermukšnėlė;SKUDURINUKAI;4619811264;Taip;3;0;1;4
10199;Šermukšnėlė;SKUDURINUKAI;4805637096;Taip;7;0;0;7
10200;Šermukšnėlė;SKUDURINUKAI;6249700552;Taip;7;0;0;7
10201;Šermukšnėlė;SKUDURINUKAI;7053319091;Taip;7;0;0;7
10202;Šermukšnėlė;SKUDURINUKAI;9714566919;Taip;2;1;0;3
10203;Šermukšnėlė;SKUDURINUKAI;6194188831;Taip;4;0;0;4
10204;Šermukšnėlė;SKUDURINUKAI;1437314920;Taip;0;7;0;7
10205;Šermukšnėlė;PAGRANDUKAI;2447547509;Taip;0;0;2;2
10206;Šermukšnėlė;PAGRANDUKAI;9876533442;Taip;6;0;2;8
10207;Šermukšnėlė;PAGRANDUKAI;3613456202;Taip;0;0;2;2
10208;Šermukšnėlė;PAGRANDUKAI;8709426669;Taip;0;7;0;7
10209;Šermukšnėlė;PAGRANDUKAI;3170388518;Ne;0;0;2;2
10210;Šermukšnėlė;PAGRANDUKAI;6585484701;Taip;7;0;0;7
10211;Šermukšnėlė;PAGRANDUKAI;3653792683;Taip;0;0;1;1
10212;Šermukšnėlė;PAGRANDUKAI;6599779539;Taip;4;6;0;10
10213;Šermukšnėlė;PAGRANDUKAI;5678559268;Taip;9;0;0;9
10214;Šypsena;NYKŠTUKAI;3809171499;Taip;9;0;1;10
10215;Šypsena;NYKŠTUKAI;1114341518;Taip;4;0;1;5
10216;Šypsena;NYKŠTUKAI;1558614852;Taip;3;1;1;5
10217;Šypsena;NYKŠTUKAI;1897176871;Taip;4;1;0;5
10218;Šypsena;NYKŠTUKAI;8715718525;Taip;0;0;2;2
10219;Šypsena;NYKŠTUKAI;2312828770;Taip;7;1;1;9
10220;Šypsena;NYKŠTUKAI;1181590127;Taip;0;13;0;13
10221;Šypsena;NYKŠTUKAI;4808041625;Taip;5;1;3;9
10222;Šypsena;NYKŠTUKAI;1422418997;Taip;7;4;0;11
10223;Šypsena;NYKŠTUKAI;5834057370;Taip;0;3;0;3
10224;Šypsena;NYKŠTUKAI;1515803985;Ne;3;5;0;8
10225;Šypsena;NYKŠTUKAI;5928432220;Taip;0;5;0;5
10226;Šypsena;NYKŠTUKAI;5504570516;Taip;0;0;3;3
10227;Šypsena;NYKŠTUKAI;1063834589;Taip;0;3;0;3
10228;Šypsena;NYKŠTUKAI;2798819321;Taip;0;1;0;1
10229;Šypsena;NYKŠTUKAI;4038279267;Taip;7;0;0;7
10230;Šypsena;NYKŠTUKAI;8950694484;Taip;0;1;0;1
10231;Šypsena;NYKŠTUKAI;4344780723;Taip;5;0;8;13
10232;Šypsena;NYKŠTUKAI;1893123775;Taip;11;0;2;13
10233;Šypsena;NYKŠTUKAI;6237208661;Taip;0;0;3;3
10234;Šypsena;NYKŠTUKAI;3506046076;Ne;0;1;3;4
10235;Šypsena;NYKŠTUKAI;7519967594;Taip;2;0;1;3
10236;Šypsena;SPINDULIUKAI;5568502083;Ne;10;0;0;10
10237;Šypsena;SPINDULIUKAI;1795366502;Taip;0;1;10;11
10238;Šypsena;SPINDULIUKAI;2706678026;Ne;10;0;0;10
10239;Šypsena;SPINDULIUKAI;3063226692;Ne;0;0;4;4
10240;Šypsena;SPINDULIUKAI;4936775366;Taip;10;0;9;19
10241;Šypsena;SPINDULIUKAI;7569495879;Taip;0;0;1;1
10242;Šypsena;SPINDULIUKAI;2248628927;Taip;5;4;0;9
10243;Šypsena;SPINDULIUKAI;2995753269;Taip;0;0;2;2
10244;Šypsena;SPINDULIUKAI;4635232236;Taip;0;3;7;10
10245;Šypsena;SPINDULIUKAI;1796837022;Taip;2;0;2;4
10246;Šypsena;SPINDULIUKAI;4677405885;Taip;0;5;1;6
10247;Šypsena;SPINDULIUKAI;6590285866;Taip;0;0;1;1
10248;Šypsena;SPINDULIUKAI;1343249939;Taip;0;5;13;18
10249;Šypsena;SPINDULIUKAI;5985974927;Taip;0;3;0;3
10250;Šypsena;SPINDULIUKAI;1387130727;Taip;10;0;1;11
10251;Šypsena;SPINDULIUKAI;3025437080;Taip;8;0;3;11
10252;Šypsena;SPINDULIUKAI;1669768648;Ne;11;0;8;19
10253;Šypsena;SPINDULIUKAI;1575413188;Taip;0;0;9;9
10254;Šypsena;SPINDULIUKAI;2005543016;Ne;0;0;3;3
10255;Šypsena;SKRUZDELIUKAI;5642959574;Ne;0;6;0;6
10256;Šypsena;SKRUZDELIUKAI;7538681006;Taip;9;0;0;9
10257;Šypsena;SKRUZDELIUKAI;1967590536;Taip;0;22;0;22
10258;Šypsena;SKRUZDELIUKAI;1659390234;Ne;0;1;1;2
10259;Šypsena;SKRUZDELIUKAI;1272973534;Ne;8;0;3;11
10260;Šypsena;SKRUZDELIUKAI;1917246860;Ne;0;4;0;4
10261;Šypsena;SKRUZDELIUKAI;46569341613;Ne;17;0;0;17
10262;Šypsena;SKRUZDELIUKAI;42130115068;Taip;0;9;0;9
10263;Šypsena;SKRUZDELIUKAI;6444616846;Taip;0;2;0;2
10264;Šypsena;SKRUZDELIUKAI;1712017606;Ne;0;2;0;2
10265;Šypsena;SKRUZDELIUKAI;3541189470;Ne;4;2;0;6
10266;Šypsena;SKRUZDELIUKAI;1996746426;Taip;10;1;0;11
10267;Šypsena;SKRUZDELIUKAI;4017777389;Taip;0;0;1;1
10268;Šypsena;SKRUZDELIUKAI;70188972463;Taip;1;0;1;2
10269;Šypsena;SKRUZDELIUKAI;76332370575;Taip;7;1;1;9
10270;Šypsena;SKRUZDELIUKAI;1906529989;Taip;11;5;0;16
10271;Šypsena;SKRUZDELIUKAI;2099216049;Taip;10;1;1;12
10272;Šypsena;SKRUZDELIUKAI;89503728819;Ne;0;6;0;6
10273;Šypsena;SKRUZDELIUKAI;93678429536;Taip;0;2;0;2
10274;Šypsena;SKRUZDELIUKAI;8197460768;Taip;0;1;0;1
10275;Šypsena;SKRUZDELIUKAI;1133113196;Ne;1;14;0;15
10276;Šypsena;Bitutės;1702152247;Taip;0;2;0;2
10277;Šypsena;Bitutės;5971488796;Taip;0;2;0;2
10278;Šypsena;Bitutės;5680397153;Taip;17;0;5;22
10279;Šypsena;Bitutės;25175991441;Taip;0;1;2;3
10280;Šypsena;Bitutės;2117865969;Taip;0;3;0;3
10281;Šypsena;Bitutės;1329170686;Taip;5;4;0;9
10282;Šypsena;Bitutės;1369664461;Ne;0;2;0;2
10283;Šypsena;Bitutės;2368339278;Taip;0;8;0;8
10284;Šypsena;Bitutės;91846404526;Ne;0;4;0;4
10285;Šypsena;Bitutės;39296351965;Taip;0;2;0;2
10286;Šypsena;Bitutės;17041968817;Taip;4;3;0;7
10287;Šypsena;Bitutės;1972212253;Taip;5;2;1;8
10288;Šypsena;Bitutės;79177095462;Taip;4;0;0;4
10289;Šypsena;Bitutės;39495782526;Taip;4;3;0;7
10290;Šypsena;MEŠKIUKAI;7877396588;Taip;0;0;1;1
10291;Šypsena;MEŠKIUKAI;1431850136;Taip;13;0;0;13
10292;Šypsena;MEŠKIUKAI;1324902555;Taip;2;0;0;2
10293;Šypsena;MEŠKIUKAI;7946379086;Taip;0;0;6;6
10294;Šypsena;MEŠKIUKAI;7160466766;Taip;7;0;3;10
10295;Šypsena;MEŠKIUKAI;3823623458;Ne;0;4;0;4
10296;Šypsena;MEŠKIUKAI;4695547847;Taip;5;0;0;5
10297;Šypsena;MEŠKIUKAI;6713182218;Taip;7;0;1;8
10298;Šypsena;MEŠKIUKAI;7537442618;Taip;0;5;0;5
10299;Šypsena;MEŠKIUKAI;3968514430;Taip;0;2;0;2
10300;Šypsena;MEŠKIUKAI;6716558946;Taip;8;3;0;11
10301;Šypsena;BORUŽĖLĖS;8215278033;Taip;6;0;0;6
10302;Šypsena;BORUŽĖLĖS;2372820133;Taip;9;0;0;9
10303;Šypsena;BORUŽĖLĖS;5879506651;Taip;2;0;3;5
10304;Šypsena;BORUŽĖLĖS;8164410749;Taip;0;0;1;1
10305;Šypsena;BORUŽĖLĖS;7898387398;Taip;12;0;0;12
10306;Šypsena;BORUŽĖLĖS;1623728091;Taip;7;0;0;7
10307;Šypsena;BORUŽĖLĖS;2584574423;Taip;5;0;0;5
10308;Šypsena;BORUŽĖLĖS;5906001927;Taip;3;1;0;4
10309;Šypsena;BORUŽĖLĖS;6229905007;Taip;0;5;0;5
10310;Šypsena;BORUŽĖLĖS;7120597034;Taip;15;0;0;15
10311;Šypsena;BORUŽĖLĖS;4520148322;Taip;8;0;0;8
10312;Šnekutis;DRUGELIŲ;1430790285;Taip;0;0;17;17
10313;Šnekutis;DRUGELIŲ;70663269171;Taip;4;0;1;5
10314;Šnekutis;DRUGELIŲ;65711574140;Taip;0;0;7;7
10315;Šnekutis;DRUGELIŲ;1723901018;Taip;0;0;1;1
10316;Šnekutis;DRUGELIŲ;81648325534;Taip;3;0;1;4
10317;Šnekutis;DRUGELIŲ;2000728679;Taip;5;0;0;5
10318;Šnekutis;DRUGELIŲ;1956224017;Taip;8;0;0;8
10319;Šnekutis;DRUGELIŲ;1159232792;Taip;10;0;3;13
10320;Šnekutis;DRUGELIŲ;2092637040;Taip;10;0;2;12
10321;Šnekutis;DRUGELIŲ;94289379983;Taip;5;0;0;5
10322;Šnekutis;DRUGELIŲ;13209811505;Ne;7;0;9;16
10323;Šnekutis;DRUGELIŲ;5962885680;Ne;0;0;2;2
10324;Šnekutis;DRUGELIŲ;4743885834;Taip;11;0;2;13
10325;Šnekutis;DRUGELIŲ;5029631107;Taip;0;7;0;7
10326;Šnekutis;DRUGELIŲ;4104052524;Ne;0;0;1;1
10327;Šnekutis;DRUGELIŲ;2102893949;Taip;0;0;6;6
10328;Šnekutis;Kačiukų;9601932777;Taip;0;18;0;18
10329;Šnekutis;Kačiukų;4302555600;Taip;0;18;0;18
10330;Šnekutis;Kačiukų;3281475303;Taip;8;0;1;9
10331;Šnekutis;Kačiukų;5052137859;Taip;5;0;1;6
10332;Šnekutis;Kačiukų;8531521901;Taip;10;0;1;11
10333;Šnekutis;Kačiukų;9670205249;Taip;0;0;1;1
10334;Šnekutis;Kačiukų;7615716438;Taip;0;0;5;5
10335;Šnekutis;Kačiukų;9780684867;Ne;5;0;2;7
10336;Šnekutis;Kačiukų;3271262071;Taip;5;0;1;6
10337;Šnekutis;Kačiukų;4405567649;Taip;17;1;0;18
10338;Šnekutis;Kačiukų;3166309530;Taip;0;9;0;9
10339;Šnekutis;Kačiukų;5049964996;Taip;0;1;7;8
10340;Šnekutis;Kačiukų;4143844589;Taip;7;8;0;15
10341;Šnekutis;Kačiukų;9312935803;Taip;0;12;2;14
10342;Šnekutis;Kačiukų;7236658561;Ne;0;0;1;1
10343;Šnekutis;Kačiukų;4992188525;Ne;10;1;0;11
10344;Šnekutis;Kačiukų;7638626055;Taip;0;11;4;15
10345;Šnekutis;Kačiukų;9896249776;Taip;13;0;6;19
10346;Šnekutis;Kačiukų;9157136735;Taip;6;8;0;14
10347;Šnekutis;Kačiukų;9790803767;Taip;4;4;1;9
10348;Šnekutis;Kačiukų;7434438142;Taip;0;7;0;7
10349;Šnekutis;Pėlėdžiukų;3068754741;Taip;0;0;2;2
10350;Šnekutis;Pėlėdžiukų;4334155280;Taip;0;0;7;7
10351;Šnekutis;Pėlėdžiukų;77534335117;Ne;0;12;3;15
10352;Šnekutis;Pėlėdžiukų;3312928478;Taip;4;0;0;4
10353;Šnekutis;Pėlėdžiukų;42697936562;Taip;12;0;1;13
10354;Šnekutis;Pėlėdžiukų;8866360301;Taip;0;0;2;2
10355;Šnekutis;Pėlėdžiukų;8745465796;Taip;0;13;9;22
10356;Šnekutis;Pėlėdžiukų;3170928052;Taip;1;0;2;3
10357;Šnekutis;Pėlėdžiukų;5321817615;Taip;5;0;2;7
10358;Šnekutis;Pėlėdžiukų;2233161242;Taip;2;0;0;2
10359;Šnekutis;Pėlėdžiukų;3578045341;Taip;0;1;0;1
10360;Šnekutis;Pėlėdžiukų;5117544317;Taip;0;0;2;2
10361;Šnekutis;Pėlėdžiukų;2446630485;Taip;0;0;1;1
10362;Šnekutis;Pėlėdžiukų;5615869149;Ne;3;15;0;18
10363;Šnekutis;Pėlėdžiukų;1329958641;Taip;0;0;1;1
10364;Šnekutis;Pėlėdžiukų;9511116249;Taip;6;1;1;8
10365;Šnekutis;Pėlėdžiukų;1369660223;Taip;0;1;1;2
10366;Šnekutis;Pėlėdžiukų;1682748852;Taip;0;15;0;15
10367;Šnekutis;Pėlėdžiukų;1447824885;Taip;0;1;0;1
10368;Šnekutis;Boružėlių;1818789769;Taip;0;5;0;5
10369;Šnekutis;Boružėlių;4557629310;Taip;10;9;0;19
10370;Šnekutis;Boružėlių;84241751923;Taip;0;0;1;1
10371;Šnekutis;Boružėlių;79174984189;Taip;0;0;1;1
10372;Šnekutis;Boružėlių;1666811336;Taip;12;0;0;12
10373;Šnekutis;Boružėlių;1249451765;Taip;0;8;0;8
10374;Šnekutis;Boružėlių;1936021189;Taip;0;9;0;9
10375;Šnekutis;Boružėlių;1031911012;Taip;0;0;1;1
10376;Šnekutis;Boružėlių;1738802158;Taip;0;0;2;2
10377;Šnekutis;Boružėlių;1744313172;Taip;0;0;3;3
10378;Šnekutis;Boružėlių;1620268693;Taip;22;0;0;22
10379;Šnekutis;Boružėlių;54532738133;Taip;22;0;0;22
10380;Šnekutis;Boružėlių;1370696345;Taip;0;2;0;2
10381;Šnekutis;Boružėlių;7514753023;Taip;0;0;4;4
10382;Šnekutis;Boružėlių;6828079735;Taip;5;0;0;5
10383;Šnekutis;Meškučių;4835202527;Taip;0;2;3;5
10384;Šnekutis;Meškučių;5597629090;Taip;1;0;0;1
10385;Šnekutis;Meškučių;8440160819;Taip;12;0;0;12
10386;Šnekutis;Meškučių;2144568225;Taip;7;0;0;7
10387;Šnekutis;Meškučių;9862362744;Taip;1;0;0;1
10388;Šnekutis;Meškučių;8486136697;Taip;5;0;0;5
10389;Šnekutis;Meškučių;9326455786;Taip;7;0;0;7
10390;Šnekutis;Meškučių;6081100604;Taip;6;2;0;8
10391;Šnekutis;Meškučių;3344425033;Taip;2;2;0;4
10392;Šnekutis;Meškučių;9054899440;Taip;15;0;0;15
10393;Šnekutis;Meškučių;6146988521;Taip;1;1;0;2
10394;Šnekutis;Meškučių;4920263429;Taip;6;8;0;14
10395;Šnekutis;Viščiukų;5906320006;Taip;11;0;1;12
10396;Šnekutis;Viščiukų;3628210526;Taip;0;0;1;1
10397;Šnekutis;Viščiukų;3889176018;Taip;4;0;7;11
10398;Šnekutis;Viščiukų;6544973632;Taip;0;0;2;2
10399;Šnekutis;Viščiukų;2843483435;Taip;6;0;1;7
10400;Šnekutis;Viščiukų;7344776758;Taip;10;0;0;10
10401;Šnekutis;Viščiukų;1504945841;Taip;6;5;0;11
10402;Šnekutis;Viščiukų;6405894763;Taip;0;2;0;2
10403;Šnekutis;Viščiukų;7089000987;Taip;0;7;0;7
10404;Šnekutis;Viščiukų;3644413861;Taip;5;0;0;5
10405;Šnekutis;Viščiukų;6578568418;Taip;0;0;6;6
10406;Užupiukas;KAČIUKŲ;3567963511;Taip;0;0;5;5
10407;Užupiukas;KAČIUKŲ;9991552624;Ne;0;0;5;5
10408;Užupiukas;KAČIUKŲ;3048959458;Taip;8;0;3;11
10409;Užupiukas;KAČIUKŲ;3080668107;Taip;0;0;3;3
10410;Užupiukas;KAČIUKŲ;1809036046;Taip;0;6;5;11
10411;Užupiukas;KAČIUKŲ;1102468034;Taip;0;0;1;1
10412;Užupiukas;KAČIUKŲ;4460047281;Ne;0;0;11;11
10413;Užupiukas;KAČIUKŲ;1464016943;Taip;5;0;0;5
10414;Užupiukas;KAČIUKŲ;4485435274;Taip;14;0;0;14
10415;Užupiukas;KAČIUKŲ;2931958829;Taip;0;0;3;3
10416;Užupiukas;KAČIUKŲ;1102293237;Taip;7;0;6;13
10417;Užupiukas;KAČIUKŲ;7048114101;Taip;5;0;1;6
10418;Užupiukas;KAČIUKŲ;8510764089;Ne;9;0;1;10
10419;Užupiukas;KAČIUKŲ;1388346927;Taip;0;8;2;10
10420;Užupiukas;KAČIUKŲ;9333587467;Taip;0;0;3;3
10421;Užupiukas;KAČIUKŲ;7574528186;Ne;7;0;9;16
10422;Užupiukas;KAČIUKŲ;7092857844;Taip;5;0;2;7
10423;Užupiukas;DRUGELIŲ;7140606152;Taip;0;0;2;2
10424;Užupiukas;DRUGELIŲ;5406866873;Taip;5;0;5;10
10425;Užupiukas;DRUGELIŲ;9655636851;Taip;10;0;0;10
10426;Užupiukas;DRUGELIŲ;1662564735;Taip;5;0;1;6
10427;Užupiukas;DRUGELIŲ;9863097416;Taip;10;0;0;10
10428;Užupiukas;DRUGELIŲ;7298322865;Taip;9;0;1;10
10429;Užupiukas;DRUGELIŲ;8734960045;Ne;5;0;8;13
10430;Užupiukas;DRUGELIŲ;8724566014;Taip;14;0;0;14
10431;Užupiukas;DRUGELIŲ;3298267311;Taip;12;0;0;12
10432;Užupiukas;DRUGELIŲ;8341598147;Taip;11;0;6;17
10433;Užupiukas;DRUGELIŲ;9782972949;Taip;10;0;1;11
10434;Užupiukas;DRUGELIŲ;2348243399;Taip;18;0;1;19
10435;Užupiukas;DRUGELIŲ;8870229834;Taip;15;0;1;16
10436;Užupiukas;DRUGELIŲ;1679324943;Taip;0;0;3;3
10437;Užupiukas;DRUGELIŲ;1772019951;Taip;10;0;0;10
10438;Užupiukas;DRUGELIŲ;9617597828;Taip;3;0;0;3
10439;Užupiukas;DRUGELIŲ;1554333137;Taip;0;5;1;6
10440;Užupiukas;DRUGELIŲ;9096157655;Ne;7;0;1;8
10441;Užupiukas;DRUGELIŲ;3231001225;Taip;5;0;5;10
10442;Užupiukas;DRUGELIŲ;3958071677;Taip;0;0;12;12
10443;Užupiukas;EŽIUKŲ;1718518621;Taip;0;3;0;3
10444;Užupiukas;EŽIUKŲ;2724216446;Taip;11;0;1;12
10445;Užupiukas;EŽIUKŲ;9446562736;Taip;0;0;4;4
10446;Užupiukas;EŽIUKŲ;5072363435;Taip;0;0;4;4
10447;Užupiukas;EŽIUKŲ;1651249962;Taip;0;0;1;1
10448;Užupiukas;EŽIUKŲ;1100574872;Taip;7;2;1;10
10449;Užupiukas;EŽIUKŲ;6531734067;Ne;7;0;1;8
10450;Užupiukas;EŽIUKŲ;5204808398;Taip;5;0;2;7
10451;Užupiukas;EŽIUKŲ;3171528288;Taip;10;0;1;11
10452;Užupiukas;EŽIUKŲ;7860601571;Taip;0;0;5;5
10453;Užupiukas;EŽIUKŲ;3611922301;Taip;0;0;3;3
10454;Užupiukas;EŽIUKŲ;8020138690;Taip;12;0;0;12
10455;Užupiukas;EŽIUKŲ;1624805701;Taip;7;0;3;10
10456;Užupiukas;EŽIUKŲ;6823724962;Taip;0;0;2;2
10457;Užupiukas;EŽIUKŲ;5538327364;Taip;8;0;1;9
10458;Užupiukas;EŽIUKŲ;3057147440;Taip;10;0;1;11
10459;Užupiukas;EŽIUKŲ;3365726271;Taip;3;0;7;10
10460;Užupiukas;EŽIUKŲ;6370918943;Taip;0;0;2;2
10461;Užupiukas;EŽIUKŲ;9357101972;Taip;0;0;9;9
10462;Užupiukas;EŽIUKŲ;6512355340;Taip;0;0;1;1
10463;Užupiukas;BORUŽĖLIŲ;7861121290;Taip;0;0;2;2
10464;Užupiukas;BORUŽĖLIŲ;12787288319;Ne;0;0;2;2
10465;Užupiukas;BORUŽĖLIŲ;6526550727;Ne;22;0;0;22
10466;Užupiukas;BORUŽĖLIŲ;9735462228;Taip;2;0;3;5
10467;Užupiukas;BORUŽĖLIŲ;1108744283;Taip;0;0;2;2
10468;Užupiukas;BORUŽĖLIŲ;1582921323;Taip;9;0;0;9
10469;Užupiukas;BORUŽĖLIŲ;6828175620;Taip;15;0;1;16
10470;Užupiukas;BORUŽĖLIŲ;9791681813;Taip;6;0;0;6
10471;Užupiukas;BORUŽĖLIŲ;1503714343;Taip;0;0;2;2
10472;Užupiukas;BORUŽĖLIŲ;8313812681;Taip;0;0;12;12
10473;Užupiukas;BORUŽĖLIŲ;9906475253;Taip;0;0;20;20
10474;Užupiukas;BORUŽĖLIŲ;9677572224;Taip;2;0;1;3
10475;Užupiukas;BORUŽĖLIŲ;2445335267;Taip;2;0;2;4
10476;Užupiukas;BORUŽĖLIŲ;38066177076;Taip;0;7;0;7
10477;Užupiukas;BORUŽĖLIŲ;1514268763;Taip;0;0;2;2
10478;Užupiukas;BORUŽĖLIŲ;7555702944;Ne;0;0;6;6
10479;Užupiukas;BORUŽĖLIŲ;2307600884;Taip;0;0;1;1
10480;Užupiukas;BORUŽĖLIŲ;6073039842;Taip;0;0;5;5
10481;Užupiukas;BORUŽĖLIŲ;3038973312;Taip;0;1;0;1
10482;Užupiukas;BORUŽĖLIŲ;6601099182;Taip;0;0;21;21
10483;Užupiukas;BORUŽĖLIŲ;3940264504;Taip;0;0;3;3
10484;Užupiukas;PELĖDŽIUKŲ;73657553075;Taip;10;0;0;10
10485;Užupiukas;PELĖDŽIUKŲ;12023740118;Taip;3;2;3;8
10486;Užupiukas;PELĖDŽIUKŲ;1102150432;Taip;0;0;6;6
10487;Užupiukas;PELĖDŽIUKŲ;1593878778;Taip;2;0;5;7
10488;Užupiukas;PELĖDŽIUKŲ;1850295450;Taip;6;0;0;6
10489;Užupiukas;PELĖDŽIUKŲ;1338561168;Taip;0;0;10;10
10490;Užupiukas;PELĖDŽIUKŲ;9843068906;Ne;0;4;1;5
10491;Užupiukas;PELĖDŽIUKŲ;94857555708;Taip;20;0;2;22
10492;Užupiukas;PELĖDŽIUKŲ;7616817709;Taip;0;0;2;2
10493;Užupiukas;PELĖDŽIUKŲ;3785893846;Taip;5;0;2;7
10494;Užupiukas;PELĖDŽIUKŲ;1159892685;Taip;5;0;0;5
10495;Užupiukas;PELĖDŽIUKŲ;6442996343;Taip;5;0;1;6
10496;Užupiukas;PELĖDŽIUKŲ;30379165882;Taip;0;0;1;1
10497;Užupiukas;PELĖDŽIUKŲ;27438104059;Taip;0;3;0;3
10498;Užupiukas;PELĖDŽIUKŲ;1535952427;Taip;0;0;2;2
10499;Užupiukas;PELĖDŽIUKŲ;95981297986;Taip;10;0;0;10
10500;Užupiukas;PELĖDŽIUKŲ;2419842168;Taip;0;0;1;1
10501;Užupiukas;PELĖDŽIUKŲ;1891595719;Taip;0;0;3;3
10502;Užupiukas;PELĖDŽIUKŲ;98209952363;Taip;0;0;3;3
10503;Užupiukas;PELĖDŽIUKŲ;79908666651;Taip;5;0;4;9
10504;Užupiukas;PELĖDŽIUKŲ;2924954048;Taip;0;0;2;2
10505;Užupiukas;PELĖDŽIUKŲ;9483673859;Taip;0;0;1;1
10506;Užupiukas;PELĖDŽIUKŲ;64962686221;Taip;0;0;3;3
10507;Užupiukas;PELĖDŽIUKŲ;1256526274;Ne;0;5;0;5
10508;Užupiukas;PELĖDŽIUKŲ;31833883832;Taip;0;3;0;3
10509;Užupiukas;LAPIUKŲ;3309195572;Taip;7;0;4;11
10510;Užupiukas;LAPIUKŲ;7563497568;Taip;22;0;0;22
10511;Užupiukas;LAPIUKŲ;2821350355;Taip;0;0;11;11
10512;Užupiukas;LAPIUKŲ;22401995674;Taip;0;0;1;1
10513;Užupiukas;LAPIUKŲ;3774364829;Taip;7;0;1;8
10514;Užupiukas;LAPIUKŲ;6236652118;Ne;5;0;2;7
10515;Užupiukas;LAPIUKŲ;4247280316;Taip;5;0;1;6
10516;Užupiukas;LAPIUKŲ;2938276316;Taip;0;0;2;2
10517;Užupiukas;LAPIUKŲ;6478702476;Taip;0;0;8;8
10518;Užupiukas;LAPIUKŲ;4132760111;Taip;0;1;2;3
10519;Užupiukas;LAPIUKŲ;3205769002;Ne;19;0;0;19
10520;Užupiukas;LAPIUKŲ;5498369850;Taip;0;3;5;8
10521;Užupiukas;LAPIUKŲ;6110869303;Taip;0;0;3;3
10522;Užupiukas;LAPIUKŲ;79442829922;Taip;0;0;2;2
10523;Užupiukas;LAPIUKŲ;4608233152;Ne;0;0;1;1
10524;Užupiukas;LAPIUKŲ;9197242545;Taip;10;0;1;11
10525;Užupiukas;LAPIUKŲ;5320544400;Ne;7;0;1;8
10526;Užupiukas;LAPIUKŲ;4880828482;Ne;0;0;3;3
10527;Užupiukas;NYKŠTUKŲ;1355954767;Taip;0;0;17;17
10528;Užupiukas;NYKŠTUKŲ;6001766518;Taip;3;0;5;8
10529;Užupiukas;NYKŠTUKŲ;2273766308;Taip;4;0;1;5
10530;Užupiukas;NYKŠTUKŲ;9428884149;Taip;0;12;1;13
10531;Užupiukas;NYKŠTUKŲ;8301340579;Taip;0;9;4;13
10532;Užupiukas;NYKŠTUKŲ;5085660507;Taip;4;0;9;13
10533;Užupiukas;NYKŠTUKŲ;1496541880;Taip;0;0;17;17
10534;Užupiukas;NYKŠTUKŲ;3528581949;Taip;0;0;11;11
10535;Užupiukas;NYKŠTUKŲ;7345579721;Taip;0;5;2;7
10536;Užupiukas;NYKŠTUKŲ;7530856195;Taip;6;0;1;7
10537;Užupiukas;NYKŠTUKŲ;9925592494;Taip;2;0;0;2
10538;Užupiukas;NYKŠTUKŲ;4054724625;Taip;0;0;3;3
10539;Užupiukas;NYKŠTUKŲ;1995228207;Taip;0;0;7;7
10540;Užupiukas;NYKŠTUKŲ;4710910251;Taip;0;0;15;15
10541;Užupiukas;NYKŠTUKŲ;2390955083;Taip;0;0;1;1
10542;Užupiukas;NYKŠTUKŲ;3768945773;Ne;4;0;0;4
10543;Užupiukas;NYKŠTUKŲ;8519118225;Taip;4;0;3;7
10544;Užupiukas;NYKŠTUKŲ;7549628277;Taip;4;0;3;7
10545;Užupiukas;NYKŠTUKŲ;1684901495;Taip;14;0;0;14
10546;Vandenis;ŽUVĖDRŲ;91659985965;Taip;0;1;1;2
10547;Vandenis;ŽUVĖDRŲ;83799061370;Taip;2;0;1;3
10548;Vandenis;ŽUVĖDRŲ;96459201904;Taip;12;0;0;12
10549;Vandenis;ŽUVĖDRŲ;49204161380;Taip;0;1;0;1
10550;Vandenis;ŽUVĖDRŲ;67472126318;Taip;5;0;0;5
10551;Vandenis;ŽUVĖDRŲ;32749176064;Taip;3;7;0;10
10552;Vandenis;ŽUVĖDRŲ;80186166441;Taip;22;0;0;22
10553;Vandenis;ŽUVĖDRŲ;85287618619;Taip;0;2;0;2
10554;Vandenis;ŽUVĖDRŲ;22764351701;Taip;0;1;0;1
10555;Vandenis;ŽUVĖDRŲ;55952119623;Taip;1;0;0;1
10556;Vandenis;ŽUVĖDRŲ;56648967396;Taip;0;9;0;9
10557;Vandenis;ŽUVĖDRŲ;87398241763;Taip;8;0;0;8
10558;Vandenis;ŽUVĖDRŲ;48908599635;Taip;0;2;0;2
10559;Vandenis;RUONIUKŲ;2422642232;Taip;0;7;7;14
10560;Vandenis;RUONIUKŲ;1051281257;Taip;0;7;7;14
10561;Vandenis;RUONIUKŲ;7565308536;Taip;5;3;0;8
10562;Vandenis;RUONIUKŲ;9518434896;Taip;7;2;0;9
10563;Vandenis;RUONIUKŲ;2638433939;Ne;8;0;4;12
10564;Vandenis;RUONIUKŲ;1120907086;Taip;7;0;0;7
10565;Vandenis;RUONIUKŲ;1563710105;Taip;0;0;2;2
10566;Vandenis;RUONIUKŲ;6476051751;Taip;3;2;0;5
10567;Vandenis;RUONIUKŲ;9162936403;Ne;6;10;0;16
10568;Vandenis;RUONIUKŲ;4713395766;Taip;5;0;0;5
10569;Vandenis;RUONIUKŲ;7754158588;Taip;3;0;1;4
10570;Vandenis;RUONIUKŲ;9731729915;Taip;8;0;0;8
10571;Vandenis;RUONIUKŲ;8971291182;Taip;5;0;2;7
10572;Vandenis;RUONIUKŲ;8729351613;Taip;10;0;2;12
10573;Vandenis;RUONIUKŲ;4971165639;Ne;2;0;0;2
10574;Vandenis;ŽUVYČIŲ;28286348996;Taip;0;2;1;3
10575;Vandenis;ŽUVYČIŲ;2494327284;Taip;0;0;1;1
10576;Vandenis;ŽUVYČIŲ;47333381244;Taip;0;3;0;3
10577;Vandenis;ŽUVYČIŲ;20458211098;Taip;0;7;0;7
10578;Vandenis;ŽUVYČIŲ;95498596116;Ne;0;1;0;1
10579;Vandenis;ŽUVYČIŲ;39662768043;Taip;0;0;1;1
10580;Vandenis;ŽUVYČIŲ;391453841;Ne;8;0;0;8
10581;Vandenis;ŽUVYČIŲ;318399174;Taip;0;2;0;2
10582;Vandenis;ŽUVYČIŲ;69485657846;Taip;3;0;0;3
10583;Vandenis;ŽUVYČIŲ;54762939917;Taip;4;0;1;5
10584;Vandenis;ŽUVYČIŲ;45362889638;Ne;5;0;3;8
10585;Vandenis;ŽUVYČIŲ;33177236893;Taip;0;2;0;2
10586;Vandenis;ŽUVYČIŲ;23752943243;Taip;0;2;0;2
10587;Vandenis;ŽUVYČIŲ;35977990277;Ne;5;7;3;15
10588;Vandenis;ŽUVYČIŲ;59487083886;Taip;0;1;0;1
10589;Vandenis;ŽUVYČIŲ;51472939588;Taip;0;2;3;5
10590;Vandenis;ŽUVYČIŲ;1493719754;Taip;5;2;1;8
10591;Vandenis;PERLIUKŲ;8678508812;Taip;5;0;0;5
10592;Vandenis;PERLIUKŲ;2645775090;Taip;0;7;0;7
10593;Vandenis;PERLIUKŲ;5844576485;Taip;5;0;2;7
10594;Vandenis;PERLIUKŲ;6295009202;Taip;0;0;2;2
10595;Vandenis;PERLIUKŲ;7473692892;Taip;7;1;0;8
10596;Vandenis;PERLIUKŲ;5323428164;Taip;4;0;0;4
10597;Vandenis;PERLIUKŲ;6073002418;Taip;0;1;0;1
10598;Vandenis;PERLIUKŲ;5565147603;Ne;0;2;0;2
10599;Vandenis;PERLIUKŲ;1511740350;Taip;8;0;0;8
10600;Vandenis;PERLIUKŲ;2690536940;Ne;5;0;0;5
10601;Vandenis;PERLIUKŲ;2576575249;Taip;13;0;0;13
10602;Vandenis;PERLIUKŲ;7869929559;Taip;0;1;0;1
10603;Vandenis;PERLIUKŲ;7832674282;Ne;5;0;0;5
10604;Vandenis;PERLIUKŲ;9798192239;Taip;3;1;0;4
10605;Vandenis;PERLIUKŲ;1975385430;Taip;9;0;0;9
10606;Vandenis;PERLIUKŲ;3061606138;Ne;0;4;0;4
10607;Vandenis;PERLIUKŲ;2321919298;Taip;8;0;3;11
10608;Vandenis;PERLIUKŲ;5963181638;Ne;5;0;0;5
10609;Vandenis;ANČIUKŲ;8233407105;Taip;0;2;3;5
10610;Vandenis;ANČIUKŲ;1282499654;Taip;0;4;0;4
10611;Vandenis;ANČIUKŲ;5395847317;Taip;8;0;0;8
10612;Vandenis;ANČIUKŲ;3938359901;Taip;0;1;0;1
10613;Vandenis;ANČIUKŲ;8251169901;Ne;3;1;0;4
10614;Vandenis;ANČIUKŲ;4750141780;Taip;3;2;0;5
10615;Vandenis;ANČIUKŲ;6181866272;Taip;0;1;0;1
10616;Vandenis;ANČIUKŲ;7522472652;Taip;0;2;0;2
10617;Vandenis;ANČIUKŲ;7630017843;Taip;6;0;0;6
10618;Vandenis;ANČIUKŲ;1222539247;Taip;9;0;0;9
10619;Vandenis;ANČIUKŲ;3067868099;Taip;0;1;0;1
10620;Vandenis;ANČIUKŲ;8511948282;Ne;0;2;0;2
10621;Vandenis;ANČIUKŲ;33317650043;Taip;0;2;0;2
10622;Vandenis;ANČIUKŲ;1739780612;Taip;0;20;2;22
10623;Vandenis;ANČIUKŲ;2489776665;Taip;10;0;2;12
10624;Vandenis;ANČIUKŲ;1621481561;Taip;0;2;0;2
10625;Vandenis;ANČIUKŲ;33782837791;Taip;0;1;0;1
10626;Vandenis;VĖŽLIUKŲ;2309166304;Taip;5;0;0;5
10627;Vandenis;VĖŽLIUKŲ;2872343656;Taip;0;3;0;3
10628;Vandenis;VĖŽLIUKŲ;5454049563;Taip;0;1;1;2
10629;Vandenis;VĖŽLIUKŲ;9805578141;Taip;0;1;1;2
10630;Vandenis;VĖŽLIUKŲ;8116532445;Taip;0;2;0;2
10631;Vandenis;VĖŽLIUKŲ;7069369080;Taip;0;2;0;2
10632;Vandenis;VĖŽLIUKŲ;6011280420;Taip;11;0;0;11
10633;Vandenis;VĖŽLIUKŲ;7924399684;Taip;0;7;0;7
10634;Vandenis;VĖŽLIUKŲ;1187395353;Taip;0;1;0;1
10635;Vandenis;VĖŽLIUKŲ;7091356848;Taip;0;10;0;10
10636;Vandenis;VĖŽLIUKŲ;1081385111;Taip;0;5;0;5
10637;Vandenis;VĖŽLIUKŲ;5126732658;Taip;0;1;0;1
10638;Vandenis;VĖŽLIUKŲ;7059385610;Taip;0;1;1;2
10639;Vandenis;VĖŽLIUKŲ;9158541919;Taip;5;1;1;7
10640;Vandenis;VĖŽLIUKŲ;5959181898;Taip;5;1;1;7
10641;Vandenis;VĖŽLIUKŲ;1707354287;Taip;7;0;0;7
10642;Vandenis;VĖŽLIUKŲ;2061017760;Taip;3;1;0;4
10643;Vandenis;VĖŽLIUKŲ;6894180651;Taip;3;1;0;4
10644;Vandenis;AŠTUNKOJŲ;69715525764;Taip;7;1;0;8
10645;Vandenis;AŠTUNKOJŲ;39832993343;Taip;0;5;0;5
10646;Vandenis;AŠTUNKOJŲ;70732367996;Ne;10;0;0;10
10647;Vandenis;AŠTUNKOJŲ;56883076424;Taip;0;1;0;1
10648;Vandenis;AŠTUNKOJŲ;2056980868;Ne;10;0;0;10
10649;Vandenis;AŠTUNKOJŲ;17644420312;Taip;0;1;0;1
10650;Vandenis;AŠTUNKOJŲ;55331810310;Taip;15;2;0;17
10651;Vandenis;AŠTUNKOJŲ;48194812760;Taip;8;2;2;12
10652;Vandenis;AŠTUNKOJŲ;84025519453;Taip;0;2;0;2
10653;Vandenis;AŠTUNKOJŲ;5363853315;Taip;0;2;2;4
10654;Vandenis;AŠTUNKOJŲ;85054617489;Taip;6;0;0;6
10655;Vandenis;AŠTUNKOJŲ;63629799884;Taip;0;2;0;2
10656;Vandenis;AŠTUNKOJŲ;8447593747;Taip;5;0;0;5
10657;Vandenis;AŠTUNKOJŲ;1646554203;Taip;5;0;0;5
10658;Vandenis;GANDRIUKŲ;8367599264;Taip;13;0;0;13
10659;Vandenis;GANDRIUKŲ;94471245079;Taip;0;0;1;1
10660;Vandenis;GANDRIUKŲ;53737587501;Taip;0;4;0;4
10661;Vandenis;GANDRIUKŲ;1945164524;Taip;0;0;1;1
10662;Vandenis;GANDRIUKŲ;38894447952;Ne;0;5;0;5
10663;Vandenis;GANDRIUKŲ;61110317694;Taip;0;6;0;6
10664;Vandenis;GANDRIUKŲ;5716325525;Taip;0;5;0;5
10665;Vandenis;GANDRIUKŲ;2447879418;Taip;5;0;0;5
10666;Vandenis;GANDRIUKŲ;7591129504;Taip;6;0;1;7
10667;Vandenis;GANDRIUKŲ;8144064189;Taip;0;0;3;3
10668;Vandenis;GANDRIUKŲ;94273730058;Ne;3;0;0;3
10669;Vandenis;GANDRIUKŲ;44800276421;Taip;7;0;0;7
10670;Vandenis;GANDRIUKŲ;1713624934;Taip;5;0;0;5
10671;Vandenis;ŽĄSIUKAI;80643665990;Taip;0;1;0;1
10672;Vandenis;ŽĄSIUKAI;74138671368;Taip;5;3;2;10
10673;Vandenis;ŽĄSIUKAI;2812520834;Taip;0;3;0;3
10674;Vandenis;ŽĄSIUKAI;11527007102;Taip;0;2;0;2
10675;Vandenis;ŽĄSIUKAI;1373653402;Taip;5;4;0;9
10676;Vandenis;ŽĄSIUKAI;65840410497;Ne;0;1;0;1
10677;Vandenis;ŽĄSIUKAI;53658866238;Taip;17;1;0;18
10678;Vandenis;ŽĄSIUKAI;1217508516;Taip;3;2;0;5
10679;Vandenis;ŽĄSIUKAI;55238344586;Taip;8;1;0;9
10680;Vandenis;ŽĄSIUKAI;25934798454;Taip;9;2;0;11
10681;Vandenis;ŽĄSIUKAI;2029167786;Taip;10;0;0;10
10682;Vandenis;ŽĄSIUKAI;23439586487;Taip;0;5;0;5
10683;Vandenis;ŽĄSIUKAI;78917527699;Taip;5;0;0;5
10684;Vandenis;ŽĄSIUKAI;1397125827;Taip;4;0;0;4
10685;Vandenis;ŽĄSIUKAI;46916815441;Taip;0;5;0;5
10686;Vandenis;ŽĄSIUKAI;1155423158;Taip;0;9;0;9
10687;Vandenis;ŽĄSIUKAI;7333587583;Taip;0;1;0;1
10688;Vandenis;ŽĄSIUKAI;18417531508;Taip;0;3;0;3
10689;Vandenis;ŽĄSIUKAI;5797629313;Taip;7;0;0;7
10690;Vandenis;PURIENŲ;2114436962;Taip;0;1;0;1
10691;Vandenis;PURIENŲ;877974909;Taip;0;3;0;3
10692;Vandenis;PURIENŲ;3823382249;Taip;0;2;0;2
10693;Vandenis;PURIENŲ;43295720034;Ne;0;1;0;1
10694;Vandenis;PURIENŲ;84636435681;Taip;2;10;0;12
10695;Vandenis;PURIENŲ;39973189502;Taip;3;0;1;4
10696;Vandenis;PURIENŲ;2096950367;Taip;0;2;0;2
10697;Vandenis;PURIENŲ;1633589144;Taip;0;3;0;3
10698;Vandenis;PURIENŲ;1854498462;Taip;0;7;0;7
10699;Vandenis;PURIENŲ;6673346389;Ne;0;1;0;1
10700;Vandenis;PURIENŲ;7168910452;Taip;0;2;0;2
10701;Vandenis;PURIENŲ;58997790744;Taip;0;3;0;3
10702;Vandenis;PURIENŲ;2073785910;Taip;0;1;0;1
10703;Vandenis;PURIENŲ;1245031666;Taip;0;1;0;1
10704;Vandenis;PURIENŲ;38137368394;Taip;7;0;0;7
10705;Vandenis;PURIENŲ;81817138188;Taip;0;1;0;1
10706;Vandenis;PURIENŲ;86947904365;Taip;0;2;0;2
10707;Vandenis;PURIENŲ;1395272045;Taip;0;1;0;1
10708;Vandenis;VARLIUKAI;5609737826;Taip;0;0;4;4
10709;Vandenis;VARLIUKAI;3633805607;Taip;0;1;0;1
10710;Vandenis;VARLIUKAI;7959438279;Taip;0;0;7;7
10711;Vandenis;VARLIUKAI;1788652447;Taip;0;0;10;10
10712;Vandenis;VARLIUKAI;2719678617;Taip;4;0;0;4
10713;Vandenis;VARLIUKAI;5764809162;Taip;5;0;0;5
10714;Vandenis;VARLIUKAI;2614561762;Taip;0;2;0;2
10715;Vandenis;VARLIUKAI;1244502945;Taip;0;1;0;1
10716;Vandenis;VARLIUKAI;2315167746;Ne;6;0;0;6
10717;Vandenis;VARLIUKAI;6332179750;Taip;2;0;0;2
10718;Vandenis;PINGVINAI;3544717790;Taip;0;2;0;2
10719;Vandenis;PINGVINAI;4085256182;Taip;4;0;0;4
10720;Vandenis;PINGVINAI;1568158992;Taip;0;9;0;9
10721;Vandenis;PINGVINAI;18336904438;Taip;7;2;0;9
10722;Vandenis;PINGVINAI;64711327503;Taip;0;7;0;7
10723;Vandenis;PINGVINAI;43933878402;Taip;4;2;0;6
10724;Vandenis;PINGVINAI;55421695186;Taip;0;1;0;1
10725;Vandenis;PINGVINAI;24217366528;Taip;0;3;0;3
10726;Vandenis;PINGVINAI;5549292096;Taip;4;7;0;11
10727;Vandenis;PINGVINAI;4643267945;Taip;5;3;0;8
10728;Vandenis;PINGVINAI;8430706407;Taip;8;0;1;9
10729;Vandenis;PINGVINAI;1535450614;Taip;0;0;1;1
10730;Vandenis;PINGVINAI;35673258175;Taip;0;0;6;6
10731;Vandenis;PINGVINAI;27409922803;Taip;16;0;0;16
10732;Vandenis;PINGVINAI;1598122777;Ne;15;0;0;15
10733;Vandenis;PINGVINAI;1815765498;Taip;16;0;0;16
10734;Vėjelis;Pumpurėliai;89672883586;Taip;0;1;1;2
10735;Vėjelis;Pumpurėliai;2647629246;Taip;20;0;0;20
10736;Vėjelis;Pumpurėliai;31795519758;Taip;0;0;2;2
10737;Vėjelis;Pumpurėliai;49983865253;Taip;3;0;3;6
10738;Vėjelis;Pumpurėliai;90185075321;Taip;0;0;2;2
10739;Vėjelis;Pumpurėliai;1640356242;Ne;0;0;2;2
10740;Vėjelis;Pumpurėliai;86128256406;Taip;5;2;4;11
10741;Vėjelis;Pumpurėliai;77205958956;Taip;3;1;1;5
10742;Vėjelis;Pumpurėliai;2718251356;Taip;0;0;2;2
10743;Vėjelis;Pumpurėliai;64339770365;Taip;5;10;0;15
10744;Vėjelis;Pumpurėliai;75596757609;Taip;0;5;0;5
10745;Vėjelis;Pumpurėliai;1934426525;Taip;6;0;7;13
10746;Vėjelis;Pumpurėliai;57285479257;Taip;0;2;1;3
10747;Vėjelis;Pumpurėliai;93219773975;Taip;0;0;6;6
10748;Vėjelis;Pumpurėliai;8198463045;Taip;0;0;4;4
10749;Vėjelis;Drugeliai;4746932126;Taip;0;9;0;9
10750;Vėjelis;Drugeliai;8353084814;Taip;0;0;2;2
10751;Vėjelis;Drugeliai;1115802837;Ne;12;0;0;12
10752;Vėjelis;Drugeliai;1494531065;Taip;0;6;0;6
10753;Vėjelis;Drugeliai;9298789434;Taip;15;0;3;18
10754;Vėjelis;Drugeliai;2734024890;Taip;10;2;0;12
10755;Vėjelis;Drugeliai;7981032872;Taip;16;0;4;20
10756;Vėjelis;Drugeliai;2000277444;Taip;0;0;3;3
10757;Vėjelis;Drugeliai;7752923796;Taip;5;0;2;7
10758;Vėjelis;Drugeliai;7594586198;Taip;5;0;1;6
10759;Vėjelis;Drugeliai;7697394469;Taip;6;0;8;14
10760;Vėjelis;Drugeliai;4066956765;Taip;0;0;2;2
10761;Vėjelis;Drugeliai;2788205363;Taip;13;0;0;13
10762;Vėjelis;Drugeliai;1331334220;Taip;11;0;6;17
10763;Vėjelis;Drugeliai;2151737048;Taip;17;1;0;18
10764;Vėjelis;Drugeliai;3276062426;Taip;14;0;3;17
10765;Vėjelis;Malūnėlis;74207410750;Taip;0;10;2;12
10766;Vėjelis;Malūnėlis;20148908290;Taip;0;8;1;9
10767;Vėjelis;Malūnėlis;90926729186;Taip;0;3;0;3
10768;Vėjelis;Malūnėlis;39671245978;Taip;0;1;1;2
10769;Vėjelis;Malūnėlis;68958036563;Taip;0;0;1;1
10770;Vėjelis;Malūnėlis;20593684676;Taip;0;0;1;1
10771;Vėjelis;Malūnėlis;14502736200;Taip;0;1;0;1
10772;Vėjelis;Malūnėlis;98024305748;Taip;12;0;0;12
10773;Vėjelis;Malūnėlis;2021887954;Taip;0;0;3;3
10774;Vėjelis;Malūnėlis;1284286578;Ne;0;0;3;3
10775;Vėjelis;Malūnėlis;1789982154;Taip;0;10;0;10
10776;Vėjelis;Malūnėlis;54924516732;Taip;0;0;2;2
10777;Vėjelis;Malūnėlis;1242928700;Taip;0;0;2;2
10778;Vėjelis;Malūnėlis;9826410933;Taip;2;0;1;3
10779;Vėjelis;Malūnėlis;4110537888;Taip;7;0;2;9
10780;Vėjelis;Malūnėlis;44482585723;Taip;0;0;2;2
10781;Vėjelis;Žvaigždutės;1612878387;Taip;0;0;3;3
10782;Vėjelis;Žvaigždutės;3485366651;Taip;0;8;0;8
10783;Vėjelis;Žvaigždutės;5139323880;Taip;0;0;1;1
10784;Vėjelis;Žvaigždutės;2363974247;Taip;2;0;0;2
10785;Vėjelis;Žvaigždutės;86337749074;Taip;0;0;1;1
10786;Vėjelis;Žvaigždutės;8379298947;Taip;2;0;0;2
10787;Vėjelis;Žvaigždutės;8973530484;Ne;0;0;7;7
10788;Vėjelis;Žvaigždutės;69341469387;Taip;0;3;0;3
10789;Vėjelis;Žvaigždutės;9190085358;Taip;10;10;0;20
10790;Vėjelis;Žvaigždutės;8949760376;Taip;0;0;22;22
10791;Vėjelis;Žvaigždutės;6002719498;Taip;0;8;0;8
10792;Vėjelis;Žvaigždutės;9000966115;Ne;0;2;0;2
10793;Vėjelis;Žvaigždutės;4230144743;Taip;12;0;0;12
10794;Vėjelis;Žvaigždutės;3255066035;Taip;0;13;0;13
10795;Vėjelis;Žvaigždutės;76305473353;Taip;5;0;2;7
10796;Vėjelis;Žvaigždutės;73287916371;Taip;10;1;0;11
10797;Vėjelis;Žvaigždutės;41673970488;Taip;0;2;4;6
10798;Vėjelis;Žvaigždutės;5396347620;Taip;0;1;0;1
10799;Vėjelis;Žvaigždutės;50124109589;Ne;0;13;0;13
10800;Vėjelis;Varpeliai;28696711850;Taip;0;1;0;1
10801;Vėjelis;Varpeliai;83608030842;Ne;11;0;0;11
10802;Vėjelis;Varpeliai;14157070764;Taip;10;0;1;11
10803;Vėjelis;Varpeliai;1944266562;Taip;7;0;0;7
10804;Vėjelis;Varpeliai;80942260332;Taip;0;2;0;2
10805;Vėjelis;Varpeliai;8389094301;Taip;7;0;0;7
10806;Vėjelis;Varpeliai;6745229012;Taip;0;0;1;1
10807;Vėjelis;Varpeliai;90103717718;Taip;0;10;0;10
10808;Vėjelis;Varpeliai;90647333398;Taip;0;10;0;10
10809;Vėjelis;Varpeliai;40744700561;Taip;0;1;0;1
10810;Vėjelis;Varpeliai;47143492836;Taip;0;0;8;8
10811;Vėjelis;Varpeliai;1295818672;Ne;7;0;2;9
10812;Vėjelis;Varpeliai;1930159743;Taip;0;0;2;2
10813;Vėjelis;Varpeliai;1540879634;Taip;10;0;0;10
10814;Vėjelis;Varpeliai;56520156825;Taip;4;5;0;9
10815;Vėjelis;Varpeliai;47986392996;Taip;0;2;0;2
10816;Vėjelis;Pelėdžiukų;1238171728;Taip;5;0;2;7
10817;Vėjelis;Pelėdžiukų;4024898537;Taip;4;0;1;5
10818;Vėjelis;Pelėdžiukų;24011371444;Taip;0;4;0;4
10819;Vėjelis;Pelėdžiukų;2819491961;Taip;3;0;0;3
10820;Vėjelis;Pelėdžiukų;1783878104;Taip;0;9;0;9
10821;Vėjelis;Pelėdžiukų;1510415602;Taip;9;0;3;12
10822;Vėjelis;Pelėdžiukų;2042863944;Taip;0;8;0;8
10823;Vėjelis;Pelėdžiukų;1563935993;Taip;0;0;1;1
10824;Vėjelis;Pelėdžiukų;5992665537;Taip;0;5;0;5
10825;Vėjelis;Pelėdžiukų;1347855869;Taip;7;0;0;7
10826;Vėjelis;Pelėdžiukų;1990674632;Taip;0;2;1;3
10827;Vėjelis;Pelėdžiukų;6618114389;Taip;0;6;0;6
10828;Vėjelis;Pelėdžiukų;1518855620;Taip;0;10;0;10
10829;Vėjelis;Pelėdžiukų;4930807661;Taip;6;0;4;10
10830;Vėjelis;Pelėdžiukų;2128818222;Ne;0;0;5;5
10831;Vėjelis;Pelėdžiukų;1603377234;Ne;10;0;0;10
10832;Vėjelis;Skruzdeliukų;3910688753;Ne;0;0;2;2
10833;Vėjelis;Skruzdeliukų;2167025998;Taip;7;0;0;7
10834;Vėjelis;Skruzdeliukų;2467377103;Taip;0;1;0;1
10835;Vėjelis;Skruzdeliukų;7400967836;Taip;10;0;0;10
10836;Vėjelis;Skruzdeliukų;8470977526;Taip;0;10;1;11
10837;Vėjelis;Skruzdeliukų;1952141664;Taip;0;0;11;11
10838;Vėjelis;Skruzdeliukų;3264153232;Taip;3;0;1;4
10839;Vėjelis;Skruzdeliukų;12087873516;Taip;0;4;0;4
10840;Vėjelis;Skruzdeliukų;7610485310;Taip;0;3;0;3
10841;Vėjelis;Skruzdeliukų;2282796452;Taip;0;13;0;13
10842;Vėjelis;Skruzdeliukų;1551143643;Taip;6;0;0;6
10843;Vėjelis;Skruzdeliukų;7771422316;Taip;0;1;0;1
10844;Vėjelis;Skruzdeliukų;7794899167;Taip;0;6;0;6
10845;Vėjelis;Skruzdeliukų;8941647789;Taip;0;0;2;2
10846;Vėjelis;Skruzdeliukų;41268510292;Taip;0;1;1;2
10847;Vėjelis;Skruzdeliukų;1534169381;Taip;0;7;0;7
10848;Vėjelis;Pieštukų;4853650350;Taip;0;9;0;9
10849;Vėjelis;Pieštukų;60890519853;Taip;0;2;0;2
10850;Vėjelis;Pieštukų;8386409466;Ne;3;14;0;17
10851;Vėjelis;Pieštukų;9492690970;Ne;0;0;1;1
10852;Vėjelis;Pieštukų;6386092350;Taip;10;10;0;20
10853;Vėjelis;Pieštukų;8684461171;Taip;0;11;0;11
10854;Vėjelis;Pieštukų;9395929106;Ne;12;5;0;17
10855;Vėjelis;Pieštukų;1205392813;Ne;0;16;0;16
10856;Vėjelis;Pieštukų;8866974952;Taip;0;1;0;1
10857;Vėjelis;Pieštukų;2117924725;Taip;18;0;0;18
10858;Vėjelis;Pieštukų;1436893015;Ne;11;0;1;12
10859;Vėjelis;Pieštukų;1549518622;Taip;0;0;2;2
10860;Vėjelis;Pieštukų;6844704326;Taip;0;0;1;1
10861;Vėjelis;Pieštukų;8300497094;Taip;7;0;3;10
10862;Vėjelis;Pieštukų;6772736175;Taip;9;0;3;12
10863;Vėjelis;Pieštukų;7255617408;Taip;0;3;0;3
10864;Vėjelis;Ramunėlių;5987294293;Taip;0;5;0;5
10865;Vėjelis;Ramunėlių;8047799576;Taip;15;3;0;18
10866;Vėjelis;Ramunėlių;4745262277;Ne;6;0;0;6
10867;Vėjelis;Ramunėlių;4353239658;Ne;0;1;9;10
10868;Vėjelis;Ramunėlių;7178844364;Taip;3;0;0;3
10869;Vėjelis;Ramunėlių;2386927970;Taip;16;1;0;17
10870;Vėjelis;Ramunėlių;2124857941;Taip;8;14;0;22
10871;Vėjelis;Ramunėlių;6455798848;Taip;0;0;4;4
10872;Vėjelis;Ramunėlių;2999425729;Taip;15;1;0;16
10873;Vėjelis;Ramunėlių;6996900411;Taip;3;5;0;8
10874;Vėjelis;Ramunėlių;2289954824;Taip;0;5;0;5
10875;Vėjelis;Ramunėlių;6777528441;Taip;0;2;0;2
10876;Vėjelis;Ramunėlių;6891260701;Taip;0;5;0;5
10877;Vėjelis;Ramunėlių;7836199284;Taip;18;1;3;22
10878;Vėjelis;Ramunėlių;4733227215;Taip;0;1;0;1
10879;Vėjelis;Ramunėlių;5909697341;Taip;0;2;0;2
10880;Vėjelis;Ramunėlių;6451722893;Taip;8;1;0;9
10881;Vėjelis;Ramunėlių;8721116918;Ne;5;1;0;6
10882;Vėjelis;Ramunėlių;1381191703;Taip;0;1;3;4
10883;Vėjelis;Nykštukai;6660799519;Taip;7;0;0;7
10884;Vėjelis;Nykštukai;2522750651;Taip;0;0;5;5
10885;Vėjelis;Nykštukai;1235788079;Ne;6;0;0;6
10886;Vėjelis;Nykštukai;2371667380;Taip;0;0;1;1
10887;Vėjelis;Nykštukai;2132551615;Ne;0;0;3;3
10888;Vėjelis;Nykštukai;4988352741;Taip;8;0;1;9
10889;Vėjelis;Nykštukai;9625857378;Taip;10;0;0;10
10890;Vėjelis;Nykštukai;8054114720;Taip;8;0;0;8
10891;Vėjelis;Nykštukai;3524350131;Taip;8;0;0;8
10892;Vėjelis;Nykštukai;9116153981;Taip;0;0;1;1
10893;Vėjelis;BITUTĖS;5902455219;Taip;11;0;0;11
10894;Vėjelis;BITUTĖS;4831426440;Taip;4;1;1;6
10895;Vėjelis;BITUTĖS;74475070018;Taip;0;1;0;1
10896;Vėjelis;BITUTĖS;6724813553;Taip;0;6;0;6
10897;Vėjelis;BITUTĖS;5508269515;Taip;2;1;0;3
10898;Vėjelis;BITUTĖS;9672929606;Taip;4;1;4;9
10899;Vėjelis;BITUTĖS;4906958328;Taip;0;2;0;2
10900;Vėjelis;BITUTĖS;43342043904;Ne;0;1;0;1
10901;Vėjelis;BITUTĖS;89943712210;Taip;0;3;0;3
10902;Vėjelis;BITUTĖS;64628040227;Taip;0;8;0;8
10903;Vėjelis;BITUTĖS;1008705526;Ne;0;1;0;1
10904;Vėjelis;BITUTĖS;1251348150;Taip;0;9;0;9
10905;Vėjelis;BITUTĖS;5207473829;Ne;0;1;1;2
10906;Vėjelis;BITUTĖS;8226906949;Taip;15;0;0;15
10907;Vėjelis;BITUTĖS;4938939921;Taip;17;0;0;17
10908;Vėjelis;BITUTĖS;20492762368;Ne;6;1;0;7
10909;Vėjelis;Boruželės;5325081841;Taip;0;3;0;3
10910;Vėjelis;Boruželės;5381588565;Taip;0;6;0;6
10911;Vėjelis;Boruželės;1863210064;Taip;0;3;0;3
10912;Vėjelis;Boruželės;9037622738;Taip;5;0;0;5
10913;Vėjelis;Boruželės;8553966497;Taip;0;5;0;5
10914;Vėjelis;Boruželės;1588345134;Taip;0;1;0;1
10915;Vėjelis;Boruželės;1751533938;Ne;2;3;0;5
10916;Vėjelis;Boruželės;1429496839;Taip;5;0;3;8
10917;Vėjelis;Boruželės;1931659200;Taip;0;2;0;2
10918;Vėjelis;Boruželės;1076538028;Ne;3;0;0;3
10919;Vėjelis;Boruželės;6221257045;Taip;0;1;0;1
10920;Vėjelis;Boruželės;8666759391;Ne;0;1;3;4
10921;Vėjelis;Boruželės;3844131154;Taip;0;4;0;4
10922;Vėjelis;Boruželės;4747466651;Taip;0;3;0;3
10923;Vėjelis;Boruželės;8141198449;Taip;6;1;2;9
10924;Vėjelis;Boruželės;8121537795;Ne;0;18;0;18
10925;Vėjelis;Boruželės;7133454882;Taip;9;0;5;14
10926;Vėjelis;Boruželės;5517128872;Ne;8;0;0;8
10927;Vėjelis;Boruželės;8938491367;Taip;8;1;0;9
10928;Vėtrungė;Debesėlių;2825732654;Taip;1;0;0;1
10929;Vėtrungė;Debesėlių;5251308945;Taip;6;0;0;6
10930;Vėtrungė;Debesėlių;5446546214;Taip;5;2;0;7
10931;Vėtrungė;Debesėlių;8956375453;Taip;0;0;1;1
10932;Vėtrungė;Debesėlių;4339450816;Taip;0;6;0;6
10933;Vėtrungė;Debesėlių;7863176604;Taip;0;4;0;4
10934;Vėtrungė;Debesėlių;3179715496;Taip;0;4;0;4
10935;Vėtrungė;Debesėlių;9423361592;Taip;8;1;1;10
10936;Vėtrungė;Debesėlių;4269488000;Taip;5;0;0;5
10937;Vėtrungė;Debesėlių;1191007983;Taip;5;1;0;6
10938;Vėtrungė;Debesėlių;3745680607;Taip;10;0;0;10
10939;Vėtrungė;Debesėlių;9359012317;Taip;8;0;0;8
10940;Vėtrungė;Zuikių;8493950205;Taip;0;10;0;10
10941;Vėtrungė;Zuikių;7585075881;Taip;10;2;3;15
10942;Vėtrungė;Zuikių;4874628984;Taip;10;0;2;12
10943;Vėtrungė;Zuikių;9332362038;Taip;2;0;0;2
10944;Vėtrungė;Zuikių;9407558097;Taip;0;8;0;8
10945;Vėtrungė;Zuikių;2985829593;Taip;10;2;0;12
10946;Vėtrungė;Zuikių;4121886031;Ne;10;4;0;14
10947;Vėtrungė;Zuikių;7573021445;Taip;3;0;5;8
10948;Vėtrungė;Zuikių;9742099165;Taip;3;2;1;6
10949;Vėtrungė;Zuikių;1215953192;Taip;12;0;0;12
10950;Vėtrungė;Zuikių;3908259010;Ne;5;0;0;5
10951;Vėtrungė;Zuikių;8421138967;Taip;14;0;0;14
10952;Vėtrungė;Drugelių;5622109033;Taip;14;1;0;15
10953;Vėtrungė;Drugelių;7936785905;Ne;8;1;2;11
10954;Vėtrungė;Drugelių;6457369177;Taip;9;0;1;10
10955;Vėtrungė;Drugelių;8744050633;Taip;9;0;1;10
10956;Vėtrungė;Drugelių;1462620951;Taip;3;2;0;5
10957;Vėtrungė;Drugelių;4408537397;Taip;10;0;0;10
10958;Vėtrungė;Drugelių;7943682529;Taip;0;0;1;1
10959;Vėtrungė;Do-re-mi;6978977383;Taip;0;0;7;7
10960;Vėtrungė;Do-re-mi;3278452234;Taip;4;1;0;5
10961;Vėtrungė;Do-re-mi;2287044278;Taip;0;2;0;2
10962;Vėtrungė;Do-re-mi;2928868412;Taip;0;2;0;2
10963;Vėtrungė;Do-re-mi;2883254822;Taip;2;0;0;2
10964;Vėtrungė;Do-re-mi;9518734260;Taip;7;0;0;7
10965;Vėtrungė;Do-re-mi;7496582551;Taip;0;0;1;1
10966;Vėtrungė;Do-re-mi;5430818470;Taip;8;3;0;11
10967;Vėtrungė;Do-re-mi;7483624989;Taip;0;3;0;3
10968;Vėtrungė;Do-re-mi;7807708310;Taip;5;3;0;8
10969;Vėtrungė;Do-re-mi;3200251047;Taip;0;0;3;3
10970;Vėtrungė;Do-re-mi;3369970611;Taip;0;2;0;2
10971;Vėtrungė;Do-re-mi;1808699695;Taip;5;0;2;7
10972;Vėtrungė;Do-re-mi;5217297849;Ne;3;0;0;3
10973;Vėtrungė;Smalsučių;5338119067;Taip;0;0;2;2
10974;Vėtrungė;Smalsučių;18747550179;Taip;3;1;0;4
10975;Vėtrungė;Smalsučių;8948342560;Taip;0;0;2;2
10976;Vėtrungė;Smalsučių;9844783953;Taip;0;2;0;2
10977;Vėtrungė;Smalsučių;65861118217;Taip;0;4;0;4
10978;Vėtrungė;Smalsučių;96980344422;Taip;0;4;0;4
10979;Vėtrungė;Smalsučių;30792456956;Taip;22;0;0;22
10980;Vėtrungė;Smalsučių;684188851;Taip;10;0;0;10
10981;Vėtrungė;Smalsučių;62501279379;Ne;0;2;0;2
10982;Vėtrungė;Smalsučių;1833285759;Taip;0;1;0;1
10983;Vėtrungė;Smalsučių;92977432447;Ne;5;11;0;16
10984;Vėtrungė;Smalsučių;4547247726;Taip;8;0;10;18
10985;Vėtrungė;Smalsučių;63472451321;Taip;1;1;1;3
10986;Vėtrungė;Smalsučių;68262180072;Taip;0;2;1;3
10987;Vėtrungė;Smalsučių;1452467682;Taip;0;0;1;1
10988;Vėtrungė;Gudručių;1128961321;Taip;0;1;0;1
10989;Vėtrungė;Gudručių;99423172685;Ne;0;1;0;1
10990;Vėtrungė;Gudručių;98795465390;Taip;0;4;0;4
10991;Vėtrungė;Gudručių;40200404538;Ne;9;2;0;11
10992;Vėtrungė;Gudručių;42353807206;Taip;0;3;0;3
10993;Vėtrungė;Gudručių;1019550327;Taip;0;10;0;10
10994;Vėtrungė;Gudručių;76967115688;Taip;0;3;0;3
10995;Vėtrungė;Gudručių;1111688152;Taip;0;4;0;4
10996;Vėtrungė;Gudručių;1533796435;Taip;4;0;0;4
10997;Vėtrungė;Gudručių;1752676956;Taip;0;3;0;3
10998;Vėtrungė;Gudručių;72462689908;Taip;0;5;0;5
10999;Vėtrungė;Gudručių;58224525427;Taip;0;4;0;4
11000;Vėtrungė;Gudručių;88062307371;Taip;0;0;6;6
11001;Vėtrungė;Gudručių;68938242748;Taip;0;4;0;4
11002;Vėtrungė;Gudručių;6520234687;Ne;0;3;0;3
11003;Vėtrungė;Kodėlčių;1366458234;Taip;0;1;12;13
11004;Vėtrungė;Kodėlčių;1021458176;Taip;0;14;0;14
11005;Vėtrungė;Kodėlčių;1267104594;Taip;0;3;0;3
11006;Vėtrungė;Kodėlčių;1022530443;Taip;0;1;2;3
11007;Vėtrungė;Kodėlčių;1283685496;Taip;0;13;0;13
11008;Vėtrungė;Kodėlčių;20608668180;Taip;0;0;2;2
11009;Vėtrungė;Kodėlčių;49220186521;Taip;0;3;0;3
11010;Vėtrungė;Kodėlčių;41508942219;Taip;0;8;0;8
11011;Vėtrungė;Kodėlčių;1662123237;Taip;0;2;0;2
11012;Vėtrungė;Kodėlčių;1456877681;Taip;0;22;0;22
11013;Vėtrungė;Kodėlčių;90528749634;Ne;0;0;3;3
11014;Vėtrungė;Kodėlčių;56266349747;Taip;10;1;0;11
11015;Vėtrungė;Kodėlčių;1902101426;Taip;0;0;22;22
11016;Vėtrungė;Kodėlčių;3231167303;Taip;0;5;0;5
11017;Vėtrungė;Kodėlčių;4291687553;Taip;0;1;8;9
11018;Vėtrungė;Kodėlčių;6563805572;Taip;8;0;0;8
11019;Vėtrungė;Kodėlčių;1395153496;Taip;0;15;0;15
11020;Vėtrungė;Kodėlčių;8857763201;Taip;13;0;0;13
11021;Vėtrungė;Kodėlčių;8080668755;Taip;0;4;0;4
11022;Vėtrungė;Paukštelių;63512524250;Ne;6;0;2;8
11023;Vėtrungė;Paukštelių;1322617786;Taip;10;0;1;11
11024;Vėtrungė;Paukštelių;2864217098;Taip;9;0;1;10
11025;Vėtrungė;Paukštelių;7921863675;Taip;0;6;0;6
11026;Vėtrungė;Paukštelių;4091719904;Taip;5;1;0;6
11027;Vėtrungė;Paukštelių;4347810256;Taip;0;0;1;1
11028;Vėtrungė;Paukštelių;8915159672;Taip;7;4;0;11
11029;Vėtrungė;Paukštelių;6732632515;Ne;10;0;0;10
11030;Vėtrungė;Paukštelių;8897558066;Taip;0;0;3;3
11031;Vėtrungė;Paukštelių;3404120492;Taip;0;0;1;1
11032;Vėtrungė;Paukštelių;8154023892;Ne;10;0;0;10
11033;Vėtrungė;Paukštelių;3721504364;Taip;0;0;2;2
11034;Vėtrungė;Paukštelių;4115995882;Taip;0;11;0;11
11035;Vėtrungė;Paukštelių;5994465833;Taip;0;2;0;2
11036;Vėtrungė;Paukštelių;8721035192;Ne;0;10;0;10
11037;Vėtrungė;Paukštelių;6964225210;Taip;0;4;6;10
11038;Vėtrungė;Paukštelių;1970034012;Ne;0;17;0;17
11039;Vėtrungė;Paukštelių;40392900667;Ne;21;0;0;21
11040;Vėtrungė;Viščiukų;4916692634;Taip;0;8;0;8
11041;Vėtrungė;Viščiukų;2447851565;Taip;10;0;0;10
11042;Vėtrungė;Viščiukų;2136966687;Taip;15;0;5;20
11043;Vėtrungė;Viščiukų;4197321604;Taip;1;0;1;2
11044;Vėtrungė;Viščiukų;6416245099;Ne;0;1;0;1
11045;Vėtrungė;Viščiukų;8742161467;Taip;0;0;1;1
11046;Vėtrungė;Viščiukų;7558548846;Taip;4;0;0;4
11047;Vėtrungė;Viščiukų;1007578933;Taip;4;0;0;4
11048;Vėtrungė;Viščiukų;9893842192;Taip;8;0;2;10
11049;Vėtrungė;Viščiukų;2641473764;Taip;6;7;2;15
11050;Vėtrungė;Viščiukų;3433811829;Taip;8;0;1;9
11051;Vėtrungė;Viščiukų;3634995652;Taip;4;0;4;8
11052;Vėtrungė;Viščiukų;1255147376;Ne;0;9;0;9
11053;Vėtrungė;Nykštukų;29699317546;Taip;0;0;10;10
11054;Vėtrungė;Nykštukų;1474010989;Ne;0;18;0;18
11055;Vėtrungė;Nykštukų;47141854213;Taip;0;2;5;7
11056;Vėtrungė;Nykštukų;1754493671;Ne;0;2;0;2
11057;Vėtrungė;Nykštukų;1843306606;Taip;0;17;0;17
11058;Vėtrungė;Nykštukų;5198153485;Ne;0;5;0;5
11059;Vėtrungė;Nykštukų;1630866223;Taip;0;16;0;16
11060;Vėtrungė;Nykštukų;1529226569;Taip;0;1;0;1
11061;Vėtrungė;Nykštukų;1370336984;Taip;0;6;0;6
11062;Vėtrungė;Nykštukų;78016704795;Taip;0;6;0;6
11063;Vėtrungė;Nykštukų;68628872682;Taip;0;0;4;4
11064;Vėtrungė;Nykštukų;70610257897;Taip;0;3;0;3
11065;Vėtrungė;Nykštukų;1744400765;Ne;0;0;1;1
11066;Vėtrungė;Nykštukų;1360031121;Taip;0;15;0;15
11067;Vėtrungė;Nykštukų;2145081325;Taip;15;0;3;18
11068;Vėtrungė;Nykštukų;1611274573;Taip;0;7;0;7
11069;Vėtrungė;Nykštukų;9606769599;Ne;10;0;0;10
11070;Vėtrungė;Meškiukų;2226654309;Taip;0;1;0;1
11071;Vėtrungė;Meškiukų;7270370939;Taip;0;1;2;3
11072;Vėtrungė;Meškiukų;9543456295;Taip;0;0;1;1
11073;Vėtrungė;Meškiukų;9207846866;Taip;5;0;0;5
11074;Vėtrungė;Meškiukų;9065848425;Taip;0;0;5;5
11075;Vėtrungė;Meškiukų;3328447991;Taip;0;1;0;1
11076;Vėtrungė;Meškiukų;9685389270;Ne;0;14;0;14
11077;Vėtrungė;Meškiukų;9313438768;Taip;11;2;0;13
11078;Vėtrungė;Meškiukų;9070732925;Taip;4;1;0;5
11079;Vėtrungė;Meškiukų;3122948974;Taip;0;7;0;7
11080;Vėtrungė;Meškiukų;2414957010;Taip;0;21;0;21
11081;Vėtrungė;Meškiukų;2880342138;Taip;5;0;0;5
11082;Vėtrungė;Meškiukų;2520926439;Taip;3;0;1;4
11083;Vėtrungė;Meškiukų;7143997258;Taip;2;0;1;3
11084;Vėtrungė;Meškiukų;5123894802;Taip;0;4;0;4
11085;Vėtrungė;Meškiukų;4394100006;Taip;11;0;11;22
11086;Vėtrungė;Meškiukų;8961791293;Taip;0;4;0;4
11087;Vėtrungė;Meškiukų;2809555356;Taip;5;0;2;7
11088;Vėtrungė;Ąžuoliukų;7813907852;Taip;0;0;5;5
11089;Vėtrungė;Ąžuoliukų;3249689008;Taip;4;5;0;9
11090;Vėtrungė;Ąžuoliukų;7295216791;Taip;5;1;0;6
11091;Vėtrungė;Ąžuoliukų;2440001662;Taip;2;8;1;11
11092;Vėtrungė;Ąžuoliukų;1636432189;Taip;2;0;2;4
11093;Vėtrungė;Ąžuoliukų;7803736567;Taip;0;3;0;3
11094;Vėtrungė;Ąžuoliukų;1042333710;Ne;0;3;0;3
11095;Vėtrungė;Ąžuoliukų;6356914122;Ne;0;13;0;13
11096;Vėtrungė;Ąžuoliukų;5367369908;Taip;3;0;0;3
11097;Vėtrungė;Ąžuoliukų;4000379945;Taip;0;2;0;2
11098;Vėtrungė;Ąžuoliukų;1789419548;Ne;0;4;0;4
11099;Vėtrungė;Ąžuoliukų;7363490503;Taip;0;10;0;10
11100;Vėtrungė;Ąžuoliukų;1082104060;Taip;10;6;0;16
11101;Vilnelė;Lakštutė;9657350714;Taip;0;4;0;4
11102;Vilnelė;Lakštutė;2121071276;Taip;4;7;0;11
11103;Vilnelė;Lakštutė;1065422209;Taip;0;0;2;2
11104;Vilnelė;Lakštutė;1607330769;Taip;0;13;0;13
11105;Vilnelė;Lakštutė;85074719873;Taip;0;1;0;1
11106;Vilnelė;Lakštutė;3316451889;Taip;4;1;0;5
11107;Vilnelė;Lakštutė;8820091584;Taip;6;0;0;6
11108;Vilnelė;Lakštutė;8270866998;Taip;0;19;0;19
11109;Vilnelė;Lakštutė;2990112955;Taip;0;1;0;1
11110;Vilnelė;Lakštutė;8593060923;Taip;0;0;8;8
11111;Vilnelė;Lakštutė;3454141069;Taip;2;2;0;4
11112;Vilnelė;Lakštutė;9618342480;Taip;0;5;0;5
11113;Vilnelė;Lakštutė;6155522893;Taip;0;0;1;1
11114;Vilnelė;Lakštutė;6898685834;Taip;8;0;2;10
11115;Vilnelė;Lakštutė;6318246517;Taip;2;5;0;7
11116;Vilnelė;Lakštutė;7387394504;Taip;10;5;0;15
11117;Vilnelė;Lakštutė;1882520335;Ne;0;2;0;2
11118;Vilnelė;Vyturėlis;5091272908;Taip;6;2;0;8
11119;Vilnelė;Vyturėlis;1133945467;Taip;0;2;2;4
11120;Vilnelė;Vyturėlis;3009064105;Taip;2;0;0;2
11121;Vilnelė;Vyturėlis;1674551092;Taip;0;4;0;4
11122;Vilnelė;Vyturėlis;3743740372;Taip;5;0;0;5
11123;Vilnelė;Vyturėlis;2131599015;Taip;0;16;0;16
11124;Vilnelė;Vyturėlis;9460789751;Ne;19;0;0;19
11125;Vilnelė;Vyturėlis;18740103706;Taip;0;1;0;1
11126;Vilnelė;Vyturėlis;7057183482;Taip;18;0;0;18
11127;Vilnelė;Vyturėlis;8725191514;Taip;6;2;0;8
11128;Vilnelė;Vyturėlis;6308015852;Taip;0;6;0;6
11129;Vilnelė;Vyturėlis;7963783957;Taip;0;1;0;1
11130;Vilnelė;Vyturėlis;1545570307;Taip;7;0;0;7
11131;Vilnelė;Vyturėlis;5540359276;Taip;3;10;0;13
11132;Vilnelė;Vyturėlis;1966090625;Taip;0;2;0;2
11133;Vilnelė;Vyturėlis;8740717061;Taip;0;1;0;1
11134;Vilnelė;Vyturėlis;3772263873;Taip;6;0;2;8
11135;Vilnelė;Vyturėlis;3351718257;Taip;0;0;1;1
11136;Vilnelė;Vyturėlis;9183391434;Taip;0;4;0;4
11137;Vilnelė;Vyturėlis;2159103903;Taip;0;3;0;3
11138;Vilnelė;Pagrandukas;6707161045;Taip;0;0;2;2
11139;Vilnelė;Pagrandukas;59579013512;Taip;0;20;0;20
11140;Vilnelė;Pagrandukas;5480363267;Taip;0;2;0;2
11141;Vilnelė;Pagrandukas;2812680090;Taip;17;0;0;17
11142;Vilnelė;Pagrandukas;95852926101;Taip;0;5;0;5
11143;Vilnelė;Pagrandukas;32662933313;Ne;0;0;1;1
11144;Vilnelė;Pagrandukas;1410511913;Taip;0;2;0;2
11145;Vilnelė;Pagrandukas;48926369907;Taip;0;5;2;7
11146;Vilnelė;Pagrandukas;13646307629;Taip;0;2;0;2
11147;Vilnelė;Pagrandukas;1680411448;Taip;0;0;2;2
11148;Vilnelė;Pagrandukas;1294194561;Taip;0;7;0;7
11149;Vilnelė;Pagrandukas;54871985655;Taip;2;0;0;2
11150;Vilnelė;Pagrandukas;91933747502;Taip;0;4;0;4
11151;Vilnelė;Pagrandukas;1346145809;Taip;5;0;1;6
11152;Vilnelė;Pagrandukas;1932829642;Ne;1;0;0;1
11153;Vilnelė;Bitutė;41258849574;Taip;2;0;0;2
11154;Vilnelė;Bitutė;77967081365;Taip;5;0;0;5
11155;Vilnelė;Bitutė;9643543101;Taip;0;7;0;7
11156;Vilnelė;Bitutė;78753442031;Taip;0;1;0;1
11157;Vilnelė;Bitutė;31701260922;Taip;0;2;0;2
11158;Vilnelė;Bitutė;95736417954;Taip;0;1;0;1
11159;Vilnelė;Bitutė;10333554439;Taip;0;6;0;6
11160;Vilnelė;Bitutė;2864763106;Taip;0;2;0;2
11161;Vilnelė;Bitutė;60707257606;Taip;0;1;0;1
11162;Vilnelė;Bitutė;96611892032;Taip;0;2;0;2
11163;Vilnelė;Bitutė;79700582010;Taip;3;1;0;4
11164;Vilnelė;Bitutė;985960052;Taip;0;7;0;7
11165;Vilnelė;Bitutė;87237045379;Taip;15;2;0;17
11166;Vilnelė;Bitutė;1051858780;Taip;15;0;1;16
11167;Vilnelė;Bitutė;2138907190;Taip;0;8;0;8
11168;Vilnelė;Bitutė;5936699300;Taip;6;1;0;7
11169;Vilnelė;Bitutė;77572611171;Taip;0;3;0;3
11170;Vilnelė;Bitutė;7442249956;Ne;12;1;1;14
11171;Vilnelė;Bitutė;1061139491;Taip;0;1;0;1
11172;Vilnelė;Šaltinėlis;1783854203;Taip;8;0;0;8
11173;Vilnelė;Šaltinėlis;5013418313;Taip;0;1;0;1
11174;Vilnelė;Šaltinėlis;42835212158;Taip;8;0;4;12
11175;Vilnelė;Šaltinėlis;98028664140;Taip;3;0;0;3
11176;Vilnelė;Šaltinėlis;1255849405;Taip;4;0;0;4
11177;Vilnelė;Šaltinėlis;11430703629;Taip;9;0;0;9
11178;Vilnelė;Šaltinėlis;7292043157;Taip;0;2;0;2
11179;Vilnelė;Šaltinėlis;6327531229;Taip;5;1;1;7
11180;Vilnelė;Šaltinėlis;10345875729;Taip;15;0;2;17
11181;Vilnelė;Šaltinėlis;1572818047;Taip;10;0;0;10
11182;Vilnelė;Šaltinėlis;2130482375;Taip;0;7;0;7
11183;Vilnelė;Šaltinėlis;9058632601;Taip;0;13;0;13
11184;Vilnelė;Šaltinėlis;1507865281;Taip;0;13;0;13
11185;Vilnelė;Šaltinėlis;39494954188;Taip;0;16;0;16
11186;Vilnelė;Šaltinėlis;8615257084;Taip;10;0;0;10
11187;Vilnelė;Šaltinėlis;6146514112;Taip;5;1;0;6
11188;Vilnelė;Šaltinėlis;9016832316;Taip;0;4;0;4
11189;Vilnelė;Šaltinėlis;1281521052;Taip;10;6;0;16
11190;Vilnelė;Šaltinėlis;5790420711;Taip;0;2;0;2
11191;Vilnelė;Riešutėllis;67561845041;Taip;0;3;0;3
11192;Vilnelė;Riešutėllis;85568332595;Taip;0;5;0;5
11193;Vilnelė;Riešutėllis;22516605873;Taip;0;11;0;11
11194;Vilnelė;Riešutėllis;64066480740;Taip;0;4;0;4
11195;Vilnelė;Riešutėllis;1859757115;Taip;0;2;0;2
11196;Vilnelė;Riešutėllis;1450994872;Taip;0;0;2;2
11197;Vilnelė;Riešutėllis;9331404812;Taip;0;9;0;9
11198;Vilnelė;Riešutėllis;11702051319;Taip;0;5;0;5
11199;Vilnelė;Riešutėllis;41536662155;Ne;0;2;1;3
11200;Vilnelė;Riešutėllis;69413564937;Taip;0;11;0;11
11201;Vilnelė;Riešutėllis;71906228270;Taip;0;0;3;3
11202;Vilnelė;Riešutėllis;7916632244;Taip;0;2;0;2
11203;Vilnelė;Riešutėllis;20639648308;Taip;0;0;3;3
11204;Vilnelė;Riešutėllis;73658263243;Ne;0;13;0;13
11205;Vilnelė;Riešutėllis;8889469645;Taip;7;8;0;15
11206;Vilnelė;Riešutėllis;1522056886;Taip;0;0;2;2
11207;Vilnelė;Riešutėllis;1321202650;Taip;10;1;0;11
11208;Vilnelė;Riešutėllis;5790420711;Taip;0;1;0;1
11209;Vilnelė;Nykštukas;1336497125;Taip;19;0;0;19
11210;Vilnelė;Nykštukas;32988468324;Taip;0;11;0;11
11211;Vilnelė;Nykštukas;89748262997;Taip;3;3;0;6
11212;Vilnelė;Nykštukas;87406093438;Taip;3;3;0;6
11213;Vilnelė;Nykštukas;13583637193;Taip;0;1;0;1
11214;Vilnelė;Nykštukas;23442711820;Taip;0;2;0;2
11215;Vilnelė;Nykštukas;47863474499;Taip;0;16;0;16
11216;Vilnelė;Nykštukas;13231410969;Taip;0;11;0;11
11217;Vilnelė;Nykštukas;62208863766;Taip;0;2;0;2
11218;Vilnelė;Nykštukas;36905818484;Taip;0;2;0;2
11219;Vilnelė;Nykštukas;87094375121;Taip;0;3;0;3
11220;Vilnelė;Nykštukas;42526993637;Taip;2;0;0;2
11221;Vilnelė;Nykštukas;58422521907;Taip;0;1;0;1
11222;Vilnelė;Nykštukas;15265621906;Taip;0;6;0;6
11223;Vilnelė;Nykštukas;5198859945;Taip;0;7;0;7
11224;Vilnelė;Nykštukas;2131603460;Taip;0;4;0;4
11225;Vilnelė;Nykštukas;1957418704;Taip;0;1;0;1
11226;Vilnelė;Pieštukas;9879688569;Taip;3;5;0;8
11227;Vilnelė;Pieštukas;5473379559;Taip;10;0;1;11
11228;Vilnelė;Pieštukas;1462397783;Taip;9;0;1;10
11229;Vilnelė;Pieštukas;1792586468;Taip;7;2;0;9
11230;Vilnelė;Pieštukas;3781595939;Taip;0;15;0;15
11231;Vilnelė;Pieštukas;9884955712;Taip;10;1;0;11
11232;Vilnelė;Pieštukas;2479090686;Taip;3;1;0;4
11233;Vilnelė;Pieštukas;3945921490;Taip;0;14;0;14
11234;Vilnelė;Pieštukas;1975954784;Taip;3;0;1;4
11235;Vilnelė;Pieštukas;7199490431;Taip;10;0;0;10
11236;Vilnelė;Pieštukas;6798728562;Taip;10;4;0;14
11237;Vilnelė;Pieštukas;1730149127;Taip;0;6;0;6
11238;Vilnelė;Pieštukas;5778176840;Taip;8;0;0;8
11239;Vilnelė;Pieštukas;6355912551;Taip;0;6;0;6
11240;Vilnelė;Pieštukas;7976798775;Taip;0;3;0;3
11241;Vilnelė;Pieštukas;7908813288;Ne;0;0;3;3
11242;Vilnelė;Pieštukas;3811289758;Taip;0;9;0;9
11243;Vilnelė;Pieštukas;5261402753;Taip;4;3;0;7
11244;Vilnelė;Pieštukas;3529718234;Taip;7;0;0;7
11245;Vilnelė;Pieštukas;4129178478;Taip;8;1;0;9
11246;Vilnelė;Voverytė;4838684336;Ne;10;2;1;13
11247;Vilnelė;Voverytė;7536603663;Taip;0;7;0;7
11248;Vilnelė;Voverytė;3503461211;Ne;10;10;0;20
11249;Vilnelė;Voverytė;7388336851;Taip;16;1;0;17
11250;Vilnelė;Voverytė;8667403338;Taip;0;8;0;8
11251;Vilnelė;Voverytė;7883724600;Taip;0;8;0;8
11252;Vilnelė;Voverytė;4166351390;Taip;2;1;0;3
11253;Vilnelė;Voverytė;1351798589;Taip;0;8;0;8
11254;Vilnelė;Voverytė;9162681538;Taip;0;2;0;2
11255;Vilnelė;Voverytė;3075681823;Taip;0;2;0;2
11256;Vilnelė;Voverytė;6342242777;Taip;0;2;0;2
11257;Vilnelė;Voverytė;3843064564;Taip;0;1;0;1
11258;Vilnelė;Voverytė;3558073399;Taip;5;0;2;7
11259;Vilnelė;Voverytė;2923012145;Taip;0;0;1;1
11260;Vilnelė;Voverytė;2841315531;Taip;4;0;2;6
11261;Vilnelė;Voverytė;9804772168;Taip;0;1;0;1
11262;Vilnelė;Voverytė;1596625263;Taip;15;0;1;16
11263;Vilnelė;Voverytė;7338573817;Taip;0;0;4;4
11264;Vilnelė;Voverytė;8121075430;Ne;0;5;0;5
11265;Vilnelė;Kodėlčiukas;6289991945;Taip;0;3;0;3
11266;Vilnelė;Kodėlčiukas;95055148560;Ne;3;0;0;3
11267;Vilnelė;Kodėlčiukas;81657018187;Taip;0;3;0;3
11268;Vilnelė;Kodėlčiukas;1448257490;Taip;0;1;0;1
11269;Vilnelė;Kodėlčiukas;69532393507;Taip;0;0;1;1
11270;Vilnelė;Kodėlčiukas;64950604083;Taip;0;5;0;5
11271;Vilnelė;Kodėlčiukas;99580393765;Taip;0;1;0;1
11272;Vilnelė;Kodėlčiukas;96900970284;Taip;0;3;0;3
11273;Vilnelė;Kodėlčiukas;85391221236;Taip;0;6;0;6
11274;Vilnelė;Kodėlčiukas;39412868538;Taip;0;4;0;4
11275;Vilnelė;Kodėlčiukas;67110179640;Ne;0;9;0;9
11276;Vilnelė;Kodėlčiukas;90980722090;Taip;5;1;0;6
11277;Vilnelė;Kodėlčiukas;32819254615;Ne;4;0;0;4
11278;Vilnelė;Kodėlčiukas;91413844614;Taip;20;1;0;21
11279;Vilnelė;Žirniukas;6026600803;Taip;0;0;2;2
11280;Vilnelė;Žirniukas;1580287517;Taip;0;2;0;2
11281;Vilnelė;Žirniukas;4328263940;Taip;15;0;0;15
11282;Vilnelė;Žirniukas;8620789304;Taip;10;0;0;10
11283;Vilnelė;Žirniukas;8439505238;Taip;5;0;0;5
11284;Vilnelė;Žirniukas;6448119003;Taip;0;1;0;1
11285;Vilnelė;Žirniukas;1027463000;Ne;0;1;2;3
11286;Vilnelė;Žirniukas;5953205533;Taip;9;0;0;9
11287;Vilnelė;Žirniukas;4448413194;Taip;0;1;1;2
11288;Vilnelė;Žirniukas;6830433856;Ne;0;3;0;3
11289;Vilnelė;Žirniukas;7020707723;Taip;0;0;8;8
11290;Vilnelė;Žirniukas;5306723959;Taip;0;0;2;2
11291;Vilnelė;Žirniukas;5558378376;Taip;5;6;0;11
11292;Vilnelė;Žirniukas;4664946923;Taip;5;0;1;6
11293;Vilnelė;Žirniukas;1960860528;Taip;7;0;1;8
11294;Vilnelė;Žirniukas;3312254613;Taip;15;0;0;15
11295;Vilnelė;Pipiras;9640330864;Taip;0;2;0;2
11296;Vilnelė;Pipiras;5961910077;Taip;5;0;0;5
11297;Vilnelė;Pipiras;4295816753;Taip;0;1;0;1
11298;Vilnelė;Pipiras;3848720970;Taip;9;0;0;9
11299;Vilnelė;Pipiras;9537740492;Taip;6;1;0;7
11300;Vilnelė;Pipiras;3670613082;Taip;10;1;0;11
11301;Vilnelė;Pipiras;3211657057;Taip;0;1;0;1
11302;Vilnelė;Pipiras;7833531435;Taip;9;3;0;12
11303;Vilnelė;Pipiras;8717111488;Taip;5;1;0;6
11304;Vilnelė;Pipiras;5756690199;Taip;0;1;0;1
11305;Vilnelė;Pipiras;3056845279;Taip;0;20;0;20
11306;Vilnelė;Pipiras;7085972543;Taip;0;2;0;2
11307;Vėrinėlis;GAIDELIAI;2529641529;Taip;10;4;0;14
11308;Vėrinėlis;GAIDELIAI;3729926575;Taip;12;0;0;12
11309;Vėrinėlis;GAIDELIAI;2774618380;Taip;6;0;2;8
11310;Vėrinėlis;GAIDELIAI;5429955166;Taip;10;0;1;11
11311;Vėrinėlis;GAIDELIAI;5209398043;Taip;0;2;0;2
11312;Vėrinėlis;GAIDELIAI;8885866108;Taip;1;0;0;1
11313;Vėrinėlis;GAIDELIAI;6136232912;Taip;14;5;0;19
11314;Vėrinėlis;GAIDELIAI;6496291933;Taip;0;2;2;4
11315;Vėrinėlis;GAIDELIAI;1164396960;Taip;0;0;8;8
11316;Vėrinėlis;GAIDELIAI;8091400240;Taip;5;0;0;5
11317;Vėrinėlis;GAIDELIAI;8728166391;Taip;10;0;0;10
11318;Vėrinėlis;GAIDELIAI;4415030161;Taip;7;7;0;14
11319;Vėrinėlis;GAIDELIAI;6413701823;Taip;10;0;0;10
11320;Vėrinėlis;GAIDELIAI;8100283579;Taip;0;0;1;1
11321;Vėrinėlis;SAULUTĖ;8755941866;Taip;18;0;1;19
11322;Vėrinėlis;SAULUTĖ;5434506594;Taip;8;1;0;9
11323;Vėrinėlis;SAULUTĖ;9751494612;Taip;0;0;2;2
11324;Vėrinėlis;SAULUTĖ;1897451825;Ne;0;6;0;6
11325;Vėrinėlis;SAULUTĖ;4727265555;Taip;10;7;0;17
11326;Vėrinėlis;SAULUTĖ;1047139776;Taip;0;5;5;10
11327;Vėrinėlis;SAULUTĖ;1493604303;Taip;10;0;0;10
11328;Vėrinėlis;SAULUTĖ;9500715949;Taip;0;0;1;1
11329;Vėrinėlis;SAULUTĖ;8922728881;Taip;7;0;0;7
11330;Vėrinėlis;SAULUTĖ;84391578139;Taip;0;0;6;6
11331;Vėrinėlis;SAULUTĖ;7071043164;Taip;5;7;0;12
11332;Vėrinėlis;SAULUTĖ;8620836106;Taip;10;7;1;18
11333;Vėrinėlis;SAULUTĖ;5003344894;Ne;0;0;1;1
11334;Vėrinėlis;SAULUTĖ;4183077476;Taip;0;1;0;1
11335;Vėrinėlis;SAULUTĖ;6906865967;Taip;0;8;0;8
11336;Vėrinėlis;SAULUTĖ;4925983616;Taip;4;0;1;5
11337;Vėrinėlis;SAULUTĖ;2732572235;Taip;3;0;1;4
11338;Vėrinėlis;NYKŠTUKAI;1518907235;Taip;0;0;6;6
11339;Vėrinėlis;NYKŠTUKAI;7978434812;Taip;6;0;4;10
11340;Vėrinėlis;NYKŠTUKAI;1339314644;Taip;0;0;3;3
11341;Vėrinėlis;NYKŠTUKAI;6065348004;Taip;0;5;2;7
11342;Vėrinėlis;NYKŠTUKAI;7436873997;Ne;10;2;0;12
11343;Vėrinėlis;NYKŠTUKAI;1592544116;Taip;0;0;1;1
11344;Vėrinėlis;NYKŠTUKAI;1261337457;Taip;4;0;6;10
11345;Vėrinėlis;NYKŠTUKAI;11459693163;Taip;0;0;1;1
11346;Vėrinėlis;NYKŠTUKAI;38428514086;Ne;4;4;0;8
11347;Vėrinėlis;NYKŠTUKAI;27431479888;Taip;5;0;1;6
11348;Vėrinėlis;NYKŠTUKAI;41029899086;Ne;0;0;4;4
11349;Vėrinėlis;NYKŠTUKAI;2001903188;Ne;4;0;1;5
11350;Vėrinėlis;NYKŠTUKAI;1251822610;Ne;0;0;2;2
11351;Vėrinėlis;NYKŠTUKAI;8755231814;Taip;7;0;0;7
11352;Vėrinėlis;BURATINAS;65408541019;Ne;14;2;0;16
11353;Vėrinėlis;BURATINAS;57498275265;Taip;0;0;2;2
11354;Vėrinėlis;BURATINAS;54666417396;Taip;8;1;1;10
11355;Vėrinėlis;BURATINAS;4067153819;Taip;0;0;1;1
11356;Vėrinėlis;BURATINAS;1170817811;Taip;0;2;0;2
11357;Vėrinėlis;BURATINAS;73256255966;Taip;0;0;2;2
11358;Vėrinėlis;BURATINAS;22726982138;Taip;0;0;1;1
11359;Vėrinėlis;BURATINAS;89785057363;Taip;0;19;0;19
11360;Vėrinėlis;BURATINAS;90264493281;Taip;0;11;0;11
11361;Vėrinėlis;BURATINAS;90979069296;Taip;8;0;0;8
11362;Vėrinėlis;BURATINAS;67282950717;Taip;0;0;5;5
11363;Vėrinėlis;BURATINAS;7431541945;Taip;5;3;0;8
11364;Vėrinėlis;BURATINAS;67987598880;Taip;0;0;2;2
11365;Vėrinėlis;BURATINAS;9266953028;Taip;0;5;0;5
11366;Vėrinėlis;BURATINAS;4789626884;Taip;2;0;0;2
11367;Vėrinėlis;GINTARĖLIAI;79005449877;Taip;0;1;0;1
11368;Vėrinėlis;GINTARĖLIAI;3183131197;Taip;0;3;0;3
11369;Vėrinėlis;GINTARĖLIAI;1028694005;Taip;0;1;1;2
11370;Vėrinėlis;GINTARĖLIAI;1465052758;Taip;13;0;0;13
11371;Vėrinėlis;GINTARĖLIAI;97559214584;Taip;0;0;4;4
11372;Vėrinėlis;GINTARĖLIAI;7819933209;Taip;7;0;0;7
11373;Vėrinėlis;GINTARĖLIAI;762270610;Taip;0;0;2;2
11374;Vėrinėlis;GINTARĖLIAI;78121632796;Ne;3;1;0;4
11375;Vėrinėlis;GINTARĖLIAI;99325931907;Taip;0;0;2;2
11376;Vėrinėlis;GINTARĖLIAI;668239862;Taip;0;3;0;3
11377;Vėrinėlis;GINTARĖLIAI;8197177876;Taip;0;2;1;3
11378;Vėrinėlis;GINTARĖLIAI;22535431362;Taip;0;1;2;3
11379;Vėrinėlis;GINTARĖLIAI;1804757495;Taip;5;0;0;5
11380;Vėrinėlis;GINTARĖLIAI;1029210296;Taip;10;0;0;10
11381;Vėrinėlis;GINTARĖLIAI;1791124205;Taip;0;2;0;2
11382;Vėrinėlis;GINTARĖLIAI;92480758419;Ne;0;0;3;3
11383;Vėrinėlis;GINTARĖLIAI;8955109359;Ne;0;0;2;2
11384;Vėrinėlis;RAMUNĖLĖS;1292880457;Taip;0;0;1;1
11385;Vėrinėlis;RAMUNĖLĖS;1398564881;Taip;0;1;0;1
11386;Vėrinėlis;RAMUNĖLĖS;68073702260;Taip;0;0;1;1
11387;Vėrinėlis;RAMUNĖLĖS;1268710930;Taip;0;1;0;1
11388;Vėrinėlis;RAMUNĖLĖS;1477336890;Taip;0;3;0;3
11389;Vėrinėlis;RAMUNĖLĖS;1803838403;Taip;10;0;1;11
11390;Vėrinėlis;RAMUNĖLĖS;71830611159;Taip;9;0;0;9
11391;Vėrinėlis;RAMUNĖLĖS;39153716711;Taip;0;9;0;9
11392;Vėrinėlis;RAMUNĖLĖS;11343969028;Taip;10;1;0;11
11393;Vėrinėlis;RAMUNĖLĖS;1086306523;Ne;10;0;3;13
11394;Vėrinėlis;RAMUNĖLĖS;1408704528;Taip;8;2;0;10
11395;Vėrinėlis;RAMUNĖLĖS;1239744245;Taip;8;2;0;10
11396;Vėrinėlis;RAMUNĖLĖS;6148700823;Taip;0;8;0;8
11397;Vėrinėlis;KODELČIUKŲ;1001125426;Taip;15;0;3;18
11398;Vėrinėlis;KODELČIUKŲ;42875958735;Ne;0;5;0;5
11399;Vėrinėlis;KODELČIUKŲ;25734061057;Taip;5;0;0;5
11400;Vėrinėlis;KODELČIUKŲ;68027880109;Taip;0;0;2;2
11401;Vėrinėlis;KODELČIUKŲ;2676104110;Taip;0;0;1;1
11402;Vėrinėlis;KODELČIUKŲ;1876456237;Taip;0;2;0;2
11403;Vėrinėlis;KODELČIUKŲ;12363691267;Taip;0;0;1;1
11404;Vėrinėlis;KODELČIUKŲ;3044373634;Taip;0;0;2;2
11405;Vėrinėlis;KODELČIUKŲ;24888549934;Taip;0;3;0;3
11406;Vėrinėlis;KODELČIUKŲ;38831165210;Taip;0;1;0;1
11407;Vėrinėlis;KODELČIUKŲ;37600982027;Ne;0;4;0;4
11408;Vėrinėlis;KODELČIUKŲ;79317384797;Taip;0;4;0;4
11409;Vėrinėlis;KODELČIUKŲ;1953362884;Taip;7;0;0;7
11410;Vėrinėlis;KODELČIUKŲ;58909000723;Taip;0;0;2;2
11411;Vėrinėlis;KODELČIUKŲ;1907101316;Taip;0;4;0;4
11412;Vėrinėlis;KODELČIUKŲ;8978798314;Taip;2;0;1;3
11413;Vėrinėlis;ŽIRNIUKAI;3074835599;Ne;8;0;3;11
11414;Vėrinėlis;ŽIRNIUKAI;1769852084;Taip;5;0;2;7
11415;Vėrinėlis;ŽIRNIUKAI;4718732261;Taip;5;0;0;5
11416;Vėrinėlis;ŽIRNIUKAI;4981127515;Taip;5;0;1;6
11417;Vėrinėlis;ŽIRNIUKAI;7845985650;Ne;6;0;2;8
11418;Vėrinėlis;ŽIRNIUKAI;2815770695;Taip;0;5;3;8
11419;Vėrinėlis;ŽIRNIUKAI;9604483237;Taip;0;0;2;2
11420;Vėrinėlis;ŽIRNIUKAI;9419245081;Taip;0;1;2;3
11421;Vėrinėlis;ŽIRNIUKAI;8329989952;Taip;14;0;0;14
11422;Vėrinėlis;ŽIRNIUKAI;3202518504;Taip;10;0;1;11
11423;Vėrinėlis;ŽIRNIUKAI;8824435889;Taip;7;0;1;8
11424;Vėrinėlis;ŽIRNIUKAI;4752902173;Taip;7;0;1;8
11425;Vėrinėlis;ŽIRNIUKAI;7237945125;Taip;12;0;2;14
11426;Vėrinėlis;ŽIRNIUKAI;5600815908;Taip;18;0;1;19
11427;Vėrinėlis;ŽIRNIUKAI;6779005350;Ne;0;0;4;4
11428;Vėrinėlis;ŽIRNIUKAI;7367485961;Taip;0;0;2;2
11429;Vėrinėlis;ŽIRNIUKAI;6576726481;Taip;12;0;1;13
11430;Vėrinėlis;ŽIRNIUKAI;8397025332;Taip;12;0;1;13
11431;Vėrinėlis;ŽIRNIUKAI;9340167973;Taip;14;1;0;15
11432;Vėrinėlis;ŽIRNIUKAI;1736733257;Ne;22;0;0;22
11433;Vėrinėlis;VARPELIAI;3316897176;Taip;0;0;10;10
11434;Vėrinėlis;VARPELIAI;9009344779;Taip;2;0;0;2
11435;Vėrinėlis;VARPELIAI;9289003583;Taip;6;1;0;7
11436;Vėrinėlis;VARPELIAI;1684203955;Taip;4;3;0;7
11437;Vėrinėlis;VARPELIAI;3882915774;Taip;0;4;0;4
11438;Vėrinėlis;VARPELIAI;7233139048;Taip;0;0;4;4
11439;Vėrinėlis;VARPELIAI;3130841241;Taip;0;7;0;7
11440;Vėrinėlis;VARPELIAI;6435612222;Taip;0;0;2;2
11441;Vėrinėlis;VARPELIAI;2337883071;Taip;17;0;1;18
11442;Vėrinėlis;VARPELIAI;6913001318;Ne;7;0;0;7
11443;Vėrinėlis;VARPELIAI;4728119881;Taip;2;0;0;2
11444;Vėrinėlis;VARPELIAI;7224418233;Taip;0;17;0;17
11445;Vėrinėlis;VARPELIAI;1894717954;Taip;6;0;0;6
11446;Vėrinėlis;VARPELIAI;3667953591;Taip;21;0;0;21
11447;Vėrinėlis;VARPELIAI;8318388772;Taip;2;0;5;7
11448;Vėrinėlis;VARPELIAI;4191386053;Taip;4;5;0;9
11449;Vėrinėlis;VARPELIAI;2090334618;Taip;12;0;0;12
11450;Vėrinėlis;BORUŽĖLĖS;8759487574;Taip;0;3;0;3
11451;Vėrinėlis;BORUŽĖLĖS;4819016753;Ne;0;0;4;4
11452;Vėrinėlis;BORUŽĖLĖS;1910385020;Taip;0;0;3;3
11453;Vėrinėlis;BORUŽĖLĖS;2078857084;Taip;3;0;3;6
11454;Vėrinėlis;BORUŽĖLĖS;3934652683;Taip;5;0;0;5
11455;Vėrinėlis;BORUŽĖLĖS;4446546335;Taip;0;0;2;2
11456;Vėrinėlis;BORUŽĖLĖS;2501287529;Taip;0;1;0;1
11457;Vėrinėlis;BORUŽĖLĖS;9217188911;Taip;5;0;0;5
11458;Vėrinėlis;BORUŽĖLĖS;7414937335;Taip;0;8;0;8
11459;Vėrinėlis;BORUŽĖLĖS;2574507205;Taip;5;0;0;5
11460;Vėrinėlis;BORUŽĖLĖS;6671382987;Taip;0;0;2;2
11461;Vėrinėlis;SVEIKUOLIAI;87606501349;Taip;0;0;6;6
11462;Vėrinėlis;SVEIKUOLIAI;19865450007;Taip;9;2;0;11
11463;Vėrinėlis;SVEIKUOLIAI;6869951613;Taip;3;0;0;3
11464;Vėrinėlis;SVEIKUOLIAI;1395590011;Ne;9;0;2;11
11465;Vėrinėlis;SVEIKUOLIAI;3975934329;Taip;3;0;1;4
11466;Vėrinėlis;SVEIKUOLIAI;9751037428;Ne;0;11;0;11
11467;Vėrinėlis;SVEIKUOLIAI;1513856520;Taip;0;0;1;1
11468;Vėrinėlis;SVEIKUOLIAI;3562371502;Taip;17;0;1;18
11469;Vėrinėlis;SVEIKUOLIAI;4089567420;Ne;7;0;3;10
11470;Vėrinėlis;SVEIKUOLIAI;5960946826;Taip;0;8;0;8
11471;Vėrinėlis;SVEIKUOLIAI;5496928903;Ne;5;0;4;9
11472;Vėrinėlis;SVEIKUOLIAI;7865276052;Taip;0;0;2;2
11473;Vėrinėlis;SVEIKUOLIAI;7981261038;Taip;0;2;0;2
11474;Vėrinėlis;SVEIKUOLIAI;5511584499;Taip;7;11;0;18
11475;Vėrinėlis;SVEIKUOLIAI;6644892686;Taip;8;3;2;13
11476;Vėrinėlis;SVEIKUOLIAI;4958359640;Taip;8;0;0;8
11477;Vėrinėlis;SVEIKUOLIAI;1338287524;Taip;4;0;1;5
11478;Vėrinėlis;SVEIKUOLIAI;8579819581;Taip;3;1;3;7
11479;Vėrinėlis;SVEIKUOLIAI;6220653152;Taip;5;4;0;9
11480;Vėrinėlis;ŠIRDELĖS;2944010445;Taip;0;18;0;18
11481;Vėrinėlis;ŠIRDELĖS;8195455092;Taip;5;0;1;6
11482;Vėrinėlis;ŠIRDELĖS;96779456411;Taip;0;1;0;1
11483;Vėrinėlis;ŠIRDELĖS;7167034587;Taip;5;5;0;10
11484;Vėrinėlis;ŠIRDELĖS;3049346950;Taip;10;0;12;22
11485;Vėrinėlis;ŠIRDELĖS;7070058961;Taip;1;4;0;5
11486;Vėrinėlis;ŠIRDELĖS;7130691686;Taip;9;0;0;9
11487;Vėrinėlis;ŠIRDELĖS;8709714647;Taip;1;0;10;11
11488;Vėrinėlis;ŠIRDELĖS;3308843618;Taip;0;0;9;9
11489;Vėrinėlis;ŠIRDELĖS;85262495209;Ne;0;9;0;9
11490;Vėrinėlis;ŠIRDELĖS;4039903678;Taip;0;0;7;7
11491;Vėrinėlis;ŠIRDELĖS;9119967823;Taip;11;0;0;11
11492;Vėrinėlis;ŠIRDELĖS;1467899937;Taip;0;0;1;1
11493;Vėrinėlis;ŠIRDELĖS;7634939364;Taip;0;0;2;2
11494;Vėrinėlis;ŠIRDELĖS;54361215161;Taip;0;0;2;2
11495;Vėrinėlis;ŠIRDELĖS;1535567719;Taip;0;8;0;8
11496;Vėrinėlis;ŠIRDELĖS;8652292752;Taip;10;8;0;18
11497;Viltenė;Drugeliai;79464006792;Taip;0;3;0;3
11498;Viltenė;Drugeliai;1936464823;Taip;0;2;0;2
11499;Viltenė;Drugeliai;50489733849;Ne;0;1;0;1
11500;Viltenė;Drugeliai;69838945768;Ne;7;0;0;7
11501;Viltenė;Drugeliai;54422258148;Taip;0;2;0;2
11502;Viltenė;Drugeliai;4322306031;Taip;0;1;0;1
11503;Viltenė;Drugeliai;82849073169;Taip;0;1;0;1
11504;Viltenė;Drugeliai;39676814294;Ne;0;1;0;1
11505;Viltenė;Drugeliai;47885567334;Taip;0;1;0;1
11506;Viltenė;Drugeliai;68110722913;Taip;4;2;0;6
11507;Viltenė;Drugeliai;21489308130;Taip;0;6;0;6
11508;Viltenė;Drugeliai;16461652415;Taip;7;1;0;8
11509;Viltenė;Drugeliai;91847807834;Taip;0;2;0;2
11510;Viltenė;Drugeliai;34691221253;Ne;0;4;0;4
11511;Viltenė;Drugeliai;75637599543;Taip;0;3;0;3
11512;Viltenė;Drugeliai;33159619580;Taip;0;6;0;6
11513;Viltenė;Drugeliai;4586042895;Taip;0;2;0;2
11514;Viltenė;Drugeliai;1739353382;Taip;0;4;0;4
11515;Viltenė;Bitučių;1747442313;Taip;0;7;0;7
11516;Viltenė;Bitučių;61093082990;Ne;7;0;0;7
11517;Viltenė;Bitučių;13157765051;Taip;0;1;0;1
11518;Viltenė;Bitučių;46245753187;Taip;0;2;0;2
11519;Viltenė;Bitučių;2046122804;Taip;0;9;0;9
11520;Viltenė;Bitučių;74464437862;Taip;0;2;0;2
11521;Viltenė;Bitučių;86055366818;Taip;0;3;0;3
11522;Viltenė;Bitučių;66587678111;Taip;5;0;0;5
11523;Viltenė;Bitučių;65252989761;Taip;0;4;0;4
11524;Viltenė;Bitučių;1702925444;Taip;0;1;0;1
11525;Viltenė;Bitučių;6006470515;Taip;5;0;0;5
11526;Viltenė;Bitučių;1656026241;Taip;0;1;0;1
11527;Viltenė;Bitučių;4554162475;Taip;0;1;0;1
11528;Viltenė;Bitučių;1291605426;Taip;0;2;0;2
11529;Viltenė;Bitučių;6322746293;Taip;0;7;0;7
11530;Viltenė;Bitučių;4334881910;Taip;0;12;0;12
11531;Viltenė;Bitučių;9068349987;Ne;0;7;0;7
11532;Viltenė;Boružėlių;3777544301;Taip;8;3;0;11
11533;Viltenė;Boružėlių;6642790962;Taip;14;0;0;14
11534;Viltenė;Boružėlių;9572407405;Taip;12;0;0;12
11535;Viltenė;Boružėlių;3738838707;Taip;0;4;0;4
11536;Viltenė;Boružėlių;8473588098;Taip;8;5;0;13
11537;Viltenė;Boružėlių;1399653129;Taip;0;7;0;7
11538;Viltenė;Boružėlių;7526555727;Taip;15;0;0;15
11539;Viltenė;Boružėlių;3164402142;Taip;10;1;0;11
11540;Viltenė;Boružėlių;5379804362;Taip;8;0;0;8
11541;Viltenė;Boružėlių;1936628249;Taip;6;0;0;6
11542;Viltenė;Boružėlių;4003018966;Taip;7;1;0;8
11543;Viltenė;Boružėlių;7912396297;Taip;11;3;0;14
11544;Viltenė;Boružėlių;4036109404;Taip;0;3;0;3
11545;Viltenė;Boružėlių;4604298036;Taip;3;6;0;9
11546;Viltenė;Boružėlių;9197007374;Taip;4;3;0;7
11547;Viltenė;Boružėlių;9242034622;Taip;10;1;0;11
11548;Viltenė;Boružėlių;5280690534;Taip;0;2;0;2
11549;Viltenė;Boružėlių;6621273812;Taip;10;2;0;12
11550;Viltenė;Boružėlių;2383607612;Taip;0;2;0;2
11551;Viltenė;Boružėlių;1496943250;Ne;9;0;0;9
11552;Viltenė;Gandriukų;6481491422;Taip;0;3;0;3
11553;Viltenė;Gandriukų;2452782594;Taip;5;0;0;5
11554;Viltenė;Gandriukų;9217178863;Ne;10;1;0;11
11555;Viltenė;Gandriukų;1126409020;Taip;0;5;0;5
11556;Viltenė;Gandriukų;2884698447;Taip;4;10;0;14
11557;Viltenė;Gandriukų;6060648988;Taip;14;0;0;14
11558;Viltenė;Gandriukų;1840626621;Taip;0;3;0;3
11559;Viltenė;Gandriukų;8549631247;Taip;13;0;0;13
11560;Viltenė;Gandriukų;7796422726;Taip;0;4;0;4
11561;Viltenė;Gandriukų;2815105107;Taip;0;15;0;15
11562;Viltenė;Gandriukų;6511850468;Taip;0;6;0;6
11563;Viltenė;Gandriukų;4945108189;Taip;0;13;0;13
11564;Viltenė;Gandriukų;5850652322;Taip;0;11;0;11
11565;Viltenė;Gandriukų;8110413064;Taip;0;3;0;3
11566;Viltenė;Gandriukų;1243595112;Taip;5;0;0;5
11567;Viltenė;Gandriukų;4388770140;Taip;0;1;0;1
11568;Viltenė;Gandriukų;3073228245;Taip;0;9;0;9
11569;Viltenė;Gandriukų;4468743044;Ne;0;11;0;11
11570;Viltenė;Gandriukų;6355857716;Ne;0;1;0;1
11571;Viltenė;Aitvariukai;51598096361;Taip;0;7;0;7
11572;Viltenė;Aitvariukai;15218988953;Taip;0;4;0;4
11573;Viltenė;Aitvariukai;9155192250;Taip;0;0;13;13
11574;Viltenė;Aitvariukai;5304966336;Taip;0;8;0;8
11575;Viltenė;Aitvariukai;3057761137;Ne;0;0;9;9
11576;Viltenė;Aitvariukai;6160715081;Taip;0;0;22;22
11577;Viltenė;Aitvariukai;5919786939;Taip;0;1;0;1
11578;Viltenė;Aitvariukai;17844870669;Taip;0;4;0;4
11579;Viltenė;Aitvariukai;56293220882;Taip;4;10;0;14
11580;Viltenė;Aitvariukai;96366849694;Ne;0;0;2;2
11581;Viltenė;Aitvariukai;8259812812;Taip;0;0;4;4
11582;Viltenė;Aitvariukai;23233966729;Taip;0;0;4;4
11583;Viltenė;Aitvariukai;44367763042;Taip;5;0;0;5
11584;Viltenė;Aitvariukai;99398043638;Taip;10;0;2;12
11585;Viltenė;Aitvariukai;55514676697;Taip;0;0;4;4
11586;Viltenė;Aitvariukai;14831307307;Taip;7;1;0;8
11587;Viltenė;Aitvariukai;70963916697;Taip;0;0;1;1
11588;Viltenė;Aitvariukai;5297513672;Taip;8;0;1;9
11589;Viltenė;Geniukų;1822220265;Ne;0;2;0;2
11590;Viltenė;Geniukų;9613791189;Taip;0;2;0;2
11591;Viltenė;Geniukų;6349032936;Taip;0;2;0;2
11592;Viltenė;Geniukų;1423254631;Ne;0;3;0;3
11593;Viltenė;Geniukų;3002690526;Taip;4;1;0;5
11594;Viltenė;Geniukų;3711956659;Taip;4;1;0;5
11595;Viltenė;Geniukų;1054469254;Taip;0;2;0;2
11596;Viltenė;Geniukų;4295285885;Taip;0;8;0;8
11597;Viltenė;Geniukų;6063181025;Taip;0;11;0;11
11598;Viltenė;Geniukų;1672091332;Taip;14;0;0;14
11599;Viltenė;Geniukų;9396183748;Taip;0;1;0;1
11600;Viltenė;Geniukų;3018271511;Taip;0;5;0;5
11601;Viltenė;Geniukų;49998813869;Taip;6;1;0;7
11602;Viltenė;Geniukų;3389110405;Taip;5;0;0;5
11603;Viltenė;Geniukų;4319685140;Taip;0;9;0;9
11604;Viltenė;Geniukų;8329611036;Ne;3;3;0;6
11605;Viltenė;Geniukų;8125023386;Taip;0;5;0;5
11606;Viltenė;Geniukų;9035687504;Taip;0;1;0;1
11607;Viltenė;Geniukų;5664573939;Taip;0;1;0;1
11608;Viltenė;Geniukų;1629377078;Taip;0;1;0;1
11609;Viltenė;Saulutės;2044754943;Taip;0;2;0;2
11610;Viltenė;Saulutės;6848403057;Taip;0;1;0;1
11611;Viltenė;Saulutės;1615415742;Taip;0;2;0;2
11612;Viltenė;Saulutės;7994367286;Taip;0;2;0;2
11613;Viltenė;Saulutės;9935236068;Taip;0;2;0;2
11614;Viltenė;Saulutės;2141002432;Taip;0;5;0;5
11615;Viltenė;Saulutės;1362308882;Taip;0;3;0;3
11616;Viltenė;Saulutės;8920533673;Ne;0;2;0;2
11617;Viltenė;Saulutės;5024192785;Taip;11;2;0;13
11618;Viltenė;Saulutės;92968672028;Taip;0;7;0;7
11619;Viltenė;Saulutės;1918867591;Taip;0;8;0;8
11620;Viltenė;Saulutės;7559243300;Taip;7;7;0;14
11621;Viltenė;Saulutės;8512665706;Taip;7;0;0;7
11622;Viltenė;Saulutės;3560474943;Taip;0;3;0;3
11623;Viltenė;Saulutės;2840208662;Taip;2;1;0;3
11624;Viltenė;Saulutės;1252657362;Taip;0;1;0;1
11625;Viltenė;Saulutės;2559945034;Taip;0;8;0;8
11626;Viltenė;Saulutės;2546789906;Taip;13;1;0;14
11627;Viltenė;Saulutės;9055821628;Taip;0;7;1;8
11628;Viltenė;Saulutės;9858998005;Taip;4;8;0;12
11629;Viltenė;Saulutės;7726650894;Taip;0;7;0;7
11630;Viltenė;Saulutės;3709362712;Taip;2;1;0;3
11631;Viltenė;Saulutės;1841732416;Taip;8;0;0;8
11632;Viltenė;Saulutės;3008272979;Taip;0;8;0;8
11633;Viltenė;Lapiukų;2016636764;Taip;0;6;0;6
11634;Viltenė;Lapiukų;1650304982;Taip;0;2;0;2
11635;Viltenė;Lapiukų;89844531860;Taip;0;2;0;2
11636;Viltenė;Lapiukų;1884043126;Taip;0;3;0;3
11637;Viltenė;Lapiukų;60092202534;Taip;0;10;0;10
11638;Viltenė;Lapiukų;22318027000;Taip;0;1;0;1
11639;Viltenė;Lapiukų;1559623914;Taip;0;7;0;7
11640;Viltenė;Lapiukų;1503728117;Taip;0;22;0;22
11641;Viltenė;Lapiukų;1042196397;Taip;5;1;0;6
11642;Viltenė;Lapiukų;1210824560;Taip;0;5;0;5
11643;Viltenė;Lapiukų;87698700338;Taip;0;3;0;3
11644;Viltenė;Lapiukų;3526237179;Taip;0;3;0;3
11645;Viltenė;Lapiukų;1662950901;Taip;3;2;0;5
11646;Viltenė;Lapiukų;1350487577;Taip;10;0;0;10
11647;Viltenė;Lapiukų;1592077335;Taip;12;2;0;14
11648;Viltenė;Lapiukų;1281808784;Ne;8;7;0;15
11649;Viltenė;Lapiukų;1726174128;Taip;5;4;0;9
11650;Viltenė;Lapiukų;2527648089;Taip;0;2;0;2
11651;Viltenė;Lapiukų;93894985640;Ne;0;3;0;3
11652;Viltenė;Lapiukų;3259114583;Taip;5;15;0;20
11653;Viltenė;Voveriukai;8732323660;Taip;0;7;0;7
11654;Viltenė;Voveriukai;13795858727;Ne;0;2;0;2
11655;Viltenė;Voveriukai;1306624353;Taip;0;2;0;2
11656;Viltenė;Voveriukai;41763338811;Taip;0;7;0;7
11657;Viltenė;Voveriukai;69110885244;Taip;0;9;0;9
11658;Viltenė;Voveriukai;46757944454;Ne;0;1;0;1
11659;Viltenė;Voveriukai;69918162258;Taip;0;2;0;2
11660;Viltenė;Voveriukai;76569470768;Taip;0;1;0;1
11661;Viltenė;Voveriukai;7245395388;Ne;7;5;0;12
11662;Viltenė;Voveriukai;92175043385;Taip;0;1;0;1
11663;Viltenė;Voveriukai;35466181637;Ne;0;1;0;1
11664;Viltenė;Voveriukai;54346881662;Taip;0;1;0;1
11665;Viltenė;Voveriukai;68243828276;Taip;0;2;0;2
11666;Viltenė;Voveriukai;1615151982;Taip;0;2;0;2
11667;Viltenė;Voveriukai;87296434240;Taip;0;1;0;1
11668;Viltenė;Voveriukai;51997485918;Ne;0;13;0;13
11669;Viltenė;Voveriukai;1872042290;Taip;0;8;0;8
11670;Viltenė;Voveriukai;1926586646;Ne;0;2;0;2
11671;Viltenė;Voveriukai;2008408325;Ne;0;11;0;11
11672;Viltenė;Voveriukai;4441280059;Taip;0;6;0;6
11673;Viltenė;Triušikai;3245284852;Taip;3;0;0;3
11674;Viltenė;Triušikai;9756519374;Taip;0;9;0;9
11675;Viltenė;Triušikai;9820462941;Taip;0;7;0;7
11676;Viltenė;Triušikai;7928894276;Taip;5;0;0;5
11677;Viltenė;Triušikai;2026654467;Taip;0;17;0;17
11678;Viltenė;Triušikai;4195708756;Taip;0;0;1;1
11679;Viltenė;Triušikai;5522245968;Taip;0;5;0;5
11680;Viltenė;Triušikai;8439859449;Taip;13;0;0;13
11681;Viltenė;Triušikai;7277455268;Taip;0;7;0;7
11682;Viltenė;Triušikai;7401460248;Taip;7;0;1;8
11683;Viltenė;Kiškučiai;6040634853;Taip;5;4;0;9
11684;Viltenė;Kiškučiai;9101795131;Taip;0;1;0;1
11685;Viltenė;Kiškučiai;6296509460;Taip;9;1;0;10
11686;Viltenė;Kiškučiai;2702489251;Taip;0;1;0;1
11687;Viltenė;Kiškučiai;6810811656;Taip;0;4;0;4
11688;Viltenė;Kiškučiai;2013415571;Taip;0;7;0;7
11689;Viltenė;Kiškučiai;8679787688;Taip;0;2;0;2
11690;Viltenė;Kiškučiai;3908574248;Taip;0;1;0;1
11691;Viltenė;Kiškučiai;9228677568;Taip;5;3;0;8
11692;Viltenė;Kiškučiai;8477241365;Taip;0;10;0;10
11693;Viltenė;Kiškučiai;8840885039;Taip;9;1;0;10
11694;Viltenė;Kiškučiai;4616047113;Taip;3;2;0;5
11695;Viltenė;Kiškučiai;2642080849;Taip;4;1;0;5
11696;Viltenė;Kiškučiai;3031790547;Taip;5;8;0;13
11697;Viltenė;Nykštukų;2036902795;Taip;7;0;0;7
11698;Viltenė;Nykštukų;9476132305;Taip;7;0;2;9
11699;Viltenė;Nykštukų;5194925689;Ne;5;0;2;7
11700;Viltenė;Nykštukų;1507287948;Taip;8;0;0;8
11701;Viltenė;Nykštukų;4121448859;Taip;2;0;2;4
11702;Viltenė;Nykštukų;5599943846;Taip;6;0;0;6
11703;Viltenė;Nykštukų;6721689684;Taip;7;0;0;7
11704;Viltenė;Nykštukų;5552217000;Taip;3;2;0;5
11705;Viltenė;Nykštukų;4243501722;Taip;0;0;3;3
11706;Viltenė;Nykštukų;3905014810;Ne;0;8;0;8
11707;Viltenė;Nykštukų;9157616307;Taip;5;0;0;5
11708;Viltenė;Nykštukų;3052677157;Taip;0;0;2;2
11709;Voveraitė;ŽVIRBLIUKŲ;6690309946;Taip;0;1;1;2
11710;Voveraitė;ŽVIRBLIUKŲ;9491132884;Taip;6;0;0;6
11711;Voveraitė;ŽVIRBLIUKŲ;8119493388;Taip;3;0;0;3
11712;Voveraitė;ŽVIRBLIUKŲ;9715405072;Taip;0;1;0;1
11713;Voveraitė;ŽVIRBLIUKŲ;5804351872;Taip;0;0;2;2
11714;Voveraitė;ŽVIRBLIUKŲ;5510544648;Taip;6;0;0;6
11715;Voveraitė;ŽVIRBLIUKŲ;3582805599;Taip;9;0;0;9
11716;Voveraitė;ŽVIRBLIUKŲ;5705303891;Ne;0;7;0;7
11717;Voveraitė;ŽVIRBLIUKŲ;6959751328;Taip;8;0;2;10
11718;Voveraitė;ŽVIRBLIUKŲ;8803052781;Taip;0;3;0;3
11719;Voveraitė;ŽVIRBLIUKŲ;8257748589;Taip;11;0;2;13
11720;Voveraitė;ŽVIRBLIUKŲ;1522307865;Taip;1;0;0;1
11721;Voveraitė;ŽVIRBLIUKŲ;3258155215;Taip;11;1;0;12
11722;Voveraitė;ŽVIRBLIUKŲ;6855501432;Taip;3;0;0;3
11723;Voveraitė;VOVERIUKŲ;1515087924;Taip;3;3;0;6
11724;Voveraitė;VOVERIUKŲ;9195700962;Taip;16;3;0;19
11725;Voveraitė;VOVERIUKŲ;4324619869;Taip;3;8;0;11
11726;Voveraitė;VOVERIUKŲ;5138855000;Taip;1;2;0;3
11727;Voveraitė;VOVERIUKŲ;1340379090;Taip;4;4;0;8
11728;Voveraitė;VOVERIUKŲ;9912862474;Taip;4;6;0;10
11729;Voveraitė;VOVERIUKŲ;1960385335;Ne;12;3;0;15
11730;Voveraitė;VOVERIUKŲ;2594535017;Taip;3;5;0;8
11731;Voveraitė;VOVERIUKŲ;7746424196;Taip;0;1;0;1
11732;Voveraitė;VOVERIUKŲ;4563198733;Taip;6;9;0;15
11733;Voveraitė;VOVERIUKŲ;8373093305;Ne;13;1;0;14
11734;Voveraitė;VOVERIUKŲ;2322594823;Taip;10;6;0;16
11735;Voveraitė;VOVERIUKŲ;2662384275;Taip;10;5;0;15
11736;Voveraitė;VOVERIUKŲ;9514425475;Taip;0;3;0;3
11737;Voveraitė;VOVERIUKŲ;6017698476;Taip;0;1;0;1
11738;Voveraitė;VOVERIUKŲ;8580034134;Taip;10;3;0;13
11739;Voveraitė;VOVERIUKŲ;6891841301;Taip;0;3;0;3
11740;Voveraitė;VOVERIUKŲ;2627555750;Taip;17;2;0;19
11741;Voveraitė;VOVERIUKŲ;5935777154;Taip;6;1;0;7
11742;Voveraitė;KIŠKUČIŲ;3615729576;Ne;7;4;0;11
11743;Voveraitė;KIŠKUČIŲ;9231751171;Taip;2;2;0;4
11744;Voveraitė;KIŠKUČIŲ;4338861332;Taip;2;1;0;3
11745;Voveraitė;KIŠKUČIŲ;9933037872;Taip;6;3;0;9
11746;Voveraitė;KIŠKUČIŲ;3113780055;Taip;7;0;0;7
11747;Voveraitė;KIŠKUČIŲ;65926130735;Taip;4;0;0;4
11748;Voveraitė;KIŠKUČIŲ;7069780513;Taip;5;4;0;9
11749;Voveraitė;KIŠKUČIŲ;9997346812;Taip;22;0;0;22
11750;Voveraitė;KIŠKUČIŲ;9703726869;Taip;9;1;0;10
11751;Voveraitė;KIŠKUČIŲ;7314148938;Taip;10;1;0;11
11752;Voveraitė;KIŠKUČIŲ;4511771924;Taip;10;1;0;11
11753;Voveraitė;KIŠKUČIŲ;9007031372;Taip;7;1;0;8
11754;Voveraitė;KIŠKUČIŲ;6369860178;Taip;3;1;0;4
11755;Voveraitė;KIŠKUČIŲ;6649068571;Taip;0;2;0;2
11756;Voveraitė;KIŠKUČIŲ;1775800865;Taip;2;7;0;9
11757;Voveraitė;KIŠKUČIŲ;6433760749;Ne;0;1;0;1
11758;Voveraitė;KIŠKUČIŲ;54408671673;Taip;14;3;0;17
11759;Voveraitė;KIŠKUČIŲ;72154318379;Taip;14;3;0;17
11760;Voveraitė;KIŠKUČIŲ;1959958256;Ne;1;3;0;4
11761;Voveraitė;KIŠKUČIŲ;2693544600;Taip;0;1;0;1
11762;Voveraitė;KODĖLČIUKŲ;3469734853;Taip;5;0;0;5
11763;Voveraitė;KODĖLČIUKŲ;5467979968;Taip;0;10;0;10
11764;Voveraitė;KODĖLČIUKŲ;1772758517;Ne;7;0;0;7
11765;Voveraitė;KODĖLČIUKŲ;4045121781;Taip;7;1;0;8
11766;Voveraitė;KODĖLČIUKŲ;2304004487;Taip;0;0;3;3
11767;Voveraitė;KODĖLČIUKŲ;5296850349;Taip;0;5;0;5
11768;Voveraitė;KODĖLČIUKŲ;2763656717;Taip;5;12;0;17
11769;Voveraitė;KODĖLČIUKŲ;4468214107;Taip;0;22;0;22
11770;Voveraitė;KODĖLČIUKŲ;9921313716;Taip;0;0;5;5
11771;Voveraitė;KODĖLČIUKŲ;5449490074;Ne;5;2;3;10
11772;Voveraitė;KODĖLČIUKŲ;7786378018;Ne;5;0;1;6
11773;Voveraitė;MEŠKIUKŲ;4079618555;Taip;0;6;0;6
11774;Voveraitė;MEŠKIUKŲ;3987058753;Taip;0;6;0;6
11775;Voveraitė;MEŠKIUKŲ;3381417855;Taip;0;3;0;3
11776;Voveraitė;MEŠKIUKŲ;3703062195;Taip;7;2;0;9
11777;Voveraitė;MEŠKIUKŲ;8438876806;Taip;3;1;0;4
11778;Voveraitė;MEŠKIUKŲ;1058273156;Taip;0;2;0;2
11779;Voveraitė;MEŠKIUKŲ;9149748841;Taip;3;2;0;5
11780;Voveraitė;MEŠKIUKŲ;5576058454;Taip;12;0;0;12
11781;Voveraitė;MEŠKIUKŲ;1629942114;Taip;0;3;0;3
11782;Voveraitė;MEŠKIUKŲ;6359983706;Taip;10;4;0;14
11783;Voveraitė;MEŠKIUKŲ;17534618616;Taip;4;2;0;6
11784;Voveraitė;MEŠKIUKŲ;1592633500;Taip;5;11;0;16
11785;Voveraitė;MEŠKIUKŲ;5437283673;Taip;3;1;0;4
11786;Voveraitė;MEŠKIUKŲ;7797966139;Taip;0;9;0;9
11787;Voveraitė;MEŠKIUKŲ;3029983180;Taip;0;11;0;11
11788;Voveraitė;MEŠKIUKŲ;9900940313;Taip;5;3;0;8
11789;Voveraitė;MEŠKIUKŲ;4680264973;Ne;0;9;0;9
11790;Voveraitė;MEŠKIUKŲ;5095849577;Taip;16;0;0;16
11791;Voveraitė;MEŠKIUKŲ;6886337758;Taip;0;17;0;17
11792;Voveraitė;MEŠKIUKŲ;6994680282;Taip;3;0;0;3
11793;Voveraitė;BORUŽĖLIŲ;49205285378;Taip;0;2;1;3
11794;Voveraitė;BORUŽĖLIŲ;1587569563;Taip;0;0;1;1
11795;Voveraitė;BORUŽĖLIŲ;89216481616;Taip;0;0;1;1
11796;Voveraitė;BORUŽĖLIŲ;46318035221;Taip;7;0;0;7
11797;Voveraitė;BORUŽĖLIŲ;26080915874;Taip;0;0;4;4
11798;Voveraitė;BORUŽĖLIŲ;3818120898;Taip;0;4;0;4
11799;Voveraitė;BORUŽĖLIŲ;64724933885;Taip;0;1;2;3
11800;Voveraitė;BORUŽĖLIŲ;69797506996;Ne;8;0;0;8
11801;Voveraitė;BORUŽĖLIŲ;57033218205;Taip;6;0;0;6
11802;Voveraitė;BORUŽĖLIŲ;89873985894;Taip;5;0;0;5
11803;Voveraitė;BORUŽĖLIŲ;61376515242;Taip;0;0;1;1
11804;Voveraitė;BORUŽĖLIŲ;47111956594;Taip;5;0;0;5
11805;Voveraitė;BORUŽĖLIŲ;53801893219;Ne;0;6;0;6
11806;Voveraitė;BORUŽĖLIŲ;59442802443;Taip;0;1;0;1
11807;Voveraitė;BORUŽĖLIŲ;1398043988;Taip;0;0;6;6
11808;Voveraitė;BORUŽĖLIŲ;22913200509;Taip;3;0;0;3
11809;Voveraitė;PELĖDŽIUKŲ;1689261748;Taip;0;1;1;2
11810;Voveraitė;PELĖDŽIUKŲ;5944299310;Taip;0;0;1;1
11811;Voveraitė;PELĖDŽIUKŲ;4266535840;Taip;13;0;0;13
11812;Voveraitė;PELĖDŽIUKŲ;76432985710;Taip;0;0;2;2
11813;Voveraitė;PELĖDŽIUKŲ;30591405375;Taip;8;9;0;17
11814;Voveraitė;PELĖDŽIUKŲ;42683378356;Taip;6;0;1;7
11815;Voveraitė;PELĖDŽIUKŲ;46665609670;Taip;0;8;1;9
11816;Voveraitė;PELĖDŽIUKŲ;5354784149;Taip;0;0;5;5
11817;Voveraitė;PELĖDŽIUKŲ;3292830298;Ne;0;0;9;9
11818;Voveraitė;PELĖDŽIUKŲ;86045196465;Taip;0;0;2;2
11819;Voveraitė;PELĖDŽIUKŲ;3756080192;Taip;0;0;4;4
11820;Voveraitė;PELĖDŽIUKŲ;1018558040;Taip;5;1;0;6
11821;Voveraitė;PELĖDŽIUKŲ;5804909515;Taip;0;0;4;4
11822;Voveraitė;DRUGELIŲ;9623406874;Taip;7;5;0;12
11823;Voveraitė;DRUGELIŲ;1753442884;Taip;9;7;1;17
11824;Voveraitė;DRUGELIŲ;63032690186;Taip;0;4;0;4
11825;Voveraitė;DRUGELIŲ;7974406524;Taip;0;9;0;9
11826;Voveraitė;DRUGELIŲ;1032086466;Taip;0;7;0;7
11827;Voveraitė;DRUGELIŲ;8538259157;Taip;0;1;0;1
11828;Voveraitė;DRUGELIŲ;2044914624;Taip;2;11;3;16
11829;Voveraitė;DRUGELIŲ;5037713667;Taip;1;4;0;5
11830;Voveraitė;DRUGELIŲ;2031078156;Taip;8;6;0;14
11831;Voveraitė;DRUGELIŲ;80330740714;Taip;7;3;0;10
11832;Voveraitė;DRUGELIŲ;6729475469;Taip;2;4;0;6
11833;Voveraitė;DRUGELIŲ;1397274691;Ne;0;15;0;15
11834;Voveraitė;DRUGELIŲ;1612322367;Taip;5;9;0;14
11835;Voveraitė;DRUGELIŲ;6847620019;Taip;0;5;0;5
11836;Voveraitė;DRUGELIŲ;53507758884;Taip;4;6;0;10
11837;Voveraitė;DRUGELIŲ;1780573926;Taip;7;2;0;9
11838;Voveraitė;NYKŠTUKŲ;59346262217;Ne;0;8;0;8
11839;Voveraitė;NYKŠTUKŲ;44115826781;Taip;0;3;0;3
11840;Voveraitė;NYKŠTUKŲ;67851579200;Taip;0;1;0;1
11841;Voveraitė;NYKŠTUKŲ;2902148527;Taip;0;1;0;1
11842;Voveraitė;NYKŠTUKŲ;1704834744;Taip;0;1;0;1
11843;Voveraitė;NYKŠTUKŲ;35549553867;Taip;0;2;0;2
11844;Voveraitė;NYKŠTUKŲ;49924157014;Taip;0;5;0;5
11845;Voveraitė;NYKŠTUKŲ;41182124889;Taip;0;3;0;3
11846;Voveraitė;NYKŠTUKŲ;13173711840;Taip;0;5;0;5
11847;Voveraitė;NYKŠTUKŲ;602726070;Taip;0;4;0;4
11848;Voveraitė;NYKŠTUKŲ;27132982320;Taip;0;1;0;1
11849;Voveraitė;NYKŠTUKŲ;2762066479;Ne;0;1;0;1
11850;Voveraitė;NYKŠTUKŲ;66612277823;Taip;0;4;0;4
11851;Voveraitė;NYKŠTUKŲ;82642244788;Taip;0;1;0;1
11852;Voveraitė;NYKŠTUKŲ;1022447432;Taip;5;12;0;17
11853;Voveraitė;NYKŠTUKŲ;2051732666;Taip;0;10;0;10
11854;Voveraitė;NYKŠTUKŲ;6460834118;Taip;15;4;0;19
11855;Voveraitė;NYKŠTUKŲ;4163635632;Taip;0;4;0;4
11856;Voveraitė;GENIUKŲ;6903776113;Taip;5;0;0;5
11857;Voveraitė;GENIUKŲ;63276868064;Taip;0;0;2;2
11858;Voveraitė;GENIUKŲ;3137529068;Taip;0;6;5;11
11859;Voveraitė;GENIUKŲ;12366200545;Taip;0;0;2;2
11860;Voveraitė;GENIUKŲ;90970378921;Taip;5;0;0;5
11861;Voveraitė;GENIUKŲ;15716865051;Ne;0;0;2;2
11862;Voveraitė;GENIUKŲ;30515775412;Taip;0;0;2;2
11863;Voveraitė;GENIUKŲ;14865004407;Taip;0;0;1;1
11864;Voveraitė;GENIUKŲ;37044398892;Taip;5;0;1;6
11865;Voveraitė;GENIUKŲ;65838266846;Taip;4;0;0;4
11866;Voveraitė;GENIUKŲ;39956224681;Taip;15;0;2;17
11867;Voveraitė;GENIUKŲ;1055423524;Taip;0;0;4;4
11868;Voveraitė;GENIUKŲ;1261834247;Taip;5;0;2;7
11869;Voveraitė;LAPIUKŲ;1141304286;Ne;4;0;10;14
11870;Voveraitė;LAPIUKŲ;1550830434;Taip;0;0;8;8
11871;Voveraitė;LAPIUKŲ;1510853268;Taip;0;0;5;5
11872;Voveraitė;LAPIUKŲ;3388547792;Taip;10;0;0;10
11873;Voveraitė;LAPIUKŲ;8344323109;Taip;0;0;10;10
11874;Voveraitė;LAPIUKŲ;7099272964;Taip;0;0;6;6
11875;Voveraitė;LAPIUKŲ;7008576999;Taip;0;0;2;2
11876;Voveraitė;LAPIUKŲ;4300235743;Taip;10;0;4;14
11877;Voveraitė;LAPIUKŲ;1441921029;Taip;5;0;0;5
11878;Voveraitė;LAPIUKŲ;2450726148;Taip;0;8;2;10
11879;Voveraitė;LAPIUKŲ;7531020548;Taip;10;4;0;14
11880;Voveraitė;LAPIUKŲ;6073270223;Taip;3;0;2;5
11881;Voveraitė;EŽIUKŲ;1614180834;Taip;11;0;0;11
11882;Voveraitė;EŽIUKŲ;6572172779;Taip;0;3;0;3
11883;Voveraitė;EŽIUKŲ;8084986328;Taip;0;5;0;5
11884;Voveraitė;EŽIUKŲ;8507818993;Taip;3;2;0;5
11885;Voveraitė;EŽIUKŲ;3736638759;Taip;0;6;0;6
11886;Voveraitė;EŽIUKŲ;6261152304;Taip;10;2;0;12
11887;Voveraitė;EŽIUKŲ;4060906360;Taip;5;7;0;12
11888;Voveraitė;EŽIUKŲ;9537862791;Taip;10;0;0;10
11889;Voveraitė;EŽIUKŲ;9011096222;Taip;3;5;0;8
11890;Voveraitė;EŽIUKŲ;4478984171;Taip;5;6;0;11
11891;Voveraitė;EŽIUKŲ;3058377539;Taip;3;7;0;10
11892;Voveraitė;EŽIUKŲ;6007396459;Taip;5;1;0;6
11893;Voveraitė;EŽIUKŲ;5114768009;Taip;5;0;0;5
11894;"Trakų Vokė";Voveriukų;2906508821;Ne;10;0;0;10
11895;"Trakų Vokė";Voveriukų;2389794233;Taip;6;0;0;6
11896;"Trakų Vokė";Voveriukų;9233090228;Taip;1;0;3;4
11897;"Trakų Vokė";Voveriukų;2880299812;Taip;0;0;2;2
11898;"Trakų Vokė";Voveriukų;4854440884;Taip;22;0;0;22
11899;"Trakų Vokė";Voveriukų;2761614687;Taip;22;0;0;22
11900;"Trakų Vokė";Voveriukų;2539647111;Taip;4;0;1;5
11901;"Trakų Vokė";Voveriukų;1360046096;Taip;10;0;0;10
11902;"Trakų Vokė";Voveriukų;1324720234;Taip;0;0;2;2
11903;"Trakų Vokė";Voveriukų;2869217654;Taip;2;0;2;4
11904;"Trakų Vokė";Voveriukų;6277305384;Taip;0;7;0;7
11905;"Trakų Vokė";Voveriukų;6369848950;Taip;11;0;1;12
11906;"Trakų Vokė";Voveriukų;6326568445;Taip;0;2;0;2
11907;"Trakų Vokė";Voveriukų;4040038648;Taip;10;1;0;11
11908;"Trakų Vokė";Voveriukų;7727246187;Taip;0;0;8;8
11909;"Trakų Vokė";Voveriukų;3611639112;Taip;0;0;3;3
11910;"Trakų Vokė";Voveriukų;5206616285;Taip;15;0;2;17
11911;"Trakų Vokė";Voveriukų;4535167417;Taip;5;10;0;15
11912;"Trakų Vokė";Boružėlių;6732422645;Taip;0;10;1;11
11913;"Trakų Vokė";Boružėlių;5338798362;Taip;13;0;0;13
11914;"Trakų Vokė";Boružėlių;3319243283;Taip;11;0;0;11
11915;"Trakų Vokė";Boružėlių;1039690987;Taip;5;0;0;5
11916;"Trakų Vokė";Boružėlių;2516219363;Taip;0;0;5;5
11917;"Trakų Vokė";Boružėlių;5909584565;Taip;0;0;3;3
11918;"Trakų Vokė";Boružėlių;6234943180;Taip;0;0;3;3
11919;"Trakų Vokė";Boružėlių;7858812338;Ne;0;0;3;3
11920;"Trakų Vokė";Boružėlių;3913623741;Taip;0;5;1;6
11921;"Trakų Vokė";Boružėlių;2730385281;Taip;6;0;1;7
11922;"Trakų Vokė";Boružėlių;1088928094;Taip;0;0;3;3
11923;"Trakų Vokė";Boružėlių;7318458282;Taip;10;2;1;13
11924;"Trakų Vokė";Boružėlių;6908913934;Ne;10;0;0;10
11925;"Trakų Vokė";Boružėlių;7909596435;Taip;3;0;0;3
11926;"Trakų Vokė";Boružėlių;5251929660;Taip;5;10;0;15
11927;"Trakų Vokė";Boružėlių;6751625456;Taip;0;0;1;1
11928;"Trakų Vokė";Boružėlių;7752786907;Taip;6;0;0;6
11929;"Trakų Vokė";Boružėlių;2475068032;Taip;0;0;1;1
11930;"Trakų Vokė";Boružėlių;4601374629;Ne;1;4;0;5
11931;"Trakų Vokė";Boružėlių;7660240598;Taip;9;7;0;16
11932;"Trakų Vokė";Boružėlių;2388817616;Taip;9;0;0;9
11933;"Trakų Vokė";BITUTUČIŲ;7792654474;Taip;10;0;0;10
11934;"Trakų Vokė";BITUTUČIŲ;1433982328;Taip;0;0;1;1
11935;"Trakų Vokė";BITUTUČIŲ;8542147751;Taip;7;0;0;7
11936;"Trakų Vokė";BITUTUČIŲ;1623166260;Taip;0;0;1;1
11937;"Trakų Vokė";BITUTUČIŲ;3406479364;Taip;5;0;1;6
11938;"Trakų Vokė";BITUTUČIŲ;95320712086;Taip;4;0;2;6
11939;"Trakų Vokė";BITUTUČIŲ;5526830430;Taip;5;0;1;6
11940;"Trakų Vokė";BITUTUČIŲ;1590598232;Taip;12;0;2;14
11941;"Trakų Vokė";BITUTUČIŲ;3373764541;Taip;0;4;0;4
11942;"Trakų Vokė";BITUTUČIŲ;4849992906;Taip;10;7;0;17
11943;"Trakų Vokė";BITUTUČIŲ;8857529726;Taip;0;0;7;7
11944;"Trakų Vokė";BITUTUČIŲ;7566567901;Taip;0;0;4;4
11945;"Trakų Vokė";BITUTUČIŲ;3098390989;Ne;5;0;2;7
11946;"Trakų Vokė";BITUTUČIŲ;8997890367;Taip;14;0;0;14
11947;"Trakų Vokė";BITUTUČIŲ;4903261568;Taip;12;0;0;12
11948;"Trakų Vokė";BITUTUČIŲ;39255784762;Taip;0;0;1;1
11949;"Trakų Vokė";KIŠKUČIŲ;15897808544;Taip;11;0;2;13
11950;"Trakų Vokė";KIŠKUČIŲ;88989814775;Taip;0;0;1;1
11951;"Trakų Vokė";KIŠKUČIŲ;6675993703;Taip;0;0;3;3
11952;"Trakų Vokė";KIŠKUČIŲ;87781186373;Taip;6;0;0;6
11953;"Trakų Vokė";KIŠKUČIŲ;69866048102;Taip;7;9;0;16
11954;"Trakų Vokė";KIŠKUČIŲ;64083541565;Taip;0;0;4;4
11955;"Trakų Vokė";KIŠKUČIŲ;67434532111;Taip;0;19;0;19
11956;"Trakų Vokė";KIŠKUČIŲ;26598573711;Taip;9;0;0;9
11957;"Trakų Vokė";KIŠKUČIŲ;69311478204;Taip;5;0;2;7
11958;"Trakų Vokė";KIŠKUČIŲ;71417288063;Taip;0;0;5;5
11959;"Trakų Vokė";KIŠKUČIŲ;44023296535;Taip;0;13;0;13
11960;"Trakų Vokė";KIŠKUČIŲ;6418198934;Taip;13;0;0;13
11961;"Trakų Vokė";KIŠKUČIŲ;50697040061;Taip;0;0;16;16
11962;"Trakų Vokė";KIŠKUČIŲ;9135918587;Taip;0;0;2;2
11963;"Trakų Vokė";KIŠKUČIŲ;18796898215;Taip;9;0;0;9
11964;"Trakų Vokė";KIŠKUČIŲ;86504089176;Taip;0;0;1;1
11965;"Trakų Vokė";KIŠKUČIŲ;3210453801;Taip;5;0;2;7
11966;"Trakų Vokė";KIŠKUČIŲ;9705561511;Taip;0;0;2;2
11967;"Trakų Vokė";KIŠKUČIŲ;40200309769;Taip;2;0;1;3
11968;"Trakų Vokė";KIŠKUČIŲ;5109850366;Taip;7;0;2;9
11969;"Trakų Vokė";KIŠKUČIŲ;85293469079;Taip;4;0;3;7
11970;Zylutė;Katerok;8749296671;Taip;0;1;0;1
11971;Zylutė;Katerok;1621772702;Taip;6;0;0;6
11972;Zylutė;Katerok;4592825972;Taip;5;5;0;10
11973;Zylutė;Katerok;8747721198;Taip;10;0;0;10
11974;Zylutė;Katerok;8212030518;Taip;0;2;0;2
11975;Zylutė;Katerok;7706833089;Taip;0;6;0;6
11976;Zylutė;Katerok;1353114929;Ne;0;1;0;1
11977;Zylutė;Katerok;3115223229;Taip;0;2;0;2
11978;Zylutė;Katerok;2968625045;Taip;0;1;0;1
11979;Zylutė;Katerok;8618778936;Taip;8;0;0;8
11980;Zylutė;Katerok;1897871944;Taip;7;0;0;7
11981;Zylutė;Katerok;5687201052;Taip;0;1;0;1
11982;Zylutė;Katerok;6221528830;Taip;14;0;0;14
11983;Zylutė;Katerok;3055559237;Taip;5;1;0;6
11984;Zylutė;Katerok;2792217953;Taip;0;1;0;1
11985;Zylutė;Katerok;5948147748;Taip;6;0;0;6
11986;Zylutė;Katerok;5264930854;Taip;10;0;0;10
11987;Zylutė;"Vesole misiaki";86301183281;Taip;6;0;0;6
11988;Zylutė;"Vesole misiaki";9262869284;Taip;0;4;0;4
11989;Zylutė;"Vesole misiaki";1256879956;Ne;0;12;0;12
11990;Zylutė;"Vesole misiaki";3126726854;Ne;11;8;0;19
11991;Zylutė;"Vesole misiaki";9484752315;Taip;0;10;0;10
11992;Zylutė;"Vesole misiaki";7140223126;Taip;9;0;0;9
11993;Zylutė;"Vesole misiaki";81796510706;Taip;12;0;0;12
11994;Zylutė;"Vesole misiaki";7606434084;Taip;7;1;0;8
11995;Zylutė;"Vesole misiaki";6299191475;Ne;5;4;0;9
11996;Zylutė;"Vesole misiaki";9953834483;Taip;3;0;0;3
11997;Zylutė;"Vesole misiaki";9664467134;Ne;7;1;0;8
11998;Zylutė;"Vesole misiaki";8336138549;Taip;5;1;0;6
11999;Zylutė;"Vesole misiaki";9457189905;Taip;0;5;0;5
12000;Zylutė;"Vesole misiaki";2445444641;Taip;0;11;0;11
12001;Zylutė;"Vesole misiaki";8638652914;Ne;3;0;0;3
12002;Zylutė;"Vesole misiaki";9908198854;Taip;0;1;0;1
12003;Zylutė;NYKŠTUKAI;19429820228;Taip;0;9;0;9
12004;Zylutė;NYKŠTUKAI;53165044678;Taip;0;3;0;3
12005;Zylutė;NYKŠTUKAI;42712894954;Taip;0;9;0;9
12006;Zylutė;NYKŠTUKAI;87231809477;Taip;4;2;0;6
12007;Zylutė;NYKŠTUKAI;1584743051;Ne;2;1;0;3
12008;Zylutė;NYKŠTUKAI;1187261223;Taip;0;5;0;5
12009;Zylutė;NYKŠTUKAI;2276463136;Taip;10;0;0;10
12010;Zylutė;NYKŠTUKAI;7042731356;Taip;0;4;0;4
12011;Zylutė;NYKŠTUKAI;35300054087;Taip;0;1;0;1
12012;Zylutė;NYKŠTUKAI;15110117571;Taip;0;3;0;3
12013;Zylutė;NYKŠTUKAI;1699222615;Taip;0;2;0;2
12014;Zylutė;NYKŠTUKAI;3246229837;Taip;5;10;0;15
12015;Zylutė;NYKŠTUKAI;6324036463;Taip;4;1;0;5
12016;Zylutė;NYKŠTUKAI;4394023057;Taip;7;0;0;7
12017;Zylutė;NYKŠTUKAI;2153133102;Taip;5;2;0;7
12018;Zylutė;NYKŠTUKAI;2910542367;Taip;0;4;0;4
12019;Zylutė;NYKŠTUKAI;8141884164;Taip;0;0;9;9
12020;Zylutė;Ručijok;6112586092;Taip;0;3;0;3
12021;Zylutė;Ručijok;5045652581;Taip;0;5;0;5
12022;Zylutė;Ručijok;3547185618;Taip;0;2;0;2
12023;Zylutė;Ručijok;9913001904;Taip;0;5;0;5
12024;Zylutė;Ručijok;3608920051;Taip;0;2;0;2
12025;Zylutė;Ručijok;7241045507;Taip;13;0;0;13
12026;Zylutė;Ručijok;9381656201;Taip;0;1;0;1
12027;Zylutė;Ručijok;2654373943;Taip;9;1;0;10
12028;Zylutė;Ručijok;4497904128;Taip;0;10;0;10
12029;Zylutė;Ručijok;9586800176;Taip;6;1;0;7
12030;Zylutė;Ručijok;3355159275;Taip;6;0;0;6
12031;Zylutė;Ručijok;9995791665;Taip;0;0;1;1
12032;Zylutė;Ručijok;4916625058;Taip;0;0;3;3
12033;Zylutė;Ručijok;8178488164;Taip;8;0;0;8
12034;Zylutė;Ručijok;6848387941;Ne;3;0;0;3
12035;Zylutė;Ručijok;9848197658;Taip;0;0;1;1
12036;Zylutė;Raduga;9325387975;Taip;0;7;0;7
12037;Zylutė;Raduga;3363212754;Taip;5;1;0;6
12038;Zylutė;Raduga;6569135467;Taip;7;3;0;10
12039;Zylutė;Raduga;3117948118;Taip;2;4;0;6
12040;Zylutė;Raduga;2654794460;Taip;0;0;1;1
12041;Zylutė;Raduga;1423890598;Taip;21;0;0;21
12042;Zylutė;Raduga;3826815202;Taip;3;0;0;3
12043;Zylutė;Raduga;3943002728;Taip;5;7;0;12
12044;Zylutė;Raduga;4043810535;Taip;4;4;0;8
12045;Zylutė;Raduga;2107123106;Ne;10;0;0;10
12046;Zylutė;Raduga;7482740111;Taip;5;0;0;5
12047;Zylutė;Raduga;2559643556;Taip;10;0;1;11
12048;Zylutė;Raduga;7824348276;Ne;0;1;0;1
12049;Zylutė;Raduga;4811667497;Ne;17;0;0;17
12050;Zylutė;Raduga;5683151005;Taip;0;0;3;3
12051;Zylutė;Raduga;2681013154;Taip;5;5;0;10
12052;Zylutė;Raduga;6833030749;Taip;15;2;0;17
12053;Zylutė;"Miki Maus";5670953383;Taip;0;0;1;1
12054;Zylutė;"Miki Maus";5027134228;Taip;0;11;0;11
12055;Zylutė;"Miki Maus";4715704693;Taip;5;6;0;11
12056;Zylutė;"Miki Maus";4543822765;Taip;11;2;0;13
12057;Zylutė;"Miki Maus";4566817285;Ne;4;0;1;5
12058;Zylutė;"Miki Maus";2092319455;Taip;7;9;0;16
12059;Zylutė;"Miki Maus";9457457032;Taip;14;0;0;14
12060;Zylutė;"Miki Maus";1290248125;Ne;7;0;0;7
12061;Zylutė;"Miki Maus";3633983359;Taip;10;0;0;10
12062;Zylutė;"Miki Maus";6833822248;Taip;10;0;0;10
12063;Zylutė;"Miki Maus";9162232979;Taip;10;0;0;10
12064;Zylutė;Solnyško;52293061924;Taip;0;6;0;6
12065;Zylutė;Solnyško;2020113161;Taip;0;1;0;1
12066;Zylutė;Solnyško;53283282669;Taip;7;3;0;10
12067;Zylutė;Solnyško;98295398362;Taip;0;1;0;1
12068;Zylutė;Solnyško;63287117036;Ne;0;8;0;8
12069;Zylutė;Solnyško;8582483538;Taip;0;1;0;1
12070;Zylutė;Solnyško;1979823314;Taip;0;9;0;9
12071;Zylutė;Solnyško;36486637873;Ne;0;10;0;10
12072;Zylutė;Solnyško;91938227358;Ne;11;2;0;13
12073;Zylutė;Solnyško;55672880453;Ne;0;3;0;3
12074;Zylutė;Solnyško;63798640792;Taip;3;7;0;10
12075;Zylutė;Solnyško;1059365398;Taip;5;0;0;5
12076;Zylutė;Motyliok;45252076215;Ne;17;0;0;17
12077;Zylutė;Motyliok;45779928616;Taip;0;12;0;12
12078;Zylutė;Motyliok;1001570452;Taip;0;1;0;1
12079;Zylutė;Motyliok;1445891751;Taip;8;0;0;8
12080;Zylutė;Motyliok;1873200936;Taip;2;0;0;2
12081;Zylutė;Motyliok;8546942240;Taip;3;0;0;3
12082;Zylutė;Motyliok;7298260831;Taip;0;7;0;7
12083;Zylutė;Motyliok;2306517891;Taip;0;6;0;6
12084;Zylutė;Motyliok;23826981323;Taip;0;1;0;1
12085;Zylutė;Motyliok;1145364380;Taip;0;1;0;1
12086;Zylutė;Motyliok;7712651566;Ne;0;1;0;1
12087;Zylutė;Motyliok;42101273435;Taip;6;0;0;6
12088;Zylutė;Motyliok;35364823312;Taip;0;5;0;5
12089;Zylutė;ŽVIRBLIUKAI;20569748356;Ne;0;1;7;8
12090;Zylutė;ŽVIRBLIUKAI;8783866036;Taip;7;6;0;13
12091;Zylutė;ŽVIRBLIUKAI;2274290871;Taip;0;12;0;12
12092;Zylutė;ŽVIRBLIUKAI;9902286013;Taip;0;0;1;1
12093;Zylutė;ŽVIRBLIUKAI;4154010905;Taip;3;0;0;3
12094;Zylutė;ŽVIRBLIUKAI;8018865138;Ne;0;4;0;4
12095;Zylutė;ŽVIRBLIUKAI;6865973084;Ne;0;1;3;4
12096;Zylutė;ŽVIRBLIUKAI;2744516236;Taip;0;1;0;1
12097;Zylutė;ŽVIRBLIUKAI;5174329244;Taip;4;0;0;4
12098;Zylutė;ŽVIRBLIUKAI;1939618217;Taip;3;1;10;14
12099;Zylutė;ŽVIRBLIUKAI;8627523283;Taip;0;5;0;5
12100;Zylutė;ŽVIRBLIUKAI;3606566852;Taip;0;2;0;2
12101;Zylutė;ŽVIRBLIUKAI;8874692591;Taip;0;1;0;1
12102;Zylutė;ŽVIRBLIUKAI;5431521522;Taip;4;0;0;4
12103;Zylutė;"DRUŽNYJE REBIATA";1428614163;Taip;0;10;0;10
12104;Zylutė;"DRUŽNYJE REBIATA";1674095701;Taip;10;5;0;15
12105;Zylutė;"DRUŽNYJE REBIATA";3379725202;Taip;0;1;3;4
12106;Zylutė;"DRUŽNYJE REBIATA";67435726524;Taip;0;0;3;3
12107;Zylutė;"DRUŽNYJE REBIATA";3843999609;Taip;8;0;0;8
12108;Zylutė;"DRUŽNYJE REBIATA";3036582121;Ne;17;1;0;18
12109;Zylutė;"DRUŽNYJE REBIATA";9163527400;Ne;0;1;0;1
12110;Zylutė;"DRUŽNYJE REBIATA";8293541980;Taip;3;0;0;3
12111;Zylutė;"DRUŽNYJE REBIATA";5452659798;Taip;0;9;0;9
12112;Zylutė;"DRUŽNYJE REBIATA";9589810356;Taip;9;0;0;9
12113;Zylutė;"DRUŽNYJE REBIATA";5224781417;Ne;0;8;0;8
12114;Zylutė;"DRUŽNYJE REBIATA";5162635301;Taip;10;12;0;22
12115;Zylutė;"DRUŽNYJE REBIATA";7023565057;Taip;17;1;0;18
12116;Zylutė;"DRUŽNYJE REBIATA";5641148690;Taip;0;5;0;5
12117;Zylutė;"DRUŽNYJE REBIATA";5803032683;Taip;7;0;0;7
12118;Zylutė;"DRUŽNYJE REBIATA";3089235413;Taip;16;1;0;17
12119;Zylutė;VIEVERSĖLIAI;2125519672;Taip;0;1;0;1
12120;Zylutė;VIEVERSĖLIAI;5172154642;Taip;0;2;0;2
12121;Zylutė;VIEVERSĖLIAI;6907378757;Taip;7;0;0;7
12122;Zylutė;VIEVERSĖLIAI;3810636967;Taip;1;0;0;1
12123;Zylutė;VIEVERSĖLIAI;6154352500;Taip;0;3;0;3
12124;Zylutė;VIEVERSĖLIAI;4016518230;Taip;0;4;0;4
12125;Zylutė;VIEVERSĖLIAI;9660898505;Taip;0;14;0;14
12126;Zylutė;VIEVERSĖLIAI;57138305703;Ne;5;3;0;8
12127;Zylutė;VIEVERSĖLIAI;5544338521;Taip;2;1;0;3
12128;Zylutė;VIEVERSĖLIAI;4764295850;Taip;0;9;0;9
12129;Želmenėliai;Bitučių;3268310531;Taip;7;0;2;9
12130;Želmenėliai;Bitučių;5211426226;Taip;11;2;1;14
12131;Želmenėliai;Bitučių;6799702725;Ne;0;2;3;5
12132;Želmenėliai;Bitučių;8358780570;Taip;4;2;2;8
12133;Želmenėliai;Bitučių;9006406225;Taip;0;3;0;3
12134;Želmenėliai;Bitučių;7423900312;Taip;3;0;2;5
12135;Želmenėliai;Bitučių;2102401372;Taip;0;2;2;4
12136;Želmenėliai;Bitučių;4931835807;Taip;0;8;0;8
12137;Želmenėliai;Bitučių;5147895081;Taip;0;2;0;2
12138;Želmenėliai;Bitučių;6481952132;Taip;0;7;0;7
12139;Želmenėliai;Bitučių;9611741258;Taip;2;0;1;3
12140;Želmenėliai;Bitučių;1619143702;Taip;6;7;0;13
12141;Želmenėliai;Bitučių;2794274146;Taip;20;0;0;20
12142;Želmenėliai;Bitučių;9825545754;Ne;7;2;2;11
12143;Želmenėliai;Bitučių;5314438217;Taip;10;0;0;10
12144;Želmenėliai;Bitučių;4927030144;Taip;5;2;0;7
12145;Želmenėliai;Kačiukų;53611793303;Taip;5;1;0;6
12146;Želmenėliai;Kačiukų;25991128602;Ne;2;8;0;10
12147;Želmenėliai;Kačiukų;50204719384;Taip;0;14;0;14
12148;Želmenėliai;Kačiukų;75215159489;Taip;0;13;0;13
12149;Želmenėliai;Kačiukų;68168210430;Ne;6;3;0;9
12150;Želmenėliai;Kačiukų;52474082386;Taip;0;5;0;5
12151;Želmenėliai;Kačiukų;32945118976;Taip;0;2;3;5
12152;Želmenėliai;Kačiukų;72091418618;Taip;10;0;0;10
12153;Želmenėliai;Kačiukų;72029098066;Taip;3;0;0;3
12154;Želmenėliai;Kačiukų;80129197524;Ne;2;1;0;3
12155;Želmenėliai;Kačiukų;25744693727;Taip;0;3;0;3
12156;Želmenėliai;Kačiukų;41941728755;Taip;0;0;2;2
12157;Želmenėliai;Kačiukų;98487229210;Taip;3;1;0;4
12158;Želmenėliai;Kačiukų;39766114351;Taip;8;0;0;8
12159;Želmenėliai;Kačiukų;11316462529;Taip;0;0;4;4
12160;Želmenėliai;Kačiukų;1064518850;Taip;0;12;0;12
12161;Želmenėliai;Voveriukų;5696221669;Taip;0;2;1;3
12162;Želmenėliai;Voveriukų;1799477959;Taip;0;1;0;1
12163;Želmenėliai;Voveriukų;1868937175;Taip;7;0;0;7
12164;Želmenėliai;Voveriukų;3258904017;Taip;0;2;0;2
12165;Želmenėliai;Voveriukų;6783113916;Taip;0;3;0;3
12166;Želmenėliai;Voveriukų;2044063398;Taip;16;0;1;17
12167;Želmenėliai;Voveriukų;2005437403;Taip;0;2;0;2
12168;Želmenėliai;Voveriukų;1744939559;Taip;0;1;0;1
12169;Želmenėliai;Voveriukų;27187464726;Taip;10;0;0;10
12170;Želmenėliai;Voveriukų;1952686295;Taip;0;6;0;6
12171;Želmenėliai;Voveriukų;2836206893;Ne;0;0;1;1
12172;Želmenėliai;Voveriukų;1342094235;Ne;3;0;1;4
12173;Želmenėliai;Voveriukų;5214021520;Ne;3;0;1;4
12174;Želmenėliai;Voveriukų;3490705425;Ne;4;0;0;4
12175;Želmenėliai;Voveriukų;6478525575;Taip;9;0;0;9
12176;Želmenėliai;Voveriukų;2231634495;Taip;9;0;0;9
12177;Želmenėliai;Ežiukų;34055134038;Taip;0;2;0;2
12178;Želmenėliai;Ežiukų;63879513374;Ne;0;2;0;2
12179;Želmenėliai;Ežiukų;12336777368;Ne;3;1;0;4
12180;Želmenėliai;Ežiukų;65633625929;Taip;0;2;1;3
12181;Želmenėliai;Ežiukų;34529381726;Taip;0;9;0;9
12182;Želmenėliai;Ežiukų;22209426414;Taip;0;2;1;3
12183;Želmenėliai;Ežiukų;21636460884;Taip;0;3;0;3
12184;Želmenėliai;Ežiukų;90992236935;Taip;0;1;0;1
12185;Želmenėliai;Ežiukų;8394779853;Taip;0;2;0;2
12186;Želmenėliai;Ežiukų;1425695010;Taip;0;4;0;4
12187;Želmenėliai;Ežiukų;9234190447;Taip;0;2;0;2
12188;Želmenėliai;Ežiukų;10686783804;Ne;0;1;0;1
12189;Želmenėliai;Ežiukų;77946540922;Taip;10;1;0;11
12190;Želmenėliai;Ežiukų;8218755050;Taip;5;1;0;6
12191;Želmenėliai;Ežiukų;10990624964;Ne;0;0;2;2
12192;Želmenėliai;Peledžiukų;4206128805;Taip;6;3;0;9
12193;Želmenėliai;Peledžiukų;6816346946;Taip;13;3;0;16
12194;Želmenėliai;Peledžiukų;9359070885;Ne;0;7;0;7
12195;Želmenėliai;Peledžiukų;2727113833;Taip;5;1;0;6
12196;Želmenėliai;Peledžiukų;2428447892;Taip;0;4;0;4
12197;Želmenėliai;Peledžiukų;5787772212;Taip;0;8;0;8
12198;Želmenėliai;Peledžiukų;1239398642;Taip;0;4;0;4
12199;Želmenėliai;Peledžiukų;29112205705;Taip;17;0;0;17
12200;Želmenėliai;Peledžiukų;1248541555;Taip;0;3;0;3
12201;Želmenėliai;Peledžiukų;8995804360;Taip;0;6;0;6
12202;Želmenėliai;Peledžiukų;1522141057;Taip;11;0;2;13
12203;Želmenėliai;Peledžiukų;5616709457;Ne;0;8;5;13
12204;Želmenėliai;Peledžiukų;8300887366;Taip;0;8;0;8
12205;Želmenėliai;Peledžiukų;96660519820;Taip;3;3;0;6
12206;Želmenėliai;Peledžiukų;5842563754;Taip;0;6;0;6
12207;Želmenėliai;Peledžiukų;9375550172;Ne;6;4;0;10
12208;Želmenėliai;Peledžiukų;8478564831;Taip;5;3;0;8
12209;Želmenėliai;Peledžiukų;1941723687;Taip;18;2;0;20
12210;Želmenėliai;Peledžiukų;8590746750;Taip;11;0;0;11
12211;Želmenėliai;Drugelių;3417538909;Taip;0;6;0;6
12212;Želmenėliai;Drugelių;3295852546;Ne;16;0;0;16
12213;Želmenėliai;Drugelių;4739083871;Taip;10;0;0;10
12214;Želmenėliai;Drugelių;3379266015;Taip;0;4;0;4
12215;Želmenėliai;Drugelių;3737786832;Ne;0;11;0;11
12216;Želmenėliai;Drugelių;5633127620;Taip;7;2;0;9
12217;Želmenėliai;Drugelių;1984105453;Taip;11;0;0;11
12218;Želmenėliai;Drugelių;1920917916;Taip;8;1;0;9
12219;Želmenėliai;Drugelių;4652412483;Taip;0;11;0;11
12220;Želmenėliai;Drugelių;1652949383;Taip;0;1;0;1
12221;Želmenėliai;Drugelių;5046836398;Taip;10;0;0;10
12222;Želmenėliai;Drugelių;9237611484;Taip;16;0;0;16
12223;Želmenėliai;Drugelių;13558387807;Taip;6;1;0;7
12224;Želmenėliai;Drugelių;5143554665;Taip;9;0;0;9
12225;Želmenėliai;Drugelių;7585159351;Taip;0;8;0;8
12226;Želmenėliai;Drugelių;9207984505;Taip;4;2;0;6
12227;Želmenėliai;Drugelių;4634346755;Taip;0;0;4;4
12228;Želmenėliai;Drugelių;4916436238;Taip;0;7;0;7
12229;Želmenėliai;Drugelių;5558795651;Taip;11;2;0;13
12230;Želmenėliai;Voriukų;4264751761;Taip;6;2;0;8
12231;Želmenėliai;Voriukų;3184074698;Taip;1;2;0;3
12232;Želmenėliai;Voriukų;1614791794;Taip;4;0;0;4
12233;Želmenėliai;Voriukų;1203343580;Taip;0;5;0;5
12234;Želmenėliai;Voriukų;9351650342;Ne;7;12;0;19
12235;Želmenėliai;Voriukų;3014568232;Taip;7;3;0;10
12236;Želmenėliai;Voriukų;6916426436;Taip;0;1;0;1
12237;Želmenėliai;Voriukų;7940403585;Taip;0;7;0;7
12238;Želmenėliai;Voriukų;7563461821;Taip;22;0;0;22
12239;Želmenėliai;Voriukų;4534946646;Taip;10;0;0;10
12240;Želmenėliai;Voriukų;4075533071;Taip;0;1;0;1
12241;Želmenėliai;Voriukų;4545012342;Taip;16;0;0;16
12242;Želmenėliai;Voriukų;7505996978;Taip;8;8;0;16
12243;Želmenėliai;Voriukų;2846903449;Taip;8;2;0;10
12244;Želmenėliai;Voriukų;4473677352;Taip;22;0;0;22
12245;Želmenėliai;Voriukų;8973215240;Taip;5;8;0;13
12246;Želmenėliai;Voriukų;2722619508;Taip;0;12;0;12
12247;Želmenėliai;Voriukų;5025345647;Taip;0;12;0;12
12248;Želmenėliai;Voriukų;3043560150;Ne;5;0;2;7
12249;Želmenėliai;Voriukų;8892137326;Taip;0;3;0;3
12250;Želmenėliai;Boružėlių;51756630728;Taip;0;11;0;11
12251;Želmenėliai;Boružėlių;5223588064;Ne;0;2;0;2
12252;Želmenėliai;Boružėlių;91372955120;Taip;0;0;2;2
12253;Želmenėliai;Boružėlių;2898358705;Taip;0;4;0;4
12254;Želmenėliai;Boružėlių;63043069680;Taip;7;5;0;12
12255;Želmenėliai;Boružėlių;10462964817;Taip;10;1;0;11
12256;Želmenėliai;Boružėlių;2103938312;Taip;0;1;0;1
12257;Želmenėliai;Boružėlių;35901929384;Taip;0;14;0;14
12258;Želmenėliai;Boružėlių;1699958696;Taip;0;9;0;9
12259;Želmenėliai;Boružėlių;98852944217;Ne;0;5;0;5
12260;Želmenėliai;Boružėlių;7502363323;Ne;0;4;0;4
12261;Želmenėliai;Boružėlių;1009164107;Taip;0;18;0;18
12262;Želmenėliai;Boružėlių;92486344928;Taip;0;8;0;8
12263;Želmenėliai;Boružėlių;1802714172;Taip;0;2;0;2
12264;Želmenėliai;Boružėlių;1933769076;Taip;0;0;4;4
12265;Želmenėliai;Boružėlių;1134743316;Taip;10;0;0;10
12266;Želmenėliai;Boružėlių;9414488405;Taip;15;5;0;20
12267;Želmenėliai;Pūkuotukų;73813829491;Taip;0;17;0;17
12268;Želmenėliai;Pūkuotukų;79879695958;Taip;9;0;1;10
12269;Želmenėliai;Pūkuotukų;54536849345;Taip;0;3;0;3
12270;Želmenėliai;Pūkuotukų;8936734213;Taip;0;2;1;3
12271;Želmenėliai;Pūkuotukų;1213403598;Taip;13;3;0;16
12272;Želmenėliai;Pūkuotukų;1803684569;Ne;0;0;5;5
12273;Želmenėliai;Pūkuotukų;1716801722;Taip;4;0;0;4
12274;Želmenėliai;Pūkuotukų;45440599686;Taip;10;3;0;13
12275;Želmenėliai;Pūkuotukų;50805473649;Taip;7;1;0;8
12276;Želmenėliai;Pūkuotukų;1405460015;Taip;0;1;0;1
12277;Želmenėliai;Pūkuotukų;85619767784;Taip;0;8;0;8
12278;Želmenėliai;Pūkuotukų;1800724034;Taip;0;0;7;7
12279;Želmenėliai;Pūkuotukų;74037118861;Taip;0;5;0;5
12280;Želmenėliai;Pūkuotukų;8706951420;Taip;12;6;0;18
12281;Želmenėliai;Pūkuotukų;7737877729;Taip;0;2;0;2
12282;Želmenėliai;Pūkuotukų;1426827854;Taip;0;4;0;4
12283;Želmenėliai;Pūkuotukų;75198661944;Taip;0;6;0;6
12284;Želmenėliai;Pūkuotukų;2036184590;Taip;0;5;0;5
12285;Želmenėliai;Pūkuotukų;72855365141;Taip;0;2;3;5
12286;Želmenėliai;Pūkuotukų;22138795060;Taip;0;1;0;1
12287;Želmenėliai;Pūkuotukų;37152467004;Taip;0;4;0;4
12288;Želmenėliai;Ančiukų;9493581034;Taip;8;0;0;8
12289;Želmenėliai;Ančiukų;8987377791;Taip;5;5;0;10
12290;Želmenėliai;Ančiukų;4126499046;Taip;10;0;0;10
12291;Želmenėliai;Ančiukų;4758240577;Taip;7;1;0;8
12292;Želmenėliai;Ančiukų;7197717698;Taip;12;0;0;12
12293;Želmenėliai;Ančiukų;2570248893;Taip;7;7;0;14
12294;Želmenėliai;Ančiukų;2111008869;Taip;4;6;0;10
12295;Želmenėliai;Ančiukų;4198085732;Taip;6;0;0;6
12296;Želmenėliai;Ančiukų;7849682820;Taip;9;0;0;9
12297;Želmenėliai;Ančiukų;4589396143;Taip;6;3;0;9
12298;Želmenėliai;Ančiukų;7094853897;Taip;7;0;0;7
12299;Želmenėliai;Ančiukų;5281861477;Taip;19;0;0;19
12300;Želmenėliai;Nykštukų;3572462731;Taip;7;0;0;7
12301;Želmenėliai;Nykštukų;1652131150;Ne;12;0;0;12
12302;Želmenėliai;Nykštukų;2350936740;Taip;15;0;0;15
12303;Želmenėliai;Nykštukų;4931664953;Taip;5;0;0;5
12304;Želmenėliai;Nykštukų;3063417708;Taip;2;2;0;4
12305;Želmenėliai;Nykštukų;2311169187;Taip;12;0;0;12
12306;Želmenėliai;Nykštukų;6635909614;Taip;0;17;0;17
12307;Želmenėliai;Nykštukų;8954705816;Taip;10;0;0;10
12308;Želmenėliai;Nykštukų;5795735579;Taip;9;0;0;9
12309;Želmenėliai;Nykštukų;1292462938;Taip;12;0;0;12
12310;Želmenėliai;Nykštukų;3353793939;Taip;10;0;0;10
12311;Želmenėliai;Nykštukų;7495157523;Taip;8;0;0;8
12312;Želmenėliai;Nykštukų;8519608506;Taip;6;0;0;6
12313;Želmenėliai;Lašelių;5171736943;Taip;10;3;0;13
12314;Želmenėliai;Lašelių;6876147546;Taip;8;3;0;11
12315;Želmenėliai;Lašelių;9126715074;Taip;6;3;0;9
12316;Želmenėliai;Lašelių;6180553648;Taip;0;8;0;8
12317;Želmenėliai;Lašelių;1260607572;Taip;0;2;0;2
12318;Želmenėliai;Lašelių;4120125150;Taip;3;0;2;5
12319;Želmenėliai;Lašelių;3972980949;Taip;0;1;0;1
12320;Želmenėliai;Lašelių;2296870749;Taip;0;0;1;1
12321;Želmenėliai;Lašelių;6779746783;Taip;7;0;0;7
12322;Žemyna;Čiauškučiai;88775150201;Taip;0;0;1;1
12323;Žemyna;Čiauškučiai;1683299408;Taip;0;1;0;1
12324;Žemyna;Čiauškučiai;39175264243;Taip;0;1;0;1
12325;Žemyna;Čiauškučiai;35462796459;Taip;0;4;0;4
12326;Žemyna;Čiauškučiai;50543973728;Taip;7;0;1;8
12327;Žemyna;Čiauškučiai;1595030102;Ne;9;0;1;10
12328;Žemyna;Čiauškučiai;6448628301;Taip;12;0;0;12
12329;Žemyna;Čiauškučiai;1421842247;Taip;0;0;1;1
12330;Žemyna;Čiauškučiai;47562685723;Taip;5;0;2;7
12331;Žemyna;Čiauškučiai;32755929074;Taip;8;6;0;14
12332;Žemyna;Čiauškučiai;54823974018;Taip;0;7;1;8
12333;Žemyna;Čiauškučiai;1049546597;Taip;0;0;2;2
12334;Žemyna;Čiauškučiai;8096035110;Taip;0;0;1;1
12335;Žemyna;Čiauškučiai;38604851102;Taip;5;0;13;18
12336;Žemyna;Čiauškučiai;1305667359;Taip;0;0;5;5
12337;Žemyna;Čiauškučiai;6089122225;Taip;0;6;0;6
12338;Žemyna;Čiauškučiai;7343337032;Taip;0;0;5;5
12339;Žemyna;Nykštukai;5114094924;Taip;0;4;0;4
12340;Žemyna;Nykštukai;2461700030;Taip;6;6;0;12
12341;Žemyna;Nykštukai;1725771976;Taip;0;0;4;4
12342;Žemyna;Nykštukai;8622780639;Taip;3;0;0;3
12343;Žemyna;Nykštukai;3643594001;Ne;0;0;1;1
12344;Žemyna;Nykštukai;7121742098;Taip;0;0;3;3
12345;Žemyna;Nykštukai;4821941126;Taip;0;0;1;1
12346;Žemyna;Nykštukai;4322192775;Taip;5;10;2;17
12347;Žemyna;Nykštukai;4444870782;Taip;0;0;2;2
12348;Žemyna;Nykštukai;4257096808;Ne;4;0;1;5
12349;Žemyna;Nykštukai;1575505075;Taip;5;0;3;8
12350;Žemyna;Nykštukai;2860210906;Taip;16;0;0;16
12351;Žemyna;Nykštukai;7832066079;Ne;11;0;1;12
12352;Žemyna;Nykštukai;4759403487;Taip;0;3;0;3
12353;Žemyna;Nykštukai;9653530823;Taip;0;0;3;3
12354;Žemyna;Nykštukai;7508491119;Taip;0;1;2;3
12355;Žemyna;Nykštukai;2928125522;Ne;0;0;1;1
12356;Žemyna;Voveriukai;3135562485;Taip;0;0;4;4
12357;Žemyna;Voveriukai;5940619734;Taip;0;1;0;1
12358;Žemyna;Voveriukai;6812823390;Taip;0;0;3;3
12359;Žemyna;Voveriukai;8500642069;Taip;0;8;0;8
12360;Žemyna;Voveriukai;7925774308;Taip;11;0;0;11
12361;Žemyna;Voveriukai;2412956023;Taip;0;5;0;5
12362;Žemyna;Voveriukai;7341750699;Taip;0;0;1;1
12363;Žemyna;Voveriukai;3938938667;Taip;0;1;1;2
12364;Žemyna;Voveriukai;9958040413;Ne;16;0;1;17
12365;Žemyna;Voveriukai;1531980297;Taip;0;0;1;1
12366;Žemyna;Voveriukai;1807466584;Taip;0;22;0;22
12367;Žemyna;Voveriukai;1543415914;Taip;7;0;4;11
12368;Žemyna;Voveriukai;9148594407;Taip;3;0;4;7
12369;Žemyna;Voveriukai;7693278353;Taip;8;0;0;8
12370;Žemyna;Voveriukai;1118997229;Ne;0;1;3;4
12371;Žemyna;Voveriukai;3357339710;Taip;0;0;5;5
12372;Žemyna;Kiškučiai;1566781183;Ne;0;0;2;2
12373;Žemyna;Kiškučiai;26124703883;Taip;11;0;0;11
12374;Žemyna;Kiškučiai;1688122673;Taip;5;0;0;5
12375;Žemyna;Kiškučiai;5635456615;Taip;0;0;2;2
12376;Žemyna;Kiškučiai;1947185865;Taip;5;0;1;6
12377;Žemyna;Kiškučiai;2235521256;Taip;0;12;0;12
12378;Žemyna;Kiškučiai;23371576969;Ne;0;0;1;1
12379;Žemyna;Kiškučiai;5830320758;Taip;0;5;0;5
12380;Žemyna;Kiškučiai;6148416514;Taip;0;22;0;22
12381;Žemyna;Kiškučiai;88687293547;Ne;8;0;0;8
12382;Žemyna;Kiškučiai;1265326169;Taip;0;0;2;2
12383;Žemyna;Kiškučiai;2032992299;Taip;0;0;2;2
12384;Žemyna;Kiškučiai;4570281722;Ne;0;0;1;1
12385;Žemyna;Kiškučiai;75681135185;Taip;0;0;1;1
12386;Žemyna;Kiškučiai;15573695823;Taip;0;1;0;1
12387;Žemyna;Kiškučiai;2072914123;Taip;0;0;4;4
12388;Žemyna;Kiškučiai;8292265369;Taip;0;0;1;1
12389;Žemyna;Vyturiukai;9232638767;Taip;5;0;1;6
12390;Žemyna;Vyturiukai;38769607968;Taip;3;0;0;3
12391;Žemyna;Vyturiukai;17098859260;Taip;0;2;0;2
12392;Žemyna;Vyturiukai;1687206394;Taip;15;0;1;16
12393;Žemyna;Vyturiukai;5508251792;Taip;8;1;1;10
12394;Žemyna;Vyturiukai;85135645557;Taip;7;1;0;8
12395;Žemyna;Vyturiukai;59506345859;Taip;5;1;0;6
12396;Žemyna;Vyturiukai;89787441782;Taip;8;3;0;11
12397;Žemyna;Vyturiukai;41538301616;Taip;6;2;0;8
12398;Žemyna;Vyturiukai;5506889213;Taip;0;2;0;2
12399;Žemyna;Vyturiukai;5306392307;Taip;3;7;0;10
12400;Žemyna;Vyturiukai;37570629861;Taip;0;17;0;17
12401;Žemyna;Vyturiukai;13242930752;Taip;0;1;1;2
12402;Žemyna;Vyturiukai;96473502730;Taip;0;0;2;2
12403;Žemyna;Vyturiukai;93423088394;Taip;0;3;0;3
12404;Žemyna;Vyturiukai;55161890341;Ne;8;5;0;13
12405;Žemyna;Vyturiukai;6618285685;Taip;0;8;2;10
12406;Žemyna;Vyturiukai;4524929331;Taip;0;4;0;4
12407;Žemyna;Vyturiukai;3622634119;Ne;5;0;0;5
12408;Žemyna;Pelėdžiukai;68982161758;Taip;0;3;2;5
12409;Žemyna;Pelėdžiukai;69634515292;Taip;0;3;0;3
12410;Žemyna;Pelėdžiukai;65677663175;Taip;2;0;3;5
12411;Žemyna;Pelėdžiukai;74969696164;Taip;0;3;0;3
12412;Žemyna;Pelėdžiukai;47974278492;Taip;0;1;0;1
12413;Žemyna;Pelėdžiukai;92159859248;Taip;0;0;5;5
12414;Žemyna;Pelėdžiukai;10344263960;Taip;0;0;3;3
12415;Žemyna;Pelėdžiukai;54029612806;Taip;0;0;1;1
12416;Žemyna;Pelėdžiukai;93378737171;Taip;7;1;0;8
12417;Žemyna;Pelėdžiukai;6546437872;Taip;0;0;3;3
12418;Žemyna;Pelėdžiukai;5204796908;Taip;9;0;0;9
12419;Žemyna;Pelėdžiukai;9556275322;Taip;0;0;3;3
12420;Žemyna;Pelėdžiukai;78280621543;Taip;0;2;0;2
12421;Žemyna;Pelėdžiukai;81683768388;Taip;6;0;1;7
12422;Žemyna;Pelėdžiukai;65117735882;Taip;8;0;1;9
12423;Žemyna;Pelėdžiukai;59441904717;Taip;5;0;0;5
12424;Žemyna;Pelėdžiukai;97712802830;Taip;0;4;0;4
12425;Žemyna;Pelėdžiukai;70694756261;Taip;0;6;3;9
12426;Žemyna;Pelėdžiukai;45269313606;Taip;4;0;2;6
12427;Žemyna;Pelėdžiukai;30518889603;Taip;0;0;1;1
12428;Žemyna;Pelėdžiukai;1674165765;Taip;0;5;0;5
12429;Žemyna;Pelėdžiukai;2033947862;Taip;0;0;3;3
12430;Žemyna;Pelėdžiukai;1337500221;Taip;0;10;0;10
12431;Žemyna;Vijurkai;62565967575;Taip;9;1;1;11
12432;Žemyna;Vijurkai;1535497308;Taip;0;1;2;3
12433;Žemyna;Vijurkai;40843229500;Ne;3;0;1;4
12434;Žemyna;Vijurkai;69690099920;Taip;0;0;2;2
12435;Žemyna;Vijurkai;98477626952;Taip;0;0;2;2
12436;Žemyna;Vijurkai;71013970407;Taip;0;0;2;2
12437;Žemyna;Vijurkai;87939385151;Taip;6;0;0;6
12438;Žemyna;Vijurkai;56418377668;Taip;0;1;0;1
12439;Žemyna;Vijurkai;46550223916;Taip;1;0;1;2
12440;Žemyna;Vijurkai;98919412716;Taip;2;0;1;3
12441;Žemyna;Vijurkai;1866645242;Taip;6;0;3;9
12442;Žemyna;Vijurkai;83056273504;Ne;0;0;2;2
12443;Žemyna;Vijurkai;1790109762;Taip;0;0;1;1
12444;Žemyna;Vijurkai;89754744294;Taip;0;1;0;1
12445;Žemyna;Vijurkai;1393006122;Taip;0;0;3;3
12446;Žemyna;Vijurkai;9409512255;Taip;10;0;5;15
12447;Žemyna;Vijurkai;55748223762;Taip;0;0;2;2
12448;Žemyna;Šnekučiai;9501126807;Taip;0;0;2;2
12449;Žemyna;Šnekučiai;6735720135;Taip;0;0;3;3
12450;Žemyna;Šnekučiai;9912869400;Taip;14;5;0;19
12451;Žemyna;Šnekučiai;2006173745;Taip;0;0;1;1
12452;Žemyna;Šnekučiai;6116581655;Taip;5;0;1;6
12453;Žemyna;Šnekučiai;7367602247;Taip;0;8;0;8
12454;Žemyna;Šnekučiai;7280740926;Taip;0;0;5;5
12455;Žemyna;Šnekučiai;6419974691;Taip;8;0;1;9
12456;Žemyna;Šnekučiai;9818711030;Taip;0;3;0;3
12457;Žemyna;Šnekučiai;9219519029;Ne;0;14;0;14
12458;Žemyna;Šnekučiai;6293560729;Taip;4;0;4;8
12459;Žemyna;Šnekučiai;7764615445;Taip;0;0;1;1
12460;Žemyna;Šnekučiai;5868208651;Ne;0;0;2;2
12461;Žemyna;Šnekučiai;3992383447;Taip;10;0;3;13
12462;Žemyna;Šnekučiai;9668975591;Taip;0;0;1;1
12463;Žemyna;Šnekučiai;6856737270;Ne;0;2;0;2
12464;Žemyna;Šnekučiai;5188496664;Taip;7;0;3;10
12465;Žemyna;Šnekučiai;4872348199;Taip;9;0;0;9
12466;Žemyna;Šnekučiai;6878669773;Taip;0;0;1;1
12467;Žemyna;Šnekučiai;4502958166;Ne;10;0;1;11
12468;Žemyna;Šnekučiai;5688714928;Taip;0;0;1;1
12469;Žemyna;Pabiručiai;82507236376;Taip;0;0;3;3
12470;Žemyna;Pabiručiai;84955588471;Taip;0;5;0;5
12471;Žemyna;Pabiručiai;82479499709;Ne;0;0;3;3
12472;Žemyna;Pabiručiai;14902924855;Taip;0;1;0;1
12473;Žemyna;Pabiručiai;1847882950;Taip;0;3;1;4
12474;Žemyna;Pabiručiai;50687988382;Ne;0;6;0;6
12475;Žemyna;Pabiručiai;1278096396;Taip;9;0;2;11
12476;Žemyna;Pabiručiai;2841526614;Taip;4;0;1;5
12477;Žemyna;Pabiručiai;8496195396;Taip;0;0;1;1
12478;Žemyna;Pabiručiai;4796265997;Taip;0;0;5;5
12479;Žemyna;Pabiručiai;3895238312;Taip;7;0;4;11
12480;Žemyna;Pabiručiai;2137718635;Ne;0;0;2;2
12481;Žemyna;Pabiručiai;1058705875;Taip;0;3;0;3
12482;Žemyna;Pabiručiai;2090395417;Taip;5;0;0;5
12483;Žemyna;Drugeliai;2100326039;Taip;0;4;2;6
12484;Žemyna;Drugeliai;84680481889;Taip;0;0;2;2
12485;Žemyna;Drugeliai;1882507954;Taip;9;0;0;9
12486;Žemyna;Drugeliai;1623854426;Taip;0;1;0;1
12487;Žemyna;Drugeliai;50369667193;Taip;5;12;0;17
12488;Žemyna;Drugeliai;1705971732;Taip;0;0;1;1
12489;Žemyna;Drugeliai;17784132877;Taip;0;0;1;1
12490;Žemyna;Drugeliai;45222048620;Taip;0;1;2;3
12491;Žemyna;Drugeliai;27867030470;Taip;0;2;0;2
12492;Žemyna;Drugeliai;51870099224;Taip;0;0;5;5
12493;Žemyna;Drugeliai;1941650167;Taip;0;10;0;10
12494;Žemyna;Drugeliai;2113826378;Taip;0;0;1;1
12495;Žemyna;Drugeliai;1867198805;Taip;0;2;0;2
12496;Žemyna;Drugeliai;4519502372;Taip;2;0;0;2
12497;Žemyna;"ŽIRNIUKAI ";7620179886;Taip;10;0;0;10
12498;Žemyna;"ŽIRNIUKAI ";5069437469;Taip;5;0;0;5
12499;Žemyna;"ŽIRNIUKAI ";7277970673;Taip;2;0;1;3
12500;Žemyna;"ŽIRNIUKAI ";3074391266;Taip;1;0;1;2
12501;Žemyna;"ŽIRNIUKAI ";2547436771;Taip;8;0;2;10
12502;Žemyna;"ŽIRNIUKAI ";6346173832;Taip;3;0;11;14
12503;Žemyna;"ŽIRNIUKAI ";1365045512;Taip;2;0;2;4
12504;Žemyna;"ŽIRNIUKAI ";4642600915;Taip;3;0;0;3
12505;Žemyna;"ŽIRNIUKAI ";5416338054;Taip;0;5;0;5
12506;Žemyna;"ŽIRNIUKAI ";5133115712;Taip;0;5;0;5
12507;Žemyna;"ŽIRNIUKAI ";2792702536;Taip;2;0;1;3
12508;Žemyna;"ŽIRNIUKAI ";6051208732;Taip;13;0;0;13
12509;Žemyna;"ŽIRNIUKAI ";7427119736;Taip;5;0;0;5
12510;Žemyna;"ŽIRNIUKAI ";2354265632;Taip;22;0;0;22
12511;Žemyna;"ŽIOGELIAI ";9094718595;Taip;0;0;3;3
12512;Žemyna;"ŽIOGELIAI ";6208953341;Taip;0;0;2;2
12513;Žemyna;"ŽIOGELIAI ";9827401825;Taip;0;7;0;7
12514;Žemyna;"ŽIOGELIAI ";8559870965;Taip;14;0;0;14
12515;Žemyna;"ŽIOGELIAI ";4176386795;Taip;7;2;0;9
12516;Žemyna;"ŽIOGELIAI ";2034162734;Taip;2;1;0;3
12517;Žemyna;"ŽIOGELIAI ";7122276019;Taip;18;0;0;18
12518;Žemyna;"ŽIOGELIAI ";7005045961;Taip;0;0;3;3
12519;Žemyna;"ŽIOGELIAI ";1745197274;Taip;15;0;0;15
12520;Žemyna;"ŽIOGELIAI ";6041223291;Taip;4;2;0;6
12521;Žemyna;"ŽIOGELIAI ";1850100203;Taip;0;1;3;4
12522;Žemyna;"ŽIOGELIAI ";9628651723;Ne;10;0;0;10
12523;Žemyna;"ŽIOGELIAI ";5743535463;Taip;17;0;0;17
12524;Žemuogėlė;Boružiukai;4231767115;Taip;3;1;0;4
12525;Žemuogėlė;Boružiukai;3977351017;Taip;3;1;0;4
12526;Žemuogėlė;Boružiukai;3854265246;Taip;3;0;0;3
12527;Žemuogėlė;Boružiukai;8737612457;Ne;0;3;0;3
12528;Žemuogėlė;Boružiukai;5147617128;Taip;12;6;0;18
12529;Žemuogėlė;Boružiukai;5625943720;Taip;0;2;2;4
12530;Žemuogėlė;Boružiukai;1058207935;Taip;4;0;0;4
12531;Žemuogėlė;Boružiukai;1628749648;Taip;0;0;1;1
12532;Žemuogėlė;Boružiukai;7714826773;Taip;3;2;0;5
12533;Žemuogėlė;Boružiukai;3134493860;Taip;0;1;0;1
12534;Žemuogėlė;Boružiukai;8023936861;Taip;0;0;1;1
12535;Žemuogėlė;Boružiukai;1907004376;Taip;0;5;0;5
12536;Žemuogėlė;Boružiukai;38870047353;Taip;7;2;1;10
12537;Žemuogėlė;Boružiukai;9315711142;Taip;6;2;0;8
12538;Žemuogėlė;Boružiukai;2102057496;Taip;0;1;0;1
12539;Žemuogėlė;Boružiukai;94792383091;Taip;9;0;0;9
12540;Žemuogėlė;Boružiukai;4421397490;Taip;7;0;0;7
12541;Žemuogėlė;Šviesuliukai;9255723192;Taip;0;4;0;4
12542;Žemuogėlė;Šviesuliukai;2740942924;Taip;11;6;0;17
12543;Žemuogėlė;Šviesuliukai;5972567526;Taip;6;2;0;8
12544;Žemuogėlė;Šviesuliukai;1910570858;Taip;0;5;0;5
12545;Žemuogėlė;Šviesuliukai;8409711622;Taip;9;0;0;9
12546;Žemuogėlė;Šviesuliukai;5127370193;Taip;0;0;3;3
12547;Žemuogėlė;Šviesuliukai;5126348190;Taip;6;0;2;8
12548;Žemuogėlė;Šviesuliukai;9534937419;Taip;2;0;0;2
12549;Žemuogėlė;Šviesuliukai;3612833383;Taip;15;0;0;15
12550;Žemuogėlė;Šviesuliukai;3000676765;Taip;4;2;0;6
12551;Žemuogėlė;Šviesuliukai;9689082202;Ne;15;1;0;16
12552;Žemuogėlė;Šviesuliukai;3411390558;Taip;0;3;0;3
12553;Žemuogėlė;Šviesuliukai;1275552038;Taip;0;0;7;7
12554;Žemuogėlė;Šviesuliukai;1377813636;Taip;5;0;2;7
12555;Žemuogėlė;Šviesuliukai;2731544174;Taip;8;0;0;8
12556;Žemuogėlė;Šviesuliukai;4660479216;Taip;17;0;0;17
12557;Žemuogėlė;Lašiukai;2099256322;Taip;5;1;0;6
12558;Žemuogėlė;Lašiukai;2320908623;Taip;0;2;0;2
12559;Žemuogėlė;Lašiukai;3208009994;Taip;0;2;0;2
12560;Žemuogėlė;Lašiukai;2146044539;Taip;3;1;0;4
12561;Žemuogėlė;Lašiukai;97014601220;Ne;0;6;0;6
12562;Žemuogėlė;Lašiukai;31450036105;Taip;4;2;4;10
12563;Žemuogėlė;Lašiukai;93523683833;Taip;0;2;0;2
12564;Žemuogėlė;Lašiukai;1223819270;Ne;0;1;0;1
12565;Žemuogėlė;Lašiukai;1608506638;Taip;6;0;0;6
12566;Žemuogėlė;Lašiukai;1448477562;Taip;6;0;0;6
12567;Žemuogėlė;Lašiukai;4900328025;Taip;13;0;0;13
12568;Žemuogėlė;Lašiukai;8295541141;Ne;0;4;0;4
12569;Žemuogėlė;Lašiukai;1223648771;Taip;0;2;0;2
12570;Žemuogėlė;Skambaliukai;58894092756;Taip;0;1;0;1
12571;Žemuogėlė;Skambaliukai;34462365948;Taip;2;2;0;4
12572;Žemuogėlė;Skambaliukai;13768771915;Taip;0;1;0;1
12573;Žemuogėlė;Skambaliukai;1844596636;Taip;0;3;0;3
12574;Žemuogėlė;Skambaliukai;10356039859;Taip;0;3;0;3
12575;Žemuogėlė;Skambaliukai;8952696734;Taip;0;6;0;6
12576;Žemuogėlė;Skambaliukai;77880141132;Taip;0;2;1;3
12577;Žemuogėlė;Skambaliukai;53763899224;Taip;10;2;1;13
12578;Žemuogėlė;Skambaliukai;29973978107;Taip;0;5;0;5
12579;Žemuogėlė;Skambaliukai;1366286798;Taip;0;0;2;2
12580;Žemuogėlė;Skambaliukai;58604834495;Taip;0;4;0;4
12581;Žemuogėlė;Skambaliukai;87719167969;Taip;0;2;0;2
12582;Žemuogėlė;Skambaliukai;66464155865;Taip;0;1;0;1
12583;Žemuogėlė;Skambaliukai;3354347837;Ne;0;2;0;2
12584;Žemuogėlė;Skambaliukai;98006600854;Taip;0;6;0;6
12585;Žemuogėlė;Skambaliukai;92317183904;Taip;0;1;0;1
12586;Žemuogėlė;Skambaliukai;28795421460;Taip;3;0;0;3
12587;Žemuogėlė;Skambaliukai;33112231008;Taip;0;17;0;17
12588;Žemuogėlė;Skambaliukai;24111477729;Taip;0;1;0;1
12589;Žemuogėlė;Spinduliukai;62210251654;Taip;6;5;0;11
12590;Žemuogėlė;Spinduliukai;22761916112;Ne;0;6;0;6
12591;Žemuogėlė;Spinduliukai;5888483930;Ne;0;5;0;5
12592;Žemuogėlė;Spinduliukai;97511628790;Taip;2;4;0;6
12593;Žemuogėlė;Spinduliukai;89316574266;Taip;4;0;0;4
12594;Žemuogėlė;Spinduliukai;64042870424;Taip;0;1;0;1
12595;Žemuogėlė;Spinduliukai;29436958034;Taip;0;1;0;1
12596;Žemuogėlė;Spinduliukai;9864664937;Taip;5;1;0;6
12597;Žemuogėlė;Spinduliukai;9042246873;Taip;12;4;0;16
12598;Žemuogėlė;Spinduliukai;57783467185;Taip;0;8;0;8
12599;Žemuogėlė;Spinduliukai;24863928147;Taip;3;0;0;3
12600;Žemuogėlė;Spinduliukai;1859848343;Taip;0;7;0;7
12601;Žemuogėlė;Spinduliukai;96167322031;Taip;17;0;0;17
12602;Žemuogėlė;Spinduliukai;4766971363;Taip;5;2;0;7
12603;Žemuogėlė;Spinduliukai;1608544032;Taip;15;2;0;17
12604;Žemuogėlė;Spinduliukai;3868254757;Taip;0;1;0;1
12605;Žemuogėlė;Spinduliukai;8187939143;Taip;0;7;0;7
12606;Žemuogėlė;Spinduliukai;5395954931;Taip;0;7;0;7
12607;Žemuogėlė;Perliukai;64182347253;Taip;0;1;0;1
12608;Žemuogėlė;Perliukai;89682626079;Taip;15;2;0;17
12609;Žemuogėlė;Perliukai;95070515682;Taip;0;1;0;1
12610;Žemuogėlė;Perliukai;7503799036;Taip;7;0;0;7
12611;Žemuogėlė;Perliukai;95392130582;Taip;0;2;0;2
12612;Žemuogėlė;Perliukai;1099252682;Taip;0;7;0;7
12613;Žemuogėlė;Perliukai;1550066922;Taip;0;3;1;4
12614;Žemuogėlė;Perliukai;1354590098;Taip;0;3;0;3
12615;Žemuogėlė;Perliukai;52842591023;Taip;0;2;7;9
12616;Žemuogėlė;Perliukai;5911529759;Taip;0;3;0;3
12617;Žemuogėlė;Perliukai;1093128368;Taip;0;1;0;1
12618;Žemuogėlė;Perliukai;70054283264;Taip;0;2;2;4
12619;Žemuogėlė;Perliukai;40590616715;Taip;0;1;0;1
12620;Žemuogėlė;Drugeliai;9592456683;Taip;10;0;0;10
12621;Žemuogėlė;Drugeliai;3765022476;Taip;15;2;0;17
12622;Žemuogėlė;Drugeliai;5266493632;Taip;5;12;0;17
12623;Žemuogėlė;Drugeliai;3237083654;Taip;10;2;2;14
12624;Žemuogėlė;Drugeliai;2259779058;Taip;10;2;0;12
12625;Žemuogėlė;Drugeliai;9693894254;Taip;0;3;0;3
12626;Žemuogėlė;Drugeliai;5418395023;Taip;10;0;0;10
12627;Žemuogėlė;Drugeliai;6581889641;Taip;0;2;8;10
12628;Žemuogėlė;Drugeliai;2555902309;Taip;20;2;0;22
12629;Žemuogėlė;Drugeliai;4536398519;Taip;13;0;0;13
12630;Žemuogėlė;Drugeliai;8757701456;Taip;0;5;0;5
12631;Žemuogėlė;Drugeliai;1713927628;Taip;11;1;0;12
12632;Žemuogėlė;Drugeliai;1844299594;Taip;0;3;0;3
12633;Žemuogėlė;Drugeliai;2132549536;Taip;0;8;0;8
12634;Žemuogėlė;Drugeliai;8496353410;Taip;0;3;0;3
12635;Žemuogėlė;Drugeliai;7804015060;Taip;0;1;0;1
12636;Žemuogėlė;Drugeliai;3714945248;Taip;22;0;0;22
12637;Žemuogėlė;Drugeliai;2001471529;Taip;0;6;0;6
12638;Žemuogėlė;Drugeliai;6913038845;Taip;2;3;0;5
12639;Žemuogėlė;"VIEVERSIUKAI ";2664267604;Taip;4;0;0;4
12640;Žemuogėlė;"VIEVERSIUKAI ";9693814425;Taip;0;21;0;21
12641;Žemuogėlė;"VIEVERSIUKAI ";3288369628;Taip;7;1;0;8
12642;Žemuogėlė;"VIEVERSIUKAI ";6276697479;Taip;0;21;0;21
12643;Žemuogėlė;"VIEVERSIUKAI ";3825509486;Taip;10;1;0;11
12644;Žemuogėlė;"VIEVERSIUKAI ";1060986850;Taip;10;11;0;21
12645;Žemuogėlė;"VIEVERSIUKAI ";1306065826;Taip;14;7;0;21
12646;Žemuogėlė;"VIEVERSIUKAI ";5992802843;Taip;6;1;0;7
12647;Žemuogėlė;"VIEVERSIUKAI ";5505719625;Taip;0;17;0;17
12648;Žemuogėlė;"VIEVERSIUKAI ";1555899448;Taip;15;7;0;22
12649;Žemuogėlė;"VIEVERSIUKAI ";7137182934;Taip;2;9;0;11
12650;Žemuogėlė;"VIEVERSIUKAI ";1796489729;Taip;10;9;1;20
12651;Žemuogėlė;"VIEVERSIUKAI ";3059525247;Taip;0;1;0;1
12652;Žemuogėlė;"NYKŠTUKAI ";3546429231;Taip;0;6;0;6
12653;Žemuogėlė;"NYKŠTUKAI ";1251497003;Taip;1;1;0;2
12654;Žemuogėlė;"NYKŠTUKAI ";3706531223;Taip;6;0;0;6
12655;Žemuogėlė;"NYKŠTUKAI ";4565097904;Ne;0;1;0;1
12656;Žemuogėlė;"NYKŠTUKAI ";1049009199;Taip;0;4;0;4
12657;Žemuogėlė;"NYKŠTUKAI ";8644564820;Taip;5;7;0;12
12658;Žemuogėlė;"NYKŠTUKAI ";9579921777;Taip;2;0;0;2
12659;Žemuogėlė;"NYKŠTUKAI ";1356340471;Taip;7;6;0;13
12660;Žemuogėlė;"NYKŠTUKAI ";7436765462;Taip;0;18;0;18
12661;Žemuogėlė;"NYKŠTUKAI ";3753156044;Ne;11;0;0;11
12662;Žemuogėlė;"NYKŠTUKAI ";3073956225;Taip;18;0;0;18
12663;Žemuogėlė;KIŠKUČIAI;3041461125;Taip;5;14;0;19
12664;Žemuogėlė;KIŠKUČIAI;1953538445;Taip;1;11;2;14
12665;Žemuogėlė;KIŠKUČIAI;6707522989;Taip;8;7;0;15
12666;Žemuogėlė;KIŠKUČIAI;9981446556;Taip;7;3;0;10
12667;Žemuogėlė;KIŠKUČIAI;3837424301;Taip;4;1;0;5
12668;Žemuogėlė;KIŠKUČIAI;9545690301;Ne;9;0;0;9
12669;Žemuogėlė;KIŠKUČIAI;8827421660;Ne;0;10;0;10
12670;Žemuogėlė;KIŠKUČIAI;7669457695;Taip;5;1;0;6
12671;Žemuogėlė;KIŠKUČIAI;8675089149;Taip;7;0;1;8
12672;Žemuogėlė;KIŠKUČIAI;4165354124;Taip;8;1;0;9
12673;Žemuogėlė;KIŠKUČIAI;6059069293;Taip;0;17;0;17
12674;Žemuogėlė;KIŠKUČIAI;5971652934;Taip;6;1;0;7
12675;Žemuogėlė;KIŠKUČIAI;9955429241;Taip;0;0;1;1
12676;Žibutė;PELĖDŽIUKAI;54535455969;Taip;0;0;4;4
12677;Žibutė;PELĖDŽIUKAI;62146271609;Taip;0;0;2;2
12678;Žibutė;PELĖDŽIUKAI;85042822872;Taip;0;7;1;8
12679;Žibutė;PELĖDŽIUKAI;59824395612;Taip;8;0;0;8
12680;Žibutė;PELĖDŽIUKAI;2361682400;Taip;0;5;4;9
12681;Žibutė;PELĖDŽIUKAI;1826763192;Taip;0;1;0;1
12682;Žibutė;PELĖDŽIUKAI;3826875107;Taip;0;12;0;12
12683;Žibutė;PELĖDŽIUKAI;3186792146;Taip;0;0;1;1
12684;Žibutė;PELĖDŽIUKAI;1226458088;Ne;0;3;0;3
12685;Žibutė;PELĖDŽIUKAI;7344095020;Taip;0;2;1;3
12686;Žibutė;PELĖDŽIUKAI;1078105287;Taip;0;2;0;2
12687;Žibutė;PELĖDŽIUKAI;2152452830;Ne;0;0;1;1
12688;Žibutė;PELĖDŽIUKAI;1394895695;Ne;0;7;0;7
12689;Žibutė;PELĖDŽIUKAI;2236930916;Taip;2;0;0;2
12690;Žibutė;PELĖDŽIUKAI;7095870173;Taip;9;0;0;9
12691;Žibutė;PELĖDŽIUKAI;2840754631;Taip;8;0;1;9
12692;Žibutė;PELĖDŽIUKAI;6089325755;Taip;4;0;2;6
12693;Žibutė;PELĖDŽIUKAI;1274409680;Taip;0;9;0;9
12694;Žibutė;KREGŽDUTĖS;8587562864;Ne;8;0;3;11
12695;Žibutė;KREGŽDUTĖS;29414890756;Ne;10;0;1;11
12696;Žibutė;KREGŽDUTĖS;3035056391;Taip;3;6;1;10
12697;Žibutė;KREGŽDUTĖS;4480906648;Ne;8;1;1;10
12698;Žibutė;KREGŽDUTĖS;90082848356;Taip;4;0;1;5
12699;Žibutė;KREGŽDUTĖS;22415995120;Taip;0;4;0;4
12700;Žibutė;KREGŽDUTĖS;82985105104;Ne;0;0;2;2
12701;Žibutė;KREGŽDUTĖS;24118925398;Taip;0;0;3;3
12702;Žibutė;KREGŽDUTĖS;37321817270;Taip;6;0;0;6
12703;Žibutė;KREGŽDUTĖS;8973875215;Taip;7;0;0;7
12704;Žibutė;KREGŽDUTĖS;4241572158;Taip;15;0;0;15
12705;Žibutė;KREGŽDUTĖS;2776197727;Ne;2;0;0;2
12706;Žibutė;KREGŽDUTĖS;3722925159;Taip;0;0;1;1
12707;Žibutė;KREGŽDUTĖS;6471216018;Taip;2;1;0;3
12708;Žibutė;KREGŽDUTĖS;8830047872;Taip;11;0;1;12
12709;Žibutė;BORUŽĖLĖS;8792292819;Taip;7;0;0;7
12710;Žibutė;BORUŽĖLĖS;2438980348;Taip;0;0;3;3
12711;Žibutė;BORUŽĖLĖS;7668484415;Taip;5;0;0;5
12712;Žibutė;BORUŽĖLĖS;5126232169;Taip;4;0;0;4
12713;Žibutė;BORUŽĖLĖS;9918283923;Taip;7;0;0;7
12714;Žibutė;BORUŽĖLĖS;9700866512;Taip;0;0;2;2
12715;Žibutė;BORUŽĖLĖS;3268141759;Ne;0;1;1;2
12716;Žibutė;BORUŽĖLĖS;7774532200;Taip;0;12;0;12
12717;Žibutė;BORUŽĖLĖS;1366469428;Taip;10;0;1;11
12718;Žibutė;BORUŽĖLĖS;4825064521;Taip;19;0;0;19
12719;Žibutė;BORUŽĖLĖS;5826523148;Taip;0;3;2;5
12720;Žibutė;BORUŽĖLĖS;5806696915;Taip;3;2;1;6
12721;Žibutė;BORUŽĖLĖS;3957898269;Taip;0;6;0;6
12722;Žibutė;BORUŽĖLĖS;4814936645;Taip;15;0;1;16
12723;Žibutė;BORUŽĖLĖS;4382812297;Taip;2;0;1;3
12724;Žibutė;BORUŽĖLĖS;5591698130;Taip;0;0;2;2
12725;Žibutė;BORUŽĖLĖS;1004098038;Taip;3;0;1;4
12726;Žibutė;BORUŽĖLĖS;2880593326;Taip;0;2;0;2
12727;Žibutė;BORUŽĖLĖS;7479437931;Ne;3;0;0;3
12728;Žibutė;BITUTĖS;3194445795;Taip;0;2;0;2
12729;Žibutė;BITUTĖS;14091973543;Taip;8;0;0;8
12730;Žibutė;BITUTĖS;24818054845;Taip;6;2;0;8
12731;Žibutė;BITUTĖS;27182644850;Taip;0;6;0;6
12732;Žibutė;BITUTĖS;9591439732;Taip;0;1;3;4
12733;Žibutė;BITUTĖS;90040902859;Taip;6;1;0;7
12734;Žibutė;BITUTĖS;39367516353;Taip;5;1;0;6
12735;Žibutė;BITUTĖS;72357016152;Taip;5;3;0;8
12736;Žibutė;BITUTĖS;1054908586;Taip;0;5;0;5
12737;Žibutė;BITUTĖS;2603387036;Taip;0;0;3;3
12738;Žibutė;BITUTĖS;1215072172;Taip;0;1;0;1
12739;Žibutė;BITUTĖS;1317512329;Taip;6;2;0;8
12740;Žibutė;BITUTĖS;2144866874;Ne;6;2;0;8
12741;Žibutė;BITUTĖS;1749323904;Taip;0;2;0;2
12742;Žibutė;BITUTĖS;19558564943;Taip;0;1;0;1
12743;Žibutė;BITUTĖS;9109825948;Taip;0;0;3;3
12744;Žibutė;BITUTĖS;6958822972;Ne;0;1;0;1
12745;Žibutė;BITUTĖS;62187632470;Ne;4;1;0;5
12746;Žibutė;KAČIUKAI;25658034484;Taip;0;1;3;4
12747;Žibutė;KAČIUKAI;6736950445;Ne;0;2;1;3
12748;Žibutė;KAČIUKAI;2089960385;Taip;0;0;6;6
12749;Žibutė;KAČIUKAI;30838051846;Taip;0;0;1;1
12750;Žibutė;KAČIUKAI;29408732286;Taip;9;2;0;11
12751;Žibutė;KAČIUKAI;35959201106;Taip;0;0;6;6
12752;Žibutė;KAČIUKAI;67702702073;Taip;6;0;3;9
12753;Žibutė;KAČIUKAI;60756444655;Ne;0;0;11;11
12754;Žibutė;KAČIUKAI;33367530216;Taip;0;0;11;11
12755;Žibutė;KAČIUKAI;97730387781;Taip;0;1;0;1
12756;Žibutė;KAČIUKAI;51435935201;Taip;0;0;5;5
12757;Žibutė;KAČIUKAI;14243834326;Taip;0;0;10;10
12758;Žibutė;KAČIUKAI;1683770314;Taip;0;3;1;4
12759;Žibutė;KAČIUKAI;99502912405;Ne;0;0;2;2
12760;Žibutė;KAČIUKAI;10269347801;Taip;0;0;3;3
12761;Žibutė;KAČIUKAI;76137370554;Ne;0;0;1;1
12762;Žibutė;KAČIUKAI;4475507372;Taip;7;0;2;9
12763;Žibutė;KAČIUKAI;2120935059;Taip;0;0;2;2
12764;Žibutė;KAČIUKAI;9655499291;Ne;0;0;4;4
12765;Žibutė;ZUIKIAI;6495108202;Taip;0;2;4;6
12766;Žibutė;ZUIKIAI;5677389434;Taip;0;1;0;1
12767;Žibutė;ZUIKIAI;5187777741;Taip;2;0;0;2
12768;Žibutė;ZUIKIAI;6013340521;Taip;0;4;1;5
12769;Žibutė;ZUIKIAI;7036454359;Ne;11;0;1;12
12770;Žibutė;ZUIKIAI;5412917352;Taip;0;0;1;1
12771;Žibutė;ZUIKIAI;8715912139;Taip;2;0;2;4
12772;Žibutė;ZUIKIAI;5416015554;Taip;7;0;0;7
12773;Žibutė;ZUIKIAI;3555071718;Taip;22;0;0;22
12774;Žibutė;ZUIKIAI;7531027545;Taip;10;0;0;10
12775;Žibutė;ZUIKIAI;3645481894;Taip;5;1;1;7
12776;Žibutė;ZUIKIAI;6074488747;Taip;0;0;3;3
12777;Žibutė;ZUIKIAI;8880329060;Taip;14;0;2;16
12778;Žibutė;ZUIKIAI;2957525481;Taip;0;0;2;2
12779;Žibutė;ZUIKIAI;5009495840;Ne;14;0;0;14
12780;Žibutė;ZUIKIAI;7136145033;Taip;0;0;3;3
12781;Žibutė;ZUIKIAI;5575614158;Taip;8;0;7;15
12782;Žibutė;ZUIKIAI;5190377896;Taip;3;0;4;7
12783;Žibutė;ZUIKIAI;3191351976;Taip;0;0;3;3
12784;Žibutė;ZUIKIAI;9498011134;Taip;0;0;1;1
12785;Žiedas;Bitutės;7123756950;Taip;0;14;0;14
12786;Žiedas;Bitutės;1818701657;Ne;0;0;2;2
12787;Žiedas;Bitutės;2063680054;Taip;7;0;0;7
12788;Žiedas;Bitutės;38427730823;Ne;9;0;0;9
12789;Žiedas;Bitutės;1631546874;Ne;0;5;0;5
12790;Žiedas;Bitutės;33966765931;Taip;5;1;0;6
12791;Žiedas;Bitutės;42777955874;Ne;10;0;0;10
12792;Žiedas;Bitutės;31369021056;Taip;7;0;0;7
12793;Žiedas;Bitutės;83630991208;Taip;0;2;0;2
12794;Žiedas;Bitutės;80003937908;Ne;0;5;0;5
12795;Žiedas;Bitutės;81304970766;Taip;0;1;0;1
12796;Žiedas;Bitutės;1288374706;Taip;12;2;0;14
12797;Žiedas;Bitutės;34178608904;Ne;7;2;0;9
12798;Žiedas;Bitutės;58252361010;Taip;0;6;0;6
12799;Žiedas;Varpeliai;32671505578;Taip;15;2;0;17
12800;Žiedas;Varpeliai;1733596148;Taip;0;7;0;7
12801;Žiedas;Varpeliai;55459877940;Ne;0;3;0;3
12802;Žiedas;Varpeliai;50069962197;Taip;0;12;0;12
12803;Žiedas;Varpeliai;59092030605;Taip;0;7;0;7
12804;Žiedas;Varpeliai;17275054601;Taip;0;3;1;4
12805;Žiedas;Varpeliai;1897597456;Taip;0;5;0;5
12806;Žiedas;Varpeliai;1443451076;Taip;0;0;4;4
12807;Žiedas;Varpeliai;1491929025;Taip;2;3;0;5
12808;Žiedas;Varpeliai;2075892389;Taip;5;0;1;6
12809;Žiedas;Varpeliai;85152640431;Ne;0;0;2;2
12810;Žiedas;Varpeliai;2147350804;Ne;7;5;0;12
12811;Žiedas;Varpeliai;1366570116;Taip;8;0;0;8
12812;Žiedas;Varpeliai;37314210812;Taip;0;1;0;1
12813;Žiedas;Varpeliai;52683198809;Taip;0;0;1;1
12814;Žiedas;Varpeliai;99985645406;Taip;0;0;1;1
12815;Žiedas;Varpeliai;39022317368;Ne;0;15;0;15
12816;Žiedas;Varpeliai;12622490543;Ne;10;12;0;22
12817;Žiedas;Varpeliai;1120478375;Taip;2;6;0;8
12818;Žiedas;Varpeliai;2081656643;Taip;0;0;3;3
12819;Žiedas;Ramunėlės;9648580306;Taip;8;1;0;9
12820;Žiedas;Ramunėlės;9736967156;Taip;5;2;0;7
12821;Žiedas;Ramunėlės;4922560649;Taip;0;2;2;4
12822;Žiedas;Ramunėlės;2511423525;Taip;3;0;0;3
12823;Žiedas;Ramunėlės;7814504623;Taip;8;0;1;9
12824;Žiedas;Ramunėlės;2095655987;Ne;9;11;0;20
12825;Žiedas;Ramunėlės;6703889237;Taip;0;5;0;5
12826;Žiedas;Ramunėlės;7954517383;Taip;0;6;0;6
12827;Žiedas;Ramunėlės;7016509405;Taip;3;0;0;3
12828;Žiedas;Ramunėlės;9247088735;Taip;19;0;0;19
12829;Žiedas;Ramunėlės;9699668892;Taip;9;2;0;11
12830;Žiedas;Ramunėlės;6432090199;Taip;6;2;5;13
12831;Žiedas;Ramunėlės;1139186052;Taip;6;2;3;11
12832;Žiedas;Ramunėlės;5653785844;Taip;0;2;1;3
12833;Žiedas;Ramunėlės;5588136738;Taip;0;7;0;7
12834;Žiedas;Ramunėlės;5626494892;Taip;15;2;2;19
12835;Žiedas;Ramunėlės;2083493509;Taip;0;0;2;2
12836;Žiedas;Ramunėlės;7708360056;Taip;0;9;0;9
12837;Žiedas;Ramunėlės;7396006218;Taip;11;2;0;13
12838;Žiedas;Ramunėlės;3586376571;Taip;6;0;16;22
12839;Žiedas;Ramunėlės;6786526552;Taip;5;2;15;22
12840;Žiedas;Ramunėlės;3702078720;Taip;10;0;2;12
12841;Žiedas;Ramunėlės;2849254119;Taip;0;8;0;8
12842;Žiedas;Pakalnutės;42049755986;Taip;2;1;0;3
12843;Žiedas;Pakalnutės;52721173922;Taip;7;2;0;9
12844;Žiedas;Pakalnutės;2060067625;Taip;0;9;0;9
12845;Žiedas;Pakalnutės;2434909184;Taip;0;3;0;3
12846;Žiedas;Pakalnutės;3616767119;Taip;0;3;0;3
12847;Žiedas;Pakalnutės;1835889494;Taip;11;1;0;12
12848;Žiedas;Pakalnutės;1600420971;Taip;7;4;0;11
12849;Žiedas;Pakalnutės;3930283171;Taip;0;10;0;10
12850;Žiedas;Pakalnutės;1708363648;Taip;6;0;0;6
12851;Žiedas;Pakalnutės;1779122644;Taip;0;4;0;4
12852;Žiedas;Pakalnutės;1200692015;Taip;0;4;0;4
12853;Žiedas;Pakalnutės;1013773415;Taip;0;1;0;1
12854;Žiedas;Pakalnutės;27339844730;Taip;2;8;0;10
12855;Žiedas;Pakalnutės;5812737969;Ne;6;2;0;8
12856;Žiedas;Pakalnutės;1127645903;Ne;19;0;0;19
12857;Žiedas;Pakalnutės;1219022794;Taip;2;10;0;12
12858;Žiedas;Pakalnutės;7647496475;Taip;4;10;0;14
12859;Žiedas;Pakalnutės;1785446716;Ne;2;1;0;3
12860;Žiedas;Pakalnutės;12960180114;Taip;5;4;0;9
12861;Žiedas;Pakalnutės;3346603228;Taip;0;12;0;12
12862;Žiedas;Rožytės;2718046390;Taip;5;6;0;11
12863;Žiedas;Rožytės;1136010138;Taip;0;9;0;9
12864;Žiedas;Rožytės;1618505155;Taip;7;0;0;7
12865;Žiedas;Rožytės;47457128214;Taip;22;0;0;22
12866;Žiedas;Rožytės;40744263923;Taip;0;5;0;5
12867;Žiedas;Rožytės;33135652351;Ne;5;0;0;5
12868;Žiedas;Rožytės;87240375524;Taip;17;0;1;18
12869;Žiedas;Rožytės;1893226570;Taip;2;14;0;16
12870;Žiedas;Rožytės;7283725455;Taip;22;0;0;22
12871;Žiedas;Rožytės;56707734658;Taip;0;0;6;6
12872;Žiedas;Rožytės;2157262849;Taip;0;14;0;14
12873;Žiedas;Rožytės;9757771445;Taip;0;7;0;7
12874;Žiedas;Rožytės;73923918829;Taip;7;0;0;7
12875;Žiedas;Rožytės;4749655084;Taip;0;10;0;10
12876;Žiedas;Rožytės;1772492727;Taip;4;0;4;8
12877;Žiedas;Rožytės;8372385066;Taip;0;0;4;4
12878;Žiedas;Rožytės;3613860509;Taip;3;7;0;10
12879;Žiedas;Rožytės;5537717174;Taip;0;5;0;5
12880;Žiedas;Rožytės;6925923143;Ne;8;8;0;16
12881;Žiedas;Rožytės;1453937876;Taip;4;0;4;8
12882;Žiedas;Rožytės;1781950568;Taip;0;14;0;14
12883;Žiedas;Rožytės;9573180529;Taip;18;0;0;18
12884;Žiedas;Pumpurėliai;9140396365;Taip;0;1;1;2
12885;Žiedas;Pumpurėliai;7097790025;Taip;0;2;0;2
12886;Žiedas;Pumpurėliai;3178778438;Taip;7;7;0;14
12887;Žiedas;Pumpurėliai;6444377924;Taip;0;0;2;2
12888;Žiedas;Pumpurėliai;9587581470;Taip;1;0;0;1
12889;Žiedas;Pumpurėliai;5578227349;Taip;0;0;5;5
12890;Žiedas;Pumpurėliai;5652936425;Taip;0;0;6;6
12891;Žiedas;Pumpurėliai;8812316692;Taip;6;0;0;6
12892;Žiedas;Pumpurėliai;3387263016;Ne;10;0;0;10
12893;Žiedas;Pumpurėliai;3230107921;Ne;0;1;0;1
12894;Žiedas;Pumpurėliai;9602083568;Taip;5;3;2;10
12895;Žiedas;Pumpurėliai;5628720422;Ne;4;1;0;5
12896;Žiedas;Pumpurėliai;1582961378;Ne;5;1;0;6
12897;Žiedas;Pumpurėliai;9020540780;Taip;3;0;5;8
12898;Žiedas;Pumpurėliai;3704491209;Taip;0;1;1;2
12899;Žiedas;Pumpurėliai;6882614465;Taip;0;0;3;3
12900;Žiedas;Pumpurėliai;6914059680;Taip;0;1;1;2
12901;Žiedas;Pumpurėliai;7771247056;Ne;15;0;1;16
12902;Žiedas;Pumpurėliai;6515510381;Taip;3;0;1;4
12903;Žiedas;Pumpurėliai;3842589827;Taip;0;0;4;4
12904;Žiedas;Pumpurėliai;5835309107;Taip;10;0;2;12
12905;Žiedas;Pumpurėliai;3178580610;Ne;5;0;1;6
12906;Žiedas;Pumpurėliai;1878050384;Taip;0;0;6;6
12907;Žiedas;"Dobiliukai ";88471315730;Taip;0;8;0;8
12908;Žiedas;"Dobiliukai ";34193530;Taip;0;12;0;12
12909;Žiedas;"Dobiliukai ";1529988412;Taip;0;1;0;1
12910;Žiedas;"Dobiliukai ";78720591915;Taip;0;1;0;1
12911;Žiedas;"Dobiliukai ";1550350520;Taip;3;0;0;3
12912;Žiedas;"Dobiliukai ";2763469583;Taip;2;0;0;2
12913;Žiedas;"Dobiliukai ";86877563124;Taip;1;3;0;4
12914;Žiedas;"Dobiliukai ";1458152054;Ne;9;0;0;9
12915;Žiedas;"Dobiliukai ";3414702993;Taip;3;1;0;4
12916;Žiedas;"Dobiliukai ";1007894628;Ne;7;12;0;19
12917;Žiedas;"Dobiliukai ";1625009666;Taip;3;7;0;10
12918;Žiedas;"Dobiliukai ";1868951268;Taip;11;1;0;12
12919;Žiedas;"Dobiliukai ";1824692620;Taip;0;5;0;5
12920;Žiedas;"Dobiliukai ";9058688663;Ne;0;4;0;4
12921;Žiedas;"Dobiliukai ";2026728639;Taip;6;0;0;6
12922;Žiedas;"Dobiliukai ";7150433256;Taip;0;7;0;7
12923;Žiedas;"Dobiliukai ";6145720452;Taip;0;3;0;3
12924;Žiedas;"Dobiliukai ";1030089009;Ne;0;7;0;7
12925;Žiedas;"Dobiliukai ";4807479784;Taip;0;2;0;2
12926;Žiedas;"Dobiliukai ";2507543124;Taip;10;12;0;22
12927;Žiedas;"Dobiliukai ";9337128671;Taip;0;1;0;1
12928;Žiedas;RŪTELĖS;5885209631;Taip;10;2;0;12
12929;Žiedas;RŪTELĖS;2134466899;Taip;8;2;3;13
12930;Žiedas;RŪTELĖS;5108263139;Taip;11;0;0;11
12931;Žiedas;RŪTELĖS;6822887260;Taip;9;2;0;11
12932;Žiedas;RŪTELĖS;9352485926;Taip;16;0;0;16
12933;Žiedas;RŪTELĖS;5914428064;Taip;10;8;0;18
12934;Žiedas;RŪTELĖS;3857121753;Taip;0;2;2;4
12935;Žiedas;RŪTELĖS;6443633568;Taip;8;10;0;18
12936;Žiedas;RŪTELĖS;5959899914;Taip;8;2;0;10
12937;Žiedas;RŪTELĖS;7333813704;Ne;0;1;0;1
12938;Žiedas;RŪTELĖS;1048272199;Taip;0;5;0;5
12939;Žiedas;RŪTELĖS;3715928992;Taip;0;0;1;1
12940;Žiedas;RŪTELĖS;6658762922;Taip;0;1;0;1
12941;Žiedas;RŪTELĖS;5703750436;Taip;0;1;0;1
12942;Žiedas;RŪTELĖS;1253833615;Taip;0;6;0;6
12943;Žiedas;RŪTELĖS;7578964555;Ne;6;1;0;7
12944;Žiedas;RŪTELĖS;5126173608;Taip;5;0;0;5
12945;Žiedas;RŪTELĖS;5647232875;Ne;7;2;1;10
12946;Žiedas;RŪTELĖS;7172793351;Ne;0;8;10;18
12947;Žiedas;RŪTELĖS;4497634040;Taip;0;0;2;2
12948;Žiedas;RŪTELĖS;7057747531;Taip;11;2;6;19
12949;Žiedas;RŪTELĖS;1738121071;Taip;9;0;0;9
12950;Žiedas;SAULĖGRĄŽOS;36350993825;Taip;5;3;0;8
12951;Žiedas;SAULĖGRĄŽOS;69245659818;Taip;5;1;0;6
12952;Žiedas;SAULĖGRĄŽOS;2391924358;Taip;0;3;0;3
12953;Žiedas;SAULĖGRĄŽOS;8172222365;Taip;0;1;0;1
12954;Žiedas;SAULĖGRĄŽOS;8753972322;Taip;9;7;0;16
12955;Žiedas;SAULĖGRĄŽOS;3900091129;Taip;0;7;0;7
12956;Žiedas;SAULĖGRĄŽOS;9363714015;Taip;7;6;0;13
12957;Žiedas;SAULĖGRĄŽOS;6964047214;Taip;9;2;0;11
12958;Žiedas;SAULĖGRĄŽOS;3067962647;Ne;0;15;0;15
12959;Žiedas;SAULĖGRĄŽOS;2843328732;Taip;5;1;0;6
12960;Žiedas;SAULĖGRĄŽOS;2515028280;Taip;5;3;0;8
12961;Žiedas;SAULĖGRĄŽOS;1215443920;Taip;0;1;0;1
12962;Žiedas;SAULĖGRĄŽOS;5282211767;Taip;0;5;0;5
12963;Žiedas;SAULĖGRĄŽOS;1583038469;Taip;13;2;0;15
12964;Žiedas;SAULĖGRĄŽOS;8208331527;Taip;0;12;0;12
12965;Žiedas;SAULĖGRĄŽOS;8517250094;Taip;0;0;7;7
12966;Žiedas;SAULĖGRĄŽOS;1318132922;Taip;0;8;0;8
12967;Žiedas;SAULĖGRĄŽOS;6815408748;Taip;5;8;0;13
12968;Žiedas;SAULĖGRĄŽOS;5451923881;Taip;19;2;0;21
12969;Žiedas;SAULĖGRĄŽOS;7136135394;Taip;2;5;0;7
12970;Žiedas;SAULĖGRĄŽOS;1450251779;Ne;0;4;0;4
12971;Žiedas;SAULĖGRĄŽOS;9037835899;Ne;8;0;0;8
12972;Žiedas;RUGIAGĖLĖS;8645771800;Taip;13;0;4;17
12973;Žiedas;RUGIAGĖLĖS;9702211410;Taip;0;5;0;5
12974;Žiedas;RUGIAGĖLĖS;5570910138;Ne;0;3;0;3
12975;Žiedas;RUGIAGĖLĖS;7187176169;Taip;0;7;0;7
12976;Žiedas;RUGIAGĖLĖS;8163645535;Taip;0;0;2;2
12977;Žiedas;RUGIAGĖLĖS;9750690920;Taip;0;8;0;8
12978;Žiedas;RUGIAGĖLĖS;4222689492;Taip;0;2;0;2
12979;Žiedas;RUGIAGĖLĖS;2763996098;Ne;15;0;0;15
12980;Žiedas;RUGIAGĖLĖS;9894489800;Ne;6;0;0;6
12981;Žiedas;RUGIAGĖLĖS;4983852075;Taip;10;0;0;10
12982;Žiedas;RUGIAGĖLĖS;4521161684;Ne;0;4;0;4
12983;Žiedas;RUGIAGĖLĖS;3641595127;Taip;0;1;0;1
12984;Žiedas;RUGIAGĖLĖS;1333233100;Taip;10;0;0;10
12985;Žiedas;RUGIAGĖLĖS;9129315784;Taip;0;13;0;13
12986;Žiedas;RUGIAGĖLĖS;4284627073;Taip;9;0;2;11
12987;Žiedas;RUGIAGĖLĖS;9094287056;Taip;0;0;1;1
12988;Žiedas;RUGIAGĖLĖS;3370495317;Taip;0;8;0;8
12989;Žiedas;RUGIAGĖLĖS;7952899220;Taip;0;15;0;15
12990;Žiedas;RUGIAGĖLĖS;6261847845;Ne;10;0;0;10
12991;Žiedas;RUGIAGĖLĖS;3984607857;Taip;0;0;4;4
12992;Žiedas;RUGIAGĖLĖS;5020148822;Taip;7;0;1;8
12993;Žiedas;RUGIAGĖLĖS;9415269410;Taip;10;0;0;10
12994;Žiedas;RUGIAGĖLĖS;7672879525;Taip;0;4;0;4
12995;Žiedas;Boružėlės;50534384762;Taip;10;0;0;10
12996;Žiedas;Boružėlės;1985949180;Taip;11;0;2;13
12997;Žiedas;Boružėlės;1782429057;Taip;4;1;0;5
12998;Žiedas;Boružėlės;85519253910;Taip;3;0;0;3
12999;Žiedas;Boružėlės;43123840066;Taip;13;1;0;14
13000;Žiedas;Boružėlės;50295529511;Taip;9;1;0;10
13001;Žiedas;Boružėlės;226707253;Taip;0;1;0;1
13002;Žiedas;Boružėlės;4665596321;Taip;0;0;1;1
13003;Žiedas;Boružėlės;39792014616;Ne;0;2;0;2
13004;Žiedas;Boružėlės;65264733887;Ne;5;1;0;6
13005;Žiedas;Boružėlės;56303923223;Taip;1;0;0;1
13006;Žiedas;Boružėlės;29411390190;Ne;6;0;0;6
13007;Žiedas;AGUONĖLĖS;3055218791;Taip;8;1;0;9
13008;Žiedas;AGUONĖLĖS;9218388800;Taip;6;3;0;9
13009;Žiedas;AGUONĖLĖS;1243169901;Taip;6;4;0;10
13010;Žiedas;AGUONĖLĖS;1333555044;Taip;14;0;0;14
13011;Žiedas;AGUONĖLĖS;2682112101;Taip;3;0;0;3
13012;Žiedas;AGUONĖLĖS;5789261620;Taip;12;0;0;12
13013;Žiedas;AGUONĖLĖS;5920211041;Taip;4;0;0;4
13014;Žiedas;AGUONĖLĖS;3168061557;Taip;18;0;0;18
13015;Žiedas;AGUONĖLĖS;4044156905;Taip;3;0;1;4
13016;Žiedas;AGUONĖLĖS;4844442247;Taip;7;1;0;8
13017;Žiedas;AGUONĖLĖS;6884933845;Taip;7;0;0;7
13018;Žiedas;AGUONĖLĖS;7294671324;Taip;7;0;0;7
13019;Žiedas;AGUONĖLĖS;2938302462;Taip;7;0;0;7
13020;Žiedas;AGUONĖLĖS;7869675895;Taip;8;0;0;8
13021;Žiedas;ŽIBUTĖS;8857150598;Taip;10;0;0;10
13022;Žiedas;ŽIBUTĖS;7942276632;Taip;3;2;0;5
13023;Žiedas;ŽIBUTĖS;1011602827;Taip;3;0;0;3
13024;Žiedas;ŽIBUTĖS;6041919197;Taip;10;0;1;11
13025;Žiedas;ŽIBUTĖS;7799489700;Taip;0;15;0;15
13026;Žiedas;ŽIBUTĖS;2932857132;Taip;15;0;0;15
13027;Žiedas;ŽIBUTĖS;2182381160;Taip;0;6;0;6
13028;Žiedas;ŽIBUTĖS;9057761408;Taip;11;0;0;11
13029;Žiedas;ŽIBUTĖS;8822472312;Taip;0;7;0;7
13030;Žiedas;ŽIBUTĖS;9021286246;Taip;0;11;0;11
13031;Žiedas;ŽIBUTĖS;4556559021;Taip;13;0;0;13
13032;Žiedas;ŽIBUTĖS;1777501190;Taip;2;8;0;10
13033;Žiedas;ŽIBUTĖS;1043230748;Taip;4;1;0;5
13034;Žiedas;ŽIBUTĖS;1844621525;Taip;10;1;0;11
13035;Žiogelis;SKRUZDELYTĖS;8819549855;Ne;0;0;1;1
13036;Žiogelis;SKRUZDELYTĖS;4508141956;Taip;0;0;6;6
13037;Žiogelis;SKRUZDELYTĖS;4343510173;Taip;0;12;0;12
13038;Žiogelis;SKRUZDELYTĖS;18018505301;Taip;0;7;0;7
13039;Žiogelis;SKRUZDELYTĖS;3503872654;Taip;0;0;3;3
13040;Žiogelis;SKRUZDELYTĖS;6067622823;Taip;0;0;1;1
13041;Žiogelis;SKRUZDELYTĖS;8702710674;Taip;0;2;0;2
13042;Žiogelis;SKRUZDELYTĖS;4671356872;Taip;9;1;0;10
13043;Žiogelis;SKRUZDELYTĖS;7881358741;Taip;0;8;0;8
13044;Žiogelis;SKRUZDELYTĖS;3609961581;Taip;0;0;1;1
13045;Žiogelis;SKRUZDELYTĖS;64865699245;Taip;0;1;0;1
13046;Žiogelis;SKRUZDELYTĖS;60959051938;Taip;0;0;1;1
13047;Žiogelis;SKRUZDELYTĖS;4445888917;Taip;1;0;0;1
13048;Žiogelis;SKRUZDELYTĖS;6659086172;Ne;5;1;1;7
13049;Žiogelis;SKRUZDELYTĖS;2883732914;Taip;3;2;0;5
13050;Žiogelis;SKRUZDELYTĖS;3189872952;Taip;4;2;0;6
13051;Žiogelis;SKRUZDELYTĖS;9295720241;Taip;14;1;0;15
13052;Žiogelis;SKRUZDELYTĖS;3203359908;Taip;10;0;2;12
13053;Žiogelis;SKRUZDELYTĖS;3320077143;Ne;5;0;4;9
13054;Žiogelis;ŽIRNIUKAI;7704256764;Taip;0;1;0;1
13055;Žiogelis;ŽIRNIUKAI;6701809272;Taip;0;2;0;2
13056;Žiogelis;ŽIRNIUKAI;2233244282;Taip;0;5;0;5
13057;Žiogelis;ŽIRNIUKAI;8675451323;Taip;6;0;2;8
13058;Žiogelis;ŽIRNIUKAI;1660784232;Taip;6;0;3;9
13059;Žiogelis;ŽIRNIUKAI;1320651707;Taip;7;0;0;7
13060;Žiogelis;ŽIRNIUKAI;1235203700;Taip;0;1;1;2
13061;Žiogelis;ŽIRNIUKAI;1551989977;Taip;0;5;0;5
13062;Žiogelis;ŽIRNIUKAI;3310492752;Taip;4;0;0;4
13063;Žiogelis;ŽIRNIUKAI;2366095661;Taip;0;10;2;12
13064;Žiogelis;ŽIRNIUKAI;1320126836;Taip;0;2;0;2
13065;Žiogelis;ŽIRNIUKAI;1442866468;Taip;5;0;0;5
13066;Žiogelis;ŽIRNIUKAI;6697117406;Taip;16;0;0;16
13067;Žiogelis;ŽIRNIUKAI;9862582346;Taip;0;11;0;11
13068;Žiogelis;ŽIRNIUKAI;7087781379;Ne;5;3;0;8
13069;Žiogelis;ŽIRNIUKAI;4015109974;Ne;7;4;0;11
13070;Žiogelis;ŽIRNIUKAI;9406830518;Taip;0;0;3;3
13071;Žiogelis;ŽIRNIUKAI;3910954904;Taip;9;0;0;9
13072;Žiogelis;ŽIRNIUKAI;4713696984;Ne;0;2;2;4
13073;Žiogelis;ŽIRNIUKAI;2028383677;Taip;1;0;0;1
13074;Žiogelis;ŽIRNIUKAI;2704243085;Taip;8;1;0;9
13075;Žiogelis;DOBILĖLIAI;8683148826;Taip;0;10;0;10
13076;Žiogelis;DOBILĖLIAI;3308563362;Taip;0;3;0;3
13077;Žiogelis;DOBILĖLIAI;2117192553;Taip;0;0;2;2
13078;Žiogelis;DOBILĖLIAI;3928697936;Taip;1;0;5;6
13079;Žiogelis;DOBILĖLIAI;1190395481;Taip;0;0;3;3
13080;Žiogelis;DOBILĖLIAI;1465027680;Taip;0;0;3;3
13081;Žiogelis;DOBILĖLIAI;6495456608;Taip;0;3;0;3
13082;Žiogelis;DOBILĖLIAI;5364996984;Taip;10;0;0;10
13083;Žiogelis;DOBILĖLIAI;9568208184;Taip;10;0;0;10
13084;Žiogelis;DOBILĖLIAI;6340620973;Taip;0;0;1;1
13085;Žiogelis;DOBILĖLIAI;7630342576;Ne;5;0;2;7
13086;Žiogelis;DOBILĖLIAI;6532218580;Taip;3;0;0;3
13087;Žiogelis;DOBILĖLIAI;1763070523;Ne;5;0;0;5
13088;Žiogelis;DOBILĖLIAI;5911231906;Taip;11;0;0;11
13089;Žiogelis;DOBILĖLIAI;1609336147;Taip;0;0;1;1
13090;Žiogelis;DOBILĖLIAI;9610249055;Taip;0;0;1;1
13091;Žiogelis;DOBILĖLIAI;3887222613;Taip;0;4;0;4
13092;Žiogelis;DOBILĖLIAI;7065052244;Taip;12;0;0;12
13093;Žiogelis;BORUŽĖLĖS;54446173105;Taip;1;0;0;1
13094;Žiogelis;BORUŽĖLĖS;4776403513;Taip;6;0;0;6
13095;Žiogelis;BORUŽĖLĖS;1617516552;Taip;5;2;0;7
13096;Žiogelis;BORUŽĖLĖS;81608736626;Taip;0;1;0;1
13097;Žiogelis;BORUŽĖLĖS;4465151986;Taip;0;2;0;2
13098;Žiogelis;BORUŽĖLĖS;6963163354;Taip;1;4;1;6
13099;Žiogelis;BORUŽĖLĖS;98660118094;Taip;0;7;0;7
13100;Žiogelis;BORUŽĖLĖS;67475530006;Ne;0;3;0;3
13101;Žiogelis;BORUŽĖLĖS;8169022043;Taip;0;2;0;2
13102;Žiogelis;BORUŽĖLĖS;5639046412;Ne;0;4;0;4
13103;Žiogelis;BORUŽĖLĖS;65387706999;Ne;0;2;0;2
13104;Žiogelis;BORUŽĖLĖS;45051106222;Taip;15;2;0;17
13105;Žiogelis;BORUŽĖLĖS;39293593638;Taip;0;8;1;9
13106;Žiogelis;BORUŽĖLĖS;49836275638;Taip;0;3;0;3
13107;Žiogelis;BORUŽĖLĖS;14932261911;Taip;2;4;0;6
13108;Žiogelis;BORUŽĖLĖS;48896172781;Taip;0;4;0;4
13109;Žiogelis;BORUŽĖLĖS;29876596658;Taip;0;4;0;4
13110;Žiogelis;BORUŽĖLĖS;63956907259;Taip;0;6;0;6
13111;Žiogelis;BORUŽĖLĖS;30488905109;Ne;0;3;0;3
13112;Žiogelis;BORUŽĖLĖS;84919810287;Taip;0;6;0;6
13113;Žiogelis;BORUŽĖLĖS;73793165310;Taip;10;2;0;12
13114;Žiogelis;BORUŽĖLĖS;28788742249;Taip;10;2;0;12
13115;Žiogelis;BORUŽĖLĖS;87755643169;Taip;0;3;0;3
13116;Žiogelis;BORUŽĖLĖS;5072204356;Taip;5;0;0;5
13117;Žiogelis;DRUGELIAI;40049935108;Taip;0;5;0;5
13118;Žiogelis;DRUGELIAI;37505015919;Taip;5;0;1;6
13119;Žiogelis;DRUGELIAI;25631779076;Taip;0;3;0;3
13120;Žiogelis;DRUGELIAI;91499233609;Taip;0;0;3;3
13121;Žiogelis;DRUGELIAI;40186714037;Taip;0;1;0;1
13122;Žiogelis;DRUGELIAI;52847485981;Taip;1;2;3;6
13123;Žiogelis;DRUGELIAI;96369154198;Ne;0;0;2;2
13124;Žiogelis;DRUGELIAI;56579227266;Ne;0;0;2;2
13125;Žiogelis;DRUGELIAI;66037746045;Taip;0;8;0;8
13126;Žiogelis;DRUGELIAI;68621438109;Taip;0;0;2;2
13127;Žiogelis;DRUGELIAI;18957711548;Taip;0;2;0;2
13128;Žiogelis;DRUGELIAI;52855728176;Ne;0;4;0;4
13129;Žiogelis;DRUGELIAI;35609682774;Taip;0;0;4;4
13130;Žiogelis;DRUGELIAI;1096666450;Taip;0;0;2;2
13131;Žiogelis;DRUGELIAI;1237788562;Taip;0;4;0;4
13132;Žiogelis;DRUGELIAI;1867019234;Taip;0;3;0;3
13133;Žiogelis;DRUGELIAI;1082983134;Taip;0;0;1;1
13134;Žiogelis;DRUGELIAI;97696839366;Taip;3;0;0;3
13135;Žiogelis;DRUGELIAI;2853980993;Taip;5;0;0;5
13136;Žiogelis;DRUGELIAI;6980862023;Taip;0;0;2;2
13137;Žiogelis;DRUGELIAI;52901528922;Taip;0;2;0;2
13138;Žiogelis;DRUGELIAI;63719135594;Ne;0;7;0;7
13139;Žiogelis;DRUGELIAI;5975060180;Taip;4;0;1;5
13140;Žiogelis;PELĖDŽIUKAI;40656416455;Taip;0;2;4;6
13141;Žiogelis;PELĖDŽIUKAI;58435832422;Taip;0;9;0;9
13142;Žiogelis;PELĖDŽIUKAI;65431295185;Taip;0;5;0;5
13143;Žiogelis;PELĖDŽIUKAI;54157468880;Taip;5;2;0;7
13144;Žiogelis;PELĖDŽIUKAI;90856268042;Taip;0;2;0;2
13145;Žiogelis;PELĖDŽIUKAI;4546122149;Taip;0;1;0;1
13146;Žiogelis;PELĖDŽIUKAI;677032532;Taip;0;1;0;1
13147;Žiogelis;PELĖDŽIUKAI;75990939732;Taip;4;0;0;4
13148;Žiogelis;PELĖDŽIUKAI;99706324340;Taip;0;1;0;1
13149;Žiogelis;PELĖDŽIUKAI;87136010729;Taip;0;1;0;1
13150;Žiogelis;PELĖDŽIUKAI;88467192459;Taip;7;9;0;16
13151;Žiogelis;PELĖDŽIUKAI;23052639699;Taip;9;0;0;9
13152;Žiogelis;PELĖDŽIUKAI;9520854450;Taip;0;2;2;4
13153;Žiogelis;PELĖDŽIUKAI;46938187629;Taip;0;2;0;2
13154;Žiogelis;PELĖDŽIUKAI;65284631135;Taip;2;2;0;4
13155;Žiogelis;PELĖDŽIUKAI;1303123383;Taip;0;1;0;1
13156;Žiogelis;PELĖDŽIUKAI;62633906174;Taip;0;2;0;2
13157;Žiogelis;PELĖDŽIUKAI;2100993889;Ne;0;2;0;2
13158;Žiogelis;PELĖDŽIUKAI;82738581846;Taip;0;2;0;2
13159;Žiogelis;PELĖDŽIUKAI;80050087040;Taip;0;16;0;16
13160;Žiogelis;VARPELIAI;63443494015;Taip;6;0;0;6
13161;Žiogelis;VARPELIAI;1069475442;Ne;0;3;0;3
13162;Žiogelis;VARPELIAI;1198917418;Taip;0;11;0;11
13163;Žiogelis;VARPELIAI;44118139818;Taip;7;2;0;9
13164;Žiogelis;VARPELIAI;7708273984;Taip;0;8;0;8
13165;Žiogelis;VARPELIAI;12932356909;Taip;3;1;0;4
13166;Žiogelis;VARPELIAI;1060830668;Taip;19;1;0;20
13167;Žiogelis;VARPELIAI;9871477318;Taip;3;1;0;4
13168;Žiogelis;VARPELIAI;6225523016;Taip;6;4;0;10
13169;Žiogelis;VARPELIAI;4402777236;Taip;12;2;0;14
13170;Žiogelis;VARPELIAI;1370071592;Taip;0;6;0;6
13171;Žiogelis;VARPELIAI;9416538794;Taip;5;2;0;7
13172;Žiogelis;VARPELIAI;7888873296;Taip;4;2;0;6
13173;Žiogelis;VARPELIAI;9032003195;Ne;0;3;0;3
13174;Žiogelis;VARPELIAI;8262619320;Taip;0;1;0;1
13175;Žiogelis;VARPELIAI;1837140329;Ne;2;1;0;3
13176;Žiogelis;VARPELIAI;8983731310;Taip;0;3;0;3
13177;Žiogelis;VARPELIAI;7493919076;Taip;16;0;0;16
13178;Žiogelis;KREGŽDUTĖS;20399291813;Taip;0;6;0;6
13179;Žiogelis;KREGŽDUTĖS;1521276302;Taip;0;4;0;4
13180;Žiogelis;KREGŽDUTĖS;52932005977;Taip;0;3;0;3
13181;Žiogelis;KREGŽDUTĖS;28585504631;Taip;6;0;3;9
13182;Žiogelis;KREGŽDUTĖS;71387182665;Ne;15;7;0;22
13183;Žiogelis;KREGŽDUTĖS;94690046398;Taip;0;1;1;2
13184;Žiogelis;KREGŽDUTĖS;88933947850;Taip;0;0;3;3
13185;Žiogelis;KREGŽDUTĖS;22969768169;Taip;0;9;0;9
13186;Žiogelis;KREGŽDUTĖS;18304908981;Taip;0;1;0;1
13187;Žiogelis;KREGŽDUTĖS;1042591705;Taip;0;2;0;2
13188;Žiogelis;KREGŽDUTĖS;1160064257;Taip;0;1;0;1
13189;Žiogelis;KREGŽDUTĖS;1162630845;Taip;0;1;1;2
13190;Žiogelis;KREGŽDUTĖS;2072071751;Taip;0;0;1;1
13191;Žiogelis;KREGŽDUTĖS;1200247527;Taip;0;1;5;6
13192;Žiogelis;KREGŽDUTĖS;41448152472;Taip;0;1;1;2
13193;Žiogelis;KREGŽDUTĖS;44023584723;Taip;0;1;2;3
13194;Žiogelis;KREGŽDUTĖS;1915370991;Taip;0;11;0;11
13195;Žiogelis;KREGŽDUTĖS;1821759690;Ne;0;8;0;8
13196;Žiogelis;KREGŽDUTĖS;24010106626;Taip;0;13;0;13
13197;Žiogelis;KREGŽDUTĖS;2062794337;Ne;10;0;0;10
13198;Žiogelis;KREGŽDUTĖS;3802615302;Taip;10;1;0;11
13199;Žiogelis;KREGŽDUTĖS;84803452318;Taip;0;4;0;4
13200;Žiogelis;KREGŽDUTĖS;10001742134;Taip;0;1;1;2
13201;Žiogelis;ŽVIRBLIUKAI;4156736676;Taip;9;0;0;9
13202;Žiogelis;ŽVIRBLIUKAI;4565342104;Taip;0;0;3;3
13203;Žiogelis;ŽVIRBLIUKAI;8894068297;Taip;6;0;1;7
13204;Žiogelis;ŽVIRBLIUKAI;4609861306;Taip;5;0;0;5
13205;Žiogelis;ŽVIRBLIUKAI;9387048672;Taip;14;0;0;14
13206;Žiogelis;ŽVIRBLIUKAI;7502572217;Taip;6;0;2;8
13207;Žiogelis;ŽVIRBLIUKAI;1939672072;Taip;5;0;0;5
13208;Žiogelis;ŽVIRBLIUKAI;2759766559;Taip;5;0;0;5
13209;Žiogelis;ŽVIRBLIUKAI;1134384178;Taip;5;1;0;6
13210;Žiogelis;ŽVIRBLIUKAI;8689074067;Taip;5;0;0;5
13211;Žiogelis;ŽVIRBLIUKAI;7128248940;Taip;0;0;6;6
13212;Žiogelis;ŽVIRBLIUKAI;3963308094;Taip;2;0;0;2
13213;Žiogelis;ŽVIRBLIUKAI;9250789113;Taip;0;2;0;2
13214;Žiogelis;ŽVIRBLIUKAI;8217782981;Taip;9;2;0;11
13215;Žiogelis;ŽVIRBLIUKAI;5876904663;Taip;12;0;0;12
13216;Žiogelis;BITUTĖS;3752355139;Taip;14;1;2;17
13217;Žiogelis;BITUTĖS;4605250897;Taip;0;2;0;2
13218;Žiogelis;BITUTĖS;6942029629;Ne;0;1;1;2
13219;Žiogelis;BITUTĖS;2173494736;Taip;0;1;1;2
13220;Žiogelis;BITUTĖS;3420228264;Taip;0;1;1;2
13221;Žiogelis;BITUTĖS;5042341085;Taip;0;3;0;3
13222;Žiogelis;BITUTĖS;9627583831;Taip;9;5;0;14
13223;Žiogelis;BITUTĖS;3296450902;Taip;0;2;0;2
13224;Žiogelis;BITUTĖS;2455244286;Taip;0;3;0;3
13225;Žiogelis;BITUTĖS;3792114246;Taip;0;4;0;4
13226;Žiogelis;BITUTĖS;9981130790;Taip;20;1;0;21
13227;Žiogelis;BITUTĖS;8293687695;Taip;0;7;0;7
13228;Žiogelis;BITUTĖS;3820534331;Taip;5;2;0;7
13229;Žiogelis;BITUTĖS;1996517542;Ne;7;5;0;12
13230;Žiogelis;BITUTĖS;5545581078;Taip;0;7;0;7
13231;Žiogelis;BITUTĖS;4630381709;Taip;0;7;0;7
13232;Žiogelis;BITUTĖS;9790463889;Taip;0;13;0;13
13233;Žiogelis;BITUTĖS;6024752960;Taip;10;2;0;12
13234;Žiogelis;BITUTĖS;8853905367;Taip;10;2;0;12
13235;Žiogelis;BITUTĖS;1397686161;Taip;0;1;0;1
13236;Žiogelis;BITUTĖS;2171351454;Taip;0;1;1;2
13237;Žiogelis;BITUTĖS;6760074113;Taip;2;1;1;4
13238;Žiogelis;RIEŠUTĖLIAI;6378295945;Taip;12;0;0;12
13239;Žiogelis;RIEŠUTĖLIAI;6308141378;Taip;10;0;0;10
13240;Žiogelis;RIEŠUTĖLIAI;1268908081;Taip;6;2;0;8
13241;Žiogelis;RIEŠUTĖLIAI;1828843135;Taip;5;0;0;5
13242;Žiogelis;RIEŠUTĖLIAI;1618384759;Taip;2;1;0;3
13243;Žiogelis;RIEŠUTĖLIAI;3856321373;Taip;6;0;0;6
13244;Žiogelis;RIEŠUTĖLIAI;7310459638;Taip;0;3;0;3
13245;Žiogelis;RIEŠUTĖLIAI;4513613915;Taip;0;1;0;1
13246;Žiogelis;RIEŠUTĖLIAI;8712788346;Taip;12;1;0;13
13247;Žiogelis;RIEŠUTĖLIAI;9813150014;Taip;8;1;0;9
13248;Žiogelis;RIEŠUTĖLIAI;9874412804;Taip;3;2;0;5
13249;Žolynėlis;Spanguolėlė;1920564803;Ne;8;0;0;8
13250;Žolynėlis;Spanguolėlė;92615552899;Taip;0;1;0;1
13251;Žolynėlis;Spanguolėlė;5717038791;Taip;0;2;1;3
13252;Žolynėlis;Spanguolėlė;15306882704;Taip;0;1;0;1
13253;Žolynėlis;Spanguolėlė;9128728457;Taip;0;9;0;9
13254;Žolynėlis;Spanguolėlė;1216568014;Taip;0;7;0;7
13255;Žolynėlis;Spanguolėlė;7438853916;Ne;7;6;0;13
13256;Žolynėlis;Spanguolėlė;44063150309;Taip;0;3;2;5
13257;Žolynėlis;Spanguolėlė;7831076713;Ne;5;1;0;6
13258;Žolynėlis;Spanguolėlė;1901979061;Ne;4;2;2;8
13259;Žolynėlis;"RŪTELĖ (spec)";48837362422;Taip;10;8;0;18
13260;Žolynėlis;"RŪTELĖ (spec)";88879292846;Taip;0;6;2;8
13261;Žolynėlis;"RŪTELĖ (spec)";1954888655;Taip;0;8;0;8
13262;Žolynėlis;"RŪTELĖ (spec)";1916465295;Taip;5;0;1;6
13263;Žolynėlis;"RŪTELĖ (spec)";6678697536;Taip;7;0;0;7
13264;Žolynėlis;"SAULUTĖ (spec)";89488434450;Ne;22;0;0;22
13265;Žolynėlis;"SAULUTĖ (spec)";1153167430;Taip;0;1;0;1
13266;Žolynėlis;"SAULUTĖ (spec)";4438939800;Taip;0;0;2;2
13267;Žolynėlis;"LINELIS (spec)";93519259505;Taip;0;1;0;1
13268;Žolynėlis;"LINELIS (spec)";7717415005;Taip;0;10;0;10
13269;Žolynėlis;"LINELIS (spec)";2665355759;Taip;0;10;0;10
13270;Žolynėlis;"LINELIS (spec)";6080154964;Taip;7;2;0;9
13271;Žolynėlis;"RASAKILA (spec)";3337602618;Ne;2;0;0;2
13272;Žolynėlis;"RASAKILA (spec)";2913607286;Taip;22;0;0;22
13273;Žolynėlis;"RASAKILA (spec)";2511678193;Taip;10;1;0;11
13274;Žolynėlis;Dobiliukai;59125596894;Taip;0;4;0;4
13275;Žolynėlis;Dobiliukai;1655571687;Taip;5;13;0;18
13276;Žolynėlis;Dobiliukai;89750778560;Taip;0;2;2;4
13277;Žolynėlis;Dobiliukai;76688557717;Taip;5;2;0;7
13278;Žolynėlis;Dobiliukai;75335374706;Taip;0;3;0;3
13279;Žolynėlis;Dobiliukai;39450377869;Taip;0;1;0;1
13280;Žolynėlis;Dobiliukai;1933377698;Taip;0;1;0;1
13281;Žolynėlis;Aguonėlė;7313345140;Taip;0;1;0;1
13282;Žolynėlis;Aguonėlė;1620578562;Taip;0;9;0;9
13283;Žolynėlis;Aguonėlė;77707724932;Taip;0;1;0;1
13284;Žolynėlis;Aguonėlė;4545601535;Taip;0;4;0;4
13285;Žolynėlis;Aguonėlė;95007685205;Taip;0;1;0;1
13286;Žolynėlis;Aguonėlė;61475380296;Taip;0;8;0;8
13287;Žolynėlis;Aguonėlė;8027151284;Taip;0;2;5;7
13288;Žolynėlis;Aguonėlė;28730145668;Taip;0;0;3;3
13289;Žolynėlis;Aguonėlė;14877714964;Taip;0;2;0;2
13290;Žolynėlis;Aguonėlė;84849092452;Taip;0;2;2;4
13291;Žolynėlis;Aguonėlė;3263848791;Taip;0;1;6;7
13292;Žolynėlis;Aguonėlė;7256502393;Taip;0;2;1;3
13293;Žolynėlis;Aguonėlė;79704789499;Taip;0;2;4;6
13294;Žolynėlis;Aguonėlė;2881461471;Taip;0;2;1;3
13295;Žolynėlis;Pienė;3520272555;Taip;0;8;0;8
13296;Žolynėlis;Pienė;2108221942;Taip;0;8;0;8
13297;Žolynėlis;Pienė;2934361190;Taip;7;11;0;18
13298;Žolynėlis;Pienė;7980206574;Taip;0;2;1;3
13299;Žolynėlis;Pienė;2460982987;Taip;0;0;4;4
13300;Žolynėlis;Pienė;8215427354;Ne;0;13;0;13
13301;Žolynėlis;Pienė;1485195267;Taip;0;2;5;7
13302;Žolynėlis;Pienė;1163753820;Ne;5;0;0;5
13303;Žolynėlis;Pienė;9106152447;Taip;0;4;0;4
13304;Žolynėlis;Pienė;1879046798;Taip;3;0;1;4
13305;Žolynėlis;Pienė;7827343027;Taip;0;0;14;14
13306;Žolynėlis;Čiobreliai;4379062413;Taip;0;9;0;9
13307;Žolynėlis;Čiobreliai;96960531652;Taip;0;2;0;2
13308;Žolynėlis;Čiobreliai;67610580721;Taip;10;5;0;15
13309;Žolynėlis;Čiobreliai;91866724044;Taip;0;13;0;13
13310;Žolynėlis;Čiobreliai;58271736414;Taip;0;4;0;4
13311;Žolynėlis;Čiobreliai;1123243743;Taip;3;2;0;5
13312;Žolynėlis;Čiobreliai;79759781705;Taip;0;1;0;1
13313;Žolynėlis;Čiobreliai;1833898567;Taip;0;1;0;1
13314;Žolynėlis;Čiobreliai;29420971822;Ne;0;1;0;1
13315;Žolynėlis;Čiobreliai;1080834237;Taip;4;0;0;4
13316;Žolynėlis;Čiobreliai;1619061427;Ne;6;0;0;6
13317;Žolynėlis;Čiobreliai;8104525380;Taip;0;2;0;2
13318;Žolynėlis;Čiobreliai;5901704055;Taip;0;6;0;6
13319;Žolynėlis;Čiobreliai;24353356454;Taip;0;3;0;3
13320;Žolynėlis;Čiobreliai;82641799101;Taip;6;3;0;9
13321;Žolynėlis;Čiobreliai;95943166746;Taip;5;0;0;5
13322;Žolynėlis;Čiobreliai;4109395683;Taip;0;4;0;4
13323;Žolynėlis;Čiobreliai;2984354887;Taip;0;5;0;5
13324;Žolynėlis;Čiobreliai;66167062016;Taip;0;2;0;2
13325;Žolynėlis;Čiobreliai;2051626484;Taip;0;5;0;5
13326;Žolynėlis;Avietėlė;1337138547;Taip;0;1;0;1
13327;Žolynėlis;Avietėlė;4618251201;Ne;5;17;0;22
13328;Žolynėlis;Avietėlė;5432464074;Taip;0;2;0;2
13329;Žolynėlis;Avietėlė;3192462197;Ne;6;7;0;13
13330;Žolynėlis;Avietėlė;1189484802;Taip;0;2;0;2
13331;Žolynėlis;Avietėlė;3984024179;Taip;1;2;0;3
13332;Žolynėlis;Avietėlė;3149718901;Taip;0;2;13;15
13333;Žolynėlis;Avietėlė;6829144389;Taip;0;2;4;6
13334;Žolynėlis;Avietėlė;6416217971;Taip;15;2;0;17
13335;Žolynėlis;Avietėlė;8646095992;Taip;2;2;0;4
13336;Žolynėlis;Avietėlė;3877168024;Taip;6;13;2;21
13337;Žolynėlis;Avietėlė;9238832484;Taip;10;3;1;14
13338;Žolynėlis;Rugiagėlė;1590210772;Taip;0;2;0;2
13339;Žolynėlis;Rugiagėlė;1997927874;Taip;5;4;0;9
13340;Žolynėlis;Rugiagėlė;1223126521;Ne;10;6;0;16
13341;Žolynėlis;Rugiagėlė;8547773739;Taip;0;6;0;6
13342;Žolynėlis;Rugiagėlė;25487230804;Taip;1;2;0;3
13343;Žolynėlis;Rugiagėlė;7870236961;Taip;0;17;0;17
13344;Žolynėlis;Rugiagėlė;3198470147;Taip;0;2;0;2
13345;Žolynėlis;Rugiagėlė;3422605135;Taip;0;6;0;6
13346;Žolynėlis;Rugiagėlė;5650427433;Taip;5;10;0;15
13347;Žolynėlis;Rugiagėlė;1473516753;Taip;0;10;0;10
13348;Žolynėlis;Rugiagėlė;9997358375;Taip;7;0;0;7
13349;Žolynėlis;Rugiagėlė;4758738231;Taip;8;7;0;15
13350;Žolynėlis;Rugiagėlė;8378313810;Taip;10;6;0;16
13351;Žolynėlis;Rugiagėlė;9926551617;Taip;5;0;2;7
13352;Žuvėdra;"JŪROS ŽVAIGŽDUTĖS";3516571980;Taip;3;0;4;7
13353;Žuvėdra;"JŪROS ŽVAIGŽDUTĖS";8096854841;Taip;0;0;5;5
13354;Žuvėdra;"JŪROS ŽVAIGŽDUTĖS";3148638780;Taip;0;13;0;13
13355;Žuvėdra;"JŪROS ŽVAIGŽDUTĖS";7673681906;Taip;7;0;0;7
13356;Žuvėdra;"JŪROS ŽVAIGŽDUTĖS";6148764075;Taip;0;1;0;1
13357;Žuvėdra;"JŪROS ŽVAIGŽDUTĖS";97427805302;Taip;0;0;1;1
13358;Žuvėdra;"JŪROS ŽVAIGŽDUTĖS";8349985186;Taip;5;0;0;5
13359;Žuvėdra;"JŪROS ŽVAIGŽDUTĖS";29500668582;Taip;0;0;6;6
13360;Žuvėdra;"JŪROS ŽVAIGŽDUTĖS";4828788876;Taip;0;6;0;6
13361;Žuvėdra;"JŪROS ŽVAIGŽDUTĖS";6068515077;Taip;0;8;0;8
13362;Žuvėdra;"JŪROS ŽVAIGŽDUTĖS";8104921853;Taip;0;1;0;1
13363;Žuvėdra;"JŪROS ŽVAIGŽDUTĖS";87882215162;Taip;0;1;7;8
13364;Žuvėdra;"JŪROS ŽVAIGŽDUTĖS";34574939898;Taip;7;1;0;8
13365;Žuvėdra;"JŪROS ŽVAIGŽDUTĖS";11300891895;Taip;0;8;0;8
13366;Žuvėdra;"JŪROS ŽVAIGŽDUTĖS";8843700949;Ne;0;2;0;2
13367;Žuvėdra;"JŪROS ŽVAIGŽDUTĖS";5472830961;Ne;9;0;0;9
13368;Žuvėdra;DELFINUKAI;1938808693;Taip;0;7;1;8
13369;Žuvėdra;DELFINUKAI;2334342995;Ne;0;1;0;1
13370;Žuvėdra;DELFINUKAI;5558584030;Taip;0;11;0;11
13371;Žuvėdra;DELFINUKAI;5049101816;Ne;12;3;0;15
13372;Žuvėdra;DELFINUKAI;9230342970;Taip;7;0;0;7
13373;Žuvėdra;DELFINUKAI;3620753237;Taip;0;9;0;9
13374;Žuvėdra;DELFINUKAI;2462839180;Ne;2;0;1;3
13375;Žuvėdra;DELFINUKAI;2660909247;Taip;5;0;0;5
13376;Žuvėdra;DELFINUKAI;8822952385;Ne;0;0;3;3
13377;Žuvėdra;DELFINUKAI;2092890028;Taip;5;0;6;11
13378;Žuvėdra;DELFINUKAI;7916717208;Taip;5;0;1;6
13379;Žuvėdra;DELFINUKAI;1311162040;Ne;0;9;0;9
13380;Žuvėdra;DELFINUKAI;9870595577;Taip;15;0;0;15
13381;Žuvėdra;DELFINUKAI;6294045755;Taip;0;4;0;4
13382;Žuvėdra;DELFINUKAI;3068069755;Taip;3;5;0;8
13383;Žuvėdra;DELFINUKAI;1200084485;Taip;5;7;0;12
13384;Žuvėdra;DELFINUKAI;2694424532;Taip;5;0;5;10
13385;Žuvėdra;DELFINUKAI;4177319374;Taip;6;0;3;9
13386;Žuvėdra;OSMINOŽKI;1762760384;Taip;0;1;0;1
13387;Žuvėdra;OSMINOŽKI;1963584073;Taip;3;4;0;7
13388;Žuvėdra;OSMINOŽKI;2136463079;Taip;0;1;1;2
13389;Žuvėdra;OSMINOŽKI;74446494235;Taip;0;10;0;10
13390;Žuvėdra;OSMINOŽKI;1639340750;Taip;0;1;0;1
13391;Žuvėdra;OSMINOŽKI;3487938908;Ne;7;0;0;7
13392;Žuvėdra;OSMINOŽKI;66236924555;Taip;7;0;0;7
13393;Žuvėdra;OSMINOŽKI;66973380124;Ne;18;1;0;19
13394;Žuvėdra;OSMINOŽKI;4588593273;Taip;10;0;5;15
13395;Žuvėdra;OSMINOŽKI;55687216943;Ne;4;3;0;7
13396;Žuvėdra;OSMINOŽKI;1236696072;Taip;0;1;1;2
13397;Žuvėdra;OSMINOŽKI;1203660127;Taip;0;11;0;11
13398;Žuvėdra;OSMINOŽKI;9911525172;Taip;0;2;0;2
13399;Žuvėdra;OSMINOŽKI;24915726868;Taip;5;0;0;5
13400;Žuvėdra;OSMINOŽKI;1116645502;Taip;8;0;0;8
13401;Žuvėdra;OSMINOŽKI;1195732987;Ne;3;5;0;8
13402;Žuvėdra;OSMINOŽKI;1312918359;Taip;5;9;0;14
13403;Žuvėdra;OSMINOŽKI;1923452638;Taip;0;0;3;3
13404;Žuvėdra;OSMINOŽKI;6468506668;Ne;5;1;0;6
13405;Žuvėdra;OSMINOŽKI;83890207087;Taip;0;10;0;10
13406;Žuvėdra;RUSALAČKA;8408371550;Taip;15;0;0;15
13407;Žuvėdra;RUSALAČKA;2731016281;Taip;11;5;0;16
13408;Žuvėdra;RUSALAČKA;1164464390;Ne;0;6;0;6
13409;Žuvėdra;RUSALAČKA;1340241206;Taip;10;4;0;14
13410;Žuvėdra;RUSALAČKA;5021263583;Taip;5;2;0;7
13411;Žuvėdra;RUSALAČKA;5489757084;Taip;0;3;0;3
13412;Žuvėdra;RUSALAČKA;14760907606;Taip;7;0;4;11
13413;Žuvėdra;RUSALAČKA;1632308084;Taip;9;0;0;9
13414;Žuvėdra;RUSALAČKA;4011849839;Taip;0;8;0;8
13415;Žuvėdra;RUSALAČKA;75901332720;Taip;0;1;0;1
13416;Žuvėdra;RUSALAČKA;5684848140;Taip;15;1;0;16
13417;Žuvėdra;RUSALAČKA;6612880861;Taip;5;3;0;8
13418;Žuvėdra;RUSALAČKA;1941428466;Ne;0;1;0;1
13419;Žuvėdra;RUSALAČKA;63053155507;Taip;0;4;0;4
13420;Žuvėdra;RUSALAČKA;3853045274;Taip;0;5;0;5
13421;Žuvėdra;RUSALAČKA;6537464526;Taip;5;5;0;10
13422;Žuvėdra;RUSALAČKA;5674529681;Taip;12;0;0;12
13423;Žuvėdra;RUSALAČKA;7630057671;Taip;3;0;0;3
13424;Žuvėdra;RUSALAČKA;7368183516;Taip;0;3;0;3
13425;Žuvėdra;RUSALAČKA;3185158741;Taip;8;0;0;8
13426;Žuvėdra;RUSALAČKA;5198825127;Taip;17;0;0;17
13427;Žuvėdra;RUSALAČKA;5561903903;Taip;0;22;0;22
13428;Žuvėdra;JANTARIKI;4715123063;Taip;0;4;0;4
13429;Žuvėdra;JANTARIKI;2582404760;Taip;0;2;0;2
13430;Žuvėdra;JANTARIKI;3613045982;Taip;2;0;0;2
13431;Žuvėdra;JANTARIKI;1509519996;Taip;6;0;0;6
13432;Žuvėdra;JANTARIKI;5151984122;Taip;0;1;0;1
13433;Žuvėdra;JANTARIKI;2987217910;Taip;2;0;0;2
13434;Žuvėdra;JANTARIKI;3349158713;Taip;1;0;0;1
13435;Žuvėdra;JANTARIKI;4702627979;Taip;0;1;0;1
13436;Žuvėdra;"AUKSINĖ ŽUVELĖ";1343293430;Taip;6;0;0;6
13437;Žuvėdra;"AUKSINĖ ŽUVELĖ";6324315523;Taip;5;11;0;16
13438;Žuvėdra;"AUKSINĖ ŽUVELĖ";7121154799;Taip;6;0;0;6
13439;Žuvėdra;"AUKSINĖ ŽUVELĖ";5744370516;Taip;0;0;1;1
13440;Žuvėdra;"AUKSINĖ ŽUVELĖ";5571732399;Taip;6;0;0;6
13441;Žuvėdra;"AUKSINĖ ŽUVELĖ";8472945857;Taip;0;1;0;1
13442;Žuvėdra;"AUKSINĖ ŽUVELĖ";7958768355;Ne;10;0;0;10
13443;Žuvėdra;"AUKSINĖ ŽUVELĖ";8185190219;Taip;7;0;0;7
13444;Žuvėdra;"AUKSINĖ ŽUVELĖ";8700802853;Taip;4;1;0;5
13445;Žuvėdra;"AUKSINĖ ŽUVELĖ";9485995178;Taip;0;8;0;8
13446;Žuvėdra;"AUKSINĖ ŽUVELĖ";5436158437;Taip;7;0;0;7
13447;Žuvėdra;"AUKSINĖ ŽUVELĖ";8599646291;Taip;8;1;0;9
13448;Žuvėdra;"AUKSINĖ ŽUVELĖ";9521104462;Taip;0;2;1;3
13449;Žuvėdra;"AUKSINĖ ŽUVELĖ";2849503557;Taip;4;0;1;5
13450;Žuvėdra;"AUKSINĖ ŽUVELĖ";8162649794;Taip;8;0;0;8
13451;Žuvėdra;"AUKSINĖ ŽUVELĖ";6952843736;Taip;6;0;0;6
13452;Žvangutis;PELIUKŲ;6701947168;Taip;0;1;0;1
13453;Žvangutis;PELIUKŲ;50889154641;Taip;7;0;0;7
13454;Žvangutis;PELIUKŲ;1165172787;Ne;10;0;1;11
13455;Žvangutis;PELIUKŲ;7202747419;Taip;0;0;3;3
13456;Žvangutis;PELIUKŲ;7320625500;Taip;0;13;0;13
13457;Žvangutis;PELIUKŲ;3513746926;Taip;11;0;5;16
13458;Žvangutis;PELIUKŲ;9408369641;Ne;0;0;3;3
13459;Žvangutis;PELIUKŲ;6110958520;Taip;9;0;3;12
13460;Žvangutis;PELIUKŲ;8288997508;Ne;0;4;0;4
13461;Žvangutis;PELIUKŲ;3817258555;Taip;0;2;0;2
13462;Žvangutis;PELIUKŲ;6844824726;Ne;0;16;0;16
13463;Žvangutis;PELIUKŲ;3315858185;Taip;22;0;0;22
13464;Žvangutis;PELIUKŲ;92356998180;Taip;0;0;2;2
13465;Žvangutis;PELIUKŲ;5683601025;Taip;7;0;0;7
13466;Žvangutis;PELIUKŲ;8617941954;Taip;9;0;0;9
13467;Žvangutis;PELIUKŲ;3775960571;Taip;0;20;0;20
13468;Žvangutis;PELIUKŲ;11567978993;Taip;14;0;0;14
13469;Žvangutis;PELIUKŲ;9134683276;Taip;0;0;2;2
13470;Žvangutis;PELIUKŲ;8511103595;Taip;0;0;7;7
13471;Žvangutis;PELIUKŲ;7267340112;Taip;2;1;0;3
13472;Žvangutis;PELIUKŲ;9145365865;Taip;4;1;0;5
13473;Žvangutis;ANČIUKŲ;46159057420;Taip;0;1;4;5
13474;Žvangutis;ANČIUKŲ;93175189832;Taip;7;0;1;8
13475;Žvangutis;ANČIUKŲ;1353686877;Taip;0;0;1;1
13476;Žvangutis;ANČIUKŲ;18751626988;Taip;0;11;0;11
13477;Žvangutis;ANČIUKŲ;98607926663;Taip;0;0;2;2
13478;Žvangutis;ANČIUKŲ;12457255518;Taip;7;1;0;8
13479;Žvangutis;ANČIUKŲ;9618217868;Taip;0;2;1;3
13480;Žvangutis;ANČIUKŲ;91140904183;Ne;6;0;0;6
13481;Žvangutis;ANČIUKŲ;30697407645;Ne;0;4;1;5
13482;Žvangutis;ANČIUKŲ;86145834840;Taip;0;5;0;5
13483;Žvangutis;ANČIUKŲ;93894162596;Taip;0;0;1;1
13484;Žvangutis;ANČIUKŲ;38451136109;Ne;0;8;0;8
13485;Žvangutis;ANČIUKŲ;39364323060;Taip;0;14;0;14
13486;Žvangutis;ANČIUKŲ;57033172828;Taip;0;1;4;5
13487;Žvangutis;ANČIUKŲ;80054829676;Taip;5;1;1;7
13488;Žvangutis;ANČIUKŲ;11053503331;Taip;9;0;1;10
13489;Žvangutis;ANČIUKŲ;41703990445;Ne;0;3;0;3
13490;Žvangutis;ANČIUKŲ;5929099485;Ne;0;7;0;7
13491;Žvangutis;ANČIUKŲ;77459956838;Taip;0;0;1;1
13492;Žvangutis;ANČIUKŲ;77044982999;Taip;6;0;2;8
13493;Žvangutis;ANČIUKŲ;5616640228;Taip;0;1;0;1
13494;Žvangutis;ANČIUKŲ;1898484868;Taip;0;0;10;10
13495;Žvangutis;PELĖDŽIUKŲ;2755838558;Taip;0;11;0;11
13496;Žvangutis;PELĖDŽIUKŲ;1322688456;Taip;0;1;0;1
13497;Žvangutis;PELĖDŽIUKŲ;9036869235;Taip;0;7;0;7
13498;Žvangutis;PELĖDŽIUKŲ;2570379643;Taip;0;5;0;5
13499;Žvangutis;PELĖDŽIUKŲ;2600596320;Taip;7;1;0;8
13500;Žvangutis;PELĖDŽIUKŲ;2623107843;Taip;0;1;0;1
13501;Žvangutis;PELĖDŽIUKŲ;1185135525;Taip;0;4;0;4
13502;Žvangutis;PELĖDŽIUKŲ;2411307963;Ne;20;0;0;20
13503;Žvangutis;PELĖDŽIUKŲ;9468660351;Taip;5;1;0;6
13504;Žvangutis;PELĖDŽIUKŲ;1324948757;Taip;0;2;0;2
13505;Žvangutis;PELĖDŽIUKŲ;2922083476;Taip;0;4;0;4
13506;Žvangutis;PELĖDŽIUKŲ;1282567366;Taip;2;1;0;3
13507;Žvangutis;PELĖDŽIUKŲ;6068428687;Taip;0;1;0;1
13508;Žvangutis;PELĖDŽIUKŲ;9149037184;Taip;0;10;0;10
13509;Žvangutis;PELĖDŽIUKŲ;3665275100;Taip;0;3;0;3
13510;Žvangutis;PELĖDŽIUKŲ;5012996199;Taip;0;1;0;1
13511;Žvangutis;PELĖDŽIUKŲ;3276065009;Taip;0;2;0;2
13512;Žvangutis;PELĖDŽIUKŲ;6040986672;Taip;11;2;0;13
13513;Žvangutis;PELĖDŽIUKŲ;2716216474;Ne;0;2;0;2
13514;Žvangutis;KAČIUKŲ;1882797491;Taip;0;9;0;9
13515;Žvangutis;KAČIUKŲ;65598561926;Taip;0;9;0;9
13516;Žvangutis;KAČIUKŲ;52544167449;Taip;0;7;0;7
13517;Žvangutis;KAČIUKŲ;8697156717;Taip;0;1;0;1
13518;Žvangutis;KAČIUKŲ;23369081648;Taip;0;5;0;5
13519;Žvangutis;KAČIUKŲ;6989839997;Taip;4;0;0;4
13520;Žvangutis;KAČIUKŲ;1065463278;Ne;0;5;0;5
13521;Žvangutis;KAČIUKŲ;1369424754;Ne;0;12;0;12
13522;Žvangutis;KAČIUKŲ;1823402065;Taip;6;0;3;9
13523;Žvangutis;KAČIUKŲ;6343552093;Taip;0;8;0;8
13524;Žvangutis;KAČIUKŲ;2145325174;Taip;0;1;0;1
13525;Žvangutis;KAČIUKŲ;1251015310;Taip;0;0;1;1
13526;Žvangutis;KAČIUKŲ;45857502483;Ne;10;4;0;14
13527;Žvangutis;KAČIUKŲ;4699447138;Taip;2;0;0;2
13528;Žvangutis;KAČIUKŲ;1862121693;Taip;0;9;0;9
13529;Žvangutis;KAČIUKŲ;1541156624;Taip;8;1;0;9
13530;Žvangutis;KAČIUKŲ;1096499939;Ne;0;3;0;3
13531;Žvangutis;KAČIUKŲ;1847928083;Taip;0;10;0;10
13532;Žvangutis;KAČIUKŲ;1665136168;Taip;0;8;0;8
13533;Žvangutis;MEŠKUČIŲ;2296360416;Taip;0;1;2;3
13534;Žvangutis;MEŠKUČIŲ;9239279639;Taip;0;1;0;1
13535;Žvangutis;MEŠKUČIŲ;1142315595;Taip;16;1;0;17
13536;Žvangutis;MEŠKUČIŲ;6041698323;Taip;11;0;0;11
13537;Žvangutis;MEŠKUČIŲ;7581320158;Taip;0;7;0;7
13538;Žvangutis;MEŠKUČIŲ;7721746116;Taip;11;0;0;11
13539;Žvangutis;MEŠKUČIŲ;2598842770;Taip;0;1;0;1
13540;Žvangutis;MEŠKUČIŲ;6723079944;Taip;0;1;0;1
13541;Žvangutis;MEŠKUČIŲ;4696437804;Taip;9;0;0;9
13542;Žvangutis;MEŠKUČIŲ;7213349517;Taip;9;0;0;9
13543;Žvangutis;KIŠKUČIŲ;1687362077;Taip;0;4;0;4
13544;Žvangutis;KIŠKUČIŲ;1886637245;Taip;0;1;0;1
13545;Žvangutis;KIŠKUČIŲ;96443240617;Taip;0;1;0;1
13546;Žvangutis;KIŠKUČIŲ;6661791076;Taip;0;3;0;3
13547;Žvangutis;KIŠKUČIŲ;1481786579;Ne;5;2;0;7
13548;Žvangutis;KIŠKUČIŲ;1334567751;Taip;0;4;0;4
13549;Žvangutis;KIŠKUČIŲ;2138652487;Ne;22;0;0;22
13550;Žvangutis;KIŠKUČIŲ;1693249341;Taip;0;7;0;7
13551;Žvangutis;KIŠKUČIŲ;4798540560;Taip;7;5;0;12
13552;Žvangutis;KIŠKUČIŲ;5563516622;Taip;0;7;0;7
13553;Žvangutis;KIŠKUČIŲ;74528704135;Taip;0;3;0;3
13554;Žvangutis;KIŠKUČIŲ;57385778197;Taip;8;1;0;9
13555;Žvangutis;KIŠKUČIŲ;79808715852;Ne;6;0;0;6
13556;Žvangutis;KIŠKUČIŲ;5643005222;Taip;16;1;1;18
13557;Žvangutis;KIŠKUČIŲ;1702224809;Ne;0;0;1;1
13558;Žvangutis;KIŠKUČIŲ;2111430405;Taip;5;0;1;6
13559;Žvangutis;KIŠKUČIŲ;46410307693;Taip;0;2;0;2
13560;Žvangutis;KIŠKUČIŲ;3049348955;Taip;0;4;0;4
13561;Žvangutis;KIŠKUČIŲ;1845521463;Taip;0;1;0;1
13562;Žirniukas;Boružiukų;5311746004;Taip;5;0;0;5
13563;Žirniukas;Boružiukų;6466220057;Ne;8;1;0;9
13564;Žirniukas;Boružiukų;3107511189;Ne;0;0;1;1
13565;Žirniukas;Boružiukų;2476906136;Taip;0;0;7;7
13566;Žirniukas;Boružiukų;2785102131;Taip;5;0;0;5
13567;Žirniukas;Boružiukų;6624263476;Taip;5;0;0;5
13568;Žirniukas;Boružiukų;8213507698;Taip;0;2;5;7
13569;Žirniukas;Boružiukų;2528905738;Ne;5;15;2;22
13570;Žirniukas;Boružiukų;2348752207;Taip;0;0;20;20
13571;Žirniukas;Boružiukų;6268788036;Taip;3;2;0;5
13572;Žirniukas;Boružiukų;6363169823;Taip;9;0;1;10
13573;Žirniukas;Boružiukų;2636634198;Taip;5;6;4;15
13574;Žirniukas;Boružiukų;8148254025;Taip;0;3;0;3
13575;Žirniukas;Boružiukų;1867254291;Taip;0;2;0;2
13576;Žirniukas;Boružiukų;5058103759;Taip;0;3;0;3
13577;Žirniukas;Boružiukų;6531175340;Taip;3;0;0;3
13578;Žirniukas;Boružiukų;9647374339;Taip;0;6;0;6
13579;Žirniukas;Boružiukų;6641200341;Taip;11;8;0;19
13580;Žirniukas;Boružiukų;3022672028;Taip;5;1;0;6
13581;Žirniukas;Smalsučiai;1701389895;Taip;0;1;1;2
13582;Žirniukas;Smalsučiai;65471257240;Ne;0;6;0;6
13583;Žirniukas;Smalsučiai;99019576563;Taip;0;1;1;2
13584;Žirniukas;Smalsučiai;56948775759;Taip;0;1;0;1
13585;Žirniukas;Smalsučiai;83035751096;Taip;0;2;1;3
13586;Žirniukas;Smalsučiai;29792078209;Ne;0;1;0;1
13587;Žirniukas;Smalsučiai;1382313386;Taip;0;1;0;1
13588;Žirniukas;Smalsučiai;49058747304;Taip;0;0;1;1
13589;Žirniukas;Smalsučiai;54685058502;Taip;0;12;0;12
13590;Žirniukas;Smalsučiai;59972903968;Taip;0;5;2;7
13591;Žirniukas;Smalsučiai;37416946100;Taip;0;12;0;12
13592;Žirniukas;Smalsučiai;3723155762;Ne;0;2;0;2
13593;Žirniukas;Smalsučiai;15527206706;Taip;0;6;0;6
13594;Žirniukas;Smalsučiai;83997736517;Taip;0;1;0;1
13595;Žirniukas;Smalsučiai;7739943293;Ne;0;2;1;3
13596;Žirniukas;Smalsučiai;89146903524;Taip;0;0;1;1
13597;Žirniukas;Smalsučiai;65003409430;Taip;0;1;0;1
13598;Žirniukas;Smalsučiai;1150580143;Taip;3;0;1;4
13599;Žirniukas;Gėlyčių;57834170089;Taip;0;2;0;2
13600;Žirniukas;Gėlyčių;74425301830;Ne;0;18;0;18
13601;Žirniukas;Gėlyčių;6649555415;Ne;11;0;0;11
13602;Žirniukas;Gėlyčių;32583177093;Taip;0;1;0;1
13603;Žirniukas;Gėlyčių;91259031678;Taip;0;0;2;2
13604;Žirniukas;Gėlyčių;1804181833;Taip;0;0;1;1
13605;Žirniukas;Gėlyčių;47573534391;Taip;22;0;0;22
13606;Žirniukas;Gėlyčių;2072018782;Taip;0;4;0;4
13607;Žirniukas;Gėlyčių;1378845384;Taip;0;5;0;5
13608;Žirniukas;Gėlyčių;6455741324;Taip;5;0;0;5
13609;Žirniukas;Gėlyčių;8190751348;Taip;12;0;7;19
13610;Žirniukas;Gėlyčių;7872611724;Taip;12;0;7;19
13611;Žirniukas;Gėlyčių;4992122911;Taip;4;0;1;5
13612;Žirniukas;Gėlyčių;8180092480;Ne;0;0;1;1
13613;Žirniukas;Gėlyčių;7397202752;Taip;5;0;1;6
13614;Žirniukas;Nykštukų;2309995947;Taip;0;0;1;1
13615;Žirniukas;Nykštukų;1944169398;Taip;0;2;1;3
13616;Žirniukas;Nykštukų;1514504241;Taip;0;12;2;14
13617;Žirniukas;Nykštukų;1064894307;Taip;2;2;0;4
13618;Žirniukas;Nykštukų;1162904969;Taip;9;3;0;12
13619;Žirniukas;Nykštukų;2049123663;Taip;0;0;5;5
13620;Žirniukas;Nykštukų;2151329751;Taip;0;1;0;1
13621;Žirniukas;Nykštukų;5939918015;Taip;5;0;0;5
13622;Žirniukas;Nykštukų;3010062747;Ne;2;8;0;10
13623;Žirniukas;Nykštukų;2162238771;Taip;0;8;2;10
13624;Žirniukas;Nykštukų;2029018108;Taip;4;2;1;7
13625;Žirniukas;Nykštukų;5987510202;Taip;0;0;2;2
13626;Žirniukas;Nykštukų;5104110821;Taip;0;0;1;1
13627;Žirniukas;Nykštukų;5471647472;Ne;8;0;0;8
13628;Žirniukas;Nykštukų;7644911127;Taip;0;0;3;3
13629;Žirniukas;Nykštukų;6180439078;Taip;0;0;2;2
13630;Žirniukas;Nykštukų;3808838764;Ne;0;7;0;7
13631;Žirniukas;Nykštukų;7975957714;Ne;11;1;0;12
13632;Žirniukas;Saulytės;37852143615;Taip;0;1;5;6
13633;Žirniukas;Saulytės;1409567693;Taip;0;4;1;5
13634;Žirniukas;Saulytės;2022475049;Taip;0;1;2;3
13635;Žirniukas;Saulytės;32419042337;Taip;12;1;0;13
13636;Žirniukas;Saulytės;71263500233;Taip;9;0;1;10
13637;Žirniukas;Saulytės;65898776759;Taip;0;0;2;2
13638;Žirniukas;Saulytės;51172128673;Taip;0;1;1;2
13639;Žirniukas;Saulytės;5189034384;Ne;8;0;5;13
13640;Žirniukas;Saulytės;68565861419;Ne;5;0;1;6
13641;Žirniukas;Saulytės;2294854901;Taip;0;7;3;10
13642;Žirniukas;Saulytės;5188013194;Taip;6;0;2;8
13643;Žirniukas;Saulytės;69810421328;Taip;0;1;1;2
13644;Žirniukas;Saulytės;66153778144;Taip;0;0;11;11
13645;Žirniukas;Saulytės;47491327916;Taip;5;0;6;11
13646;Žirniukas;Saulytės;98028824068;Taip;0;2;0;2
13647;Žirniukas;Saulytės;28992463324;Taip;0;0;2;2
13648;Žirniukas;Saulytės;60060805955;Taip;2;0;0;2
13649;Žirniukas;Saulytės;71922426195;Taip;0;0;5;5
13650;Žirniukas;Drugelių;2141162140;Taip;0;1;0;1
13651;Žirniukas;Drugelių;1294183547;Taip;5;3;0;8
13652;Žirniukas;Drugelių;9192660067;Taip;0;10;0;10
13653;Žirniukas;Drugelių;2557138057;Taip;4;2;1;7
13654;Žirniukas;Drugelių;3068684150;Taip;10;0;7;17
13655;Žirniukas;Drugelių;8644938346;Ne;0;5;0;5
13656;Žirniukas;Drugelių;1991599271;Ne;0;9;0;9
13657;Žirniukas;Drugelių;2282495237;Taip;0;0;1;1
13658;Žirniukas;Drugelių;1961708150;Taip;0;3;0;3
13659;Žirniukas;Drugelių;1393738771;Taip;0;0;1;1
13660;Žirniukas;Drugelių;98962928727;Taip;4;0;0;4
13661;Žirniukas;Drugelių;6409900451;Taip;7;0;0;7
13662;Žirniukas;Drugelių;46265018782;Taip;10;6;0;16
13663;Žirniukas;Drugelių;7190628011;Taip;3;13;0;16
13664;Žirniukas;Drugelių;3248779733;Taip;4;0;0;4
13665;Žirniukas;Drugelių;9374080010;Taip;5;0;0;5
13666;Žirniukas;Drugelių;1095501791;Taip;0;1;6;7
13667;Žirniukas;Drugelių;1678041002;Taip;0;2;1;3
13668;Žirniukas;Pelėdžiukai;1685677297;Taip;0;0;1;1
13669;Žirniukas;Pelėdžiukai;9424009308;Taip;0;2;1;3
13670;Žirniukas;Pelėdžiukai;1542257475;Taip;0;2;0;2
13671;Žirniukas;Pelėdžiukai;98781117814;Taip;7;0;2;9
13672;Žirniukas;Pelėdžiukai;1158530590;Taip;0;12;2;14
13673;Žirniukas;Pelėdžiukai;1352159915;Taip;0;0;5;5
13674;Žirniukas;Pelėdžiukai;1096649614;Taip;0;1;0;1
13675;Žirniukas;Pelėdžiukai;1506642709;Taip;0;0;1;1
13676;Žirniukas;Pelėdžiukai;2118772211;Taip;0;0;2;2
13677;Žirniukas;Pelėdžiukai;1788183728;Taip;5;0;0;5
13678;Žirniukas;Pelėdžiukai;1907669506;Taip;0;1;2;3
13679;Žirniukas;Pelėdžiukai;1607867151;Ne;7;0;4;11
13680;Žirniukas;Pelėdžiukai;1586083174;Taip;4;0;1;5
13681;Žirniukas;Pelėdžiukai;52181077421;Taip;5;6;4;15
13682;Žirniukas;Pelėdžiukai;5479153220;Taip;2;1;0;3
13683;Žirniukas;Pelėdžiukai;4842182809;Taip;0;0;4;4
13684;Žirniukas;Pelėdžiukai;3236175335;Taip;5;0;0;5
13685;Žirniukas;ZUIKUČIAI;2733313392;Taip;5;0;0;5
13686;Žirniukas;ZUIKUČIAI;9961947583;Taip;0;2;0;2
13687;Žirniukas;ZUIKUČIAI;6834792589;Taip;1;0;1;2
13688;Žirniukas;ZUIKUČIAI;3610402086;Ne;5;0;0;5
13689;Žirniukas;ZUIKUČIAI;4827797140;Taip;10;0;0;10
13690;Žirniukas;ZUIKUČIAI;4045432303;Taip;0;1;1;2
13691;Žirniukas;ZUIKUČIAI;9707776533;Taip;10;1;0;11
13692;Žirniukas;ZUIKUČIAI;7278153529;Taip;10;1;0;11
13693;Žirniukas;ZUIKUČIAI;6254250706;Taip;7;0;0;7
13694;Žirniukas;ZUIKUČIAI;1262404954;Taip;7;0;0;7
13695;Žirniukas;ZUIKUČIAI;7926160083;Taip;7;0;0;7
13696;Žirniukas;ZUIKUČIAI;5422282267;Taip;12;0;1;13
13697;Aušra;Kodėlčiukai;2199083085;Taip;0;0;1;1
13698;Aušra;Kodėlčiukai;4720749995;Taip;0;3;0;3
13699;Aušra;Kodėlčiukai;5929538617;Taip;0;0;1;1
13700;Aušra;Kodėlčiukai;6139706771;Taip;8;0;0;8
13701;Aušra;Kodėlčiukai;7314273812;Ne;0;0;6;6
13702;Aušra;Kodėlčiukai;1526296386;Taip;6;0;1;7
13703;Aušra;Kodėlčiukai;4540040693;Taip;8;2;0;10
13704;Aušra;Kodėlčiukai;5013135853;Taip;0;0;7;7
13705;Aušra;Kodėlčiukai;9728140172;Taip;0;1;2;3
13706;Aušra;Kodėlčiukai;7765504789;Taip;0;4;0;4
13707;Aušra;Kodėlčiukai;8108663467;Taip;10;0;0;10
13708;Aušra;Kodėlčiukai;4824773027;Ne;5;0;0;5
13709;Aušra;Kodėlčiukai;1897365632;Taip;0;1;0;1
13710;Aušra;Kodėlčiukai;7469266085;Taip;2;4;0;6
13711;Aušra;Kodėlčiukai;1010721404;Taip;0;6;0;6
13712;Aušra;Pelėdžiukai;8686777160;Ne;0;2;0;2
13713;Aušra;Pelėdžiukai;15657824495;Taip;0;4;0;4
13714;Aušra;Pelėdžiukai;79051821501;Taip;5;0;0;5
13715;Aušra;Pelėdžiukai;3001784066;Taip;5;2;1;8
13716;Aušra;Pelėdžiukai;21234588466;Taip;0;14;0;14
13717;Aušra;Pelėdžiukai;5815377310;Ne;8;2;0;10
13718;Aušra;Pelėdžiukai;23609052737;Taip;5;13;0;18
13719;Aušra;Pelėdžiukai;3823619675;Taip;7;0;0;7
13720;Aušra;Pelėdžiukai;41017803426;Taip;3;0;0;3
13721;Aušra;Pelėdžiukai;13825730049;Taip;0;0;4;4
13722;Aušra;Pelėdžiukai;58254707316;Ne;0;2;0;2
13723;Aušra;Pelėdžiukai;18943927144;Taip;0;2;6;8
13724;Aušra;Pelėdžiukai;1623803107;Taip;0;2;3;5
13725;Aušra;Pelėdžiukai;57469542504;Taip;4;2;2;8
13726;Aušra;Pelėdžiukai;2121418946;Taip;18;0;0;18
13727;Aušra;Pelėdžiukai;5409157554;Taip;0;0;3;3
13728;Aušra;Pelėdžiukai;2227238810;Ne;0;2;1;3
13729;Aušra;Pelėdžiukai;2000206874;Taip;15;7;0;22
13730;Aušra;Pelėdžiukai;4325224130;Taip;13;1;0;14
13731;Aušra;Pelėdžiukai;59267104215;Taip;0;4;0;4
13732;Aušra;Smalsučiai;1049364899;Taip;0;1;0;1
13733;Aušra;Smalsučiai;1473962346;Taip;0;1;0;1
13734;Aušra;Smalsučiai;81510885976;Ne;0;1;1;2
13735;Aušra;Smalsučiai;1767520195;Taip;2;0;0;2
13736;Aušra;Smalsučiai;76979979920;Taip;0;0;1;1
13737;Aušra;Smalsučiai;97571593143;Taip;0;8;1;9
13738;Aušra;Smalsučiai;59235411329;Taip;0;0;5;5
13739;Aušra;Smalsučiai;42344686036;Ne;0;1;0;1
13740;Aušra;Smalsučiai;62209740677;Taip;0;0;2;2
13741;Aušra;Smalsučiai;2019580127;Taip;9;9;0;18
13742;Aušra;Smalsučiai;95586246863;Taip;0;4;0;4
13743;Aušra;Smalsučiai;1095212350;Taip;0;0;1;1
13744;Aušra;Smalsučiai;66203768924;Taip;2;1;0;3
13745;Aušra;Smalsučiai;7962184651;Taip;0;2;0;2
13746;Aušra;Smalsučiai;12689030409;Taip;0;2;1;3
13747;Aušra;Smalsučiai;98150444770;Taip;0;2;2;4
13748;Aušra;Smalsučiai;1167565535;Taip;0;11;1;12
13749;Aušra;Smalsučiai;52044254281;Taip;0;0;2;2
13750;Aušra;Smalsučiai;1831747749;Taip;0;2;0;2
13751;Aušra;Smalsučiai;7222605763;Taip;10;0;0;10
13752;Aušra;Smalsučiai;4645855409;Taip;8;0;2;10
13753;Aušra;Smalsučiai;14343589644;Taip;0;0;3;3
13754;Aušra;Pagrandukai;7043021721;Taip;22;0;0;22
13755;Aušra;Pagrandukai;2023718424;Taip;0;0;3;3
13756;Aušra;Pagrandukai;8709340592;Taip;0;0;22;22
13757;Aušra;Pagrandukai;5524681006;Ne;0;0;13;13
13758;Aušra;Pagrandukai;4404047456;Taip;0;0;9;9
13759;Aušra;Pagrandukai;3680329197;Taip;6;0;1;7
13760;Aušra;Pagrandukai;2288159223;Taip;5;7;0;12
13761;Aušra;Pagrandukai;4805298824;Taip;0;1;0;1
13762;Aušra;Pagrandukai;29499576216;Taip;3;0;0;3
13763;Aušra;Pagrandukai;1940882109;Taip;0;1;0;1
13764;Aušra;Pagrandukai;7814902928;Taip;0;1;0;1
13765;Aušra;Pagrandukai;9702136789;Taip;0;1;0;1
13766;Aušra;Pagrandukai;6384243597;Taip;0;7;0;7
13767;Aušra;Pagrandukai;1612662076;Taip;0;2;1;3
13768;Aušra;Pagrandukai;3898178166;Ne;0;8;0;8
13769;Aušra;Pagrandukai;4352174590;Taip;3;2;2;7
13770;Aušra;Pagrandukai;1575761029;Taip;8;0;1;9
13771;Aušra;Pagrandukai;5673568541;Taip;0;0;3;3
13772;Aušra;Pagrandukai;97102749430;Taip;0;2;0;2
13773;Aušra;Pagrandukai;5777939563;Ne;7;0;2;9
13774;Aušra;Pagrandukai;1956830515;Taip;7;0;0;7
13775;Aušra;Pagrandukai;8740755922;Taip;0;0;4;4
13776;Aušra;"1A klasė";8510995681;Taip;2;0;0;2
13777;Aušra;"1A klasė";9605206310;Taip;9;0;0;9
13778;Aušra;"1A klasė";3284383302;Taip;2;0;0;2
13779;Aušra;"1A klasė";13157844661;Taip;2;0;0;2
13780;Aušra;"1A klasė";68160889669;Taip;2;0;0;2
13781;Aušra;"1A klasė";88655846176;Taip;3;0;0;3
13782;Aušra;"1A klasė";73509864636;Ne;2;0;0;2
13783;Aušra;"1A klasė";40499781883;Taip;2;0;0;2
13784;Aušra;"1A klasė";70233681803;Taip;2;0;0;2
13785;Aušra;"1A klasė";40714551025;Taip;13;0;0;13
13786;Aušra;"1A klasė";97781409787;Ne;2;0;0;2
13787;Aušra;"1A klasė";1396233353;Taip;9;0;0;9
13788;Aušra;"1A klasė";1437126272;Taip;2;0;0;2
13789;Aušra;"1A klasė";39537089288;Taip;2;0;0;2
13790;Aušra;"1A klasė";3965445196;Taip;2;0;0;2
13791;Aušra;"1A klasė";85578471272;Taip;2;0;0;2
13792;Aušra;"1A klasė";27958163601;Taip;2;0;0;2
13793;Aušra;"1A klasė";68031503463;Taip;2;0;0;2
13794;Aušra;"1A klasė";81633973264;Taip;2;0;0;2
13795;Aušra;"1A klasė";52985512945;Taip;2;0;0;2
13796;Aušra;"1A klasė";51185323645;Ne;2;0;0;2
13797;Aušra;"1A klasė";1437385365;Taip;13;0;0;13
13798;Aušra;"1A klasė";80929303402;Taip;0;22;0;22
13799;Aušra;"1A klasė";15330844181;Taip;2;0;0;2
13800;Aušra;"1A klasė";92468615840;Taip;3;0;0;3
13801;Aušra;"1A klasė";2062775070;Taip;10;0;0;10
13802;Aušra;"2A klasė";94704151051;Taip;2;0;0;2
13803;Aušra;"2A klasė";99886964420;Taip;0;22;0;22
13804;Aušra;"2A klasė";19920237804;Taip;2;0;0;2
13805;Aušra;"2A klasė";13361663464;Taip;11;0;0;11
13806;Aušra;"2A klasė";95948867937;Taip;0;22;0;22
13807;Aušra;"2A klasė";78030425432;Taip;2;0;0;2
13808;Aušra;"2A klasė";34795588283;Ne;0;22;0;22
13809;Aušra;"2A klasė";29636399665;Taip;2;0;0;2
13810;Aušra;"2A klasė";81428848455;Taip;4;0;0;4
13811;Aušra;"2A klasė";47725613978;Taip;0;22;0;22
13812;Aušra;"2A klasė";93365393803;Ne;13;0;0;13
13813;Aušra;"2A klasė";70687041413;Taip;9;0;0;9
13814;Aušra;"2A klasė";52864653926;Taip;0;22;0;22
13815;Aušra;"2A klasė";10272136932;Taip;2;0;0;2
13816;Aušra;"2A klasė";77425098448;Taip;4;0;0;4
13817;Aušra;"2A klasė";20550256232;Taip;2;0;0;2
13818;Aušra;"2A klasė";42015974556;Taip;2;0;0;2
13819;Aušra;"2A klasė";2113586354;Taip;4;0;0;4
13820;Aušra;"2A klasė";19718806057;Taip;2;0;0;2
13821;Aušra;"2A klasė";21856009403;Taip;2;0;0;2
13822;Aušra;"2A klasė";5166358753;Taip;2;0;0;2
13823;Aušra;"2A klasė";44870195034;Taip;2;0;0;2
13824;Aušra;"2A klasė";68481706412;Taip;0;22;0;22
13825;Aušra;"3A klasė";2908360090;Ne;2;0;0;2
13826;Aušra;"3A klasė";1585279799;Ne;2;0;0;2
13827;Aušra;"3A klasė";8497743711;Ne;15;0;0;15
13828;Aušra;"3A klasė";7439801986;Ne;2;0;0;2
13829;Aušra;"3A klasė";4952796453;Ne;2;0;0;2
13830;Aušra;"3A klasė";1404310604;Ne;2;0;0;2
13831;Aušra;"3A klasė";5770340819;Ne;3;0;0;3
13832;Aušra;"3A klasė";9510786725;Ne;2;0;0;2
13833;Aušra;"3A klasė";2280410145;Ne;12;0;0;12
13834;Aušra;"3A klasė";29945175192;Taip;0;22;0;22
13835;Aušra;"3A klasė";8367064629;Ne;2;0;0;2
13836;Aušra;"3A klasė";7931858964;Ne;2;0;0;2
13837;Aušra;"3A klasė";5792862565;Ne;2;0;0;2
13838;Aušra;"3A klasė";6942076490;Ne;2;0;0;2
13839;Aušra;"3A klasė";4399210916;Ne;2;0;0;2
13840;Aušra;"3A klasė";8892613555;Ne;3;0;0;3
13841;Aušra;"3A klasė";6534693192;Ne;2;0;0;2
13842;Aušra;"3A klasė";2797588970;Ne;7;0;0;7
13843;Aušra;"3A klasė";5657162092;Ne;0;22;0;22
13844;Aušra;"3A klasė";3435983733;Ne;2;0;0;2
13845;Aušra;"3A klasė";5825720308;Ne;2;0;0;2
13846;Aušra;"3A klasė";7313001921;Ne;2;0;0;2
13847;Aušra;"3A klasė";2796012982;Ne;2;0;0;2
13848;Aušra;"3A klasė";8632721907;Ne;2;0;0;2
13849;Aušra;"3A klasė";7113793626;Ne;2;0;0;2
13850;Aušra;"3A klasė";75839555732;Taip;2;0;0;2
13851;Aušra;"3A klasė";96979357769;Taip;0;22;0;22
13852;Aušra;"3A klasė";9584232864;Ne;5;0;0;5
13853;Aušra;"4A klasė";4190936993;Ne;2;0;0;2
13854;Aušra;"4A klasė";1685764132;Ne;2;0;0;2
13855;Aušra;"4A klasė";5340257141;Ne;8;0;0;8
13856;Aušra;"4A klasė";8328298376;Ne;0;22;0;22
13857;Aušra;"4A klasė";8543429220;Ne;0;22;0;22
13858;Aušra;"4A klasė";4341245904;Ne;2;0;0;2
13859;Aušra;"4A klasė";7499852390;Ne;14;0;0;14
13860;Aušra;"4A klasė";3749854924;Ne;2;0;0;2
13861;Aušra;"4A klasė";2072790876;Ne;2;0;0;2
13862;Aušra;"4A klasė";2863356239;Ne;2;0;0;2
13863;Aušra;"4A klasė";1448718807;Ne;0;22;0;22
13864;Aušra;"4A klasė";8550981774;Ne;3;0;0;3
13865;Aušra;"4A klasė";2951199272;Ne;2;0;0;2
13866;Aušra;"4A klasė";9332506542;Ne;2;0;0;2
13867;Aušra;"4A klasė";3115696927;Ne;2;0;0;2
13868;Aušra;"4A klasė";62035537641;Taip;0;22;0;22
13869;Aušra;"4A klasė";4073898542;Ne;2;0;0;2
13870;Aušra;"4A klasė";1414034080;Ne;0;22;0;22
13871;Aušra;"4A klasė";7435902333;Ne;2;0;0;2
13872;Aušra;"4A klasė";6232778631;Ne;2;0;0;2
13873;Aušra;"4A klasė";54244461148;Ne;2;0;0;2
13874;Aušra;"4A klasė";6540515450;Ne;0;22;0;22
13875;Aušra;"4A klasė";4257487788;Ne;2;0;0;2
13876;Aušra;"4A klasė";2942755846;Ne;2;0;0;2
13877;Aušra;"2B klasė";92119607174;Taip;2;0;0;2
13878;Aušra;"2B klasė";22923377435;Ne;3;0;0;3
13879;Aušra;"2B klasė";41852924528;Taip;2;0;0;2
13880;Aušra;"2B klasė";58526614808;Taip;2;0;0;2
13881;Aušra;"2B klasė";41039525379;Ne;2;0;0;2
13882;Aušra;"2B klasė";37339481276;Taip;7;0;0;7
13883;Aušra;"2B klasė";45165946624;Taip;2;0;0;2
13884;Aušra;"2B klasė";59107169775;Ne;2;0;0;2
13885;Aušra;"2B klasė";48349819906;Ne;2;0;0;2
13886;Aušra;"2B klasė";71596384638;Taip;2;0;0;2
13887;Aušra;"2B klasė";52332096506;Taip;2;0;0;2
13888;Aušra;"2B klasė";35703433862;Taip;2;0;0;2
13889;Aušra;"2B klasė";6201728036;Taip;5;5;0;10
13890;Aušra;"2B klasė";36889923728;Taip;3;0;0;3
13891;Aušra;"2B klasė";39957179831;Taip;0;22;0;22
13892;Aušra;"2B klasė";52909474598;Ne;2;0;0;2
13893;Aušra;"2B klasė";8901585006;Taip;3;0;0;3
13894;Aušra;"2B klasė";64562667133;Taip;2;0;0;2
13895;Aušra;"2B klasė";95076478544;Ne;2;0;0;2
13896;Aušra;"2B klasė";36899257479;Ne;2;0;0;2
13897;Aušra;"2B klasė";57520886724;Taip;0;22;0;22
13898;Aušra;"2B klasė";1815771421;Ne;2;0;0;2
13899;Aušra;"2B klasė";75433637766;Taip;5;0;0;5
13900;Aušra;"2B klasė";83119050626;Taip;3;0;0;3
13901;Aušra;"3B klasė";5687605664;Ne;0;22;0;22
13902;Aušra;"3B klasė";7713995959;Ne;2;0;0;2
13903;Aušra;"3B klasė";2610054474;Ne;2;0;0;2
13904;Aušra;"3B klasė";95798840861;Taip;0;22;0;22
13905;Aušra;"3B klasė";7553225340;Ne;3;0;0;3
13906;Aušra;"3B klasė";9736905104;Ne;2;0;0;2
13907;Aušra;"3B klasė";70054065156;Taip;5;0;0;5
13908;Aušra;"3B klasė";9695887585;Ne;2;0;0;2
13909;Aušra;"3B klasė";3225989797;Ne;5;0;0;5
13910;Aušra;"3B klasė";7405776766;Ne;0;22;0;22
13911;Aušra;"3B klasė";5005513948;Ne;2;0;0;2
13912;Aušra;"3B klasė";7697924792;Ne;2;0;0;2
13913;Aušra;"3B klasė";2412235474;Ne;3;0;0;3
13914;Aušra;"3B klasė";2075587354;Ne;2;0;0;2
13915;Aušra;"3B klasė";65535488153;Taip;3;0;0;3
13916;Aušra;"3B klasė";9600565378;Ne;2;0;0;2
13917;Aušra;"3B klasė";3114317363;Ne;7;0;0;7
13918;Aušra;"3B klasė";7075053685;Ne;0;22;0;22
13919;Aušra;"3B klasė";98154599269;Taip;0;22;0;22
13920;Aušra;"3B klasė";7321317333;Ne;2;0;0;2
13921;Aušra;"3B klasė";2893668707;Ne;2;0;0;2
13922;Aušra;"3B klasė";7886658451;Ne;0;22;0;22
13923;Berželis;PČIOLKI;1612263252;Taip;6;0;0;6
13924;Berželis;PČIOLKI;58375151019;Ne;5;0;1;6
13925;Berželis;PČIOLKI;56738219250;Taip;9;0;0;9
13926;Berželis;PČIOLKI;88322206113;Taip;7;0;1;8
13927;Berželis;PČIOLKI;75750848557;Ne;14;0;0;14
13928;Berželis;PČIOLKI;69799827219;Taip;3;0;0;3
13929;Berželis;PČIOLKI;56482980062;Ne;5;0;0;5
13930;Berželis;PČIOLKI;1740077377;Taip;0;8;0;8
13931;Berželis;PČIOLKI;91676607875;Taip;0;0;2;2
13932;Berželis;PČIOLKI;1729593575;Taip;0;0;3;3
13933;Berželis;PČIOLKI;4605587503;Taip;7;0;0;7
13934;Berželis;PČIOLKI;9901922166;Taip;0;0;5;5
13935;Berželis;PČIOLKI;68853290649;Ne;0;0;4;4
13936;Berželis;PČIOLKI;1929783185;Taip;10;1;0;11
13937;Berželis;PČIOLKI;50400542457;Taip;5;0;0;5
13938;Berželis;PČIOLKI;68192824475;Taip;0;0;1;1
13939;Berželis;"BOŽJI KOROVKI";3162044236;Taip;6;0;0;6
13940;Berželis;"BOŽJI KOROVKI";9132058594;Taip;5;5;0;10
13941;Berželis;"BOŽJI KOROVKI";7421059780;Taip;14;0;0;14
13942;Berželis;"BOŽJI KOROVKI";4100740863;Taip;5;9;0;14
13943;Berželis;"BOŽJI KOROVKI";1750209600;Taip;12;0;0;12
13944;Berželis;"BOŽJI KOROVKI";5953387226;Taip;0;22;0;22
13945;Berželis;"BOŽJI KOROVKI";9466461910;Taip;5;0;0;5
13946;Berželis;"BOŽJI KOROVKI";3070917065;Taip;10;1;0;11
13947;Berželis;"BOŽJI KOROVKI";5408368340;Taip;0;8;0;8
13948;Berželis;"BOŽJI KOROVKI";1049199372;Ne;20;0;0;20
13949;Berželis;"BOŽJI KOROVKI";2005082089;Taip;11;3;0;14
13950;Berželis;"BOŽJI KOROVKI";5692603837;Taip;10;0;1;11
13951;Berželis;"BOŽJI KOROVKI";5194480946;Taip;0;22;0;22
13952;Berželis;"BOŽJI KOROVKI";9848723402;Taip;14;0;0;14
13953;Berželis;"BOŽJI KOROVKI";5551459997;Taip;10;0;0;10
13954;Berželis;"BOŽJI KOROVKI";6651007152;Taip;0;10;0;10
13955;Berželis;SOLNYŠKO;8871199713;Taip;0;10;0;10
13956;Berželis;SOLNYŠKO;2182268389;Taip;9;0;0;9
13957;Berželis;SOLNYŠKO;4163605313;Taip;0;0;1;1
13958;Berželis;SOLNYŠKO;2882693941;Taip;0;21;0;21
13959;Berželis;SOLNYŠKO;9438498834;Taip;6;0;0;6
13960;Berželis;SOLNYŠKO;7852089381;Taip;10;0;2;12
13961;Berželis;SOLNYŠKO;6189116357;Ne;8;0;0;8
13962;Berželis;SOLNYŠKO;8737788279;Taip;9;0;0;9
13963;Berželis;SOLNYŠKO;8875116641;Taip;6;0;0;6
13964;Berželis;SOLNYŠKO;8297975308;Taip;0;9;0;9
13965;Berželis;SOLNYŠKO;2693961315;Taip;6;0;5;11
13966;Berželis;SOLNYŠKO;7080168105;Taip;0;1;0;1
13967;Berželis;SOLNYŠKO;1316018865;Taip;5;0;0;5
13968;Berželis;BABOČKI;5371508044;Taip;19;0;0;19
13969;Berželis;BABOČKI;1076719080;Taip;7;0;0;7
13970;Berželis;BABOČKI;2016194182;Taip;0;0;5;5
13971;Berželis;BABOČKI;2030770943;Taip;0;4;0;4
13972;Berželis;BABOČKI;9839929976;Taip;10;0;0;10
13973;Berželis;BABOČKI;2667957070;Taip;10;0;2;12
13974;Berželis;BABOČKI;7781031211;Taip;7;0;0;7
13975;Berželis;BABOČKI;2493612905;Taip;22;0;0;22
13976;Berželis;BABOČKI;5688897783;Taip;0;11;0;11
13977;Berželis;BABOČKI;6942559693;Taip;0;0;5;5
13978;Berželis;BABOČKI;9245706377;Taip;4;1;0;5
13979;Berželis;BABOČKI;6352635742;Ne;0;9;0;9
13980;Berželis;BABOČKI;3613459846;Taip;8;0;0;8
13981;Berželis;BABOČKI;8448872491;Taip;0;0;5;5
13982;Berželis;BABOČKI;2954451168;Taip;5;0;0;5
13983;Berželis;BABOČKI;4312062240;Taip;0;12;0;12
13984;Berželis;BABOČKI;9091691636;Taip;5;0;1;6
13985;Berželis;SOVUŠKI;8939353460;Taip;22;0;0;22
13986;Berželis;SOVUŠKI;5879965735;Taip;0;0;4;4
13987;Berželis;SOVUŠKI;1183377037;Ne;3;0;0;3
13988;Berželis;SOVUŠKI;61614684164;Taip;4;0;0;4
13989;Berželis;SOVUŠKI;1573177287;Taip;0;7;0;7
13990;Berželis;SOVUŠKI;48932211843;Ne;7;15;0;22
13991;Berželis;SOVUŠKI;11671380984;Taip;0;0;3;3
13992;Berželis;SOVUŠKI;1927042277;Taip;0;12;0;12
13993;Berželis;SOVUŠKI;1566912722;Taip;0;0;1;1
13994;Berželis;SOVUŠKI;1865658456;Taip;17;0;0;17
13995;Berželis;SOVUŠKI;1061894314;Taip;0;0;1;1
13996;Berželis;SOVUŠKI;5739686368;Taip;0;0;2;2
13997;Berželis;SOVUŠKI;25985469678;Taip;16;1;0;17
13998;Berželis;SOVUŠKI;2028316867;Ne;0;13;0;13
13999;Berželis;SOVUŠKI;1470907829;Taip;5;0;0;5
14000;Berželis;SOVUŠKI;9134420285;Ne;0;5;0;5
14001;Berželis;SOVUŠKI;5337604370;Ne;3;0;0;3
14002;Berželis;SOVUŠKI;1492203156;Taip;22;0;0;22
14003;Berželis;SOVUŠKI;1511044883;Taip;6;7;0;13
14004;Berželis;SOVUŠKI;7713921014;Taip;0;0;7;7
14005;Berželis;PODSOLNUŠKI;4521372127;Taip;6;0;0;6
14006;Berželis;PODSOLNUŠKI;2214171136;Taip;18;0;0;18
14007;Berželis;PODSOLNUŠKI;97218091736;Taip;14;0;0;14
14008;Berželis;PODSOLNUŠKI;1521982237;Taip;11;0;0;11
14009;Berželis;PODSOLNUŠKI;4013215941;Taip;0;0;1;1
14010;Berželis;PODSOLNUŠKI;7526006253;Taip;5;2;0;7
14011;Berželis;PODSOLNUŠKI;64214150955;Ne;13;0;0;13
14012;Berželis;PODSOLNUŠKI;9024992452;Taip;0;7;0;7
14013;Berželis;PODSOLNUŠKI;9644196870;Taip;0;0;1;1
14014;Berželis;PODSOLNUŠKI;5084171353;Taip;19;0;0;19
14015;Berželis;PODSOLNUŠKI;6473498471;Taip;3;0;0;3
14016;Berželis;PODSOLNUŠKI;3772780161;Taip;15;0;0;15
14017;Berželis;PODSOLNUŠKI;4563582416;Taip;15;0;0;15
14018;Berželis;PODSOLNUŠKI;7227603702;Taip;12;0;0;12
14019;Berželis;PODSOLNUŠKI;6113571093;Ne;18;0;0;18
14020;Berželis;PODSOLNUŠKI;4284157599;Taip;10;1;0;11
14021;Berželis;PODSOLNUŠKI;2615440913;Taip;6;0;0;6
14022;Berželis;PODSOLNUŠKI;9894751274;Taip;9;0;0;9
14023;Berželis;PODSOLNUŠKI;3298044639;Taip;0;0;1;1
14024;Berželis;PODSOLNUŠKI;3437712794;Taip;12;0;0;12
14025;Berželis;"1 klasė";7375940325;Taip;6;0;0;6
14026;Berželis;"1 klasė";90573854976;Taip;1;0;0;1
14027;Berželis;"1 klasė";39511689145;Taip;4;0;0;4
14028;Berželis;"1 klasė";62426432001;Taip;3;0;0;3
14029;Berželis;"1 klasė";29561378525;Taip;0;22;0;22
14030;Berželis;"1 klasė";51807139150;Ne;5;0;0;5
14031;Berželis;"1 klasė";95780247776;Ne;3;0;0;3
14032;Berželis;"1 klasė";83552840429;Taip;2;0;0;2
14033;Berželis;"1 klasė";84379482983;Taip;1;0;0;1
14034;Berželis;"1 klasė";17710158252;Taip;1;0;0;1
14035;Berželis;"1 klasė";86666390300;Taip;1;0;0;1
14036;Berželis;"1 klasė";37637382978;Taip;1;0;0;1
14037;Berželis;"1 klasė";95587380846;Taip;2;0;0;2
14038;Berželis;"1 klasė";48161697699;Taip;1;0;0;1
14039;Berželis;"1 klasė";44215014337;Taip;1;0;0;1
14040;Berželis;"1 klasė";2066819593;Taip;1;0;0;1
14041;Berželis;"2 klasė";3554738276;Taip;8;0;0;8
14042;Berželis;"2 klasė";68739754511;Taip;12;0;0;12
14043;Berželis;"2 klasė";9168601277;Taip;7;0;0;7
14044;Berželis;"2 klasė";93543942806;Taip;7;0;0;7
14045;Berželis;"2 klasė";5442568208;Taip;1;0;0;1
14046;Berželis;"2 klasė";84043380820;Taip;2;0;0;2
14047;Berželis;"2 klasė";945754955;Taip;6;0;0;6
14048;Berželis;"2 klasė";3658542055;Ne;0;22;0;22
14049;Berželis;"2 klasė";12564193771;Taip;2;0;0;2
14050;Berželis;"2 klasė";2412399682;Taip;2;0;0;2
14051;Berželis;"2 klasė";40956353978;Taip;7;0;0;7
14052;Berželis;"2 klasė";34721593327;Taip;8;0;0;8
14053;Berželis;"3 klasė";66532479024;Ne;1;0;0;1
14054;Berželis;"3 klasė";4381565277;Ne;3;0;0;3
14055;Berželis;"3 klasė";47358747103;Taip;2;0;0;2
14056;Berželis;"3 klasė";4263364972;Taip;1;0;0;1
14057;Berželis;"3 klasė";4750570367;Ne;0;22;0;22
14058;Berželis;"3 klasė";67358830655;Taip;1;0;0;1
14059;Berželis;"3 klasė";12252622276;Taip;6;0;0;6
14060;Berželis;"3 klasė";68547063004;Taip;2;0;0;2
14061;Berželis;"3 klasė";12819628369;Taip;5;0;0;5
14062;Berželis;"3 klasė";13521812215;Taip;0;22;0;22
14063;Berželis;"3 klasė";32336500026;Taip;7;0;0;7
14064;Berželis;"3 klasė";17898339325;Taip;6;0;0;6
14065;Berželis;"3 klasė";9395016208;Taip;1;0;0;1
14066;Berželis;"3 klasė";55709962549;Taip;3;0;0;3
14067;Berželis;"3 klasė";62300805754;Taip;1;0;0;1
14068;Berželis;"3 klasė";1162529591;Taip;3;0;0;3
14069;Berželis;"4 klasė";2691853015;Ne;1;0;0;1
14070;Berželis;"4 klasė";5856177876;Ne;5;0;0;5
14071;Berželis;"4 klasė";8143634742;Ne;7;0;0;7
14072;Berželis;"4 klasė";5616257764;Taip;1;0;0;1
14073;Berželis;"4 klasė";9486991928;Ne;1;0;0;1
14074;Berželis;"4 klasė";62987603892;Taip;4;0;0;4
14075;Berželis;"4 klasė";9998560354;Ne;14;0;0;14
14076;Berželis;"4 klasė";6702857359;Ne;4;0;0;4
14077;Berželis;"4 klasė";2955045450;Ne;1;0;0;1
14078;Berželis;"4 klasė";3149377224;Ne;3;0;0;3
14079;Berželis;"4 klasė";50930845005;Taip;1;0;0;1
14080;Berželis;"4 klasė";1161378829;Ne;1;0;0;1
14081;Berželis;"4 klasė";8322372921;Ne;1;0;0;1
14082;Berželis;"4 klasė";2501433917;Ne;6;0;0;6
14083;Berželis;"4 klasė";7728620622;Ne;1;0;0;1
14084;Berželis;"4 klasė";8921842915;Ne;1;0;0;1
14085;Berželis;"4 klasė";3064700283;Ne;1;0;0;1
14086;Saulutė;Drugeliai;66108847230;Taip;9;1;2;12
14087;Saulutė;Drugeliai;1556270046;Taip;0;1;1;2
14088;Saulutė;Drugeliai;3064199909;Taip;0;0;3;3
14089;Saulutė;Drugeliai;2097055107;Taip;5;2;0;7
14090;Saulutė;Drugeliai;1717909005;Taip;5;1;1;7
14091;Saulutė;Drugeliai;8599199376;Taip;8;0;0;8
14092;Saulutė;Drugeliai;1750571258;Taip;0;0;6;6
14093;Saulutė;Drugeliai;87814849917;Taip;10;1;0;11
14094;Saulutė;Drugeliai;1609952589;Taip;0;1;1;2
14095;Saulutė;Drugeliai;1386800520;Taip;0;1;6;7
14096;Saulutė;Drugeliai;1320018338;Ne;9;1;1;11
14097;Saulutė;Drugeliai;1291318940;Taip;22;0;0;22
14098;Saulutė;Drugeliai;2162114750;Ne;0;0;21;21
14099;Saulutė;Drugeliai;9550046358;Taip;13;0;0;13
14100;Saulutė;Drugeliai;1391904744;Taip;8;1;1;10
14101;Saulutė;Drugeliai;8944601874;Taip;0;10;0;10
14102;Saulutė;Drugeliai;4272320685;Taip;0;1;0;1
14103;Saulutė;Drugeliai;7539721995;Taip;0;6;0;6
14104;Saulutė;"Saulės zuikučiai";8946107286;Taip;6;0;0;6
14105;Saulutė;"Saulės zuikučiai";2397257894;Taip;0;5;0;5
14106;Saulutė;"Saulės zuikučiai";2010774109;Taip;4;10;0;14
14107;Saulutė;"Saulės zuikučiai";5148542811;Taip;20;0;0;20
14108;Saulutė;"Saulės zuikučiai";1562393383;Taip;5;0;1;6
14109;Saulutė;"Saulės zuikučiai";2259917151;Taip;0;0;2;2
14110;Saulutė;"Saulės zuikučiai";3691381351;Taip;2;0;0;2
14111;Saulutė;"Saulės zuikučiai";8242602551;Taip;10;0;1;11
14112;Saulutė;"Saulės zuikučiai";1324799653;Taip;6;12;0;18
14113;Saulutė;"Saulės zuikučiai";5247769309;Taip;10;0;3;13
14114;Saulutė;"Saulės zuikučiai";2816806902;Taip;0;0;2;2
14115;Saulutė;"Saulės zuikučiai";9521155670;Taip;0;0;1;1
14116;Saulutė;"Saulės zuikučiai";9892855816;Taip;5;0;0;5
14117;Saulutė;"Saulės zuikučiai";5326279083;Taip;0;0;1;1
14118;Saulutė;"Saulės zuikučiai";3675783868;Taip;0;0;1;1
14119;Saulutė;"Saulės zuikučiai";7351477901;Taip;7;0;0;7
14120;Saulutė;"Saulės zuikučiai";5839981073;Ne;0;12;0;12
14121;Saulutė;Boružėlės;3272296969;Taip;0;0;7;7
14122;Saulutė;Boružėlės;6044672321;Ne;5;0;1;6
14123;Saulutė;Boružėlės;3295289082;Taip;0;1;0;1
14124;Saulutė;Boružėlės;1587328722;Taip;0;3;0;3
14125;Saulutė;Boružėlės;8390767549;Taip;13;0;0;13
14126;Saulutė;Boružėlės;7576532632;Taip;0;0;21;21
14127;Saulutė;Boružėlės;2725491887;Taip;5;0;0;5
14128;Saulutė;Boružėlės;9314889468;Taip;8;0;0;8
14129;Saulutė;Boružėlės;9173336078;Taip;4;1;0;5
14130;Saulutė;Boružėlės;5329894543;Taip;5;0;2;7
14131;Saulutė;Boružėlės;6803541200;Taip;21;0;0;21
14132;Saulutė;Boružėlės;1265174091;Taip;2;0;0;2
14133;Saulutė;Boružėlės;4818911910;Ne;0;0;2;2
14134;Saulutė;Boružėlės;1803710557;Taip;5;0;0;5
14135;Saulutė;Boružėlės;7425789805;Taip;0;6;1;7
14136;Saulutė;Boružėlės;7474989619;Ne;3;0;2;5
14137;Saulutė;Boružėlės;8619163154;Ne;4;0;0;4
14138;Saulutė;Nykštukai;7318452189;Taip;0;8;0;8
14139;Saulutė;Nykštukai;78558743548;Taip;0;3;0;3
14140;Saulutė;Nykštukai;91371507376;Ne;0;0;2;2
14141;Saulutė;Nykštukai;55160240384;Taip;6;4;0;10
14142;Saulutė;Nykštukai;19852146326;Taip;3;1;0;4
14143;Saulutė;Nykštukai;1861612651;Taip;11;0;0;11
14144;Saulutė;Nykštukai;1745560688;Taip;0;0;5;5
14145;Saulutė;Nykštukai;12674831673;Taip;9;0;0;9
14146;Saulutė;Nykštukai;32539394191;Ne;8;0;1;9
14147;Saulutė;Nykštukai;1913500127;Taip;0;1;0;1
14148;Saulutė;Nykštukai;54373231773;Taip;0;2;0;2
14149;Saulutė;Nykštukai;88168936754;Taip;0;0;3;3
14150;Saulutė;Nykštukai;98979263108;Ne;0;0;11;11
14151;Saulutė;Nykštukai;1217446865;Taip;0;0;1;1
14152;Saulutė;Nykštukai;8372468555;Taip;12;0;1;13
14153;Saulutė;Meškiukai;1776164273;Taip;0;0;11;11
14154;Saulutė;Meškiukai;5264813819;Taip;9;0;4;13
14155;Saulutė;Meškiukai;5850783789;Taip;5;0;14;19
14156;Saulutė;Meškiukai;7243072252;Taip;4;0;2;6
14157;Saulutė;Meškiukai;5607937410;Taip;5;6;2;13
14158;Saulutė;Meškiukai;2450554594;Taip;4;0;1;5
14159;Saulutė;Meškiukai;4800144085;Taip;12;0;2;14
14160;Saulutė;Meškiukai;6982979199;Taip;0;0;19;19
14161;Saulutė;Meškiukai;3571751974;Taip;15;0;1;16
14162;Saulutė;Meškiukai;5928628498;Taip;0;0;2;2
14163;Saulutė;Meškiukai;2527027536;Taip;5;0;9;14
14164;Saulutė;Meškiukai;7620841597;Taip;12;0;7;19
14165;Saulutė;Meškiukai;7640441297;Taip;5;0;8;13
14166;Saulutė;Meškiukai;6046611248;Taip;18;0;0;18
14167;Saulutė;Meškiukai;4301516165;Taip;0;0;8;8
14168;Saulutė;Meškiukai;3221612665;Taip;10;0;7;17
14169;Saulutė;Meškiukai;6608003946;Taip;5;0;0;5
14170;Saulutė;Meškiukai;8736917541;Taip;3;0;0;3
14171;Saulutė;Meškiukai;3244850673;Taip;0;0;7;7
14172;Saulutė;Meškiukai;9903380188;Taip;3;0;0;3
14173;Saulutė;Ežiukai;1855999738;Ne;0;0;2;2
14174;Saulutė;Ežiukai;1686338325;Taip;0;0;1;1
14175;Saulutė;Ežiukai;1888990522;Taip;0;0;4;4
14176;Saulutė;Ežiukai;1546200973;Ne;5;0;3;8
14177;Saulutė;Ežiukai;1077526046;Ne;0;0;2;2
14178;Saulutė;Ežiukai;1917058710;Taip;5;6;2;13
14179;Saulutė;Ežiukai;2813274509;Taip;22;0;0;22
14180;Saulutė;Ežiukai;4510990261;Taip;0;0;9;9
14181;Saulutė;Ežiukai;8708184278;Taip;10;0;0;10
14182;Saulutė;Ežiukai;8433646525;Taip;0;0;2;2
14183;Saulutė;Ežiukai;3410606033;Taip;0;3;0;3
14184;Saulutė;Ežiukai;6057668143;Ne;5;0;3;8
14185;Saulutė;Ežiukai;7413098580;Taip;3;0;3;6
14186;Saulutė;Ežiukai;9269501176;Ne;0;0;2;2
14187;Saulutė;Ežiukai;2059342403;Ne;16;0;1;17
14188;Saulutė;Ežiukai;8257363228;Taip;6;0;2;8
14189;Saulutė;Ežiukai;2074473832;Taip;0;0;2;2
14190;Saulutė;Ežiukai;8040751073;Taip;0;0;7;7
14191;Saulutė;Bitutės;8984040932;Taip;5;5;0;10
14192;Saulutė;Bitutės;2373409300;Taip;16;0;3;19
14193;Saulutė;Bitutės;2545930114;Ne;15;0;0;15
14194;Saulutė;Bitutės;1056158093;Taip;13;0;1;14
14195;Saulutė;Bitutės;7297886198;Taip;5;0;8;13
14196;Saulutė;Bitutės;8512137633;Taip;10;0;3;13
14197;Saulutė;Bitutės;4123500930;Ne;0;0;14;14
14198;Saulutė;Bitutės;1745754752;Taip;10;0;0;10
14199;Saulutė;Bitutės;9497439410;Taip;12;0;0;12
14200;Saulutė;Bitutės;8405262902;Taip;8;0;5;13
14201;Saulutė;Bitutės;4363210987;Taip;16;0;0;16
14202;Saulutė;Bitutės;6842585310;Taip;8;0;11;19
14203;Saulutė;Bitutės;2601822200;Taip;0;0;7;7
14204;Saulutė;Bitutės;4211866191;Taip;4;0;7;11
14205;Saulutė;Bitutės;8371366346;Taip;5;0;13;18
14206;Saulutė;Bitutės;7139492238;Taip;8;0;7;15
14207;Saulutė;Bitutės;1323161584;Taip;5;0;7;12
14208;Saulutė;Bitutės;5165268747;Taip;12;7;0;19
14209;Saulutė;Bitutės;7574225926;Taip;0;0;2;2
14210;Saulutė;Pelėdžiukai;3445723020;Ne;0;0;1;1
14211;Saulutė;Pelėdžiukai;27386434894;Taip;3;0;0;3
14212;Saulutė;Pelėdžiukai;65492344097;Taip;11;0;0;11
14213;Saulutė;Pelėdžiukai;1935503629;Taip;0;5;0;5
14214;Saulutė;Pelėdžiukai;31705050946;Taip;0;0;2;2
14215;Saulutė;Pelėdžiukai;14195215027;Taip;5;0;0;5
14216;Saulutė;Pelėdžiukai;50944263059;Taip;10;0;1;11
14217;Saulutė;Pelėdžiukai;1510434265;Taip;0;0;1;1
14218;Saulutė;Pelėdžiukai;5574049005;Taip;14;0;1;15
14219;Saulutė;Pelėdžiukai;4312318284;Taip;18;0;1;19
14220;Saulutė;Pelėdžiukai;27752316336;Taip;2;1;0;3
14221;Saulutė;Pelėdžiukai;77170708225;Taip;0;1;0;1
14222;Saulutė;Pelėdžiukai;5745065672;Taip;0;0;2;2
14223;Saulutė;Pelėdžiukai;9612975694;Taip;3;0;4;7
14224;Saulutė;Pelėdžiukai;4287223197;Taip;0;8;1;9
14225;Saulutė;Pelėdžiukai;5511093996;Taip;0;0;3;3
14226;Saulutė;Pelėdžiukai;7471061365;Ne;0;0;2;2
14227;Saulutė;Zylutės;1277263391;Taip;9;0;1;10
14228;Saulutė;Zylutės;37315117916;Taip;0;0;1;1
14229;Saulutė;Zylutės;75405796772;Ne;9;0;0;9
14230;Saulutė;Zylutės;35570367633;Taip;2;0;1;3
14231;Saulutė;Zylutės;2098990667;Taip;0;0;1;1
14232;Saulutė;Zylutės;1786491396;Taip;6;0;5;11
14233;Saulutė;Zylutės;10893091651;Taip;0;0;2;2
14234;Saulutė;Zylutės;85182498024;Taip;6;0;0;6
14235;Saulutė;Zylutės;16622528829;Taip;4;5;0;9
14236;Saulutė;Zylutės;1911318708;Taip;0;0;1;1
14237;Saulutė;Zylutės;9565528566;Taip;19;0;1;20
14238;Saulutė;Zylutės;1332002470;Taip;0;5;0;5
14239;Saulutė;Zylutės;9081236999;Ne;0;1;6;7
14240;Saulutė;Zylutės;67332285574;Taip;0;0;3;3
14241;Saulutė;Zylutės;28772515317;Ne;0;0;1;1
14242;Saulutė;Zylutės;7564649742;Taip;2;17;0;19
14243;Saulutė;Zylutės;97145959022;Taip;17;0;0;17
14244;Saulutė;"1 klasė";3183309722;Ne;3;0;0;3
14245;Saulutė;"1 klasė";78967475616;Ne;1;0;0;1
14246;Saulutė;"1 klasė";13147367113;Taip;9;0;0;9
14247;Saulutė;"1 klasė";6557918941;Taip;1;0;0;1
14248;Saulutė;"1 klasė";1005459768;Taip;10;0;0;10
14249;Saulutė;"1 klasė";97296161595;Taip;1;0;0;1
14250;Saulutė;"1 klasė";1205642335;Taip;4;0;0;4
14251;Saulutė;"1 klasė";36414547943;Taip;1;0;0;1
14252;Saulutė;"1 klasė";1337654926;Taip;9;0;0;9
14253;Saulutė;"1 klasė";2426509692;Taip;9;0;0;9
14254;Saulutė;"1 klasė";96497471950;Taip;5;0;0;5
14255;Saulutė;"1 klasė";2216383015;Taip;6;0;0;6
14256;Saulutė;"1 klasė";3156830821;Taip;1;0;0;1
14257;Saulutė;"2 klasė";58163470119;Taip;5;0;0;5
14258;Saulutė;"2 klasė";67739063665;Taip;1;0;0;1
14259;Saulutė;"2 klasė";1418237274;Taip;22;0;0;22
14260;Saulutė;"2 klasė";39606108938;Ne;3;0;0;3
14261;Saulutė;"2 klasė";16523279366;Taip;5;0;0;5
14262;Saulutė;"2 klasė";2095347468;Taip;7;0;0;7
14263;Saulutė;"2 klasė";5997216605;Taip;22;0;0;22
14264;Saulutė;"2 klasė";8308288099;Ne;2;0;0;2
14265;Saulutė;"2 klasė";6469772450;Taip;22;0;0;22
14266;Saulutė;"2 klasė";4302511346;Ne;22;0;0;22
14267;Saulutė;"2 klasė";8632066475;Ne;22;0;0;22
14268;Saulutė;"2 klasė";45877127245;Taip;1;0;0;1
14269;Saulutė;"2 klasė";8962761979;Taip;22;0;0;22
14270;Saulutė;"2 klasė";7785909571;Ne;1;0;0;1
14271;Saulutė;"2 klasė";90078805222;Taip;4;0;0;4
14272;Saulutė;"3 klasė";8531372660;Taip;2;0;0;2
14273;Saulutė;"3 klasė";3614749034;Taip;2;0;0;2
14274;Saulutė;"3 klasė";1153099638;Taip;10;0;0;10
14275;Saulutė;"3 klasė";5786453424;Taip;10;0;0;10
14276;Saulutė;"3 klasė";4342595483;Taip;1;0;0;1
14277;Saulutė;"3 klasė";1081812391;Taip;5;0;0;5
14278;Saulutė;"3 klasė";4252242862;Taip;2;0;0;2
14279;Saulutė;"3 klasė";2517511237;Taip;6;0;0;6
14280;Saulutė;"3 klasė";2957436888;Taip;4;0;0;4
14281;Saulutė;"3 klasė";3937034221;Ne;5;0;0;5
14282;Saulutė;"3 klasė";1312993030;Taip;10;0;0;10
14283;Saulutė;"3 klasė";7543978588;Taip;3;0;0;3
14284;Saulutė;"3 klasė";6924270821;Ne;1;0;0;1
14285;Saulutė;"3 klasė";1701868565;Taip;8;0;0;8
14286;Saulutė;"3 klasė";3755300838;Taip;1;0;0;1
14287;Saulutė;"3 klasė";1117229507;Taip;9;0;0;9
14288;Saulutė;"3 klasė";6025668467;Ne;1;0;0;1
14289;Saulutė;"4 klasė";9113434597;Ne;2;0;0;2
14290;Saulutė;"4 klasė";9833653313;Ne;4;0;0;4
14291;Saulutė;"4 klasė";1659579883;Ne;4;0;0;4
14292;Saulutė;"4 klasė";6957680310;Ne;8;0;0;8
14293;Saulutė;"4 klasė";7700196440;Ne;8;0;0;8
14294;Saulutė;"4 klasė";7343265118;Ne;22;0;0;22
14295;Saulutė;"4 klasė";5193599921;Ne;4;0;0;4
14296;Saulutė;"4 klasė";2638495931;Ne;22;0;0;22
14297;Saulutė;"4 klasė";4189732482;Ne;22;0;0;22
14298;Saulutė;"4 klasė";6797161399;Ne;2;0;0;2
14299;Saulutė;"4 klasė";6128992723;Ne;1;0;0;1
14300;Saulutė;"4 klasė";9621988308;Ne;22;0;0;22
14301;Saulutė;"4 klasė";1604607524;Ne;22;0;0;22
14302;Saulutė;"4 klasė";9885756874;Ne;7;0;0;7
14303;Saulutė;"4 klasė";3495588866;Taip;3;0;0;3
14304;Svaja;"STEBUKLINGAS ŽIBINTAS";83624935456;Taip;0;0;1;1
14305;Svaja;"STEBUKLINGAS ŽIBINTAS";9847061480;Taip;3;0;1;4
14306;Svaja;"STEBUKLINGAS ŽIBINTAS";9628146488;Taip;5;0;1;6
14307;Svaja;"STEBUKLINGAS ŽIBINTAS";1304775332;Taip;0;0;1;1
14308;Svaja;"STEBUKLINGAS ŽIBINTAS";26902749194;Taip;0;6;0;6
14309;Svaja;"STEBUKLINGAS ŽIBINTAS";1903424547;Taip;0;0;1;1
14310;Svaja;"STEBUKLINGAS ŽIBINTAS";30360097999;Taip;2;0;4;6
14311;Svaja;"STEBUKLINGAS ŽIBINTAS";19887874988;Taip;0;0;5;5
14312;Svaja;"STEBUKLINGAS ŽIBINTAS";1967394949;Taip;1;0;0;1
14313;Svaja;"STEBUKLINGAS ŽIBINTAS";7719185632;Taip;0;0;1;1
14314;Svaja;"STEBUKLINGAS ŽIBINTAS";1297727288;Taip;0;0;2;2
14315;Svaja;"STEBUKLINGAS ŽIBINTAS";57216954289;Taip;0;0;12;12
14316;Svaja;"STEBUKLINGAS ŽIBINTAS";1352488176;Taip;8;0;2;10
14317;Svaja;"STEBUKLINGAS ŽIBINTAS";44989143252;Taip;0;0;4;4
14318;Svaja;"STEBUKLINGAS ŽIBINTAS";1943166503;Ne;0;3;5;8
14319;Svaja;"STEBUKLINGAS ŽIBINTAS";6056157113;Taip;2;0;3;5
14320;Svaja;"STEBUKLINGAS ŽIBINTAS";43223177664;Taip;0;0;2;2
14321;Svaja;"STEBUKLINGAS ŽIBINTAS";97298858365;Taip;0;0;1;1
14322;Svaja;"STEBUKLINGAS ŽIBINTAS";3077814152;Taip;0;0;4;4
14323;Svaja;"STEBUKLINGAS ŽIBINTAS";3499148291;Taip;0;0;12;12
14324;Svaja;SAULUTĖ;50207734108;Taip;4;0;2;6
14325;Svaja;SAULUTĖ;2493749424;Taip;0;0;3;3
14326;Svaja;SAULUTĖ;30719991872;Taip;13;0;1;14
14327;Svaja;SAULUTĖ;6665752307;Taip;22;0;0;22
14328;Svaja;SAULUTĖ;4968201186;Taip;4;5;0;9
14329;Svaja;SAULUTĖ;8689706130;Taip;0;3;0;3
14330;Svaja;SAULUTĖ;3633996231;Taip;0;0;6;6
14331;Svaja;SAULUTĖ;2750615517;Taip;0;0;6;6
14332;Svaja;SAULUTĖ;4341042027;Taip;0;0;2;2
14333;Svaja;SAULUTĖ;3802996573;Taip;5;0;2;7
14334;Svaja;SAULUTĖ;7936765752;Taip;0;0;2;2
14335;Svaja;SAULUTĖ;4293339784;Taip;14;0;2;16
14336;Svaja;SAULUTĖ;9475971731;Taip;7;0;0;7
14337;Svaja;SAULUTĖ;5479482244;Ne;12;0;0;12
14338;Svaja;SAULUTĖ;7473493846;Taip;9;4;1;14
14339;Svaja;SAULUTĖ;5443682744;Ne;14;2;0;16
14340;Svaja;"AUKSINĖ ŽUVELĖ";43307670660;Taip;0;4;0;4
14341;Svaja;"AUKSINĖ ŽUVELĖ";25194696146;Taip;5;0;0;5
14342;Svaja;"AUKSINĖ ŽUVELĖ";55925058866;Taip;0;0;1;1
14343;Svaja;"AUKSINĖ ŽUVELĖ";1704075006;Ne;4;0;0;4
14344;Svaja;"AUKSINĖ ŽUVELĖ";70641067006;Taip;0;10;0;10
14345;Svaja;"AUKSINĖ ŽUVELĖ";8279605005;Taip;0;0;2;2
14346;Svaja;"AUKSINĖ ŽUVELĖ";1437557657;Taip;14;0;2;16
14347;Svaja;"AUKSINĖ ŽUVELĖ";36505115395;Taip;5;0;2;7
14348;Svaja;"AUKSINĖ ŽUVELĖ";58102699652;Ne;0;1;0;1
14349;Svaja;"AUKSINĖ ŽUVELĖ";5335776957;Ne;0;10;0;10
14350;Svaja;"AUKSINĖ ŽUVELĖ";8242667827;Ne;0;0;5;5
14351;Svaja;"AUKSINĖ ŽUVELĖ";6211339131;Ne;0;0;5;5
14352;Svaja;"AUKSINĖ ŽUVELĖ";1295012978;Taip;5;0;1;6
14353;Svaja;"AUKSINĖ ŽUVELĖ";64196174690;Taip;5;0;0;5
14354;Svaja;"AUKSINĖ ŽUVELĖ";22702341083;Taip;15;0;1;16
14355;Svaja;"AUKSINĖ ŽUVELĖ";2076060840;Taip;8;0;1;9
14356;Svaja;"AUKSINĖ ŽUVELĖ";27445299450;Taip;0;0;3;3
14357;Svaja;"PRIE ĮLANKOS";5522433229;Taip;0;0;3;3
14358;Svaja;"PRIE ĮLANKOS";67462299886;Taip;11;0;0;11
14359;Svaja;"PRIE ĮLANKOS";21608020858;Ne;0;0;5;5
14360;Svaja;"PRIE ĮLANKOS";1655551042;Taip;0;0;1;1
14361;Svaja;"PRIE ĮLANKOS";26500981786;Taip;0;0;1;1
14362;Svaja;"PRIE ĮLANKOS";89042677798;Taip;1;0;0;1
14363;Svaja;"PRIE ĮLANKOS";1601648171;Taip;0;0;1;1
14364;Svaja;"PRIE ĮLANKOS";4804779327;Taip;6;0;1;7
14365;Svaja;"PRIE ĮLANKOS";23112873505;Taip;0;2;0;2
14366;Svaja;"PRIE ĮLANKOS";1400892707;Taip;7;0;0;7
14367;Svaja;"PRIE ĮLANKOS";54745410330;Taip;0;1;0;1
14368;Svaja;"PRIE ĮLANKOS";3022690832;Taip;0;0;3;3
14369;Svaja;"PRIE ĮLANKOS";69413101571;Taip;3;0;0;3
14370;Svaja;"PRIE ĮLANKOS";3035781587;Taip;5;0;0;5
14371;Svaja;"PRIE ĮLANKOS";15246943974;Taip;0;0;3;3
14372;Svaja;"PRIE ĮLANKOS";4881476441;Taip;5;0;0;5
14373;Svaja;"1 A klasė";8828911320;Ne;0;3;0;3
14374;Svaja;"1 A klasė";75104768118;Taip;0;22;0;22
14375;Svaja;"1 A klasė";18238622848;Taip;0;1;0;1
14376;Svaja;"1 A klasė";1649920341;Taip;0;1;0;1
14377;Svaja;"1 A klasė";64487515384;Taip;0;1;0;1
14378;Svaja;"1 A klasė";72752022712;Taip;0;6;0;6
14379;Svaja;"1 A klasė";36386223863;Taip;0;1;0;1
14380;Svaja;"1 A klasė";30754812113;Taip;0;2;0;2
14381;Svaja;SAULĖGRĄŽA;1579441289;Taip;0;0;2;2
14382;Svaja;SAULĖGRĄŽA;9811110367;Taip;0;0;2;2
14383;Svaja;SAULĖGRĄŽA;7023534254;Taip;10;0;0;10
14384;Svaja;SAULĖGRĄŽA;3792660330;Taip;11;0;0;11
14385;Svaja;SAULĖGRĄŽA;9240037050;Taip;17;1;0;18
14386;Svaja;SAULĖGRĄŽA;7575922215;Taip;0;0;1;1
14387;Svaja;SAULĖGRĄŽA;4510147045;Taip;0;5;0;5
14388;Svaja;SAULĖGRĄŽA;9680766688;Taip;9;0;2;11
14389;Svaja;SAULĖGRĄŽA;3912426942;Taip;0;0;3;3
14390;Svaja;SAULĖGRĄŽA;3809817617;Taip;0;4;0;4
14391;Svaja;SAULĖGRĄŽA;3501620040;Taip;12;2;0;14
14392;Svaja;SAULĖGRĄŽA;4333001830;Taip;0;0;3;3
14393;Svaja;SAULĖGRĄŽA;6980866050;Taip;0;0;2;2
14394;Svaja;SAULĖGRĄŽA;6928763381;Taip;3;0;1;4
14395;Svaja;SAULĖGRĄŽA;7408966637;Taip;0;1;0;1
14396;Svaja;SAULĖGRĄŽA;2209697834;Taip;8;1;0;9
14397;Svaja;SAULĖGRĄŽA;7089640807;Taip;21;0;0;21
14398;Svaja;SAULĖGRĄŽA;3461282516;Taip;0;0;2;2
14399;Svaja;SAULĖGRĄŽA;4253831334;Taip;18;0;0;18
14400;Svaja;SAULĖGRĄŽA;6963684639;Taip;0;1;0;1
14401;Šilelis;PAUKŠTELIAI;1048576329;Taip;4;0;2;6
14402;Šilelis;PAUKŠTELIAI;15636728118;Taip;13;0;0;13
14403;Šilelis;PAUKŠTELIAI;79937811039;Taip;9;0;0;9
14404;Šilelis;PAUKŠTELIAI;2478018487;Taip;11;0;0;11
14405;Šilelis;PAUKŠTELIAI;43394471973;Taip;0;7;0;7
14406;Šilelis;PAUKŠTELIAI;78892676375;Ne;3;3;0;6
14407;Šilelis;PAUKŠTELIAI;2033871385;Taip;0;14;0;14
14408;Šilelis;PAUKŠTELIAI;5025537628;Taip;0;0;1;1
14409;Šilelis;PAUKŠTELIAI;1150836049;Ne;5;0;2;7
14410;Šilelis;PAUKŠTELIAI;8337759186;Taip;0;0;5;5
14411;Šilelis;PAUKŠTELIAI;79806281817;Taip;0;0;5;5
14412;Šilelis;PAUKŠTELIAI;1483339314;Taip;0;5;0;5
14413;Šilelis;PAUKŠTELIAI;19141613082;Taip;0;0;2;2
14414;Šilelis;SKRUZDELIUKAI;6510813364;Taip;12;0;0;12
14415;Šilelis;SKRUZDELIUKAI;6099940488;Taip;8;0;0;8
14416;Šilelis;SKRUZDELIUKAI;6139976105;Taip;0;8;0;8
14417;Šilelis;SKRUZDELIUKAI;3940123543;Ne;0;3;4;7
14418;Šilelis;SKRUZDELIUKAI;3823958567;Taip;14;0;0;14
14419;Šilelis;SKRUZDELIUKAI;2289616655;Taip;10;0;0;10
14420;Šilelis;SKRUZDELIUKAI;1887013803;Taip;0;2;0;2
14421;Šilelis;SKRUZDELIUKAI;6359318134;Taip;6;0;2;8
14422;Šilelis;SKRUZDELIUKAI;5598152793;Taip;9;3;0;12
14423;Šilelis;SKRUZDELIUKAI;1200024379;Taip;5;0;0;5
14424;Šilelis;SKRUZDELIUKAI;7299084520;Taip;6;0;1;7
14425;Šilelis;SKRUZDELIUKAI;4196893379;Taip;7;0;0;7
14426;Šilelis;SMERFY;1246899777;Taip;12;4;0;16
14427;Šilelis;SMERFY;93686653078;Taip;4;0;0;4
14428;Šilelis;SMERFY;8980788109;Taip;0;0;1;1
14429;Šilelis;SMERFY;30180586342;Taip;7;0;0;7
14430;Šilelis;SMERFY;7936978436;Taip;5;0;0;5
14431;Šilelis;SMERFY;8100789958;Taip;13;0;0;13
14432;Šilelis;SMERFY;6572969153;Taip;0;2;0;2
14433;Šilelis;SMERFY;3015424614;Taip;0;0;1;1
14434;Šilelis;SMERFY;3247333567;Taip;0;4;0;4
14435;Šilelis;SMERFY;9886134621;Ne;2;0;0;2
14436;Šilelis;SMERFY;5036549574;Taip;7;0;1;8
14437;Šilelis;SMERFY;74190923349;Taip;0;10;0;10
14438;Šilelis;SMERFY;5665331529;Taip;2;0;0;2
14439;Šilelis;SMERFY;6773906184;Ne;5;0;0;5
14440;Šilelis;SMERFY;3089270468;Taip;0;7;0;7
14441;Šilelis;SMERFY;7824279279;Ne;0;8;0;8
14442;Šilelis;SMERFY;4504627601;Taip;8;0;0;8
14443;Šilelis;SMERFY;7534468539;Taip;0;0;4;4
14444;Šilelis;EŽIUKAI;8416126751;Taip;8;0;0;8
14445;Šilelis;EŽIUKAI;9266061396;Ne;3;4;0;7
14446;Šilelis;EŽIUKAI;4494932923;Taip;0;2;0;2
14447;Šilelis;EŽIUKAI;7074963804;Taip;0;7;0;7
14448;Šilelis;EŽIUKAI;1165219272;Taip;0;5;0;5
14449;Šilelis;EŽIUKAI;3234612149;Taip;12;0;0;12
14450;Šilelis;EŽIUKAI;4702068672;Taip;6;3;0;9
14451;Šilelis;EŽIUKAI;1724976098;Taip;5;6;0;11
14452;Šilelis;EŽIUKAI;1586414960;Taip;0;15;0;15
14453;Šilelis;EŽIUKAI;5020209473;Taip;8;0;0;8
14454;Šilelis;EŽIUKAI;2397366916;Taip;17;0;0;17
14455;Šilelis;EŽIUKAI;2151250706;Taip;11;0;0;11
14456;Šilelis;EŽIUKAI;5131051261;Taip;13;0;0;13
14457;Šilelis;EŽIUKAI;8339335908;Taip;8;0;0;8
14458;Šilelis;EŽIUKAI;1883483049;Taip;16;0;0;16
14459;Šilelis;EŽIUKAI;6386996498;Taip;5;0;0;5
14460;Šilelis;EŽIUKAI;4285845345;Taip;6;0;0;6
14461;Šilelis;EŽIUKAI;9354491312;Taip;12;0;0;12
14462;Šilelis;NYKŠTUKAI;53418739087;Taip;6;0;4;10
14463;Šilelis;NYKŠTUKAI;47822247496;Ne;12;0;0;12
14464;Šilelis;NYKŠTUKAI;51144587636;Taip;0;0;2;2
14465;Šilelis;NYKŠTUKAI;27632618220;Taip;0;2;0;2
14466;Šilelis;NYKŠTUKAI;70854637761;Taip;0;0;3;3
14467;Šilelis;NYKŠTUKAI;46963038100;Taip;0;5;0;5
14468;Šilelis;NYKŠTUKAI;36489228256;Ne;7;3;0;10
14469;Šilelis;NYKŠTUKAI;11569489731;Taip;0;1;0;1
14470;Šilelis;NYKŠTUKAI;1062766090;Taip;0;2;0;2
14471;Šilelis;NYKŠTUKAI;1740251009;Taip;4;0;0;4
14472;Šilelis;NYKŠTUKAI;1525689616;Ne;0;2;0;2
14473;Šilelis;NYKŠTUKAI;90624206653;Taip;16;0;0;16
14474;Šilelis;NYKŠTUKAI;4263665228;Taip;0;2;0;2
14475;Šilelis;ANČIUKAI;6560491835;Taip;0;0;2;2
14476;Šilelis;ANČIUKAI;8969858170;Taip;7;0;0;7
14477;Šilelis;ANČIUKAI;2078673522;Taip;0;0;5;5
14478;Šilelis;ANČIUKAI;3489973354;Taip;0;8;0;8
14479;Šilelis;ANČIUKAI;56024407115;Taip;0;1;0;1
14480;Šilelis;ANČIUKAI;5489571459;Taip;11;0;0;11
14481;Šilelis;ANČIUKAI;34382940842;Taip;5;0;2;7
14482;Šilelis;ANČIUKAI;37050806780;Taip;0;1;0;1
14483;Šilelis;ANČIUKAI;1621768113;Taip;0;4;0;4
14484;Šilelis;ANČIUKAI;3892886609;Taip;0;2;0;2
14485;Šilelis;ANČIUKAI;1257686463;Taip;22;0;0;22
14486;Šilelis;ANČIUKAI;1633933962;Ne;14;0;3;17
14487;Šilelis;ANČIUKAI;8127562502;Taip;5;9;0;14
14488;Šilelis;ANČIUKAI;7201199871;Taip;0;1;0;1
14489;Šilelis;ANČIUKAI;1766981537;Taip;0;6;0;6
14490;Šilelis;KAČIUKAI;9899047136;Taip;11;0;0;11
14491;Šilelis;KAČIUKAI;3216168797;Taip;12;0;0;12
14492;Šilelis;KAČIUKAI;4743459915;Ne;5;0;0;5
14493;Šilelis;KAČIUKAI;2420308954;Ne;5;0;2;7
14494;Šilelis;KAČIUKAI;8387022157;Taip;15;0;0;15
14495;Šilelis;KAČIUKAI;3393466953;Taip;0;0;6;6
14496;Šilelis;KAČIUKAI;2111979474;Ne;10;0;0;10
14497;Šilelis;KAČIUKAI;8064905796;Taip;12;0;1;13
14498;Šilelis;KAČIUKAI;5589764935;Taip;12;0;1;13
14499;Šilelis;KAČIUKAI;7123048946;Taip;5;5;0;10
14500;Šilelis;KAČIUKAI;1821827154;Taip;7;0;1;8
14501;Šilelis;KAČIUKAI;1142044361;Taip;0;0;2;2
14502;Šilelis;KAČIUKAI;3686287802;Taip;10;0;0;10
14503;Šilelis;KIŠKUČIAI;62991250307;Taip;5;8;0;13
14504;Šilelis;KIŠKUČIAI;1392455608;Taip;0;0;2;2
14505;Šilelis;KIŠKUČIAI;65917456866;Ne;0;5;0;5
14506;Šilelis;KIŠKUČIAI;193181908;Taip;2;0;0;2
14507;Šilelis;KIŠKUČIAI;21871530266;Taip;0;0;1;1
14508;Šilelis;KIŠKUČIAI;1747920772;Taip;0;0;3;3
14509;Šilelis;KIŠKUČIAI;1904442630;Taip;0;2;0;2
14510;Šilelis;KIŠKUČIAI;1640789816;Taip;0;2;0;2
14511;Šilelis;KIŠKUČIAI;6061033736;Taip;0;18;0;18
14512;Šilelis;KIŠKUČIAI;1976745574;Taip;0;0;2;2
14513;Šilelis;KIŠKUČIAI;88436890881;Taip;0;2;0;2
14514;Šilelis;KIŠKUČIAI;29368876227;Taip;8;0;0;8
14515;Šilelis;KIŠKUČIAI;20920553773;Taip;4;0;1;5
14516;Šilelis;KIŠKUČIAI;5478094866;Taip;0;0;8;8
14517;Šilelis;KIŠKUČIAI;6096639483;Taip;4;2;0;6
14518;Šilelis;KIŠKUČIAI;4332682721;Ne;0;0;2;2
14519;Šilelis;KIŠKUČIAI;2256130191;Taip;14;0;0;14
14520;Šilelis;KIŠKUČIAI;1610171462;Taip;14;0;0;14
14521;Šilelis;KIŠKUČIAI;8491275729;Taip;0;0;1;1
14522;Šilelis;KREGŽDUTĖS;50209412455;Taip;0;1;0;1
14523;Šilelis;KREGŽDUTĖS;1719681061;Taip;0;3;0;3
14524;Šilelis;KREGŽDUTĖS;2049105004;Taip;2;0;0;2
14525;Šilelis;KREGŽDUTĖS;36811772392;Taip;0;3;0;3
14526;Šilelis;KREGŽDUTĖS;1497479780;Taip;0;5;0;5
14527;Šilelis;KREGŽDUTĖS;1958785859;Taip;5;3;0;8
14528;Šilelis;KREGŽDUTĖS;89194687299;Taip;7;5;0;12
14529;Šilelis;KREGŽDUTĖS;1571063782;Taip;15;0;0;15
14530;Šilelis;KREGŽDUTĖS;1930906118;Taip;0;5;0;5
14531;Šilelis;KREGŽDUTĖS;82928837930;Taip;5;2;0;7
14532;Šilelis;KREGŽDUTĖS;5186367833;Ne;0;4;0;4
14533;Šilelis;KREGŽDUTĖS;1984731000;Ne;0;3;0;3
14534;Šilelis;KREGŽDUTĖS;1528581005;Taip;0;3;0;3
14535;Šilelis;KREGŽDUTĖS;40753518660;Taip;3;3;0;6
14536;Šilelis;KREGŽDUTĖS;75274553746;Taip;0;0;20;20
14537;Šilelis;KREGŽDUTĖS;20994727549;Taip;7;0;0;7
14538;Šilelis;KREGŽDUTĖS;8915228012;Taip;0;19;0;19
14539;Šilelis;KREGŽDUTĖS;8012626513;Ne;6;1;0;7
14540;Šilelis;PAGRANDUKAI;43259107285;Taip;0;2;0;2
14541;Šilelis;PAGRANDUKAI;3660152224;Taip;2;0;0;2
14542;Šilelis;PAGRANDUKAI;4814863979;Ne;10;0;1;11
14543;Šilelis;PAGRANDUKAI;9670243727;Taip;0;1;0;1
14544;Šilelis;PAGRANDUKAI;8357287467;Taip;9;1;0;10
14545;Šilelis;PAGRANDUKAI;20525573092;Taip;0;5;0;5
14546;Šilelis;PAGRANDUKAI;1288690113;Taip;0;5;0;5
14547;Šilelis;PAGRANDUKAI;3583955729;Taip;12;0;0;12
14548;Šilelis;PAGRANDUKAI;8199573104;Ne;5;0;1;6
14549;Šilelis;PAGRANDUKAI;9113098594;Taip;5;0;2;7
14550;Šilelis;PAGRANDUKAI;3485639108;Taip;0;2;0;2
14551;Šilelis;PAGRANDUKAI;56885383122;Taip;0;0;3;3
14552;Šilelis;PAGRANDUKAI;8265212749;Taip;0;14;0;14
14553;Šilelis;PAGRANDUKAI;9081488972;Taip;8;0;0;8
14554;Šilelis;PAGRANDUKAI;55396452032;Taip;5;6;0;11
14555;Šilelis;PAGRANDUKAI;7623203279;Taip;10;0;1;11
14556;Šilelis;PAGRANDUKAI;2397630691;Taip;22;0;0;22
14557;Šilelis;PAGRANDUKAI;4340856490;Taip;6;2;0;8
14558;Šilelis;PAGRANDUKAI;3807787648;Taip;10;2;0;12
14559;Šilelis;PAGRANDUKAI;2354942164;Taip;2;2;0;4
14560;Šilelis;PAGRANDUKAI;8687864179;Taip;3;0;0;3
14561;Šilelis;PAGRANDUKAI;6276408187;Taip;0;0;2;2
14562;Šilelis;BITUTĖS;2948291866;Taip;10;3;0;13
14563;Šilelis;BITUTĖS;4682742121;Taip;0;5;0;5
14564;Šilelis;BITUTĖS;5835209357;Taip;0;3;0;3
14565;Šilelis;BITUTĖS;7512731255;Taip;0;6;0;6
14566;Šilelis;BITUTĖS;1268335563;Taip;0;2;0;2
14567;Šilelis;BITUTĖS;4781652156;Taip;0;8;0;8
14568;Šilelis;BITUTĖS;9035595952;Taip;0;3;1;4
14569;Šilelis;BITUTĖS;6104538160;Ne;0;0;5;5
14570;Šilelis;BITUTĖS;8271830626;Ne;20;2;0;22
14571;Šilelis;BITUTĖS;7814807923;Taip;15;4;0;19
14572;Šilelis;BITUTĖS;9071963194;Taip;13;2;6;21
14573;Šilelis;BITUTĖS;1306672095;Ne;3;2;0;5
14574;Šilelis;BITUTĖS;6297546907;Taip;0;0;15;15
14575;Šilelis;BITUTĖS;5843337891;Taip;6;0;0;6
14576;Šilelis;BITUTĖS;1960952604;Taip;0;0;5;5
14577;Šilelis;BITUTĖS;7350013139;Taip;0;3;0;3
14578;Šilelis;BITUTĖS;3879234745;Taip;5;0;2;7
14579;Šilelis;BITUTĖS;3062557053;Taip;0;0;1;1
14580;Šilelis;BITUTĖS;1390916076;Taip;3;10;0;13
14581;Šilelis;DRUGELIAI;1877467761;Taip;5;7;0;12
14582;Šilelis;DRUGELIAI;2079073174;Taip;4;0;0;4
14583;Šilelis;DRUGELIAI;3598370884;Taip;0;14;0;14
14584;Šilelis;DRUGELIAI;1347150938;Ne;0;0;3;3
14585;Šilelis;DRUGELIAI;7636725161;Taip;0;6;0;6
14586;Šilelis;DRUGELIAI;9256656029;Taip;0;4;0;4
14587;Šilelis;DRUGELIAI;1891388542;Taip;0;0;2;2
14588;Šilelis;DRUGELIAI;5759824196;Ne;5;0;0;5
14589;Šilelis;DRUGELIAI;31906089315;Ne;0;0;4;4
14590;Šilelis;DRUGELIAI;4115738520;Taip;0;0;2;2
14591;Šilelis;DRUGELIAI;3824174896;Taip;0;0;2;2
14592;Šilelis;DRUGELIAI;8090765017;Taip;0;6;0;6
14593;Šilelis;DRUGELIAI;54633547799;Taip;0;0;2;2
14594;Šilelis;DRUGELIAI;9100047520;Ne;12;0;0;12
14595;Šilelis;DRUGELIAI;1019874215;Taip;0;3;0;3
14596;Šilelis;DRUGELIAI;5863425750;Taip;9;0;2;11
14597;Šilelis;DRUGELIAI;1448291886;Ne;0;8;0;8
14598;Šilelis;DRUGELIAI;1638362625;Taip;1;0;3;4
14599;Šilelis;DRUGELIAI;6230566495;Taip;11;5;0;16
14600;Šilelis;DRUGELIAI;6523676718;Ne;0;0;3;3
14601;Vaduvos;PAGRANDUKAI;1048630061;Taip;0;14;0;14
14602;Vaduvos;PAGRANDUKAI;1431863758;Taip;0;2;2;4
14603;Vaduvos;PAGRANDUKAI;8408017356;Taip;0;6;0;6
14604;Vaduvos;PAGRANDUKAI;72724196791;Taip;5;10;0;15
14605;Vaduvos;PAGRANDUKAI;9371067563;Taip;0;1;0;1
14606;Vaduvos;PAGRANDUKAI;9987311980;Taip;0;1;0;1
14607;Vaduvos;PAGRANDUKAI;6425640531;Taip;0;0;2;2
14608;Vaduvos;PAGRANDUKAI;18035723255;Ne;0;0;3;3
14609;Vaduvos;PAGRANDUKAI;7397068779;Ne;0;3;0;3
14610;Vaduvos;PAGRANDUKAI;8875709110;Taip;0;3;0;3
14611;Vaduvos;PAGRANDUKAI;4789480822;Taip;0;5;0;5
14612;Vaduvos;PAGRANDUKAI;7305111076;Taip;3;1;0;4
14613;Vaduvos;PAGRANDUKAI;68848152670;Taip;9;0;0;9
14614;Vaduvos;PAGRANDUKAI;4105978403;Taip;0;3;0;3
14615;Vaduvos;PAGRANDUKAI;3111866557;Ne;0;0;3;3
14616;Vaduvos;PAGRANDUKAI;5428067167;Taip;0;2;0;2
14617;Vaduvos;PAGRANDUKAI;3699578284;Taip;12;0;0;12
14618;Vaduvos;KODĖLČIUKAI;9429028460;Taip;8;2;0;10
14619;Vaduvos;KODĖLČIUKAI;6210729584;Taip;1;0;0;1
14620;Vaduvos;KODĖLČIUKAI;9606193112;Taip;9;0;1;10
14621;Vaduvos;KODĖLČIUKAI;9540008495;Taip;2;0;0;2
14622;Vaduvos;KODĖLČIUKAI;4177935331;Taip;0;3;0;3
14623;Vaduvos;KODĖLČIUKAI;9072097216;Ne;0;0;1;1
14624;Vaduvos;KODĖLČIUKAI;6810198013;Taip;0;0;2;2
14625;Vaduvos;KODĖLČIUKAI;9178907705;Taip;20;0;0;20
14626;Vaduvos;KODĖLČIUKAI;3641822841;Taip;22;0;0;22
14627;Vaduvos;KODĖLČIUKAI;4270137614;Taip;4;1;0;5
14628;Vaduvos;KODĖLČIUKAI;3682708061;Taip;5;0;0;5
14629;Vaduvos;KODĖLČIUKAI;7181151562;Taip;8;0;0;8
14630;Vaduvos;KODĖLČIUKAI;5262165284;Taip;2;0;1;3
14631;Vaduvos;KODĖLČIUKAI;8603418399;Taip;7;0;0;7
14632;Vaduvos;KODĖLČIUKAI;3096104197;Taip;12;0;1;13
14633;Vaduvos;KODĖLČIUKAI;5761137540;Ne;0;10;3;13
14634;Vaduvos;KODĖLČIUKAI;1054097622;Taip;8;0;1;9
14635;Vaduvos;SMALSUČIAI;5307128703;Taip;0;1;0;1
14636;Vaduvos;SMALSUČIAI;6121365922;Taip;0;1;6;7
14637;Vaduvos;SMALSUČIAI;62183976729;Taip;8;0;0;8
14638;Vaduvos;SMALSUČIAI;1825188497;Taip;6;0;0;6
14639;Vaduvos;SMALSUČIAI;3555513755;Taip;0;0;3;3
14640;Vaduvos;SMALSUČIAI;3010510262;Taip;0;2;1;3
14641;Vaduvos;SMALSUČIAI;7537754249;Taip;0;0;1;1
14642;Vaduvos;SMALSUČIAI;4565556635;Taip;0;0;4;4
14643;Vaduvos;SMALSUČIAI;4615315809;Taip;3;0;5;8
14644;Vaduvos;SMALSUČIAI;7337663549;Taip;0;0;4;4
14645;Vaduvos;SMALSUČIAI;5055972872;Taip;7;0;1;8
14646;Vaduvos;SMALSUČIAI;6192828320;Taip;7;0;1;8
14647;Vaduvos;SMALSUČIAI;13888236429;Taip;0;0;4;4
14648;Vaduvos;SMALSUČIAI;3722349868;Taip;0;7;0;7
14649;Vaduvos;SMALSUČIAI;3091707832;Taip;5;0;2;7
14650;Vaduvos;SMALSUČIAI;13178417729;Taip;0;9;0;9
14651;Vaduvos;GILIUKAI;11202010413;Taip;0;3;0;3
14652;Vaduvos;GILIUKAI;15757662594;Taip;0;1;0;1
14653;Vaduvos;GILIUKAI;97007740148;Taip;0;0;3;3
14654;Vaduvos;GILIUKAI;1464016847;Taip;0;4;2;6
14655;Vaduvos;GILIUKAI;2006018986;Taip;0;3;0;3
14656;Vaduvos;GILIUKAI;86095539298;Taip;0;0;1;1
14657;Vaduvos;GILIUKAI;59616893535;Taip;14;0;2;16
14658;Vaduvos;GILIUKAI;61046090149;Taip;0;0;1;1
14659;Vaduvos;GILIUKAI;87008942241;Taip;8;0;2;10
14660;Vaduvos;GILIUKAI;68937983441;Taip;0;6;0;6
14661;Vaduvos;GILIUKAI;1703266825;Taip;2;0;0;2
14662;Vaduvos;BORUŽĖLĖS;24887196729;Taip;0;0;4;4
14663;Vaduvos;BORUŽĖLĖS;70693742936;Taip;0;3;0;3
14664;Vaduvos;BORUŽĖLĖS;4670249904;Taip;0;0;1;1
14665;Vaduvos;BORUŽĖLĖS;19390879176;Taip;2;0;0;2
14666;Vaduvos;BORUŽĖLĖS;47465933557;Taip;0;10;0;10
14667;Vaduvos;BORUŽĖLĖS;16006064074;Taip;0;0;5;5
14668;Vaduvos;BORUŽĖLĖS;3172047211;Taip;17;0;0;17
14669;Vaduvos;BORUŽĖLĖS;93924290247;Taip;0;0;5;5
14670;Vaduvos;BORUŽĖLĖS;95104294893;Taip;9;0;3;12
14671;Vaduvos;BORUŽĖLĖS;6155494370;Ne;10;3;0;13
14672;Vaduvos;BORUŽĖLĖS;7957072941;Taip;0;0;15;15
14673;Vaduvos;BORUŽĖLĖS;6386205227;Taip;0;0;8;8
14674;Vaduvos;DRUGELIAI;39687066893;Ne;0;0;1;1
14675;Vaduvos;DRUGELIAI;40872193458;Taip;4;0;0;4
14676;Vaduvos;DRUGELIAI;1241148402;Taip;0;10;0;10
14677;Vaduvos;DRUGELIAI;13203715320;Taip;4;10;3;17
14678;Vaduvos;DRUGELIAI;26736566969;Taip;0;0;1;1
14679;Vaduvos;DRUGELIAI;64074141491;Taip;0;1;0;1
14680;Vaduvos;DRUGELIAI;66359913774;Taip;0;2;0;2
14681;Vaduvos;DRUGELIAI;49738318631;Taip;0;0;1;1
14682;Vaduvos;DRUGELIAI;96892752634;Taip;0;0;2;2
14683;Vaduvos;DRUGELIAI;8802765960;Taip;0;0;5;5
14684;Vaduvos;DRUGELIAI;1107557891;Ne;9;9;0;18
14685;Vaduvos;DRUGELIAI;78931952732;Taip;0;3;0;3
14686;Vaduvos;DRUGELIAI;3632802933;Ne;0;0;1;1
14687;Vaduvos;DRUGELIAI;2605583220;Taip;2;0;0;2
14688;Vaduvos;DRUGELIAI;54193761898;Taip;0;0;1;1
14689;Vaduvos;DRUGELIAI;1010061503;Taip;7;0;3;10
14690;Vaduvos;DRUGELIAI;2348627375;Taip;16;0;0;16
14691;Vaduvos;DRUGELIAI;1139509471;Taip;0;0;4;4
14692;Vaduvos;RIEŠUTĖLIAI;1422507884;Taip;0;0;3;3
14693;Vaduvos;RIEŠUTĖLIAI;2417613291;Taip;13;0;0;13
14694;Vaduvos;RIEŠUTĖLIAI;8324927031;Taip;4;0;3;7
14695;Vaduvos;RIEŠUTĖLIAI;5717064754;Ne;0;0;1;1
14696;Vaduvos;RIEŠUTĖLIAI;5634252033;Taip;5;0;3;8
14697;Vaduvos;RIEŠUTĖLIAI;9705185906;Taip;6;0;0;6
14698;Vaduvos;RIEŠUTĖLIAI;2277525837;Taip;0;3;0;3
14699;Vaduvos;RIEŠUTĖLIAI;6991960029;Taip;10;0;0;10
14700;Vaduvos;"1 klasė";42498568346;Taip;0;1;0;1
14701;Vaduvos;"1 klasė";38504924027;Taip;0;1;0;1
14702;Vaduvos;"1 klasė";96148085691;Taip;0;1;0;1
14703;Vaduvos;"1 klasė";33277362439;Ne;0;1;0;1
14704;Vaduvos;"1 klasė";32138087379;Taip;0;1;0;1
14705;Vaduvos;"1 klasė";67324784528;Taip;0;1;0;1
14706;Vaduvos;"1 klasė";2181614424;Taip;0;4;0;4
14707;Vaduvos;"1 klasė";2019573643;Taip;0;1;0;1
14708;Vaduvos;"1 klasė";27419094487;Taip;0;1;0;1
14709;Vaduvos;"1 klasė";41272273463;Taip;0;3;0;3
14710;Vaduvos;"1 klasė";89793734700;Taip;0;2;0;2
14711;Vaduvos;"1 klasė";17473821556;Taip;0;1;0;1
14712;Vaduvos;"1 klasė";53866301875;Ne;0;2;0;2
14713;Vaduvos;"1 klasė";1532675814;Taip;0;1;0;1
14714;Vaduvos;"1 klasė";36931517006;Taip;0;1;0;1
14715;Vaduvos;"1 klasė";61243424057;Taip;0;1;0;1
14716;Vaduvos;"1 klasė";30979103892;Taip;0;1;0;1
14717;Vaduvos;"1 klasė";78245732319;Taip;0;1;0;1
14718;Vaduvos;"1 klasė";97878811046;Taip;0;2;0;2
14719;Vaduvos;"1 klasė";48433447683;Taip;0;2;0;2
14720;Vaduvos;"1 klasė";12330772986;Taip;0;1;0;1
14721;Vaduvos;"1 klasė";4807104855;Taip;0;3;0;3
14722;Vaduvos;"1 klasė";7786986697;Taip;0;1;0;1
14723;Vaduvos;"1 klasė";98259624669;Taip;0;1;0;1
14724;Vaduvos;"1 klasė";85090873161;Taip;0;1;0;1
14725;Vaduvos;"1 klasė";97423576166;Taip;0;1;0;1
14726;Vaduvos;"2 klasė";96473212525;Taip;0;2;0;2
14727;Vaduvos;"2 klasė";75428164558;Taip;0;7;0;7
14728;Vaduvos;"2 klasė";8188624118;Ne;0;22;0;22
14729;Vaduvos;"2 klasė";63286903462;Taip;0;1;0;1
14730;Vaduvos;"2 klasė";20841176336;Taip;0;22;0;22
14731;Vaduvos;"2 klasė";13721939854;Taip;0;1;0;1
14732;Vaduvos;"2 klasė";7172286009;Taip;0;22;0;22
14733;Vaduvos;"2 klasė";6049882391;Ne;0;3;0;3
14734;Vaduvos;"2 klasė";38013859931;Taip;0;1;0;1
14735;Vaduvos;"2 klasė";61830127618;Taip;0;1;0;1
14736;Vaduvos;"2 klasė";4591744662;Taip;0;22;0;22
14737;Vaduvos;"2 klasė";9149523910;Taip;0;22;0;22
14738;Vaduvos;"2 klasė";76662161382;Taip;0;1;0;1
14739;Vaduvos;"2 klasė";26934740147;Taip;0;22;0;22
14740;Vaduvos;"2 klasė";18300713872;Taip;0;22;0;22
14741;Vaduvos;"2 klasė";768455288;Ne;0;22;0;22
14742;Vaduvos;"2 klasė";1768173501;Taip;0;1;0;1
14743;Vaduvos;"2 klasė";60531886576;Taip;0;3;0;3
14744;Vaduvos;"2 klasė";2004208381;Ne;0;1;0;1
14745;Vaduvos;"2 klasė";38462664426;Ne;0;1;0;1
14746;Vaduvos;"2 klasė";2029363844;Taip;0;22;0;22
14747;Vaduvos;"2 klasė";1821644443;Ne;0;6;0;6
14748;Vaduvos;"2 klasė";1171210935;Ne;0;1;0;1
14749;Vaduvos;"3 klasė";8009941823;Taip;0;1;0;1
14750;Vaduvos;"3 klasė";2423925079;Ne;0;22;0;22
14751;Vaduvos;"3 klasė";7410760461;Taip;0;22;0;22
14752;Vaduvos;"3 klasė";6487033699;Taip;0;1;0;1
14753;Vaduvos;"3 klasė";1671409152;Taip;0;3;0;3
14754;Vaduvos;"3 klasė";5072769647;Taip;0;1;0;1
14755;Vaduvos;"3 klasė";4637670260;Taip;0;1;0;1
14756;Vaduvos;"3 klasė";7236550835;Taip;0;1;0;1
14757;Vaduvos;"3 klasė";9372936408;Taip;0;1;0;1
14758;Vaduvos;"3 klasė";7243175751;Taip;0;1;0;1
14759;Vaduvos;"3 klasė";2482212122;Taip;0;1;0;1
14760;Vaduvos;"3 klasė";1982860223;Taip;0;2;0;2
14761;Vaduvos;"3 klasė";4447152355;Taip;0;1;0;1
14762;Vaduvos;"3 klasė";3325229112;Taip;0;4;0;4
14763;Vaduvos;"3 klasė";5531150399;Taip;0;22;0;22
14764;Vaduvos;"3 klasė";6980440631;Taip;0;1;0;1
14765;Vaduvos;"3 klasė";1091221509;Ne;0;1;0;1
14766;Vaduvos;"3 klasė";7614692200;Taip;0;1;0;1
14767;Vaduvos;"3 klasė";8216757208;Taip;0;1;0;1
14768;Vaduvos;"3 klasė";5459268700;Ne;0;22;0;22
14769;Vaduvos;"3 klasė";5593756016;Taip;0;2;0;2
14770;Vaduvos;"3 klasė";1642242442;Taip;0;2;0;2
14771;Vaduvos;"3 klasė";8928517238;Taip;0;1;0;1
14772;Vaduvos;"3 klasė";5099560123;Taip;0;1;0;1
14773;Vaduvos;"3 klasė";7899239147;Taip;0;1;0;1
14774;Vaduvos;"4 klasė";2149582337;Taip;0;10;0;10
14775;Vaduvos;"4 klasė";3755145838;Taip;0;20;0;20
14776;Vaduvos;"4 klasė";9494193819;Ne;0;21;0;21
14777;Vaduvos;"4 klasė";1086186628;Taip;0;5;0;5
14778;Vaduvos;"4 klasė";6964778383;Taip;0;1;0;1
14779;Vaduvos;"4 klasė";9644782309;Taip;0;1;0;1
14780;Vaduvos;"4 klasė";5786723345;Ne;0;9;0;9
14781;Vaduvos;"4 klasė";7786044620;Taip;0;21;0;21
14782;Vaduvos;"4 klasė";1954540001;Taip;0;9;0;9
14783;Vaduvos;"4 klasė";3583694770;Taip;0;2;0;2
14784;Vaduvos;"4 klasė";6896561963;Taip;0;1;0;1
14785;Vaduvos;"4 klasė";2149582337;Taip;0;11;0;11
14786;Vaduvos;"4 klasė";3755145838;Taip;0;21;0;21
14787;Vaduvos;"4 klasė";9494193819;Ne;0;22;0;22
14788;Vaduvos;"4 klasė";7838224919;Ne;0;1;0;1
14789;Vaduvos;"4 klasė";2520421584;Ne;0;1;0;1
14790;Vaduvos;"4 klasė";1086186628;Taip;0;6;0;6
14791;Vaduvos;"4 klasė";8241399720;Taip;0;1;0;1
14792;Vaduvos;"4 klasė";9441676636;Ne;0;1;0;1
14793;Vaduvos;"4 klasė";1841919654;Ne;0;1;0;1
14794;Vaduvos;"4 klasė";6964778383;Taip;0;2;0;2
14795;Vaduvos;"4 klasė";7719637673;Taip;0;1;0;1
14796;Vaduvos;"4 klasė";9644782309;Taip;0;2;0;2
14797;Vaduvos;"4 klasė";6748405557;Taip;0;1;0;1
14798;Vaduvos;"4 klasė";5523290081;Taip;0;1;0;1
14799;Vaduvos;"4 klasė";5786723345;Ne;0;10;0;10
14800;Vaduvos;"4 klasė";1730710569;Taip;0;1;0;1
14801;Vaduvos;"4 klasė";1461738157;Taip;0;1;0;1
14802;Vaduvos;"4 klasė";6744521293;Ne;0;1;0;1
14803;Vaduvos;"4 klasė";7786044620;Taip;0;22;0;22
14804;Vaduvos;"4 klasė";4347558872;Taip;0;1;0;1
14805;Vaduvos;"4 klasė";1954540001;Taip;0;10;0;10
14806;Vaduvos;"4 klasė";8801412437;Taip;0;1;0;1
14807;Vaduvos;"4 klasė";3583694770;Taip;0;3;0;3
14808;Vaduvos;"4 klasė";9271050464;Taip;0;1;0;1
14809;Vilkpėdės;BORUŽĖLĖS;8969001990;Taip;10;0;0;10
14810;Vilkpėdės;BORUŽĖLĖS;6744834487;Taip;8;1;0;9
14811;Vilkpėdės;BORUŽĖLĖS;7401886306;Taip;3;0;0;3
14812;Vilkpėdės;BORUŽĖLĖS;1528619779;Taip;10;0;0;10
14813;Vilkpėdės;BORUŽĖLĖS;6820236577;Taip;4;0;3;7
14814;Vilkpėdės;BORUŽĖLĖS;5053032081;Taip;11;0;0;11
14815;Vilkpėdės;BORUŽĖLĖS;4166416292;Taip;0;0;1;1
14816;Vilkpėdės;BORUŽĖLĖS;3785308006;Taip;5;0;1;6
14817;Vilkpėdės;BORUŽĖLĖS;6473925760;Taip;11;0;0;11
14818;Vilkpėdės;BORUŽĖLĖS;6283767445;Taip;7;0;0;7
14819;Vilkpėdės;BORUŽĖLĖS;9605430333;Taip;0;0;4;4
14820;Vilkpėdės;BORUŽĖLĖS;3888880306;Taip;2;0;2;4
14821;Vilkpėdės;BORUŽĖLĖS;1571869318;Taip;2;2;0;4
14822;Vilkpėdės;SKRUZDĖLIUKAI;1838974989;Taip;0;0;6;6
14823;Vilkpėdės;SKRUZDĖLIUKAI;8820585407;Taip;0;0;3;3
14824;Vilkpėdės;SKRUZDĖLIUKAI;4018140154;Taip;0;0;2;2
14825;Vilkpėdės;SKRUZDĖLIUKAI;8385974099;Taip;0;0;1;1
14826;Vilkpėdės;SKRUZDĖLIUKAI;5719253028;Taip;13;0;0;13
14827;Vilkpėdės;SKRUZDĖLIUKAI;4031175523;Taip;0;0;2;2
14828;Vilkpėdės;SKRUZDĖLIUKAI;3948025914;Taip;0;0;9;9
14829;Vilkpėdės;SKRUZDĖLIUKAI;9553242594;Taip;0;6;0;6
14830;Vilkpėdės;DRUGELIAI;2420271759;Taip;4;6;0;10
14831;Vilkpėdės;DRUGELIAI;2377248778;Taip;0;0;2;2
14832;Vilkpėdės;DRUGELIAI;7698759895;Taip;0;2;0;2
14833;Vilkpėdės;DRUGELIAI;1019057127;Taip;5;2;1;8
14834;Vilkpėdės;DRUGELIAI;1807884737;Taip;2;1;2;5
14835;Vilkpėdės;DRUGELIAI;6816745585;Taip;4;0;0;4
14836;Vilkpėdės;DRUGELIAI;9460356725;Taip;4;0;0;4
14837;Vilkpėdės;DRUGELIAI;8015392054;Taip;7;2;0;9
14838;Vilkpėdės;DRUGELIAI;2320350937;Taip;5;2;0;7
14839;Vilkpėdės;DRUGELIAI;7894766629;Taip;0;22;0;22
14840;Vilkpėdės;DRUGELIAI;6762306583;Taip;11;3;0;14
14841;Vilkpėdės;DRUGELIAI;9795696242;Taip;2;0;0;2
14842;Vilkpėdės;DRUGELIAI;4095366279;Taip;11;0;0;11
14843;Vilkpėdės;DRUGELIAI;8128254701;Taip;0;4;2;6
14844;Vilkpėdės;DRUGELIAI;7747013579;Taip;0;0;3;3
14845;Vilkpėdės;ŽIOGELIAI;7508333714;Taip;4;0;0;4
14846;Vilkpėdės;ŽIOGELIAI;5551822633;Taip;16;0;0;16
14847;Vilkpėdės;ŽIOGELIAI;9544418642;Taip;3;0;0;3
14848;Vilkpėdės;ŽIOGELIAI;1063740772;Taip;8;1;0;9
14849;Vilkpėdės;ŽIOGELIAI;5633014328;Taip;2;1;0;3
14850;Vilkpėdės;ŽIOGELIAI;5346798201;Taip;6;0;0;6
14851;Vilkpėdės;ŽIOGELIAI;5340239466;Taip;5;0;0;5
14852;Vilkpėdės;ŽIOGELIAI;3720639726;Taip;1;0;2;3
14853;Vilkpėdės;BITUTĖS;9605399822;Taip;0;1;0;1
14854;Vilkpėdės;BITUTĖS;7875898177;Taip;0;1;0;1
14855;Vilkpėdės;BITUTĖS;9867411687;Taip;0;1;0;1
14856;Vilkpėdės;BITUTĖS;4735164204;Taip;7;1;0;8
14857;Vilkpėdės;BITUTĖS;46561435465;Ne;12;7;0;19
14858;Vilkpėdės;BITUTĖS;48059844727;Taip;0;6;0;6
14859;Vilkpėdės;BITUTĖS;1195392132;Taip;5;0;0;5
14860;Vilkpėdės;BITUTĖS;4392760215;Ne;0;1;0;1
14861;Vilkpėdės;BITUTĖS;2955411131;Taip;5;8;0;13
14862;Vilkpėdės;BITUTĖS;2736368118;Taip;0;14;0;14
14863;Vilkpėdės;BITUTĖS;4515945951;Taip;0;0;5;5
14864;Vilkpėdės;BITUTĖS;2900581406;Taip;2;5;0;7
14865;Vilkpėdės;BITUTĖS;7527929277;Taip;5;0;0;5
14866;Vilkpėdės;BITUTĖS;8865545376;Ne;0;10;0;10
14867;Vilkpėdės;BITUTĖS;4276158771;Taip;2;0;0;2
14868;Vilkpėdės;BITUTĖS;7889480219;Ne;0;1;0;1
14869;Vilkpėdės;BITUTĖS;2125569383;Taip;0;7;0;7
14870;Vilkpėdės;"2 klasė";49513181091;Taip;1;0;0;1
14871;Vilkpėdės;"2 klasė";1032216128;Taip;3;0;0;3
14872;Vilkpėdės;"2 klasė";66356984763;Taip;0;1;0;1
14873;Vilkpėdės;"2 klasė";88279045901;Taip;0;1;0;1
14874;Vilkpėdės;"2 klasė";66451097025;Taip;2;0;0;2
14875;Vilkpėdės;"2 klasė";2806307083;Taip;2;0;0;2
14876;Vilkpėdės;"2 klasė";51799865091;Taip;1;0;0;1
14877;Vilkpėdės;GUDRUČIAI;63180329851;Ne;0;1;0;1
14878;Vilkpėdės;GUDRUČIAI;93775558547;Ne;10;1;0;11
14879;Vilkpėdės;GUDRUČIAI;5218466024;Taip;10;0;1;11
14880;Vilkpėdės;GUDRUČIAI;41394645789;Taip;2;5;0;7
14881;Vilkpėdės;GUDRUČIAI;4457851703;Taip;5;0;0;5
14882;Vilkpėdės;GUDRUČIAI;70184817311;Taip;5;3;0;8
14883;Vilkpėdės;GUDRUČIAI;81712437117;Taip;0;7;0;7
14884;Vilkpėdės;GUDRUČIAI;61457409195;Ne;0;9;0;9
14885;Vilkpėdės;GUDRUČIAI;90816091771;Taip;0;1;0;1
14886;Vilkpėdės;GUDRUČIAI;60687258266;Taip;0;5;0;5
14887;Vilkpėdės;GUDRUČIAI;25846393751;Taip;3;0;0;3
14888;Vilkpėdės;GUDRUČIAI;95615604947;Taip;4;5;0;9
14889;Vilkpėdės;GUDRUČIAI;3001209213;Taip;0;1;0;1
14890;Vilkpėdės;GUDRUČIAI;90226911248;Taip;0;1;0;1
14891;Vilkpėdės;GUDRUČIAI;18860888473;Taip;0;1;0;1
14892;Vilkpėdės;GUDRUČIAI;73812058890;Taip;0;22;0;22
14893;Vilkpėdės;GUDRUČIAI;95408044297;Taip;0;1;0;1
14894;Vilkpėdės;GUDRUČIAI;64155507543;Taip;0;0;1;1
14895;Vilkpėdės;GUDRUČIAI;33842357499;Taip;0;1;0;1
14896;Vilkpėdės;GUDRUČIAI;21841574426;Taip;0;7;0;7
14897;Vilkpėdės;GUDRUČIAI;32683398503;Taip;8;2;0;10
14898;Vilkpėdės;GUDRUČIAI;58037049872;Taip;0;1;0;1
14899;Vilkpėdės;SMALSUČIAI;2065010940;Taip;0;5;0;5
14900;Vilkpėdės;SMALSUČIAI;1137529145;Taip;0;1;0;1
14901;Vilkpėdės;SMALSUČIAI;1052719398;Taip;3;1;0;4
14902;Vilkpėdės;SMALSUČIAI;1145968615;Taip;10;1;0;11
14903;Vilkpėdės;SMALSUČIAI;1598018406;Taip;0;2;1;3
14904;Vilkpėdės;SMALSUČIAI;55747681017;Taip;0;0;2;2
14905;Vilkpėdės;SMALSUČIAI;1136036746;Taip;0;2;0;2
14906;Vilkpėdės;SMALSUČIAI;51976067616;Taip;5;2;4;11
14907;Vilkpėdės;SMALSUČIAI;73470824566;Ne;0;0;7;7
14908;Vilkpėdės;SMALSUČIAI;5912919726;Taip;0;1;1;2
14909;Vilkpėdės;SMALSUČIAI;40385792431;Ne;0;8;0;8
14910;Vilkpėdės;SMALSUČIAI;72227817278;Ne;11;2;0;13
14911;Vilkpėdės;SMALSUČIAI;1795879331;Taip;0;0;2;2
14912;Vilkpėdės;SMALSUČIAI;72899151328;Taip;0;0;1;1
14913;Vilkpėdės;SMALSUČIAI;1527272055;Ne;0;2;0;2
14914;Vilkpėdės;SMALSUČIAI;25008201566;Taip;6;14;0;20
14915;Vilkpėdės;SMALSUČIAI;9393571483;Taip;4;0;0;4
14916;Žiburėlis;Nykštukai;6696156248;Ne;5;1;0;6
14917;Žiburėlis;Nykštukai;7163594513;Taip;8;0;0;8
14918;Žiburėlis;Nykštukai;5209976632;Taip;4;0;0;4
14919;Žiburėlis;Nykštukai;5408766721;Ne;15;0;0;15
14920;Žiburėlis;Nykštukai;3646988912;Taip;10;0;0;10
14921;Žiburėlis;Nykštukai;8535429783;Taip;21;0;0;21
14922;Žiburėlis;Nykštukai;9670396828;Ne;12;0;0;12
14923;Žiburėlis;Nykštukai;7211961512;Ne;0;4;0;4
14924;Žiburėlis;Nykštukai;2624326930;Taip;5;6;0;11
14925;Žiburėlis;Nykštukai;6300247811;Taip;8;0;0;8
14926;Žiburėlis;Nykštukai;3033049328;Taip;5;1;0;6
14927;Žiburėlis;Nykštukai;7862546963;Taip;5;0;0;5
14928;Žiburėlis;Nykštukai;8902837168;Taip;5;0;0;5
14929;Žiburėlis;Nykštukai;5303511810;Taip;20;0;0;20
14930;Žiburėlis;Nykštukai;3262856058;Ne;19;1;0;20
14931;Žiburėlis;Nykštukai;5816890413;Taip;13;0;0;13
14932;Žiburėlis;"Žiniukai ";25134435204;Taip;10;0;0;10
14933;Žiburėlis;"Žiniukai ";3966740507;Ne;0;1;0;1
14934;Žiburėlis;"Žiniukai ";1463581257;Ne;6;0;0;6
14935;Žiburėlis;"Žiniukai ";1115857147;Taip;5;0;0;5
14936;Žiburėlis;"Žiniukai ";78896331135;Taip;2;1;0;3
14937;Žiburėlis;"Žiniukai ";32837087738;Taip;0;9;0;9
14938;Žiburėlis;"Žiniukai ";78861342608;Ne;0;1;0;1
14939;Žiburėlis;"Žiniukai ";49081936325;Taip;0;2;0;2
14940;Žiburėlis;"Žiniukai ";7135920347;Taip;0;1;0;1
14941;Žiburėlis;"Žiniukai ";25826760783;Taip;0;4;0;4
14942;Žiburėlis;"Žiniukai ";45509849089;Taip;10;0;0;10
14943;Žiburėlis;"Žiniukai ";73054546792;Taip;4;1;0;5
14944;Žiburėlis;"Žiniukai ";16721946185;Taip;0;1;0;1
14945;Žiburėlis;"Žiniukai ";42442737710;Taip;0;1;0;1
14946;Žiburėlis;"Smalsiukai ";50484332477;Taip;0;6;0;6
14947;Žiburėlis;"Smalsiukai ";5006361324;Taip;4;0;0;4
14948;Žiburėlis;"Smalsiukai ";1876645582;Taip;0;2;0;2
14949;Žiburėlis;"Smalsiukai ";8109335587;Taip;0;2;0;2
14950;Žiburėlis;"Smalsiukai ";4187381976;Taip;0;2;0;2
14951;Žiburėlis;"Smalsiukai ";2982016133;Taip;0;1;0;1
14952;Žiburėlis;"Smalsiukai ";5517458323;Ne;6;0;0;6
14953;Žiburėlis;"Smalsiukai ";1720078356;Ne;8;1;0;9
14954;Žiburėlis;"Smalsiukai ";57892276898;Taip;0;1;0;1
14955;Žiburėlis;"Smalsiukai ";77674964341;Taip;6;0;0;6
14956;Žiburėlis;"Smalsiukai ";13256396372;Taip;0;2;0;2
14957;Žiburėlis;"Smalsiukai ";87417486808;Taip;12;1;0;13
14958;Žiburėlis;"Smalsiukai ";68423991252;Taip;0;3;0;3
14959;Žiburėlis;"Giliukai ";52216192635;Taip;11;0;0;11
14960;Žiburėlis;"Giliukai ";4355778076;Taip;0;2;0;2
14961;Žiburėlis;"Giliukai ";92490398630;Taip;0;2;0;2
14962;Žiburėlis;"Giliukai ";67168630669;Taip;9;3;0;12
14963;Žiburėlis;"Giliukai ";3867540155;Taip;0;7;0;7
14964;Žiburėlis;"Giliukai ";7578655857;Ne;0;1;0;1
14965;Žiburėlis;"Giliukai ";75538036055;Taip;0;2;0;2
14966;Žiburėlis;"Giliukai ";8677998615;Taip;3;1;0;4
14967;Žiburėlis;"Giliukai ";2796489509;Taip;6;3;0;9
14968;Žiburėlis;"Giliukai ";18739941845;Taip;6;0;0;6
14969;Žiburėlis;"Giliukai ";24639355056;Taip;4;6;0;10
14970;Žiburėlis;"Giliukai ";1842029645;Taip;0;1;0;1
14971;Žiburėlis;"Giliukai ";6519139977;Taip;15;5;0;20
14972;Žiburėlis;"Giliukai ";7861704875;Ne;0;7;0;7
14973;Žiburėlis;"Giliukai ";34873231652;Taip;0;2;0;2
14974;Žiburėlis;"Giliukai ";1125662904;Taip;11;0;0;11
14975;Žiburėlis;"Giliukai ";2175751377;Taip;0;3;0;3
14976;Žiburėlis;"Giliukai ";8531121002;Ne;10;2;0;12
14977;Žiburėlis;"Giliukai ";28985997205;Taip;8;3;0;11
14978;Žiburėlis;"1 klasė";5914668910;Ne;0;1;0;1
14979;Žiburėlis;"1 klasė";95216886081;Taip;0;1;0;1
14980;Žiburėlis;"1 klasė";37375035477;Taip;0;1;0;1
14981;Žiburėlis;"1 klasė";54487369856;Taip;0;1;0;1
14982;Žiburėlis;"1 klasė";1483522393;Taip;0;1;0;1
14983;Žiburėlis;"1 klasė";93584914250;Taip;0;1;0;1
14984;Žiburėlis;"1 klasė";1858285649;Taip;0;1;0;1
14985;Žiburėlis;"1 klasė";41774939326;Taip;0;1;0;1
14986;Žiburėlis;"1 klasė";5778346952;Taip;3;1;0;4
14987;Žiburėlis;"1 klasė";67896676967;Taip;0;1;0;1
14988;Žiburėlis;"1 klasė";1852949849;Ne;1;1;0;2
14989;Žiburėlis;"1 klasė";95176636771;Taip;0;1;0;1
14990;Žiburėlis;"1 klasė";88801862582;Taip;4;1;0;5
14991;Žiburėlis;Meškiukai;7070952018;Ne;8;0;0;8
14992;Žiburėlis;Meškiukai;874653320;Taip;0;4;0;4
14993;Žiburėlis;Meškiukai;96004573835;Taip;0;2;0;2
14994;Žiburėlis;Meškiukai;2270893326;Taip;9;0;0;9
14995;Žiburėlis;Meškiukai;1728059994;Taip;6;2;0;8
14996;Žiburėlis;Meškiukai;1523632106;Taip;10;1;0;11
14997;Žiburėlis;Meškiukai;9069606713;Ne;3;2;0;5
14998;Žiburėlis;Meškiukai;46449810717;Taip;5;0;2;7
14999;Žiburėlis;Meškiukai;3678560815;Taip;0;0;1;1
15000;Žiburėlis;Meškiukai;57749440744;Taip;10;0;0;10
15001;Žiburėlis;Meškiukai;1614403409;Taip;0;3;0;3
15002;Žiburėlis;Meškiukai;808556747;Taip;0;16;0;16
15003;Žiburėlis;Meškiukai;50869669391;Taip;0;3;0;3
15004;Žiburėlis;Meškiukai;31669188580;Taip;0;3;0;3
15005;Žiburėlis;Meškiukai;1612968712;Taip;0;1;0;1
15006;Žiburėlis;Meškiukai;5495813195;Taip;0;2;6;8
15007;Žiburėlis;Viščiukai;2491972986;Taip;2;0;0;2
15008;Žiburėlis;Viščiukai;3108947070;Taip;3;0;0;3
15009;Žiburėlis;Viščiukai;8970153523;Taip;10;0;0;10
15010;Žiburėlis;Viščiukai;9589823198;Taip;0;2;0;2
15011;Žiburėlis;Viščiukai;7865562941;Ne;0;1;0;1
15012;Žiburėlis;Viščiukai;8973307069;Taip;5;0;0;5
15013;Žiburėlis;Viščiukai;6669890698;Taip;10;0;0;10
15014;Žiburėlis;Viščiukai;8133371774;Taip;8;0;0;8
15015;Žiburėlis;Viščiukai;4916545915;Taip;5;1;0;6
15016;Žiburėlis;Viščiukai;6647598068;Taip;2;1;0;3
15017;Žiburėlis;Viščiukai;4109288891;Taip;8;0;0;8
15018;Žiburėlis;Viščiukai;7111530833;Ne;4;0;0;4
15019;Žiburėlis;Viščiukai;7825665451;Taip;9;0;0;9
15020;Žiburėlis;"Drambliukai ";7633450988;Taip;5;2;0;7
15021;Žiburėlis;"Drambliukai ";6830200578;Ne;11;0;0;11
15022;Žiburėlis;"Drambliukai ";2253167147;Taip;0;2;0;2
15023;Žiburėlis;"Drambliukai ";7402647048;Taip;0;3;0;3
15024;Žiburėlis;"Drambliukai ";8215816053;Ne;0;2;0;2
15025;Žiburėlis;"Drambliukai ";9352485231;Taip;0;1;0;1
15026;Žiburėlis;"Drambliukai ";4710995351;Taip;8;0;0;8
15027;Žiburėlis;"Drambliukai ";2292895729;Taip;2;2;0;4
15028;Žiburėlis;"Drambliukai ";7273838695;Taip;6;0;0;6
15029;Žiburėlis;"Drambliukai ";5098955523;Taip;0;1;3;4
15030;Žiburėlis;"Drambliukai ";6250610187;Taip;10;12;0;22
15031;Žiburėlis;"Drambliukai ";5629404179;Taip;0;9;0;9
15032;Žiburėlis;"Drambliukai ";9806454408;Taip;0;1;1;2
15033;Žiburėlis;"Drambliukai ";8686565770;Taip;2;3;0;5
15034;Žiburėlis;"Drambliukai ";3938379566;Taip;11;0;0;11
15035;Žiburėlis;"Drambliukai ";5556807335;Taip;13;2;0;15
15036;Žiburėlis;"Drambliukai ";8346571253;Taip;8;1;0;9
15037;Žiburėlis;"2 klasė";78965453247;Ne;0;1;0;1
15038;Žiburėlis;"2 klasė";91489560481;Taip;1;1;0;2
15039;Žiburėlis;"2 klasė";86214644730;Taip;0;1;0;1
15040;Žiburėlis;"2 klasė";50386629614;Taip;0;1;0;1
15041;Žiburėlis;"2 klasė";29289711001;Ne;0;22;0;22
15042;Žiburėlis;"2 klasė";3462265950;Taip;0;22;0;22
15043;Žiburėlis;"2 klasė";97596344387;Taip;1;1;0;2
15044;Žiburėlis;"2 klasė";67880120356;Taip;5;1;0;6
15045;Žiburėlis;"2 klasė";83887875309;Taip;0;1;1;2
15046;Žiburėlis;"2 klasė";75779767358;Ne;1;1;0;2
15047;Žiburėlis;"2 klasė";33877368082;Taip;0;1;0;1
15048;Žiburėlis;"2 klasė";40167464240;Taip;0;1;0;1
15049;Žiburėlis;"2 klasė";91397954329;Taip;0;1;0;1
15050;Žiburėlis;"2 klasė";1266445858;Taip;0;1;0;1
15051;Žiburėlis;"2 klasė";19924188057;Taip;0;1;0;1
15052;Žiburėlis;"2 klasė";16657264022;Taip;0;1;0;1
15053;Žiburėlis;"2 klasė";23334642950;Taip;4;1;0;5
15054;Žiburėlis;"2 klasė";4909760547;Taip;0;1;0;1
15055;Žiburėlis;"3 klasė";8108287017;Ne;0;22;0;22
15056;Žiburėlis;"3 klasė";7328501055;Ne;0;1;0;1
15057;Žiburėlis;"3 klasė";6555937866;Ne;0;1;0;1
15058;Žiburėlis;"3 klasė";9986286327;Ne;0;22;0;22
15059;Žiburėlis;"3 klasė";8967516850;Ne;0;1;0;1
15060;Žiburėlis;"3 klasė";4955196776;Ne;0;1;0;1
15061;Žiburėlis;"3 klasė";5730454385;Ne;2;1;0;3
15062;Žiburėlis;"3 klasė";7420310542;Ne;5;1;0;6
15063;Žiburėlis;"3 klasė";9030168070;Ne;1;1;0;2
15064;Žiburėlis;"3 klasė";1040139766;Ne;0;1;0;1
15065;Žiburėlis;"3 klasė";5120367724;Ne;0;1;0;1
15066;Žiburėlis;"3 klasė";5154752431;Ne;2;1;0;3
15067;Žiburėlis;"3 klasė";2895056046;Ne;5;1;0;6
15068;Žiburėlis;"3 klasė";2980656238;Ne;0;1;0;1
15069;Žiburėlis;"3 klasė";9444201589;Ne;0;1;0;1
15070;Žiburėlis;"3 klasė";6532799193;Ne;0;1;0;1
15071;Žiburėlis;"3 klasė";5587135070;Ne;10;1;0;11
15072;Žiburėlis;"3 klasė";7971654401;Ne;0;1;0;1
15073;Žiburėlis;"3 klasė";7244452816;Ne;0;1;0;1
15074;Žiburėlis;"4 klasė";2145461317;Ne;1;1;0;2
15075;Žiburėlis;"4 klasė";6992801094;Ne;2;1;0;3
15076;Žiburėlis;"4 klasė";7451312098;Ne;0;1;0;1
15077;Žiburėlis;"4 klasė";4444164248;Ne;0;1;0;1
15078;Žiburėlis;"4 klasė";8755335337;Ne;0;22;0;22
15079;Žiburėlis;"4 klasė";9803636658;Ne;0;22;0;22
15080;Žiburėlis;"4 klasė";7239532785;Ne;0;1;0;1
15081;Žiburėlis;"4 klasė";9676316394;Ne;1;1;0;2
15082;Žiburėlis;"4 klasė";8942909201;Ne;5;1;0;6
15083;Žiburėlis;"4 klasė";3493549126;Ne;0;22;0;22
15084;Žiburėlis;"4 klasė";6088424692;Ne;0;22;0;22
15085;Žiburėlis;"4 klasė";5999075406;Ne;0;22;0;22
15086;Žiburėlis;"4 klasė";8539444386;Ne;0;1;0;1
15087;Žiburėlis;"4 klasė";3931688013;Ne;0;22;0;22
15088;Žiburėlis;"4 klasė";1769155142;Ne;2;1;0;3
15089;Justinukas;SMALSUČIŲ;7005815238;Taip;0;1;0;1
15090;Justinukas;SMALSUČIŲ;13170636069;Taip;0;2;0;2
15091;Justinukas;SMALSUČIŲ;3118698712;Taip;7;0;0;7
15092;Justinukas;SMALSUČIŲ;3312575449;Taip;3;1;0;4
15093;Justinukas;SMALSUČIŲ;1773690115;Taip;15;5;0;20
15094;Justinukas;SMALSUČIŲ;1121936989;Taip;0;1;0;1
15095;Justinukas;SMALSUČIŲ;46705419124;Taip;5;1;0;6
15096;Justinukas;SMALSUČIŲ;49343952061;Ne;0;2;0;2
15097;Justinukas;SMALSUČIŲ;8741735734;Taip;0;0;19;19
15098;Justinukas;SMALSUČIŲ;8529082669;Taip;0;12;0;12
15099;Justinukas;SMALSUČIŲ;7678062264;Taip;0;12;0;12
15100;Justinukas;SMALSUČIŲ;1830060403;Taip;4;4;1;9
15101;Justinukas;SMALSUČIŲ;6597383913;Taip;13;0;0;13
15102;Justinukas;SMALSUČIŲ;3062444365;Taip;0;2;0;2
15103;Justinukas;SMALSUČIŲ;93600065957;Taip;16;0;0;16
15104;Justinukas;SMALSUČIŲ;2317566323;Taip;12;0;1;13
15105;Justinukas;SMALSUČIŲ;9343761295;Taip;0;11;0;11
15106;Justinukas;SVAJOKLIŲ;9822696769;Taip;0;9;0;9
15107;Justinukas;SVAJOKLIŲ;1627717901;Taip;3;0;0;3
15108;Justinukas;SVAJOKLIŲ;6234625191;Ne;9;2;0;11
15109;Justinukas;SVAJOKLIŲ;752609119;Taip;0;1;0;1
15110;Justinukas;SVAJOKLIŲ;5225263863;Taip;0;1;0;1
15111;Justinukas;SVAJOKLIŲ;3863971540;Taip;0;3;0;3
15112;Justinukas;SVAJOKLIŲ;43527855441;Taip;0;2;0;2
15113;Justinukas;SVAJOKLIŲ;16029286933;Taip;0;2;0;2
15114;Justinukas;SVAJOKLIŲ;8971898312;Taip;0;4;0;4
15115;Justinukas;SVAJOKLIŲ;48101258124;Taip;0;1;0;1
15116;Justinukas;SVAJOKLIŲ;1216138998;Taip;0;8;0;8
15117;Justinukas;SVAJOKLIŲ;3790209561;Taip;16;4;0;20
15118;Justinukas;SVAJOKLIŲ;9558483512;Taip;2;0;0;2
15119;Justinukas;SVAJOKLIŲ;1814943669;Taip;3;4;0;7
15120;Justinukas;SVAJOKLIŲ;37288931495;Taip;0;8;0;8
15121;Justinukas;SVAJOKLIŲ;8636869322;Ne;17;0;0;17
15122;Justinukas;SVAJOKLIŲ;6766493175;Taip;4;3;0;7
15123;Justinukas;SVAJOKLIŲ;5494500249;Taip;4;3;0;7
15124;Justinukas;SVAJOKLIŲ;6816901962;Taip;0;4;0;4
15125;Justinukas;SVAJOKLIŲ;3657642693;Taip;0;4;0;4
15126;Justinukas;"SAULĖS ZUIKIŲ";1550323727;Taip;0;2;0;2
15127;Justinukas;"SAULĖS ZUIKIŲ";1801800210;Taip;0;2;0;2
15128;Justinukas;"SAULĖS ZUIKIŲ";40999006978;Taip;8;1;0;9
15129;Justinukas;"SAULĖS ZUIKIŲ";3813820356;Taip;0;15;0;15
15130;Justinukas;"SAULĖS ZUIKIŲ";3215259838;Taip;9;4;0;13
15131;Justinukas;"SAULĖS ZUIKIŲ";66240994100;Taip;6;3;0;9
15132;Justinukas;"SAULĖS ZUIKIŲ";8350429513;Taip;0;1;0;1
15133;Justinukas;"SAULĖS ZUIKIŲ";2532510817;Taip;0;7;0;7
15134;Justinukas;"SAULĖS ZUIKIŲ";52253951149;Taip;0;8;0;8
15135;Justinukas;"SAULĖS ZUIKIŲ";9411813711;Taip;0;0;7;7
15136;Justinukas;"SAULĖS ZUIKIŲ";78270625975;Taip;12;3;0;15
15137;Justinukas;"SAULĖS ZUIKIŲ";5215250778;Taip;12;0;1;13
15138;Justinukas;"SAULĖS ZUIKIŲ";2018007566;Taip;13;1;0;14
15139;Justinukas;"SAULĖS ZUIKIŲ";1590855655;Taip;0;10;0;10
15140;Justinukas;"SAULĖS ZUIKIŲ";49880907488;Taip;3;4;0;7
15141;Justinukas;"SAULĖS ZUIKIŲ";76257661228;Taip;0;3;0;3
15142;Justinukas;"SAULĖS ZUIKIŲ";1967313365;Taip;0;5;2;7
15143;Justinukas;"SAULĖS ZUIKIŲ";56402748009;Taip;0;1;0;1
15144;Justinukas;PABIRUČIŲ;7727870261;Ne;0;0;3;3
15145;Justinukas;PABIRUČIŲ;6482808707;Taip;3;1;0;4
15146;Justinukas;PABIRUČIŲ;4756483798;Ne;0;2;0;2
15147;Justinukas;PABIRUČIŲ;6470287041;Taip;0;5;0;5
15148;Justinukas;PABIRUČIŲ;3268913601;Taip;13;0;0;13
15149;Justinukas;PABIRUČIŲ;2017929633;Taip;0;1;0;1
15150;Justinukas;PABIRUČIŲ;7710916537;Taip;8;0;0;8
15151;Justinukas;PABIRUČIŲ;4194429972;Ne;0;3;0;3
15152;Justinukas;PABIRUČIŲ;8913463448;Ne;1;0;1;2
15153;Justinukas;PABIRUČIŲ;7854674833;Taip;0;1;0;1
15154;Justinukas;PABIRUČIŲ;3768735503;Taip;10;0;0;10
15155;Justinukas;PABIRUČIŲ;8086378912;Taip;12;0;0;12
15156;Justinukas;PABIRUČIŲ;4271601149;Taip;0;1;0;1
15157;Justinukas;PABIRUČIŲ;8603454290;Taip;0;7;0;7
15158;Justinukas;PABIRUČIŲ;5928377774;Taip;11;0;0;11
15159;Justinukas;PABIRUČIŲ;4698732792;Taip;0;0;11;11
15160;Justinukas;PABIRUČIŲ;5524861976;Taip;3;0;1;4
15161;Justinukas;PABIRUČIŲ;2160089993;Taip;0;3;0;3
15162;Justinukas;PABIRUČIŲ;8878782037;Taip;6;0;0;6
15163;Justinukas;PABIRUČIŲ;2585198498;Taip;2;0;0;2
15164;Justinukas;VYTURIUKŲ;1585956968;Taip;0;2;0;2
15165;Justinukas;VYTURIUKŲ;4056697803;Taip;0;18;0;18
15166;Justinukas;VYTURIUKŲ;1181972027;Taip;0;6;0;6
15167;Justinukas;VYTURIUKŲ;59176678396;Taip;0;3;0;3
15168;Justinukas;VYTURIUKŲ;1598234416;Taip;0;7;0;7
15169;Justinukas;VYTURIUKŲ;1785794727;Taip;4;1;3;8
15170;Justinukas;VYTURIUKŲ;99512297006;Taip;2;0;0;2
15171;Justinukas;VYTURIUKŲ;28095047700;Taip;4;1;0;5
15172;Justinukas;VYTURIUKŲ;91620507403;Taip;4;0;2;6
15173;Justinukas;VYTURIUKŲ;35192728896;Taip;0;1;0;1
15174;Justinukas;VYTURIUKŲ;13774489893;Taip;21;0;0;21
15175;Justinukas;VYTURIUKŲ;2002649360;Taip;0;4;0;4
15176;Justinukas;VYTURIUKŲ;30823793919;Taip;4;0;2;6
15177;Justinukas;VYTURIUKŲ;89330918024;Ne;0;10;0;10
15178;Justinukas;KODĖLČIUKŲ;8566530492;Taip;0;2;0;2
15179;Justinukas;KODĖLČIUKŲ;9226989209;Taip;9;0;0;9
15180;Justinukas;KODĖLČIUKŲ;2900181358;Taip;0;2;0;2
15181;Justinukas;KODĖLČIUKŲ;2268124610;Taip;0;12;0;12
15182;Justinukas;KODĖLČIUKŲ;5978993456;Taip;6;9;0;15
15183;Justinukas;KODĖLČIUKŲ;8874979704;Taip;7;0;0;7
15184;Justinukas;KODĖLČIUKŲ;3193143474;Taip;9;0;0;9
15185;Justinukas;KODĖLČIUKŲ;1540892686;Taip;18;0;0;18
15186;Justinukas;KODĖLČIUKŲ;3013789713;Taip;8;0;0;8
15187;Justinukas;KODĖLČIUKŲ;3611504027;Taip;0;0;1;1
15188;Justinukas;KODĖLČIUKŲ;8650379074;Taip;7;0;0;7
15189;Justinukas;KODĖLČIUKŲ;2594906884;Taip;4;0;0;4
15190;Justinukas;KODĖLČIUKŲ;2808141352;Taip;0;0;6;6
15191;Justinukas;VIKRUOLIŲ;59108759161;Taip;15;0;1;16
15192;Justinukas;VIKRUOLIŲ;2776259830;Taip;0;0;1;1
15193;Justinukas;VIKRUOLIŲ;95467011497;Taip;0;7;0;7
15194;Justinukas;VIKRUOLIŲ;48732379120;Ne;0;1;0;1
15195;Justinukas;VIKRUOLIŲ;1844038414;Taip;8;1;0;9
15196;Justinukas;VIKRUOLIŲ;2952798555;Taip;8;0;1;9
15197;Justinukas;VIKRUOLIŲ;54102488427;Taip;0;4;0;4
15198;Justinukas;VIKRUOLIŲ;28543773229;Taip;0;1;0;1
15199;Justinukas;VIKRUOLIŲ;68853730495;Taip;0;0;2;2
15200;Justinukas;VIKRUOLIŲ;80827159258;Taip;6;0;0;6
15201;Justinukas;VIKRUOLIŲ;311074533;Taip;12;0;0;12
15202;Justinukas;VIKRUOLIŲ;7120661911;Taip;0;1;0;1
15203;Justinukas;VIKRUOLIŲ;55151392377;Taip;0;2;0;2
15204;Justinukas;VIKRUOLIŲ;97284171512;Taip;10;0;0;10
15205;Justinukas;VIKRUOLIŲ;1480054888;Taip;0;5;3;8
15206;Justinukas;VIKRUOLIŲ;5199005933;Taip;4;2;0;6
15207;Justinukas;PELEDŽIUKŲ;6268022925;Taip;21;0;0;21
15208;Justinukas;PELEDŽIUKŲ;1405642653;Taip;0;3;0;3
15209;Justinukas;PELEDŽIUKŲ;1976450069;Taip;0;3;0;3
15210;Justinukas;PELEDŽIUKŲ;90692179185;Taip;0;3;0;3
15211;Justinukas;PELEDŽIUKŲ;61301662234;Taip;3;4;0;7
15212;Justinukas;PELEDŽIUKŲ;2027779101;Ne;2;0;2;4
15213;Justinukas;PELEDŽIUKŲ;8742157840;Taip;9;0;0;9
15214;Justinukas;PELEDŽIUKŲ;55089909579;Taip;9;0;0;9
15215;Justinukas;PELEDŽIUKŲ;12741015006;Ne;0;7;0;7
15216;Justinukas;PELEDŽIUKŲ;48908098476;Taip;0;4;0;4
15217;Justinukas;PELEDŽIUKŲ;1956136425;Taip;0;1;0;1
15218;Justinukas;PELEDŽIUKŲ;29165025048;Taip;0;0;4;4
15219;Justinukas;PELEDŽIUKŲ;8748370028;Taip;5;0;3;8
15220;Justinukas;PELEDŽIUKŲ;5610993611;Taip;0;0;2;2
15221;Justinukas;PELEDŽIUKŲ;67366895767;Taip;0;10;0;10
15222;Justinukas;ŽIRNIUKŲ;1447493567;Taip;10;1;0;11
15223;Justinukas;ŽIRNIUKŲ;8185266162;Taip;5;0;0;5
15224;Justinukas;ŽIRNIUKŲ;9569479551;Taip;1;0;0;1
15225;Justinukas;ŽIRNIUKŲ;6184892609;Taip;7;0;0;7
15226;Justinukas;ŽIRNIUKŲ;8242805821;Taip;8;0;0;8
15227;Justinukas;ŽIRNIUKŲ;1779138446;Taip;7;0;0;7
15228;Justinukas;ŽIRNIUKŲ;3777745443;Taip;5;1;0;6
15229;Justinukas;ŽIRNIUKŲ;8564006025;Taip;5;1;0;6
15230;Justinukas;ŽIRNIUKŲ;5490753578;Taip;9;0;1;10
15231;Justinukas;ŽIRNIUKŲ;5711628356;Taip;5;2;0;7
15232;Justinukas;ŽIRNIUKŲ;9151163087;Taip;4;2;0;6
15233;Justinukas;ŽIRNIUKŲ;6984802993;Taip;8;0;0;8
15234;Justinukas;GUDRUČIŲ;2495027317;Taip;5;2;0;7
15235;Justinukas;GUDRUČIŲ;5337728911;Taip;10;0;0;10
15236;Justinukas;GUDRUČIŲ;2378107030;Taip;0;1;0;1
15237;Justinukas;GUDRUČIŲ;9714895573;Taip;12;0;0;12
15238;Justinukas;GUDRUČIŲ;7135292839;Taip;5;0;0;5
15239;Justinukas;GUDRUČIŲ;9037601873;Taip;3;0;1;4
15240;Justinukas;GUDRUČIŲ;7035968183;Taip;8;0;1;9
15241;Justinukas;GUDRUČIŲ;8874149122;Taip;0;11;0;11
15242;Justinukas;GUDRUČIŲ;3138582167;Taip;5;4;2;11
15243;Justinukas;GUDRUČIŲ;3082687604;Taip;6;0;1;7
15244;Justinukas;GUDRUČIŲ;7989662358;Taip;0;4;0;4
15245;Justinukas;GUDRUČIŲ;2362568676;Taip;0;0;3;3
15246;Justinukas;BORUŽIUKŲ;4542350401;Taip;4;2;0;6
15247;Justinukas;BORUŽIUKŲ;4347647695;Taip;4;2;0;6
15248;Justinukas;BORUŽIUKŲ;3388483002;Taip;12;0;5;17
15249;Justinukas;BORUŽIUKŲ;9998493076;Taip;0;7;0;7
15250;Justinukas;BORUŽIUKŲ;1129392970;Taip;5;0;0;5
15251;Justinukas;BORUŽIUKŲ;8281005516;Taip;7;0;1;8
15252;Justinukas;BORUŽIUKŲ;1398976932;Taip;11;0;0;11
15253;Justinukas;BORUŽIUKŲ;1977242147;Taip;2;0;0;2
15254;Justinukas;BORUŽIUKŲ;5258444578;Taip;0;0;2;2
15255;Justinukas;BORUŽIUKŲ;4574673585;Taip;3;1;0;4
15256;Justinukas;BORUŽIUKŲ;7006338378;Taip;0;2;0;2
15257;Justinukas;BORUŽIUKŲ;7166828675;Ne;5;0;1;6
15258;Justinukas;BORUŽIUKŲ;4010638658;Taip;0;2;0;2
15259;Justinukas;BORUŽIUKŲ;1172609518;Ne;5;0;5;10
15260;Justinukas;BORUŽIUKŲ;1616324236;Taip;4;1;0;5
15261;Justinukas;BORUŽIUKŲ;3030820917;Taip;0;14;0;14
15262;Justinukas;BORUŽIUKŲ;4430183106;Ne;5;0;10;15
15263;Justinukas;BORUŽIUKŲ;1507699415;Taip;13;0;1;14
15264;Aidas;Boružėlių;2027860670;Ne;0;0;3;3
15265;Aidas;Boružėlių;8915901727;Taip;0;0;2;2
15266;Aidas;Boružėlių;5311183877;Taip;11;0;2;13
15267;Aidas;Boružėlių;5962551687;Taip;0;0;22;22
15268;Aidas;Drugelių;7094228848;Ne;0;9;0;9
15269;Aidas;Drugelių;5560434420;Ne;0;9;0;9
15270;Aidas;Aitvariukų;17920063762;Taip;0;0;2;2
15271;Aidas;Aitvariukų;3127870635;Taip;0;0;3;3
15272;Aidas;Aitvariukų;3366848846;Taip;0;0;4;4
15273;Aidas;Aitvariukų;6835234112;Taip;0;0;1;1
15274;Aidas;Aitvariukų;3473596157;Taip;5;0;0;5
15275;Aidas;Aitvariukų;3748420427;Ne;1;0;0;1
15276;Aidas;"Meškučių kl.";5806540190;Taip;0;0;7;7
15277;Aidas;"Gaidelių kl.";2501187241;Ne;0;0;3;3
15278;Aidas;"Gaidelių kl.";3442250711;Ne;0;0;1;1
15279;Aidas;"Gaidelių kl.";6213577188;Ne;0;0;3;3
15280;Aidas;"Gaidelių kl.";2446003793;Ne;0;0;2;2
15281;Aidas;"Gaidelių kl.";2234931428;Ne;6;0;0;6
15282;Aidas;"Kiškelių kl";7354905114;Ne;8;1;0;9
15283;Aidas;"Kiškelių kl";5905008395;Ne;0;1;0;1
15284;Aidas;"Kiškelių kl";9613466086;Taip;0;0;7;7
15285;Aidas;"Ančiukų kl.";63508565206;Ne;0;0;1;1
15286;Aidas;"Ančiukų kl.";1079077463;Taip;0;0;3;3
15287;Aidas;"Ančiukų kl.";3194974747;Ne;0;0;1;1
15288;Aidas;"Ančiukų kl.";72751441075;Taip;3;0;3;6
15289;Aidas;"Pelėdžiukų kl.";5712688030;Ne;0;0;1;1
15290;Aidas;"Pelėdžiukų kl.";3279914631;Ne;0;0;4;4
15291;Aidas;"Papūgėlių kl.";4372628947;Ne;0;0;14;14
15292;Aidas;"Papūgėlių kl.";7821044288;Ne;9;0;0;9
15293;Aidas;"Saulutės kl.";1535004699;Ne;0;0;14;14
15294;Aidas;"Saulutės kl.";74897451962;Taip;0;0;2;2
15295;Aidas;"Saulutės kl.";4890362155;Taip;12;0;0;12
15296;Aidas;"Saulutės kl.";7329254454;Taip;5;0;0;5
15297;Aidas;"Katinėlių kl.";6356218442;Ne;1;0;0;1
15298;Aidas;"Katinėlių kl.";92425322676;Ne;0;0;9;9
15299;Aidas;"Katinėlių kl.";4081645294;Ne;0;0;1;1
15300;Aidas;"Katinėlių kl.";81654551230;Taip;0;0;2;2
15301;Aidas;"Katinėlių kl.";9944901942;Ne;0;2;0;2
15302;Bangelė;"Jūros žvaigždutės ";6861123988;Taip;5;5;0;10
15303;Bangelė;"Jūros žvaigždutės ";2658414287;Ne;0;0;6;6
15304;Bangelė;"Jūros žvaigždutės ";2017886238;Taip;0;0;1;1
15305;Bangelė;"Jūros žvaigždutės ";8758933649;Taip;6;0;2;8
15306;Bangelė;"Jūros žvaigždutės ";9041585534;Taip;7;5;0;12
15307;Bangelė;"Jūros žvaigždutės ";4338067260;Taip;5;8;0;13
15308;Bangelė;"Jūros žvaigždutės ";4412780063;Taip;16;0;5;21
15309;Bangelė;"Jūros žvaigždutės ";9009809585;Ne;0;0;2;2
15310;Bangelė;"Jūros žvaigždutės ";6044653707;Taip;5;9;0;14
15311;Bangelė;"Jūros žvaigždutės ";1915827035;Taip;5;9;0;14
15312;Bangelė;"Jūros žvaigždutės ";7685394517;Taip;4;0;3;7
15313;Bangelė;"Jūros žvaigždutės ";9706351115;Taip;8;0;0;8
15314;Bangelė;"Jūros žvaigždutės ";6693019825;Taip;4;0;3;7
15315;Bangelė;"Jūros žvaigždutės ";3991021350;Taip;7;0;6;13
15316;Bangelė;"Jūros žvaigždutės ";3990966706;Taip;0;9;0;9
15317;Bangelė;"Jūros žvaigždutės ";2764009011;Taip;6;0;1;7
15318;Bangelė;"Jūros žvaigždutės ";8799415648;Taip;0;0;16;16
15319;Bangelė;"Jūros žvaigždutės ";7230987338;Taip;0;3;0;3
15320;Bangelė;"Jūros žvaigždutės ";7337449523;Taip;15;0;1;16
15321;Bangelė;Žuvytės;9983202427;Ne;4;0;7;11
15322;Bangelė;Žuvytės;47454787439;Taip;6;9;0;15
15323;Bangelė;Žuvytės;3961043533;Taip;9;0;0;9
15324;Bangelė;Žuvytės;2112394008;Taip;7;0;1;8
15325;Bangelė;Žuvytės;5323726165;Taip;12;0;8;20
15326;Bangelė;Žuvytės;8836861853;Taip;0;1;1;2
15327;Bangelė;Žuvytės;4571869439;Taip;6;1;0;7
15328;Bangelė;Žuvytės;6712145066;Taip;3;0;3;6
15329;Bangelė;Žuvytės;1528387105;Taip;0;5;0;5
15330;Bangelė;Žuvytės;4506651162;Taip;0;0;3;3
15331;Bangelė;Žuvytės;9672505885;Taip;6;0;9;15
15332;Bangelė;Žuvytės;7723290276;Taip;8;0;0;8
15333;Bangelė;Žuvytės;2872188915;Taip;5;0;0;5
15334;Bangelė;Žuvytės;9822287576;Taip;0;0;8;8
15335;Bangelė;Žuvytės;7375004714;Ne;7;0;1;8
15336;Bangelė;Žuvytės;7701956270;Taip;0;0;6;6
15337;Bangelė;Žuvytės;1367082230;Taip;5;5;1;11
15338;Bangelė;Žuvytės;1348995498;Ne;0;10;0;10
15339;Gėlynas;PAKALNUTĖ;6375754699;Taip;0;0;3;3
15340;Gėlynas;PAKALNUTĖ;2349352560;Taip;0;0;1;1
15341;Gėlynas;PAKALNUTĖ;4445250490;Taip;0;3;0;3
15342;Gėlynas;PAKALNUTĖ;1897547388;Taip;3;0;3;6
15343;Gėlynas;PAKALNUTĖ;9911225363;Taip;4;12;0;16
15344;Gėlynas;PAKALNUTĖ;2400929266;Taip;0;0;5;5
15345;Gėlynas;PAKALNUTĖ;6898127005;Ne;0;10;0;10
15346;Gėlynas;PAKALNUTĖ;2906909558;Taip;0;18;0;18
15347;Gėlynas;PAKALNUTĖ;3365442661;Taip;9;3;2;14
15348;Gėlynas;PAKALNUTĖ;6528464599;Taip;11;0;2;13
15349;Gėlynas;PAKALNUTĖ;5395474698;Taip;0;1;0;1
15350;Gėlynas;PAKALNUTĖ;90046802421;Taip;5;0;1;6
15351;Gėlynas;PAKALNUTĖ;8615943743;Taip;5;0;1;6
15352;Gėlynas;PAKALNUTĖ;7814357385;Taip;7;2;0;9
15353;Gėlynas;PAKALNUTĖ;1674569569;Taip;0;3;0;3
15354;Gėlynas;PAKALNUTĖ;5695333666;Taip;0;20;0;20
15355;Gėlynas;PAKALNUTĖ;2348787949;Taip;0;2;0;2
15356;Gėlynas;VARPELIS;72991081966;Taip;8;0;0;8
15357;Gėlynas;VARPELIS;14307514975;Taip;0;12;0;12
15358;Gėlynas;VARPELIS;72544014665;Taip;6;0;2;8
15359;Gėlynas;VARPELIS;93919808581;Taip;0;0;2;2
15360;Gėlynas;VARPELIS;31532261756;Taip;7;8;0;15
15361;Gėlynas;VARPELIS;85912494214;Taip;5;0;0;5
15362;Gėlynas;VARPELIS;22067595840;Taip;9;2;0;11
15363;Gėlynas;VARPELIS;91530210644;Ne;4;0;3;7
15364;Gėlynas;VARPELIS;75222833700;Taip;6;1;0;7
15365;Gėlynas;VARPELIS;95681874019;Taip;0;2;0;2
15366;Gėlynas;VARPELIS;40702362906;Taip;0;11;0;11
15367;Gėlynas;VARPELIS;1406567756;Taip;0;1;0;1
15368;Gėlynas;VARPELIS;58542813068;Ne;0;0;1;1
15369;Gėlynas;VARPELIS;63379609794;Taip;4;0;1;5
15370;Gėlynas;RAKTAŽOLĖ;1797681067;Taip;7;0;0;7
15371;Gėlynas;RAKTAŽOLĖ;1117528954;Ne;0;7;0;7
15372;Gėlynas;RAKTAŽOLĖ;57429063547;Taip;12;0;0;12
15373;Gėlynas;RAKTAŽOLĖ;7796794153;Taip;0;0;2;2
15374;Gėlynas;RAKTAŽOLĖ;6264361257;Ne;0;3;0;3
15375;Gėlynas;RAKTAŽOLĖ;1047462165;Taip;0;14;0;14
15376;Gėlynas;RAKTAŽOLĖ;1754734306;Ne;0;3;0;3
15377;Gėlynas;RAKTAŽOLĖ;9780911032;Taip;0;1;0;1
15378;Gėlynas;RAKTAŽOLĖ;84546885977;Ne;0;17;0;17
15379;Gėlynas;RAKTAŽOLĖ;5135747448;Taip;0;4;0;4
15380;Gėlynas;RAKTAŽOLĖ;7808971151;Taip;0;5;0;5
15381;Gėlynas;RAKTAŽOLĖ;7337987259;Taip;0;2;0;2
15382;Gėlynas;RAKTAŽOLĖ;9026298982;Ne;0;14;0;14
15383;Gėlynas;RAKTAŽOLĖ;4382465307;Taip;0;16;0;16
15384;Gėlynas;RAKTAŽOLĖ;7562201835;Taip;5;0;0;5
15385;Gėlynas;RAKTAŽOLĖ;2417880374;Taip;0;0;4;4
15386;Gėlynas;SAULĖGRĄŽA;1995694892;Taip;0;0;1;1
15387;Gėlynas;SAULĖGRĄŽA;1191494598;Ne;17;0;2;19
15388;Gėlynas;SAULĖGRĄŽA;1407350449;Taip;5;0;0;5
15389;Gėlynas;SAULĖGRĄŽA;1676904275;Taip;19;0;0;19
15390;Gėlynas;SAULĖGRĄŽA;85310323038;Taip;0;3;0;3
15391;Gėlynas;SAULĖGRĄŽA;47220216751;Taip;0;7;0;7
15392;Gėlynas;SAULĖGRĄŽA;2099722437;Taip;3;2;1;6
15393;Gėlynas;SAULĖGRĄŽA;86881175896;Taip;2;1;0;3
15394;Gėlynas;SAULĖGRĄŽA;1053422007;Taip;11;0;0;11
15395;Gėlynas;SAULĖGRĄŽA;1608626732;Taip;11;0;0;11
15396;Gėlynas;SAULĖGRĄŽA;2018911523;Taip;21;0;0;21
15397;Gėlynas;SAULĖGRĄŽA;1431418368;Taip;5;0;0;5
15398;Gėlynas;SAULĖGRĄŽA;15277524754;Taip;1;0;0;1
15399;Gėlynas;SAULĖGRĄŽA;8324564359;Taip;0;10;0;10
15400;Gėlynas;RAMUNĖLĖ;6451922757;Taip;0;0;6;6
15401;Gėlynas;RAMUNĖLĖ;4983822000;Taip;0;0;2;2
15402;Gėlynas;RAMUNĖLĖ;5898582218;Taip;8;0;0;8
15403;Gėlynas;RAMUNĖLĖ;2742456983;Taip;10;0;0;10
15404;Gėlynas;RAMUNĖLĖ;5124029118;Ne;0;7;0;7
15405;Gėlynas;RAMUNĖLĖ;6815740588;Ne;0;11;0;11
15406;Gėlynas;RAMUNĖLĖ;5541707540;Taip;14;0;0;14
15407;Gėlynas;RAMUNĖLĖ;5964419627;Taip;5;0;1;6
15408;Gėlynas;RAMUNĖLĖ;4824667762;Taip;7;5;0;12
15409;Gėlynas;RAMUNĖLĖ;2141722631;Taip;6;1;0;7
15410;Gėlynas;RAMUNĖLĖ;1505666690;Taip;8;0;3;11
15411;Gėlynas;RAMUNĖLĖ;3492361041;Taip;2;0;3;5
15412;Gėlynas;RAMUNĖLĖ;4505012978;Taip;4;0;0;4
15413;Gėlynas;ŽIBUTĖ;6042268146;Taip;10;1;0;11
15414;Gėlynas;ŽIBUTĖ;9724668402;Taip;3;1;0;4
15415;Gėlynas;ŽIBUTĖ;1822933936;Taip;10;1;1;12
15416;Gėlynas;ŽIBUTĖ;8999346908;Taip;13;2;0;15
15417;Gėlynas;ŽIBUTĖ;6114995335;Taip;18;0;0;18
15418;Gėlynas;ŽIBUTĖ;7998013477;Ne;12;0;0;12
15419;Gėlynas;ŽIBUTĖ;9330385153;Taip;3;0;0;3
15420;Gėlynas;ŽIBUTĖ;9462822190;Ne;0;6;0;6
15421;Gėlynas;ŽIBUTĖ;5291444399;Ne;10;0;0;10
15422;Obelėlė;Bildukai;43664898514;Taip;5;0;1;6
15423;Obelėlė;Bildukai;58388471530;Taip;5;0;0;5
15424;Obelėlė;Bildukai;1466324860;Taip;3;1;0;4
15425;Obelėlė;Bildukai;52857531341;Taip;5;1;0;6
15426;Obelėlė;Bildukai;68222818886;Ne;0;0;1;1
15427;Obelėlė;Bildukai;1831642058;Taip;3;4;0;7
15428;Obelėlė;Bildukai;13913516066;Taip;8;0;0;8
15429;Obelėlė;Bildukai;50077685481;Taip;0;3;0;3
15430;Obelėlė;Bildukai;22986329944;Ne;12;0;0;12
15431;Obelėlė;Bildukai;29677456066;Taip;10;0;0;10
15432;Obelėlė;Bildukai;646883449;Taip;5;0;0;5
15433;Obelėlė;Bildukai;89380447507;Taip;0;0;2;2
15434;Obelėlė;Bildukai;1816297607;Ne;6;0;1;7
15435;Obelėlė;Gudručiai;2014314139;Taip;6;0;2;8
15436;Obelėlė;Gudručiai;9900484892;Taip;7;7;0;14
15437;Obelėlė;Gudručiai;6145113624;Taip;5;0;2;7
15438;Obelėlė;Gudručiai;9586720282;Taip;14;0;2;16
15439;Obelėlė;Gudručiai;9567704282;Taip;22;0;0;22
15440;Obelėlė;Gudručiai;9305279614;Taip;1;3;0;4
15441;Obelėlė;Gudručiai;4015702815;Taip;15;0;0;15
15442;Obelėlė;Gudručiai;4309139638;Taip;2;0;2;4
15443;Obelėlė;Gudručiai;5141585309;Taip;0;0;5;5
15444;Obelėlė;Gudručiai;9736557012;Taip;20;0;0;20
15445;Obelėlė;Gudručiai;6720058972;Taip;0;0;3;3
15446;Obelėlė;Gudručiai;4451814487;Taip;9;0;0;9
15447;Obelėlė;Gudručiai;2053807216;Taip;6;0;1;7
15448;Obelėlė;Gudručiai;1184082097;Taip;11;0;0;11
15449;Obelėlė;Gudručiai;6466755394;Taip;0;1;0;1
15450;Obelėlė;Gudručiai;2533715287;Taip;5;0;0;5
15451;Obelėlė;Gudručiai;1598785483;Taip;11;1;0;12
15452;Obelėlė;Drugeliai;5960204860;Taip;0;11;0;11
15453;Obelėlė;Drugeliai;1271351257;Taip;11;0;3;14
15454;Obelėlė;Drugeliai;1980250599;Taip;0;0;1;1
15455;Obelėlė;Drugeliai;4111486929;Taip;5;0;0;5
15456;Obelėlė;Drugeliai;8115772385;Taip;0;0;4;4
15457;Obelėlė;Drugeliai;2018689468;Taip;0;0;1;1
15458;Obelėlė;Drugeliai;7120041402;Taip;0;0;2;2
15459;Obelėlė;Drugeliai;9059791812;Taip;0;0;2;2
15460;Obelėlė;Drugeliai;4835765774;Taip;0;0;2;2
15461;Obelėlė;Drugeliai;8173154620;Taip;0;0;1;1
15462;Obelėlė;Drugeliai;46597815116;Taip;0;0;6;6
15463;Obelėlė;Drugeliai;65578250853;Taip;0;0;17;17
15464;Obelėlė;Drugeliai;1044733634;Taip;0;0;2;2
15465;Obelėlė;Drugeliai;1847501295;Taip;15;0;1;16
15466;Obelėlė;Drugeliai;6693601673;Taip;11;0;1;12
15467;Obelėlė;Pasakaitė;1695933896;Taip;6;0;5;11
15468;Obelėlė;Pasakaitė;1833543299;Taip;0;0;2;2
15469;Obelėlė;Pasakaitė;1555780072;Taip;0;0;5;5
15470;Obelėlė;Pasakaitė;77743243622;Taip;0;0;1;1
15471;Obelėlė;Pasakaitė;1543298097;Taip;0;0;1;1
15472;Obelėlė;Pasakaitė;3330983614;Taip;5;0;0;5
15473;Obelėlė;Pasakaitė;4257479486;Taip;0;0;4;4
15474;Obelėlė;Pasakaitė;8394566707;Taip;0;5;2;7
15475;Obelėlė;Pasakaitė;10939948244;Taip;0;0;3;3
15476;Obelėlė;Pasakaitė;1141707374;Taip;0;0;1;1
15477;Obelėlė;Pasakaitė;6789881144;Taip;0;0;2;2
15478;Obelėlė;Pasakaitė;8324404990;Taip;22;0;0;22
15479;Obelėlė;Pasakaitė;1893470952;Taip;13;7;0;20
15480;Obelėlė;Pasakaitė;7754276632;Taip;0;22;0;22
15481;Obelėlė;Svajokliai;7647724926;Taip;4;0;0;4
15482;Obelėlė;Svajokliai;2093164210;Taip;4;0;0;4
15483;Obelėlė;Svajokliai;8202131299;Ne;4;0;2;6
15484;Obelėlė;Svajokliai;58153232854;Taip;2;0;5;7
15485;Obelėlė;Svajokliai;57788788343;Taip;0;0;2;2
15486;Obelėlė;Svajokliai;2014450377;Taip;0;5;2;7
15487;Obelėlė;Svajokliai;5512990125;Taip;0;0;1;1
15488;Obelėlė;Svajokliai;1824412493;Taip;6;0;3;9
15489;Obelėlė;Svajokliai;52277220462;Ne;0;3;1;4
15490;Obelėlė;Svajokliai;1210385417;Taip;0;0;3;3
15491;Obelėlė;Svajokliai;82119081040;Taip;0;0;7;7
15492;Obelėlė;Svajokliai;1670594471;Ne;2;1;0;3
15493;Obelėlė;Svajokliai;1536889615;Taip;5;0;3;8
15494;Obelėlė;Svajokliai;1484822838;Taip;12;0;2;14
15495;Obelėlė;Smalsučiai;43103357250;Ne;1;0;2;3
15496;Obelėlė;Smalsučiai;1337679766;Taip;0;0;2;2
15497;Obelėlė;Smalsučiai;2107924334;Taip;0;0;12;12
15498;Obelėlė;Smalsučiai;1844067391;Taip;4;0;0;4
15499;Obelėlė;Smalsučiai;72467035839;Taip;0;0;2;2
15500;Obelėlė;Smalsučiai;3220190193;Ne;0;0;4;4
15501;Obelėlė;Smalsučiai;39757539751;Taip;0;0;1;1
15502;Obelėlė;Smalsučiai;20691217408;Taip;0;0;1;1
15503;Obelėlė;Smalsučiai;35495444231;Ne;0;0;3;3
15504;Obelėlė;Smalsučiai;97298049429;Taip;0;0;1;1
15505;Obelėlė;Smalsučiai;68776273648;Taip;0;0;6;6
15506;Obelėlė;Smalsučiai;2605865270;Ne;0;0;6;6
15507;Obelėlė;Smalsučiai;1915402358;Taip;0;0;2;2
15508;Obelėlė;Smalsučiai;1758206243;Taip;0;0;10;10
15509;Obelėlė;Smalsučiai;78242377913;Taip;7;0;0;7
15510;Obelėlė;Pabiručiai;1547195948;Taip;3;2;1;6
15511;Obelėlė;Pabiručiai;1586544097;Taip;0;0;2;2
15512;Obelėlė;Pabiručiai;94350358246;Taip;0;0;1;1
15513;Obelėlė;Pabiručiai;79388410820;Taip;0;0;1;1
15514;Obelėlė;Pabiručiai;40103909643;Taip;0;16;0;16
15515;Obelėlė;Pabiručiai;1420633482;Taip;2;0;1;3
15516;Obelėlė;Pabiručiai;1698995389;Taip;6;1;0;7
15517;Obelėlė;Pabiručiai;31018018065;Taip;0;0;2;2
15518;Obelėlė;Pabiručiai;2015165566;Ne;0;0;6;6
15519;Obelėlė;Pabiručiai;16430825029;Taip;0;5;0;5
15520;Obelėlė;Pabiručiai;8882103124;Taip;0;0;2;2
15521;Obelėlė;Pabiručiai;5471194804;Taip;0;0;1;1
15522;Obelėlė;Pabiručiai;69055416041;Taip;0;9;0;9
15523;Obelėlė;Pabiručiai;74455701543;Taip;6;0;0;6
15524;Obelėlė;Pabiručiai;74564453474;Taip;0;12;0;12
15525;Obelėlė;Strakaliukai;1706102918;Taip;0;0;1;1
15526;Obelėlė;Strakaliukai;2770477678;Taip;0;0;3;3
15527;Obelėlė;Strakaliukai;8682794598;Taip;0;4;1;5
15528;Obelėlė;Strakaliukai;8754552660;Taip;0;11;0;11
15529;Obelėlė;Strakaliukai;8092024850;Taip;0;0;1;1
15530;Obelėlė;Strakaliukai;4251418414;Taip;0;4;0;4
15531;Obelėlė;Strakaliukai;7128421330;Taip;8;7;1;16
15532;Obelėlė;Strakaliukai;5943314566;Taip;0;22;0;22
15533;Obelėlė;Strakaliukai;3116100694;Taip;8;0;0;8
15534;Obelėlė;Strakaliukai;5326258755;Taip;10;9;0;19
15535;Obelėlė;Strakaliukai;5741823041;Taip;0;0;2;2
15536;Obelėlė;Strakaliukai;8050551266;Taip;14;0;0;14
15537;Obelėlė;Strakaliukai;7468335279;Taip;7;0;1;8
15538;Obelėlė;Strakaliukai;1180508643;Taip;0;0;6;6
15539;Obelėlė;Strakaliukai;7124393375;Taip;0;0;12;12
15540;Obelėlė;Strakaliukai;1040304018;Taip;1;0;1;2
15541;Obelėlė;Strakaliukai;7514587933;Taip;15;0;2;17
15542;Obelėlė;Strakaliukai;5001844064;Taip;6;0;4;10
15543;Obelėlė;Saulutė;98290583667;Ne;3;0;0;3
15544;Obelėlė;Saulutė;77954383604;Taip;0;0;1;1
15545;Obelėlė;Saulutė;1826138505;Taip;0;0;1;1
15546;Obelėlė;Saulutė;1741425229;Taip;6;0;2;8
15547;Obelėlė;Saulutė;1336592238;Taip;4;0;0;4
15548;Obelėlė;Saulutė;1240673124;Taip;0;0;1;1
15549;Obelėlė;Saulutė;24010838180;Taip;0;11;0;11
15550;Obelėlė;Saulutė;1061262980;Taip;0;0;1;1
15551;Obelėlė;Saulutė;6054898307;Taip;0;9;1;10
15552;Obelėlė;Saulutė;3076493150;Taip;3;0;4;7
15553;Obelėlė;Saulutė;1521926754;Ne;0;0;11;11
15554;Obelėlė;Saulutė;6720229368;Ne;0;0;2;2
15555;Obelėlė;Saulutė;1021948127;Taip;10;0;0;10
15556;Obelėlė;Saulutė;4107928390;Taip;0;0;1;1
15557;Obelėlė;Rieduliukai;8173307704;Taip;0;22;0;22
15558;Obelėlė;Rieduliukai;6364101139;Taip;9;1;0;10
15559;Obelėlė;Rieduliukai;6691540418;Taip;10;0;0;10
15560;Obelėlė;Rieduliukai;6008839269;Taip;6;0;0;6
15561;Obelėlė;Rieduliukai;6020342761;Taip;4;0;0;4
15562;Obelėlė;Rieduliukai;4987747783;Taip;0;0;5;5
15563;Obelėlė;Rieduliukai;5085970254;Taip;0;0;4;4
15564;Obelėlė;Rieduliukai;8709758561;Taip;8;0;1;9
15565;Obelėlė;Rieduliukai;5739522736;Taip;7;0;3;10
15566;Obelėlė;Rieduliukai;2631405243;Taip;10;0;0;10
15567;Obelėlė;Rieduliukai;1867185320;Taip;15;0;5;20
15568;Obelėlė;Rieduliukai;9796759067;Taip;8;0;0;8
15569;Obelėlė;Rieduliukai;6720808705;Taip;0;0;4;4
15570;Obelėlė;Rieduliukai;7850656031;Taip;8;0;0;8
15571;Obelėlė;Rieduliukai;9084969712;Taip;0;0;6;6
15572;Obelėlė;Žirniukai;7794072582;Taip;7;0;0;7
15573;Obelėlė;Žirniukai;9641297002;Taip;0;0;3;3
15574;Obelėlė;Žirniukai;8918176312;Taip;0;0;2;2
15575;Obelėlė;Žirniukai;9070960601;Taip;0;15;0;15
15576;Obelėlė;Žirniukai;7003947655;Taip;0;0;5;5
15577;Obelėlė;Žirniukai;3986892111;Taip;10;0;0;10
15578;Obelėlė;Žirniukai;1705232474;Taip;0;0;1;1
15579;Obelėlė;Žirniukai;5620250331;Taip;16;0;0;16
15580;Obelėlė;Žirniukai;5588467580;Taip;0;0;15;15
15581;Obelėlė;Žirniukai;8231489868;Taip;5;0;0;5
15582;Obelėlė;Žirniukai;7094715237;Taip;0;0;3;3
15583;Obelėlė;Žirniukai;4489212434;Taip;0;0;10;10
15584;Obelėlė;Žirniukai;8183287212;Taip;0;0;7;7
15585;Obelėlė;Bičiuliai;9031690002;Taip;8;0;0;8
15586;Obelėlė;Bičiuliai;3425736276;Taip;10;0;0;10
15587;Obelėlė;Bičiuliai;1507072248;Taip;18;0;0;18
15588;Obelėlė;Bičiuliai;5776116844;Taip;10;1;0;11
15589;Obelėlė;Bičiuliai;8487088625;Taip;0;0;6;6
15590;Obelėlė;Bičiuliai;1630067014;Taip;0;12;0;12
15591;Obelėlė;Bičiuliai;1537769810;Taip;7;0;0;7
15592;Obelėlė;Bičiuliai;8371648703;Taip;0;0;3;3
15593;Obelėlė;Bičiuliai;3517342646;Taip;5;0;0;5
15594;Obelėlė;Bičiuliai;8757731600;Taip;22;0;0;22
15595;Obelėlė;Bičiuliai;2329734472;Taip;0;1;0;1
15596;Obelėlė;Bičiuliai;1419189517;Taip;0;0;2;2
15597;Obelėlė;Bičiuliai;4220808775;Ne;2;5;11;18
15598;Obelėlė;Bičiuliai;7934760271;Taip;11;5;2;18
15599;Obelėlė;Bičiuliai;4849175527;Taip;10;5;0;15
15600;Obelėlė;Bičiuliai;1362135757;Ne;0;0;1;1
15601;Obelėlė;Bičiuliai;3769993089;Taip;14;0;1;15
15602;Obelėlė;Bičiuliai;5374979248;Taip;8;0;0;8
15603;Obelėlė;Bičiuliai;5568285702;Taip;0;0;5;5
15604;Spygliukas;Bitutės;5827455834;Taip;0;4;1;5
15605;Spygliukas;Bitutės;9975117461;Taip;0;0;3;3
15606;Spygliukas;Bitutės;16828631895;Ne;0;0;3;3
15607;Spygliukas;Bitutės;4653108810;Ne;0;4;0;4
15608;Spygliukas;Bitutės;2980459339;Taip;4;0;0;4
15609;Spygliukas;Bitutės;7421000718;Ne;9;0;0;9
15610;Spygliukas;Bitutės;8103481313;Taip;5;0;8;13
15611;Spygliukas;Bitutės;4430242310;Taip;0;0;1;1
15612;Spygliukas;Bitutės;5022615426;Taip;0;5;0;5
15613;Spygliukas;Bitutės;7250958367;Taip;0;2;0;2
15614;Spygliukas;Bitutės;1679263120;Taip;0;1;0;1
15615;Spygliukas;Bitutės;9001243644;Taip;3;10;2;15
15616;Spygliukas;Bitutės;8646122773;Taip;1;5;1;7
15617;Spygliukas;Bitutės;4933577424;Taip;0;0;1;1
15618;Spygliukas;Bitutės;8992822256;Taip;15;1;1;17
15619;Spygliukas;Bitutės;1940209166;Ne;5;0;0;5
15620;Spygliukas;Bitutės;1855897974;Ne;0;0;1;1
15621;Spygliukas;Kiškučiai;8802722601;Taip;5;0;2;7
15622;Spygliukas;Kiškučiai;6248409896;Ne;5;0;1;6
15623;Spygliukas;Kiškučiai;3416275094;Taip;9;0;0;9
15624;Spygliukas;Kiškučiai;4477402331;Taip;7;0;0;7
15625;Spygliukas;Kiškučiai;6917435881;Taip;0;1;0;1
15626;Spygliukas;Kiškučiai;3569857813;Taip;10;0;2;12
15627;Spygliukas;Kiškučiai;2772801133;Taip;8;0;0;8
15628;Spygliukas;Kiškučiai;2177856916;Taip;1;0;7;8
15629;Spygliukas;Kiškučiai;6931145017;Taip;9;0;2;11
15630;Spygliukas;Kiškučiai;9285259322;Taip;0;1;0;1
15631;Spygliukas;Kiškučiai;8806126755;Taip;10;2;3;15
15632;Spygliukas;Kiškučiai;4245624629;Taip;0;0;2;2
15633;Spygliukas;Kiškučiai;6332646009;Taip;7;0;1;8
15634;Spygliukas;Kiškučiai;5765106914;Taip;0;2;0;2
15635;Spygliukas;Kiškučiai;8825264090;Taip;0;0;3;3
15636;Spygliukas;Boružėlės;1238940921;Taip;0;0;1;1
15637;Spygliukas;Boružėlės;9288806012;Taip;0;1;2;3
15638;Spygliukas;Boružėlės;4104158994;Taip;0;0;7;7
15639;Spygliukas;Boružėlės;10858715103;Taip;0;1;1;2
15640;Spygliukas;Boružėlės;1002603766;Taip;0;8;0;8
15641;Spygliukas;Boružėlės;34209607173;Taip;0;1;0;1
15642;Spygliukas;Boružėlės;1842315404;Taip;0;1;0;1
15643;Spygliukas;Boružėlės;7114613140;Taip;0;1;0;1
15644;Spygliukas;Boružėlės;92279064240;Taip;0;12;0;12
15645;Spygliukas;Boružėlės;30201229961;Ne;0;1;1;2
15646;Spygliukas;Boružėlės;79584454527;Taip;0;8;0;8
15647;Spygliukas;Boružėlės;47977103711;Taip;0;0;1;1
15648;Spygliukas;Boružėlės;1321926079;Taip;0;2;0;2
15649;Spygliukas;Boružėlės;9513387087;Ne;5;1;5;11
15650;Spygliukas;Boružėlės;1193015656;Taip;4;0;0;4
15651;Spygliukas;Ežiukai;1832756255;Taip;0;6;0;6
15652;Spygliukas;Ežiukai;9593700812;Taip;0;0;3;3
15653;Spygliukas;Ežiukai;2126162527;Taip;14;0;0;14
15654;Spygliukas;Ežiukai;1260920726;Ne;0;1;1;2
15655;Spygliukas;Ežiukai;42285404110;Taip;0;1;0;1
15656;Spygliukas;Ežiukai;2040903312;Taip;11;4;0;15
15657;Spygliukas;Ežiukai;3037648954;Taip;0;1;0;1
15658;Spygliukas;Ežiukai;1211969263;Taip;2;5;0;7
15659;Spygliukas;Ežiukai;7219659640;Taip;0;1;2;3
15660;Spygliukas;Ežiukai;1881745347;Taip;0;1;0;1
15661;Spygliukas;Ežiukai;4355472423;Taip;0;0;1;1
15662;Spygliukas;Ežiukai;53324066837;Ne;0;0;1;1
15663;Spygliukas;Ežiukai;9957292202;Taip;0;0;1;1
15664;Spygliukas;Ežiukai;1298381738;Taip;0;8;2;10
15665;Spygliukas;Ežiukai;7649832094;Taip;3;1;2;6
15666;Spygliukas;Ežiukai;5780485510;Taip;0;0;1;1
15667;Spygliukas;Ežiukai;8686118262;Taip;0;1;0;1
15668;Spygliukas;Ežiukai;5253108181;Taip;7;2;0;9
15669;Spygliukas;Ežiukai;3785469286;Taip;0;0;6;6
15670;Spygliukas;Ežiukai;29015391754;Taip;5;2;2;9
15671;Spygliukas;Ežiukai;84556142803;Taip;8;5;0;13
15672;Spygliukas;Geniukai;6242194100;Taip;5;0;1;6
15673;Spygliukas;Geniukai;4577592862;Ne;11;0;2;13
15674;Spygliukas;Geniukai;4721066953;Ne;0;0;1;1
15675;Spygliukas;Geniukai;4949371837;Taip;0;0;2;2
15676;Spygliukas;Geniukai;4650693672;Taip;0;0;5;5
15677;Spygliukas;Geniukai;6835488489;Taip;0;6;2;8
15678;Spygliukas;Geniukai;3658613027;Ne;0;0;4;4
15679;Spygliukas;Geniukai;3365209400;Ne;0;0;5;5
15680;Spygliukas;Geniukai;6457632191;Ne;8;0;0;8
15681;Spygliukas;Geniukai;1691209405;Taip;4;0;0;4
15682;Spygliukas;Geniukai;9178184431;Ne;4;0;0;4
15683;Spygliukas;Geniukai;5962360012;Taip;0;0;1;1
15684;Spygliukas;Geniukai;2739564216;Taip;5;0;5;10
15685;Spygliukas;Geniukai;4610504338;Taip;0;0;1;1
15686;Spygliukas;Geniukai;7900652746;Taip;9;0;0;9
15687;Spygliukas;Geniukai;5778081118;Taip;12;2;0;14
15688;Spygliukas;Geniukai;6000906766;Taip;11;0;1;12
15689;Spygliukas;Geniukai;50047868918;Ne;7;1;1;9
15690;Spygliukas;Riešutėliai;1227595604;Ne;4;6;0;10
15691;Spygliukas;Riešutėliai;21074122407;Taip;2;1;0;3
15692;Spygliukas;Riešutėliai;26697357569;Taip;0;0;2;2
15693;Spygliukas;Riešutėliai;48097650803;Taip;0;0;1;1
15694;Spygliukas;Riešutėliai;84487759175;Taip;0;2;0;2
15695;Spygliukas;Riešutėliai;68487983068;Taip;0;0;3;3
15696;Spygliukas;Riešutėliai;7829656569;Taip;4;0;2;6
15697;Spygliukas;Riešutėliai;45296663285;Taip;0;1;0;1
15698;Spygliukas;Riešutėliai;56991221970;Taip;3;0;0;3
15699;Spygliukas;Riešutėliai;1971162865;Taip;6;0;2;8
15700;Spygliukas;Riešutėliai;1076152986;Ne;0;0;1;1
15701;Spygliukas;Riešutėliai;97773415559;Taip;0;0;2;2
15702;Spygliukas;Riešutėliai;77970187363;Taip;0;1;0;1
15703;Spygliukas;Riešutėliai;43541072654;Taip;0;0;2;2
15704;Spygliukas;Pelėdžiukai;57098709793;Taip;0;5;0;5
15705;Spygliukas;Pelėdžiukai;1447408559;Taip;0;1;0;1
15706;Spygliukas;Pelėdžiukai;80768950728;Ne;5;2;0;7
15707;Spygliukas;Pelėdžiukai;15887839786;Taip;7;0;2;9
15708;Spygliukas;Pelėdžiukai;28639466275;Taip;0;0;3;3
15709;Spygliukas;Pelėdžiukai;67896776952;Ne;0;3;0;3
15710;Spygliukas;Pelėdžiukai;38040423877;Taip;0;2;0;2
15711;Spygliukas;Pelėdžiukai;88332181449;Taip;0;0;1;1
15712;Spygliukas;Pelėdžiukai;20248450562;Ne;11;1;2;14
15713;Spygliukas;Pelėdžiukai;58880461920;Taip;5;0;0;5
15714;Spygliukas;Pelėdžiukai;1012592509;Taip;0;1;0;1
15715;Spygliukas;Pelėdžiukai;91727550789;Taip;0;1;0;1
15716;Spygliukas;Pelėdžiukai;42786380899;Taip;0;1;5;6
15717;Spygliukas;Pelėdžiukai;1398592801;Ne;2;0;3;5
15718;Spygliukas;Pelėdžiukai;1482370515;Taip;0;2;0;2
15719;Spygliukas;Pelėdžiukai;88798186419;Taip;0;9;0;9
15720;Spygliukas;Zylutės;7271659513;Taip;4;17;0;21
15721;Spygliukas;Zylutės;4368224847;Taip;0;5;4;9
15722;Spygliukas;Zylutės;9316731983;Taip;4;14;0;18
15723;Spygliukas;Zylutės;5012876830;Taip;0;0;1;1
15724;Spygliukas;Zylutės;2315421636;Taip;0;0;3;3
15725;Spygliukas;Zylutės;8708083787;Taip;5;7;0;12
15726;Spygliukas;Zylutės;7125425492;Taip;0;0;7;7
15727;Spygliukas;Zylutės;1974541155;Taip;3;0;0;3
15728;Spygliukas;Zylutės;2989701249;Taip;20;0;0;20
15729;Spygliukas;Zylutės;6630979640;Taip;0;0;1;1
15730;Spygliukas;Zylutės;5214431060;Taip;2;0;0;2
15731;Spygliukas;Zylutės;9086986643;Taip;7;1;0;8
15732;Spygliukas;Zylutės;9052337501;Taip;0;3;0;3
15733;Spygliukas;Skruzdėliukai;8404929784;Taip;10;0;0;10
15734;Spygliukas;Skruzdėliukai;3041184642;Taip;7;1;1;9
15735;Spygliukas;Skruzdėliukai;9070219319;Taip;5;0;0;5
15736;Spygliukas;Skruzdėliukai;8476882854;Taip;13;3;0;16
15737;Spygliukas;Skruzdėliukai;9112172144;Ne;8;0;2;10
15738;Spygliukas;Skruzdėliukai;2395961015;Taip;0;8;1;9
15739;Spygliukas;Skruzdėliukai;9413950200;Taip;0;1;0;1
15740;Spygliukas;Skruzdėliukai;1664878188;Taip;4;1;2;7
15741;Spygliukas;Skruzdėliukai;1333556956;Taip;0;0;1;1
15742;Spygliukas;Skruzdėliukai;4835818382;Taip;4;1;0;5
15743;Spygliukas;Skruzdėliukai;8869320003;Taip;13;0;0;13
15744;Spygliukas;Skruzdėliukai;8270525839;Taip;7;0;0;7
15745;Spygliukas;Skruzdėliukai;3697691132;Taip;3;0;0;3
15746;Spygliukas;Skruzdėliukai;4053158210;Taip;1;0;2;3
15747;Spygliukas;Skruzdėliukai;9444569348;Taip;12;0;0;12
15748;Spygliukas;Voveraitės;5049529300;Taip;6;0;0;6
15749;Spygliukas;Voveraitės;1773639994;Taip;4;0;2;6
15750;Spygliukas;Voveraitės;2066739772;Ne;4;0;3;7
15751;Spygliukas;Voveraitės;1042495269;Taip;0;0;1;1
15752;Spygliukas;Voveraitės;1590677993;Ne;5;0;2;7
15753;Spygliukas;Voveraitės;1030973848;Taip;0;0;3;3
15754;Spygliukas;Voveraitės;1935233612;Taip;5;2;0;7
15755;Spygliukas;Voveraitės;8801225066;Taip;3;0;0;3
15756;Spygliukas;Voveraitės;8453683673;Ne;22;0;0;22
15757;Spygliukas;Voveraitės;1045253540;Ne;3;0;1;4
15758;Spygliukas;Voveraitės;8048474808;Taip;5;0;2;7
15759;Spygliukas;Voveraitės;45881077771;Taip;0;17;0;17
15760;Spygliukas;Voveraitės;1415694208;Taip;0;0;1;1
15761;Spygliukas;Giliukų;6405496193;Taip;10;0;0;10
15762;Spygliukas;Giliukų;9219327706;Taip;0;0;4;4
15763;Spygliukas;Giliukų;1426267001;Taip;11;0;1;12
15764;Spygliukas;Giliukų;1234195733;Taip;0;5;0;5
15765;Spygliukas;Giliukų;6758336405;Taip;0;0;5;5
15766;Spygliukas;Giliukų;6587957213;Taip;0;1;2;3
15767;Spygliukas;Giliukų;8877911083;Taip;5;0;3;8
15768;Spygliukas;Giliukų;7897603878;Taip;0;1;0;1
15769;Vieversys;Žirniukai;8129139979;Taip;5;2;0;7
15770;Vieversys;Žirniukai;1149316471;Taip;0;2;0;2
15771;Vieversys;Žirniukai;1728554204;Taip;0;0;1;1
15772;Vieversys;Žirniukai;6787960120;Taip;0;0;1;1
15773;Vieversys;Žirniukai;9612415733;Taip;0;19;0;19
15774;Vieversys;Žirniukai;5917328379;Taip;6;2;0;8
15775;Vieversys;Žirniukai;53977164888;Taip;0;2;0;2
15776;Vieversys;Žirniukai;82594887399;Taip;0;3;0;3
15777;Vieversys;Žirniukai;7500147648;Taip;5;11;0;16
15778;Vieversys;Žirniukai;2621046003;Taip;0;0;5;5
15779;Vieversys;Žirniukai;9835682858;Taip;0;14;0;14
15780;Vieversys;Žirniukai;6596979763;Taip;0;2;0;2
15781;Vieversys;Žirniukai;5286521728;Taip;7;3;0;10
15782;Vieversys;Žirniukai;8038341998;Taip;0;9;0;9
15783;Vieversys;Žirniukai;1247565595;Taip;0;2;0;2
15784;Vieversys;Žirniukai;6720355390;Taip;0;0;11;11
15785;Vieversys;Žirniukai;4313822180;Taip;0;8;0;8
15786;Vieversys;Žirniukai;7812227428;Ne;0;6;0;6
15787;Vieversys;Žirniukai;4455039401;Taip;0;2;0;2
15788;Vieversys;Žirniukai;5810605263;Taip;0;0;5;5
15789;Vieversys;Varpelių;38299255111;Taip;0;2;0;2
15790;Vieversys;Varpelių;34168958939;Taip;0;1;0;1
15791;Vieversys;Varpelių;25198979253;Taip;0;2;1;3
15792;Vieversys;Varpelių;29002693436;Taip;0;0;2;2
15793;Vieversys;Varpelių;41282339758;Taip;0;1;0;1
15794;Vieversys;Varpelių;6427430220;Taip;7;1;0;8
15795;Vieversys;Varpelių;72475350152;Taip;5;0;0;5
15796;Vieversys;Varpelių;61074394922;Taip;8;0;0;8
15797;Vieversys;Varpelių;11528430680;Taip;0;3;0;3
15798;Vieversys;Varpelių;79197759451;Taip;0;11;0;11
15799;Vieversys;Varpelių;2010825247;Ne;5;7;0;12
15800;Vieversys;Varpelių;89564962534;Taip;4;1;0;5
15801;Vieversys;Varpelių;65696183376;Taip;5;10;0;15
15802;Vieversys;Varpelių;2561825171;Taip;0;0;2;2
15803;Vieversys;Varpelių;87314456133;Ne;0;0;2;2
15804;Vieversys;Kiškučių;2511719188;Ne;0;2;3;5
15805;Vieversys;Kiškučių;5337856442;Taip;0;1;4;5
15806;Vieversys;Kiškučių;5051310223;Ne;7;1;0;8
15807;Vieversys;Kiškučių;75434941104;Taip;0;1;0;1
15808;Vieversys;Kiškučių;83420473111;Taip;0;0;4;4
15809;Vieversys;Kiškučių;22717987850;Taip;6;0;0;6
15810;Vieversys;Kiškučių;26092685300;Ne;0;1;6;7
15811;Vieversys;Kiškučių;56670426557;Taip;0;1;0;1
15812;Vieversys;Kiškučių;72651951788;Taip;0;0;3;3
15813;Vieversys;Kiškučių;34494816770;Taip;0;2;1;3
15814;Vieversys;Kiškučių;63139698249;Taip;0;2;0;2
15815;Vieversys;Kiškučių;66155667200;Taip;0;1;0;1
15816;Vieversys;Kiškučių;7126970560;Taip;0;3;0;3
15817;Vieversys;Kiškučių;61951858540;Taip;0;1;0;1
15818;Vieversys;Kiškučių;1371669237;Taip;0;2;0;2
15819;Vieversys;Kiškučių;93582609868;Taip;0;0;1;1
15820;Vieversys;Kiškučių;35144734547;Taip;4;0;0;4
15821;Vieversys;Pelėdžiukų;8421719030;Taip;4;0;0;4
15822;Vieversys;Pelėdžiukų;77272293257;Taip;1;7;0;8
15823;Vieversys;Pelėdžiukų;94463134058;Taip;0;3;0;3
15824;Vieversys;Pelėdžiukų;5434952733;Taip;0;0;10;10
15825;Vieversys;Pelėdžiukų;2193074123;Taip;5;0;1;6
15826;Vieversys;Pelėdžiukų;7007620994;Taip;0;0;11;11
15827;Vieversys;Pelėdžiukų;9499315463;Taip;7;1;0;8
15828;Vieversys;Pelėdžiukų;9774365819;Taip;5;4;0;9
15829;Vieversys;Pelėdžiukų;9494957750;Taip;13;0;1;14
15830;Vieversys;Pelėdžiukų;2521488728;Taip;8;3;2;13
15831;Vieversys;Pelėdžiukų;6473759470;Taip;9;2;0;11
15832;Vieversys;Pelėdžiukų;1120594293;Taip;1;0;5;6
15833;Vieversys;Pelėdžiukų;1273951001;Taip;14;0;1;15
15834;Vieversys;Pelėdžiukų;48430863473;Taip;15;4;0;19
15835;Vieversys;Pelėdžiukų;50181034746;Taip;0;5;0;5
15836;Vieversys;Pelėdžiukų;1027693153;Taip;0;0;1;1
15837;Vieversys;Pelėdžiukų;5871715452;Taip;6;0;2;8
15838;Vieversys;Pelėdžiukų;7676796264;Taip;0;1;0;1
15839;Vieversys;Pelėdžiukų;9659337657;Ne;6;0;2;8
15840;Vieversys;Pelėdžiukų;3458399180;Taip;6;8;0;14
15841;Vieversys;Pelėdžiukų;1361156816;Taip;10;0;0;10
15842;Vieversys;Saulučių;53189421149;Taip;0;0;4;4
15843;Vieversys;Saulučių;81494754248;Taip;5;0;0;5
15844;Vieversys;Saulučių;12419984038;Taip;0;0;7;7
15845;Vieversys;Saulučių;78901148667;Taip;0;0;1;1
15846;Vieversys;Saulučių;1601102808;Ne;1;0;2;3
15847;Vieversys;Saulučių;84134333980;Taip;0;0;1;1
15848;Vieversys;Saulučių;9980447111;Taip;0;0;1;1
15849;Vieversys;Saulučių;2733479642;Taip;1;1;1;3
15850;Vieversys;Saulučių;25507613416;Ne;0;0;1;1
15851;Vieversys;Saulučių;1307701524;Taip;9;0;0;9
15852;Vieversys;Saulučių;8966153890;Taip;0;1;0;1
15853;Vieversys;Saulučių;1025794194;Taip;0;1;1;2
15854;Vieversys;Saulučių;2756075736;Taip;0;0;3;3
15855;Vieversys;Saulučių;3907748584;Taip;0;0;2;2
15856;Vieversys;Saulučių;93675768307;Taip;0;2;0;2
15857;Vieversys;Kregždučių;55553505459;Ne;0;3;1;4
15858;Vieversys;Kregždučių;16002848795;Ne;0;3;1;4
15859;Vieversys;Kregždučių;1933907389;Taip;4;0;3;7
15860;Vieversys;Kregždučių;2130449373;Taip;5;0;0;5
15861;Vieversys;Kregždučių;44086673096;Taip;0;0;2;2
15862;Vieversys;Kregždučių;89223502405;Taip;5;3;0;8
15863;Vieversys;Kregždučių;41215224179;Taip;5;0;0;5
15864;Vieversys;Kregždučių;938801303;Taip;9;0;0;9
15865;Vieversys;Kregždučių;2141967793;Taip;1;1;0;2
15866;Vieversys;Kregždučių;2128428329;Taip;10;1;0;11
15867;Vieversys;Kregždučių;62465517391;Taip;0;1;0;1
15868;Vieversys;Kregždučių;5123994167;Taip;0;0;2;2
15869;Vieversys;Kregždučių;12524976076;Taip;6;0;0;6
15870;Vieversys;Kregždučių;1300013110;Taip;0;0;5;5
15871;Vieversys;Kregždučių;1716198618;Taip;0;10;0;10
15872;Vieversys;Kregždučių;8213134622;Taip;10;2;7;19
15873;Vieversys;Kregždučių;2879546284;Ne;0;0;8;8
15874;Vieversys;Kregždučių;3839507103;Ne;0;0;1;1
15875;Vieversys;Kregždučių;46624143347;Taip;9;0;0;9
15876;Vieversys;Boružėlių;6236703869;Taip;0;0;2;2
15877;Vieversys;Boružėlių;6116471730;Ne;10;3;0;13
15878;Vieversys;Boružėlių;1815073796;Taip;0;7;0;7
15879;Vieversys;Boružėlių;20960056744;Ne;6;0;0;6
15880;Vieversys;Boružėlių;95472887427;Taip;0;0;2;2
15881;Vieversys;Boružėlių;58287759954;Taip;4;0;1;5
15882;Vieversys;Boružėlių;72395946516;Ne;0;0;2;2
15883;Vieversys;Boružėlių;86213464121;Taip;6;10;0;16
15884;Vieversys;Boružėlių;55764266970;Taip;6;3;0;9
15885;Vieversys;Boružėlių;1588939300;Taip;4;0;1;5
15886;Vieversys;Boružėlių;86119860485;Taip;0;0;2;2
15887;Vieversys;Boružėlių;57223617591;Taip;0;0;2;2
15888;Vieversys;Boružėlių;1028950997;Taip;7;0;5;12
15889;Vieversys;Boružėlių;14574836082;Ne;16;0;1;17
15890;Vieversys;Boružėlių;95886969053;Ne;7;7;2;16
15891;Vieversys;Boružėlių;95891054066;Ne;5;0;0;5
15892;Vieversys;Boružėlių;5197639355;Taip;3;0;5;8
15893;Vieversys;Boružėlių;8744701209;Taip;0;2;0;2
15894;Vieversys;Boružėlių;50192413803;Ne;2;0;1;3
15895;Vieversys;Boružėlių;1715902540;Taip;0;9;0;9
15896;Vieversys;Boružėlių;1765258957;Taip;0;0;2;2
15897;Vieversys;Bitučių;9972526744;Taip;0;3;0;3
15898;Vieversys;Bitučių;5654533451;Taip;0;4;0;4
15899;Vieversys;Bitučių;6127272124;Taip;5;0;3;8
15900;Vieversys;Bitučių;3405502715;Taip;5;0;0;5
15901;Vieversys;Bitučių;9985374057;Taip;8;0;0;8
15902;Vieversys;Bitučių;9308040716;Taip;16;0;0;16
15903;Vieversys;Bitučių;4741252829;Taip;11;0;3;14
15904;Vieversys;Bitučių;7048475906;Taip;0;0;11;11
15905;Vieversys;Bitučių;4072323869;Taip;0;19;0;19
15906;Vieversys;Bitučių;6110034652;Taip;7;0;3;10
15907;Vieversys;Bitučių;2663322242;Ne;5;0;0;5
15908;Vieversys;Bitučių;4024758152;Taip;0;1;0;1
15909;Vieversys;Bitučių;6194712643;Taip;0;1;0;1
15910;Vieversys;Bitučių;7596355010;Taip;0;13;0;13
15911;Vieversys;Bitučių;4892622551;Ne;0;0;1;1
15912;Vieversys;Bitučių;4690095102;Taip;13;0;2;15
15913;Vieversys;Bitučių;4968278870;Taip;2;0;0;2
15914;Vieversys;Smalsučių;5922485482;Taip;5;0;1;6
15915;Vieversys;Smalsučių;9164615794;Taip;0;11;0;11
15916;Vieversys;Smalsučių;2096514775;Ne;0;0;2;2
15917;Vieversys;Smalsučių;3684937630;Taip;0;8;0;8
15918;Vieversys;Smalsučių;6563139211;Taip;0;12;0;12
15919;Vieversys;Smalsučių;1757028935;Taip;0;0;1;1
15920;Vieversys;Smalsučių;4488027554;Taip;0;0;1;1
15921;Vieversys;Smalsučių;4294676988;Taip;3;10;0;13
15922;Vieversys;Smalsučių;3917758713;Taip;5;5;0;10
15923;Vieversys;Smalsučių;4835022593;Taip;4;0;2;6
15924;Vieversys;Smalsučių;4778339658;Taip;16;2;0;18
15925;Vieversys;Smalsučių;3249717073;Taip;17;0;0;17
15926;Vieversys;Smalsučių;7120329258;Taip;5;0;0;5
15927;Vieversys;Smalsučių;9387421639;Taip;7;1;4;12
15928;Vieversys;Smalsučių;8174124875;Taip;10;0;8;18
15929;Vieversys;Smalsučių;4187114865;Taip;0;2;0;2
15930;Vieversys;Smalsučių;5769453869;Taip;6;0;0;6
15931;Vieversys;Smalsučių;5789530087;Taip;0;0;6;6
15932;Vieversys;Smalsučių;3755410640;Ne;7;0;0;7
15933;Vieversys;Smalsučių;1322495361;Taip;6;0;1;7
15934;Vieversys;Kodėlčiukų;69275621813;Taip;10;1;0;11
15935;Vieversys;Kodėlčiukų;1455615413;Taip;12;0;4;16
15936;Vieversys;Kodėlčiukų;1970088958;Ne;0;0;6;6
15937;Vieversys;Kodėlčiukų;1586720551;Taip;0;0;1;1
15938;Vieversys;Kodėlčiukų;9012978017;Taip;4;8;0;12
15939;Vieversys;Kodėlčiukų;1738313365;Taip;0;0;1;1
15940;Vieversys;Kodėlčiukų;1766638116;Taip;7;0;6;13
15941;Vieversys;Kodėlčiukų;1599787985;Ne;18;0;0;18
15942;Vieversys;Kodėlčiukų;1491424075;Taip;10;0;4;14
15943;Vieversys;Kodėlčiukų;1361494430;Taip;6;0;3;9
15944;Vieversys;Kodėlčiukų;9829388743;Taip;5;11;0;16
15945;Vieversys;Kodėlčiukų;1878278158;Taip;4;0;0;4
15946;Vieversys;Kodėlčiukų;7315438787;Taip;0;3;0;3
15947;Vieversys;Kodėlčiukų;16617102917;Taip;0;10;0;10
15948;Vieversys;Kodėlčiukų;1793994492;Taip;14;0;3;17
15949;Vieversys;Kodėlčiukų;2236904814;Taip;5;0;7;12
15950;Vieversys;Kodėlčiukų;3792076932;Taip;5;0;2;7
15951;Vieversys;Kodėlčiukų;7385860819;Taip;0;0;1;1
15952;Vieversys;Kodėlčiukų;9680719247;Taip;10;0;0;10
15953;Vieversys;Kodėlčiukų;2294276744;Taip;5;2;0;7
15954;Vieversys;Kodėlčiukų;3640960566;Taip;11;0;2;13
15955;Vieversys;NYKŠTUKAI;9453100342;Taip;10;0;1;11
15956;Vieversys;NYKŠTUKAI;3731412573;Ne;0;13;0;13
15957;Vieversys;NYKŠTUKAI;3947405446;Taip;10;0;1;11
15958;Vieversys;NYKŠTUKAI;9826657384;Taip;10;0;0;10
15959;Vieversys;NYKŠTUKAI;8084767846;Taip;0;0;6;6
15960;Vieversys;NYKŠTUKAI;7364582681;Taip;22;0;0;22
15961;Vieversys;NYKŠTUKAI;4088189914;Taip;6;0;0;6
15962;Vieversys;NYKŠTUKAI;7399326463;Taip;16;0;0;16
15963;Vieversys;NYKŠTUKAI;4565799599;Taip;7;1;0;8
15964;Vieversys;NYKŠTUKAI;9884517851;Taip;0;3;0;3
15965;Vieversys;NYKŠTUKAI;6765094662;Ne;22;0;0;22
15966;Vieversys;NYKŠTUKAI;5683183310;Taip;5;0;0;5
15967;Vieversys;NYKŠTUKAI;8587368497;Taip;7;0;0;7
15968;Vieversys;NYKŠTUKAI;2027613318;Taip;0;6;0;6
15969;Vieversys;NYKŠTUKAI;1478357320;Taip;3;0;3;6
15970;Vieversys;NYKŠTUKAI;6430944858;Taip;0;0;1;1
15971;Vieversys;DRUGELIAI;9093088054;Taip;6;0;5;11
15972;Vieversys;DRUGELIAI;6808541662;Taip;5;0;1;6
15973;Vieversys;DRUGELIAI;2849852593;Taip;6;0;0;6
15974;Vieversys;DRUGELIAI;5486475468;Taip;5;0;0;5
15975;Vieversys;DRUGELIAI;8141710663;Taip;10;0;2;12
15976;Vieversys;DRUGELIAI;2230503026;Taip;5;0;3;8
15977;Vieversys;DRUGELIAI;5645852451;Taip;8;1;2;11
15978;Vieversys;DRUGELIAI;3122763958;Taip;0;0;3;3
15979;Vieversys;DRUGELIAI;2529690060;Taip;11;0;0;11
15980;Vieversys;DRUGELIAI;9088171869;Taip;0;0;1;1
15981;Vieversys;DRUGELIAI;1685531183;Ne;10;0;0;10
15982;Vieversys;DRUGELIAI;7998100115;Taip;0;18;0;18
15983;Vieversys;DRUGELIAI;4870401841;Taip;14;0;0;14
15984;Žirmūnėliai;SAULUTĖS;8030469722;Taip;0;2;0;2
15985;Žirmūnėliai;SAULUTĖS;3166454638;Taip;2;0;0;2
15986;Žirmūnėliai;SAULUTĖS;73664204182;Taip;0;0;1;1
15987;Žirmūnėliai;SAULUTĖS;1725143117;Taip;12;1;0;13
15988;Žirmūnėliai;SAULUTĖS;1073135587;Taip;0;6;0;6
15989;Žirmūnėliai;SAULUTĖS;3128190518;Taip;7;0;0;7
15990;Žirmūnėliai;SAULUTĖS;8317328771;Taip;0;0;1;1
15991;Žirmūnėliai;SAULUTĖS;1478039469;Taip;3;3;0;6
15992;Žirmūnėliai;SAULUTĖS;6896145409;Taip;0;0;1;1
15993;Žirmūnėliai;SAULUTĖS;1255857051;Taip;0;2;0;2
15994;Žirmūnėliai;SAULUTĖS;72738770293;Taip;1;0;0;1
15995;Žirmūnėliai;SAULUTĖS;4517290068;Taip;0;5;0;5
15996;Žirmūnėliai;SAULUTĖS;1582563837;Taip;6;0;2;8
15997;Žirmūnėliai;SAULUTĖS;1381923106;Taip;0;1;1;2
15998;Žirmūnėliai;SAULUTĖS;5037669167;Taip;13;0;0;13
15999;Žirmūnėliai;SAULUTĖS;1761284228;Taip;0;7;1;8
16000;Žirmūnėliai;SAULUTĖS;41018224936;Taip;0;13;0;13
16001;Žirmūnėliai;SAULUTĖS;1894070647;Taip;0;4;0;4
16002;Žirmūnėliai;SAULUTĖS;1347664230;Taip;7;0;0;7
16003;Žirmūnėliai;SAULUTĖS;1302022463;Taip;0;2;0;2
16004;Žirmūnėliai;GILIUKAI;37231106844;Taip;11;0;0;11
16005;Žirmūnėliai;GILIUKAI;5673929155;Taip;0;2;0;2
16006;Žirmūnėliai;GILIUKAI;68678277635;Taip;15;2;0;17
16007;Žirmūnėliai;GILIUKAI;1818060330;Taip;1;0;0;1
16008;Žirmūnėliai;GILIUKAI;1963980356;Taip;0;1;0;1
16009;Žirmūnėliai;GILIUKAI;1302040861;Ne;0;5;0;5
16010;Žirmūnėliai;GILIUKAI;1816123753;Taip;0;6;0;6
16011;Žirmūnėliai;GILIUKAI;1308593517;Taip;0;14;0;14
16012;Žirmūnėliai;GILIUKAI;53028161711;Taip;0;3;0;3
16013;Žirmūnėliai;GILIUKAI;6578685370;Ne;11;0;1;12
16014;Žirmūnėliai;GILIUKAI;1493536049;Taip;0;8;0;8
16015;Žirmūnėliai;GILIUKAI;1626619024;Taip;0;5;0;5
16016;Žirmūnėliai;GILIUKAI;8824743884;Taip;0;6;0;6
16017;Žirmūnėliai;GILIUKAI;1556389237;Taip;0;17;0;17
16018;Žirmūnėliai;GILIUKAI;1764226619;Taip;0;0;1;1
16019;Žirmūnėliai;GILIUKAI;1183883183;Taip;0;9;0;9
16020;Žirmūnėliai;GILIUKAI;7929881052;Ne;0;4;0;4
16021;Žirmūnėliai;DAINORĖLIAI;6493142538;Taip;9;0;0;9
16022;Žirmūnėliai;DAINORĖLIAI;1655437833;Taip;7;0;5;12
16023;Žirmūnėliai;DAINORĖLIAI;2693415717;Taip;0;0;5;5
16024;Žirmūnėliai;DAINORĖLIAI;8930536051;Taip;9;0;1;10
16025;Žirmūnėliai;DAINORĖLIAI;7953019230;Taip;0;12;0;12
16026;Žirmūnėliai;DAINORĖLIAI;6982109508;Taip;6;0;4;10
16027;Žirmūnėliai;DAINORĖLIAI;3458810185;Ne;5;0;2;7
16028;Žirmūnėliai;DAINORĖLIAI;3994865244;Taip;0;0;6;6
16029;Žirmūnėliai;DAINORĖLIAI;3640979388;Taip;6;0;0;6
16030;Žirmūnėliai;DAINORĖLIAI;6878528100;Taip;8;0;0;8
16031;Žirmūnėliai;DAINORĖLIAI;8440187348;Taip;7;0;0;7
16032;Žirmūnėliai;DAINORĖLIAI;9402567487;Taip;0;0;3;3
16033;Žirmūnėliai;DAINORĖLIAI;1832367936;Taip;0;0;2;2
16034;Žirmūnėliai;DAINORĖLIAI;9759491055;Taip;13;0;0;13
16035;Žirmūnėliai;DAINORĖLIAI;3297360222;Ne;0;0;2;2
16036;Žirmūnėliai;DAINORĖLIAI;1127214387;Taip;5;0;0;5
16037;Žirmūnėliai;DAINORĖLIAI;4101748829;Taip;7;0;0;7
16038;Žirmūnėliai;DAINORĖLIAI;6448582622;Taip;9;0;0;9
16039;Žirmūnėliai;DAINORĖLIAI;2661052835;Taip;5;5;0;10
16040;Žirmūnėliai;DAINORĖLIAI;7011701994;Ne;12;0;0;12
16041;Žirmūnėliai;DRUGELIAI;4218266688;Taip;7;0;0;7
16042;Žirmūnėliai;DRUGELIAI;7020486370;Taip;5;1;0;6
16043;Žirmūnėliai;DRUGELIAI;3449815783;Taip;5;0;0;5
16044;Žirmūnėliai;DRUGELIAI;9541122034;Taip;0;1;0;1
16045;Žirmūnėliai;DRUGELIAI;5736502380;Ne;5;0;0;5
16046;Žirmūnėliai;DRUGELIAI;9154874729;Taip;8;2;0;10
16047;Žirmūnėliai;DRUGELIAI;9378860669;Taip;0;9;0;9
16048;Žirmūnėliai;DRUGELIAI;8607934394;Taip;0;6;0;6
16049;Žirmūnėliai;DRUGELIAI;8999160836;Taip;0;7;1;8
16050;Žirmūnėliai;DRUGELIAI;8209309240;Taip;0;6;0;6
16051;Žirmūnėliai;DRUGELIAI;5209700153;Taip;1;0;2;3
16052;Žirmūnėliai;DRUGELIAI;2837129621;Taip;6;2;2;10
16053;Žirmūnėliai;DRUGELIAI;1273684243;Taip;0;0;1;1
16054;Žirmūnėliai;DRUGELIAI;2971175236;Taip;0;2;0;2
16055;Žirmūnėliai;DRUGELIAI;6594728970;Taip;10;0;0;10
16056;Žirmūnėliai;DRUGELIAI;5090067954;Ne;12;0;0;12
16057;Žirmūnėliai;DRUGELIAI;7422544482;Taip;0;13;0;13
16058;Žirmūnėliai;DRUGELIAI;4336415033;Taip;0;5;0;5
16059;Žirmūnėliai;DRUGELIAI;9241738140;Taip;0;2;2;4
16060;Žirmūnėliai;BORUŽIUKAI;76779474158;Taip;0;11;2;13
16061;Žirmūnėliai;BORUŽIUKAI;18242077086;Taip;0;6;0;6
16062;Žirmūnėliai;BORUŽIUKAI;1119678857;Taip;0;3;0;3
16063;Žirmūnėliai;BORUŽIUKAI;99980167497;Taip;0;0;1;1
16064;Žirmūnėliai;BORUŽIUKAI;88436070676;Taip;0;0;1;1
16065;Žirmūnėliai;BORUŽIUKAI;85286691926;Taip;0;1;0;1
16066;Žirmūnėliai;BORUŽIUKAI;7777166572;Taip;0;6;0;6
16067;Žirmūnėliai;BORUŽIUKAI;20851917855;Taip;0;8;0;8
16068;Žirmūnėliai;BORUŽIUKAI;26463655365;Ne;0;2;3;5
16069;Žirmūnėliai;BORUŽIUKAI;1157270725;Taip;0;5;0;5
16070;Žirmūnėliai;BORUŽIUKAI;22592450568;Taip;0;0;3;3
16071;Žirmūnėliai;EŽIUKAI;75310341519;Taip;0;2;0;2
16072;Žirmūnėliai;EŽIUKAI;1617021385;Taip;4;0;0;4
16073;Žirmūnėliai;EŽIUKAI;36822027549;Taip;0;0;4;4
16074;Žirmūnėliai;EŽIUKAI;1563132542;Taip;0;0;2;2
16075;Žirmūnėliai;EŽIUKAI;31231655300;Taip;6;0;7;13
16076;Žirmūnėliai;EŽIUKAI;5450253994;Taip;0;0;8;8
16077;Žirmūnėliai;EŽIUKAI;67024451309;Taip;7;0;1;8
16078;Žirmūnėliai;EŽIUKAI;39347099487;Taip;5;2;0;7
16079;Žirmūnėliai;EŽIUKAI;6380354636;Ne;2;0;0;2
16080;Žirmūnėliai;EŽIUKAI;58158145123;Taip;3;0;0;3
16081;Žirmūnėliai;EŽIUKAI;30933761145;Taip;0;0;1;1
16082;Žirmūnėliai;EŽIUKAI;33441696614;Taip;2;4;0;6
16083;Žirmūnėliai;EŽIUKAI;51268874840;Taip;0;4;0;4
16084;Žirmūnėliai;EŽIUKAI;57457297276;Taip;0;0;2;2
16085;Žirmūnėliai;EŽIUKAI;1023642666;Taip;10;0;1;11
16086;Žirmūnėliai;ŽVIRBLIUKAI;73552867802;Taip;0;2;1;3
16087;Žirmūnėliai;ŽVIRBLIUKAI;38316483993;Taip;0;2;0;2
16088;Žirmūnėliai;ŽVIRBLIUKAI;1250060420;Taip;5;1;0;6
16089;Žirmūnėliai;ŽVIRBLIUKAI;1477593223;Ne;0;5;0;5
16090;Žirmūnėliai;ŽVIRBLIUKAI;3896978775;Taip;0;2;3;5
16091;Žirmūnėliai;ŽVIRBLIUKAI;1235090013;Taip;0;6;0;6
16092;Žirmūnėliai;ŽVIRBLIUKAI;87693490164;Taip;7;0;0;7
16093;Žirmūnėliai;ŽVIRBLIUKAI;45541156029;Taip;0;2;2;4
16094;Žirmūnėliai;ŽVIRBLIUKAI;96121856269;Taip;2;4;0;6
16095;Žirmūnėliai;ŽVIRBLIUKAI;28826938550;Taip;5;0;1;6
16096;Žirmūnėliai;ŽVIRBLIUKAI;65810358813;Taip;4;0;1;5
16097;Žirmūnėliai;ŽVIRBLIUKAI;12766765793;Taip;10;0;0;10
16098;Žirmūnėliai;ŽVIRBLIUKAI;61531418513;Taip;0;2;0;2
16099;Žirmūnėliai;ŽVIRBLIUKAI;5276699877;Taip;0;1;0;1
16100;Žirmūnėliai;ŽVIRBLIUKAI;20902834369;Taip;0;1;0;1
16101;Žirmūnėliai;SPALVELĖS;4986702792;Ne;0;1;0;1
16102;Žirmūnėliai;SPALVELĖS;3691651489;Taip;5;0;6;11
16103;Žirmūnėliai;SPALVELĖS;1120531178;Taip;0;1;1;2
16104;Žirmūnėliai;SPALVELĖS;1273301982;Taip;0;1;1;2
16105;Žirmūnėliai;SPALVELĖS;29952298800;Taip;0;1;21;22
16106;Žirmūnėliai;SPALVELĖS;2127930970;Taip;5;4;0;9
16107;Žirmūnėliai;SPALVELĖS;4710829908;Taip;0;1;0;1
16108;Žirmūnėliai;SPALVELĖS;7918747416;Taip;4;0;0;4
16109;Žirmūnėliai;SPALVELĖS;1865240339;Taip;6;1;1;8
16110;Žirmūnėliai;SPALVELĖS;8339819296;Taip;0;1;0;1
16111;Žirmūnėliai;SPALVELĖS;51723882387;Taip;0;1;4;5
16112;Žirmūnėliai;SPALVELĖS;8308074932;Taip;5;1;1;7
16113;Žirmūnėliai;SPALVELĖS;4638575301;Taip;0;1;0;1
16114;Žirmūnėliai;SPALVELĖS;1017903291;Ne;11;4;0;15
16115;Žirmūnėliai;SPALVELĖS;52524235797;Ne;5;0;2;7
16116;Žirmūnėliai;SPALVELĖS;9482910388;Taip;4;2;0;6
16117;Žirmūnėliai;DEBESĖLIAI;64969220116;Taip;0;18;0;18
16118;Žirmūnėliai;DEBESĖLIAI;1690539251;Taip;0;1;0;1
16119;Žirmūnėliai;DEBESĖLIAI;1542147528;Ne;0;0;1;1
16120;Žirmūnėliai;DEBESĖLIAI;5527904792;Taip;0;9;0;9
16121;Žirmūnėliai;DEBESĖLIAI;31403739893;Taip;5;0;0;5
16122;Žirmūnėliai;DEBESĖLIAI;9926432375;Ne;0;1;0;1
16123;Žirmūnėliai;DEBESĖLIAI;2263604297;Taip;0;7;0;7
16124;Žirmūnėliai;DEBESĖLIAI;1885292520;Taip;8;0;1;9
16125;Žirmūnėliai;DEBESĖLIAI;1618573494;Taip;0;22;0;22
16126;Žirmūnėliai;DEBESĖLIAI;5611315994;Taip;0;0;3;3
16127;Žirmūnėliai;DEBESĖLIAI;2739395691;Ne;0;13;0;13
16128;Žirmūnėliai;DEBESĖLIAI;7528704460;Taip;0;0;3;3
16129;Žirmūnėliai;DEBESĖLIAI;3006508357;Taip;0;8;1;9
16130;Žirmūnėliai;DEBESĖLIAI;6647641423;Taip;0;20;0;20
16131;Žirmūnėliai;DEBESĖLIAI;3351861764;Taip;0;1;0;1
16132;Žirmūnėliai;DEBESĖLIAI;3274576752;Taip;10;10;0;20
16133;Žirmūnėliai;DEBESĖLIAI;3540307559;Taip;7;0;0;7
16134;Žirmūnėliai;VIŠČIUKAI;6875484657;Taip;0;0;1;1
16135;Žirmūnėliai;VIŠČIUKAI;7410921362;Taip;0;9;0;9
16136;Žirmūnėliai;VIŠČIUKAI;3532895278;Taip;0;0;2;2
16137;Žirmūnėliai;VIŠČIUKAI;8432654056;Taip;0;0;1;1
16138;Žirmūnėliai;VIŠČIUKAI;8459217612;Taip;1;0;2;3
16139;Žirmūnėliai;VIŠČIUKAI;2959090234;Taip;0;0;2;2
16140;Žirmūnėliai;VIŠČIUKAI;9871163622;Taip;3;0;0;3
16141;Žirmūnėliai;VIŠČIUKAI;1356219744;Taip;9;1;0;10
16142;Žirmūnėliai;VIŠČIUKAI;1791977446;Taip;8;0;0;8
16143;Žirmūnėliai;VIŠČIUKAI;6259368139;Taip;5;1;1;7
16144;Žirmūnėliai;VIŠČIUKAI;4548601585;Taip;2;0;1;3
16145;Žirmūnėliai;VIŠČIUKAI;9892620134;Taip;0;0;2;2
16146;Žirmūnėliai;VIŠČIUKAI;8627403283;Taip;0;8;0;8
16147;Žirmūnėliai;ZUIKUČIŲ;3562689670;Taip;0;4;0;4
16148;Žirmūnėliai;ZUIKUČIŲ;1571242696;Taip;7;1;0;8
16149;Žirmūnėliai;ZUIKUČIŲ;1401001989;Ne;0;1;2;3
16150;Žirmūnėliai;ZUIKUČIŲ;8631248243;Taip;0;0;22;22
16151;Žirmūnėliai;ZUIKUČIŲ;2866010286;Taip;0;1;0;1
16152;Žirmūnėliai;ZUIKUČIŲ;2904787614;Taip;8;0;0;8
16153;Žirmūnėliai;ZUIKUČIŲ;1025809131;Taip;10;0;0;10
16154;Žirmūnėliai;ZUIKUČIŲ;5929166560;Taip;7;1;3;11
16155;Žirmūnėliai;ZUIKUČIŲ;5104310002;Taip;8;0;3;11
16156;Žirmūnėliai;ZUIKUČIŲ;2506945279;Taip;0;11;0;11
16157;Žirmūnėliai;ZUIKUČIŲ;3949374730;Taip;0;10;0;10
16158;Žirmūnėliai;ZUIKUČIŲ;3767421827;Taip;0;0;2;2
16159;Žirmūnėliai;ZUIKUČIŲ;4327504033;Taip;9;0;0;9
16160;Žirmūnėliai;ZUIKUČIŲ;6869102228;Taip;3;1;0;4
16161;Žirmūnėliai;ZUIKUČIŲ;2841958534;Taip;8;1;0;9
16162;Žirmūnėliai;ZUIKUČIŲ;6430944858;Taip;10;0;0;10
16163;Žirmūnėliai;OBUOLIUKAI;9666769523;Taip;0;6;0;6
16164;Žirmūnėliai;OBUOLIUKAI;24877884441;Taip;5;0;0;5
16165;Žirmūnėliai;OBUOLIUKAI;85408994677;Taip;2;0;2;4
16166;Žirmūnėliai;OBUOLIUKAI;2336720944;Taip;0;5;0;5
16167;Žirmūnėliai;OBUOLIUKAI;1110585472;Taip;0;1;0;1
16168;Žirmūnėliai;OBUOLIUKAI;93072181228;Ne;6;0;0;6
16169;Žirmūnėliai;OBUOLIUKAI;155054610;Taip;0;0;2;2
16170;Žirmūnėliai;OBUOLIUKAI;89429083939;Taip;0;6;0;6
16171;Žirmūnėliai;OBUOLIUKAI;36305353664;Taip;2;0;0;2
16172;Žirmūnėliai;OBUOLIUKAI;4030572434;Taip;0;1;0;1
16173;Žirmūnėliai;OBUOLIUKAI;6758118659;Taip;0;1;0;1
16174;Žirmūnėliai;OBUOLIUKAI;53081289792;Taip;0;1;0;1
16175;Žirmūnėliai;OBUOLIUKAI;4675716163;Taip;16;0;1;17
16176;Žirmūnėliai;OBUOLIUKAI;2216383670;Ne;0;0;15;15
16177;Žirmūnėliai;OBUOLIUKAI;9448136354;Ne;6;0;5;11
16178;Žirmūnėliai;OBUOLIUKAI;2094542223;Ne;3;0;0;3
16179;Dainorėliai;VARPELIAI;11506295275;Taip;0;1;0;1
16180;Dainorėliai;VARPELIAI;31902102771;Taip;0;2;2;4
16181;Dainorėliai;VARPELIAI;18233813290;Taip;0;1;0;1
16182;Dainorėliai;VARPELIAI;6176171443;Taip;0;1;0;1
16183;Dainorėliai;VARPELIAI;88781762328;Taip;5;2;3;10
16184;Dainorėliai;VARPELIAI;9319771186;Taip;0;2;5;7
16185;Dainorėliai;VARPELIAI;7822546498;Taip;0;1;0;1
16186;Dainorėliai;VARPELIAI;8719834064;Taip;10;2;0;12
16187;Dainorėliai;VARPELIAI;5693385617;Taip;0;4;7;11
16188;Dainorėliai;VARPELIAI;8267213392;Ne;0;4;1;5
16189;Dainorėliai;VARPELIAI;5959380807;Taip;0;2;1;3
16190;Dainorėliai;VARPELIAI;2938732886;Taip;0;4;1;5
16191;Dainorėliai;VARPELIAI;3183793211;Taip;0;2;2;4
16192;Dainorėliai;VARPELIAI;2797544232;Taip;0;1;0;1
16193;Dainorėliai;VARPELIAI;65467351140;Taip;0;2;1;3
16194;Dainorėliai;VARPELIAI;8521878734;Taip;2;1;0;3
16195;Dainorėliai;VARPELIAI;1928369859;Taip;2;2;1;5
16196;Dainorėliai;VARPELIAI;6909583023;Taip;0;1;0;1
16197;Dainorėliai;VARPELIAI;4269946363;Taip;0;2;4;6
16198;Dainorėliai;VARPELIAI;1088248393;Taip;0;1;0;1
16199;Dainorėliai;ŽIOGELIAI;99597416067;Taip;0;1;1;2
16200;Dainorėliai;ŽIOGELIAI;88201007119;Taip;0;1;0;1
16201;Dainorėliai;ŽIOGELIAI;31267856584;Ne;0;1;0;1
16202;Dainorėliai;ŽIOGELIAI;87717571411;Taip;3;0;0;3
16203;Dainorėliai;ŽIOGELIAI;18936645521;Ne;18;0;0;18
16204;Dainorėliai;ŽIOGELIAI;35528654099;Taip;0;6;0;6
16205;Dainorėliai;ŽIOGELIAI;29132059636;Taip;0;1;0;1
16206;Dainorėliai;ŽIOGELIAI;32573583030;Taip;3;0;0;3
16207;Dainorėliai;ŽIOGELIAI;17358842027;Taip;0;1;1;2
16208;Dainorėliai;ŽIOGELIAI;63211091321;Taip;0;3;0;3
16209;Dainorėliai;ŽIOGELIAI;45577031767;Taip;10;2;0;12
16210;Dainorėliai;ŽIOGELIAI;80499999855;Taip;0;7;4;11
16211;Dainorėliai;ŽIOGELIAI;72073028506;Ne;0;2;0;2
16212;Dainorėliai;ŽIOGELIAI;78002267589;Taip;3;0;5;8
16213;Dainorėliai;ŽIOGELIAI;3761026792;Taip;6;0;0;6
16214;Dainorėliai;ŽIOGELIAI;58071607976;Taip;0;1;0;1
16215;Dainorėliai;DRUGELIAI;6411939690;Taip;0;2;0;2
16216;Dainorėliai;DRUGELIAI;50432354832;Taip;0;1;0;1
16217;Dainorėliai;DRUGELIAI;19286303769;Taip;0;1;0;1
16218;Dainorėliai;DRUGELIAI;1015870220;Taip;0;1;0;1
16219;Dainorėliai;DRUGELIAI;5212308610;Taip;0;9;0;9
16220;Dainorėliai;DRUGELIAI;6404337541;Taip;5;2;1;8
16221;Dainorėliai;DRUGELIAI;94480397292;Taip;0;2;5;7
16222;Dainorėliai;DRUGELIAI;53935690864;Taip;0;9;0;9
16223;Dainorėliai;DRUGELIAI;27521381629;Taip;0;0;2;2
16224;Dainorėliai;DRUGELIAI;86187568203;Taip;0;2;1;3
16225;Dainorėliai;DRUGELIAI;5238082419;Taip;0;10;0;10
16226;Dainorėliai;DRUGELIAI;1626877066;Taip;10;1;0;11
16227;Dainorėliai;DRUGELIAI;1158895670;Taip;10;0;0;10
16228;Dainorėliai;DRUGELIAI;4087344015;Taip;0;4;2;6
16229;Dainorėliai;DRUGELIAI;3128897752;Taip;4;0;0;4
16230;Dainorėliai;DRUGELIAI;1357413314;Taip;0;0;3;3
16231;Dainorėliai;DRUGELIAI;1515552402;Ne;0;9;1;10
16232;Dainorėliai;DRUGELIAI;36313982965;Taip;0;1;0;1
16233;Dainorėliai;SAULUTĖS;4798415786;Taip;5;0;0;5
16234;Dainorėliai;SAULUTĖS;5102030168;Taip;0;0;9;9
16235;Dainorėliai;SAULUTĖS;6704354150;Taip;0;0;7;7
16236;Dainorėliai;SAULUTĖS;4612995336;Taip;2;0;0;2
16237;Dainorėliai;SAULUTĖS;3605697179;Taip;0;0;3;3
16238;Dainorėliai;SAULUTĖS;8977759216;Ne;6;1;6;13
16239;Dainorėliai;SAULUTĖS;8857018998;Taip;10;0;0;10
16240;Dainorėliai;SAULUTĖS;4307591123;Taip;10;0;0;10
16241;Dainorėliai;SAULUTĖS;2070086316;Taip;0;0;5;5
16242;Dainorėliai;SAULUTĖS;5632663846;Taip;5;0;2;7
16243;Dainorėliai;SAULUTĖS;7804441689;Taip;0;0;7;7
16244;Dainorėliai;SAULUTĖS;5410183494;Taip;12;0;0;12
16245;Dainorėliai;SAULUTĖS;9130473411;Taip;0;10;0;10
16246;Dainorėliai;SAULUTĖS;5587907483;Ne;10;0;3;13
16247;Dainorėliai;SAULUTĖS;1547686786;Taip;7;0;0;7
16248;Dainorėliai;SAULUTĖS;1552829080;Taip;0;0;1;1
16249;Lokiukas;BITUTĖS;6758550653;Taip;11;3;0;14
16250;Lokiukas;BITUTĖS;1040288021;Taip;9;5;0;14
16251;Lokiukas;BITUTĖS;6336140882;Taip;0;5;3;8
16252;Lokiukas;BITUTĖS;9142262360;Taip;0;1;2;3
16253;Lokiukas;BITUTĖS;8775608581;Taip;0;8;0;8
16254;Lokiukas;BITUTĖS;1752784666;Taip;0;1;0;1
16255;Lokiukas;BITUTĖS;34546519642;Taip;0;0;3;3
16256;Lokiukas;BITUTĖS;7305062511;Taip;5;0;0;5
16257;Lokiukas;BITUTĖS;1025576053;Taip;3;0;1;4
16258;Lokiukas;BITUTĖS;6069516217;Taip;12;3;0;15
16259;Lokiukas;BITUTĖS;7943213321;Taip;0;7;0;7
16260;Lokiukas;BITUTĖS;4007839265;Taip;6;0;2;8
16261;Lokiukas;BITUTĖS;8796640190;Taip;0;1;2;3
16262;Lokiukas;BITUTĖS;5943412920;Taip;0;8;3;11
16263;Lokiukas;BITUTĖS;2885398200;Taip;0;0;1;1
16264;Lokiukas;BITUTĖS;3694653020;Taip;5;0;0;5
16265;Lokiukas;BITUTĖS;4379238557;Taip;0;3;0;3
16266;Lokiukas;BITUTĖS;2052174669;Taip;0;11;0;11
16267;Lokiukas;BITUTĖS;8902619265;Taip;0;4;0;4
16268;Lokiukas;BITUTĖS;9336617879;Taip;0;4;0;4
16269;Lokiukas;"1 B klasė";18336619115;Taip;1;0;0;1
16270;Lokiukas;"1 B klasė";32506466236;Taip;8;0;0;8
16271;Lokiukas;"1 B klasė";7324496782;Taip;22;0;0;22
16272;Lokiukas;"1 B klasė";10811780420;Taip;3;0;0;3
16273;Lokiukas;"1 B klasė";28796727185;Taip;21;0;0;21
16274;Lokiukas;"1 B klasė";96046361641;Taip;9;0;0;9
16275;Lokiukas;"1 B klasė";95910336503;Taip;4;0;0;4
16276;Lokiukas;"1 B klasė";88415635113;Taip;17;0;0;17
16277;Lokiukas;"1 B klasė";7497324442;Ne;22;0;0;22
16278;Lokiukas;"1 B klasė";7903535850;Taip;8;0;0;8
16279;Lokiukas;"1 B klasė";61890775725;Taip;9;0;0;9
16280;Lokiukas;"1 B klasė";24221829774;Taip;5;0;0;5
16281;Lokiukas;"1 B klasė";58513885211;Taip;13;0;0;13
16282;Lokiukas;"1 B klasė";57958699478;Taip;8;0;0;8
16283;Lokiukas;"1 B klasė";79109699217;Taip;10;0;0;10
16284;Lokiukas;"1 B klasė";18646642032;Taip;16;0;0;16
16285;Lokiukas;"1 B klasė";50713289266;Ne;10;0;0;10
16286;Lokiukas;"1 B klasė";20231469825;Ne;10;0;0;10
16287;Lokiukas;"1 B klasė";1146878499;Taip;11;0;0;11
16288;Lokiukas;"1 B klasė";46587243900;Taip;8;0;0;8
16289;Lokiukas;"1 B klasė";9141446821;Taip;3;0;0;3
16290;Lokiukas;"1 B klasė";75507005694;Taip;2;0;0;2
16291;Lokiukas;"1 B klasė";73426072972;Ne;19;0;0;19
16292;Lokiukas;"1 B klasė";59913848400;Taip;15;0;0;15
16293;Lokiukas;"1 B klasė";39867459515;Taip;6;0;0;6
16294;Lokiukas;"1 B klasė";2105377652;Taip;1;0;0;1
16295;Lokiukas;"1 B klasė";2105377652;Taip;1;0;0;1
16296;Lokiukas;"1 B klasė";62268017779;Taip;15;0;0;15
16297;Lokiukas;"1 B klasė";62268017779;Taip;15;0;0;15
16298;Lokiukas;"1 A klasė";15406362908;Taip;2;0;0;2
16299;Lokiukas;"1 A klasė";45122233067;Taip;3;0;0;3
16300;Lokiukas;"1 A klasė";21802863853;Taip;3;0;0;3
16301;Lokiukas;"1 A klasė";84682977618;Taip;3;0;0;3
16302;Lokiukas;"1 A klasė";22979689191;Taip;3;0;0;3
16303;Lokiukas;"1 A klasė";80754592972;Taip;2;0;0;2
16304;Lokiukas;"1 A klasė";14903100496;Taip;2;0;0;2
16305;Lokiukas;"1 A klasė";99706061553;Taip;2;0;0;2
16306;Lokiukas;"1 A klasė";7785940412;Taip;3;0;0;3
16307;Lokiukas;"1 A klasė";24099693663;Taip;22;0;0;22
16308;Lokiukas;"1 A klasė";72092394330;Taip;8;0;0;8
16309;Lokiukas;"1 A klasė";9413274607;Taip;6;0;0;6
16310;Lokiukas;"1 A klasė";35769782473;Taip;9;0;0;9
16311;Lokiukas;"1 A klasė";38531751377;Taip;3;0;0;3
16312;Lokiukas;"1 A klasė";80793623068;Ne;2;0;0;2
16313;Lokiukas;"1 A klasė";25170045140;Ne;22;0;0;22
16314;Lokiukas;"1 A klasė";10948160841;Taip;22;0;0;22
16315;Lokiukas;"1 A klasė";4608275224;Taip;4;0;0;4
16316;Lokiukas;"1 A klasė";43070670534;Taip;2;0;0;2
16317;Lokiukas;"1 A klasė";59840033826;Taip;22;0;0;22
16318;Lokiukas;"1 A klasė";1855267362;Taip;3;0;0;3
16319;Lokiukas;"1 A klasė";84273668685;Taip;3;0;0;3
16320;Lokiukas;"1 A klasė";9747265775;Taip;3;0;0;3
16321;Lokiukas;"1 A klasė";5198408183;Taip;3;0;0;3
16322;Lokiukas;"1 A klasė";93374754851;Ne;3;0;0;3
16323;Lokiukas;"1 A klasė";15685936471;Taip;3;0;0;3
16324;Lokiukas;"1 A klasė";97609897018;Taip;4;0;0;4
16325;Lokiukas;"1 A klasė";23688235312;Taip;3;0;0;3
16326;Lokiukas;"1 A klasė";15574258138;Ne;3;0;0;3
16327;Lokiukas;"1 A klasė";9077016953;Taip;1;0;0;1
16328;Lokiukas;GUDRUČIAI;27150769109;Ne;1;0;1;2
16329;Lokiukas;GUDRUČIAI;7334971595;Ne;2;0;0;2
16330;Lokiukas;GUDRUČIAI;7235277422;Taip;11;0;0;11
16331;Lokiukas;GUDRUČIAI;57505829630;Taip;3;0;0;3
16332;Lokiukas;GUDRUČIAI;2959877846;Taip;15;0;0;15
16333;Lokiukas;GUDRUČIAI;8920359311;Taip;4;6;0;10
16334;Lokiukas;GUDRUČIAI;38884246104;Ne;1;0;0;1
16335;Lokiukas;GUDRUČIAI;29396361769;Ne;0;0;3;3
16336;Lokiukas;GUDRUČIAI;51059574159;Taip;0;0;3;3
16337;Lokiukas;GUDRUČIAI;61807094999;Taip;0;1;0;1
16338;Lokiukas;GUDRUČIAI;2955445066;Ne;0;0;6;6
16339;Lokiukas;BORUŽĖLĖS;4849031542;Taip;8;3;4;15
16340;Lokiukas;BORUŽĖLĖS;9307491947;Taip;10;1;0;11
16341;Lokiukas;BORUŽĖLĖS;3744484616;Taip;5;5;1;11
16342;Lokiukas;BORUŽĖLĖS;8286358519;Taip;7;1;1;9
16343;Lokiukas;BORUŽĖLĖS;2625981190;Taip;10;0;0;10
16344;Lokiukas;BORUŽĖLĖS;4585621105;Taip;4;1;0;5
16345;Lokiukas;BORUŽĖLĖS;5522089503;Taip;16;0;0;16
16346;Lokiukas;BORUŽĖLĖS;8576418875;Taip;9;10;0;19
16347;Lokiukas;BORUŽĖLĖS;4617372387;Taip;15;1;1;17
16348;Lokiukas;BORUŽĖLĖS;6869785650;Taip;0;6;0;6
16349;Lokiukas;BORUŽĖLĖS;8630112458;Taip;13;0;0;13
16350;Lokiukas;BORUŽĖLĖS;5467387832;Taip;8;12;0;20
16351;Lokiukas;BORUŽĖLĖS;6245610875;Taip;0;19;0;19
16352;Lokiukas;BORUŽĖLĖS;3930463578;Taip;5;8;0;13
16353;Lokiukas;BORUŽĖLĖS;3333990952;Taip;4;0;0;4
16354;Lokiukas;BORUŽĖLĖS;5548875714;Taip;4;0;0;4
16355;Lokiukas;BORUŽĖLĖS;6277388612;Taip;5;0;0;5
16356;Lokiukas;BORUŽĖLĖS;1833001939;Taip;0;22;0;22
16357;Lokiukas;BORUŽĖLĖS;2660616022;Taip;10;8;0;18
16358;Lokiukas;BORUŽĖLĖS;9798351980;Taip;0;11;0;11
16359;Lokiukas;BORUŽĖLĖS;5401463671;Ne;11;3;0;14
16360;Lokiukas;BORUŽĖLĖS;9996442005;Ne;11;3;0;14
16361;Lokiukas;BORUŽĖLĖS;4317453894;Taip;0;3;0;3
16362;Lokiukas;BORUŽĖLĖS;1226376844;Ne;0;9;1;10
16363;Lokiukas;ANČIUKAI;5518041213;Taip;6;0;0;6
16364;Lokiukas;ANČIUKAI;8738488104;Taip;7;0;1;8
16365;Lokiukas;ANČIUKAI;4197547631;Taip;0;21;0;21
16366;Lokiukas;ANČIUKAI;7783006852;Taip;5;0;1;6
16367;Lokiukas;ANČIUKAI;8596706753;Taip;7;6;0;13
16368;Lokiukas;ANČIUKAI;7006828256;Taip;9;1;0;10
16369;Lokiukas;ANČIUKAI;2782818158;Taip;9;7;0;16
16370;Lokiukas;ANČIUKAI;1170293017;Taip;12;1;0;13
16371;Lokiukas;ANČIUKAI;7532603655;Taip;0;19;0;19
16372;Lokiukas;ANČIUKAI;2021477393;Taip;0;8;0;8
16373;Lokiukas;ANČIUKAI;4442073527;Taip;7;2;0;9
16374;Lokiukas;ANČIUKAI;4206181176;Taip;10;0;0;10
16375;Lokiukas;ANČIUKAI;4858829710;Taip;16;0;0;16
16376;Lokiukas;ANČIUKAI;8329540746;Taip;7;0;0;7
16377;Lokiukas;KODĖLČIUKAI;2548712970;Taip;6;1;2;9
16378;Lokiukas;KODĖLČIUKAI;2673522432;Taip;0;1;0;1
16379;Lokiukas;KODĖLČIUKAI;9625041533;Ne;0;0;1;1
16380;Lokiukas;KODĖLČIUKAI;8399364170;Taip;0;4;0;4
16381;Lokiukas;KODĖLČIUKAI;4580716838;Taip;0;1;1;2
16382;Lokiukas;KODĖLČIUKAI;1201125655;Taip;0;9;0;9
16383;Lokiukas;KODĖLČIUKAI;73696992182;Taip;6;0;0;6
16384;Lokiukas;KODĖLČIUKAI;82025637099;Taip;3;0;0;3
16385;Lokiukas;KODĖLČIUKAI;8846527481;Taip;0;1;1;2
16386;Lokiukas;KODĖLČIUKAI;36677665098;Taip;2;0;0;2
16387;Lokiukas;KODĖLČIUKAI;131300206;Taip;0;7;0;7
16388;Lokiukas;KODĖLČIUKAI;7495691956;Ne;10;1;1;12
16389;Lokiukas;KODĖLČIUKAI;83528495608;Ne;0;1;0;1
16390;Lokiukas;KODĖLČIUKAI;1333650630;Ne;0;1;0;1
16391;Lokiukas;KODĖLČIUKAI;52940830874;Ne;5;3;0;8
16392;Lokiukas;KODĖLČIUKAI;41809745552;Taip;13;2;0;15
16393;Lokiukas;DRUGELIAI;7942641594;Taip;6;0;0;6
16394;Lokiukas;DRUGELIAI;8568285232;Taip;0;2;0;2
16395;Lokiukas;DRUGELIAI;5453470660;Taip;0;7;0;7
16396;Lokiukas;DRUGELIAI;5879386524;Taip;5;0;2;7
16397;Lokiukas;DRUGELIAI;14605095801;Taip;0;1;0;1
16398;Lokiukas;DRUGELIAI;46838695582;Taip;17;2;0;19
16399;Lokiukas;DRUGELIAI;2642065594;Taip;0;1;0;1
16400;Lokiukas;DRUGELIAI;1626698185;Taip;6;0;0;6
16401;Lokiukas;DRUGELIAI;39222094073;Taip;9;0;2;11
16402;Lokiukas;DRUGELIAI;1695680881;Ne;14;0;0;14
16403;Lokiukas;DRUGELIAI;69364831994;Taip;10;0;1;11
16404;Lokiukas;DRUGELIAI;39975872119;Taip;11;0;0;11
16405;Lokiukas;DRUGELIAI;78106313493;Taip;2;0;0;2
16406;Lokiukas;DRUGELIAI;74169282323;Taip;4;0;0;4
16407;Lokiukas;DRUGELIAI;1625137322;Taip;0;9;0;9
16408;Lokiukas;DRUGELIAI;1381505711;Taip;0;7;0;7
16409;Lokiukas;DRUGELIAI;8452600632;Taip;0;13;0;13
16410;Lokiukas;DRUGELIAI;7386571822;Ne;0;10;0;10
16411;Lokiukas;DRUGELIAI;35890122494;Taip;0;5;0;5
16412;Lokiukas;DRUGELIAI;1210407640;Taip;0;0;3;3
16413;Lokiukas;DRUGELIAI;7591418969;Taip;7;10;0;17
16414;Lokiukas;DRUGELIAI;8270572748;Taip;3;0;0;3
16415;Lokiukas;DRUGELIAI;8036643654;Taip;22;0;0;22
16416;Lokiukas;DRUGELIAI;99183628764;Taip;9;1;0;10
16417;Lokiukas;"2 A klasė";67818191566;Taip;11;0;0;11
16418;Lokiukas;"2 A klasė";45280536946;Taip;22;0;0;22
16419;Lokiukas;"2 A klasė";53087036306;Taip;22;0;0;22
16420;Lokiukas;"2 A klasė";79223457439;Ne;2;0;0;2
16421;Lokiukas;"2 A klasė";75613665040;Taip;2;0;0;2
16422;Lokiukas;"2 A klasė";1143130271;Taip;10;0;0;10
16423;Lokiukas;"2 A klasė";86623153797;Taip;2;0;0;2
16424;Lokiukas;"2 A klasė";27050402360;Ne;7;0;0;7
16425;Lokiukas;"2 A klasė";43389930516;Taip;2;0;0;2
16426;Lokiukas;"2 A klasė";53245573692;Taip;5;0;0;5
16427;Lokiukas;"2 A klasė";23222644824;Taip;2;0;0;2
16428;Lokiukas;"2 A klasė";52296454506;Ne;2;0;0;2
16429;Lokiukas;"2 A klasė";66999644935;Taip;22;0;0;22
16430;Lokiukas;"2 A klasė";72167964645;Ne;2;0;0;2
16431;Lokiukas;"2 A klasė";2143040924;Taip;22;0;0;22
16432;Lokiukas;"2 A klasė";3206276637;Taip;22;0;0;22
16433;Lokiukas;"2 A klasė";5775631777;Ne;7;0;0;7
16434;Lokiukas;"2 A klasė";25058082693;Ne;22;0;0;22
16435;Lokiukas;"2 A klasė";38636200254;Ne;2;0;0;2
16436;Lokiukas;"2 A klasė";47410036889;Taip;7;0;0;7
16437;Lokiukas;"2 A klasė";53544600623;Taip;22;0;0;22
16438;Lokiukas;"2 A klasė";14341255985;Taip;7;0;0;7
16439;Lokiukas;"2 A klasė";6702448475;Taip;3;0;0;3
16440;Lokiukas;"2 A klasė";82966541165;Taip;4;0;0;4
16441;Lokiukas;"2 A klasė";80180114948;Taip;18;0;0;18
16442;Lokiukas;"2 A klasė";42292408557;Taip;2;0;0;2
16443;Lokiukas;"2 A klasė";10240586503;Taip;22;0;0;22
16444;Lokiukas;"2 A klasė";3703002168;Taip;2;0;0;2
16445;Lokiukas;"2 B klasė";70028115546;Taip;22;0;0;22
16446;Lokiukas;"2 B klasė";35018370441;Taip;1;0;0;1
16447;Lokiukas;"2 B klasė";60370754283;Taip;2;0;0;2
16448;Lokiukas;"2 B klasė";98289469398;Taip;2;0;0;2
16449;Lokiukas;"2 B klasė";15445053855;Taip;2;0;0;2
16450;Lokiukas;"2 B klasė";3262579895;Taip;6;0;0;6
16451;Lokiukas;"2 B klasė";17622979450;Taip;2;0;0;2
16452;Lokiukas;"2 B klasė";51554951703;Taip;4;0;0;4
16453;Lokiukas;"2 B klasė";88947878548;Taip;2;0;0;2
16454;Lokiukas;"2 B klasė";66392613629;Taip;3;0;0;3
16455;Lokiukas;"2 B klasė";29198900240;Taip;4;0;0;4
16456;Lokiukas;"2 B klasė";17034757778;Taip;1;0;0;1
16457;Lokiukas;"2 B klasė";1716358913;Taip;5;0;0;5
16458;Lokiukas;"2 B klasė";77441549037;Taip;3;0;0;3
16459;Lokiukas;"2 B klasė";79301547085;Ne;2;0;0;2
16460;Lokiukas;"2 B klasė";10897713744;Taip;2;0;0;2
16461;Lokiukas;"2 B klasė";16889795010;Ne;3;0;0;3
16462;Lokiukas;"2 B klasė";18432518932;Taip;5;0;0;5
16463;Lokiukas;"2 B klasė";45805925058;Taip;2;0;0;2
16464;Lokiukas;"2 B klasė";5067673212;Taip;2;0;0;2
16465;Lokiukas;"2 B klasė";1104333637;Taip;2;0;0;2
16466;Lokiukas;"2 B klasė";79597160668;Taip;5;0;0;5
16467;Lokiukas;"2 B klasė";45735190114;Taip;22;0;0;22
16468;Lokiukas;"2 B klasė";37669645510;Taip;7;0;0;7
16469;Lokiukas;"2 B klasė";2353550739;Taip;2;0;0;2
16470;Lokiukas;"2 B klasė";15004419516;Taip;2;0;0;2
16471;Lokiukas;"2 B klasė";69089214980;Taip;5;0;0;5
16472;Lokiukas;"3 A klasė";2374089307;Ne;5;0;0;5
16473;Lokiukas;"3 A klasė";2607988265;Taip;5;0;0;5
16474;Lokiukas;"3 A klasė";4992275038;Taip;3;0;0;3
16475;Lokiukas;"3 A klasė";1492303633;Taip;3;0;0;3
16476;Lokiukas;"3 A klasė";6856770462;Ne;4;0;0;4
16477;Lokiukas;"3 A klasė";8766212402;Ne;5;0;0;5
16478;Lokiukas;"3 A klasė";5559967651;Taip;11;0;0;11
16479;Lokiukas;"3 A klasė";3528533437;Taip;22;0;0;22
16480;Lokiukas;"3 A klasė";5465758477;Taip;5;0;0;5
16481;Lokiukas;"3 A klasė";5700685872;Ne;11;0;0;11
16482;Lokiukas;"3 A klasė";6496662759;Taip;8;0;0;8
16483;Lokiukas;"3 A klasė";5737714024;Ne;3;0;0;3
16484;Lokiukas;"3 A klasė";7069020705;Ne;5;0;0;5
16485;Lokiukas;"3 A klasė";6129602024;Ne;5;0;0;5
16486;Lokiukas;"3 A klasė";9199283952;Taip;22;0;0;22
16487;Lokiukas;"3 A klasė";8378630091;Taip;3;0;0;3
16488;Lokiukas;"3 A klasė";3138145333;Ne;22;0;0;22
16489;Lokiukas;"3 A klasė";3506723678;Taip;3;0;0;3
16490;Lokiukas;"3 A klasė";1555365851;Ne;12;0;0;12
16491;Lokiukas;"3 A klasė";4615481025;Ne;3;0;0;3
16492;Lokiukas;"3 A klasė";5889819809;Ne;3;0;0;3
16493;Lokiukas;"3 A klasė";8499895935;Taip;10;0;0;10
16494;Lokiukas;"3 A klasė";7553457572;Ne;6;0;0;6
16495;Lokiukas;"3 A klasė";1571404671;Taip;7;0;0;7
16496;Lokiukas;"3 A klasė";1729941577;Taip;12;0;0;12
16497;Lokiukas;"3 B klasė";5745254234;Taip;3;0;0;3
16498;Lokiukas;"3 B klasė";8189433550;Taip;7;0;0;7
16499;Lokiukas;"3 B klasė";9114504810;Taip;9;0;0;9
16500;Lokiukas;"3 B klasė";1048772300;Taip;2;0;0;2
16501;Lokiukas;"3 B klasė";2021690274;Taip;2;0;0;2
16502;Lokiukas;"3 B klasė";5918592397;Taip;3;0;0;3
16503;Lokiukas;"3 B klasė";6538311120;Taip;3;0;0;3
16504;Lokiukas;"3 B klasė";7595514531;Taip;2;0;0;2
16505;Lokiukas;"3 B klasė";7144013238;Ne;4;0;0;4
16506;Lokiukas;"3 B klasė";8235437961;Taip;2;0;0;2
16507;Lokiukas;"3 B klasė";2905935730;Taip;21;0;0;21
16508;Lokiukas;"3 B klasė";8395026474;Ne;2;0;0;2
16509;Lokiukas;"3 B klasė";7439047502;Taip;2;0;0;2
16510;Lokiukas;"3 B klasė";8954484534;Taip;2;0;0;2
16511;Lokiukas;"3 B klasė";7722830021;Taip;2;0;0;2
16512;Lokiukas;"3 B klasė";9681048306;Taip;2;0;0;2
16513;Lokiukas;"3 B klasė";1388342336;Taip;4;0;0;4
16514;Lokiukas;"3 B klasė";1746819279;Taip;4;0;0;4
16515;Lokiukas;"3 B klasė";4418425219;Taip;2;0;0;2
16516;Lokiukas;"3 B klasė";3364994110;Taip;17;0;0;17
16517;Lokiukas;"3 B klasė";6063796643;Taip;3;0;0;3
16518;Lokiukas;"3 B klasė";6663700618;Taip;2;0;0;2
16519;Lokiukas;"3 B klasė";6151885589;Taip;2;0;0;2
16520;Lokiukas;"3 B klasė";1440437389;Taip;6;0;0;6
16521;Lokiukas;"3 B klasė";2059112380;Taip;3;0;0;3
16522;Lokiukas;"3 B klasė";1676862169;Ne;2;0;0;2
16523;Lokiukas;"4 A klasė";2220223549;Taip;22;0;0;22
16524;Lokiukas;"4 A klasė";7349936354;Ne;3;0;0;3
16525;Lokiukas;"4 A klasė";8192834838;Taip;5;0;0;5
16526;Lokiukas;"4 A klasė";7086818828;Taip;16;0;0;16
16527;Lokiukas;"4 A klasė";8959417696;Taip;3;0;0;3
16528;Lokiukas;"4 A klasė";1362995666;Taip;3;0;0;3
16529;Lokiukas;"4 A klasė";4873942674;Taip;14;0;0;14
16530;Lokiukas;"4 A klasė";2745780921;Taip;6;0;0;6
16531;Lokiukas;"4 A klasė";3007573139;Taip;11;0;0;11
16532;Lokiukas;"4 A klasė";5058488696;Taip;13;0;0;13
16533;Lokiukas;"4 A klasė";6008557035;Taip;10;0;0;10
16534;Lokiukas;"4 A klasė";1243245356;Taip;4;0;0;4
16535;Lokiukas;"4 A klasė";9322204885;Taip;22;0;0;22
16536;Lokiukas;"4 A klasė";1822055099;Ne;16;0;0;16
16537;Lokiukas;"4 A klasė";3700837936;Taip;6;0;0;6
16538;Lokiukas;"4 A klasė";6022402998;Taip;5;0;0;5
16539;Lokiukas;"4 A klasė";9743363133;Taip;15;0;0;15
16540;Lokiukas;"4 A klasė";2029507962;Taip;6;0;0;6
16541;Lokiukas;"4 A klasė";88967710414;Taip;12;0;0;12
16542;Lokiukas;"4 A klasė";88967710414;Taip;12;0;0;12
16543;Lokiukas;"4 A klasė";2129701351;Taip;20;0;0;20
16544;Lokiukas;"4 B klasė";1692231191;Taip;2;0;0;2
16545;Lokiukas;"4 B klasė";2284932363;Taip;5;0;0;5
16546;Lokiukas;"4 B klasė";4160279615;Taip;10;0;0;10
16547;Lokiukas;"4 B klasė";4368235682;Taip;4;0;0;4
16548;Lokiukas;"4 B klasė";9376247296;Taip;11;0;0;11
16549;Lokiukas;"4 B klasė";7943448919;Taip;6;0;0;6
16550;Lokiukas;"4 B klasė";9922964495;Taip;6;0;0;6
16551;Lokiukas;"4 B klasė";8822883914;Ne;16;0;0;16
16552;Lokiukas;"4 B klasė";6270747705;Taip;2;0;0;2
16553;Lokiukas;"4 B klasė";9390626220;Taip;22;0;0;22
16554;Lokiukas;"4 B klasė";5562737843;Taip;7;0;0;7
16555;Lokiukas;"4 B klasė";4467643205;Taip;4;0;0;4
16556;Lokiukas;"4 B klasė";6110849113;Taip;7;0;0;7
16557;Lokiukas;"4 B klasė";8175005473;Taip;13;0;0;13
16558;Lokiukas;"4 B klasė";4504812769;Taip;13;0;0;13
16559;Lokiukas;"4 B klasė";6210160161;Taip;19;0;0;19
16560;Lokiukas;"4 B klasė";1860245985;Ne;22;0;0;22
16561;Lokiukas;"4 B klasė";1727242060;Taip;22;0;0;22
16562;Lokiukas;"4 B klasė";8300861451;Taip;11;0;0;11
16563;Lokiukas;"4 B klasė";7692067948;Taip;7;0;0;7
16564;Lokiukas;"4 B klasė";7728788069;Taip;22;0;0;22
16565;Lokiukas;"4 B klasė";9985555940;Taip;22;0;0;22
16566;Lokiukas;"4 B klasė";4447860405;Taip;22;0;0;22
16567;Lokiukas;"4 B klasė";3823547337;Taip;7;0;0;7
16568;Lokiukas;"4 B klasė";5496591880;Taip;22;0;0;22
16569;Lokiukas;"4 B klasė";1491789191;Taip;9;0;0;9
16570;Lokiukas;"4 B klasė";1419846182;Taip;2;0;0;2
16571;Lokiukas;"4 B klasė";9310088026;Taip;7;0;0;7
16572;Lokiukas;"4 B klasė";1787800667;Taip;4;0;0;4
16573;Šaltinėlis;Ančiukų;3011747942;Taip;4;4;0;8
16574;Šaltinėlis;Ančiukų;9769491789;Taip;0;11;0;11
16575;Šaltinėlis;Ančiukų;56396772538;Taip;20;1;0;21
16576;Šaltinėlis;Ančiukų;6462738640;Taip;5;4;0;9
16577;Šaltinėlis;Ančiukų;3493429067;Taip;3;1;0;4
16578;Šaltinėlis;Ančiukų;77872075694;Taip;0;2;0;2
16579;Šaltinėlis;Ančiukų;9218883174;Ne;10;2;0;12
16580;Šaltinėlis;Ančiukų;7133143923;Taip;0;7;0;7
16581;Šaltinėlis;Ančiukų;9820788524;Taip;0;17;0;17
16582;Šaltinėlis;Ančiukų;3691635011;Ne;0;1;0;1
16583;Šaltinėlis;Ančiukų;2630875135;Taip;0;2;0;2
16584;Šaltinėlis;Ančiukų;2973820849;Ne;0;6;0;6
16585;Šaltinėlis;Ančiukų;6487378225;Taip;0;9;0;9
16586;Šaltinėlis;Ančiukų;1464992631;Taip;12;3;0;15
16587;Šaltinėlis;Ančiukų;9274165569;Taip;0;7;0;7
16588;Šaltinėlis;Ančiukų;8500790262;Taip;12;1;0;13
16589;Šaltinėlis;Ančiukų;4332884673;Taip;0;4;0;4
16590;Šaltinėlis;Ančiukų;9362495172;Ne;6;3;0;9
16591;Šaltinėlis;Ančiukų;7737797979;Taip;0;1;1;2
16592;Šaltinėlis;Ančiukų;5455278072;Taip;5;1;0;6
16593;Šaltinėlis;Ančiukų;6887838949;Taip;6;4;0;10
16594;Šaltinėlis;Ančiukų;2084451705;Ne;6;1;0;7
16595;Šaltinėlis;Bitučių;3455754351;Taip;8;1;0;9
16596;Šaltinėlis;Bitučių;1224027643;Taip;6;1;0;7
16597;Šaltinėlis;Bitučių;35748040565;Taip;0;1;0;1
16598;Šaltinėlis;Bitučių;86592374576;Taip;0;1;4;5
16599;Šaltinėlis;Bitučių;3022926855;Ne;5;1;0;6
16600;Šaltinėlis;Bitučių;32264290873;Taip;0;1;4;5
16601;Šaltinėlis;Bitučių;1767635282;Taip;7;1;0;8
16602;Šaltinėlis;Bitučių;1390316465;Taip;7;1;0;8
16603;Šaltinėlis;Bitučių;37786438977;Taip;6;3;0;9
16604;Šaltinėlis;Bitučių;5442943843;Taip;0;1;0;1
16605;Šaltinėlis;Bitučių;6764006747;Taip;0;1;0;1
16606;Šaltinėlis;Bitučių;1658370782;Ne;0;15;0;15
16607;Šaltinėlis;Bitučių;10918276041;Ne;4;1;0;5
16608;Šaltinėlis;Bitučių;66575684640;Taip;0;1;1;2
16609;Šaltinėlis;Bitučių;13808708760;Taip;0;7;0;7
16610;Šaltinėlis;Bitučių;1718488108;Taip;0;1;0;1
16611;Šaltinėlis;Bitučių;79406746980;Taip;0;4;0;4
16612;Šaltinėlis;Bitučių;3577137327;Taip;0;1;1;2
16613;Šaltinėlis;Bitučių;48525545812;Taip;7;2;0;9
16614;Šaltinėlis;Bitučių;7073644279;Taip;0;1;2;3
16615;Šaltinėlis;Bitučių;1190394855;Taip;7;1;0;8
16616;Šaltinėlis;Bitučių;1456486363;Taip;16;1;0;17
16617;Šaltinėlis;Bitučių;32949623652;Taip;0;16;0;16
16618;Šaltinėlis;Bitučių;1614411921;Ne;0;5;0;5
16619;Šaltinėlis;Bitučių;29359826470;Taip;0;1;0;1
16620;Šaltinėlis;Bitučių;6176560054;Ne;0;1;0;1
16621;Šaltinėlis;Saulutės;7311831014;Taip;6;1;0;7
16622;Šaltinėlis;Saulutės;5854723120;Taip;0;8;0;8
16623;Šaltinėlis;Saulutės;5833136956;Taip;0;1;2;3
16624;Šaltinėlis;Saulutės;3483756240;Taip;5;1;0;6
16625;Šaltinėlis;Saulutės;6380346298;Taip;5;1;0;6
16626;Šaltinėlis;Saulutės;5799032398;Taip;10;1;1;12
16627;Šaltinėlis;Saulutės;5525740049;Taip;8;3;0;11
16628;Šaltinėlis;Saulutės;5382567842;Taip;0;4;0;4
16629;Šaltinėlis;Saulutės;1978469605;Ne;3;8;1;12
16630;Šaltinėlis;Saulutės;9762392403;Ne;0;1;0;1
16631;Šaltinėlis;Saulutės;4743907195;Taip;5;1;0;6
16632;Šaltinėlis;Saulutės;5343279219;Taip;8;3;0;11
16633;Šaltinėlis;Saulutės;7118672118;Taip;6;1;1;8
16634;Šaltinėlis;Saulutės;2465009553;Taip;6;1;1;8
16635;Šaltinėlis;Saulutės;9108653045;Taip;5;1;1;7
16636;Šaltinėlis;Saulutės;5345738219;Ne;0;1;2;3
16637;Šaltinėlis;Saulutės;3579974049;Taip;0;6;0;6
16638;Šaltinėlis;Saulutės;6721510313;Ne;9;1;1;11
16639;Šaltinėlis;Saulutės;7650840990;Taip;6;5;0;11
16640;Šaltinėlis;Meškiukų;3264138693;Taip;2;9;0;11
16641;Šaltinėlis;Meškiukų;2013810425;Taip;0;5;0;5
16642;Šaltinėlis;Meškiukų;1045163890;Taip;10;1;1;12
16643;Šaltinėlis;Meškiukų;7231645416;Ne;0;1;1;2
16644;Šaltinėlis;Meškiukų;8555517284;Taip;2;10;0;12
16645;Šaltinėlis;Meškiukų;9757246434;Taip;16;1;0;17
16646;Šaltinėlis;Meškiukų;1073305554;Taip;6;1;0;7
16647;Šaltinėlis;Meškiukų;7483928256;Taip;0;1;0;1
16648;Šaltinėlis;Meškiukų;3516760367;Taip;9;8;0;17
16649;Šaltinėlis;Meškiukų;2628936055;Taip;10;1;0;11
16650;Šaltinėlis;Meškiukų;5256665649;Taip;9;1;2;12
16651;Šaltinėlis;Meškiukų;2700475528;Taip;7;2;1;10
16652;Šaltinėlis;Meškiukų;1035890284;Taip;20;1;0;21
16653;Šaltinėlis;Meškiukų;6880337593;Ne;0;1;1;2
16654;Šaltinėlis;Meškiukų;1543331408;Taip;0;6;0;6
16655;Šaltinėlis;Meškiukų;9305706589;Ne;0;4;0;4
16656;Šaltinėlis;Meškiukų;8902634958;Ne;7;1;0;8
16657;Šaltinėlis;Meškiukų;9968637187;Taip;11;1;0;12
16658;Šaltinėlis;Nykštukai;1823048790;Taip;9;1;2;12
16659;Šaltinėlis;Nykštukai;9522524163;Taip;14;1;1;16
16660;Šaltinėlis;Nykštukai;4681460322;Taip;12;2;0;14
16661;Šaltinėlis;Nykštukai;4430546695;Taip;13;1;1;15
16662;Šaltinėlis;Nykštukai;1686009371;Taip;8;1;3;12
16663;Šaltinėlis;Nykštukai;9075507649;Taip;3;1;0;4
16664;Šaltinėlis;Nykštukai;7068058767;Taip;10;1;0;11
16665;Šaltinėlis;Nykštukai;8914777163;Taip;12;2;0;14
16666;Šaltinėlis;Nykštukai;7387221265;Taip;10;1;1;12
16667;Šaltinėlis;Nykštukai;3073692882;Taip;7;1;0;8
16668;Šaltinėlis;Nykštukai;2126751248;Taip;8;9;0;17
16669;Šaltinėlis;Nykštukai;7133044918;Taip;9;1;2;12
16670;Šaltinėlis;Nykštukai;2806453623;Taip;6;1;2;9
16671;Šaltinėlis;Nykštukai;8695191968;Taip;4;4;1;9
16672;Šaltinėlis;Nykštukai;8506287076;Taip;0;1;0;1
16673;Šaltinėlis;Perliukų;17147527171;Ne;5;1;1;7
16674;Šaltinėlis;Perliukų;11083638216;Taip;0;1;6;7
16675;Šaltinėlis;Perliukų;1091056386;Taip;14;1;0;15
16676;Šaltinėlis;Perliukų;52507085619;Taip;0;1;1;2
16677;Šaltinėlis;Perliukų;23301579810;Taip;0;1;2;3
16678;Šaltinėlis;Perliukų;2146141461;Taip;0;1;1;2
16679;Šaltinėlis;Perliukų;1958647188;Taip;0;6;0;6
16680;Šaltinėlis;Perliukų;2034838765;Taip;0;1;0;1
16681;Šaltinėlis;Perliukų;1935762293;Taip;7;1;1;9
16682;Šaltinėlis;Perliukų;1583520894;Ne;5;7;0;12
16683;Šaltinėlis;Perliukų;1023238509;Taip;0;2;0;2
16684;Šaltinėlis;Perliukų;84494627465;Taip;0;1;0;1
16685;Šaltinėlis;Perliukų;98941037508;Taip;0;1;0;1
16686;Šaltinėlis;Perliukų;1004445904;Taip;0;1;0;1
16687;Šaltinėlis;Perliukų;9425353041;Taip;0;5;0;5
16688;Šaltinėlis;Perliukų;526307704;Taip;0;3;0;3
16689;Šaltinėlis;Perliukų;7262120071;Ne;0;1;1;2
16690;Šaltinėlis;Perliukų;6068980312;Taip;0;1;3;4
16691;Šaltinėlis;Perliukų;5869977541;Taip;19;1;0;20
16692;Šaltinėlis;Perliukų;4416064304;Ne;0;1;6;7
16693;Šaltinėlis;Perliukų;2333071711;Ne;6;1;1;8
16694;Šaltinėlis;Perliukų;1580090516;Taip;0;1;3;4
16695;Šaltinėlis;BORUŽĖLĖS;6645807642;Ne;6;1;1;8
16696;Šaltinėlis;BORUŽĖLĖS;8896316882;Taip;0;13;0;13
16697;Šaltinėlis;BORUŽĖLĖS;5325974488;Taip;0;7;0;7
16698;Šaltinėlis;BORUŽĖLĖS;1445108285;Taip;6;2;0;8
16699;Šaltinėlis;BORUŽĖLĖS;9759912102;Taip;0;1;1;2
16700;Šaltinėlis;BORUŽĖLĖS;6586783795;Taip;0;10;0;10
16701;Šaltinėlis;BORUŽĖLĖS;9691993251;Taip;6;1;0;7
16702;Šaltinėlis;BORUŽĖLĖS;4248763165;Taip;8;1;0;9
16703;Šaltinėlis;BORUŽĖLĖS;2189112609;Taip;0;1;0;1
16704;Šaltinėlis;BORUŽĖLĖS;9674923143;Taip;9;1;0;10
16705;Šaltinėlis;BORUŽĖLĖS;2022956307;Taip;5;10;0;15
16706;Šaltinėlis;BORUŽĖLĖS;7955094634;Taip;7;1;0;8
16707;Šaltinėlis;BORUŽĖLĖS;4664741207;Taip;10;1;0;11
16708;Šaltinėlis;BORUŽĖLĖS;9950106412;Taip;5;1;2;8
16709;Šaltinėlis;BORUŽĖLĖS;8995077908;Taip;9;3;0;12
16710;Šaltinėlis;"4B klasė";2413295020;Ne;0;22;0;22
16711;Šaltinėlis;"4B klasė";7404225862;Ne;0;5;0;5
16712;Šaltinėlis;"4B klasė";3375856084;Ne;0;9;0;9
16713;Šaltinėlis;"4B klasė";8670777468;Ne;0;5;0;5
16714;Šaltinėlis;"4B klasė";1687964284;Ne;0;5;0;5
16715;Šaltinėlis;"4B klasė";5105961386;Ne;0;5;0;5
16716;Šaltinėlis;"4B klasė";7121732840;Ne;0;14;0;14
16717;Šaltinėlis;"4B klasė";7917468152;Taip;0;5;0;5
16718;Šaltinėlis;"4B klasė";4335720836;Ne;0;15;0;15
16719;Šaltinėlis;"4B klasė";4994088781;Ne;0;10;0;10
16720;Šaltinėlis;"4B klasė";3680528737;Ne;0;5;0;5
16721;Šaltinėlis;"4B klasė";9708038079;Ne;0;10;0;10
16722;Šaltinėlis;"4B klasė";2160937385;Ne;0;22;0;22
16723;Šaltinėlis;"4B klasė";6381956693;Ne;0;22;0;22
16724;Šaltinėlis;"4B klasė";5181754988;Ne;0;22;0;22
16725;Šaltinėlis;"4B klasė";4543101402;Ne;0;6;0;6
16726;Šaltinėlis;1A;14213856824;Taip;0;5;0;5
16727;Šaltinėlis;1A;80649337160;Taip;0;10;0;10
16728;Šaltinėlis;1A;92958012146;Taip;0;5;0;5
16729;Šaltinėlis;1A;84656960510;Taip;0;12;0;12
16730;Šaltinėlis;1A;83621946293;Taip;0;22;0;22
16731;Šaltinėlis;1A;67808618878;Ne;0;5;0;5
16732;Šaltinėlis;1A;1278910777;Taip;0;5;0;5
16733;Šaltinėlis;1A;9647785988;Ne;0;22;0;22
16734;Šaltinėlis;1A;82671662416;Taip;0;5;0;5
16735;Šaltinėlis;1A;54025577281;Taip;0;7;0;7
16736;Šaltinėlis;1A;29482180151;Taip;0;5;0;5
16737;Šaltinėlis;1A;54753218491;Taip;0;5;0;5
16738;Šaltinėlis;1A;86029472773;Taip;0;5;0;5
16739;Šaltinėlis;1A;64821172553;Taip;0;11;0;11
16740;Šaltinėlis;1A;5744976843;Taip;0;14;0;14
16741;Šaltinėlis;1A;25459069972;Ne;0;6;0;6
16742;Šaltinėlis;1A;6669392157;Taip;0;5;0;5
16743;Šaltinėlis;1A;89358384113;Taip;0;11;0;11
16744;Šaltinėlis;1A;28956971978;Taip;0;5;0;5
16745;Šaltinėlis;1A;4050444191;Taip;0;5;0;5
16746;Šaltinėlis;1A;89093437170;Taip;0;5;0;5
16747;Šaltinėlis;1A;51872331010;Taip;0;7;0;7
16748;Šaltinėlis;1A;5056986469;Taip;0;5;0;5
16749;Šaltinėlis;1A;488285764;Taip;0;5;0;5
16750;Šaltinėlis;"2A klasė";83657465071;Taip;0;5;0;5
16751;Šaltinėlis;"2A klasė";86309198604;Taip;0;5;0;5
16752;Šaltinėlis;"2A klasė";9705941341;Taip;0;22;0;22
16753;Šaltinėlis;"2A klasė";38496350161;Taip;0;22;0;22
16754;Šaltinėlis;"2A klasė";62612067151;Taip;0;5;0;5
16755;Šaltinėlis;"2A klasė";96133834896;Ne;0;22;0;22
16756;Šaltinėlis;"2A klasė";2323456393;Ne;0;22;0;22
16757;Šaltinėlis;"2A klasė";56279691365;Taip;0;5;0;5
16758;Šaltinėlis;"2A klasė";4587186145;Taip;0;6;0;6
16759;Šaltinėlis;"2A klasė";70948186548;Taip;0;10;0;10
16760;Šaltinėlis;"2A klasė";47045578599;Taip;0;5;0;5
16761;Šaltinėlis;"2A klasė";36718328105;Taip;0;10;0;10
16762;Šaltinėlis;"2A klasė";86995081866;Taip;0;22;0;22
16763;Šaltinėlis;"2A klasė";7929809205;Ne;0;6;0;6
16764;Šaltinėlis;"2A klasė";29683761586;Ne;0;6;0;6
16765;Šaltinėlis;"2A klasė";40769315138;Taip;0;11;0;11
16766;Šaltinėlis;"2A klasė";7563879445;Ne;0;12;0;12
16767;Šaltinėlis;"2A klasė";66754907606;Taip;0;22;0;22
16768;Šaltinėlis;"2A klasė";35387543586;Taip;0;6;0;6
16769;Šaltinėlis;"2A klasė";9927833966;Ne;0;6;0;6
16770;Šaltinėlis;"3A klasė";7214517805;Ne;0;22;0;22
16771;Šaltinėlis;"3A klasė";9978493148;Ne;0;5;0;5
16772;Šaltinėlis;"3A klasė";1839665658;Ne;0;5;0;5
16773;Šaltinėlis;"3A klasė";8445115141;Ne;0;5;0;5
16774;Šaltinėlis;"3A klasė";1450894955;Ne;0;22;0;22
16775;Šaltinėlis;"3A klasė";8898225999;Ne;0;22;0;22
16776;Šaltinėlis;"3A klasė";6044895102;Ne;0;6;0;6
16777;Šaltinėlis;"3A klasė";7967108692;Ne;0;6;0;6
16778;Šaltinėlis;"3A klasė";4843823058;Ne;0;22;0;22
16779;Šaltinėlis;"3A klasė";92001008485;Taip;0;22;0;22
16780;Šaltinėlis;"3A klasė";7264810605;Ne;0;5;0;5
16781;Šaltinėlis;"3A klasė";7058348243;Ne;0;5;0;5
16782;Šaltinėlis;"3A klasė";5012608633;Ne;0;22;0;22
16783;Šaltinėlis;"3A klasė";2076892804;Ne;0;5;0;5
16784;Šaltinėlis;"3A klasė";8680271000;Ne;0;14;0;14
16785;Šaltinėlis;"3A klasė";6876036723;Ne;0;5;0;5
16786;Šaltinėlis;"3A klasė";6171441011;Ne;0;5;0;5
16787;Šaltinėlis;"4A klasė";9057225956;Ne;0;5;0;5
16788;Šaltinėlis;"4A klasė";8714253922;Ne;0;6;0;6
16789;Šaltinėlis;"4A klasė";6765467361;Ne;0;5;0;5
16790;Šaltinėlis;"4A klasė";2010277249;Ne;0;5;0;5
16791;Šaltinėlis;"4A klasė";3636296862;Ne;0;8;0;8
16792;Šaltinėlis;"4A klasė";4062628468;Ne;0;6;0;6
16793;Šaltinėlis;"4A klasė";6948074305;Ne;0;12;0;12
16794;Šaltinėlis;"4A klasė";2154195956;Ne;0;22;0;22
16795;Šaltinėlis;"4A klasė";47857916979;Taip;0;22;0;22
16796;Šaltinėlis;"4A klasė";6443537515;Ne;0;8;0;8
16797;Šaltinėlis;"4A klasė";57928407025;Ne;0;22;0;22
16798;Šaltinėlis;"4A klasė";9341104954;Ne;0;22;0;22
16799;Šaltinėlis;"4A klasė";8503985429;Ne;0;22;0;22
16800;Šaltinėlis;"4A klasė";4977611599;Ne;0;5;0;5
16801;Šaltinėlis;"4A klasė";24414070672;Ne;0;22;0;22
16802;Šaltinėlis;"4A klasė";4884745983;Taip;0;22;0;22
16803;Šaltinėlis;"4A klasė";3553168020;Ne;0;6;0;6
16804;Šaltinėlis;3B;7142082502;Ne;0;22;0;22
16805;Šaltinėlis;3B;6719801285;Ne;0;8;0;8
16806;Šaltinėlis;3B;1756003648;Taip;0;22;0;22
16807;Šaltinėlis;3B;4141263000;Ne;0;5;0;5
16808;Šaltinėlis;3B;3863654037;Ne;0;10;0;10
16809;Šaltinėlis;3B;5776007602;Ne;0;5;0;5
16810;Šaltinėlis;3B;3037854361;Ne;0;6;0;6
16811;Šaltinėlis;3B;2089316824;Ne;0;9;0;9
16812;Šaltinėlis;3B;7420737103;Ne;0;5;0;5
16813;Šaltinėlis;3B;8380122669;Ne;0;7;0;7
16814;Šaltinėlis;3B;82404351290;Taip;0;5;0;5
16815;Šaltinėlis;3B;5999279571;Ne;0;6;0;6
16816;Šaltinėlis;3B;3329317171;Ne;0;6;0;6
16817;Šaltinėlis;3B;8219291385;Ne;0;6;0;6
16818;Šaltinėlis;3B;49275031765;Taip;0;6;0;6
16819;Šaltinėlis;1B;93256161233;Taip;0;5;0;5
16820;Šaltinėlis;1B;83173349544;Taip;0;5;0;5
16821;Šaltinėlis;1B;39088869084;Taip;0;5;0;5
16822;Šaltinėlis;1B;95542489944;Taip;0;6;0;6
16823;Šaltinėlis;1B;3072314714;Taip;0;5;0;5
16824;Šaltinėlis;1B;1220687492;Taip;0;5;0;5
16825;Šaltinėlis;1B;74337710550;Ne;0;8;0;8
16826;Šaltinėlis;1B;35401075864;Ne;0;22;0;22
16827;Šaltinėlis;1B;19630605543;Taip;0;7;0;7
16828;Šaltinėlis;1B;3626545396;Ne;0;22;0;22
16829;Šaltinėlis;1B;72372808270;Taip;0;5;0;5
16830;Šaltinėlis;1B;1924418657;Taip;0;5;0;5
16831;Šaltinėlis;1B;77194317310;Taip;0;5;0;5
16832;Šaltinėlis;1B;57847832778;Taip;0;5;0;5
16833;Šaltinėlis;1B;70315400705;Ne;0;5;0;5
16834;Šaltinėlis;1B;81082410620;Taip;0;5;0;5
16835;Šaltinėlis;1B;1422035829;Taip;0;22;0;22
16836;Šaltinėlis;1B;84522552145;Taip;0;9;0;9
16837;Šaltinėlis;1B;7711903999;Ne;0;2;0;2
16838;Šaltinėlis;1B;6317111400;Taip;0;1;0;1
16839;Šaltinėlis;1B;4762756751;Ne;0;1;0;1
16840;Gabijėlė;GANDRIUKŲ;9706026832;Taip;0;5;0;5
16841;Gabijėlė;GANDRIUKŲ;2277489032;Taip;0;0;5;5
16842;Gabijėlė;GANDRIUKŲ;8994076883;Taip;0;0;5;5
16843;Gabijėlė;GANDRIUKŲ;7087892822;Taip;10;3;0;13
16844;Gabijėlė;GANDRIUKŲ;2550300871;Taip;0;1;2;3
16845;Gabijėlė;GANDRIUKŲ;3548399391;Taip;0;0;2;2
16846;Gabijėlė;GANDRIUKŲ;3532989398;Taip;1;0;0;1
16847;Gabijėlė;GANDRIUKŲ;2215880644;Taip;0;0;12;12
16848;Gabijėlė;GANDRIUKŲ;8904768332;Taip;0;0;2;2
16849;Gabijėlė;GANDRIUKŲ;3799003783;Taip;10;0;0;10
16850;Gabijėlė;GANDRIUKŲ;8572833698;Taip;10;0;0;10
16851;Gabijėlė;GANDRIUKŲ;7433142478;Taip;0;0;1;1
16852;Gabijėlė;GANDRIUKŲ;2491503656;Taip;10;1;0;11
16853;Gabijėlė;LAKŠTINGALIUKŲ;92624581275;Taip;0;1;0;1
16854;Gabijėlė;LAKŠTINGALIUKŲ;38094271521;Taip;0;0;1;1
16855;Gabijėlė;LAKŠTINGALIUKŲ;53325200270;Taip;0;4;2;6
16856;Gabijėlė;LAKŠTINGALIUKŲ;48032842307;Taip;0;0;1;1
16857;Gabijėlė;LAKŠTINGALIUKŲ;1451870519;Ne;0;5;0;5
16858;Gabijėlė;LAKŠTINGALIUKŲ;2220139259;Ne;1;0;1;2
16859;Gabijėlė;LAKŠTINGALIUKŲ;82760473229;Taip;0;2;0;2
16860;Gabijėlė;LAKŠTINGALIUKŲ;54950294060;Taip;0;1;0;1
16861;Gabijėlė;LAKŠTINGALIUKŲ;1988838165;Taip;0;2;0;2
16862;Gabijėlė;LAKŠTINGALIUKŲ;67189240970;Taip;0;10;0;10
16863;Gabijėlė;LAKŠTINGALIUKŲ;1240051312;Taip;0;0;3;3
16864;Gabijėlė;LAKŠTINGALIUKŲ;4662981914;Taip;7;7;0;14
16865;Gabijėlė;ŽVIRBLIUKŲ;7043775905;Taip;0;5;0;5
16866;Gabijėlė;ŽVIRBLIUKŲ;4475530177;Taip;10;0;1;11
16867;Gabijėlė;ŽVIRBLIUKŲ;5743861607;Taip;0;0;3;3
16868;Gabijėlė;ŽVIRBLIUKŲ;7410541320;Taip;0;21;0;21
16869;Gabijėlė;ŽVIRBLIUKŲ;4493192224;Taip;21;0;0;21
16870;Gabijėlė;ŽVIRBLIUKŲ;9259964641;Taip;9;0;1;10
16871;Gabijėlė;ŽVIRBLIUKŲ;3268231136;Taip;0;11;0;11
16872;Gabijėlė;ŽVIRBLIUKŲ;8879972953;Taip;7;13;0;20
16873;Gabijėlė;ŽVIRBLIUKŲ;5332825339;Taip;0;0;2;2
16874;Gabijėlė;ŽVIRBLIUKŲ;9627906252;Taip;3;0;4;7
16875;Gabijėlė;ŽVIRBLIUKŲ;2264669298;Ne;5;5;2;12
16876;Gabijėlė;ŽVIRBLIUKŲ;7417179112;Taip;5;0;1;6
16877;Gabijėlė;ŽVIRBLIUKŲ;5387026410;Taip;5;0;1;6
16878;Gabijėlė;ŽVIRBLIUKŲ;8292463617;Taip;8;0;2;10
16879;Gabijėlė;ŽVIRBLIUKŲ;3155403180;Taip;10;0;0;10
16880;Gabijėlė;ŽVIRBLIUKŲ;1158461185;Taip;10;0;0;10
16881;Gabijėlė;ŽVIRBLIUKŲ;6604681536;Ne;0;15;0;15
16882;Gabijėlė;ŽVIRBLIUKŲ;3218415151;Taip;7;0;4;11
16883;Gabijėlė;ŽVIRBLIUKŲ;8384795164;Ne;3;0;0;3
16884;Gabijėlė;ŽVIRBLIUKŲ;4146051969;Ne;0;15;0;15
16885;Gabijėlė;ŽVIRBLIUKŲ;6674038058;Taip;3;0;0;3
16886;Gabijėlė;ŽVIRBLIUKŲ;8823299212;Taip;5;0;2;7
16887;Gabijėlė;GENIUKŲ;3445433386;Taip;0;11;0;11
16888;Gabijėlė;GENIUKŲ;2980295345;Taip;0;2;0;2
16889;Gabijėlė;GENIUKŲ;1862655595;Taip;0;1;0;1
16890;Gabijėlė;GENIUKŲ;7312628876;Taip;5;2;0;7
16891;Gabijėlė;GENIUKŲ;1581688238;Taip;5;1;0;6
16892;Gabijėlė;GENIUKŲ;5301905117;Taip;0;9;0;9
16893;Gabijėlė;GENIUKŲ;3176075887;Taip;0;6;0;6
16894;Gabijėlė;GENIUKŲ;6866641272;Taip;6;0;0;6
16895;Gabijėlė;GENIUKŲ;9972967198;Taip;17;0;0;17
16896;Gabijėlė;GENIUKŲ;8305098808;Ne;6;0;0;6
16897;Gabijėlė;GENIUKŲ;1589534853;Ne;0;2;0;2
16898;Gabijėlė;GENIUKŲ;3020599503;Taip;5;6;0;11
16899;Gabijėlė;GENIUKŲ;4234733280;Taip;0;2;1;3
16900;Gabijėlė;GENIUKŲ;1922979974;Ne;9;0;0;9
16901;Gabijėlė;GENIUKŲ;6482824000;Taip;6;0;0;6
16902;Gabijėlė;GENIUKŲ;5962852108;Taip;3;0;1;4
16903;Gabijėlė;GENIUKŲ;2431615096;Taip;8;0;0;8
16904;Gabijėlė;GENIUKŲ;3289157020;Taip;8;0;0;8
16905;Gabijėlė;DAGILIUKŲ;9348393550;Taip;3;3;0;6
16906;Gabijėlė;DAGILIUKŲ;4264925447;Taip;3;3;0;6
16907;Gabijėlė;DAGILIUKŲ;9120107749;Taip;8;0;12;20
16908;Gabijėlė;DAGILIUKŲ;7426579018;Taip;12;0;2;14
16909;Gabijėlė;DAGILIUKŲ;3700639354;Taip;6;0;0;6
16910;Gabijėlė;DAGILIUKŲ;6438144206;Taip;0;1;0;1
16911;Gabijėlė;DAGILIUKŲ;4462129182;Taip;8;0;0;8
16912;Gabijėlė;DAGILIUKŲ;8662914262;Taip;8;2;0;10
16913;Gabijėlė;DAGILIUKŲ;9280283478;Ne;7;0;0;7
16914;Gabijėlė;DAGILIUKŲ;9503639471;Taip;0;2;0;2
16915;Gabijėlė;DAGILIUKŲ;1988597157;Ne;22;0;0;22
16916;Gabijėlė;DAGILIUKŲ;8036572198;Taip;22;0;0;22
16917;Gabijėlė;DAGILIUKŲ;9895518740;Taip;3;0;3;6
16918;Gabijėlė;DAGILIUKŲ;1455856766;Taip;0;0;1;1
16919;Gabijėlė;DAGILIUKŲ;6322094719;Taip;0;2;0;2
16920;Gabijėlė;DAGILIUKŲ;9449023766;Taip;0;5;0;5
16921;Gabijėlė;DAGILIUKŲ;2254104149;Taip;8;0;0;8
16922;Gabijėlė;DAGILIUKŲ;1286688629;Taip;5;0;1;6
16923;Gabijėlė;DAGILIUKŲ;4797994026;Taip;7;0;2;9
16924;Gabijėlė;PELEDŽIUKŲ;94478599707;Taip;0;0;1;1
16925;Gabijėlė;PELEDŽIUKŲ;2067646395;Taip;0;0;6;6
16926;Gabijėlė;PELEDŽIUKŲ;1068556799;Taip;0;2;2;4
16927;Gabijėlė;PELEDŽIUKŲ;1171257945;Ne;0;2;6;8
16928;Gabijėlė;PELEDŽIUKŲ;8044682830;Taip;0;2;1;3
16929;Gabijėlė;PELEDŽIUKŲ;43109352262;Taip;0;6;0;6
16930;Gabijėlė;PELEDŽIUKŲ;1747282196;Taip;0;1;3;4
16931;Gabijėlė;PELEDŽIUKŲ;39679870094;Taip;6;2;0;8
16932;Gabijėlė;PELEDŽIUKŲ;36642141718;Taip;6;2;0;8
16933;Gabijėlė;PELEDŽIUKŲ;1608940997;Taip;0;1;0;1
16934;Gabijėlė;PELEDŽIUKŲ;3610392405;Taip;0;5;0;5
16935;Gabijėlė;PELEDŽIUKŲ;4916964663;Taip;5;1;0;6
16936;Gabijėlė;PELEDŽIUKŲ;17443601729;Ne;18;0;0;18
16937;Gabijėlė;PELEDŽIUKŲ;1286307671;Taip;6;4;4;14
16938;Gabijėlė;PELEDŽIUKŲ;37544281230;Taip;0;2;0;2
16939;Gabijėlė;PELEDŽIUKŲ;4726771205;Ne;0;0;4;4
16940;Gabijėlė;PELEDŽIUKŲ;24035160251;Taip;0;0;9;9
16941;Gabijėlė;PELEDŽIUKŲ;65735862964;Taip;0;0;1;1
16942;Gabijėlė;PELEDŽIUKŲ;8746641978;Ne;3;0;0;3
16943;Gabijėlė;KREGZDŽIUKŲ;1743647754;Ne;0;2;0;2
16944;Gabijėlė;KREGZDŽIUKŲ;79544806044;Taip;5;1;0;6
16945;Gabijėlė;KREGZDŽIUKŲ;34683603878;Taip;0;2;0;2
16946;Gabijėlė;KREGZDŽIUKŲ;13013873198;Taip;0;1;0;1
16947;Gabijėlė;KREGZDŽIUKŲ;91643373754;Taip;5;0;4;9
16948;Gabijėlė;KREGZDŽIUKŲ;7298662616;Taip;7;0;0;7
16949;Gabijėlė;KREGZDŽIUKŲ;53576382572;Ne;6;0;0;6
16950;Gabijėlė;KREGZDŽIUKŲ;2958504770;Taip;10;0;0;10
16951;Gabijėlė;KREGZDŽIUKŲ;34998957585;Taip;4;0;3;7
16952;Gabijėlė;KREGZDŽIUKŲ;1770578935;Taip;0;0;5;5
16953;Gabijėlė;KREGZDŽIUKŲ;1455625997;Taip;2;1;0;3
16954;Gabijėlė;KREGZDŽIUKŲ;1937862725;Taip;0;0;1;1
16955;Gabijėlė;KREGZDŽIUKŲ;25732601952;Taip;0;2;0;2
16956;Gabijėlė;KREGZDŽIUKŲ;1217019582;Taip;0;0;2;2
16957;Gabijėlė;KREGZDŽIUKŲ;46552208567;Taip;0;7;0;7
16958;Gabijėlė;KREGZDŽIUKŲ;26058036933;Ne;2;0;0;2
16959;Gabijėlė;KREGZDŽIUKŲ;84120660883;Ne;2;0;0;2
16960;Gabijėlė;KREGZDŽIUKŲ;36447115547;Taip;2;1;0;3
16961;Gabijėlė;ZYLIUKŲ;41421082754;Taip;0;1;0;1
16962;Gabijėlė;ZYLIUKŲ;90540638931;Taip;5;1;0;6
16963;Gabijėlė;ZYLIUKŲ;20248530233;Taip;0;0;6;6
16964;Gabijėlė;ZYLIUKŲ;25691510343;Taip;0;0;1;1
16965;Gabijėlė;ZYLIUKŲ;70110432877;Taip;0;1;0;1
16966;Gabijėlė;ZYLIUKŲ;84464214049;Taip;0;4;0;4
16967;Gabijėlė;ZYLIUKŲ;62562568076;Taip;0;0;4;4
16968;Gabijėlė;ZYLIUKŲ;1505873499;Taip;0;0;1;1
16969;Gabijėlė;ZYLIUKŲ;1257150362;Ne;0;0;1;1
16970;Gabijėlė;ZYLIUKŲ;32203098792;Taip;0;7;0;7
16971;Gabijėlė;ZYLIUKŲ;1642361191;Ne;0;0;4;4
16972;Gabijėlė;ZYLIUKŲ;1036201997;Taip;0;1;0;1
16973;Gabijėlė;ZYLIUKŲ;60548215051;Taip;0;0;4;4
16974;Gabijėlė;ZYLIUKŲ;7778613039;Taip;0;0;3;3
16975;Gabijėlė;ZYLIUKŲ;31458685084;Taip;10;4;0;14
16976;Gabijėlė;ZYLIUKŲ;16804922682;Taip;4;2;0;6
16977;Gabijėlė;ZYLIUKŲ;1213013384;Ne;0;0;2;2
16978;Gabijėlė;ZYLIUKŲ;2010619186;Ne;0;0;2;2
16979;Gabijėlė;ZYLIUKŲ;1145863002;Taip;0;3;5;8
16980;Gabijėlė;ZYLIUKŲ;1649556120;Taip;10;0;0;10
16981;Gabijėlė;VOLUNGĖLIŲ;1779924073;Ne;0;0;4;4
16982;Gabijėlė;VOLUNGĖLIŲ;4166739739;Taip;0;6;0;6
16983;Gabijėlė;VOLUNGĖLIŲ;1492231030;Taip;0;6;0;6
16984;Gabijėlė;VOLUNGĖLIŲ;1317309811;Taip;0;4;0;4
16985;Gabijėlė;VOLUNGĖLIŲ;1523331860;Taip;0;2;0;2
16986;Gabijėlė;VOLUNGĖLIŲ;21740150080;Taip;0;6;0;6
16987;Gabijėlė;VOLUNGĖLIŲ;5558919097;Taip;10;7;0;17
16988;Gabijėlė;VOLUNGĖLIŲ;9683524530;Taip;7;0;7;14
16989;Gabijėlė;VOLUNGĖLIŲ;59837942520;Taip;0;0;1;1
16990;Gabijėlė;VOLUNGĖLIŲ;46021970332;Ne;10;0;2;12
16991;Gabijėlė;VOLUNGĖLIŲ;8480479946;Taip;0;8;0;8
16992;Gabijėlė;VOLUNGĖLIŲ;13265905500;Taip;10;12;0;22
16993;Gabijėlė;VOLUNGĖLIŲ;43737170074;Taip;0;0;2;2
16994;Gabijėlė;VOLUNGĖLIŲ;1480704497;Taip;0;5;0;5
16995;Gabijėlė;VOLUNGĖLIŲ;1669529717;Taip;0;0;2;2
16996;Gabijėlė;VOLUNGĖLIŲ;5704281727;Taip;0;0;1;1
16997;Gabijėlė;VOLUNGĖLIŲ;95685721388;Taip;6;7;0;13
16998;Gabijėlė;VOLUNGĖLIŲ;76416239647;Ne;3;0;1;4
16999;Gabijėlė;VOLUNGĖLIŲ;2102821834;Taip;0;0;1;1
17000;Gabijėlė;VOLUNGĖLIŲ;43869055555;Ne;0;0;1;1
17001;Gabijėlė;VOLUNGĖLIŲ;6271780003;Taip;0;1;0;1
17002;Gabijėlė;VOLUNGĖLIŲ;2051109865;Ne;6;1;0;7
17003;Gabijėlė;VOLUNGĖLIŲ;64252867351;Ne;0;11;0;11
17004;Gabijėlė;ANČIUKŲ;43123279348;Taip;0;13;0;13
17005;Gabijėlė;ANČIUKŲ;2036978425;Taip;0;17;0;17
17006;Gabijėlė;ANČIUKŲ;5219706067;Taip;13;1;0;14
17007;Gabijėlė;ANČIUKŲ;10796114623;Ne;0;19;0;19
17008;Gabijėlė;ANČIUKŲ;3454412432;Ne;0;0;2;2
17009;Gabijėlė;ANČIUKŲ;4752631976;Taip;6;0;2;8
17010;Gabijėlė;ANČIUKŲ;9822093084;Taip;4;2;0;6
17011;Gabijėlė;ANČIUKŲ;85836097485;Taip;0;0;1;1
17012;Gabijėlė;ANČIUKŲ;28017865889;Taip;0;6;0;6
17013;Gabijėlė;ANČIUKŲ;1917587420;Taip;11;6;0;17
17014;Gabijėlė;ANČIUKŲ;1465584524;Taip;10;0;0;10
17015;Gabijėlė;ANČIUKŲ;6198439092;Taip;3;0;0;3
17016;Gabijėlė;ANČIUKŲ;5783373671;Taip;0;12;0;12
17017;Gabijėlė;ANČIUKŲ;7948343328;Taip;0;5;0;5
17018;Gabijėlė;ANČIUKŲ;2052892422;Ne;0;0;3;3
17019;Gabijėlė;ANČIUKŲ;8111239476;Taip;19;3;0;22
17020;Gabijėlė;ANČIUKŲ;6766770793;Taip;0;10;0;10
17021;Gabijėlė;ANČIUKŲ;8778396292;Ne;8;0;1;9
17022;Gabijėlė;ANČIUKŲ;4085049535;Taip;0;17;0;17
17023;Gabijėlė;ANČIUKŲ;8893637755;Taip;0;12;0;12
17024;Gabijėlė;BALANDŽIUKŲ;4110081664;Taip;1;0;0;1
17025;Gabijėlė;BALANDŽIUKŲ;9157819780;Taip;0;9;0;9
17026;Gabijėlė;BALANDŽIUKŲ;1045338865;Taip;0;6;0;6
17027;Gabijėlė;BALANDŽIUKŲ;4330624300;Taip;5;0;3;8
17028;Gabijėlė;BALANDŽIUKŲ;33124420723;Taip;5;0;0;5
17029;Gabijėlė;BALANDŽIUKŲ;2097260657;Taip;8;0;0;8
17030;Gabijėlė;BALANDŽIUKŲ;8131229306;Taip;5;0;1;6
17031;Gabijėlė;BALANDŽIUKŲ;8525869648;Taip;0;6;0;6
17032;Gabijėlė;BALANDŽIUKŲ;56914218692;Taip;17;0;0;17
17033;Gabijėlė;BALANDŽIUKŲ;2070050969;Taip;5;5;0;10
17034;Gabijėlė;BALANDŽIUKŲ;7144977279;Ne;6;1;0;7
17035;Gabijėlė;BALANDŽIUKŲ;9197020006;Taip;13;2;0;15
17036;Gabijėlė;BALANDŽIUKŲ;1615940996;Taip;0;13;0;13
17037;Gabijėlė;BALANDŽIUKŲ;1273722177;Taip;5;0;2;7
17038;Gabijėlė;VYTURIUKŲ;2059859352;Taip;5;0;0;5
17039;Gabijėlė;VYTURIUKŲ;1859288888;Ne;11;0;0;11
17040;Gabijėlė;VYTURIUKŲ;44322663690;Ne;6;0;0;6
17041;Gabijėlė;VYTURIUKŲ;1479311429;Ne;10;0;0;10
17042;Gabijėlė;VYTURIUKŲ;4765125810;Taip;10;0;0;10
17043;Gabijėlė;VYTURIUKŲ;1219257874;Taip;8;0;0;8
17044;Gabijėlė;VYTURIUKŲ;39269336820;Taip;0;21;0;21
17045;Gabijėlė;VYTURIUKŲ;1829866148;Ne;7;0;1;8
17046;Gabijėlė;VYTURIUKŲ;47989272121;Ne;0;2;0;2
17047;Gabijėlė;VYTURIUKŲ;5736000160;Taip;9;0;0;9
17048;Gabijėlė;VYTURIUKŲ;9320327120;Taip;3;3;0;6
17049;Gabijėlė;VYTURIUKŲ;4632508075;Taip;9;0;1;10
17050;Gabijėlė;VYTURIUKŲ;1426802917;Taip;0;10;0;10
17051;Gabijėlė;VYTURIUKŲ;41212490042;Ne;2;0;4;6
17052;Gabijėlė;VYTURIUKŲ;1287165224;Taip;0;2;0;2
17053;Gabijėlė;VYTURIUKŲ;34609028374;Taip;8;2;0;10
17054;Gabijėlė;VYTURIUKŲ;1185452849;Taip;4;0;0;4
17055;Gabijėlė;VYTURIUKŲ;90520726029;Taip;3;0;0;3
17056;Gabijėlė;VYTURIUKŲ;11048695176;Taip;7;0;0;7
17057;Gabijėlė;VYTURIUKŲ;6492199649;Taip;5;0;0;5
17058;Pilaitukas;BITUTĖS;4305634374;Taip;2;0;0;2
17059;Pilaitukas;BITUTĖS;3519198814;Taip;4;0;0;4
17060;Pilaitukas;BITUTĖS;8169484415;Taip;0;0;5;5
17061;Pilaitukas;BITUTĖS;1729494874;Taip;0;3;0;3
17062;Pilaitukas;BITUTĖS;4082490488;Taip;9;0;2;11
17063;Pilaitukas;BITUTĖS;3345387791;Taip;0;0;1;1
17064;Pilaitukas;BITUTĖS;3913169122;Taip;7;0;0;7
17065;Pilaitukas;BITUTĖS;3541354283;Taip;0;3;0;3
17066;Pilaitukas;BITUTĖS;7342388716;Taip;0;4;3;7
17067;Pilaitukas;BITUTĖS;5740951665;Taip;12;0;1;13
17068;Pilaitukas;BITUTĖS;4591799893;Taip;18;0;0;18
17069;Pilaitukas;BITUTĖS;6308557885;Taip;16;0;0;16
17070;Pilaitukas;BITUTĖS;6514731102;Taip;14;0;0;14
17071;Pilaitukas;BITUTĖS;5988165204;Taip;0;0;1;1
17072;Pilaitukas;BITUTĖS;3037850837;Ne;7;0;1;8
17073;Pilaitukas;BITUTĖS;9126553732;Taip;0;5;1;6
17074;Pilaitukas;BITUTĖS;7438112270;Taip;9;0;1;10
17075;Pilaitukas;ZUIKUČIAI;5206637809;Taip;7;0;0;7
17076;Pilaitukas;ZUIKUČIAI;5288784331;Taip;0;0;2;2
17077;Pilaitukas;ZUIKUČIAI;8255398803;Ne;11;0;0;11
17078;Pilaitukas;ZUIKUČIAI;2862447956;Taip;0;1;0;1
17079;Pilaitukas;ZUIKUČIAI;8727175656;Taip;0;1;0;1
17080;Pilaitukas;ZUIKUČIAI;8207194955;Taip;0;1;2;3
17081;Pilaitukas;ZUIKUČIAI;5640802570;Ne;12;0;0;12
17082;Pilaitukas;ZUIKUČIAI;9988041515;Taip;8;1;0;9
17083;Pilaitukas;ZUIKUČIAI;9108428738;Taip;8;2;0;10
17084;Pilaitukas;ZUIKUČIAI;9878890346;Ne;0;0;2;2
17085;Pilaitukas;ZUIKUČIAI;6838035491;Taip;0;0;1;1
17086;Pilaitukas;ZUIKUČIAI;5710747769;Taip;5;0;1;6
17087;Pilaitukas;ZUIKUČIAI;7568744500;Taip;7;0;2;9
17088;Pilaitukas;ZUIKUČIAI;5407354218;Taip;17;0;0;17
17089;Pilaitukas;ZUIKUČIAI;9414051187;Taip;10;2;0;12
17090;Pilaitukas;ZUIKUČIAI;1295215465;Taip;0;5;0;5
17091;Pilaitukas;ANČIUKAI;9724892897;Taip;4;0;0;4
17092;Pilaitukas;ANČIUKAI;36338976218;Taip;3;0;0;3
17093;Pilaitukas;ANČIUKAI;1114477688;Taip;3;0;0;3
17094;Pilaitukas;ANČIUKAI;1512181401;Taip;9;0;0;9
17095;Pilaitukas;ANČIUKAI;3821748678;Taip;0;0;1;1
17096;Pilaitukas;ANČIUKAI;4505384039;Taip;4;0;0;4
17097;Pilaitukas;ANČIUKAI;5206439753;Taip;0;4;0;4
17098;Pilaitukas;ANČIUKAI;79485847381;Taip;9;0;1;10
17099;Pilaitukas;ANČIUKAI;5211988291;Taip;10;0;0;10
17100;Pilaitukas;ANČIUKAI;2117570444;Taip;0;6;0;6
17101;Pilaitukas;ANČIUKAI;87760608710;Taip;11;0;6;17
17102;Pilaitukas;ANČIUKAI;7909465673;Taip;6;0;2;8
17103;Pilaitukas;ANČIUKAI;2298935154;Taip;7;0;0;7
17104;Pilaitukas;ANČIUKAI;4694691187;Taip;0;0;4;4
17105;Pilaitukas;ANČIUKAI;9224653856;Taip;6;0;7;13
17106;Pilaitukas;ANČIUKAI;58250008277;Taip;10;0;2;12
17107;Pilaitukas;MEŠKIUKAI;57931719105;Taip;0;6;0;6
17108;Pilaitukas;MEŠKIUKAI;14554050141;Taip;0;7;1;8
17109;Pilaitukas;MEŠKIUKAI;9015675095;Taip;0;1;0;1
17110;Pilaitukas;MEŠKIUKAI;4505147961;Taip;0;0;1;1
17111;Pilaitukas;MEŠKIUKAI;9618329726;Taip;0;0;2;2
17112;Pilaitukas;MEŠKIUKAI;6514784647;Taip;0;0;1;1
17113;Pilaitukas;MEŠKIUKAI;9732741366;Taip;0;0;1;1
17114;Pilaitukas;MEŠKIUKAI;4038320896;Taip;0;0;2;2
17115;Pilaitukas;MEŠKIUKAI;3794882532;Taip;4;0;0;4
17116;Pilaitukas;MEŠKIUKAI;18466900688;Taip;0;5;0;5
17117;Pilaitukas;MEŠKIUKAI;2736736697;Ne;0;0;3;3
17118;Pilaitukas;MEŠKIUKAI;3214740183;Ne;0;0;1;1
17119;Pilaitukas;MEŠKIUKAI;39600380611;Taip;0;4;0;4
17120;Pilaitukas;MEŠKIUKAI;5604992163;Taip;0;6;0;6
17121;Pilaitukas;MEŠKIUKAI;9450834035;Taip;0;6;0;6
17122;Pilaitukas;MEŠKIUKAI;5689385925;Taip;0;5;0;5
17123;Pilaitukas;MEŠKIUKAI;1003278169;Ne;0;1;5;6
17124;Pilaitukas;MEŠKIUKAI;6117985788;Taip;0;0;2;2
17125;Pilaitukas;MEŠKIUKAI;9924612250;Taip;0;0;1;1
17126;Pilaitukas;ŽUVYTĖS;86572852457;Taip;0;0;1;1
17127;Pilaitukas;ŽUVYTĖS;83886439719;Taip;0;7;0;7
17128;Pilaitukas;ŽUVYTĖS;74367577786;Taip;6;0;0;6
17129;Pilaitukas;ŽUVYTĖS;8441380474;Taip;3;1;0;4
17130;Pilaitukas;ŽUVYTĖS;53049608654;Taip;0;0;3;3
17131;Pilaitukas;ŽUVYTĖS;62992423192;Taip;0;0;1;1
17132;Pilaitukas;ŽUVYTĖS;1707355162;Ne;7;0;0;7
17133;Pilaitukas;ŽUVYTĖS;27233065857;Ne;0;7;0;7
17134;Pilaitukas;ŽUVYTĖS;1824063553;Taip;9;0;0;9
17135;Pilaitukas;ŽUVYTĖS;37415672544;Taip;7;0;0;7
17136;Pilaitukas;ŽUVYTĖS;44413072002;Taip;9;0;0;9
17137;Pilaitukas;ŽUVYTĖS;66377321935;Taip;0;0;1;1
17138;Pilaitukas;ŽUVYTĖS;63470473930;Taip;9;1;0;10
17139;Pilaitukas;ŽUVYTĖS;1286286153;Ne;0;9;0;9
17140;Pilaitukas;ŽUVYTĖS;1896452184;Taip;0;1;0;1
17141;Pilaitukas;ŽUVYTĖS;49542027658;Taip;0;0;2;2
17142;Pilaitukas;ŽUVYTĖS;3723836301;Taip;0;0;2;2
17143;Pilaitukas;ŽUVYTĖS;6913383121;Ne;0;1;0;1
17144;Pilaitukas;ŽUVYTĖS;50368168240;Taip;0;0;1;1
17145;Pilaitukas;ŽUVYTĖS;81347327136;Taip;10;0;1;11
17146;Pilaitukas;PAUKŠTELIAI;98876022289;Taip;3;0;0;3
17147;Pilaitukas;PAUKŠTELIAI;25872504305;Taip;8;2;0;10
17148;Pilaitukas;PAUKŠTELIAI;26318820010;Taip;0;1;0;1
17149;Pilaitukas;PAUKŠTELIAI;68819621853;Taip;0;1;0;1
17150;Pilaitukas;PAUKŠTELIAI;99558991322;Taip;0;6;0;6
17151;Pilaitukas;PAUKŠTELIAI;61458733284;Taip;0;0;3;3
17152;Pilaitukas;PAUKŠTELIAI;88894299577;Taip;4;0;0;4
17153;Pilaitukas;PAUKŠTELIAI;32580431386;Taip;0;0;1;1
17154;Pilaitukas;PAUKŠTELIAI;95753711905;Taip;2;5;0;7
17155;Pilaitukas;PAUKŠTELIAI;46467461875;Ne;5;3;0;8
17156;Pilaitukas;PAUKŠTELIAI;89335569661;Ne;0;0;1;1
17157;Pilaitukas;PAUKŠTELIAI;49882457703;Ne;12;0;0;12
17158;Pilaitukas;PAUKŠTELIAI;97868106590;Taip;0;0;1;1
17159;Pilaitukas;PAUKŠTELIAI;36677686051;Taip;0;0;2;2
17160;Pilaitukas;PAUKŠTELIAI;98123777614;Taip;5;1;0;6
17161;Pilaitukas;PAUKŠTELIAI;93292073339;Taip;10;2;0;12
17162;Pilaitukas;PAUKŠTELIAI;27134663020;Taip;7;2;0;9
17163;Pilaitukas;PAUKŠTELIAI;74933839730;Taip;3;1;0;4
17164;Pilaitukas;PAUKŠTELIAI;29035791508;Ne;0;2;0;2
17165;Pilaitukas;BORUŽĖLĖS;98045145204;Taip;0;0;2;2
17166;Pilaitukas;BORUŽĖLĖS;2145561638;Taip;0;3;0;3
17167;Pilaitukas;BORUŽĖLĖS;14937983736;Taip;0;0;2;2
17168;Pilaitukas;BORUŽĖLĖS;1704733670;Ne;3;0;1;4
17169;Pilaitukas;BORUŽĖLĖS;2308673826;Taip;0;0;15;15
17170;Pilaitukas;BORUŽĖLĖS;1714711904;Taip;10;0;0;10
17171;Pilaitukas;BORUŽĖLĖS;2561804291;Taip;5;0;3;8
17172;Pilaitukas;BORUŽĖLĖS;9414846817;Taip;16;0;2;18
17173;Pilaitukas;BORUŽĖLĖS;56069293343;Taip;12;0;0;12
17174;Pilaitukas;BORUŽĖLĖS;7156205658;Taip;21;0;0;21
17175;Pilaitukas;BORUŽĖLĖS;5063602139;Ne;0;0;2;2
17176;Pilaitukas;BORUŽĖLĖS;5984878126;Taip;6;0;1;7
17177;Pilaitukas;BORUŽĖLĖS;84508228457;Taip;0;0;3;3
17178;Pilaitukas;BORUŽĖLĖS;95439358242;Ne;13;0;0;13
17179;Pilaitukas;BORUŽĖLĖS;6024861998;Taip;9;0;0;9
17180;Pilaitukas;BORUŽĖLĖS;58416972423;Taip;7;0;1;8
17181;Pilaitukas;BORUŽĖLĖS;9898379569;Taip;0;0;1;1
17182;Pilaitukas;DRUGELIAI;7961518607;Taip;10;0;1;11
17183;Pilaitukas;DRUGELIAI;7082054458;Taip;10;0;1;11
17184;Pilaitukas;DRUGELIAI;64601938351;Taip;0;10;0;10
17185;Pilaitukas;DRUGELIAI;5185051301;Taip;0;21;0;21
17186;Pilaitukas;DRUGELIAI;38456484551;Taip;0;3;0;3
17187;Pilaitukas;DRUGELIAI;7838787153;Taip;11;0;0;11
17188;Pilaitukas;DRUGELIAI;2613078582;Taip;6;3;0;9
17189;Pilaitukas;DRUGELIAI;9246391309;Ne;10;0;0;10
17190;Pilaitukas;DRUGELIAI;1677962644;Taip;18;0;0;18
17191;Pilaitukas;DRUGELIAI;4745358362;Taip;18;0;0;18
17192;Pilaitukas;DRUGELIAI;7853910193;Taip;9;0;2;11
17193;Pilaitukas;DRUGELIAI;6646474196;Taip;0;0;1;1
17194;Pilaitukas;DRUGELIAI;9801214344;Ne;11;0;1;12
17195;Pilaitukas;DRUGELIAI;5331915157;Taip;0;0;2;2
17196;Pilaitukas;DRUGELIAI;8302624354;Taip;0;0;1;1
17197;Pilaitukas;DRUGELIAI;5422289286;Taip;0;0;1;1
17198;Pilaitukas;DRUGELIAI;1272758839;Taip;0;0;1;1
17199;Pilaitukas;PELIUKAI;54387359229;Taip;6;0;0;6
17200;Pilaitukas;PELIUKAI;29229117661;Taip;0;6;0;6
17201;Pilaitukas;PELIUKAI;15303269615;Taip;6;1;0;7
17202;Pilaitukas;PELIUKAI;26063381713;Ne;5;0;0;5
17203;Pilaitukas;PELIUKAI;90148331957;Taip;0;0;2;2
17204;Pilaitukas;PELIUKAI;89719236172;Ne;0;3;0;3
17205;Pilaitukas;PELIUKAI;49084081967;Taip;5;0;0;5
17206;Pilaitukas;PELIUKAI;3685682772;Taip;0;22;0;22
17207;Pilaitukas;PELIUKAI;25608611239;Taip;1;0;0;1
17208;Pilaitukas;PELIUKAI;54706920576;Taip;12;0;0;12
17209;Pilaitukas;PELIUKAI;1168958446;Taip;0;2;0;2
17210;Pilaitukas;PELIUKAI;8152280709;Taip;7;0;1;8
17211;Pilaitukas;PELIUKAI;42514613325;Taip;15;0;0;15
17212;Pilaitukas;PELIUKAI;1611616941;Taip;0;8;0;8
17213;Pilaitukas;PELIUKAI;1726805610;Taip;3;0;0;3
17214;Pilaitukas;PELIUKAI;68571454940;Ne;1;0;0;1
17215;Pilaitukas;PELIUKAI;1779631590;Taip;5;0;0;5
17216;Pilaitukas;KAČIUKAI;74264627858;Taip;12;2;0;14
17217;Pilaitukas;KAČIUKAI;70465651068;Taip;2;0;0;2
17218;Pilaitukas;KAČIUKAI;4283157555;Taip;3;0;0;3
17219;Pilaitukas;KAČIUKAI;78293798850;Taip;0;2;0;2
17220;Pilaitukas;KAČIUKAI;58064353914;Taip;5;2;0;7
17221;Pilaitukas;KAČIUKAI;92823052045;Taip;5;5;0;10
17222;Pilaitukas;KAČIUKAI;7032684121;Taip;0;1;0;1
17223;Pilaitukas;KAČIUKAI;28902841059;Taip;1;0;0;1
17224;Pilaitukas;KAČIUKAI;78048449266;Taip;1;0;0;1
17225;Pilaitukas;KAČIUKAI;82688660737;Taip;1;0;0;1
17226;Pilaitukas;KAČIUKAI;1508672511;Taip;0;6;0;6
17227;Pilaitukas;KAČIUKAI;4348058482;Ne;3;2;0;5
17228;Pilaitukas;KAČIUKAI;17571219106;Taip;7;0;0;7
17229;Pilaitukas;KAČIUKAI;34346418650;Ne;4;0;0;4
17230;Pilaitukas;KAČIUKAI;6069797837;Taip;6;3;0;9
17231;Pilaitukas;SAULUTĖS;7222856683;Taip;0;21;0;21
17232;Pilaitukas;SAULUTĖS;6436694057;Taip;0;0;1;1
17233;Pilaitukas;SAULUTĖS;4719223490;Taip;0;0;2;2
17234;Pilaitukas;SAULUTĖS;9247501721;Taip;0;8;0;8
17235;Pilaitukas;SAULUTĖS;3825942473;Taip;0;11;0;11
17236;Pilaitukas;SAULUTĖS;3298272815;Taip;7;0;1;8
17237;Pilaitukas;SAULUTĖS;1731106179;Taip;9;0;0;9
17238;Pilaitukas;SAULUTĖS;2697591669;Ne;0;0;2;2
17239;Pilaitukas;SAULUTĖS;3954210452;Ne;14;0;0;14
17240;Pilaitukas;SAULUTĖS;3772830210;Ne;0;0;1;1
17241;Pilaitukas;SAULUTĖS;1611371690;Taip;0;0;7;7
17242;Pilaitukas;MENULIUKAI;4014329370;Taip;1;0;0;1
17243;Pilaitukas;MENULIUKAI;9774222130;Taip;0;0;1;1
17244;Pilaitukas;MENULIUKAI;4810825253;Taip;3;0;2;5
17245;Pilaitukas;MENULIUKAI;9556421129;Taip;5;0;0;5
17246;Pilaitukas;MENULIUKAI;8168228529;Ne;0;0;3;3
17247;Pilaitukas;MENULIUKAI;7604004800;Taip;1;0;1;2
17248;Pilaitukas;MENULIUKAI;8769116377;Taip;5;0;0;5
17249;Pilaitukas;MENULIUKAI;8501376663;Taip;4;0;2;6
17250;Pilaitukas;MENULIUKAI;6833933586;Taip;0;0;1;1
17251;Pilaitukas;MENULIUKAI;1270365948;Taip;0;0;1;1
17252;Pilaitukas;MENULIUKAI;1683900907;Taip;0;2;0;2
17253;Pilaitukas;MENULIUKAI;2416277190;Taip;0;21;0;21
17254;Pilaitukas;MENULIUKAI;7808204054;Ne;0;0;2;2
17255;Pilaitukas;ĖŽIUKAI;9653647227;Taip;0;0;19;19
17256;Pilaitukas;ĖŽIUKAI;5326689274;Taip;0;0;19;19
17257;Pilaitukas;ĖŽIUKAI;2463482642;Taip;8;0;1;9
17258;Pilaitukas;ĖŽIUKAI;2406183145;Taip;0;1;2;3
17259;Pilaitukas;ĖŽIUKAI;2379660463;Taip;0;1;2;3
17260;Pilaitukas;ĖŽIUKAI;1585341963;Taip;2;1;0;3
17261;Pilaitukas;ĖŽIUKAI;3080014745;Taip;0;1;0;1
17262;Pilaitukas;ĖŽIUKAI;5353687011;Taip;5;5;0;10
17263;Pilaitukas;ĖŽIUKAI;6102253106;Taip;2;5;3;10
17264;Pilaitukas;ĖŽIUKAI;8009040109;Taip;9;0;0;9
17265;Pilaitukas;ĖŽIUKAI;4022543517;Taip;0;3;0;3
17266;Pilaitukas;ĖŽIUKAI;7594484959;Taip;0;5;0;5
17267;"Naujųjų verkių";Lopšelinė;3825572125;Taip;0;5;0;5
17268;"Naujųjų verkių";Lopšelinė;8223747534;Taip;13;0;0;13
17269;"Naujųjų verkių";Lopšelinė;9200073539;Taip;16;0;0;16
17270;"Naujųjų verkių";Lopšelinė;8429923120;Taip;0;22;0;22
17271;"Naujųjų verkių";Lopšelinė;1693323032;Taip;0;14;0;14
17272;"Naujųjų verkių";Lopšelinė;1536075084;Taip;0;0;2;2
17273;"Naujųjų verkių";Lopšelinė;7010430969;Taip;3;3;0;6
17274;"Naujųjų verkių";Lopšelinė;9462019924;Taip;8;0;0;8
17275;"Naujųjų verkių";Lopšelinė;7734802846;Taip;5;0;0;5
17276;"Naujųjų verkių";Lopšelinė;3459439843;Taip;5;0;0;5
17277;"Naujųjų verkių";Lopšelinė;7510541192;Taip;0;3;0;3
17278;"Naujųjų verkių";Darželinė;12970840107;Taip;8;0;0;8
17279;"Naujųjų verkių";Darželinė;91710448735;Taip;0;6;0;6
17280;"Naujųjų verkių";Darželinė;70974231925;Taip;0;2;0;2
17281;"Naujųjų verkių";Darželinė;96956603806;Taip;0;1;0;1
17282;"Naujųjų verkių";Darželinė;60556803369;Taip;0;3;0;3
17283;"Naujųjų verkių";Darželinė;2636744220;Taip;0;7;0;7
17284;"Naujųjų verkių";Darželinė;1273331977;Taip;0;5;0;5
17285;"Naujųjų verkių";Darželinė;45101251137;Taip;0;2;0;2
17286;"Naujųjų verkių";Darželinė;1321551506;Taip;0;1;0;1
17287;"Naujųjų verkių";Darželinė;1061601585;Taip;0;1;0;1
17288;"Naujųjų verkių";Darželinė;19360482785;Ne;0;5;0;5
17289;"Naujųjų verkių";Darželinė;49937307547;Taip;0;22;0;22
17290;"Naujųjų verkių";Darželinė;89540088936;Taip;0;8;0;8
17291;"Naujųjų verkių";Darželinė;1023447413;Taip;0;0;1;1
17292;"Naujųjų verkių";Darželinė;7872515649;Taip;0;22;0;22
17293;"Naujųjų verkių";Darželinė;9840473841;Taip;0;9;0;9
17294;"Naujųjų verkių";Darželinė;63932903598;Taip;0;9;0;9
17295;"Naujųjų verkių";Darželinė;6425840559;Taip;0;2;0;2
17296;"Naujųjų verkių";Darželinė;3572188688;Taip;7;3;0;10
17297;Švelnukas;Pelėdžiukai;97312326369;Taip;0;2;0;2
17298;Švelnukas;Pelėdžiukai;54159329795;Taip;0;3;0;3
17299;Švelnukas;Pelėdžiukai;56353311492;Taip;13;0;5;18
17300;Švelnukas;Pelėdžiukai;73720184241;Taip;10;1;0;11
17301;Švelnukas;Pelėdžiukai;94832155557;Taip;10;2;0;12
17302;Švelnukas;Pelėdžiukai;4006769867;Taip;0;5;0;5
17303;Švelnukas;Pelėdžiukai;39249642586;Taip;0;0;1;1
17304;Švelnukas;Pelėdžiukai;81569596159;Taip;0;0;2;2
17305;Švelnukas;Pelėdžiukai;72764312386;Ne;13;0;1;14
17306;Švelnukas;Pelėdžiukai;59229958089;Taip;4;3;0;7
17307;Švelnukas;Pelėdžiukai;57026029080;Ne;2;0;1;3
17308;Švelnukas;Pelėdžiukai;30679686753;Taip;5;5;3;13
17309;Švelnukas;Pelėdžiukai;32473329970;Ne;0;1;0;1
17310;Švelnukas;Pelėdžiukai;50326830712;Ne;4;0;2;6
17311;Švelnukas;Pelėdžiukai;16880708270;Taip;0;2;0;2
17312;Švelnukas;Pelėdžiukai;52477782880;Taip;15;0;0;15
17313;Švelnukas;Pelėdžiukai;2123115761;Taip;0;0;1;1
17314;Švelnukas;Ežiukai;79306550532;Taip;0;2;0;2
17315;Švelnukas;Ežiukai;41867077386;Ne;2;0;2;4
17316;Švelnukas;Ežiukai;64192510147;Taip;0;2;0;2
17317;Švelnukas;Ežiukai;41365412569;Taip;0;0;6;6
17318;Švelnukas;Ežiukai;25374873288;Taip;0;0;1;1
17319;Švelnukas;Ežiukai;15308444101;Taip;7;0;1;8
17320;Švelnukas;Ežiukai;1755384216;Ne;0;0;1;1
17321;Švelnukas;Ežiukai;31881188589;Taip;0;0;1;1
17322;Švelnukas;Ežiukai;38902466526;Taip;4;0;2;6
17323;Švelnukas;Ežiukai;8399963483;Taip;3;0;1;4
17324;Švelnukas;Ežiukai;4711482287;Taip;7;0;0;7
17325;Švelnukas;Ežiukai;8681264696;Taip;11;3;0;14
17326;Švelnukas;Ežiukai;5608926908;Taip;10;0;0;10
17327;Švelnukas;Ežiukai;4373567509;Ne;0;2;1;3
17328;Švelnukas;Ežiukai;73628749439;Taip;0;10;0;10
17329;Švelnukas;Švelnukai;4681584014;Taip;0;0;4;4
17330;Švelnukas;Švelnukai;8211289456;Taip;0;0;3;3
17331;Švelnukas;Švelnukai;6607578153;Taip;5;0;2;7
17332;Švelnukas;Švelnukai;6798179840;Taip;0;0;3;3
17333;Švelnukas;Švelnukai;8847738918;Taip;0;1;0;1
17334;Švelnukas;Švelnukai;9829912750;Taip;6;0;0;6
17335;Švelnukas;Švelnukai;2464467471;Taip;7;0;1;8
17336;Švelnukas;Švelnukai;5213589179;Taip;15;2;0;17
17337;Švelnukas;Švelnukai;4544791546;Taip;4;0;0;4
17338;Švelnukas;Švelnukai;1963518457;Taip;0;22;0;22
17339;Švelnukas;Švelnukai;5936821902;Taip;0;0;2;2
17340;Švelnukas;Boružiukai;1951447127;Taip;5;0;1;6
17341;Švelnukas;Boružiukai;3849957906;Taip;10;0;2;12
17342;Švelnukas;Boružiukai;5550841477;Taip;4;7;0;11
17343;Švelnukas;Boružiukai;5974324302;Taip;3;0;0;3
17344;Švelnukas;Boružiukai;9722532034;Taip;1;0;1;2
17345;Švelnukas;Boružiukai;2400781175;Taip;12;8;0;20
17346;Švelnukas;Boružiukai;1264256177;Taip;8;1;1;10
17347;Švelnukas;Boružiukai;1332533332;Taip;6;0;5;11
17348;Švelnukas;Boružiukai;8787505507;Taip;0;1;0;1
17349;Švelnukas;Boružiukai;4134678301;Ne;2;0;4;6
17350;Švelnukas;Boružiukai;8458233793;Taip;5;0;4;9
17351;Švelnukas;Boružiukai;7967996032;Taip;0;0;1;1
17352;Švelnukas;Boružiukai;8951980999;Taip;0;0;2;2
17353;Švelnukas;Boružiukai;4990399144;Taip;0;4;0;4
17354;Švelnukas;Boružiukai;9575767514;Taip;0;0;3;3
17355;Švelnukas;Boružiukai;5409130195;Taip;10;0;2;12
17356;Švelnukas;Boružiukai;9479536507;Taip;0;3;0;3
17357;Švelnukas;Boružiukai;3145935641;Taip;1;3;0;4
17358;Švelnukas;Smalsučiai;76418408780;Taip;0;0;1;1
17359;Švelnukas;Smalsučiai;82202942341;Taip;0;11;0;11
17360;Švelnukas;Smalsučiai;63394075248;Taip;0;4;0;4
17361;Švelnukas;Smalsučiai;87770765141;Taip;0;0;8;8
17362;Švelnukas;Smalsučiai;47645479348;Taip;0;2;0;2
17363;Švelnukas;Smalsučiai;26077395334;Ne;0;12;0;12
17364;Švelnukas;Smalsučiai;15711256627;Taip;13;2;0;15
17365;Švelnukas;Smalsučiai;95780894209;Ne;0;0;2;2
17366;Švelnukas;Smalsučiai;76563731138;Ne;0;13;0;13
17367;Švelnukas;Smalsučiai;3388721433;Ne;0;1;0;1
17368;Švelnukas;Smalsučiai;1742714140;Taip;0;4;0;4
17369;Švelnukas;Smalsučiai;54425041280;Taip;0;3;0;3
17370;Švelnukas;Smalsučiai;91569132037;Taip;0;3;0;3
17371;Švelnukas;Smalsučiai;34570338962;Taip;0;0;6;6
17372;Švelnukas;Smalsučiai;78611632021;Taip;0;14;0;14
17373;Švelnukas;Smalsučiai;1139744541;Taip;0;0;4;4
17374;Švelnukas;Smalsučiai;15774114007;Taip;0;0;1;1
17375;Švelnukas;Smalsučiai;26312856720;Taip;5;0;1;6
17376;Švelnukas;Nykštukai;2141519946;Taip;0;6;0;6
17377;Švelnukas;Nykštukai;8771953161;Taip;0;0;3;3
17378;Švelnukas;Nykštukai;5327209876;Taip;0;5;0;5
17379;Švelnukas;Nykštukai;2282356211;Taip;5;0;0;5
17380;Švelnukas;Nykštukai;4697253853;Ne;0;0;2;2
17381;Švelnukas;Nykštukai;7387060610;Taip;0;2;0;2
17382;Švelnukas;Nykštukai;1762528313;Taip;0;0;1;1
17383;Švelnukas;Nykštukai;7380948648;Taip;0;1;0;1
17384;Švelnukas;Nykštukai;3473146893;Taip;0;1;0;1
17385;Švelnukas;Nykštukai;3370028567;Taip;0;4;0;4
17386;Švelnukas;Nykštukai;6633233824;Taip;15;0;0;15
17387;Švelnukas;Nykštukai;2106591525;Ne;8;0;0;8
17388;Švelnukas;Nykštukai;93497358197;Taip;0;2;0;2
17389;Švelnukas;Nykštukai;2971380970;Taip;9;0;0;9
17390;Švelnukas;Nykštukai;3389897065;Taip;9;0;0;9
17391;Švelnukas;Nykštukai;4302735157;Taip;0;0;4;4
17392;Švelnukas;Nykštukai;2785396019;Ne;0;0;2;2
17393;Boružėlė;"Nykštukai gudručiai";17133057179;Taip;0;3;0;3
17394;Boružėlė;"Nykštukai gudručiai";61157651941;Ne;8;0;0;8
17395;Boružėlė;"Nykštukai gudručiai";62849453206;Taip;8;1;0;9
17396;Boružėlė;"Nykštukai gudručiai";90752643228;Taip;0;1;0;1
17397;Boružėlė;"Nykštukai gudručiai";52470353273;Taip;12;2;0;14
17398;Boružėlė;"Nykštukai gudručiai";3659004986;Taip;4;0;0;4
17399;Boružėlė;"Nykštukai gudručiai";28726593347;Taip;3;2;0;5
17400;Boružėlė;"Nykštukai gudručiai";55985459125;Ne;0;1;0;1
17401;Boružėlė;"Nykštukai gudručiai";68875252308;Taip;4;1;0;5
17402;Boružėlė;"Nykštukai gudručiai";229765248;Taip;0;2;0;2
17403;Boružėlė;"Nykštukai gudručiai";82591189080;Taip;0;2;0;2
17404;Boružėlė;"Nykštukai gudručiai";95194187600;Taip;0;6;0;6
17405;Boružėlė;"Nykštukai gudručiai";59772973857;Taip;0;4;0;4
17406;Boružėlė;"Nykštukai gudručiai";473765285;Taip;1;0;0;1
17407;Boružėlė;"Saulės zuikučiai";4554260776;Taip;0;3;0;3
17408;Boružėlė;"Saulės zuikučiai";8259586236;Taip;8;0;0;8
17409;Boružėlė;"Saulės zuikučiai";3955841578;Taip;8;0;0;8
17410;Boružėlė;"Saulės zuikučiai";1583223569;Taip;8;1;0;9
17411;Boružėlė;"Saulės zuikučiai";5516103398;Taip;5;0;1;6
17412;Boružėlė;"Saulės zuikučiai";5298170118;Taip;0;2;2;4
17413;Boružėlė;"Saulės zuikučiai";9271331800;Taip;0;1;0;1
17414;Boružėlė;"Saulės zuikučiai";2133849514;Taip;3;3;0;6
17415;Boružėlė;"Saulės zuikučiai";1116012068;Ne;10;0;0;10
17416;Boružėlė;"Saulės zuikučiai";3412892266;Taip;5;0;0;5
17417;Boružėlė;"Saulės zuikučiai";1292298259;Taip;0;3;0;3
17418;Boružėlė;"Saulės zuikučiai";3130977416;Taip;0;1;0;1
17419;Boružėlė;"Saulės zuikučiai";7256396576;Taip;10;2;2;14
17420;Boružėlė;"Saulės zuikučiai";4323998138;Taip;14;0;0;14
17421;Boružėlė;"Saulės zuikučiai";2087238951;Taip;4;0;0;4
17422;Boružėlė;"Saulės zuikučiai";4999277693;Taip;12;1;0;13
17423;Boružėlė;"Saulės zuikučiai";6990311896;Taip;14;1;0;15
17424;Boružėlė;"Saulės zuikučiai";4509233532;Taip;12;0;0;12
17425;Boružėlė;"Saulės zuikučiai";3952645542;Taip;14;1;0;15
17426;Boružėlė;Gėlytės;4023646693;Taip;0;0;1;1
17427;Boružėlė;Gėlytės;51321138507;Taip;12;10;0;22
17428;Boružėlė;Gėlytės;62298785353;Taip;16;0;0;16
17429;Boružėlė;Gėlytės;84087304104;Taip;6;1;1;8
17430;Boružėlė;Gėlytės;11785706048;Taip;3;0;5;8
17431;Boružėlė;Gėlytės;77207874939;Taip;5;1;0;6
17432;Boružėlė;Gėlytės;86742600111;Taip;0;2;0;2
17433;Boružėlė;Gėlytės;25443948372;Taip;0;0;2;2
17434;Boružėlė;Gėlytės;57842027470;Taip;0;1;0;1
17435;Boružėlė;Gėlytės;1010790194;Taip;2;1;0;3
17436;Boružėlė;Gėlytės;1813949172;Taip;6;3;0;9
17437;Boružėlė;Gėlytės;5306841409;Ne;12;0;0;12
17438;Boružėlė;Gėlytės;43198292519;Taip;7;0;2;9
17439;Boružėlė;Smalsutis;2086485441;Taip;0;1;0;1
17440;Boružėlė;Smalsutis;5129244830;Taip;6;0;1;7
17441;Boružėlė;Smalsutis;2887130633;Taip;0;0;4;4
17442;Boružėlė;Smalsutis;4947670606;Taip;0;0;2;2
17443;Boružėlė;Smalsutis;2917508421;Taip;5;0;0;5
17444;Boružėlė;Smalsutis;7263730692;Taip;5;0;0;5
17445;Boružėlė;Smalsutis;5708558321;Taip;0;2;2;4
17446;Boružėlė;Smalsutis;6484173786;Taip;0;0;1;1
17447;Boružėlė;Smalsutis;2132904457;Ne;0;0;12;12
17448;Boružėlė;Smalsutis;77513300382;Ne;0;0;1;1
17449;Boružėlė;Smalsutis;39553430808;Taip;0;0;3;3
17450;Boružėlė;Smalsutis;4958704459;Taip;0;4;0;4
17451;Boružėlė;Smalsutis;5618586722;Taip;0;2;1;3
17452;Boružėlė;Smalsutis;4283064680;Taip;0;0;4;4
17453;Boružėlė;Drugeliai;8357946299;Taip;0;2;2;4
17454;Boružėlė;Drugeliai;1130980139;Taip;4;1;0;5
17455;Boružėlė;Drugeliai;6463583187;Taip;4;2;0;6
17456;Boružėlė;Drugeliai;6049501362;Ne;0;1;0;1
17457;Boružėlė;Drugeliai;8683282162;Ne;3;1;0;4
17458;Boružėlė;Drugeliai;3136028536;Taip;5;2;0;7
17459;Boružėlė;Drugeliai;2211576663;Taip;0;10;0;10
17460;Boružėlė;Drugeliai;1559001916;Taip;15;1;0;16
17461;Boružėlė;Drugeliai;4233602822;Taip;3;2;0;5
17462;Boružėlė;Drugeliai;9463322491;Taip;7;0;0;7
17463;Boružėlė;Drugeliai;3108758436;Taip;0;2;2;4
17464;Boružėlė;Drugeliai;8482813204;Taip;0;2;1;3
17465;Boružėlė;Drugeliai;6902130914;Taip;0;12;2;14
17466;Boružėlė;Drugeliai;3459207879;Ne;6;1;0;7
17467;Boružėlė;Drugeliai;1545244006;Taip;12;0;0;12
17468;Boružėlė;Drugeliai;6980022864;Taip;14;0;0;14
17469;Boružėlė;Drugeliai;7756929745;Taip;3;1;0;4
17470;Boružėlė;Drugeliai;5726187445;Taip;5;0;0;5
17471;Boružėlė;Drugeliai;2308405580;Taip;7;0;0;7
17472;Boružėlė;Vyturėliai;1913540317;Taip;3;0;0;3
17473;Boružėlė;Vyturėliai;1950269258;Taip;0;14;0;14
17474;Boružėlė;Vyturėliai;1591582954;Taip;5;9;0;14
17475;Boružėlė;Vyturėliai;3322567969;Taip;0;0;5;5
17476;Boružėlė;Vyturėliai;1718509953;Taip;0;1;0;1
17477;Boružėlė;Vyturėliai;8311383437;Taip;15;1;1;17
17478;Boružėlė;Vyturėliai;7534482245;Ne;10;1;0;11
17479;Boružėlė;Vyturėliai;3310676316;Taip;0;5;0;5
17480;Boružėlė;Vyturėliai;87834777247;Ne;11;1;0;12
17481;Boružėlė;Vyturėliai;50071056728;Taip;10;8;0;18
17482;Boružėlė;Vyturėliai;2098408445;Taip;0;1;0;1
17483;Boružėlė;Vyturėliai;8706461730;Taip;0;9;0;9
17484;Boružėlė;Vyturėliai;5337704114;Taip;0;2;1;3
17485;Boružėlė;Vyturėliai;8146684259;Taip;0;2;0;2
17486;Boružėlė;Vyturėliai;67504667512;Taip;0;1;0;1
17487;Boružėlė;Vyturėliai;5811751925;Taip;0;9;3;12
17488;Boružėlė;Vyturėliai;7136428795;Taip;0;1;0;1
17489;Boružėlė;Žvaigždutės;9838823214;Taip;0;0;4;4
17490;Boružėlė;Žvaigždutės;6293878183;Taip;4;5;0;9
17491;Boružėlė;Žvaigždutės;3489498503;Taip;0;1;0;1
17492;Boružėlė;Žvaigždutės;6972646373;Taip;0;1;0;1
17493;Boružėlė;Žvaigždutės;9720535449;Taip;0;2;1;3
17494;Boružėlė;Žvaigždutės;6435556131;Taip;0;2;1;3
17495;Boružėlė;Žvaigždutės;3140264242;Taip;1;1;0;2
17496;Boružėlė;Žvaigždutės;6847906406;Ne;0;1;5;6
17497;Boružėlė;Žvaigždutės;9836736618;Taip;0;1;2;3
17498;Boružėlė;Žvaigždutės;8029389952;Taip;0;1;0;1
17499;Boružėlė;Žvaigždutės;5307997577;Taip;0;0;5;5
17500;Boružėlė;Žvaigždutės;7078709057;Taip;0;1;0;1
17501;Boružėlė;Žvaigždutės;8213060214;Taip;0;0;1;1
17502;Boružėlė;Žvaigždutės;6724101421;Taip;0;2;0;2
17503;Boružėlė;Ąžuoliukai;5774358876;Taip;0;4;5;9
17504;Boružėlė;Ąžuoliukai;4519645340;Taip;0;2;1;3
17505;Boružėlė;Ąžuoliukai;24315678618;Taip;0;0;1;1
17506;Boružėlė;Ąžuoliukai;2618814096;Ne;9;8;0;17
17507;Boružėlė;Ąžuoliukai;6439902117;Taip;0;2;0;2
17508;Boružėlė;Ąžuoliukai;3040376382;Taip;0;7;0;7
17509;Boružėlė;Ąžuoliukai;3912668735;Taip;5;0;0;5
17510;Boružėlė;Ąžuoliukai;3840860155;Taip;0;2;0;2
17511;Boružėlė;Ąžuoliukai;3869817904;Taip;0;2;1;3
17512;Boružėlė;Ąžuoliukai;7722277859;Taip;0;3;0;3
17513;Boružėlė;Ąžuoliukai;6954794465;Taip;16;1;0;17
17514;Boružėlė;Ąžuoliukai;6545116373;Taip;5;8;0;13
17515;Boružėlė;Ąžuoliukai;5832223872;Taip;0;2;0;2
17516;Boružėlė;Ąžuoliukai;3695411422;Taip;0;22;0;22
17517;Boružėlė;Ąžuoliukai;5148410392;Ne;0;6;0;6
17518;Boružėlė;Ąžuoliukai;76222777017;Taip;0;2;1;3
17519;Boružėlė;Ąžuoliukai;45181369655;Taip;0;6;0;6
17520;Boružėlė;Ąžuoliukai;2077228543;Taip;0;1;0;1
17521;Boružėlė;Ąžuoliukai;6022191251;Taip;0;13;0;13
17522;Boružėlė;Saulutės;55049551150;Taip;0;2;0;2
17523;Boružėlė;Saulutės;1311485296;Taip;12;2;0;14
17524;Boružėlė;Saulutės;64389558278;Taip;3;4;0;7
17525;Boružėlė;Saulutės;1399195259;Taip;4;2;0;6
17526;Boružėlė;Saulutės;1247185819;Taip;0;1;0;1
17527;Boružėlė;Saulutės;1910653135;Taip;0;4;0;4
17528;Boružėlė;Saulutės;1527135537;Taip;0;2;0;2
17529;Boružėlė;Saulutės;8814486475;Ne;4;4;0;8
17530;Boružėlė;Saulutės;48414697489;Taip;0;2;0;2
17531;Boružėlė;Saulutės;4567360023;Taip;3;2;0;5
17532;Boružėlė;Saulutės;96500755145;Ne;0;2;0;2
17533;Boružėlė;Saulutės;2402968573;Taip;0;1;0;1
17534;Boružėlė;Saulutės;2690216341;Ne;0;2;0;2
17535;Boružėlė;Saulutės;1456577285;Taip;0;2;0;2
17536;Boružėlė;Saulutės;8659850691;Taip;0;2;0;2
17537;Boružėlė;Saulutės;4562962568;Taip;0;2;0;2
17538;Boružėlė;Saulutės;64347371263;Taip;1;2;0;3
17539;Boružėlė;Saulutės;1040409859;Taip;14;1;0;15
17540;Boružėlė;Saulutės;1750151078;Taip;0;11;0;11
17541;Boružėlė;Ežiukai;1637965530;Taip;3;0;0;3
17542;Boružėlė;Ežiukai;80490841186;Taip;0;0;5;5
17543;Boružėlė;Ežiukai;9645420240;Taip;0;1;0;1
17544;Boružėlė;Ežiukai;9436674675;Taip;0;1;0;1
17545;Boružėlė;Ežiukai;58923894463;Taip;5;2;0;7
17546;Boružėlė;Ežiukai;27456755162;Taip;0;2;1;3
17547;Boružėlė;Ežiukai;1339605077;Taip;0;2;0;2
17548;Boružėlė;Ežiukai;80239337645;Taip;3;2;0;5
17549;Boružėlė;Ežiukai;1007058344;Taip;0;2;0;2
17550;Boružėlė;Ežiukai;2138048547;Ne;5;0;5;10
17551;Boružėlė;Ežiukai;1431869021;Taip;0;7;0;7
17552;Boružėlė;Ežiukai;1474967056;Taip;0;1;2;3
17553;Boružėlė;Ežiukai;62548032852;Taip;0;1;0;1
17554;Boružėlė;Ežiukai;17258743024;Taip;0;4;0;4
17555;Boružėlė;Ežiukai;31109596405;Taip;0;7;0;7
17556;Boružėlė;Ežiukai;49403734292;Taip;10;0;1;11
17557;Boružėlė;Ežiukai;46486992436;Taip;0;1;0;1
17558;Boružėlė;Ežiukai;39704329817;Ne;0;2;0;2
17559;Boružėlė;Ežiukai;61932744418;Taip;0;2;0;2
17560;Boružėlė;Ežiukai;1459630343;Taip;0;8;0;8
17561;Boružėlė;Ežiukai;80378241169;Ne;0;2;0;2
17562;Boružėlė;Ežiukai;73347816357;Ne;0;1;0;1
17563;Boružėlė;Boružiukai;9520696660;Taip;0;6;2;8
17564;Boružėlė;Boružiukai;3288141024;Taip;4;6;0;10
17565;Boružėlė;Boružiukai;7942043844;Taip;0;12;1;13
17566;Boružėlė;Boružiukai;3226733236;Taip;0;4;0;4
17567;Boružėlė;Boružiukai;2842256033;Taip;0;2;0;2
17568;Boružėlė;Boružiukai;7262515868;Taip;0;2;0;2
17569;Boružėlė;Boružiukai;3340082011;Taip;0;2;0;2
17570;Boružėlė;Boružiukai;4020348640;Taip;7;0;5;12
17571;Boružėlė;Boružiukai;1166207929;Taip;8;0;0;8
17572;Boružėlė;Boružiukai;2561969142;Taip;5;0;0;5
17573;Boružėlė;Boružiukai;6070356395;Taip;10;1;0;11
17574;Boružėlė;Boružiukai;1547802140;Taip;5;0;0;5
17575;Boružėlė;Boružiukai;4637656311;Taip;0;0;1;1
17576;Boružėlė;Boružiukai;5768415821;Taip;5;0;0;5
17577;Boružėlė;Nykštukai;6590829182;Ne;0;1;2;3
17578;Boružėlė;Nykštukai;8141240094;Taip;0;2;2;4
17579;Boružėlė;Nykštukai;3129825206;Taip;6;2;0;8
17580;Boružėlė;Nykštukai;1894170218;Taip;4;0;0;4
17581;Boružėlė;Nykštukai;1784594085;Taip;6;0;0;6
17582;Boružėlė;Nykštukai;3509512899;Taip;5;1;0;6
17583;Boružėlė;Nykštukai;8888151470;Taip;5;1;0;6
17584;Boružėlė;Nykštukai;3430953692;Ne;15;0;0;15
17585;Boružėlė;Nykštukai;6166247730;Taip;0;2;0;2
17586;Boružėlė;Nykštukai;2744894565;Taip;0;1;1;2
17587;Boružėlė;Nykštukai;9771767352;Taip;15;6;0;21
17588;Boružėlė;Nykštukai;5825164520;Taip;9;0;0;9
17589;Boružėlė;Nykštukai;4990831292;Taip;5;1;2;8
17590;Žaliakalnio;Drugeliai;96127127960;Ne;0;1;0;1
17591;Žaliakalnio;Drugeliai;69892069029;Taip;5;0;0;5
17592;Žaliakalnio;Drugeliai;1012597457;Taip;0;3;0;3
17593;Žaliakalnio;Drugeliai;55967554391;Taip;1;0;8;9
17594;Žaliakalnio;Drugeliai;1357321617;Taip;0;1;0;1
17595;Žaliakalnio;Drugeliai;19165022144;Taip;2;1;0;3
17596;Žaliakalnio;Drugeliai;1902477771;Taip;5;0;0;5
17597;Žaliakalnio;Drugeliai;21032761681;Taip;0;0;2;2
17598;Žaliakalnio;Drugeliai;1919996835;Ne;0;1;0;1
17599;Žaliakalnio;Boružėlių;5843020412;Taip;5;1;0;6
17600;Žaliakalnio;Boružėlių;9625531462;Taip;0;7;0;7
17601;Žaliakalnio;Boružėlių;6699373334;Taip;0;7;0;7
17602;Žaliakalnio;Boružėlių;7087535800;Taip;9;1;0;10
17603;Žaliakalnio;Boružėlių;1528111839;Ne;0;9;0;9
17604;Žaliakalnio;Boružėlių;7023886811;Taip;8;1;0;9
17605;Žaliakalnio;Boružėlių;1673321992;Taip;9;0;0;9
17606;Žaliakalnio;Boružėlių;2284465378;Taip;0;12;0;12
17607;Žaliakalnio;Boružėlių;7977009681;Taip;8;3;0;11
17608;Žaliakalnio;Boružėlių;2808776865;Taip;17;0;0;17
17609;Žaliakalnio;Boružėlių;2278681435;Taip;8;0;0;8
17610;Žaliakalnio;Boružėlių;5157814568;Taip;11;0;0;11
17611;Žaliakalnio;Boružėlių;9421259943;Taip;1;0;0;1
17612;Žaliakalnio;Boružėlių;3445649442;Taip;3;1;0;4
17613;Žaliakalnio;Boružėlių;3105500733;Taip;0;5;0;5
17614;Žaliakalnio;Boružėlių;4864834075;Taip;5;0;2;7
17615;Žaliakalnio;Boružėlių;5764128482;Taip;10;1;0;11
17616;Žaliakalnio;Boružėlių;1200844791;Ne;0;8;0;8
17617;Žaliakalnio;Boružėlių;8052539476;Taip;5;6;0;11
17618;Žaliakalnio;Zuikučiai;1592051491;Ne;0;8;0;8
17619;Žaliakalnio;Zuikučiai;6088333997;Taip;10;4;0;14
17620;Žaliakalnio;Zuikučiai;2621828772;Taip;0;1;0;1
17621;Žaliakalnio;Zuikučiai;2673619031;Taip;0;4;0;4
17622;Žaliakalnio;Zuikučiai;5843314345;Taip;0;1;0;1
17623;Žaliakalnio;Zuikučiai;7447278960;Taip;0;13;0;13
17624;Žaliakalnio;Zuikučiai;2180165053;Taip;5;11;0;16
17625;Žaliakalnio;Zuikučiai;6823528666;Taip;0;12;0;12
17626;Žaliakalnio;Zuikučiai;3509064089;Taip;0;2;0;2
17627;Žaliakalnio;Zuikučiai;7000429934;Taip;0;4;0;4
17628;Žaliakalnio;Zuikučiai;5730610895;Taip;7;0;0;7
17629;Žaliakalnio;Zuikučiai;6881070397;Taip;7;0;0;7
17630;Žaliakalnio;Zuikučiai;8209559343;Taip;17;0;0;17
17631;Žaliakalnio;Zuikučiai;3835667120;Taip;9;13;0;22
17632;Žaliakalnio;Zuikučiai;9799056285;Taip;10;0;0;10
17633;Žaliakalnio;Zuikučiai;1321592040;Taip;8;0;0;8
17634;Žaliakalnio;Zuikučiai;9331287916;Taip;8;3;0;11
17635;Žaliakalnio;Zuikučiai;6726832258;Taip;6;1;0;7
17636;Žaliakalnio;Zuikučiai;4607456527;Taip;6;5;0;11
17637;Žaliakalnio;Zuikučiai;4511376806;Taip;0;4;0;4
17638;Žaliakalnio;Bitutė;23692122313;Ne;0;2;0;2
17639;Žaliakalnio;Bitutė;1581365258;Taip;0;2;0;2
17640;Žaliakalnio;Bitutė;26003637304;Taip;5;1;0;6
17641;Žaliakalnio;Bitutė;1673236492;Taip;5;0;0;5
17642;Žaliakalnio;Bitutė;46360583256;Taip;10;10;0;20
17643;Žaliakalnio;Bitutė;1027036769;Ne;0;1;0;1
17644;Žaliakalnio;Bitutė;1142844672;Taip;11;0;0;11
17645;Žaliakalnio;Bitutė;1447567627;Taip;0;6;0;6
17646;Žaliakalnio;Bitutė;1113616994;Ne;0;1;0;1
17647;Žaliakalnio;Bitutė;64628389691;Taip;0;1;0;1
17648;Žaliakalnio;Bitutė;1909837418;Ne;0;1;0;1
17649;Žaliakalnio;Bitutė;56508324349;Taip;5;2;0;7
17650;Žaliakalnio;Bitutė;92533370070;Ne;0;5;0;5
17651;Žaliakalnio;Bitutė;5761499050;Taip;6;0;1;7
17652;Žaliakalnio;Nykštukų;9057678671;Ne;0;6;0;6
17653;Žaliakalnio;Nykštukų;8640423692;Ne;0;1;0;1
17654;Žaliakalnio;Nykštukų;19192494119;Taip;4;1;0;5
17655;Žaliakalnio;Nykštukų;91524700281;Taip;6;1;0;7
17656;Žaliakalnio;Nykštukų;1932906021;Taip;0;2;0;2
17657;Žaliakalnio;Nykštukų;1753760382;Taip;4;0;0;4
17658;Žaliakalnio;Nykštukų;61215164827;Ne;4;0;0;4
17659;Žaliakalnio;Nykštukų;1657390839;Taip;0;9;0;9
17660;Žaliakalnio;Nykštukų;2655227703;Taip;0;0;3;3
17661;Žaliakalnio;Nykštukų;8085215871;Taip;0;13;0;13
17662;Žaliakalnio;Nykštukų;8469042778;Taip;13;0;2;15
17663;Žaliakalnio;Nykštukų;41844570217;Ne;0;1;0;1
17664;Žaliakalnio;Nykštukų;6638075273;Ne;18;0;0;18
17665;Žaliakalnio;Nykštukų;21744638321;Taip;2;7;0;9
17666;Žaliakalnio;Nykštukų;1514982516;Taip;7;12;0;19
17667;Žaliakalnio;Nykštukų;5946168564;Ne;0;7;0;7
17668;Žaliakalnio;Nykštukų;1589546605;Taip;5;2;0;7
17669;Žaliakalnio;Nykštukų;1511544568;Taip;0;5;0;5
17670;Žaliakalnio;ŽIOGELIAI;1413563085;Ne;7;1;0;8
17671;Žaliakalnio;ŽIOGELIAI;7449949339;Ne;10;0;0;10
17672;Žaliakalnio;ŽIOGELIAI;6379145626;Ne;14;0;0;14
17673;Žaliakalnio;ŽIOGELIAI;7094914749;Taip;8;2;0;10
17674;Žaliakalnio;ŽIOGELIAI;2607433844;Taip;1;5;1;7
17675;Žaliakalnio;ŽIOGELIAI;2432935088;Ne;0;4;0;4
17676;Žaliakalnio;ŽIOGELIAI;3058369504;Ne;5;0;0;5
17677;Žaliakalnio;ŽIOGELIAI;9771191966;Taip;4;0;0;4
17678;Žaliakalnio;ŽIOGELIAI;2201538495;Taip;10;1;0;11
17679;Žaliakalnio;ŽIOGELIAI;6919074533;Taip;1;2;0;3
17680;Žaliakalnio;ŽIOGELIAI;2426844621;Ne;7;0;0;7
17681;Žaliakalnio;ŽIOGELIAI;5752912101;Ne;8;0;0;8
17682;Žaliakalnio;ŽIOGELIAI;9967098834;Ne;10;0;0;10
17683;Žaliakalnio;ŽIOGELIAI;1133557422;Taip;0;1;0;1
17684;Žaliakalnio;ŽIOGELIAI;3464935314;Taip;11;1;0;12
17685;Žaliakalnio;ŽIOGELIAI;4497938258;Taip;6;0;1;7
17686;Žaliakalnio;ŽIOGELIAI;7648422668;Ne;10;0;0;10
17687;Žaliakalnio;ŽIOGELIAI;4702470511;Taip;8;0;0;8
17688;Žaliakalnio;ŽIOGELIAI;2272043654;Taip;10;0;0;10
17689;Žaliakalnio;ŽIOGELIAI;9363615751;Taip;0;6;0;6
17690;Giliukas;SMALSUČIAI;1289574961;Taip;0;2;2;4
17691;Giliukas;SMALSUČIAI;9747155435;Taip;0;22;0;22
17692;Giliukas;SMALSUČIAI;8359296058;Ne;2;7;0;9
17693;Giliukas;SMALSUČIAI;2006450088;Ne;5;2;0;7
17694;Giliukas;SMALSUČIAI;40373221046;Taip;0;2;1;3
17695;Giliukas;SMALSUČIAI;8575067944;Ne;0;2;2;4
17696;Giliukas;SMALSUČIAI;1463748654;Taip;0;2;0;2
17697;Giliukas;SMALSUČIAI;26109227683;Taip;10;0;0;10
17698;Giliukas;SMALSUČIAI;1417138570;Taip;0;1;0;1
17699;Giliukas;SMALSUČIAI;4053376466;Ne;0;12;0;12
17700;Giliukas;SMALSUČIAI;1406371374;Ne;13;0;0;13
17701;Giliukas;SMALSUČIAI;34155615138;Ne;7;2;0;9
17702;Giliukas;SMALSUČIAI;10326073797;Taip;8;0;0;8
17703;Giliukas;SMALSUČIAI;5914236976;Taip;10;0;4;14
17704;Giliukas;SMALSUČIAI;6453425490;Taip;8;1;0;9
17705;Giliukas;SMALSUČIAI;1190611675;Ne;9;0;0;9
17706;Giliukas;SMALSUČIAI;14318411597;Taip;0;1;0;1
17707;Giliukas;GUDRUČIAI;51201920656;Taip;2;0;0;2
17708;Giliukas;GUDRUČIAI;2617670085;Ne;0;4;0;4
17709;Giliukas;GUDRUČIAI;1649456516;Taip;7;2;1;10
17710;Giliukas;GUDRUČIAI;1431811346;Taip;0;1;0;1
17711;Giliukas;GUDRUČIAI;76716908362;Taip;0;6;2;8
17712;Giliukas;GUDRUČIAI;1771662094;Taip;0;2;1;3
17713;Giliukas;GUDRUČIAI;60766023175;Taip;0;0;1;1
17714;Giliukas;GUDRUČIAI;1869027087;Taip;0;1;0;1
17715;Giliukas;GUDRUČIAI;7223355423;Taip;0;2;1;3
17716;Giliukas;GUDRUČIAI;1624952768;Ne;0;1;0;1
17717;Giliukas;GUDRUČIAI;84750777858;Taip;8;2;1;11
17718;Giliukas;GUDRUČIAI;1665908531;Taip;0;1;0;1
17719;Giliukas;GUDRUČIAI;1910800137;Taip;0;2;2;4
17720;Giliukas;GUDRUČIAI;9826756136;Taip;0;22;0;22
17721;Giliukas;GUDRUČIAI;1733875411;Taip;0;2;4;6
17722;Giliukas;GUDRUČIAI;8284364049;Taip;3;2;2;7
17723;Giliukas;GUDRUČIAI;80254838594;Taip;0;22;0;22
17724;Giliukas;GUDRUČIAI;4163391813;Taip;0;22;0;22
17725;Giliukas;GUDRUČIAI;50289768374;Taip;0;22;0;22
17726;Giliukas;GUDRUČIAI;6154379463;Taip;0;22;0;22
17727;Giliukas;ŠNEKUČIAI;5513311280;Ne;3;6;2;11
17728;Giliukas;ŠNEKUČIAI;24030146209;Taip;0;22;0;22
17729;Giliukas;ŠNEKUČIAI;3847358328;Taip;14;1;0;15
17730;Giliukas;ŠNEKUČIAI;1890147760;Taip;0;22;0;22
17731;Giliukas;ŠNEKUČIAI;1469477982;Ne;10;0;0;10
17732;Giliukas;ŠNEKUČIAI;3983555939;Taip;0;1;0;1
17733;Giliukas;ŠNEKUČIAI;7780118692;Taip;0;1;2;3
17734;Giliukas;ŠNEKUČIAI;9401247559;Taip;9;1;0;10
17735;Giliukas;ŠNEKUČIAI;5994213515;Taip;0;22;0;22
17736;Giliukas;ŠNEKUČIAI;4916844983;Taip;5;1;0;6
17737;Giliukas;ŠNEKUČIAI;5787041097;Taip;15;0;0;15
17738;Giliukas;ŠNEKUČIAI;4987348316;Taip;4;1;0;5
17739;Giliukas;ŠNEKUČIAI;7159681896;Taip;0;1;0;1
17740;Giliukas;ŠNEKUČIAI;7540576615;Taip;0;22;0;22
17741;Giliukas;ŠNEKUČIAI;7386694567;Taip;0;22;0;22
17742;Giliukas;ŠNEKUČIAI;1734336095;Taip;0;17;0;17
17743;Giliukas;PABIRUČIAI;6469454991;Taip;0;22;0;22
17744;Giliukas;PABIRUČIAI;8267507304;Ne;14;2;0;16
17745;Giliukas;PABIRUČIAI;4854370266;Taip;0;2;0;2
17746;Giliukas;PABIRUČIAI;9608331265;Taip;0;9;0;9
17747;Giliukas;PABIRUČIAI;1870173947;Taip;11;0;0;11
17748;Giliukas;PABIRUČIAI;9644050818;Taip;4;1;5;10
17749;Giliukas;PABIRUČIAI;3150981084;Taip;0;0;1;1
17750;Giliukas;PABIRUČIAI;3137768675;Taip;7;0;3;10
17751;Giliukas;PABIRUČIAI;5816317197;Taip;8;0;3;11
17752;Giliukas;PABIRUČIAI;9408948207;Taip;10;0;1;11
17753;Giliukas;PABIRUČIAI;2003990493;Taip;0;0;7;7
17754;Giliukas;PABIRUČIAI;4960232685;Taip;10;0;0;10
17755;Giliukas;PABIRUČIAI;6338583515;Taip;5;0;3;8
17756;Giliukas;PABIRUČIAI;9458151965;Taip;0;0;2;2
17757;Giliukas;PABIRUČIAI;6703080106;Taip;16;0;0;16
17758;Giliukas;PABIRUČIAI;4912872957;Taip;0;9;0;9
17759;Giliukas;PABIRUČIAI;8502974441;Taip;0;8;0;8
17760;"Lazdynų mokykla";Drugeliai;10453975773;Taip;0;15;0;15
17761;"Lazdynų mokykla";Drugeliai;93091209041;Taip;5;0;0;5
17762;"Lazdynų mokykla";Drugeliai;1117304239;Taip;0;1;4;5
17763;"Lazdynų mokykla";Drugeliai;6209271043;Taip;0;1;5;6
17764;"Lazdynų mokykla";Drugeliai;7154882168;Taip;0;22;0;22
17765;"Lazdynų mokykla";Drugeliai;6835150864;Ne;0;9;0;9
17766;"Lazdynų mokykla";Drugeliai;9449948668;Taip;0;1;0;1
17767;"Lazdynų mokykla";Drugeliai;4520091712;Taip;0;0;2;2
17768;"Lazdynų mokykla";Drugeliai;1177208864;Taip;8;1;0;9
17769;"Lazdynų mokykla";Drugeliai;8472834181;Taip;7;1;1;9
17770;"Lazdynų mokykla";Drugeliai;9196184984;Taip;2;0;0;2
17771;"Lazdynų mokykla";Drugeliai;2469486746;Taip;0;8;0;8
17772;"Lazdynų mokykla";Drugeliai;6394098306;Taip;0;0;4;4
17773;"Lazdynų mokykla";Drugeliai;5982024698;Taip;4;0;3;7
17774;"Lazdynų mokykla";Drugeliai;2027751624;Taip;5;0;0;5
17775;"Lazdynų mokykla";Zuikučiai;1065999533;Ne;5;0;0;5
17776;"Lazdynų mokykla";Zuikučiai;5613360688;Ne;6;1;1;8
17777;"Lazdynų mokykla";Zuikučiai;40995112936;Taip;0;1;1;2
17778;"Lazdynų mokykla";Zuikučiai;9591838054;Taip;0;3;0;3
17779;"Lazdynų mokykla";Zuikučiai;8847547438;Ne;0;1;0;1
17780;"Lazdynų mokykla";Zuikučiai;6615724604;Taip;2;1;0;3
17781;"Lazdynų mokykla";Zuikučiai;9386629495;Taip;3;0;0;3
17782;"Lazdynų mokykla";Zuikučiai;1817040419;Taip;0;3;0;3
17783;"Lazdynų mokykla";Zuikučiai;1910670134;Ne;0;5;0;5
17784;"Lazdynų mokykla";Zuikučiai;25106446270;Ne;5;4;0;9
17785;"Lazdynų mokykla";Zuikučiai;9123178095;Taip;0;5;0;5
17786;"Lazdynų mokykla";Zuikučiai;6848743350;Taip;0;10;0;10
17787;"Lazdynų mokykla";Zuikučiai;1365362641;Taip;4;0;0;4
17788;"Lazdynų mokykla";Zuikučiai;3435025978;Taip;4;0;6;10
17789;"Lazdynų mokykla";Zuikučiai;7549389699;Ne;6;1;0;7
17790;"Lazdynų mokykla";Zuikučiai;8899186547;Taip;4;0;0;4
17791;"Lazdynų mokykla";Zuikučiai;5465094647;Taip;6;0;0;6
17792;"Lazdynų mokykla";Zuikučiai;1044630813;Taip;0;1;0;1
17793;"Lazdynų mokykla";RUPG;8280802645;Taip;4;0;1;5
17794;"Lazdynų mokykla";RUPG;2495494392;Taip;0;17;0;17
17795;"Lazdynų mokykla";RUPG;11571302488;Taip;0;0;4;4
17796;"Lazdynų mokykla";RUPG;7809088591;Ne;1;0;0;1
17797;"Lazdynų mokykla";RUPG;2989421059;Ne;0;0;1;1
17798;"Lazdynų mokykla";RUPG;5286305468;Ne;0;3;0;3
17799;"Lazdynų mokykla";RUPG;7639418071;Ne;9;0;0;9
17800;"Lazdynų mokykla";RUPG;10051044012;Taip;0;0;1;1
17801;"Lazdynų mokykla";RUPG;3746366243;Taip;4;0;2;6
17802;"Lazdynų mokykla";RUPG;59028339197;Taip;6;0;2;8
17803;"Lazdynų mokykla";RUPG;2054450461;Taip;0;0;1;1
17804;"Lazdynų mokykla";RUPG;9380814933;Taip;0;0;3;3
17805;"Lazdynų mokykla";RUPG;1837465174;Taip;0;4;2;6
17806;"Lazdynų mokykla";PG;6813765251;Taip;0;0;5;5
17807;"Lazdynų mokykla";PG;6453272974;Taip;0;1;0;1
17808;"Lazdynų mokykla";PG;1602013811;Taip;0;2;0;2
17809;"Lazdynų mokykla";PG;3349776899;Taip;0;2;0;2
17810;"Lazdynų mokykla";PG;5357769446;Taip;0;0;3;3
17811;"Lazdynų mokykla";PG;7276376278;Taip;0;0;2;2
17812;"„Atžalyno” mokykla-darželis";Giliukai;40936892543;Taip;10;0;0;10
17813;"„Atžalyno” mokykla-darželis";Giliukai;1426814743;Taip;2;0;5;7
17814;"„Atžalyno” mokykla-darželis";Giliukai;7699590933;Taip;6;0;0;6
17815;"„Atžalyno” mokykla-darželis";Giliukai;17672482867;Taip;10;0;0;10
17816;"„Atžalyno” mokykla-darželis";Giliukai;4537410041;Taip;3;0;0;3
17817;"„Atžalyno” mokykla-darželis";Giliukai;1233812908;Ne;0;0;14;14
17818;"„Atžalyno” mokykla-darželis";Giliukai;91701621174;Taip;5;0;1;6
17819;"„Atžalyno” mokykla-darželis";Giliukai;98404616387;Taip;0;0;2;2
17820;"„Atžalyno” mokykla-darželis";Giliukai;1267427191;Taip;16;0;5;21
17821;"„Atžalyno” mokykla-darželis";Giliukai;42069870710;Taip;2;0;0;2
17822;"„Atžalyno” mokykla-darželis";Giliukai;28021807339;Taip;0;0;5;5
17823;"„Atžalyno” mokykla-darželis";Giliukai;17110908746;Taip;0;0;2;2
17824;"„Atžalyno” mokykla-darželis";Giliukai;1481021352;Taip;11;0;1;12
17825;"„Atžalyno” mokykla-darželis";Giliukai;94908008744;Taip;0;0;2;2
17826;"„Atžalyno” mokykla-darželis";Giliukai;1997515382;Ne;5;0;0;5
17827;"„Atžalyno” mokykla-darželis";Giliukai;8806492917;Taip;0;0;1;1
17828;"„Atžalyno” mokykla-darželis";Giliukai;8495976081;Ne;0;0;1;1
17829;"„Atžalyno” mokykla-darželis";Giliukai;77204026281;Taip;0;0;2;2
17830;"„Atžalyno” mokykla-darželis";Giliukai;1342370096;Taip;0;0;3;3
17831;"„Atžalyno” mokykla-darželis";Giliukai;3943563359;Taip;0;0;2;2
17832;"„Atžalyno” mokykla-darželis";Riešutėliai;4784990018;Taip;0;2;0;2
17833;"„Atžalyno” mokykla-darželis";Riešutėliai;4345420422;Taip;5;0;0;5
17834;"„Atžalyno” mokykla-darželis";Riešutėliai;71840666522;Taip;0;2;0;2
17835;"„Atžalyno” mokykla-darželis";Riešutėliai;4290226052;Ne;12;0;5;17
17836;"„Atžalyno” mokykla-darželis";Riešutėliai;5596753512;Ne;2;0;0;2
17837;"„Atžalyno” mokykla-darželis";Riešutėliai;9806203065;Taip;11;0;2;13
17838;"„Atžalyno” mokykla-darželis";Riešutėliai;4832534190;Ne;0;0;2;2
17839;"„Atžalyno” mokykla-darželis";Riešutėliai;1151879281;Ne;0;10;5;15
17840;"„Atžalyno” mokykla-darželis";Riešutėliai;8008000299;Taip;0;0;6;6
17841;"„Atžalyno” mokykla-darželis";Riešutėliai;9215658103;Taip;0;0;1;1
17842;"„Atžalyno” mokykla-darželis";Riešutėliai;3484401937;Taip;3;0;2;5
17843;"„Atžalyno” mokykla-darželis";Riešutėliai;7652421432;Taip;10;0;0;10
17844;"„Atžalyno” mokykla-darželis";Riešutėliai;8254801574;Taip;0;0;1;1
17845;"„Atžalyno” mokykla-darželis";Riešutėliai;9013323901;Taip;12;2;0;14
17846;"„Atžalyno” mokykla-darželis";Riešutėliai;3529875728;Taip;14;0;0;14
17847;"„Atžalyno” mokykla-darželis";Žirniukai;6903825217;Taip;10;1;0;11
17848;"„Atžalyno” mokykla-darželis";Žirniukai;9101301819;Taip;4;0;0;4
17849;"„Atžalyno” mokykla-darželis";Žirniukai;6602037942;Taip;4;1;0;5
17850;"„Atžalyno” mokykla-darželis";Žirniukai;7579781779;Taip;11;0;0;11
17851;"„Atžalyno” mokykla-darželis";Žirniukai;1915676392;Ne;1;0;0;1
17852;"„Atžalyno” mokykla-darželis";Žirniukai;7669725276;Taip;6;0;0;6
17853;"„Atžalyno” mokykla-darželis";Žirniukai;9913048992;Taip;5;3;0;8
17854;"„Atžalyno” mokykla-darželis";Žirniukai;4107946143;Taip;10;3;0;13
17855;"„Atžalyno” mokykla-darželis";Žirniukai;7883570492;Ne;0;4;0;4
17856;"„Atžalyno” mokykla-darželis";Žirniukai;7502911642;Taip;19;0;0;19
17857;"„Atžalyno” mokykla-darželis";Žirniukai;8320161812;Taip;7;0;0;7
17858;"„Atžalyno” mokykla-darželis";Žirniukai;5335059675;Taip;0;3;0;3
17859;"„Atžalyno” mokykla-darželis";Žirniukai;1766599777;Taip;4;4;0;8
17860;"„Atžalyno” mokykla-darželis";Žirniukai;6922776405;Ne;5;0;0;5
17861;"„Atžalyno” mokykla-darželis";Žirniukai;9690554753;Taip;15;0;0;15
17862;"„Atžalyno” mokykla-darželis";Žirniukai;1961428224;Ne;0;0;2;2
17863;"Vilniaus Emilijos Pliaterytės progimnazija";PELĖDŽIUKAI;1475766630;Taip;8;6;8;22
17864;"Vilniaus Emilijos Pliaterytės progimnazija";PELĖDŽIUKAI;6025990670;Taip;0;0;1;1
17865;"Vilniaus Emilijos Pliaterytės progimnazija";PELĖDŽIUKAI;1758561647;Taip;3;1;0;4
17866;"Vilniaus Emilijos Pliaterytės progimnazija";PELĖDŽIUKAI;11101488283;Taip;4;0;1;5
17867;"Vilniaus Emilijos Pliaterytės progimnazija";PELĖDŽIUKAI;1551926849;Taip;3;0;1;4
17868;"Vilniaus Emilijos Pliaterytės progimnazija";PELĖDŽIUKAI;9980215936;Ne;0;1;2;3
17869;"Vilniaus Emilijos Pliaterytės progimnazija";PELĖDŽIUKAI;6406833864;Taip;0;5;0;5
17870;"Vilniaus Emilijos Pliaterytės progimnazija";PELĖDŽIUKAI;7540156488;Taip;0;6;0;6
17871;"Vilniaus Emilijos Pliaterytės progimnazija";PELĖDŽIUKAI;4146983741;Taip;0;1;1;2
17872;"Vilniaus Emilijos Pliaterytės progimnazija";PELĖDŽIUKAI;9886869275;Taip;5;0;0;5
17873;"Vilniaus Emilijos Pliaterytės progimnazija";PELĖDŽIUKAI;96590022188;Taip;0;4;0;4
17874;"Vilniaus Emilijos Pliaterytės progimnazija";PELĖDŽIUKAI;63585262568;Taip;0;0;1;1
17875;"Vilniaus Emilijos Pliaterytės progimnazija";PELĖDŽIUKAI;1653793823;Taip;0;2;0;2
17876;"Vilniaus Emilijos Pliaterytės progimnazija";BITUTĖS;68989648581;Taip;2;1;0;3
17877;"Vilniaus Emilijos Pliaterytės progimnazija";BITUTĖS;8848135087;Taip;1;0;0;1
17878;"Vilniaus Emilijos Pliaterytės progimnazija";BITUTĖS;1767730990;Taip;1;20;0;21
17879;"Vilniaus Emilijos Pliaterytės progimnazija";BITUTĖS;18253351529;Taip;6;0;0;6
17880;"Vilniaus Emilijos Pliaterytės progimnazija";BITUTĖS;40082135876;Taip;0;0;7;7
17881;"Vilniaus Emilijos Pliaterytės progimnazija";BITUTĖS;3419150668;Ne;2;1;0;3
17882;"Vilniaus Emilijos Pliaterytės progimnazija";BITUTĖS;9371122369;Taip;6;0;1;7
17883;"Vilniaus Emilijos Pliaterytės progimnazija";BITUTĖS;4680059512;Taip;1;0;0;1
17884;"Vilniaus Emilijos Pliaterytės progimnazija";BITUTĖS;8303408604;Taip;0;9;0;9
17885;"Vilniaus Emilijos Pliaterytės progimnazija";BITUTĖS;1082350468;Taip;0;0;3;3
17886;"Vilniaus Karaliaus Mindaugo pagrindinė mokykla";"PUG 3";1860540266;Taip;0;0;10;10
17887;"Vilniaus Karaliaus Mindaugo pagrindinė mokykla";"PUG 3";9555191234;Taip;0;0;8;8
17888;"Vilniaus Karaliaus Mindaugo pagrindinė mokykla";"PUG 3";9136681731;Taip;0;5;7;12
17889;"Vilniaus Karaliaus Mindaugo pagrindinė mokykla";"PUG 3";3680257542;Ne;0;0;6;6
17890;"Vilniaus Karaliaus Mindaugo pagrindinė mokykla";"PUG 3";1401502095;Ne;0;0;3;3
17891;"Vilniaus Karaliaus Mindaugo pagrindinė mokykla";"PUG 3";65541524010;Taip;5;0;1;6
17892;"Vilniaus Karaliaus Mindaugo pagrindinė mokykla";"PUG 3";1450039671;Taip;0;0;1;1
17893;"Vilniaus Karaliaus Mindaugo pagrindinė mokykla";"PUG 3";1969208564;Taip;0;0;6;6
17894;"Vilniaus Karaliaus Mindaugo pagrindinė mokykla";"PUG 3";3447871828;Taip;6;4;0;10
17895;"Vilniaus Karaliaus Mindaugo pagrindinė mokykla";"PUG 3";7596203918;Taip;0;0;22;22
17896;"Vilniaus Karaliaus Mindaugo pagrindinė mokykla";"PUG 2";2027114365;Taip;3;0;0;3
17897;"Vilniaus Karaliaus Mindaugo pagrindinė mokykla";"PUG 2";39088931809;Taip;5;0;1;6
17898;"Vilniaus Karaliaus Mindaugo pagrindinė mokykla";"PUG 2";1812197417;Ne;0;0;2;2
17899;"Vilniaus Karaliaus Mindaugo pagrindinė mokykla";"PUG 2";46282997811;Taip;9;0;2;11
17900;"Vilniaus Karaliaus Mindaugo pagrindinė mokykla";"PUG 2";41323355319;Taip;5;0;3;8
17901;"Vilniaus Karaliaus Mindaugo pagrindinė mokykla";"PUG 2";7641286244;Taip;0;0;2;2
17902;"Vilniaus Karaliaus Mindaugo pagrindinė mokykla";"PUG 2";1245722149;Taip;0;0;14;14
17903;"Vilniaus Karaliaus Mindaugo pagrindinė mokykla";"PUG 2";7259413060;Taip;5;0;5;10
17904;"Vilniaus Karaliaus Mindaugo pagrindinė mokykla";"PUG 2";13211267463;Taip;0;0;4;4
17905;"Vilniaus Karaliaus Mindaugo pagrindinė mokykla";"PUG 2";57220861535;Ne;6;0;2;8
17906;"Vilniaus Karaliaus Mindaugo pagrindinė mokykla";"PUG 2";8452554061;Taip;5;0;0;5
17907;"Vilniaus Karaliaus Mindaugo pagrindinė mokykla";"PUG 2";21847996888;Taip;6;0;0;6
17908;"Vilniaus Karaliaus Mindaugo pagrindinė mokykla";"PUG 2";10114111509;Taip;5;0;2;7
17909;"Vilniaus Karaliaus Mindaugo pagrindinė mokykla";"PUG 2";48069555680;Taip;13;0;0;13
17910;"Vilniaus Karaliaus Mindaugo pagrindinė mokykla";"PUG 1";5049742406;Ne;0;0;2;2
17911;"Vilniaus Karaliaus Mindaugo pagrindinė mokykla";"PUG 1";56814748796;Taip;0;1;0;1
17912;"Vilniaus Karaliaus Mindaugo pagrindinė mokykla";"PUG 1";152363521;Taip;4;7;1;12
17913;"Vilniaus Karaliaus Mindaugo pagrindinė mokykla";"PUG 1";18443760034;Taip;0;0;1;1
17914;"Vilniaus Karaliaus Mindaugo pagrindinė mokykla";"PUG 1";61301531283;Taip;5;14;0;19
17915;"Vilniaus Karaliaus Mindaugo pagrindinė mokykla";"PUG 1";8567961973;Taip;0;0;1;1
17916;"Vilniaus Karaliaus Mindaugo pagrindinė mokykla";"PUG 1";3468743460;Taip;0;0;5;5
17917;"Vilniaus Karaliaus Mindaugo pagrindinė mokykla";"PUG 1";1934113564;Ne;0;3;1;4
17918;"Vilniaus Karaliaus Mindaugo pagrindinė mokykla";"PUG 1";1967327730;Taip;10;0;1;11
17919;"Vilniaus Karaliaus Mindaugo pagrindinė mokykla";"PUG 1";1417730062;Taip;10;0;1;11
17920;"Vilniaus Karaliaus Mindaugo pagrindinė mokykla";"PUG 1";7798858993;Taip;0;0;1;1
17921;"Vilniaus Karaliaus Mindaugo pagrindinė mokykla";"PUG 1";93604802567;Taip;6;0;0;6
17922;"Vilniaus Karaliaus Mindaugo pagrindinė mokykla";"PUG 1";2026314698;Taip;0;0;6;6
17923;"Vilniaus Levo Karsavimo vidurinė mokykla";"Priešmokyklinukai A";6379177542;Taip;0;9;0;9
17924;"Vilniaus Levo Karsavimo vidurinė mokykla";"Priešmokyklinukai A";1840757726;Taip;6;0;0;6
17925;"Vilniaus Levo Karsavimo vidurinė mokykla";"Priešmokyklinukai A";36362624522;Taip;0;0;1;1
17926;"Vilniaus Levo Karsavimo vidurinė mokykla";"Priešmokyklinukai A";60768660940;Taip;0;2;0;2
17927;"Vilniaus Levo Karsavimo vidurinė mokykla";"Priešmokyklinukai A";71494345484;Taip;0;4;0;4
17928;"Vilniaus Levo Karsavimo vidurinė mokykla";"Priešmokyklinukai A";1035415228;Taip;0;4;0;4
17929;"Vilniaus Levo Karsavimo vidurinė mokykla";"Priešmokyklinukai A";24566804095;Taip;0;3;0;3
17930;"Vilniaus Levo Karsavimo vidurinė mokykla";"Priešmokyklinukai A";27116746304;Taip;0;0;1;1
17931;"Vilniaus Levo Karsavimo vidurinė mokykla";"Priešmokyklinukai A";86343860903;Taip;6;0;3;9
17932;"Vilniaus Levo Karsavimo vidurinė mokykla";"Priešmokyklinukai A";3847912854;Taip;0;0;4;4
17933;"Vilniaus Levo Karsavimo vidurinė mokykla";"Priešmokyklinukai A";1620139958;Taip;5;0;1;6
17934;"Vilniaus Levo Karsavimo vidurinė mokykla";"Priešmokyklinukai A";1356029457;Taip;0;0;1;1
17935;"Vilniaus Levo Karsavimo vidurinė mokykla";"Priešmokyklinukai A";89044270439;Taip;3;0;0;3
17936;"Vilniaus Liepkalnio Pagrindinė Mokykla";Bitutės;5028304472;Taip;0;0;1;1
17937;"Vilniaus Liepkalnio Pagrindinė Mokykla";Bitutės;73391370015;Taip;5;0;1;6
17938;"Vilniaus Liepkalnio Pagrindinė Mokykla";Bitutės;8550048533;Ne;1;0;2;3
17939;"Vilniaus Liepkalnio Pagrindinė Mokykla";Bitutės;1614647892;Taip;0;0;1;1
17940;"Vilniaus Liepkalnio Pagrindinė Mokykla";Bitutės;1886141947;Taip;0;0;1;1
17941;"Vilniaus Liepkalnio Pagrindinė Mokykla";Bitutės;8372336161;Ne;0;0;3;3
17942;"Vilniaus Liepkalnio Pagrindinė Mokykla";Bitutės;1141466643;Taip;9;0;1;10
17943;"Vilniaus Pranciškaus Skorinos gimnazija";Saulytė;72376520386;Taip;8;0;1;9
17944;"Vilniaus Pranciškaus Skorinos gimnazija";Saulytė;6268191102;Ne;7;0;0;7
17945;"Vilniaus Pranciškaus Skorinos gimnazija";Saulytė;9902282505;Taip;6;0;0;6
17946;"Vilniaus Pranciškaus Skorinos gimnazija";Saulytė;3374669528;Taip;0;0;1;1
17947;"Vilniaus Pranciškaus Skorinos gimnazija";Saulytė;2214122633;Taip;0;1;0;1
17948;"Vilniaus Pranciškaus Skorinos gimnazija";Saulytė;48454225305;Taip;0;0;1;1
17949;"Vilniaus Pranciškaus Skorinos gimnazija";Saulytė;77518622497;Taip;0;3;0;3
17950;"Vilniaus Pranciškaus Skorinos gimnazija";Saulytė;69884900143;Taip;0;0;7;7
17951;"Vilniaus Pranciškaus Skorinos gimnazija";Saulytė;10188975432;Taip;0;0;1;1
17952;"Vilniaus Pranciškaus Skorinos gimnazija";Saulytė;1326855282;Taip;0;1;2;3
17953;"Vilniaus Pranciškaus Skorinos gimnazija";Saulytė;8996622650;Ne;4;0;0;4
17954;"Vilniaus Pranciškaus Skorinos gimnazija";Saulytė;1098174103;Taip;8;2;0;10
17955;"Vilniaus Pranciškaus Skorinos gimnazija";Saulytė;2034261990;Taip;0;0;4;4
17956;"Vilniaus Pranciškaus Skorinos gimnazija";Saulytė;91720422401;Taip;7;0;1;8
17957;"Vilniaus Pranciškaus Skorinos gimnazija";Saulytė;1590889839;Taip;10;2;0;12
17958;"Vilniaus Pranciškaus Skorinos gimnazija";Saulytė;8198614500;Taip;0;0;3;3
17959;"Vilniaus Pranciškaus Skorinos gimnazija";Saulytė;8585340012;Ne;3;0;2;5
17960;"Vilniaus Simono Konarskio vidurinės mokykla";"1 gr.";4600958567;Taip;7;0;0;7
17961;"Vilniaus Simono Konarskio vidurinės mokykla";"1 gr.";5738026683;Taip;5;0;0;5
17962;"Vilniaus Simono Konarskio vidurinės mokykla";"1 gr.";24072345175;Taip;2;0;0;2
17963;"Vilniaus Simono Konarskio vidurinės mokykla";"1 gr.";2749669816;Taip;7;0;0;7
17964;"Vilniaus Simono Konarskio vidurinės mokykla";"1 gr.";51558463647;Taip;3;0;0;3
17965;"Vilniaus Simono Konarskio vidurinės mokykla";"1 gr.";30126718224;Taip;10;0;0;10
17966;"Vilniaus Trakų Vokės gimnazija";Priešmokyklinė;84749146259;Taip;0;6;0;6
17967;"Vilniaus Trakų Vokės gimnazija";Priešmokyklinė;37080835526;Taip;0;6;0;6
17968;"Vilniaus Trakų Vokės gimnazija";Priešmokyklinė;92262591306;Taip;0;6;1;7
17969;"Vilniaus Trakų Vokės gimnazija";Priešmokyklinė;49616069190;Taip;5;6;0;11
17970;"Vilniaus Trakų Vokės gimnazija";Priešmokyklinė;76399539244;Taip;0;6;1;7
17971;"Vilniaus Trakų Vokės gimnazija";Priešmokyklinė;96632696431;Taip;0;6;1;7
17972;"Vilniaus Trakų Vokės gimnazija";Priešmokyklinė;9642375918;Taip;0;6;2;8
17973;"Vilniaus Trakų Vokės gimnazija";Priešmokyklinė;1809637955;Taip;0;6;2;8
17974;"Vilniaus Trakų Vokės gimnazija";Priešmokyklinė;43780546254;Taip;0;6;1;7
17975;"Vilniaus Trakų Vokės gimnazija";Priešmokyklinė;1858168427;Taip;0;6;0;6
17976;"Vilniaus Trakų Vokės gimnazija";Priešmokyklinė;39658854196;Taip;0;6;0;6
17977;"Vilniaus Trakų Vokės gimnazija";Priešmokyklinė;32336388708;Taip;10;6;0;16
17978;"Vilniaus Trakų Vokės gimnazija";Priešmokyklinė;1994808263;Taip;0;6;0;6
17979;"Vilniaus Trakų Vokės gimnazija";Priešmokyklinė;1805549433;Taip;0;6;3;9
17980;"Vilniaus Trakų Vokės gimnazija";Priešmokyklinė;68968521202;Taip;0;6;1;7
17981;"Vilniaus Trakų Vokės gimnazija";Priešmokyklinė;1837766168;Taip;5;6;1;12
17982;"Vilniaus Trakų Vokės gimnazija";Priešmokyklinė;38738283929;Ne;3;6;0;9
17983;"Vilniaus Trakų Vokės gimnazija";Priešmokyklinė;71993634591;Taip;5;6;1;12
17984;"Vilniaus Trakų Vokės gimnazija";Priešmokyklinė;66607811394;Taip;0;6;0;6
17985;"Vilniaus Trakų Vokės gimnazija";Priešmokyklinė;2052523633;Taip;0;6;0;6
17986;"Vilniaus Trakų Vokės gimnazija";Priešmokyklinė;95403241312;Taip;0;6;0;6
17987;"Vilniaus Trakų Vokės gimnazija";"Priešmokyklinė 2";28609993291;Taip;5;7;0;12
17988;"Vilniaus Trakų Vokės gimnazija";"Priešmokyklinė 2";2742109510;Taip;0;13;0;13
17989;"Vilniaus Trakų Vokės gimnazija";"Priešmokyklinė 2";4137954109;Taip;0;7;2;9
17990;"Vilniaus Trakų Vokės gimnazija";"Priešmokyklinė 2";41050699676;Taip;0;7;0;7
17991;"Vilniaus Trakų Vokės gimnazija";"Priešmokyklinė 2";76000339425;Ne;0;7;0;7
17992;"Vilniaus Trakų Vokės gimnazija";"Priešmokyklinė 2";4025564140;Ne;0;7;5;12
17993;"Vilniaus Trakų Vokės gimnazija";"Priešmokyklinė 2";42898142937;Ne;0;7;0;7
17994;"Vilniaus Trakų Vokės gimnazija";"Priešmokyklinė 2";7405750799;Ne;0;17;0;17
17995;"Vilniaus Trakų Vokės gimnazija";"Priešmokyklinė 2";9212173480;Taip;15;7;0;22
17996;"Vilniaus Trakų Vokės gimnazija";"Priešmokyklinė 2";29983824202;Taip;0;7;0;7
17997;"Vilniaus Trakų Vokės gimnazija";"Priešmokyklinė 2";39185053006;Taip;6;7;1;14
17998;"Vilniaus Trakų Vokės gimnazija";"Priešmokyklinė 2";6075862061;Taip;0;10;0;10
17999;"Vilniaus Trakų Vokės gimnazija";"Priešmokyklinė 2";1100961040;Taip;0;7;0;7
18000;"Vilniaus Trakų Vokės gimnazija";"Priešmokyklinė 2";1246702054;Taip;0;7;0;7
18001;"Vilniaus Trakų Vokės gimnazija";"Priešmokyklinė 2";1604147234;Taip;0;7;9;16
18002;"Vilniaus Trakų Vokės gimnazija";"Priešmokyklinė 2";2671842885;Taip;0;6;0;6
18003;"Vilniaus Ryto progimnazija";Pelėdžiukai;8927710614;Taip;0;0;2;2
18004;"Vilniaus Ryto progimnazija";Pelėdžiukai;83599369692;Taip;0;1;0;1
18005;"Vilniaus Ryto progimnazija";Pelėdžiukai;1498045991;Taip;5;0;0;5
18006;"Vilniaus Ryto progimnazija";Pelėdžiukai;5003717844;Taip;15;0;0;15
18007;"Vilniaus Ryto progimnazija";Pelėdžiukai;2033804954;Taip;0;2;0;2
18008;"Vilniaus Ryto progimnazija";Pelėdžiukai;4459592042;Taip;8;0;0;8
18009;"Vilniaus Ryto progimnazija";Pelėdžiukai;4334517915;Taip;0;1;0;1
18010;"Vilniaus Ryto progimnazija";Vyturiukai;70950123240;Taip;5;0;0;5
18011;"Vilniaus Ryto progimnazija";Vyturiukai;98670272543;Taip;0;4;0;4
18012;"Vilniaus Ryto progimnazija";Vyturiukai;58253869146;Taip;0;5;0;5
18013;"Vilniaus Ryto progimnazija";Vyturiukai;1480772531;Taip;0;1;0;1
18014;"Vilniaus Ryto progimnazija";Vyturiukai;35463696785;Taip;2;0;0;2
18015;"Vilniaus Ryto progimnazija";Vyturiukai;9651077239;Taip;0;0;1;1
18016;"Vilniaus Ryto progimnazija";Vyturiukai;11940207202;Taip;7;0;0;7
18017;"Vilniaus Ryto progimnazija";Vyturiukai;8782782031;Taip;0;2;0;2
18018;"Vilniaus Ryto progimnazija";Vyturiukai;5157022077;Taip;0;5;0;5
18019;"Vilniaus Ryto progimnazija";Vyturiukai;24547508796;Ne;0;4;0;4
18020;"Vilniaus Ryto progimnazija";Vyturiukai;24021665703;Taip;13;2;0;15
18021;"Vilniaus Ryto progimnazija";Vyturiukai;7602825079;Taip;12;2;0;14
18022;"Vilniaus Salininkų gimnazija";"Priešmokyklinė A";8897523583;Taip;0;5;0;5
18023;"Vilniaus Salininkų gimnazija";"Priešmokyklinė A";1507178637;Taip;0;5;0;5
18024;"Vilniaus Salininkų gimnazija";"Priešmokyklinė A";81713688097;Taip;0;2;0;2
18025;"Vilniaus Salininkų gimnazija";"Priešmokyklinė A";77477857775;Taip;4;0;0;4
18026;"Vilniaus Salininkų gimnazija";"Priešmokyklinė A";93466518815;Taip;0;6;0;6
18027;"Vilniaus Salininkų gimnazija";"Priešmokyklinė A";86262807558;Taip;0;0;1;1
18028;"Vilniaus Salininkų gimnazija";"Priešmokyklinė A";8726140660;Ne;0;0;1;1
18029;"Vilniaus Salininkų gimnazija";"Priešmokyklinė A";1614501473;Taip;0;7;0;7
18030;"Vilniaus Salininkų gimnazija";"Priešmokyklinė A";1489067126;Taip;0;1;0;1
18031;"Vilniaus Salininkų gimnazija";"Priešmokyklinė A";75056599725;Taip;0;1;0;1
18032;"Vilniaus Salininkų gimnazija";"Priešmokyklinė A";3263103387;Ne;9;0;0;9
18033;"Vilniaus Salininkų gimnazija";"PRIEŠMOKYKLINĖ B";54352547774;Taip;21;0;0;21
18034;"Vilniaus Salininkų gimnazija";"PRIEŠMOKYKLINĖ B";87653480003;Taip;1;0;0;1
18035;"Vilniaus Salininkų gimnazija";"PRIEŠMOKYKLINĖ B";2035304515;Ne;0;21;0;21
18036;"Vilniaus Salininkų gimnazija";"PRIEŠMOKYKLINĖ B";1632485114;Taip;0;21;0;21
18037;"Vilniaus Salininkų gimnazija";"PRIEŠMOKYKLINĖ B";5483806059;Taip;0;21;0;21
18038;"Vilniaus Salininkų gimnazija";"PRIEŠMOKYKLINĖ B";61252066272;Ne;0;22;0;22
18039;"Vilniaus Salininkų gimnazija";"PRIEŠMOKYKLINĖ B";9441176013;Taip;0;22;0;22
18040;"Vilniaus Salininkų gimnazija";"PRIEŠMOKYKLINĖ B";16879258172;Taip;0;22;0;22
18041;"Vilniaus Salininkų gimnazija";"PRIEŠMOKYKLINĖ B";2081621978;Taip;0;22;0;22
18042;"Vilniaus Salininkų gimnazija";"PRIEŠMOKYKLINĖ B";56301286871;Taip;0;22;0;22
18043;"Vilniaus Salininkų gimnazija";"PRIEŠMOKYKLINĖ B";8258045565;Taip;6;0;0;6
18044;"Vilniaus Salininkų gimnazija";"PRIEŠMOKYKLINĖ B";10179604964;Taip;11;0;0;11
18045;"Vilniaus Spindulio pagrindinė mokykla";PM3;22293456491;Taip;0;21;0;21
18046;"Vilniaus Spindulio pagrindinė mokykla";PM3;90681333497;Taip;3;0;0;3
18047;"Vilniaus Spindulio pagrindinė mokykla";PM3;43582907178;Taip;4;0;0;4
18048;"Vilniaus Spindulio pagrindinė mokykla";PM3;51686992586;Taip;8;0;0;8
18049;"Vilniaus Spindulio pagrindinė mokykla";PM3;1452723869;Ne;0;22;0;22
18050;"Vilniaus Spindulio pagrindinė mokykla";PM3;1535907893;Ne;0;1;0;1
18051;"Vilniaus Spindulio pagrindinė mokykla";PM3;1876110301;Taip;9;0;0;9
18052;"Vilniaus Spindulio pagrindinė mokykla";PM3;1201971467;Taip;0;15;0;15
18053;"Vilniaus Spindulio pagrindinė mokykla";PM3;65948673886;Taip;5;0;0;5
18054;"Vilniaus Spindulio pagrindinė mokykla";PM3;33466088300;Taip;5;0;0;5
18055;"Vilniaus Spindulio pagrindinė mokykla";PM3;8838175732;Ne;0;3;0;3
18056;"Vilniaus Spindulio pagrindinė mokykla";PM2;30064453011;Ne;0;0;1;1
18057;"Vilniaus Spindulio pagrindinė mokykla";PM2;37530814188;Taip;1;11;1;13
18058;"Vilniaus Spindulio pagrindinė mokykla";PM2;94392092103;Ne;0;1;0;1
18059;"Vilniaus Spindulio pagrindinė mokykla";PM2;8335398345;Taip;5;1;0;6
18060;"Vilniaus Spindulio pagrindinė mokykla";PM2;1119763619;Taip;0;1;0;1
18061;"Vilniaus Spindulio pagrindinė mokykla";PM2;1275460051;Taip;0;1;1;2
18062;"Vilniaus Spindulio pagrindinė mokykla";PM2;51442842468;Taip;0;1;0;1
18063;"Vilniaus Spindulio pagrindinė mokykla";PM2;70985723823;Ne;0;1;0;1
18064;"Vilniaus Spindulio pagrindinė mokykla";PM2;2308733347;Taip;0;1;0;1
18065;"Vilniaus Spindulio pagrindinė mokykla";PM2;89455376961;Taip;0;6;0;6
18066;"Vilniaus Spindulio pagrindinė mokykla";PM2;8096536272;Ne;0;1;0;1
18067;"Vilniaus Spindulio pagrindinė mokykla";PM2;8367775964;Taip;0;1;0;1
18068;"Vilniaus Spindulio pagrindinė mokykla";PM2;1382754985;Taip;0;1;0;1
18069;"Vilniaus Spindulio pagrindinė mokykla";PM2;82176273307;Taip;0;1;0;1
18070;"Vilniaus Spindulio pagrindinė mokykla";PM2;38262299304;Taip;4;1;0;5
18071;"Vilniaus Spindulio pagrindinė mokykla";PM2;4402050671;Taip;0;1;0;1
18072;"Vilniaus Spindulio pagrindinė mokykla";PM2;98839852579;Taip;0;1;0;1
18073;"Vilniaus Spindulio pagrindinė mokykla";PM2;96133788423;Taip;7;1;0;8
18074;"Vilniaus Spindulio pagrindinė mokykla";PM1;47625081475;Taip;10;0;0;10
18075;"Vilniaus Spindulio pagrindinė mokykla";PM1;1435104895;Taip;0;0;3;3
18076;"Vilniaus Spindulio pagrindinė mokykla";PM1;29649846186;Taip;0;0;2;2
18077;"Vilniaus Spindulio pagrindinė mokykla";PM1;1101237825;Taip;5;0;0;5
18078;"Vilniaus Spindulio pagrindinė mokykla";PM1;2960662435;Taip;0;0;2;2
18079;"Vilniaus Spindulio pagrindinė mokykla";PM1;8461648619;Taip;0;19;0;19
18080;"Vilniaus Spindulio pagrindinė mokykla";PM1;42543506690;Ne;5;0;0;5
18081;"Vilniaus Spindulio pagrindinė mokykla";PM1;6460911796;Taip;5;0;0;5
18082;"Vilniaus Vladislavo Sirokomlės vidurinė mokykla";Nykštukai;3757723755;Taip;0;25;0;25
18083;"Vilniaus Vladislavo Sirokomlės vidurinė mokykla";Nykštukai;6973757062;Taip;0;1;0;1
18084;"Vilniaus Vladislavo Sirokomlės vidurinė mokykla";Nykštukai;67365224459;Taip;0;1;2;3
18085;"Vilniaus Vladislavo Sirokomlės vidurinė mokykla";Nykštukai;1182643102;Taip;0;2;0;2
18086;"Vilniaus Vladislavo Sirokomlės vidurinė mokykla";Nykštukai;6027613840;Taip;3;0;0;3
18087;"Vilniaus Vladislavo Sirokomlės vidurinė mokykla";Nykštukai;7921336790;Taip;5;0;0;5
18088;"Vilniaus Vladislavo Sirokomlės vidurinė mokykla";Nykštukai;19918665437;Taip;4;0;0;4
18089;"Vilniaus Vladislavo Sirokomlės vidurinė mokykla";Nykštukai;1755934341;Taip;0;25;0;25
18090;"Vilniaus Vladislavo Sirokomlės vidurinė mokykla";Nykštukai;8471020975;Taip;3;0;3;6
18091;"Vilniaus Vladislavo Sirokomlės vidurinė mokykla";Nykštukai;67716590566;Taip;9;0;0;9
18092;"Vilniaus Vladislavo Sirokomlės vidurinė mokykla";Smurfai;1277422207;Taip;0;4;0;4
18093;"Vilniaus Vladislavo Sirokomlės vidurinė mokykla";Smurfai;1824370122;Taip;0;4;0;4
18094;"Vilniaus Vladislavo Sirokomlės vidurinė mokykla";Smurfai;4727762605;Taip;0;6;0;6
18095;"Vilniaus Vladislavo Sirokomlės vidurinė mokykla";Smurfai;93964052608;Taip;0;1;0;1
18096;"Vilniaus Vladislavo Sirokomlės vidurinė mokykla";Smurfai;1775227032;Taip;0;1;0;1
18097;"Vilniaus Joachimo Lelevelio vidurinė mokykla";0A;2854451964;Taip;0;11;0;11
18098;"Vilniaus Joachimo Lelevelio vidurinė mokykla";0A;6406533101;Taip;0;2;0;2
18099;"Vilniaus Joachimo Lelevelio vidurinė mokykla";0A;3842907348;Taip;0;3;0;3
18100;"Vilniaus Joachimo Lelevelio vidurinė mokykla";0A;28504617099;Taip;0;24;0;24
18101;"Vilniaus Joachimo Lelevelio vidurinė mokykla";0A;8995997848;Taip;2;0;15;17
18102;"Vilniaus Joachimo Lelevelio vidurinė mokykla";0A;4250816034;Taip;0;4;1;5
18103;"Vilniaus Joachimo Lelevelio vidurinė mokykla";0A;1771141306;Taip;0;2;0;2
18104;"Vilniaus Joachimo Lelevelio vidurinė mokykla";0A;7557437205;Taip;3;2;3;8
18105;"Vilniaus Joachimo Lelevelio vidurinė mokykla";0A;1615068173;Taip;0;1;0;1
18106;"Vilniaus Joachimo Lelevelio vidurinė mokykla";0A;2062489205;Taip;0;3;0;3
18107;"Vilniaus Joachimo Lelevelio vidurinė mokykla";0A;18542160352;Taip;0;3;0;3
18108;"Vilniaus Joachimo Lelevelio vidurinė mokykla";0A;1701035826;Ne;6;0;8;14
18109;"Vilniaus Joachimo Lelevelio vidurinė mokykla";0B;1398713963;Taip;5;0;4;9
18110;"Vilniaus Joachimo Lelevelio vidurinė mokykla";0B;7498447014;Ne;0;24;0;24
18111;"Vilniaus Joachimo Lelevelio vidurinė mokykla";0B;12358360731;Taip;6;2;0;8
18112;"Vilniaus Joachimo Lelevelio vidurinė mokykla";0B;1294879767;Taip;0;4;0;4
18113;"Vilniaus Joachimo Lelevelio vidurinė mokykla";0B;13127077816;Taip;0;24;0;24
18114;"Vilniaus Joachimo Lelevelio vidurinė mokykla";0B;97106889191;Taip;0;24;0;24
18115;"Vilniaus Joachimo Lelevelio vidurinė mokykla";0B;1400614987;Taip;0;1;0;1
18116;"Vilniaus Joachimo Lelevelio vidurinė mokykla";0B;5826045578;Ne;3;0;0;3
18117;"Vilniaus Joachimo Lelevelio vidurinė mokykla";0C;77834846979;Taip;0;23;0;23
18118;"Vilniaus Joachimo Lelevelio vidurinė mokykla";0C;7474239709;Taip;0;23;0;23
18119;"Vilniaus Joachimo Lelevelio vidurinė mokykla";0C;4298878720;Ne;0;22;0;22
18120;"Vilniaus Joachimo Lelevelio vidurinė mokykla";0C;2066262598;Ne;0;1;0;1
18121;"Vilniaus Joachimo Lelevelio vidurinė mokykla";0C;6729635545;Taip;2;2;0;4
18122;"Vilniaus Joachimo Lelevelio vidurinė mokykla";0C;47825918748;Taip;0;6;0;6
18123;"Vilniaus Joachimo Lelevelio vidurinė mokykla";0C;74314676598;Taip;1;0;1;2
18124;"Vilniaus Joachimo Lelevelio vidurinė mokykla";0C;1634442815;Taip;1;3;0;4
18125;"Vilniaus Joachimo Lelevelio vidurinė mokykla";0C;8552721960;Taip;0;2;1;3
18126;"Vilniaus Juzefo Ignacijaus Kraševskio gimnazija";Priešmokyklinė;3992602769;Ne;15;0;0;15
18127;"Vilniaus Juzefo Ignacijaus Kraševskio gimnazija";Priešmokyklinė;96528175390;Ne;6;0;0;6
18128;"Vilniaus Juzefo Ignacijaus Kraševskio gimnazija";Priešmokyklinė;7947779677;Taip;0;0;2;2
18129;"Vilniaus Juzefo Ignacijaus Kraševskio gimnazija";Priešmokyklinė;9640287886;Ne;7;0;2;9
18130;"Vilniaus Juzefo Ignacijaus Kraševskio gimnazija";Priešmokyklinė;67676283920;Taip;0;0;1;1
18131;"Vilniaus Juzefo Ignacijaus Kraševskio gimnazija";Priešmokyklinė;85741340293;Taip;0;0;1;1
18132;"Vilniaus Juzefo Ignacijaus Kraševskio gimnazija";Priešmokyklinė;3041637447;Taip;5;0;0;5
18133;"Vilniaus Juzefo Ignacijaus Kraševskio gimnazija";Priešmokyklinė;52109524827;Ne;0;0;1;1
18134;"Vilniaus Juzefo Ignacijaus Kraševskio gimnazija";Priešmokyklinė;1963122314;Taip;5;0;0;5
18135;"Vilniaus Juzefo Ignacijaus Kraševskio gimnazija";Priešmokyklinė;9167719015;Ne;18;0;0;18
18136;"Vilniaus Juzefo Ignacijaus Kraševskio gimnazija";Priešmokyklinė;6560740320;Taip;0;0;2;2
18137;"Vilniaus Juzefo Ignacijaus Kraševskio gimnazija";Priešmokyklinė;6224053661;Taip;8;0;2;10
18138;"Vilniaus Juzefo Ignacijaus Kraševskio gimnazija";Priešmokyklinė;6879140016;Taip;7;0;0;7
18139;"Vilniaus Jono Pauliaus II progimnazija";Nykštukai;62887824954;Taip;3;0;0;3
18140;"Vilniaus Jono Pauliaus II progimnazija";Nykštukai;21391476676;Ne;0;1;0;1
18141;"Vilniaus Jono Pauliaus II progimnazija";Nykštukai;69740475863;Ne;3;0;0;3
18142;"Vilniaus Jono Pauliaus II progimnazija";Nykštukai;9711206546;Taip;3;0;0;3
18143;"Vilniaus Jono Pauliaus II progimnazija";Nykštukai;63900641942;Taip;9;2;0;11
18144;"Vilniaus Jono Pauliaus II progimnazija";Nykštukai;72881976363;Taip;16;2;0;18
18145;"Vilniaus Jono Pauliaus II progimnazija";Nykštukai;1448250372;Taip;8;0;0;8
18146;"Vilniaus Jono Pauliaus II progimnazija";Nykštukai;1974161463;Taip;10;0;0;10
18147;"Vilniaus Jono Pauliaus II progimnazija";Nykštukai;6069988171;Taip;10;0;0;10
18148;"Vilniaus Jono Pauliaus II progimnazija";Nykštukai;69919525470;Taip;0;21;0;21
18149;"Vilniaus Jono Pauliaus II progimnazija";Nykštukai;62372417041;Taip;0;10;0;10
18150;"Vilniaus Jono Pauliaus II progimnazija";Nykštukai;2030227606;Taip;10;0;0;10
18151;"Vilniaus Jono Pauliaus II progimnazija";Nykštukai;1623576857;Taip;1;0;0;1
18152;"Vilniaus Jono Pauliaus II progimnazija";Nykštukai;29087363179;Taip;5;0;0;5
18153;"Vilniaus Jono Pauliaus II progimnazija";Nykštukai;40427909744;Taip;0;2;0;2
18154;"Vilniaus Jono Pauliaus II progimnazija";Nykštukai;86192743256;Taip;0;2;0;2
18155;"Vilniaus Jono Pauliaus II progimnazija";Žiniukai;1911748280;Taip;7;0;0;7
18156;"Vilniaus Jono Pauliaus II progimnazija";Žiniukai;66327590524;Taip;0;3;0;3
18157;"Vilniaus Jono Pauliaus II progimnazija";Žiniukai;71909273139;Taip;3;0;0;3
18158;"Vilniaus Jono Pauliaus II progimnazija";Žiniukai;9949006053;Taip;13;0;1;14
18159;"Vilniaus Jono Pauliaus II progimnazija";Žiniukai;9000145666;Taip;0;21;0;21
18160;"Vilniaus Jono Pauliaus II progimnazija";Žiniukai;8259564583;Taip;4;0;0;4
18161;"Vilniaus Jono Pauliaus II progimnazija";Žiniukai;5323116194;Taip;1;0;0;1
18162;"Vilniaus Jono Pauliaus II progimnazija";Žiniukai;21795184411;Ne;2;2;0;4
18163;"Vilniaus Jono Pauliaus II progimnazija";Žiniukai;66338689682;Taip;0;0;1;1
18164;"Vilniaus Jono Pauliaus II progimnazija";Žiniukai;56656769188;Taip;4;0;0;4
18165;"Vilniaus Jono Pauliaus II progimnazija";Žiniukai;9962282406;Taip;5;0;0;5
18166;"Vilniaus Jono Pauliaus II progimnazija";Žiniukai;1000417905;Taip;11;0;2;13
18167;"Vilniaus Jono Pauliaus II progimnazija";Žiniukai;52202199212;Taip;12;5;0;17
18168;"Vilniaus Jono Pauliaus II progimnazija";Žiniukai;64337451741;Ne;0;0;2;2
18169;"Vilniaus Jono Pauliaus II progimnazija";Spindulėlis;6312963672;Taip;0;24;0;24
18170;"Vilniaus Jono Pauliaus II progimnazija";Spindulėlis;73847154996;Taip;12;0;0;12
18171;"Vilniaus Jono Pauliaus II progimnazija";Spindulėlis;38517844902;Taip;0;0;3;3
18172;"Vilniaus Jono Pauliaus II progimnazija";Spindulėlis;1053502203;Ne;0;24;0;24
18173;"Vilniaus Jono Pauliaus II progimnazija";Spindulėlis;53090437775;Taip;0;0;2;2
18174;"Vilniaus Jono Pauliaus II progimnazija";Spindulėlis;78465993753;Ne;16;0;0;16
18175;"Vilniaus Jono Pauliaus II progimnazija";Spindulėlis;92991242443;Taip;3;0;0;3
18176;"Vilniaus Jono Pauliaus II progimnazija";Spindulėlis;85352317063;Taip;0;2;0;2
18177;"Vilniaus Jono Pauliaus II progimnazija";Spindulėlis;7126070419;Ne;2;6;0;8
18178;"Vilniaus Jono Pauliaus II progimnazija";Spindulėlis;68841073274;Taip;5;5;0;10
18179;"Vilniaus Jono Pauliaus II progimnazija";Spindulėlis;9989277772;Taip;0;0;1;1
18180;"Vilniaus Jono Pauliaus II progimnazija";Spindulėlis;9275686861;Ne;19;0;0;19
18181;"Vilniaus Jono Pauliaus II progimnazija";Spindulėlis;2957745091;Taip;9;0;0;9
18182;"Vilniaus Jono Pauliaus II progimnazija";Spindulėlis;4502784565;Ne;2;2;0;4
18183;"Vilniaus Jono Pauliaus II progimnazija";Spindulėlis;4113350416;Taip;14;0;0;14
18184;"Vilniaus Jono Pauliaus II progimnazija";Spindulėlis;2939189437;Ne;0;0;1;1
18185;"Vilniaus Jono Pauliaus II progimnazija";Spindulėlis;1573790467;Taip;7;0;0;7
18186;"Vilniaus Senamiesčio vidurinė mokykla";PG1;2869694644;Taip;3;0;2;5
18187;"Vilniaus Senamiesčio vidurinė mokykla";PG1;87869418489;Taip;0;0;2;2
18188;"Vilniaus Senamiesčio vidurinė mokykla";PG1;1905141424;Taip;6;0;3;9
18189;"Vilniaus Senamiesčio vidurinė mokykla";PG1;9906690140;Ne;0;21;0;21
18190;"Vilniaus Senamiesčio vidurinė mokykla";PG1;1984531468;Taip;3;4;0;7
18191;"Vilniaus Senamiesčio vidurinė mokykla";PG1;78593862724;Ne;9;0;0;9
18192;"Vilniaus Senamiesčio vidurinė mokykla";PG1;1882022060;Ne;0;0;2;2
18193;"Vilniaus Senamiesčio vidurinė mokykla";PG1;47953806522;Taip;0;10;0;10
18194;"Vilniaus Senamiesčio vidurinė mokykla";PG1;5536467023;Ne;0;0;1;1
18195;"Vilniaus Senamiesčio vidurinė mokykla";PG1;2864419137;Taip;8;3;0;11
18196;"Vilniaus Senamiesčio vidurinė mokykla";PG1;2764636358;Taip;0;0;1;1
18197;"Vilniaus Senamiesčio vidurinė mokykla";PG1;1369622524;Taip;0;21;0;21
18198;"Vilniaus Senamiesčio vidurinė mokykla";PG1;8449484660;Taip;0;0;2;2
18199;"Vilniaus Senamiesčio vidurinė mokykla";PG1;2094485999;Taip;0;0;2;2
18200;"Vilniaus Senamiesčio vidurinė mokykla";PG1;7764171885;Taip;0;0;4;4
18201;Gluosnis;KIŠKUČIAI;4591550636;Taip;0;10;0;10
18202;Gluosnis;KIŠKUČIAI;8689557248;Taip;0;0;2;2
18203;Gluosnis;KIŠKUČIAI;2984134115;Taip;0;0;1;1
18204;Gluosnis;KIŠKUČIAI;6955695422;Taip;1;0;0;1
18205;Gluosnis;KIŠKUČIAI;6140294839;Taip;0;0;7;7
18206;Gluosnis;KIŠKUČIAI;1305651237;Taip;0;0;11;11
18207;Gluosnis;KIŠKUČIAI;1341265560;Taip;0;0;5;5
18208;Gluosnis;KIŠKUČIAI;4285562600;Taip;0;7;0;7
18209;Gluosnis;KIŠKUČIAI;1773343262;Taip;5;0;0;5
18210;Gluosnis;KIŠKUČIAI;5432102004;Taip;5;0;1;6
18211;Gluosnis;KIŠKUČIAI;1712795835;Taip;0;0;4;4
18212;Gluosnis;KIŠKUČIAI;8009719622;Taip;0;0;3;3
18213;Gluosnis;KIŠKUČIAI;6883663577;Taip;0;0;2;2
18214;Gluosnis;KIŠKUČIAI;1512855055;Taip;9;0;1;10
18215;Gluosnis;KIŠKUČIAI;8383489040;Taip;7;0;7;14
18216;Gluosnis;KIŠKUČIAI;4632419177;Taip;0;0;2;2
18217;Gluosnis;EŽIUKAI;6113153127;Taip;10;0;0;10
18218;Gluosnis;EŽIUKAI;4153713911;Taip;0;0;7;7
18219;Gluosnis;EŽIUKAI;6612468095;Taip;2;0;0;2
18220;Gluosnis;EŽIUKAI;3323237449;Taip;6;2;0;8
18221;Gluosnis;EŽIUKAI;7769522093;Taip;5;0;0;5
18222;Gluosnis;EŽIUKAI;4107344313;Taip;0;0;13;13
18223;Gluosnis;EŽIUKAI;9888037899;Taip;0;0;2;2
18224;Gluosnis;EŽIUKAI;3273127718;Taip;0;0;1;1
18225;Gluosnis;EŽIUKAI;6994005000;Taip;3;0;0;3
18226;Gluosnis;EŽIUKAI;1351519995;Taip;8;0;0;8
18227;Gluosnis;MEŠKIUKAI;8981904827;Taip;5;0;3;8
18228;Gluosnis;MEŠKIUKAI;4506243333;Taip;2;0;0;2
18229;Gluosnis;MEŠKIUKAI;1846499141;Taip;0;0;8;8
18230;Gluosnis;MEŠKIUKAI;9102081648;Taip;6;0;1;7
18231;Gluosnis;MEŠKIUKAI;4498429439;Taip;10;0;2;12
18232;Gluosnis;MEŠKIUKAI;8259160584;Taip;1;0;0;1
18233;Gluosnis;MEŠKIUKAI;1235091885;Taip;0;0;5;5
18234;Gluosnis;MEŠKIUKAI;2867319899;Taip;8;0;0;8
18235;Gluosnis;LAPIUKAI;94487630173;Taip;6;0;0;6
18236;Gluosnis;LAPIUKAI;7445566160;Taip;0;0;4;4
18237;Gluosnis;LAPIUKAI;1933496033;Taip;6;0;0;6
18238;Gluosnis;LAPIUKAI;8259035822;Taip;5;3;0;8
18239;Gluosnis;LAPIUKAI;5354082364;Ne;9;0;0;9
18240;Gluosnis;LAPIUKAI;3758930567;Taip;0;1;0;1
18241;Gluosnis;LAPIUKAI;6536698798;Taip;5;0;0;5
18242;Gluosnis;LAPIUKAI;3504197974;Taip;5;0;0;5
18243;Gluosnis;LAPIUKAI;1153781469;Taip;0;0;5;5
18244;Gluosnis;LAPIUKAI;6088139556;Taip;0;1;4;5
18245;Gluosnis;LAPIUKAI;2810808007;Taip;2;0;0;2
18246;Gluosnis;LAPIUKAI;9146356004;Taip;5;0;2;7
18247;Gluosnis;LAPIUKAI;4005023841;Ne;0;1;0;1
18248;Gluosnis;LAPIUKAI;9497547057;Ne;7;0;0;7
18249;Gluosnis;LAPIUKAI;1119389682;Taip;4;0;1;5
18250;Gluosnis;LAPIUKAI;1298724775;Taip;0;0;3;3
18251;Gluosnis;PELĖDŽIUKAI;1739047746;Taip;7;0;0;7
18252;Gluosnis;PELĖDŽIUKAI;4856769984;Taip;0;0;5;5
18253;Gluosnis;PELĖDŽIUKAI;1944291082;Taip;0;0;1;1
18254;Gluosnis;PELĖDŽIUKAI;54773515741;Taip;5;0;0;5
18255;Gluosnis;PELĖDŽIUKAI;75777330223;Taip;0;0;1;1
18256;Gluosnis;PELĖDŽIUKAI;1319664504;Taip;0;0;1;1
18257;Gluosnis;PELĖDŽIUKAI;11053850075;Taip;0;4;0;4
18258;Gluosnis;PELĖDŽIUKAI;8925611940;Taip;0;0;7;7
18259;Gluosnis;PELĖDŽIUKAI;62170308628;Taip;10;0;0;10
18260;Gluosnis;PELĖDŽIUKAI;8014916932;Ne;0;0;1;1
18261;Gluosnis;PELĖDŽIUKAI;48170110340;Taip;0;0;1;1
18262;Gluosnis;PELĖDŽIUKAI;31133574731;Taip;13;0;0;13
18263;Gluosnis;PELĖDŽIUKAI;5853981937;Taip;6;0;0;6
18264;Gluosnis;PELĖDŽIUKAI;8788880196;Taip;5;0;2;7
18265;Gluosnis;PELĖDŽIUKAI;1984089149;Ne;0;0;2;2
18266;Gluosnis;PELĖDŽIUKAI;2562046934;Ne;0;0;2;2
18267;Gluosnis;VOVERIUKAI;8719047997;Taip;0;0;4;4
18268;Gluosnis;VOVERIUKAI;5059528135;Ne;0;0;5;5
18269;Gluosnis;VOVERIUKAI;7075070566;Taip;0;0;1;1
18270;Gluosnis;VOVERIUKAI;1147279898;Taip;0;0;3;3
18271;Gluosnis;VOVERIUKAI;8928237970;Ne;0;0;1;1
18272;Gluosnis;VOVERIUKAI;9786252471;Taip;0;0;5;5
18273;Gluosnis;VOVERIUKAI;6944918504;Taip;5;0;3;8
18274;Gluosnis;VOVERIUKAI;9669118189;Taip;0;0;9;9
18275;Gluosnis;VOVERIUKAI;4757276892;Taip;0;0;2;2
18276;Gluosnis;VOVERIUKAI;6113600571;Taip;0;0;1;1
18277;Gluosnis;VOVERIUKAI;1565251804;Taip;7;0;0;7
18278;Gluosnis;BITUTĖS;4176300773;Taip;10;0;0;10
18279;Gluosnis;BITUTĖS;1848647593;Taip;10;0;0;10
18280;Gluosnis;BITUTĖS;2554790908;Taip;6;0;1;7
18281;Gluosnis;BITUTĖS;8281499182;Taip;7;0;0;7
18282;Gluosnis;BITUTĖS;5186060122;Taip;9;0;0;9
18283;Gluosnis;BITUTĖS;8690911930;Taip;3;0;0;3
18284;Gluosnis;BITUTĖS;2403029153;Taip;5;0;2;7
18285;Gluosnis;BITUTĖS;9542889575;Taip;0;0;1;1
18286;Gluosnis;BITUTĖS;1966484574;Taip;5;0;1;6
18287;Gluosnis;BITUTĖS;1170053777;Ne;3;0;1;4
18288;Gluosnis;BITUTĖS;4353195155;Taip;6;0;0;6
18289;Gluosnis;BITUTĖS;3235523199;Taip;13;0;0;13
18290;Gluosnis;BITUTĖS;8035097045;Taip;8;0;0;8
18291;Gluosnis;BITUTĖS;3362089746;Taip;5;0;0;5
18292;Gluosnis;BITUTĖS;6767500085;Ne;4;0;0;4
18293;Gluosnis;BITUTĖS;4505504276;Taip;10;0;0;10
18294;Gluosnis;BITUTĖS;7390361159;Ne;6;0;0;6
18295;"Vilniaus Ateities mokykla";Priešmokyklinė;4422816945;Taip;0;24;0;24
18296;"Vilniaus Ateities mokykla";Priešmokyklinė;3856518725;Taip;0;24;0;24
18297;"Vilniaus Ateities mokykla";Priešmokyklinė;1119814512;Ne;0;24;0;24
18298;"Vilniaus Ateities mokykla";Priešmokyklinė;7104794885;Taip;0;24;0;24
18299;"Vilniaus Ateities mokykla";Priešmokyklinė;1420929477;Taip;0;25;0;25
18300;"Vilniaus Ateities mokykla";Priešmokyklinė;27840592998;Taip;0;25;0;25
18301;"Vilniaus Ateities mokykla";Priešmokyklinė;40706531692;Taip;0;25;0;25
18302;"Vilniaus Ateities mokykla";Priešmokyklinė;69095956441;Taip;0;25;0;25
18303;"Vilniaus Ateities mokykla";Priešmokyklinė;66162315180;Taip;0;25;0;25
18304;"Vilniaus Ateities mokykla";Priešmokyklinė;41745965224;Taip;0;25;0;25
18305;"Vilniaus Ateities mokykla";Priešmokyklinė;2083974132;Taip;0;25;0;25
18306;"Vilniaus Ateities mokykla";Priešmokyklinė;4339671951;Taip;0;25;0;25
18307;"Vilniaus Ateities mokykla";Priešmokyklinė;8520589200;Taip;0;25;0;25
18308;"Vilniaus Ateities mokykla";Priešmokyklinė;2854877428;Ne;0;25;0;25
18309;"Vilniaus Ateities mokykla";Priešmokyklinė;90324652854;Ne;0;25;0;25
18310;"Vilniaus Ateities mokykla";Priešmokyklinė;1868431609;Taip;0;24;0;24
18311;"Vilniaus Ateities mokykla";Priešmokyklinė;99734698213;Taip;0;24;0;24
18312;"Vilniaus Martyno Mažvydo progimnazija";PRIEŠMOKYKLINĖ;96793345108;Taip;4;0;0;4
18313;"Vilniaus Martyno Mažvydo progimnazija";PRIEŠMOKYKLINĖ;19181545360;Taip;10;3;0;13
18314;"Vilniaus Martyno Mažvydo progimnazija";PRIEŠMOKYKLINĖ;4858524232;Taip;0;23;0;23
18315;"Vilniaus Martyno Mažvydo progimnazija";PRIEŠMOKYKLINĖ;3964251862;Taip;0;0;2;2
18316;"Vilniaus Martyno Mažvydo progimnazija";PRIEŠMOKYKLINĖ;41410871117;Taip;0;4;1;5
18317;"Vilniaus Martyno Mažvydo progimnazija";PRIEŠMOKYKLINĖ;2032732500;Taip;7;2;0;9
18318;"Vilniaus Martyno Mažvydo progimnazija";PRIEŠMOKYKLINĖ;18742574853;Taip;0;1;0;1
18319;"Vilniaus Martyno Mažvydo progimnazija";PRIEŠMOKYKLINĖ;1126288017;Taip;0;0;2;2
18320;"Vilniaus Martyno Mažvydo progimnazija";PRIEŠMOKYKLINĖ;1148912605;Taip;4;3;0;7
18321;"Vilniaus Martyno Mažvydo progimnazija";PRIEŠMOKYKLINĖ;83270172138;Taip;8;0;0;8
18322;"Vilniaus Martyno Mažvydo progimnazija";PRIEŠMOKYKLINĖ;1693121016;Taip;0;3;0;3
18323;"Vilniaus Martyno Mažvydo progimnazija";PRIEŠMOKYKLINĖ;1993355696;Ne;0;0;2;2
18324;"Vilniaus Martyno Mažvydo progimnazija";PRIEŠMOKYKLINĖ;25732368565;Ne;0;23;0;23
18325;"Vilniaus Martyno Mažvydo progimnazija";PRIEŠMOKYKLINĖ;5973303255;Taip;0;0;3;3
18326;"Vilniaus Martyno Mažvydo progimnazija";PRIEŠMOKYKLINĖ;34352165481;Taip;0;1;1;2
18327;"Vilniaus Martyno Mažvydo progimnazija";PRIEŠMOKYKLINĖ;1726899445;Ne;0;0;1;1
18328;"Vilniaus Martyno Mažvydo progimnazija";PRIEŠMOKYKLINĖ;4134546404;Ne;8;0;1;9
18329;"Vilniaus „Genio“ pradinė mokykla";Priešmokyklinė;3158067311;Taip;8;0;0;8
18330;"Vilniaus „Genio“ pradinė mokykla";Priešmokyklinė;4754232120;Ne;2;0;0;2
18331;"Vilniaus „Genio“ pradinė mokykla";Priešmokyklinė;6265455084;Taip;4;0;0;4
18332;"Vilniaus „Genio“ pradinė mokykla";Priešmokyklinė;1924335940;Ne;2;0;0;2
18333;"Vilniaus „Genio“ pradinė mokykla";Priešmokyklinė;2259206809;Taip;6;0;0;6
18334;"Vilniaus „Genio“ pradinė mokykla";Priešmokyklinė;2085116521;Taip;2;0;0;2
18335;"Vilniaus „Genio“ pradinė mokykla";Priešmokyklinė;1877764699;Taip;1;0;0;1
18336;"Vilniaus „Genio“ pradinė mokykla";Priešmokyklinė;2104449007;Ne;8;0;0;8
18337;"Vilniaus „Genio“ pradinė mokykla";Priešmokyklinė;2238619197;Taip;5;0;0;5
18338;"Vilniaus „Genio“ pradinė mokykla";Priešmokyklinė;55275739324;Ne;3;0;1;4
18339;"Vilniaus „Genio“ pradinė mokykla";Priešmokyklinė;1203715568;Taip;3;0;0;3
18340;"Vilniaus „Genio“ pradinė mokykla";Priešmokyklinė;8585966469;Ne;3;0;0;3
18341;"Vilniaus „Genio“ pradinė mokykla";Priešmokyklinė;47677246360;Taip;5;0;0;5
18342;"Vilniaus „Genio“ pradinė mokykla";Priešmokyklinė;4550479746;Taip;11;0;0;11
