Nr.;"Darželio pavadinimas";"Grupės pavadinimas";"Vaiko Identifikacinis Nr.";"Deklaruotas mieste";"Pateisintos dėl ligos";"Pateisintos dėl kitų priežasčių";"Nepateisintos dienos";"Praleistos dienos Viso"
1;Aitvaras;"VIJURKAI (ALERG.)";1795308718;Taip;0;1;0;1
2;Aitvaras;"VIJURKAI (ALERG.)";9649742132;Taip;0;2;0;2
3;Aitvaras;"VIJURKAI (ALERG.)";84922258988;Taip;0;10;0;10
4;Aitvaras;"VIJURKAI (ALERG.)";1201862001;Ne;17;0;0;17
5;Aitvaras;"VIJURKAI (ALERG.)";8970519668;Ne;0;10;0;10
6;Aitvaras;"VIJURKAI (ALERG.)";1600657305;Taip;0;5;0;5
7;Aitvaras;"VIJURKAI (ALERG.)";1621302802;Taip;0;6;0;6
8;Aitvaras;"VIJURKAI (ALERG.)";94080483856;Taip;0;1;2;3
9;Aitvaras;"VIJURKAI (ALERG.)";5083382326;Taip;0;1;0;1
10;Aitvaras;"VIJURKAI (ALERG.)";1773366241;Taip;1;0;0;1
11;Aitvaras;"VIJURKAI (ALERG.)";1553462849;Taip;3;7;0;10
12;Aitvaras;"VIJURKAI (ALERG.)";1398792964;Ne;0;6;0;6
13;Aitvaras;"VIJURKAI (ALERG.)";2159901439;Taip;0;9;0;9
14;Aitvaras;"VIJURKAI (ALERG.)";8366627546;Taip;0;3;0;3
15;Aitvaras;"VIJURKAI (ALERG.)";1481849611;Taip;0;0;2;2
16;Aitvaras;"VIJURKAI (ALERG.)";1090979323;Taip;2;0;3;5
17;Aitvaras;"SMALSUČIAI (ALERG.)";85826303673;Ne;0;2;0;2
18;Aitvaras;"SMALSUČIAI (ALERG.)";7592535089;Taip;0;2;0;2
19;Aitvaras;"SMALSUČIAI (ALERG.)";9845539641;Ne;7;4;0;11
20;Aitvaras;"SMALSUČIAI (ALERG.)";44139920757;Ne;4;1;0;5
21;Aitvaras;"SMALSUČIAI (ALERG.)";4708741626;Taip;0;2;0;2
22;Aitvaras;"SMALSUČIAI (ALERG.)";1301667420;Ne;0;7;0;7
23;Aitvaras;"SMALSUČIAI (ALERG.)";47686798724;Taip;0;2;5;7
24;Aitvaras;"SMALSUČIAI (ALERG.)";1892295973;Ne;5;5;1;11
25;Aitvaras;"SMALSUČIAI (ALERG.)";89623351867;Taip;0;2;3;5
26;Aitvaras;"SMALSUČIAI (ALERG.)";5204534227;Taip;0;2;3;5
27;Aitvaras;"SMALSUČIAI (ALERG.)";2674192321;Taip;0;2;9;11
28;Aitvaras;"SMALSUČIAI (ALERG.)";37391225613;Taip;6;1;0;7
29;Aitvaras;"SMALSUČIAI (ALERG.)";36359228257;Taip;0;1;0;1
30;Aitvaras;"SMALSUČIAI (ALERG.)";31074942686;Taip;0;6;0;6
31;Aitvaras;"SMALSUČIAI (ALERG.)";13670186807;Taip;4;0;5;9
32;Aitvaras;"SMALSUČIAI (ALERG.)";14251469975;Taip;9;3;1;13
33;Aitvaras;PADAUŽIUKAI;46998364516;Taip;0;1;0;1
34;Aitvaras;PADAUŽIUKAI;54438500410;Taip;0;0;1;1
35;Aitvaras;PADAUŽIUKAI;1476238636;Taip;0;9;2;11
36;Aitvaras;PADAUŽIUKAI;64683090780;Ne;0;6;3;9
37;Aitvaras;PADAUŽIUKAI;87846069433;Taip;0;2;0;2
38;Aitvaras;PADAUŽIUKAI;1850900990;Taip;0;1;2;3
39;Aitvaras;PADAUŽIUKAI;69145890005;Taip;3;1;0;4
40;Aitvaras;PADAUŽIUKAI;89194677727;Taip;0;0;1;1
41;Aitvaras;PADAUŽIUKAI;45833790181;Taip;0;0;1;1
42;Aitvaras;PADAUŽIUKAI;2092431875;Taip;0;4;0;4
43;Aitvaras;PADAUŽIUKAI;12216502128;Taip;0;0;3;3
44;Aitvaras;PADAUŽIUKAI;64205113506;Taip;0;0;1;1
45;Aitvaras;PADAUŽIUKAI;403821197;Taip;0;2;2;4
46;Aitvaras;"AITVARIUKAI (ALERG.)";1542575012;Taip;2;1;0;3
47;Aitvaras;"AITVARIUKAI (ALERG.)";3471031093;Ne;3;3;0;6
48;Aitvaras;"AITVARIUKAI (ALERG.)";9810370596;Taip;5;1;0;6
49;Aitvaras;"AITVARIUKAI (ALERG.)";34735287315;Taip;1;11;0;12
50;Aitvaras;"AITVARIUKAI (ALERG.)";9745864667;Taip;5;5;0;10
51;Aitvaras;"AITVARIUKAI (ALERG.)";5389627560;Taip;0;22;0;22
52;Aitvaras;"AITVARIUKAI (ALERG.)";1636794584;Taip;0;1;0;1
53;Aitvaras;"AITVARIUKAI (ALERG.)";2953536545;Taip;0;1;0;1
54;Aitvaras;"AITVARIUKAI (ALERG.)";3535659630;Taip;0;0;1;1
55;Aitvaras;"AITVARIUKAI (ALERG.)";3488467265;Taip;1;6;1;8
56;Aitvaras;"AITVARIUKAI (ALERG.)";2566375128;Taip;0;1;0;1
57;Aitvaras;"AITVARIUKAI (ALERG.)";6356432078;Taip;18;0;0;18
58;Aitvaras;"AITVARIUKAI (ALERG.)";3639102842;Taip;8;4;0;12
59;Aitvaras;"AITVARIUKAI (ALERG.)";7243387750;Taip;14;0;0;14
60;Aitvaras;"AITVARIUKAI (ALERG.)";6587437949;Taip;0;2;0;2
61;Aitvaras;"AITVARIUKAI (ALERG.)";7461284958;Taip;10;1;0;11
62;Aitvaras;"SAULĖS ZUIKUČIAI  (ALERG.)";837021325;Taip;8;1;0;9
63;Aitvaras;"SAULĖS ZUIKUČIAI  (ALERG.)";1207249857;Taip;1;2;1;4
64;Aitvaras;"SAULĖS ZUIKUČIAI  (ALERG.)";24247118884;Taip;0;1;1;2
65;Aitvaras;"SAULĖS ZUIKUČIAI  (ALERG.)";1516018865;Taip;0;1;0;1
66;Aitvaras;"SAULĖS ZUIKUČIAI  (ALERG.)";1392528718;Taip;3;2;0;5
67;Aitvaras;"SAULĖS ZUIKUČIAI  (ALERG.)";2021772475;Ne;4;1;2;7
68;Aitvaras;"SAULĖS ZUIKUČIAI  (ALERG.)";1872130301;Taip;0;1;8;9
69;Aitvaras;"SAULĖS ZUIKUČIAI  (ALERG.)";3433178644;Ne;0;4;1;5
70;Aitvaras;"SAULĖS ZUIKUČIAI  (ALERG.)";69352006024;Taip;0;4;0;4
71;Aitvaras;"SAULĖS ZUIKUČIAI  (ALERG.)";2083332491;Ne;0;1;0;1
72;Aitvaras;"SAULĖS ZUIKUČIAI  (ALERG.)";61721665912;Taip;0;1;2;3
73;Aitvaras;"SAULĖS ZUIKUČIAI  (ALERG.)";6238828251;Taip;0;2;3;5
74;Aitvaras;"SAULĖS ZUIKUČIAI  (ALERG.)";1877245088;Taip;0;2;0;2
75;Aitvaras;"SAULĖS ZUIKUČIAI  (ALERG.)";5619137905;Taip;5;3;0;8
76;Aitvaras;"ŽEMYNUKAI (ALERG.)";1652681820;Taip;5;1;0;6
77;Aitvaras;"ŽEMYNUKAI (ALERG.)";6166757095;Taip;6;0;3;9
78;Aitvaras;"ŽEMYNUKAI (ALERG.)";5595233402;Taip;2;0;1;3
79;Aitvaras;"ŽEMYNUKAI (ALERG.)";2650483861;Taip;7;0;0;7
80;Aitvaras;"ŽEMYNUKAI (ALERG.)";5922357091;Ne;0;2;3;5
81;Aitvaras;"ŽEMYNUKAI (ALERG.)";4868552034;Taip;0;7;0;7
82;Aitvaras;"ŽEMYNUKAI (ALERG.)";1494094426;Ne;0;6;0;6
83;Aitvaras;"ŽEMYNUKAI (ALERG.)";9562494357;Taip;7;2;1;10
84;Aitvaras;"ŽEMYNUKAI (ALERG.)";6021342178;Taip;2;10;0;12
85;Aitvaras;"ŽEMYNUKAI (ALERG.)";9142513631;Taip;15;2;0;17
86;Aitvaras;"ŽEMYNUKAI (ALERG.)";2737503753;Taip;3;0;0;3
87;Aitvaras;"ŽEMYNUKAI (ALERG.)";4480921300;Taip;4;10;0;14
88;Aitvaras;"ŽEMYNUKAI (ALERG.)";8567255042;Ne;5;6;2;13
89;Aitvaras;"ŽEMYNUKAI (ALERG.)";6218019092;Taip;0;7;0;7
90;Aitvaras;"ŽEMYNUKAI (ALERG.)";7560642918;Taip;0;2;0;2
91;Aitvaras;"ŽEMYNUKAI (ALERG.)";3820930777;Taip;22;0;0;22
92;Aitvaras;"ŽEMYNUKAI (ALERG.)";6624986090;Taip;21;0;0;21
93;Aitvaras;"ŽEMYNUKAI (ALERG.)";4733627644;Taip;8;1;0;9
94;Aitvaras;"ŽEMYNUKAI (ALERG.)";3104109370;Taip;0;0;3;3
95;Aitvaras;"LINKSMUČIAI (ALERG.)";7109001184;Taip;10;0;0;10
96;Aitvaras;"LINKSMUČIAI (ALERG.)";5378212904;Ne;15;1;0;16
97;Aitvaras;"LINKSMUČIAI (ALERG.)";3655710511;Taip;6;0;0;6
98;Aitvaras;"LINKSMUČIAI (ALERG.)";1091372798;Taip;0;2;2;4
99;Aitvaras;"LINKSMUČIAI (ALERG.)";8666824607;Taip;8;2;0;10
100;Aitvaras;"LINKSMUČIAI (ALERG.)";5612991255;Taip;0;1;0;1
101;Aitvaras;"LINKSMUČIAI (ALERG.)";5330618557;Ne;11;0;0;11
102;Aitvaras;"LINKSMUČIAI (ALERG.)";8178703988;Taip;17;0;1;18
103;Aitvaras;"LINKSMUČIAI (ALERG.)";7260577885;Taip;8;0;0;8
104;Aitvaras;"LINKSMUČIAI (ALERG.)";1599183050;Taip;3;0;0;3
105;Aitvaras;"LINKSMUČIAI (ALERG.)";1115202169;Ne;5;2;0;7
106;Aitvaras;"LINKSMUČIAI (ALERG.)";7029464687;Taip;6;0;0;6
107;Aitvaras;"LINKSMUČIAI (ALERG.)";4613894944;Taip;11;0;2;13
108;Aitvaras;"LINKSMUČIAI (ALERG.)";2760970218;Taip;14;1;0;15
109;Aitvaras;"LINKSMUČIAI (ALERG.)";4120515569;Taip;18;0;0;18
110;Aitvaras;"LINKSMUČIAI (ALERG.)";9885781306;Taip;8;1;0;9
111;Aitvaras;"LINKSMUČIAI (ALERG.)";4564723798;Taip;11;0;0;11
112;Aitvaras;"LINKSMUČIAI (ALERG.)";4612994715;Taip;15;0;3;18
113;Aitvaras;NAMINUKAI;1493048970;Ne;6;1;2;9
114;Aitvaras;NAMINUKAI;1306408890;Taip;0;4;0;4
115;Aitvaras;NAMINUKAI;59572108690;Taip;4;8;1;13
116;Aitvaras;NAMINUKAI;74628671065;Taip;0;1;1;2
117;Aitvaras;NAMINUKAI;70367340825;Taip;0;0;4;4
118;Aitvaras;NAMINUKAI;62126044317;Taip;0;8;0;8
119;Aitvaras;NAMINUKAI;1790437467;Taip;0;3;0;3
120;Aitvaras;NAMINUKAI;46021715174;Taip;0;0;4;4
121;Aitvaras;NAMINUKAI;85560586048;Taip;0;0;1;1
122;Aitvaras;NAMINUKAI;26906648835;Taip;0;5;0;5
123;Aitvaras;NAMINUKAI;1681260995;Taip;0;0;4;4
124;Aitvaras;NAMINUKAI;42556460388;Taip;0;0;1;1
125;Aitvaras;NAMINUKAI;54496602809;Ne;0;0;1;1
126;Aitvaras;NAMINUKAI;1487264184;Ne;5;0;0;5
127;Aitvaras;NAMINUKAI;97382092851;Taip;0;12;0;12
128;Aitvaras;NAMINUKAI;1886917840;Taip;0;6;0;6
129;Aitvaras;NAMINUKAI;6647800967;Ne;7;0;0;7
130;Aitvaras;NAMINUKAI;52679806772;Taip;11;0;0;11
131;Aitvaras;NAMINUKAI;5103057090;Taip;6;0;0;6
132;Aitvaras;NAMINUKAI;3836513736;Taip;9;0;0;9
133;Aitvaras;ŠELMIAI;9332771711;Ne;6;1;0;7
134;Aitvaras;ŠELMIAI;6550426644;Taip;8;7;0;15
135;Aitvaras;ŠELMIAI;5818794912;Taip;5;2;0;7
136;Aitvaras;ŠELMIAI;58780461337;Taip;9;0;0;9
137;Aitvaras;ŠELMIAI;1116271183;Taip;11;2;0;13
138;Aitvaras;ŠELMIAI;44046627149;Taip;9;0;0;9
139;Aitvaras;ŠELMIAI;43711349817;Taip;7;0;0;7
140;Aitvaras;ŠELMIAI;2408952971;Taip;10;1;0;11
141;Aitvaras;ŠELMIAI;2330782717;Taip;6;0;0;6
142;Aitvaras;ŠELMIAI;47875842134;Taip;11;0;0;11
143;Aitvaras;ŠELMIAI;40799643122;Taip;5;2;1;8
144;Aitvaras;ŠELMIAI;2601983670;Taip;0;2;0;2
145;Aitvaras;ŠELMIAI;1387254053;Taip;0;1;0;1
146;Aitvaras;ŠELMIAI;8503279655;Taip;0;3;0;3
147;Aitvaras;ŠELMIAI;1105354193;Taip;5;0;0;5
148;Aitvaras;ŠELMIAI;2034293999;Ne;22;0;0;22
149;Aitvaras;ŠELMIAI;2804106417;Taip;8;0;0;8
150;Aitvaras;ŠELMIAI;2711888522;Taip;6;2;0;8
151;Aitvaras;ŠELMIAI;1996524718;Taip;3;1;1;5
152;Aitvaras;ŠELMIAI;4110585744;Ne;14;2;0;16
153;Aitvaras;ŠELMIAI;6010324894;Taip;9;1;0;10
154;Aitvaras;KODĖLČIUKAI;6214572150;Taip;17;1;0;18
155;Aitvaras;KODĖLČIUKAI;3323458595;Ne;5;1;0;6
156;Aitvaras;KODĖLČIUKAI;8065540507;Taip;10;3;0;13
157;Aitvaras;KODĖLČIUKAI;1288810999;Taip;0;0;1;1
158;Aitvaras;KODĖLČIUKAI;6501943902;Taip;5;0;0;5
159;Aitvaras;KODĖLČIUKAI;4350590529;Taip;0;0;1;1
160;Aitvaras;KODĖLČIUKAI;7777235021;Ne;0;11;0;11
161;Aitvaras;KODĖLČIUKAI;5641224483;Taip;0;2;2;4
162;Aitvaras;KODĖLČIUKAI;1830134108;Taip;0;12;0;12
163;Aitvaras;KODĖLČIUKAI;8121858940;Taip;12;1;0;13
164;Aitvaras;KODĖLČIUKAI;3178965623;Taip;0;3;0;3
165;Aitvaras;KODĖLČIUKAI;5905456814;Ne;9;2;0;11
166;Aitvaras;KODĖLČIUKAI;1761446849;Taip;2;0;0;2
167;Aitvaras;KODĖLČIUKAI;6739827530;Taip;0;1;0;1
168;Aitvaras;KODĖLČIUKAI;2807595769;Ne;0;10;1;11
169;Aitvaras;KODĖLČIUKAI;1252145346;Taip;0;0;2;2
170;Aitvaras;KODĖLČIUKAI;7455895024;Taip;0;0;1;1
171;Aitvaras;KODĖLČIUKAI;8439586875;Taip;6;0;0;6
172;Aitvaras;PABIRUČIAI;8043062737;Taip;0;1;0;1
173;Aitvaras;PABIRUČIAI;9039303562;Taip;8;2;1;11
174;Aitvaras;PABIRUČIAI;6080549524;Taip;8;2;1;11
175;Aitvaras;PABIRUČIAI;6060880045;Taip;3;0;0;3
176;Aitvaras;PABIRUČIAI;1376605323;Taip;3;0;0;3
177;Aitvaras;PABIRUČIAI;8512502118;Taip;0;1;0;1
178;Aitvaras;PABIRUČIAI;3347213578;Taip;12;2;4;18
179;Aitvaras;PABIRUČIAI;3053557807;Taip;8;2;1;11
180;Aitvaras;PABIRUČIAI;2821221241;Ne;8;0;0;8
181;Aitvaras;PABIRUČIAI;6048701733;Taip;0;2;1;3
182;Aitvaras;PABIRUČIAI;9024245490;Taip;22;0;0;22
183;Aitvaras;PABIRUČIAI;6110226958;Taip;14;0;0;14
184;Aitvaras;PABIRUČIAI;6126913961;Taip;14;0;0;14
185;Aitvaras;PABIRUČIAI;4555281655;Taip;9;2;0;11
186;Aitvaras;"SVAJOKLIAI  (ALERG.)";1606267845;Taip;0;6;0;6
187;Aitvaras;"SVAJOKLIAI  (ALERG.)";2004112424;Taip;6;6;0;12
188;Aitvaras;"SVAJOKLIAI  (ALERG.)";6084096300;Taip;0;1;0;1
189;Aitvaras;"SVAJOKLIAI  (ALERG.)";5750154036;Taip;0;1;0;1
190;Aitvaras;"SVAJOKLIAI  (ALERG.)";6201118021;Ne;14;4;0;18
191;Aitvaras;"SVAJOKLIAI  (ALERG.)";3133031845;Ne;0;1;0;1
192;Aitvaras;"SVAJOKLIAI  (ALERG.)";1275561645;Ne;0;7;0;7
193;Aitvaras;"SVAJOKLIAI  (ALERG.)";1879540041;Taip;0;2;0;2
194;Aitvaras;"SVAJOKLIAI  (ALERG.)";1347364985;Taip;9;0;1;10
195;Aitvaras;"SVAJOKLIAI  (ALERG.)";5425259260;Taip;0;10;0;10
196;Aitvaras;"SVAJOKLIAI  (ALERG.)";9228736015;Taip;3;13;0;16
197;Aitvaras;"SVAJOKLIAI  (ALERG.)";9763502346;Taip;18;0;4;22
198;Aitvaras;"SVAJOKLIAI  (ALERG.)";7568388141;Taip;0;2;0;2
199;Aitvaras;"SVAJOKLIAI  (ALERG.)";4204923580;Taip;10;2;0;12
200;Aitvaras;"SVAJOKLIAI  (ALERG.)";1532588441;Ne;0;1;0;1
201;Aitvaras;"SVAJOKLIAI  (ALERG.)";8206046301;Taip;3;0;1;4
202;Aitvaras;"SVAJOKLIAI  (ALERG.)";3005447572;Taip;5;6;0;11
203;Aitvaras;"SVAJOKLIAI  (ALERG.)";1859647003;Taip;10;0;0;10
204;Atžalėlės;Gėlytės;5742471497;Taip;10;0;0;10
205;Atžalėlės;Gėlytės;4284673729;Ne;0;17;4;21
206;Atžalėlės;Gėlytės;8695865604;Ne;0;8;0;8
207;Atžalėlės;Gėlytės;1137741059;Taip;11;0;0;11
208;Atžalėlės;Gėlytės;2385614957;Taip;5;0;0;5
209;Atžalėlės;Gėlytės;5432433423;Taip;0;9;0;9
210;Atžalėlės;Gėlytės;9715625283;Taip;9;0;0;9
211;Atžalėlės;Gėlytės;6024189665;Taip;4;0;0;4
212;Atžalėlės;Gėlytės;4682216852;Ne;0;4;3;7
213;Atžalėlės;Gėlytės;4238773173;Taip;5;0;1;6
214;Atžalėlės;Gėlytės;2131592139;Taip;0;10;0;10
215;Atžalėlės;Gėlytės;3191066669;Taip;2;0;0;2
216;Atžalėlės;Gėlytės;1500456945;Taip;0;0;6;6
217;Atžalėlės;Gėlytės;6177038838;Taip;4;1;0;5
218;Atžalėlės;Gėlytės;1722233272;Taip;6;12;0;18
219;Atžalėlės;Gėlytės;5310990513;Taip;3;0;1;4
220;Atžalėlės;Gėlytės;7702502252;Taip;9;7;0;16
221;Atžalėlės;Gėlytės;9189223222;Taip;0;10;0;10
222;Atžalėlės;Gėlytės;3283415814;Taip;11;0;0;11
223;Atžalėlės;Gėlytės;1146492807;Taip;5;0;2;7
224;Atžalėlės;Gėlytės;3870758086;Taip;4;0;0;4
225;Atžalėlės;Gėlytės;6202250600;Taip;11;5;0;16
226;Atžalėlės;Drugeliai;4643154006;Taip;1;1;0;2
227;Atžalėlės;Drugeliai;6903666624;Taip;2;1;0;3
228;Atžalėlės;Drugeliai;4902947406;Taip;0;9;0;9
229;Atžalėlės;Drugeliai;6570245757;Taip;13;0;8;21
230;Atžalėlės;Drugeliai;6132569107;Taip;6;0;1;7
231;Atžalėlės;Drugeliai;6782007470;Taip;0;4;0;4
232;Atžalėlės;Drugeliai;8393217418;Taip;0;12;0;12
233;Atžalėlės;Drugeliai;1805496887;Taip;3;0;3;6
234;Atžalėlės;Drugeliai;5417971068;Taip;3;0;1;4
235;Atžalėlės;Drugeliai;7953922166;Taip;0;3;0;3
236;Atžalėlės;Drugeliai;5147078840;Taip;0;5;0;5
237;Atžalėlės;Drugeliai;9222670655;Taip;0;4;0;4
238;Atžalėlės;Drugeliai;77261118958;Taip;3;1;2;6
239;Atžalėlės;Drugeliai;1429493246;Taip;0;6;0;6
240;Atžalėlės;Drugeliai;6114426973;Taip;5;9;0;14
241;Atžalėlės;Drugeliai;1456979448;Taip;0;5;0;5
242;Atžalėlės;Drugeliai;4032519781;Taip;9;7;0;16
243;Atžalėlės;Gandriukai;28910361902;Ne;9;1;0;10
244;Atžalėlės;Gandriukai;32154742975;Taip;0;0;1;1
245;Atžalėlės;Gandriukai;93452036571;Taip;0;3;0;3
246;Atžalėlės;Gandriukai;4483002806;Ne;0;0;3;3
247;Atžalėlės;Gandriukai;16442821393;Taip;0;2;0;2
248;Atžalėlės;Gandriukai;1197205716;Taip;5;0;0;5
249;Atžalėlės;Gandriukai;70694002130;Taip;0;0;2;2
250;Atžalėlės;Gandriukai;87334806437;Taip;5;0;0;5
251;Atžalėlės;Gandriukai;1204800605;Taip;0;3;0;3
252;Atžalėlės;Gandriukai;1074259644;Taip;0;6;0;6
253;Atžalėlės;Gandriukai;66107666615;Taip;4;0;1;5
254;Atžalėlės;Gandriukai;63867153552;Taip;1;1;1;3
255;Atžalėlės;Gandriukai;87567915519;Taip;5;3;0;8
256;Atžalėlės;Gandriukai;82049064201;Taip;4;8;0;12
257;Atžalėlės;Gandriukai;1011601294;Taip;6;9;0;15
258;Atžalėlės;Gandriukai;1299048195;Taip;0;6;1;7
259;Atžalėlės;Gandriukai;54869610865;Taip;0;0;2;2
260;Atžalėlės;Gandriukai;80500800894;Taip;8;0;2;10
261;Atžalėlės;Gandriukai;519493490;Ne;0;5;0;5
262;Atžalėlės;Gandriukai;82777644548;Taip;0;0;10;10
263;Atžalėlės;Gandriukai;78664848612;Taip;0;1;0;1
264;Atžalėlės;Voveriukai;52803011399;Taip;5;0;1;6
265;Atžalėlės;Voveriukai;30370285022;Taip;4;1;0;5
266;Atžalėlės;Voveriukai;1447259034;Taip;2;2;1;5
267;Atžalėlės;Voveriukai;64596277701;Taip;9;0;9;18
268;Atžalėlės;Voveriukai;3379307367;Taip;5;0;0;5
269;Atžalėlės;Voveriukai;62325712598;Taip;6;0;0;6
270;Atžalėlės;Voveriukai;1312772153;Taip;2;0;0;2
271;Atžalėlės;Voveriukai;1865339755;Taip;0;10;2;12
272;Atžalėlės;Voveriukai;8138683218;Taip;0;3;0;3
273;Atžalėlės;Voveriukai;4467364336;Taip;4;0;3;7
274;Atžalėlės;Voveriukai;1316154666;Taip;0;1;1;2
275;Atžalėlės;Voveriukai;9699811980;Taip;0;5;0;5
276;Atžalėlės;Voveriukai;8847754477;Taip;10;0;5;15
277;Atžalėlės;Voveriukai;7689394485;Taip;14;0;6;20
278;Atžalėlės;Voveriukai;2013707106;Taip;0;7;0;7
279;Atžalėlės;Voveriukai;2757744826;Ne;0;2;0;2
280;Atžalėlės;Voveriukai;3795729265;Taip;5;0;1;6
281;Atžalėlės;Voveriukai;8201582382;Taip;0;0;2;2
282;Atžalėlės;Voveriukai;4362058013;Taip;0;0;5;5
283;Atžalėlės;Voveriukai;8819893830;Ne;0;0;5;5
284;Atžalėlės;Žirniukai;4098210138;Ne;8;0;0;8
285;Atžalėlės;Žirniukai;7807313362;Taip;7;0;0;7
286;Atžalėlės;Žirniukai;4081717007;Taip;2;0;0;2
287;Atžalėlės;Žirniukai;9977104915;Taip;3;2;0;5
288;Atžalėlės;Žirniukai;6265777690;Taip;0;8;0;8
289;Atžalėlės;Žirniukai;7321516783;Taip;3;2;0;5
290;Atžalėlės;Žirniukai;9628476764;Taip;6;2;0;8
291;Atžalėlės;Žirniukai;8768704484;Taip;0;0;8;8
292;Atžalėlės;Žirniukai;6675588261;Taip;0;0;8;8
293;Atžalėlės;Žirniukai;1844980319;Ne;3;0;1;4
294;Atžalėlės;Žirniukai;8524244526;Ne;11;0;9;20
295;Atžalėlės;Žirniukai;1704679306;Taip;0;5;1;6
296;Atžalėlės;Žirniukai;6873507667;Taip;4;0;0;4
297;Atžalėlės;Žirniukai;2374624441;Taip;0;3;0;3
298;Atžalėlės;Ežiukai;8586739429;Taip;0;5;0;5
299;Atžalėlės;Ežiukai;1423254771;Taip;5;0;0;5
300;Atžalėlės;Ežiukai;4227804985;Taip;0;4;2;6
301;Atžalėlės;Ežiukai;3281114596;Taip;0;0;7;7
302;Atžalėlės;Ežiukai;1431197358;Taip;0;0;6;6
303;Atžalėlės;Ežiukai;4177753994;Taip;0;0;1;1
304;Atžalėlės;Ežiukai;3982090601;Taip;0;0;1;1
305;Atžalėlės;Ežiukai;9925178685;Taip;2;0;1;3
306;Atžalėlės;Ežiukai;2617568019;Taip;9;0;1;10
307;Atžalėlės;Ežiukai;8512283024;Taip;22;0;0;22
308;Atžalėlės;Ežiukai;9053620501;Taip;0;0;1;1
309;Atžalėlės;Ežiukai;8508450500;Taip;2;8;0;10
310;Atžalėlės;Ežiukai;3743308789;Taip;3;0;1;4
311;Atžalėlės;Ežiukai;2339599448;Ne;11;3;0;14
312;Atžalėlės;Ežiukai;9054589111;Taip;2;4;0;6
313;Atžalėlės;Paukšteliai;77693032830;Ne;0;5;0;5
314;Atžalėlės;Paukšteliai;99097316080;Taip;9;0;0;9
315;Atžalėlės;Paukšteliai;1576891322;Ne;0;0;1;1
316;Atžalėlės;Paukšteliai;18833055728;Taip;5;0;6;11
317;Atžalėlės;Paukšteliai;72360139252;Taip;0;12;0;12
318;Atžalėlės;Paukšteliai;89028851257;Taip;5;3;2;10
319;Atžalėlės;Paukšteliai;54417643140;Taip;0;0;1;1
320;Atžalėlės;Paukšteliai;88525056192;Taip;0;9;0;9
321;Atžalėlės;Paukšteliai;30452835434;Taip;0;1;2;3
322;Atžalėlės;Paukšteliai;1046971571;Taip;0;0;4;4
323;Atžalėlės;Paukšteliai;71490200980;Taip;0;0;2;2
324;Atžalėlės;Paukšteliai;93709702327;Taip;10;0;0;10
325;Atžalėlės;Paukšteliai;90664899396;Taip;4;0;2;6
326;Atžalėlės;Paukšteliai;93762990685;Taip;13;0;1;14
327;Atžalėlės;Paukšteliai;42752976301;Taip;0;0;8;8
328;Atžalėlės;Paukšteliai;27330226432;Taip;0;0;2;2
329;Atžalėlės;Paukšteliai;57459192709;Ne;6;0;0;6
330;Atžalėlės;Paukšteliai;1772202805;Taip;0;0;2;2
331;Atžalėlės;Meškiukai;26878092629;Taip;0;8;0;8
332;Atžalėlės;Meškiukai;53385285795;Ne;4;1;0;5
333;Atžalėlės;Meškiukai;57197465236;Taip;0;0;3;3
334;Atžalėlės;Meškiukai;96954269567;Taip;9;0;0;9
335;Atžalėlės;Meškiukai;91094623082;Taip;5;6;0;11
336;Atžalėlės;Meškiukai;97667536161;Taip;0;6;0;6
337;Atžalėlės;Meškiukai;32165722689;Taip;0;8;1;9
338;Atžalėlės;Meškiukai;59994970570;Taip;0;0;2;2
339;Atžalėlės;Meškiukai;60841336326;Taip;2;0;2;4
340;Atžalėlės;Meškiukai;83433461267;Taip;0;8;0;8
341;Atžalėlės;Meškiukai;78909909613;Ne;0;0;1;1
342;Atžalėlės;Meškiukai;46263888918;Ne;13;1;0;14
343;Atžalėlės;Meškiukai;7315734265;Taip;0;5;0;5
344;Atžalėlės;Meškiukai;30776087985;Taip;5;0;0;5
345;Atžalėlės;Meškiukai;74153703568;Taip;0;0;1;1
346;Atžalėlės;Meškiukai;939302682;Taip;0;5;0;5
347;Atžalėlės;Meškiukai;40388417436;Taip;0;1;0;1
348;Atžalėlės;Meškiukai;45860181171;Taip;5;2;0;7
349;Atžalėlės;Meškiukai;1512766841;Taip;11;0;2;13
350;Atžalėlės;Meškiukai;76280495364;Taip;0;3;0;3
351;Atžalėlės;Meškiukai;1448431632;Taip;5;8;0;13
352;Atžalėlės;Meškiukai;4702130326;Taip;0;3;0;3
353;Aušrelė;PASAKIUKAI;1659335142;Taip;0;3;0;3
354;Aušrelė;PASAKIUKAI;2974714806;Ne;12;1;0;13
355;Aušrelė;PASAKIUKAI;1327431679;Taip;13;0;0;13
356;Aušrelė;PASAKIUKAI;8960462835;Taip;0;22;0;22
357;Aušrelė;PASAKIUKAI;6037757548;Taip;14;3;0;17
358;Aušrelė;PASAKIUKAI;7682402576;Taip;9;0;0;9
359;Aušrelė;PASAKIUKAI;1408751702;Taip;20;1;0;21
360;Aušrelė;PASAKIUKAI;6995749373;Taip;0;11;0;11
361;Aušrelė;PASAKIUKAI;1502146844;Ne;9;1;0;10
362;Aušrelė;PASAKIUKAI;8341539501;Taip;5;1;0;6
363;Aušrelė;PASAKIUKAI;8230362307;Taip;12;2;0;14
364;Aušrelė;PASAKIUKAI;9440600785;Ne;11;2;0;13
365;Aušrelė;PASAKIUKAI;91282753561;Taip;8;0;0;8
366;Aušrelė;PASAKIUKAI;4306578299;Taip;0;22;0;22
367;Aušrelė;PASAKIUKAI;5777214701;Taip;5;3;0;8
368;Aušrelė;PASAKIUKAI;6277405405;Taip;0;8;0;8
369;Aušrelė;PASAKIUKAI;3682523696;Taip;4;9;0;13
370;Aušrelė;PASAKIUKAI;6909708079;Ne;0;4;0;4
371;Aušrelė;BORUŽĖLĖS;6673034329;Ne;0;6;0;6
372;Aušrelė;BORUŽĖLĖS;4957581753;Ne;9;0;0;9
373;Aušrelė;BORUŽĖLĖS;3165692699;Ne;7;0;1;8
374;Aušrelė;BORUŽĖLĖS;1928260563;Taip;7;1;0;8
375;Aušrelė;BORUŽĖLĖS;2626569015;Taip;0;18;2;20
376;Aušrelė;BORUŽĖLĖS;1543314096;Taip;0;0;2;2
377;Aušrelė;BORUŽĖLĖS;6084682084;Taip;0;4;0;4
378;Aušrelė;BORUŽĖLĖS;8243716759;Ne;0;6;1;7
379;Aušrelė;BORUŽĖLĖS;6886505025;Taip;7;9;0;16
380;Aušrelė;BORUŽĖLĖS;3206495858;Taip;11;4;0;15
381;Aušrelė;BORUŽĖLĖS;7861208185;Taip;7;3;1;11
382;Aušrelė;BORUŽĖLĖS;1549962200;Taip;0;2;0;2
383;Aušrelė;BORUŽĖLĖS;4505922394;Taip;11;0;4;15
384;Aušrelė;BORUŽĖLĖS;7190665397;Taip;5;3;2;10
385;Aušrelė;BORUŽĖLĖS;2991828434;Taip;8;0;1;9
386;Aušrelė;SMALSUČIAI;76459345433;Ne;0;2;0;2
387;Aušrelė;SMALSUČIAI;17931731597;Taip;15;0;0;15
388;Aušrelė;SMALSUČIAI;8572216200;Taip;0;5;0;5
389;Aušrelė;SMALSUČIAI;1951435363;Taip;0;2;0;2
390;Aušrelė;SMALSUČIAI;3392276890;Taip;0;1;0;1
391;Aušrelė;SMALSUČIAI;14080739740;Taip;0;5;0;5
392;Aušrelė;SMALSUČIAI;73050137188;Taip;0;6;0;6
393;Aušrelė;SMALSUČIAI;49563719275;Taip;0;1;0;1
394;Aušrelė;SMALSUČIAI;7859894371;Taip;0;14;0;14
395;Aušrelė;SMALSUČIAI;68223308125;Ne;0;0;8;8
396;Aušrelė;SMALSUČIAI;26235102809;Taip;0;2;0;2
397;Aušrelė;SMALSUČIAI;42158121278;Taip;0;4;7;11
398;Aušrelė;SMALSUČIAI;78823564616;Taip;0;17;0;17
399;Aušrelė;SMALSUČIAI;1944021609;Taip;0;2;2;4
400;Aušrelė;SMALSUČIAI;1561253093;Taip;0;1;0;1
401;Aušrelė;SMALSUČIAI;1322089393;Taip;0;6;0;6
402;Aušrelė;SMALSUČIAI;94997479625;Ne;0;3;0;3
403;Aušrelė;KODĖLČIUKAI;12032618723;Taip;11;1;0;12
404;Aušrelė;KODĖLČIUKAI;18676216802;Taip;5;0;0;5
405;Aušrelė;KODĖLČIUKAI;75580617180;Taip;6;4;0;10
406;Aušrelė;KODĖLČIUKAI;24202090947;Ne;0;4;0;4
407;Aušrelė;KODĖLČIUKAI;50864528673;Ne;5;0;0;5
408;Aušrelė;KODĖLČIUKAI;2427329184;Taip;0;0;1;1
409;Aušrelė;KODĖLČIUKAI;24201363476;Taip;0;8;1;9
410;Aušrelė;KODĖLČIUKAI;39887348225;Taip;0;6;0;6
411;Aušrelė;KODĖLČIUKAI;1535153901;Taip;0;1;0;1
412;Aušrelė;KODĖLČIUKAI;63497657826;Taip;0;0;2;2
413;Aušrelė;KODĖLČIUKAI;8837069458;Taip;0;6;0;6
414;Aušrelė;KODĖLČIUKAI;36096756485;Taip;8;1;0;9
415;Aušrelė;KODĖLČIUKAI;1058114795;Taip;0;0;7;7
416;Aušrelė;KODĖLČIUKAI;19415824416;Taip;1;2;1;4
417;Aušrelė;KODĖLČIUKAI;4476948928;Taip;0;1;0;1
418;Aušrelė;KODĖLČIUKAI;44971525276;Taip;0;1;0;1
419;Aušrelė;KODĖLČIUKAI;26185247513;Taip;0;22;0;22
420;Aušrelė;KODĖLČIUKAI;9107952292;Taip;0;7;1;8
421;Aušrelė;KODĖLČIUKAI;58007820848;Taip;0;0;5;5
422;Aušrelė;PELĖDŽIUKAI;34891640909;Taip;0;2;0;2
423;Aušrelė;PELĖDŽIUKAI;5955421544;Ne;4;10;0;14
424;Aušrelė;PELĖDŽIUKAI;1706417053;Taip;10;0;0;10
425;Aušrelė;PELĖDŽIUKAI;31441512644;Taip;9;1;0;10
426;Aušrelė;PELĖDŽIUKAI;2030362509;Ne;0;11;0;11
427;Aušrelė;PELĖDŽIUKAI;1296552763;Taip;11;1;0;12
428;Aušrelė;PELĖDŽIUKAI;1160772086;Taip;11;1;0;12
429;Aušrelė;PELĖDŽIUKAI;1352195876;Taip;1;0;1;2
430;Aušrelė;PELĖDŽIUKAI;1599595256;Taip;5;7;0;12
431;Aušrelė;PELĖDŽIUKAI;1539176090;Taip;0;7;0;7
432;Aušrelė;PELĖDŽIUKAI;1868818387;Taip;3;0;2;5
433;Aušrelė;PELĖDŽIUKAI;2987088389;Ne;0;0;4;4
434;Aušrelė;PELĖDŽIUKAI;1506444915;Taip;0;3;0;3
435;Aušrelė;PELĖDŽIUKAI;5304765447;Taip;5;1;0;6
436;Aušrelė;PELĖDŽIUKAI;85739624682;Taip;12;0;0;12
437;Aušrelė;PELĖDŽIUKAI;6837623034;Taip;0;0;8;8
438;Aušrelė;PELĖDŽIUKAI;3974308431;Ne;4;0;0;4
439;Aušrelė;PELĖDŽIUKAI;1549596452;Taip;0;0;3;3
440;Aušrelė;AITVARIUKAI;49583107808;Taip;6;0;0;6
441;Aušrelė;AITVARIUKAI;2045076279;Taip;0;1;0;1
442;Aušrelė;AITVARIUKAI;1153416324;Taip;0;21;1;22
443;Aušrelė;AITVARIUKAI;1340754039;Ne;0;2;0;2
444;Aušrelė;AITVARIUKAI;42721248496;Taip;0;7;0;7
445;Aušrelė;AITVARIUKAI;79695989966;Taip;0;5;0;5
446;Aušrelė;AITVARIUKAI;1045290039;Taip;0;14;0;14
447;Aušrelė;AITVARIUKAI;51119593813;Taip;0;0;1;1
448;Aušrelė;AITVARIUKAI;5813735533;Taip;0;6;0;6
449;Aušrelė;AITVARIUKAI;18117725053;Taip;0;13;0;13
450;Aušrelė;AITVARIUKAI;27629722512;Taip;0;10;0;10
451;Aušrelė;AITVARIUKAI;1830501248;Ne;0;2;0;2
452;Aušrelė;AITVARIUKAI;65369497777;Taip;0;17;5;22
453;Aušrelė;AITVARIUKAI;1750555187;Taip;0;1;0;1
454;Aušrelė;AITVARIUKAI;8221635058;Taip;0;8;0;8
455;Aušrelė;AITVARIUKAI;1163757003;Taip;0;13;0;13
456;Aušrelė;AITVARIUKAI;1792774415;Taip;3;18;0;21
457;Aušrelė;BITUTĖS;5670986879;Ne;0;3;0;3
458;Aušrelė;BITUTĖS;2096291405;Taip;5;1;0;6
459;Aušrelė;BITUTĖS;6519246290;Taip;0;7;0;7
460;Aušrelė;BITUTĖS;54807413055;Taip;2;4;0;6
461;Aušrelė;BITUTĖS;2085252423;Ne;0;10;0;10
462;Aušrelė;BITUTĖS;4882556718;Ne;7;2;0;9
463;Aušrelė;BITUTĖS;1680740501;Taip;0;1;0;1
464;Aušrelė;BITUTĖS;1666951645;Taip;6;3;0;9
465;Aušrelė;BITUTĖS;1372660806;Taip;9;1;0;10
466;Aušrelė;BITUTĖS;1958425979;Taip;7;0;0;7
467;Aušrelė;BITUTĖS;72441793163;Ne;0;2;0;2
468;Aušrelė;BITUTĖS;6604163285;Ne;5;6;0;11
469;Aušrelė;BITUTĖS;5176016947;Taip;0;0;3;3
470;Aušrelė;BITUTĖS;1306572766;Ne;0;0;18;18
471;Aušrelė;BITUTĖS;3326145998;Taip;0;0;10;10
472;Aušrelė;ŽIRNIUKAI;6761263775;Taip;0;2;1;3
473;Aušrelė;ŽIRNIUKAI;3015028879;Taip;0;5;0;5
474;Aušrelė;ŽIRNIUKAI;8503309819;Taip;3;0;0;3
475;Aušrelė;ŽIRNIUKAI;2827216981;Taip;0;2;0;2
476;Aušrelė;ŽIRNIUKAI;2852596989;Taip;3;19;0;22
477;Aušrelė;ŽIRNIUKAI;7930717076;Taip;15;0;0;15
478;Aušrelė;ŽIRNIUKAI;4942168388;Taip;0;18;4;22
479;Aušrelė;ŽIRNIUKAI;2266390402;Taip;0;13;0;13
480;Aušrelė;ŽIRNIUKAI;2390128933;Taip;0;2;0;2
481;Aušrelė;ŽIRNIUKAI;9443641849;Taip;9;1;0;10
482;Aušrelė;ŽIRNIUKAI;1556010005;Taip;7;0;0;7
483;Aušrelė;ŽIRNIUKAI;7609339123;Taip;9;4;0;13
484;Aušrelė;ŽIRNIUKAI;7070013052;Taip;0;1;0;1
485;Aušrelė;ŽIRNIUKAI;5478028396;Ne;14;5;0;19
486;Aušrelė;ŽIRNIUKAI;5935579452;Taip;5;0;0;5
487;Aušrelė;ŽIRNIUKAI;2863655361;Taip;0;2;0;2
488;Aušrelė;ŽIRNIUKAI;3581155949;Taip;9;0;0;9
489;Aušrelė;ŽIRNIUKAI;2766357229;Ne;17;0;0;17
490;Aušrelė;GRYBUKAI;6911735462;Taip;18;0;0;18
491;Aušrelė;GRYBUKAI;5712867880;Taip;5;0;0;5
492;Aušrelė;GRYBUKAI;6002434911;Taip;0;15;0;15
493;Aušrelė;GRYBUKAI;4288695809;Taip;0;2;0;2
494;Aušrelė;GRYBUKAI;7327544406;Ne;0;2;1;3
495;Aušrelė;GRYBUKAI;5046027475;Ne;0;6;0;6
496;Aušrelė;GRYBUKAI;3320399046;Taip;0;0;3;3
497;Aušrelė;GRYBUKAI;7723159748;Taip;8;1;0;9
498;Aušrelė;GRYBUKAI;7367268748;Taip;10;1;0;11
499;Aušrelė;GRYBUKAI;2030555139;Taip;0;8;0;8
500;Aušrelė;GRYBUKAI;1976613166;Ne;0;1;0;1
501;Aušrelė;GRYBUKAI;8338569001;Taip;0;4;0;4
502;Aušrelė;GRYBUKAI;6186758486;Taip;0;0;1;1
503;Aušrelė;GRYBUKAI;4248808572;Taip;18;4;0;22
504;Aušrelė;GRYBUKAI;3623813061;Taip;0;7;0;7
505;Aušrelė;GRYBUKAI;8693750994;Taip;11;0;0;11
506;Aušrelė;GRYBUKAI;6308519574;Taip;0;5;0;5
507;Aušrelė;DRUGELIAI;8210698019;Taip;0;22;0;22
508;Aušrelė;DRUGELIAI;2545065554;Taip;12;0;0;12
509;Aušrelė;DRUGELIAI;8411336992;Taip;3;2;0;5
510;Aušrelė;DRUGELIAI;2656152037;Taip;0;5;0;5
511;Aušrelė;DRUGELIAI;8917907028;Taip;15;0;0;15
512;Aušrelė;DRUGELIAI;7494298336;Taip;3;5;0;8
513;Aušrelė;DRUGELIAI;4012186237;Taip;7;2;0;9
514;Aušrelė;DRUGELIAI;3738923947;Ne;1;1;1;3
515;Aušrelė;DRUGELIAI;1741716341;Taip;0;22;0;22
516;Aušrelė;DRUGELIAI;3223092149;Taip;0;3;0;3
517;Aušrelė;DRUGELIAI;8580241126;Taip;2;0;4;6
518;Aušrelė;DRUGELIAI;9244715396;Taip;15;0;3;18
519;Aušrelė;DRUGELIAI;4227228548;Taip;5;0;0;5
520;Aušrelė;DRUGELIAI;8996445434;Taip;5;0;0;5
521;Aušrelė;DRUGELIAI;6109859056;Ne;22;0;0;22
522;Aušrelė;DRUGELIAI;8661284187;Taip;0;1;0;1
523;Aušrelė;NYKŠTUKAI;6434548772;Taip;22;0;0;22
524;Aušrelė;NYKŠTUKAI;4595435635;Taip;0;7;0;7
525;Aušrelė;NYKŠTUKAI;1458580523;Taip;19;0;1;20
526;Aušrelė;NYKŠTUKAI;9158248746;Taip;12;5;0;17
527;Aušrelė;NYKŠTUKAI;5708459561;Taip;8;0;0;8
528;Aušrelė;NYKŠTUKAI;5125295651;Taip;0;3;0;3
529;Aušrelė;NYKŠTUKAI;6833654667;Taip;15;1;0;16
530;Aušrelė;NYKŠTUKAI;6601922746;Taip;9;7;0;16
531;Aušrelė;NYKŠTUKAI;8029484123;Taip;11;1;0;12
532;Aušrelė;NYKŠTUKAI;9733877752;Taip;0;2;3;5
533;Aušrelė;NYKŠTUKAI;9608444990;Taip;4;1;0;5
534;Aušrelė;NYKŠTUKAI;1081603034;Taip;0;19;0;19
535;Aušrelė;NYKŠTUKAI;2311552230;Taip;5;6;0;11
536;Aušrelė;NYKŠTUKAI;5602774323;Taip;4;5;0;9
537;Aušrelė;NYKŠTUKAI;1039180129;Taip;3;1;3;7
538;Beržynėlis;SVIRPLIUKAI;29356394553;Taip;9;10;0;19
539;Beržynėlis;SVIRPLIUKAI;45685658789;Taip;3;2;0;5
540;Beržynėlis;SVIRPLIUKAI;7649359221;Taip;0;5;0;5
541;Beržynėlis;SVIRPLIUKAI;74856278886;Taip;10;0;0;10
542;Beržynėlis;SVIRPLIUKAI;1207208151;Taip;13;0;0;13
543;Beržynėlis;SVIRPLIUKAI;1583090840;Taip;0;8;0;8
544;Beržynėlis;SVIRPLIUKAI;7289803632;Taip;0;1;0;1
545;Beržynėlis;SVIRPLIUKAI;1682929565;Taip;5;6;0;11
546;Beržynėlis;SVIRPLIUKAI;1612137286;Taip;0;8;0;8
547;Beržynėlis;SVIRPLIUKAI;71505149611;Taip;3;2;0;5
548;Beržynėlis;SVIRPLIUKAI;5196910604;Taip;0;5;0;5
549;Beržynėlis;SVIRPLIUKAI;7248602510;Ne;0;6;0;6
550;Beržynėlis;SVIRPLIUKAI;3641421009;Taip;16;0;0;16
551;Beržynėlis;SVIRPLIUKAI;9566341884;Taip;6;1;0;7
552;Beržynėlis;SVIRPLIUKAI;3278699117;Taip;0;1;0;1
553;Beržynėlis;SVIRPLIUKAI;1838631438;Taip;9;0;0;9
554;Beržynėlis;SVIRPLIUKAI;1639928056;Ne;6;4;0;10
555;Beržynėlis;SVIRPLIUKAI;1136091326;Taip;13;0;0;13
556;Beržynėlis;SVIRPLIUKAI;1516309509;Taip;3;2;0;5
557;Beržynėlis;SVIRPLIUKAI;6395436937;Ne;0;2;0;2
558;Beržynėlis;PELEDŽIUKAI;9035951859;Taip;4;3;0;7
559;Beržynėlis;PELEDŽIUKAI;46844790286;Taip;0;0;1;1
560;Beržynėlis;PELEDŽIUKAI;27071588761;Taip;0;0;5;5
561;Beržynėlis;PELEDŽIUKAI;6082843533;Taip;0;6;0;6
562;Beržynėlis;PELEDŽIUKAI;23484694902;Ne;0;2;1;3
563;Beržynėlis;PELEDŽIUKAI;6002421623;Ne;0;17;0;17
564;Beržynėlis;PELEDŽIUKAI;59717323779;Ne;0;0;6;6
565;Beržynėlis;PELEDŽIUKAI;73555363332;Taip;4;6;0;10
566;Beržynėlis;PELEDŽIUKAI;69508373227;Taip;11;2;0;13
567;Beržynėlis;PELEDŽIUKAI;80418262829;Taip;0;4;2;6
568;Beržynėlis;PELEDŽIUKAI;48768116923;Taip;6;0;0;6
569;Beržynėlis;PELEDŽIUKAI;48258183822;Taip;0;2;1;3
570;Beržynėlis;PELEDŽIUKAI;19892724367;Taip;4;7;0;11
571;Beržynėlis;PELEDŽIUKAI;9737673167;Taip;0;0;1;1
572;Beržynėlis;PELEDŽIUKAI;13290088644;Taip;0;1;0;1
573;Beržynėlis;PELEDŽIUKAI;75283423384;Taip;13;0;0;13
574;Beržynėlis;ŽIOGELIAI;1893270997;Taip;0;5;0;5
575;Beržynėlis;ŽIOGELIAI;7929997884;Taip;8;3;0;11
576;Beržynėlis;ŽIOGELIAI;5308596559;Taip;16;2;0;18
577;Beržynėlis;ŽIOGELIAI;4035764376;Taip;0;8;0;8
578;Beržynėlis;ŽIOGELIAI;4970999989;Taip;5;3;0;8
579;Beržynėlis;ŽIOGELIAI;1325972861;Taip;11;0;1;12
580;Beržynėlis;ŽIOGELIAI;8297427176;Taip;3;9;0;12
581;Beržynėlis;ŽIOGELIAI;8688852668;Taip;0;4;0;4
582;Beržynėlis;ŽIOGELIAI;9540292311;Taip;0;0;12;12
583;Beržynėlis;ŽIOGELIAI;9088059487;Ne;6;2;0;8
584;Beržynėlis;ŽIOGELIAI;6218165554;Taip;0;0;2;2
585;Beržynėlis;ŽIOGELIAI;5473666098;Taip;0;2;2;4
586;Beržynėlis;ŽIOGELIAI;7589778533;Taip;0;4;0;4
587;Beržynėlis;ŽIOGELIAI;8591800387;Taip;0;5;0;5
588;Beržynėlis;ŽIOGELIAI;6739927917;Taip;0;4;6;10
589;Beržynėlis;ŽIOGELIAI;2971686368;Taip;5;3;0;8
590;Beržynėlis;ŽIOGELIAI;9409317403;Taip;8;4;0;12
591;Beržynėlis;ŽIOGELIAI;6334152631;Taip;3;11;0;14
592;Beržynėlis;ŽIOGELIAI;2740093399;Taip;22;0;0;22
593;Beržynėlis;ŽVIRBLIUKAI;95544821432;Taip;0;2;3;5
594;Beržynėlis;ŽVIRBLIUKAI;1910024785;Taip;0;13;0;13
595;Beržynėlis;ŽVIRBLIUKAI;1367442186;Taip;10;0;0;10
596;Beržynėlis;ŽVIRBLIUKAI;1823144276;Ne;0;2;3;5
597;Beržynėlis;ŽVIRBLIUKAI;1464556813;Taip;0;6;0;6
598;Beržynėlis;ŽVIRBLIUKAI;1945230630;Taip;2;0;0;2
599;Beržynėlis;ŽVIRBLIUKAI;2023412985;Taip;0;0;1;1
600;Beržynėlis;ŽVIRBLIUKAI;1578089280;Taip;0;2;0;2
601;Beržynėlis;ŽVIRBLIUKAI;2067928004;Taip;0;4;0;4
602;Beržynėlis;ŽVIRBLIUKAI;87592204193;Taip;0;2;10;12
603;Beržynėlis;ŽVIRBLIUKAI;62962970458;Taip;0;11;0;11
604;Beržynėlis;ŽVIRBLIUKAI;17743947386;Taip;0;2;2;4
605;Beržynėlis;ŽVIRBLIUKAI;30539063473;Taip;0;2;0;2
606;Beržynėlis;ŽVIRBLIUKAI;1885972165;Taip;0;1;0;1
607;Beržynėlis;ŽVIRBLIUKAI;1391844432;Taip;0;4;13;17
608;Beržynėlis;ŽVIRBLIUKAI;1014895926;Taip;0;4;13;17
609;Beržynėlis;ŽIRNIUKAI;8701990625;Taip;0;1;0;1
610;Beržynėlis;ŽIRNIUKAI;2221708263;Ne;17;2;0;19
611;Beržynėlis;ŽIRNIUKAI;3715070791;Taip;9;0;0;9
612;Beržynėlis;ŽIRNIUKAI;9580286493;Taip;0;5;0;5
613;Beržynėlis;ŽIRNIUKAI;6330033887;Taip;8;0;0;8
614;Beržynėlis;ŽIRNIUKAI;5189335842;Taip;6;2;0;8
615;Beržynėlis;ŽIRNIUKAI;4161974847;Ne;15;1;0;16
616;Beržynėlis;ŽIRNIUKAI;4270889499;Taip;0;9;0;9
617;Beržynėlis;ŽIRNIUKAI;3209966996;Taip;3;0;0;3
618;Beržynėlis;ŽIRNIUKAI;3345231579;Taip;22;0;0;22
619;Beržynėlis;ŽIRNIUKAI;2273629510;Taip;0;3;0;3
620;Beržynėlis;ŽIRNIUKAI;1799326151;Taip;0;3;0;3
621;Beržynėlis;VIŠČIUKAI;7953957525;Taip;0;11;0;11
622;Beržynėlis;VIŠČIUKAI;4466393687;Ne;0;1;0;1
623;Beržynėlis;VIŠČIUKAI;8280378527;Taip;0;7;0;7
624;Beržynėlis;VIŠČIUKAI;6713134631;Taip;1;0;0;1
625;Beržynėlis;VIŠČIUKAI;3334994408;Taip;22;0;0;22
626;Beržynėlis;VIŠČIUKAI;4774769217;Taip;5;1;0;6
627;Beržynėlis;VIŠČIUKAI;8881566865;Taip;2;0;0;2
628;Beržynėlis;VIŠČIUKAI;5194416351;Taip;8;0;0;8
629;Beržynėlis;VIŠČIUKAI;9754455116;Taip;5;0;0;5
630;Beržynėlis;VIŠČIUKAI;6272047137;Taip;5;8;0;13
631;Beržynėlis;VIŠČIUKAI;8233464088;Taip;3;1;0;4
632;Beržynėlis;VIŠČIUKAI;4013099670;Taip;0;4;0;4
633;Beržynėlis;VIŠČIUKAI;2892553878;Taip;0;1;0;1
634;Beržynėlis;VIŠČIUKAI;9777841895;Taip;5;2;0;7
635;Beržynėlis;VIŠČIUKAI;9503352345;Ne;7;9;0;16
636;Bildukas;"Svetliački savaitinė";80327840821;Taip;0;2;0;2
637;Bildukas;"Svetliački savaitinė";1029617146;Taip;0;9;0;9
638;Bildukas;"Svetliački savaitinė";1643122874;Taip;0;8;1;9
639;Bildukas;"Svetliački savaitinė";70033583066;Taip;3;8;0;11
640;Bildukas;"Svetliački savaitinė";75301544496;Taip;2;0;0;2
641;Bildukas;"Svetliački savaitinė";1023163775;Ne;0;20;0;20
642;Bildukas;"Svetliački savaitinė";5026245712;Taip;0;6;0;6
643;Bildukas;"Svetliački savaitinė";13885215871;Taip;0;0;1;1
644;Bildukas;"Svetliački savaitinė";25050688839;Ne;0;10;0;10
645;Bildukas;"Svetliački savaitinė";9535522910;Ne;0;1;0;1
646;Bildukas;"Svetliački savaitinė";1183272346;Ne;0;1;2;3
647;Bildukas;"Svetliački savaitinė";6219872984;Taip;5;0;2;7
648;Bildukas;"Svetliački savaitinė";2091204077;Taip;0;3;0;3
649;Bildukas;"Svetliački savaitinė";4112888719;Taip;0;11;7;18
650;Bildukas;"Svetliački savaitinė";3531285331;Taip;0;1;0;1
651;Bildukas;"Svetliački savaitinė";1409708149;Taip;5;1;1;7
652;Bildukas;"Svetliački savaitinė";1786822865;Ne;0;1;0;1
653;Bildukas;"Svetliački savaitinė";8382899180;Ne;10;3;0;13
654;Bildukas;"Zaičiata savaitinė ( keli alergiški vaikai)";8927489885;Taip;2;0;1;3
655;Bildukas;"Zaičiata savaitinė ( keli alergiški vaikai)";1312165385;Taip;0;0;2;2
656;Bildukas;"Zaičiata savaitinė ( keli alergiški vaikai)";8694887879;Taip;0;5;0;5
657;Bildukas;"Zaičiata savaitinė ( keli alergiški vaikai)";4168864882;Ne;6;2;4;12
658;Bildukas;"Zaičiata savaitinė ( keli alergiški vaikai)";1720671485;Taip;5;0;0;5
659;Bildukas;"Zaičiata savaitinė ( keli alergiški vaikai)";6376189019;Taip;5;1;5;11
660;Bildukas;"Zaičiata savaitinė ( keli alergiški vaikai)";5747277587;Taip;0;1;0;1
661;Bildukas;"Zaičiata savaitinė ( keli alergiški vaikai)";3239566139;Taip;0;6;0;6
662;Bildukas;"Zaičiata savaitinė ( keli alergiški vaikai)";5794471794;Taip;1;0;0;1
663;Bildukas;"Zaičiata savaitinė ( keli alergiški vaikai)";2539486337;Taip;0;12;0;12
664;Bildukas;"Zaičiata savaitinė ( keli alergiški vaikai)";8496678513;Taip;9;0;0;9
665;Bildukas;"Zaičiata savaitinė ( keli alergiški vaikai)";2154916232;Taip;13;0;0;13
666;Bildukas;"Zaičiata savaitinė ( keli alergiški vaikai)";8080989574;Taip;7;1;0;8
667;Bildukas;Gnomiki;4392299046;Taip;0;0;3;3
668;Bildukas;Gnomiki;1486878343;Taip;0;1;0;1
669;Bildukas;Gnomiki;1987773024;Taip;0;11;0;11
670;Bildukas;Gnomiki;8999239172;Taip;0;1;3;4
671;Bildukas;Gnomiki;9156801640;Ne;6;1;4;11
672;Bildukas;Gnomiki;9756326725;Taip;5;0;0;5
673;Bildukas;Gnomiki;8835111916;Taip;0;0;6;6
674;Bildukas;Gnomiki;5724787637;Taip;0;4;0;4
675;Bildukas;Gnomiki;9835391223;Taip;0;13;0;13
676;Bildukas;Gnomiki;2429527586;Taip;0;0;8;8
677;Bildukas;Gnomiki;4116831802;Ne;17;0;0;17
678;Bildukas;Gnomiki;4677564389;Taip;0;11;0;11
679;Bildukas;Gnomiki;1916522637;Taip;9;0;0;9
680;Bildukas;Zvonočki;4866401336;Taip;7;6;0;13
681;Bildukas;Zvonočki;1180357950;Ne;0;6;3;9
682;Bildukas;Zvonočki;99302309410;Taip;0;1;0;1
683;Bildukas;Zvonočki;91777282521;Ne;0;4;0;4
684;Bildukas;Zvonočki;1713133196;Ne;0;1;1;2
685;Bildukas;Zvonočki;1956741726;Taip;2;0;4;6
686;Bildukas;Zvonočki;4404602365;Taip;11;5;0;16
687;Bildukas;Zvonočki;8440936221;Taip;0;0;22;22
688;Bildukas;Zvonočki;4014493868;Taip;12;4;0;16
689;Bildukas;Zvonočki;6388514464;Taip;12;4;0;16
690;Bildukas;Zvonočki;4377803110;Taip;0;10;0;10
691;Bildukas;Zvonočki;7898746258;Taip;0;10;4;14
692;Bildukas;Zvonočki;9569296370;Taip;2;0;17;19
693;Bildukas;Zvonočki;1113168085;Taip;0;0;7;7
694;Bildukas;Zvonočki;1125206576;Taip;0;20;0;20
695;Bildukas;Zvonočki;4623727349;Taip;0;3;4;7
696;Bildukas;Zvonočki;1047459617;Taip;0;9;0;9
697;Bildukas;Zvonočki;5217751936;Taip;16;3;0;19
698;Birutės;SKRUZDELIUKŲ;7526975680;Taip;8;0;0;8
699;Birutės;SKRUZDELIUKŲ;4968068043;Ne;1;0;1;2
700;Birutės;SKRUZDELIUKŲ;1761065941;Taip;18;0;0;18
701;Birutės;SKRUZDELIUKŲ;3728361481;Taip;4;0;0;4
702;Birutės;SKRUZDELIUKŲ;9610268046;Taip;7;0;1;8
703;Birutės;SKRUZDELIUKŲ;4027700332;Taip;9;1;0;10
704;Birutės;SKRUZDELIUKŲ;7685356079;Ne;7;0;0;7
705;Birutės;SKRUZDELIUKŲ;4375683234;Taip;0;0;1;1
706;Birutės;SKRUZDELIUKŲ;1105133326;Taip;17;0;4;21
707;Birutės;SKRUZDELIUKŲ;8413760872;Taip;11;0;0;11
708;Birutės;SKRUZDELIUKŲ;8636113039;Taip;0;4;0;4
709;Birutės;SKRUZDELIUKŲ;9411016611;Taip;13;0;0;13
710;Birutės;SKRUZDELIUKŲ;7119951690;Taip;5;5;1;11
711;Birutės;SKRUZDELIUKŲ;1945532852;Taip;4;0;0;4
712;Birutės;SKRUZDELIUKŲ;9541516589;Taip;3;0;0;3
713;Birutės;SKRUZDELIUKŲ;5811810714;Taip;17;0;0;17
714;Birutės;SKRUZDELIUKŲ;6815916679;Taip;0;7;3;10
715;Birutės;SKRUZDELIUKŲ;7940403585;Ne;5;0;1;6
716;Birutės;SKRUZDELIUKŲ;4253571334;Taip;0;0;1;1
717;Birutės;SKRUZDELIUKŲ;9187671201;Ne;0;14;0;14
718;Birutės;BITUČIŲ;1599159924;Taip;9;0;0;9
719;Birutės;BITUČIŲ;33770983649;Taip;2;15;0;17
720;Birutės;BITUČIŲ;87693588654;Taip;0;1;0;1
721;Birutės;BITUČIŲ;1234596925;Taip;2;0;0;2
722;Birutės;BITUČIŲ;2975442228;Ne;15;0;3;18
723;Birutės;BITUČIŲ;5770026060;Taip;10;0;0;10
724;Birutės;BITUČIŲ;98391790116;Ne;0;0;4;4
725;Birutės;BITUČIŲ;5947971037;Taip;0;7;1;8
726;Birutės;BITUČIŲ;3870702348;Taip;4;0;1;5
727;Birutės;BITUČIŲ;1064449916;Taip;0;6;0;6
728;Birutės;BITUČIŲ;3436637062;Taip;3;5;0;8
729;Birutės;BITUČIŲ;9769645272;Taip;7;0;2;9
730;Birutės;BITUČIŲ;8465645434;Taip;18;0;0;18
731;Birutės;BITUČIŲ;9722922540;Ne;0;0;7;7
732;Birutės;BITUČIŲ;4427232735;Ne;0;6;0;6
733;Birutės;BITUČIŲ;3061210677;Taip;5;0;9;14
734;Birutės;BITUČIŲ;6431396285;Taip;0;0;5;5
735;Birutės;BITUČIŲ;5099524382;Taip;0;0;22;22
736;Birutės;BORUŽIUKAI;83627433055;Taip;0;1;1;2
737;Birutės;BORUŽIUKAI;48493277224;Taip;0;1;2;3
738;Birutės;BORUŽIUKAI;1244627213;Ne;0;0;12;12
739;Birutės;BORUŽIUKAI;44098551169;Taip;4;0;0;4
740;Birutės;BORUŽIUKAI;1228407191;Taip;0;1;0;1
741;Birutės;BORUŽIUKAI;78441249067;Taip;2;14;0;16
742;Birutės;BORUŽIUKAI;1735549924;Taip;6;0;0;6
743;Birutės;BORUŽIUKAI;1905393478;Taip;8;0;0;8
744;Birutės;BORUŽIUKAI;1427891290;Taip;14;4;0;18
745;Birutės;BORUŽIUKAI;44844176536;Taip;0;0;1;1
746;Birutės;BORUŽIUKAI;22452517583;Taip;0;1;0;1
747;Birutės;BORUŽIUKAI;9450257904;Taip;0;1;0;1
748;Birutės;BORUŽIUKAI;1596098119;Taip;0;1;0;1
749;Birutės;BORUŽIUKAI;60466633757;Taip;10;4;0;14
750;Birutės;BORUŽIUKAI;9936423295;Ne;0;0;1;1
751;Birutės;BORUŽIUKAI;70370187632;Taip;0;6;0;6
752;Birutės;BORUŽIUKAI;1471448452;Ne;0;6;3;9
753;Birutės;BORUŽIUKAI;1264545164;Taip;0;0;9;9
754;Birutės;DRUGELIAI;1447494370;Ne;0;1;0;1
755;Birutės;DRUGELIAI;79438789443;Ne;0;0;9;9
756;Birutės;DRUGELIAI;77244600491;Taip;4;0;4;8
757;Birutės;DRUGELIAI;22036269009;Taip;7;0;0;7
758;Birutės;DRUGELIAI;3213573357;Taip;0;0;1;1
759;Birutės;DRUGELIAI;23540610503;Ne;5;0;1;6
760;Birutės;DRUGELIAI;3490951066;Taip;2;0;2;4
761;Birutės;DRUGELIAI;32780299044;Ne;0;0;1;1
762;Birutės;DRUGELIAI;1346957081;Ne;0;3;0;3
763;Birutės;DRUGELIAI;1950295916;Ne;0;0;2;2
764;Birutės;DRUGELIAI;9662009307;Taip;17;0;5;22
765;Birutės;DRUGELIAI;9860683556;Taip;0;2;0;2
766;Birutės;DRUGELIAI;53416654439;Taip;0;0;7;7
767;Birutės;DRUGELIAI;18503890312;Taip;0;7;0;7
768;Birutės;DRUGELIAI;5574120561;Taip;3;0;10;13
769;Bitutė;Aitvariukų;90943054285;Taip;0;6;0;6
770;Bitutė;Aitvariukų;3254061362;Taip;8;0;0;8
771;Bitutė;Aitvariukų;8394685672;Taip;1;0;0;1
772;Bitutė;Aitvariukų;3796188100;Taip;0;0;6;6
773;Bitutė;Aitvariukų;1846974702;Taip;3;0;0;3
774;Bitutė;Aitvariukų;1162903905;Taip;13;0;0;13
775;Bitutė;Aitvariukų;1560715159;Taip;5;5;0;10
776;Bitutė;Aitvariukų;2518730247;Taip;9;1;0;10
777;Bitutė;Aitvariukų;8743734366;Taip;3;0;0;3
778;Bitutė;Aitvariukų;2804203556;Taip;13;9;0;22
779;Bitutė;Aitvariukų;5455919343;Taip;4;0;2;6
780;Bitutė;Aitvariukų;6737174004;Taip;4;0;0;4
781;Bitutė;Aitvariukų;3432065233;Taip;2;0;0;2
782;Bitutė;Aitvariukų;5679397165;Taip;2;12;0;14
783;Bitutė;Aitvariukų;7056737587;Ne;3;0;4;7
784;Bitutė;Aitvariukų;1564763789;Taip;0;6;0;6
785;Bitutė;Aitvariukų;7456328992;Taip;0;1;0;1
786;Bitutė;Ežiukų;78233050805;Taip;0;0;3;3
787;Bitutė;Ežiukų;43167655810;Ne;12;0;1;13
788;Bitutė;Ežiukų;67601917966;Taip;0;1;1;2
789;Bitutė;Ežiukų;1824939092;Taip;0;0;4;4
790;Bitutė;Ežiukų;1262030751;Taip;0;0;17;17
791;Bitutė;Ežiukų;57841590670;Ne;0;1;2;3
792;Bitutė;Ežiukų;70388118169;Taip;22;0;0;22
793;Bitutė;Ežiukų;5126303823;Taip;0;4;0;4
794;Bitutė;Ežiukų;9838379838;Taip;0;22;0;22
795;Bitutė;Ežiukų;42098027592;Ne;4;0;5;9
796;Bitutė;Ežiukų;17953339860;Taip;0;2;0;2
797;Bitutė;Ežiukų;4764586168;Taip;0;0;3;3
798;Bitutė;Ežiukų;8905075899;Taip;7;0;2;9
799;Bitutė;Ežiukų;1709788155;Taip;0;5;0;5
800;Bitutė;Žvirbliukų;3804171750;Taip;0;5;0;5
801;Bitutė;Žvirbliukų;8545377054;Taip;0;9;0;9
802;Bitutė;Žvirbliukų;5406667195;Taip;0;7;0;7
803;Bitutė;Žvirbliukų;4458990772;Ne;0;0;8;8
804;Bitutė;Žvirbliukų;3723040682;Taip;0;4;0;4
805;Bitutė;Žvirbliukų;2190439190;Taip;3;0;1;4
806;Bitutė;Žvirbliukų;7113693496;Taip;13;0;0;13
807;Bitutė;Žvirbliukų;2483462846;Taip;12;0;0;12
808;Bitutė;Žvirbliukų;8186706520;Taip;0;22;0;22
809;Bitutė;Žvirbliukų;6044969600;Taip;6;2;0;8
810;Bitutė;Žvirbliukų;4303490614;Ne;4;7;0;11
811;Bitutė;Žvirbliukų;3654065124;Taip;0;7;0;7
812;Bitutė;Žvirbliukų;9166624750;Taip;0;0;6;6
813;Bitutė;Gandriukų;20823074269;Taip;0;6;0;6
814;Bitutė;Gandriukų;20308800957;Taip;0;2;0;2
815;Bitutė;Gandriukų;83034164893;Taip;0;5;0;5
816;Bitutė;Gandriukų;51014007755;Taip;0;7;0;7
817;Bitutė;Gandriukų;55763538285;Taip;9;1;0;10
818;Bitutė;Gandriukų;55722176820;Taip;6;0;0;6
819;Bitutė;Gandriukų;41836931870;Taip;7;5;0;12
820;Bitutė;Gandriukų;1926912966;Taip;0;9;0;9
821;Bitutė;Gandriukų;16096919364;Ne;0;2;0;2
822;Bitutė;Gandriukų;2007360730;Taip;15;0;0;15
823;Bitutė;Gandriukų;2004589442;Taip;0;12;0;12
824;Bitutė;Gandriukų;1514919519;Ne;0;8;0;8
825;Bitutė;Gandriukų;1756799209;Ne;0;0;1;1
826;Bitutė;Gandriukų;39963735248;Taip;2;1;0;3
827;Bitutė;Gandriukų;2311037144;Taip;0;2;0;2
828;Bitutė;Gandriukų;41659768159;Taip;11;0;0;11
829;Bitutė;Pelėdžiukai;76504719475;Taip;3;1;0;4
830;Bitutė;Pelėdžiukai;29837823635;Taip;0;0;11;11
831;Bitutė;Pelėdžiukai;73214901448;Taip;0;2;0;2
832;Bitutė;Pelėdžiukai;239058855;Ne;4;10;1;15
833;Bitutė;Pelėdžiukai;94263857872;Taip;0;7;0;7
834;Bitutė;Pelėdžiukai;4311138099;Ne;0;10;0;10
835;Bitutė;Pelėdžiukai;27177678441;Taip;1;0;0;1
836;Bitutė;Pelėdžiukai;13826670333;Taip;0;0;1;1
837;Bitutė;Pelėdžiukai;5513662035;Taip;0;0;1;1
838;Bitutė;Pelėdžiukai;1799005979;Taip;0;0;1;1
839;Bitutė;Pelėdžiukai;1342209916;Taip;0;0;3;3
840;Bitutė;Pelėdžiukai;1235354320;Taip;4;0;0;4
841;Bitutė;Pelėdžiukai;1086803168;Taip;1;1;0;2
842;Bitutė;Pelėdžiukai;54838528906;Taip;0;2;0;2
843;Bitutė;Pelėdžiukai;5365203210;Taip;0;9;1;10
844;Bitutė;Boružėlių;6586888742;Taip;10;0;0;10
845;Bitutė;Boružėlių;5783154071;Taip;0;8;8;16
846;Bitutė;Boružėlių;6052204491;Taip;3;0;0;3
847;Bitutė;Boružėlių;37105491775;Ne;7;2;2;11
848;Bitutė;Boružėlių;50869152455;Taip;0;0;1;1
849;Bitutė;Boružėlių;7352524951;Taip;1;6;3;10
850;Bitutė;Boružėlių;27144303911;Ne;3;0;2;5
851;Bitutė;Boružėlių;1802887869;Ne;3;0;1;4
852;Bitutė;Boružėlių;51054491845;Ne;3;0;1;4
853;Bitutė;Boružėlių;5653055907;Taip;7;1;1;9
854;Bitutė;Boružėlių;1809034174;Taip;5;1;0;6
855;Bitutė;Boružėlių;5644789669;Taip;6;2;6;14
856;Bitutė;Boružėlių;2350260809;Taip;0;1;1;2
857;Bitutė;Boružėlių;1307749129;Taip;9;1;0;10
858;Bitutė;Boružėlių;3980455738;Taip;0;7;1;8
859;Bitutė;Boružėlių;6678928989;Taip;6;2;0;8
860;Bitutė;Boružėlių;11567978993;Ne;7;0;0;7
861;Bitutė;Boružėlių;8519978626;Taip;4;7;4;15
862;Bitutė;Šokliukų;8754340459;Taip;0;3;0;3
863;Bitutė;Šokliukų;22504941477;Taip;0;4;0;4
864;Bitutė;Šokliukų;4054959628;Ne;0;0;7;7
865;Bitutė;Šokliukų;74038944722;Taip;0;0;2;2
866;Bitutė;Šokliukų;9314363274;Taip;0;22;0;22
867;Bitutė;Šokliukų;1703630417;Taip;0;1;0;1
868;Bitutė;Šokliukų;14787330368;Taip;6;1;0;7
869;Bitutė;Šokliukų;6591291681;Taip;0;5;0;5
870;Bitutė;Šokliukų;86636444738;Taip;0;5;0;5
871;Bitutė;Šokliukų;1956718350;Ne;0;0;5;5
872;Bitutė;Šokliukų;11128936533;Taip;0;1;1;2
873;Bitutė;Šokliukų;2775304620;Taip;0;1;0;1
874;Bitutė;Šokliukų;2104500642;Taip;0;2;0;2
875;Bitutė;Šokliukų;1385876629;Taip;0;9;0;9
876;Bitutė;Šokliukų;84694903978;Taip;0;3;0;3
877;Bitutė;Šokliukų;71957147569;Taip;0;6;0;6
878;Bitutė;Šokliukų;98029500731;Taip;0;3;0;3
879;Bitutė;Drugelių;57770829048;Taip;0;1;0;1
880;Bitutė;Drugelių;2531472741;Taip;0;3;0;3
881;Bitutė;Drugelių;55812244900;Taip;0;1;0;1
882;Bitutė;Drugelių;74525712637;Taip;0;1;0;1
883;Bitutė;Drugelių;56620848568;Taip;8;0;0;8
884;Bitutė;Drugelių;2049938111;Taip;0;4;0;4
885;Bitutė;Drugelių;58668298206;Taip;7;4;0;11
886;Bitutė;Drugelių;1863634233;Taip;4;0;4;8
887;Bitutė;Drugelių;9550491607;Taip;0;12;0;12
888;Bitutė;Drugelių;3982159333;Ne;5;11;0;16
889;Bitutė;Drugelių;27461264704;Taip;0;0;2;2
890;Bitutė;Drugelių;29300327608;Taip;0;7;0;7
891;Bitutė;Drugelių;50605497381;Taip;0;9;0;9
892;Bitutė;Drugelių;1030677273;Taip;0;2;0;2
893;Bitutė;Drugelių;3319657847;Taip;0;4;0;4
894;Bitutė;Drugelių;72872147664;Taip;0;0;3;3
895;Bitutė;Drugelių;7236048627;Taip;0;2;0;2
896;Bitutė;Kiškučių;9451529077;Ne;6;0;0;6
897;Bitutė;Kiškučių;2812580726;Ne;11;8;0;19
898;Bitutė;Kiškučių;1907876695;Taip;0;2;0;2
899;Bitutė;Kiškučių;7720798466;Taip;0;2;0;2
900;Bitutė;Kiškučių;1662815358;Taip;0;0;1;1
901;Bitutė;Kiškučių;1733189730;Taip;12;1;0;13
902;Bitutė;Kiškučių;3227252972;Taip;4;1;0;5
903;Bitutė;Kiškučių;9966437881;Taip;0;2;2;4
904;Bitutė;Kiškučių;8373296210;Taip;5;0;0;5
905;Bitutė;Kiškučių;1985958540;Taip;20;0;0;20
906;Bitutė;Kiškučių;8743960488;Taip;0;10;0;10
907;Bitutė;Kiškučių;9337144831;Taip;0;0;2;2
908;Bitutė;Kiškučių;1024337077;Taip;11;6;0;17
909;Bitutė;Kiškučių;4566919587;Taip;14;0;0;14
910;Bitutė;Kiškučių;6569166515;Taip;0;0;1;1
911;Bitutė;Kiškučių;2806899030;Taip;9;0;0;9
912;Bitutė;Kiškučių;5443722813;Taip;4;3;0;7
913;Bitutė;Kiškučių;1241863345;Taip;3;0;0;3
914;Bitutė;Kiškučių;8789574593;Taip;22;0;0;22
915;Bitutė;Kiškučių;8799003374;Taip;10;0;0;10
916;Bitutė;"Viščiukų ";1348548294;Taip;0;11;0;11
917;Bitutė;"Viščiukų ";8872286273;Taip;12;0;0;12
918;Bitutė;"Viščiukų ";5169768042;Taip;9;0;0;9
919;Bitutė;"Viščiukų ";7165511381;Taip;4;4;0;8
920;Bitutė;"Viščiukų ";4527880105;Taip;0;1;0;1
921;Bitutė;"Viščiukų ";1012702386;Taip;0;4;0;4
922;Bitutė;"Viščiukų ";9465186207;Taip;9;0;0;9
923;Bitutė;"Viščiukų ";9924340801;Taip;10;2;0;12
924;Bitutė;"Viščiukų ";4917599786;Taip;22;0;0;22
925;Bitutė;"Viščiukų ";9855080887;Taip;0;2;0;2
926;Bitutė;"Viščiukų ";8211710975;Taip;5;6;0;11
927;Bitutė;"Viščiukų ";7318555933;Taip;3;0;0;3
928;Bitutė;"Viščiukų ";4513783927;Ne;0;13;0;13
929;Bitutė;"Skruzdėliukai ";37364063140;Ne;0;1;0;1
930;Bitutė;"Skruzdėliukai ";1590580158;Taip;0;7;0;7
931;Bitutė;"Skruzdėliukai ";5910842956;Taip;4;0;1;5
932;Bitutė;"Skruzdėliukai ";1913421864;Taip;0;5;0;5
933;Bitutė;"Skruzdėliukai ";38436660859;Taip;0;0;5;5
934;Bitutė;"Skruzdėliukai ";2126118124;Taip;7;7;2;16
935;Bitutė;"Skruzdėliukai ";87960363246;Taip;0;1;0;1
936;Bitutė;"Skruzdėliukai ";1064809221;Taip;22;0;0;22
937;Bitutė;"Skruzdėliukai ";1521753712;Taip;10;0;4;14
938;Bitutė;"Skruzdėliukai ";1307910515;Taip;0;0;1;1
939;Bitutė;"Skruzdėliukai ";5886190377;Taip;0;0;9;9
940;Bitutė;"Skruzdėliukai ";61233878620;Taip;4;3;0;7
941;Bitutė;"Skruzdėliukai ";1130379531;Taip;0;4;0;4
942;Bitutė;"Skruzdėliukai ";2031043488;Taip;0;5;0;5
943;Bitutė;"Skruzdėliukai ";1354608761;Taip;0;2;0;2
944;Bitutė;"Skruzdėliukai ";95252521365;Ne;0;13;1;14
945;Bitutė;"Skruzdėliukai ";6969112590;Taip;0;1;0;1
946;Bitutė;"Nykštukų ";2144568225;Taip;4;9;0;13
947;Bitutė;"Nykštukų ";5188828679;Taip;0;6;0;6
948;Bitutė;"Nykštukų ";8109028957;Taip;0;6;0;6
949;Bitutė;"Nykštukų ";1904108612;Taip;0;7;1;8
950;Bitutė;"Nykštukų ";6169426273;Taip;10;0;0;10
951;Bitutė;"Nykštukų ";5942493696;Taip;10;0;0;10
952;Bitutė;"Nykštukų ";2252157473;Taip;0;2;0;2
953;Bitutė;"Nykštukų ";8439759353;Taip;6;0;0;6
954;Bitutė;"Nykštukų ";2853616585;Taip;5;1;0;6
955;Bitutė;"Nykštukų ";1423694056;Taip;3;0;0;3
956;Bitutė;"Nykštukų ";5109258680;Taip;0;1;0;1
957;Bitutė;"Nykštukų ";5686278261;Taip;9;0;0;9
958;Bitutė;"Nykštukų ";7145036085;Taip;14;0;3;17
959;Bitutė;"Nykštukų ";9602659259;Taip;6;0;8;14
960;Bitutė;"Nykštukų ";6311396261;Taip;14;0;0;14
961;Bitutė;"Nykštukų ";5378885117;Taip;0;0;4;4
962;Coliukė;DRUGELIAI;6725408547;Taip;0;8;0;8
963;Coliukė;DRUGELIAI;5450167562;Taip;7;2;0;9
964;Coliukė;DRUGELIAI;7248705010;Taip;7;4;0;11
965;Coliukė;DRUGELIAI;3427704550;Taip;0;3;0;3
966;Coliukė;DRUGELIAI;5139645108;Taip;4;12;0;16
967;Coliukė;DRUGELIAI;3499575148;Taip;4;1;1;6
968;Coliukė;DRUGELIAI;3323738649;Taip;0;1;0;1
969;Coliukė;DRUGELIAI;9331485675;Taip;7;0;0;7
970;Coliukė;DRUGELIAI;2275327607;Taip;5;1;1;7
971;Coliukė;DRUGELIAI;4188233426;Taip;8;0;0;8
972;Coliukė;DRUGELIAI;4845247006;Taip;0;9;0;9
973;Coliukė;DRUGELIAI;3318808813;Ne;22;0;0;22
974;Coliukė;BITUTĖS;82989338835;Taip;0;11;1;12
975;Coliukė;BITUTĖS;1199350941;Taip;6;13;0;19
976;Coliukė;BITUTĖS;1960898805;Taip;0;8;0;8
977;Coliukė;BITUTĖS;58421006265;Taip;0;7;0;7
978;Coliukė;BITUTĖS;8457120425;Taip;2;0;0;2
979;Coliukė;BITUTĖS;9311775782;Taip;10;6;0;16
980;Coliukė;BITUTĖS;36554487034;Taip;3;3;0;6
981;Coliukė;BITUTĖS;7920728387;Taip;0;8;0;8
982;Coliukė;BITUTĖS;1240946719;Ne;0;7;0;7
983;Coliukė;BITUTĖS;4408284518;Taip;11;6;0;17
984;Coliukė;BITUTĖS;3346269598;Taip;5;0;0;5
985;Coliukė;BITUTĖS;6860757091;Taip;0;7;0;7
986;Coliukė;BITUTĖS;1458763954;Ne;2;2;0;4
987;Coliukė;BITUTĖS;1968467455;Ne;8;2;0;10
988;Coliukė;BITUTĖS;3919482569;Ne;11;2;0;13
989;Coliukė;BITUTĖS;8517128464;Taip;0;1;0;1
990;Coliukė;BITUTĖS;1328505569;Ne;10;4;0;14
991;Coliukė;BITUTĖS;4645245689;Taip;16;0;0;16
992;Coliukė;BITUTĖS;6170362846;Taip;8;1;0;9
993;Coliukė;VABALIUKAI;62876576078;Taip;0;2;0;2
994;Coliukė;VABALIUKAI;26698840369;Ne;3;9;0;12
995;Coliukė;VABALIUKAI;78760440826;Taip;11;6;0;17
996;Coliukė;VABALIUKAI;22951260339;Taip;0;8;0;8
997;Coliukė;VABALIUKAI;33158793202;Taip;0;2;0;2
998;Coliukė;VABALIUKAI;33587152454;Taip;7;6;0;13
999;Coliukė;VABALIUKAI;82064520362;Taip;8;0;0;8
1000;Coliukė;VABALIUKAI;57504928606;Taip;3;3;0;6
1001;Coliukė;VABALIUKAI;4649987214;Taip;4;0;0;4
1002;Coliukė;VABALIUKAI;63258983714;Taip;0;1;0;1
1003;Coliukė;VABALIUKAI;99200764707;Taip;14;0;0;14
1004;Coliukė;VABALIUKAI;1476750428;Ne;10;4;0;14
1005;Coliukė;VABALIUKAI;8323242104;Taip;0;11;0;11
1006;Coliukė;VABALIUKAI;6333099356;Taip;3;1;0;4
1007;Coliukė;VABALIUKAI;9526108197;Ne;17;0;0;17
1008;Coliukė;VABALIUKAI;3539878011;Taip;3;0;0;3
1009;Coliukė;VABALIUKAI;4739310916;Taip;16;0;0;16
1010;Coliukė;VABALIUKAI;5541328815;Taip;5;0;0;5
1011;Coliukė;VABALIUKAI;1318558913;Taip;0;0;1;1
1012;Coliukė;VABALIUKAI;4010374947;Taip;15;0;0;15
1013;Coliukė;VABALIUKAI;7622526793;Taip;0;8;0;8
1014;Coliukė;VABALIUKAI;5163405988;Ne;7;0;0;7
1015;Coliukė;VABALIUKAI;3513604594;Ne;7;0;0;7
1016;Coliukė;VABALIUKAI;4626722910;Taip;10;0;2;12
1017;Coliukė;NYKŠTUKAI;1659532709;Taip;0;10;2;12
1018;Coliukė;NYKŠTUKAI;4747481676;Ne;0;7;0;7
1019;Coliukė;NYKŠTUKAI;2168987649;Taip;10;0;0;10
1020;Coliukė;NYKŠTUKAI;2684151591;Taip;0;7;0;7
1021;Coliukė;NYKŠTUKAI;4499924331;Taip;5;2;0;7
1022;Coliukė;NYKŠTUKAI;4806478786;Taip;0;0;2;2
1023;Coliukė;NYKŠTUKAI;7566429633;Taip;0;5;0;5
1024;Coliukė;NYKŠTUKAI;7670166244;Taip;11;3;0;14
1025;Coliukė;NYKŠTUKAI;4845049639;Taip;3;0;0;3
1026;Coliukė;NYKŠTUKAI;1537341012;Taip;10;6;0;16
1027;Coliukė;NYKŠTUKAI;6403149921;Ne;10;0;0;10
1028;Coliukė;NYKŠTUKAI;1105879142;Taip;5;0;0;5
1029;Coliukė;NYKŠTUKAI;4022408510;Ne;0;2;0;2
1030;Coliukė;NYKŠTUKAI;1600495468;Taip;0;1;0;1
1031;Coliukė;NYKŠTUKAI;6781303455;Taip;12;2;0;14
1032;Coliukė;NYKŠTUKAI;7502911642;Ne;0;10;0;10
1033;Coliukė;GĖLYTĖS;8149118599;Taip;0;4;0;4
1034;Coliukė;GĖLYTĖS;1390751418;Taip;3;4;0;7
1035;Coliukė;GĖLYTĖS;2078549599;Taip;0;2;0;2
1036;Coliukė;GĖLYTĖS;4881447596;Taip;0;3;0;3
1037;Coliukė;GĖLYTĖS;9750447455;Taip;0;3;0;3
1038;Coliukė;GĖLYTĖS;2385917598;Taip;4;0;0;4
1039;Coliukė;GĖLYTĖS;7345905007;Taip;0;1;0;1
1040;Coliukė;GĖLYTĖS;3628571567;Taip;0;2;0;2
1041;Coliukė;GĖLYTĖS;9752408693;Taip;5;0;0;5
1042;Coliukė;GĖLYTĖS;7216221020;Taip;0;1;0;1
1043;Coliukė;"BORUŽĖLĖS (SPEC.)";1988394967;Ne;0;2;0;2
1044;Coliukė;"BORUŽĖLĖS (SPEC.)";3746858489;Taip;7;2;0;9
1045;Coliukė;"BORUŽĖLĖS (SPEC.)";2080118127;Taip;9;4;0;13
1046;Coliukė;"BORUŽĖLĖS (SPEC.)";8070499557;Taip;0;7;0;7
1047;Coliukė;"BORUŽĖLĖS (SPEC.)";9368334915;Taip;5;2;0;7
1048;Coliukė;"BORUŽĖLĖS (SPEC.)";1233731506;Taip;3;0;0;3
1049;Coliukė;"BORUŽĖLĖS (SPEC.)";5706671963;Taip;3;0;0;3
1050;Coliukė;"BORUŽĖLĖS (SPEC.)";7025195076;Taip;9;0;0;9
1051;Čiauškutis;BITUTĖS;3499391608;Taip;0;0;3;3
1052;Čiauškutis;BITUTĖS;1443155220;Ne;1;3;0;4
1053;Čiauškutis;BITUTĖS;1804509009;Taip;5;0;1;6
1054;Čiauškutis;BITUTĖS;22717947028;Taip;6;4;0;10
1055;Čiauškutis;BITUTĖS;3917667527;Ne;7;0;3;10
1056;Čiauškutis;BITUTĖS;5900996969;Taip;9;0;0;9
1057;Čiauškutis;BITUTĖS;54635137954;Taip;0;0;1;1
1058;Čiauškutis;BITUTĖS;7060197354;Taip;9;0;0;9
1059;Čiauškutis;BITUTĖS;30480486366;Taip;0;0;1;1
1060;Čiauškutis;BITUTĖS;1732370199;Ne;11;0;3;14
1061;Čiauškutis;BITUTĖS;3370047940;Taip;0;0;10;10
1062;Čiauškutis;BITUTĖS;9208388159;Ne;0;0;3;3
1063;Čiauškutis;ŽVIRBLIUKAI;2044220236;Taip;3;0;2;5
1064;Čiauškutis;ŽVIRBLIUKAI;4239145386;Taip;0;9;0;9
1065;Čiauškutis;ŽVIRBLIUKAI;2633243682;Ne;3;0;0;3
1066;Čiauškutis;ŽVIRBLIUKAI;7009893338;Taip;9;0;7;16
1067;Čiauškutis;ŽVIRBLIUKAI;6705934636;Taip;12;0;0;12
1068;Čiauškutis;ŽVIRBLIUKAI;5957587644;Taip;0;0;2;2
1069;Čiauškutis;ŽVIRBLIUKAI;1733251156;Ne;4;0;0;4
1070;Čiauškutis;ŽVIRBLIUKAI;7654242839;Ne;10;0;0;10
1071;Čiauškutis;ŽVIRBLIUKAI;5575614158;Taip;0;12;4;16
1072;Čiauškutis;SAULUTĖS;93468721158;Taip;0;11;0;11
1073;Čiauškutis;SAULUTĖS;2012201854;Taip;0;10;0;10
1074;Čiauškutis;SAULUTĖS;27158851138;Taip;14;0;0;14
1075;Čiauškutis;SAULUTĖS;78373250443;Taip;5;5;0;10
1076;Čiauškutis;SAULUTĖS;7755428393;Taip;2;2;0;4
1077;Čiauškutis;SAULUTĖS;3653044274;Taip;0;1;0;1
1078;Čiauškutis;SAULUTĖS;1417978731;Taip;5;0;0;5
1079;Čiauškutis;SAULUTĖS;1503190001;Taip;4;0;0;4
1080;Čiauškutis;SAULUTĖS;1719875491;Taip;8;0;0;8
1081;Čiauškutis;SAULUTĖS;1486206292;Taip;5;0;0;5
1082;Čiauškutis;EŽIUKAI;7746580858;Taip;1;0;0;1
1083;Čiauškutis;EŽIUKAI;2411714732;Taip;15;0;3;18
1084;Čiauškutis;EŽIUKAI;2686038029;Taip;0;0;3;3
1085;Čiauškutis;EŽIUKAI;1928404791;Taip;1;0;0;1
1086;Čiauškutis;EŽIUKAI;6056618348;Taip;0;1;7;8
1087;Čiauškutis;EŽIUKAI;7489733038;Ne;4;0;0;4
1088;Čiauškutis;EŽIUKAI;5404165993;Ne;11;1;0;12
1089;Čiauškutis;EŽIUKAI;2554011985;Ne;0;2;0;2
1090;Čiauškutis;EŽIUKAI;9959952114;Taip;0;0;5;5
1091;Čiauškutis;EŽIUKAI;1158816422;Ne;0;7;0;7
1092;Čiauškutis;EŽIUKAI;7239878097;Taip;0;0;2;2
1093;Čiauškutis;EŽIUKAI;5910818962;Ne;13;0;0;13
1094;Čiauškutis;DRUGELIAI;7080320173;Taip;11;0;0;11
1095;Čiauškutis;DRUGELIAI;7312776041;Ne;7;0;0;7
1096;Čiauškutis;DRUGELIAI;1301573542;Taip;0;0;1;1
1097;Čiauškutis;DRUGELIAI;9072764004;Ne;5;0;0;5
1098;Čiauškutis;DRUGELIAI;1036358147;Taip;0;11;6;17
1099;Čiauškutis;DRUGELIAI;8690876173;Ne;0;1;5;6
1100;Čiauškutis;DRUGELIAI;1750040659;Taip;5;0;0;5
1101;Čiauškutis;DRUGELIAI;8346845876;Taip;10;4;0;14
1102;Čiauškutis;DRUGELIAI;98579606504;Taip;0;0;1;1
1103;Čiauškutis;DRUGELIAI;1426744251;Taip;0;0;2;2
1104;Čiauškutis;GENELIAI;3888278518;Ne;5;0;2;7
1105;Čiauškutis;GENELIAI;47866559654;Taip;0;1;0;1
1106;Čiauškutis;GENELIAI;2034456215;Taip;0;0;3;3
1107;Čiauškutis;GENELIAI;45303538716;Ne;0;4;0;4
1108;Čiauškutis;GENELIAI;7011763860;Taip;0;0;10;10
1109;Čiauškutis;GENELIAI;2273215873;Ne;0;0;1;1
1110;Čiauškutis;GENELIAI;7332285452;Taip;10;1;0;11
1111;Čiauškutis;GENELIAI;1233059816;Taip;0;2;0;2
1112;Čiauškutis;GENELIAI;28814860843;Taip;8;0;0;8
1113;Čiauškutis;GENELIAI;8483195434;Taip;9;0;0;9
1114;Čiauškutis;LINKSMUČIAI;4600623461;Taip;14;0;0;14
1115;Čiauškutis;LINKSMUČIAI;1332686904;Taip;5;1;0;6
1116;Čiauškutis;LINKSMUČIAI;55539901360;Ne;0;0;1;1
1117;Čiauškutis;LINKSMUČIAI;1380571576;Ne;11;3;0;14
1118;Čiauškutis;LINKSMUČIAI;1109018212;Taip;7;0;0;7
1119;Čiauškutis;LINKSMUČIAI;3080441515;Taip;0;1;0;1
1120;Čiauškutis;LINKSMUČIAI;8884708945;Taip;16;0;1;17
1121;Čiauškutis;LINKSMUČIAI;9603569117;Ne;0;1;0;1
1122;Čiauškutis;LINKSMUČIAI;2019831231;Taip;0;0;2;2
1123;Čiauškutis;LINKSMUČIAI;67405154291;Taip;0;0;4;4
1124;Čiauškutis;LINKSMUČIAI;1778900145;Taip;9;0;6;15
1125;Čiauškutis;KIŠKUČIAI;1474355889;Taip;0;2;0;2
1126;Čiauškutis;KIŠKUČIAI;72264057427;Taip;0;0;9;9
1127;Čiauškutis;KIŠKUČIAI;8808041204;Taip;0;2;0;2
1128;Čiauškutis;KIŠKUČIAI;2099735647;Taip;0;5;1;6
1129;Čiauškutis;KIŠKUČIAI;8992775168;Taip;9;0;10;19
1130;Čiauškutis;KIŠKUČIAI;1480363762;Taip;8;1;0;9
1131;Čiauškutis;KIŠKUČIAI;1849532875;Ne;5;0;0;5
1132;Čiauškutis;KIŠKUČIAI;2218793969;Taip;8;0;0;8
1133;Čiauškutis;KIŠKUČIAI;6115354862;Taip;7;0;0;7
1134;Čiauškutis;KIŠKUČIAI;5759367884;Taip;0;4;0;4
1135;Čiauškutis;KIŠKUČIAI;1456067541;Taip;8;0;8;16
1136;Čiauškutis;KIŠKUČIAI;7367933940;Taip;5;0;0;5
1137;Čiauškutis;LAPIUKAI;31203540590;Taip;3;0;0;3
1138;Čiauškutis;LAPIUKAI;1657452686;Ne;0;5;2;7
1139;Čiauškutis;LAPIUKAI;43313173294;Taip;0;0;3;3
1140;Čiauškutis;LAPIUKAI;95770489933;Taip;2;0;1;3
1141;Čiauškutis;MEŠKUČIAI;4341825486;Taip;4;0;0;4
1142;Čiauškutis;MEŠKUČIAI;8375416027;Ne;3;0;3;6
1143;Čiauškutis;MEŠKUČIAI;1938531597;Ne;0;5;0;5
1144;Čiauškutis;PELĖDŽIUKAI;8728572783;Ne;0;1;0;1
1145;Čiauškutis;PELĖDŽIUKAI;82575455120;Taip;0;0;1;1
1146;Čiauškutis;PELĖDŽIUKAI;1546096184;Taip;0;0;1;1
1147;Čiauškutis;PELĖDŽIUKAI;4135020826;Taip;0;0;15;15
1148;Čiauškutis;PELĖDŽIUKAI;5897061482;Taip;0;1;2;3
1149;Čiauškutis;NYKŠTUKAI;6258150407;Taip;12;1;0;13
1150;Čiauškutis;NYKŠTUKAI;4898534899;Ne;0;1;0;1
1151;Čiauškutis;NYKŠTUKAI;1413414774;Taip;7;0;0;7
1152;Čiauškutis;NYKŠTUKAI;4917339896;Taip;7;0;0;7
1153;Čiauškutis;NYKŠTUKAI;8030685444;Ne;4;2;0;6
1154;Čiauškutis;NYKŠTUKAI;1809511815;Taip;0;17;0;17
1155;Čiauškutis;NYKŠTUKAI;1422589887;Taip;8;0;0;8
1156;Čiauškutis;NYKŠTUKAI;8709039752;Taip;11;0;0;11
1157;Delfinukas;Boružėlių;6935992202;Taip;5;2;0;7
1158;Delfinukas;Boružėlių;7904803011;Taip;4;1;0;5
1159;Delfinukas;Boružėlių;8186312409;Taip;10;1;0;11
1160;Delfinukas;Boružėlių;8148610460;Taip;14;3;0;17
1161;Delfinukas;Boružėlių;1484123788;Taip;0;3;7;10
1162;Delfinukas;Boružėlių;6531930806;Taip;4;0;0;4
1163;Delfinukas;Boružėlių;8076961367;Ne;8;1;0;9
1164;Delfinukas;Boružėlių;8439204095;Taip;10;0;0;10
1165;Delfinukas;Boružėlių;4989239822;Taip;0;0;4;4
1166;Delfinukas;Boružėlių;7638190553;Ne;0;19;1;20
1167;Delfinukas;Boružėlių;2010703982;Ne;5;0;0;5
1168;Delfinukas;Boružėlių;8728791932;Taip;13;0;0;13
1169;Delfinukas;Boružėlių;5794346039;Ne;12;0;0;12
1170;Delfinukas;Boružėlių;1153948822;Ne;0;0;3;3
1171;Delfinukas;Boružėlių;6700068320;Taip;14;3;0;17
1172;Delfinukas;Boružėlių;7277680544;Ne;9;2;0;11
1173;Delfinukas;Boružėlių;9099945815;Ne;10;1;0;11
1174;Delfinukas;Boružėlių;1212995285;Taip;9;1;0;10
1175;Delfinukas;Saulytės;65798709244;Taip;4;0;0;4
1176;Delfinukas;Saulytės;79934072325;Taip;0;4;1;5
1177;Delfinukas;Saulytės;2096874518;Taip;0;2;0;2
1178;Delfinukas;Saulytės;46847640903;Taip;0;0;11;11
1179;Delfinukas;Saulytės;4142864015;Taip;0;7;0;7
1180;Delfinukas;Saulytės;16785309188;Taip;0;9;0;9
1181;Delfinukas;Saulytės;34563800372;Taip;0;18;4;22
1182;Delfinukas;Saulytės;1939499375;Taip;0;5;0;5
1183;Delfinukas;Saulytės;1813240176;Taip;0;0;1;1
1184;Delfinukas;Saulytės;1293348150;Ne;0;10;0;10
1185;Delfinukas;Saulytės;1364873935;Taip;9;8;0;17
1186;Delfinukas;Saulytės;5912904296;Taip;4;1;0;5
1187;Delfinukas;Pelėdžiukų;3940838205;Ne;16;1;0;17
1188;Delfinukas;Pelėdžiukų;8774145277;Ne;11;1;0;12
1189;Delfinukas;Pelėdžiukų;1395257200;Taip;10;0;0;10
1190;Delfinukas;Pelėdžiukų;7249857412;Taip;3;2;0;5
1191;Delfinukas;Pelėdžiukų;2658828200;Taip;0;7;0;7
1192;Delfinukas;Pelėdžiukų;3770227955;Taip;22;0;0;22
1193;Delfinukas;Pelėdžiukų;6113662246;Taip;4;4;0;8
1194;Delfinukas;Pelėdžiukų;1526129772;Taip;7;0;1;8
1195;Delfinukas;Pelėdžiukų;8659309242;Taip;0;10;0;10
1196;Delfinukas;Pelėdžiukų;8882370994;Ne;22;0;0;22
1197;Delfinukas;Pelėdžiukų;9319874239;Ne;4;0;0;4
1198;Delfinukas;Pelėdžiukų;2809947323;Taip;17;0;0;17
1199;Delfinukas;Pelėdžiukų;3465186420;Taip;14;0;0;14
1200;Delfinukas;Pelėdžiukų;8913681176;Ne;10;0;0;10
1201;Delfinukas;Varliukų;1091165849;Taip;3;0;0;3
1202;Delfinukas;Varliukų;9573336239;Taip;4;0;0;4
1203;Delfinukas;Varliukų;1454101129;Taip;9;2;0;11
1204;Delfinukas;Varliukų;1251961268;Taip;0;2;0;2
1205;Delfinukas;Varliukų;1789047913;Taip;0;13;4;17
1206;Delfinukas;Varliukų;1194444282;Ne;3;0;0;3
1207;Delfinukas;Varliukų;9347513042;Taip;0;2;0;2
1208;Delfinukas;Varliukų;8875479631;Ne;0;19;0;19
1209;Delfinukas;Varliukų;3344476309;Taip;8;0;1;9
1210;Delfinukas;Varliukų;3955783379;Ne;5;8;0;13
1211;Delfinukas;Varliukų;9502789660;Taip;4;0;0;4
1212;Delfinukas;Varliukų;3489297719;Taip;4;2;0;6
1213;Delfinukas;Varliukų;1948438336;Ne;11;0;0;11
1214;Delfinukas;Varliukų;9266646602;Taip;14;0;4;18
1215;Delfinukas;Varliukų;3674481373;Taip;5;4;0;9
1216;Delfinukas;Varliukų;9516852657;Taip;0;0;19;19
1217;Delfinukas;Varliukų;1338476746;Taip;0;1;0;1
1218;Delfinukas;Varpelių;8855690221;Taip;9;0;2;11
1219;Delfinukas;Varpelių;3093606855;Taip;8;1;0;9
1220;Delfinukas;Varpelių;6393090675;Taip;11;0;0;11
1221;Delfinukas;Varpelių;1268754720;Taip;0;2;0;2
1222;Delfinukas;Varpelių;1959331544;Taip;3;1;0;4
1223;Delfinukas;Varpelių;43859975789;Taip;2;0;0;2
1224;Delfinukas;Varpelių;2531571615;Taip;9;0;0;9
1225;Delfinukas;Varpelių;91028452879;Taip;4;0;0;4
1226;Delfinukas;Varpelių;1325054642;Ne;0;7;0;7
1227;Delfinukas;Varpelių;7163839896;Ne;0;7;0;7
1228;Delfinukas;Varpelių;7493037613;Ne;0;7;0;7
1229;Delfinukas;Varpelių;4239224971;Taip;0;7;0;7
1230;Delfinukas;Varpelių;1650166115;Ne;9;1;0;10
1231;Delfinukas;Varpelių;5123666058;Ne;0;10;0;10
1232;Delfinukas;Varpelių;4713803167;Ne;15;7;0;22
1233;Delfinukas;Varpelių;8936645508;Taip;4;3;0;7
1234;Delfinukas;Varpelių;26626004000;Taip;0;0;2;2
1235;Delfinukas;Varpelių;6047881184;Taip;11;0;0;11
1236;Delfinukas;Delfinukai;17266052771;Taip;4;3;0;7
1237;Delfinukas;Delfinukai;46276990963;Taip;0;1;0;1
1238;Delfinukas;Delfinukai;7528505426;Taip;6;0;0;6
1239;Delfinukas;Delfinukai;545765924;Taip;4;0;0;4
1240;Delfinukas;Delfinukai;4405301567;Taip;3;0;0;3
1241;Delfinukas;Delfinukai;2402524470;Taip;0;1;0;1
1242;Delfinukas;Delfinukai;9168812609;Taip;0;0;1;1
1243;Delfinukas;Delfinukai;2135364149;Taip;5;0;0;5
1244;Delfinukas;Delfinukai;34706967888;Ne;0;22;0;22
1245;Delfinukas;Delfinukai;1848598718;Taip;3;0;0;3
1246;Delfinukas;Delfinukai;4435982727;Taip;0;2;2;4
1247;Delfinukas;Delfinukai;85274001355;Taip;0;6;0;6
1248;Delfinukas;Delfinukai;9821969586;Ne;5;11;0;16
1249;Delfinukas;Delfinukai;4569691896;Taip;4;1;0;5
1250;Delfinukas;Drugeliai;2402204674;Taip;2;0;6;8
1251;Delfinukas;Drugeliai;4179507316;Taip;0;1;0;1
1252;Delfinukas;Drugeliai;2701448160;Ne;12;0;0;12
1253;Delfinukas;Drugeliai;8440546956;Taip;5;1;0;6
1254;Delfinukas;Drugeliai;6201567680;Taip;0;0;6;6
1255;Delfinukas;Drugeliai;1672021829;Ne;0;0;1;1
1256;Delfinukas;Drugeliai;2429427703;Ne;3;0;0;3
1257;Delfinukas;Drugeliai;9921730735;Taip;5;0;6;11
1258;Delfinukas;Drugeliai;7826428639;Ne;4;0;2;6
1259;Delfinukas;Drugeliai;1000049779;Taip;0;0;8;8
1260;Delfinukas;Drugeliai;3071312399;Ne;0;0;14;14
1261;Delfinukas;Drugeliai;2883959240;Taip;0;2;0;2
1262;Delfinukas;Drugeliai;1160537966;Taip;0;2;0;2
1263;Delfinukas;Drugeliai;1430155044;Taip;0;3;8;11
1264;Delfinukas;Žuvytės;6578506861;Taip;0;0;1;1
1265;Delfinukas;Žuvytės;6572690788;Taip;0;3;0;3
1266;Delfinukas;Žuvytės;3397350274;Ne;4;1;0;5
1267;Delfinukas;Žuvytės;9520598359;Ne;4;0;0;4
1268;Delfinukas;Žuvytės;3804996594;Taip;0;1;0;1
1269;Delfinukas;Žuvytės;1136182876;Ne;0;1;0;1
1270;Delfinukas;Žuvytės;7873373923;Taip;5;0;1;6
1271;Delfinukas;Žuvytės;7487111570;Ne;0;2;0;2
1272;Delfinukas;Žuvytės;6844500395;Taip;0;3;8;11
1273;Delfinukas;Žuvytės;9074294473;Taip;0;0;7;7
1274;Delfinukas;Žuvytės;2445742257;Taip;0;22;0;22
1275;Delfinukas;Žuvytės;8938997208;Ne;22;0;0;22
1276;Delfinukas;Žuvytės;9934325492;Taip;0;2;0;2
1277;Delfinukas;Žuvytės;8160982025;Taip;0;5;0;5
1278;Delfinukas;Žuvytės;6949000708;Taip;0;0;6;6
1279;Delfinukas;Žuvytės;9898412288;Taip;22;0;0;22
1280;Delfinukas;Žuvytės;6445868759;Taip;0;4;0;4
1281;Delfinukas;Delfinai;3796051179;Taip;21;0;1;22
1282;Delfinukas;Delfinai;9628317328;Taip;5;0;0;5
1283;Delfinukas;Delfinai;5797308373;Taip;10;1;0;11
1284;Delfinukas;Delfinai;6337962165;Taip;5;0;0;5
1285;Delfinukas;Delfinai;8099120371;Taip;0;0;2;2
1286;Delfinukas;Delfinai;3108430680;Taip;6;3;0;9
1287;Delfinukas;Delfinai;7663934825;Ne;8;3;0;11
1288;Delfinukas;Delfinai;1200205376;Taip;10;2;1;13
1289;Delfinukas;Delfinai;7629622746;Ne;0;2;3;5
1290;Delfinukas;Delfinai;4347116918;Taip;5;0;0;5
1291;Delfinukas;Delfinai;2784942324;Ne;5;1;0;6
1292;Delfinukas;Delfinai;1922513830;Ne;6;5;0;11
1293;Delfinukas;Delfinai;6270012707;Taip;11;4;0;15
1294;Delfinukas;Delfinai;1119373532;Ne;7;0;0;7
1295;Delfinukas;Paukšteliai;6873181103;Taip;0;4;0;4
1296;Delfinukas;Paukšteliai;7868415893;Taip;10;1;0;11
1297;Delfinukas;Paukšteliai;2756574162;Taip;6;1;0;7
1298;Delfinukas;Paukšteliai;5060445169;Taip;0;3;0;3
1299;Delfinukas;Paukšteliai;6992505341;Ne;0;0;22;22
1300;Delfinukas;Paukšteliai;9927854348;Taip;17;0;0;17
1301;Delfinukas;Paukšteliai;8028279246;Taip;15;0;0;15
1302;Delfinukas;Paukšteliai;6884260821;Taip;12;0;0;12
1303;Delfinukas;Paukšteliai;9592384914;Taip;6;0;0;6
1304;Delfinukas;Paukšteliai;2985669766;Taip;0;22;0;22
1305;Delfinukas;Paukšteliai;8328481987;Ne;0;0;22;22
1306;Delfinukas;Kiškučiai;98742243823;Taip;0;2;1;3
1307;Delfinukas;Kiškučiai;1498120150;Taip;8;3;0;11
1308;Delfinukas;Kiškučiai;1767369189;Taip;4;6;0;10
1309;Delfinukas;Kiškučiai;1495145663;Taip;0;0;5;5
1310;Delfinukas;Kiškučiai;1301231548;Taip;0;2;1;3
1311;Delfinukas;Kiškučiai;1477374660;Taip;7;2;0;9
1312;Delfinukas;Kiškučiai;1011101007;Taip;6;0;0;6
1313;Delfinukas;Kiškučiai;1166370228;Taip;4;0;0;4
1314;Delfinukas;Kiškučiai;96861425670;Taip;0;1;0;1
1315;Delfinukas;Kiškučiai;60320557464;Ne;3;2;0;5
1316;Delfinukas;Kiškučiai;1594700604;Taip;0;9;0;9
1317;Delfinukas;Kiškučiai;7509276953;Ne;0;1;0;1
1318;Delfinukas;Kiškučiai;83920976768;Taip;0;12;0;12
1319;Drevinukas;ZUIKUČIAI;1720464417;Taip;0;0;8;8
1320;Drevinukas;ZUIKUČIAI;6095020718;Ne;3;0;0;3
1321;Drevinukas;ZUIKUČIAI;3981507849;Taip;8;5;0;13
1322;Drevinukas;ZUIKUČIAI;5679723776;Taip;0;2;0;2
1323;Drevinukas;ZUIKUČIAI;2857797268;Taip;0;0;1;1
1324;Drevinukas;ZUIKUČIAI;7753238387;Taip;0;0;1;1
1325;Drevinukas;ZUIKUČIAI;3875062228;Taip;4;0;0;4
1326;Drevinukas;ZUIKUČIAI;8479979176;Ne;11;0;2;13
1327;Drevinukas;ZUIKUČIAI;2531207946;Ne;11;0;2;13
1328;Drevinukas;ZUIKUČIAI;3972897839;Ne;8;0;1;9
1329;Drevinukas;ZUIKUČIAI;1152161183;Taip;0;0;2;2
1330;Drevinukas;ZUIKUČIAI;8936058501;Taip;2;0;1;3
1331;Drevinukas;ZUIKUČIAI;9772484901;Taip;0;6;0;6
1332;Drevinukas;ZUIKUČIAI;7520907833;Taip;0;1;0;1
1333;Drevinukas;ZUIKUČIAI;8625382465;Ne;6;0;0;6
1334;Drevinukas;ZUIKUČIAI;8611131264;Taip;0;13;0;13
1335;Drevinukas;ZUIKUČIAI;6833120798;Taip;4;0;1;5
1336;Drevinukas;ZUIKUČIAI;7607135647;Taip;0;18;0;18
1337;Drevinukas;AŽUOLIUKŲ;1970787957;Taip;0;5;0;5
1338;Drevinukas;AŽUOLIUKŲ;39014589824;Taip;0;1;1;2
1339;Drevinukas;AŽUOLIUKŲ;3625661236;Taip;0;9;0;9
1340;Drevinukas;AŽUOLIUKŲ;46323011887;Taip;0;1;0;1
1341;Drevinukas;AŽUOLIUKŲ;1437074990;Taip;0;0;1;1
1342;Drevinukas;AŽUOLIUKŲ;1577311253;Taip;0;0;1;1
1343;Drevinukas;AŽUOLIUKŲ;6539595624;Taip;0;0;1;1
1344;Drevinukas;AŽUOLIUKŲ;1929303009;Taip;0;13;1;14
1345;Drevinukas;AŽUOLIUKŲ;59090501289;Taip;0;0;2;2
1346;Drevinukas;AŽUOLIUKŲ;1585468549;Ne;0;13;0;13
1347;Drevinukas;AŽUOLIUKŲ;1276720097;Taip;0;2;3;5
1348;Drevinukas;AŽUOLIUKŲ;3604979285;Taip;0;0;2;2
1349;Drevinukas;AŽUOLIUKŲ;78348414683;Taip;14;0;0;14
1350;Drevinukas;AŽUOLIUKŲ;83194462453;Taip;0;10;0;10
1351;Drevinukas;PELĖDŽIUKAI;17456144256;Taip;0;0;1;1
1352;Drevinukas;PELĖDŽIUKAI;3066586415;Taip;0;0;6;6
1353;Drevinukas;PELĖDŽIUKAI;1250033881;Taip;1;0;0;1
1354;Drevinukas;PELĖDŽIUKAI;22050717457;Taip;0;0;2;2
1355;Drevinukas;PELĖDŽIUKAI;74690633233;Taip;0;1;0;1
1356;Drevinukas;PELĖDŽIUKAI;29000633056;Taip;0;5;3;8
1357;Drevinukas;PELĖDŽIUKAI;46006802320;Taip;0;2;0;2
1358;Drevinukas;PELĖDŽIUKAI;1978599912;Taip;0;0;7;7
1359;Drevinukas;PELĖDŽIUKAI;9657606451;Taip;4;3;0;7
1360;Drevinukas;PELĖDŽIUKAI;4150306697;Taip;0;18;0;18
1361;Drevinukas;PELĖDŽIUKAI;71447591085;Taip;5;2;0;7
1362;Drevinukas;PELĖDŽIUKAI;2483043689;Taip;0;0;1;1
1363;Drevinukas;BORUŽĖLĖS;7519369167;Taip;4;0;5;9
1364;Drevinukas;BORUŽĖLĖS;1123115847;Taip;9;13;0;22
1365;Drevinukas;BORUŽĖLĖS;1987939679;Taip;0;6;0;6
1366;Drevinukas;BORUŽĖLĖS;2070374746;Taip;0;5;1;6
1367;Drevinukas;BORUŽĖLĖS;16952164778;Taip;0;6;0;6
1368;Drevinukas;BORUŽĖLĖS;3657451903;Taip;0;3;1;4
1369;Drevinukas;BORUŽĖLĖS;8180027849;Taip;4;1;2;7
1370;Drevinukas;BORUŽĖLĖS;5046355276;Taip;0;1;1;2
1371;Drevinukas;BORUŽĖLĖS;4332606643;Ne;14;0;1;15
1372;Drevinukas;BORUŽĖLĖS;7632515230;Taip;0;14;0;14
1373;Drevinukas;BORUŽĖLĖS;6304169257;Taip;0;6;0;6
1374;Drevinukas;BORUŽĖLĖS;85288014888;Taip;0;1;1;2
1375;Drevinukas;BORUŽĖLĖS;1019214451;Ne;9;1;5;15
1376;Drevinukas;BITUTĖS;24300552411;Taip;6;0;0;6
1377;Drevinukas;BITUTĖS;96688324084;Taip;0;1;0;1
1378;Drevinukas;BITUTĖS;7088781332;Ne;0;0;3;3
1379;Drevinukas;BITUTĖS;67343152327;Ne;0;1;0;1
1380;Drevinukas;BITUTĖS;73165075762;Taip;0;0;1;1
1381;Drevinukas;BITUTĖS;91352351942;Taip;0;0;2;2
1382;Drevinukas;BITUTĖS;43573400232;Taip;3;0;0;3
1383;Drevinukas;BITUTĖS;43087053446;Taip;0;1;0;1
1384;Drevinukas;BITUTĖS;62294117396;Taip;0;0;4;4
1385;Drevinukas;BITUTĖS;7670120949;Ne;3;10;0;13
1386;Drevinukas;BITUTĖS;1180916359;Ne;7;0;2;9
1387;Drevinukas;BITUTĖS;8943620706;Taip;13;0;3;16
1388;Drevinukas;BITUTĖS;4352184625;Taip;0;0;3;3
1389;Drevinukas;BITUTĖS;1025218361;Taip;0;1;1;2
1390;Drevinukas;BITUTĖS;1711831210;Taip;0;1;1;2
1391;Drevinukas;NYKŠTUKAI;4539246865;Taip;8;0;0;8
1392;Drevinukas;NYKŠTUKAI;7334626684;Taip;13;0;1;14
1393;Drevinukas;NYKŠTUKAI;5236292764;Taip;0;0;1;1
1394;Drevinukas;NYKŠTUKAI;1098647410;Taip;11;0;0;11
1395;Drevinukas;NYKŠTUKAI;2935175014;Ne;22;0;0;22
1396;Drevinukas;NYKŠTUKAI;5348609358;Taip;14;0;0;14
1397;Drevinukas;NYKŠTUKAI;2312241894;Taip;5;2;0;7
1398;Drevinukas;NYKŠTUKAI;5394143000;Taip;6;2;0;8
1399;Drevinukas;NYKŠTUKAI;4260123123;Ne;0;22;0;22
1400;Drevinukas;NYKŠTUKAI;5754055310;Ne;0;0;6;6
1401;Drevinukas;NYKŠTUKAI;3871506691;Taip;14;1;0;15
1402;Drevinukas;NYKŠTUKAI;6914111231;Taip;14;1;0;15
1403;Drevinukas;NYKŠTUKAI;3046196006;Ne;3;11;0;14
1404;Drevinukas;NYKŠTUKAI;3377957769;Ne;7;0;6;13
1405;Drevinukas;NYKŠTUKAI;3779983775;Taip;9;0;0;9
1406;Drevinukas;NYKŠTUKAI;1343431478;Taip;0;6;0;6
1407;Drevinukas;NYKŠTUKAI;1829421385;Taip;12;0;0;12
1408;Drevinukas;NYKŠTUKAI;4134729710;Ne;0;13;0;13
1409;Drevinukas;NYKŠTUKAI;8262224710;Ne;6;2;0;8
1410;Drevinukas;SMALSUČIAI;1644656704;Taip;0;0;1;1
1411;Drevinukas;SMALSUČIAI;1058927778;Taip;0;6;0;6
1412;Drevinukas;SMALSUČIAI;5673244101;Taip;6;0;0;6
1413;Drevinukas;SMALSUČIAI;1564065835;Taip;4;6;0;10
1414;Drevinukas;SMALSUČIAI;7689145214;Ne;0;0;7;7
1415;Drevinukas;SMALSUČIAI;8143614891;Ne;17;0;0;17
1416;Drevinukas;SMALSUČIAI;4262951360;Taip;3;0;0;3
1417;Drevinukas;SMALSUČIAI;9174977150;Taip;0;1;3;4
1418;Drevinukas;SMALSUČIAI;5928234487;Taip;10;0;0;10
1419;Drevinukas;SMALSUČIAI;6904083734;Ne;0;0;1;1
1420;Drevinukas;SMALSUČIAI;5323434566;Taip;22;0;0;22
1421;Drevinukas;SMALSUČIAI;8239000041;Taip;0;0;4;4
1422;Drevinukas;SMALSUČIAI;5704489483;Taip;0;0;3;3
1423;Drevinukas;ŽVIRBLIUKAI;6316000019;Taip;1;0;10;11
1424;Drevinukas;ŽVIRBLIUKAI;3032536983;Ne;6;0;0;6
1425;Drevinukas;ŽVIRBLIUKAI;8556218971;Taip;3;0;0;3
1426;Drevinukas;ŽVIRBLIUKAI;5524567803;Taip;0;0;6;6
1427;Drevinukas;ŽVIRBLIUKAI;9016985238;Taip;3;0;1;4
1428;Drevinukas;ŽVIRBLIUKAI;2929598743;Taip;0;6;0;6
1429;Drevinukas;ŽVIRBLIUKAI;6373230526;Ne;10;3;4;17
1430;Drevinukas;ŽVIRBLIUKAI;4404254932;Taip;1;0;1;2
1431;Drevinukas;ŽVIRBLIUKAI;2378493422;Taip;6;0;0;6
1432;Drevinukas;ŽVIRBLIUKAI;8984653958;Taip;9;2;0;11
1433;Drevinukas;ŽVIRBLIUKAI;5620887702;Ne;0;2;0;2
1434;Drevinukas;ŽVIRBLIUKAI;2281463885;Ne;0;2;0;2
1435;Drevinukas;ŽVIRBLIUKAI;4662426451;Taip;5;0;0;5
1436;Drevinukas;ŽVIRBLIUKAI;7218201733;Ne;22;0;0;22
1437;Drevinukas;ŽVIRBLIUKAI;4076576850;Taip;0;0;19;19
1438;Drevinukas;ŽVIRBLIUKAI;1859208322;Taip;18;0;0;18
1439;Drevinukas;ŽVIRBLIUKAI;5875459639;Taip;0;9;0;9
1440;Drevinukas;ŽVIRBLIUKAI;4312429104;Taip;9;0;1;10
1441;Drugelis;NYKŠTUKŲ;6452921695;Taip;0;6;0;6
1442;Drugelis;NYKŠTUKŲ;4927896706;Ne;3;0;0;3
1443;Drugelis;NYKŠTUKŲ;3551095669;Taip;5;4;0;9
1444;Drugelis;NYKŠTUKŲ;1785724340;Ne;0;12;0;12
1445;Drugelis;NYKŠTUKŲ;6632884258;Taip;9;7;0;16
1446;Drugelis;NYKŠTUKŲ;3061896520;Taip;0;1;0;1
1447;Drugelis;NYKŠTUKŲ;8070030439;Taip;0;1;0;1
1448;Drugelis;NYKŠTUKŲ;7447519502;Taip;0;1;0;1
1449;Drugelis;NYKŠTUKŲ;4523513611;Taip;6;2;0;8
1450;Drugelis;NYKŠTUKŲ;6594452094;Ne;0;4;1;5
1451;Drugelis;NYKŠTUKŲ;5122256823;Taip;5;0;0;5
1452;Drugelis;NYKŠTUKŲ;4825232236;Taip;4;2;2;8
1453;Drugelis;NYKŠTUKŲ;7477547789;Taip;8;1;0;9
1454;Drugelis;NYKŠTUKŲ;8752459733;Taip;11;0;0;11
1455;Drugelis;NYKŠTUKŲ;8717445483;Taip;0;12;0;12
1456;Drugelis;NYKŠTUKŲ;4158475365;Ne;5;1;0;6
1457;Drugelis;NYKŠTUKŲ;7609530453;Taip;0;0;4;4
1458;Drugelis;NYKŠTUKŲ;4867387611;Taip;16;1;0;17
1459;Drugelis;SMALSUČIŲ;3096906506;Taip;0;2;0;2
1460;Drugelis;SMALSUČIŲ;1576853049;Taip;0;0;3;3
1461;Drugelis;SMALSUČIŲ;1856912386;Ne;0;9;1;10
1462;Drugelis;SMALSUČIŲ;1255315664;Taip;0;5;0;5
1463;Drugelis;SMALSUČIŲ;7406396614;Taip;0;3;0;3
1464;Drugelis;SMALSUČIŲ;1217635751;Taip;0;0;11;11
1465;Drugelis;SMALSUČIŲ;68223183150;Ne;5;2;0;7
1466;Drugelis;SMALSUČIŲ;3479833265;Taip;6;2;1;9
1467;Drugelis;SMALSUČIŲ;3202149560;Taip;8;0;0;8
1468;Drugelis;SMALSUČIŲ;27569805506;Taip;0;14;0;14
1469;Drugelis;SMALSUČIŲ;1901608445;Taip;8;6;0;14
1470;Drugelis;SMALSUČIŲ;1843605624;Taip;0;2;0;2
1471;Drugelis;SMALSUČIŲ;1506988472;Taip;0;1;0;1
1472;Drugelis;SMALSUČIŲ;1991420008;Taip;0;1;0;1
1473;Drugelis;SMALSUČIŲ;1421438458;Ne;0;4;0;4
1474;Drugelis;SMALSUČIŲ;53874036107;Taip;0;1;0;1
1475;Drugelis;SMALSUČIŲ;1961898730;Taip;0;2;2;4
1476;Drugelis;SMALSUČIŲ;4788423265;Taip;0;0;1;1
1477;Drugelis;SMALSUČIŲ;1541276266;Taip;0;5;1;6
1478;Drugelis;SMALSUČIŲ;5954059321;Ne;13;2;1;16
1479;Drugelis;SMALSUČIŲ;1888002607;Taip;0;6;0;6
1480;Drugelis;MUMINUKŲ;51963723965;Taip;0;0;1;1
1481;Drugelis;MUMINUKŲ;10841811704;Taip;0;4;0;4
1482;Drugelis;MUMINUKŲ;55662263930;Taip;0;4;0;4
1483;Drugelis;MUMINUKŲ;78391738678;Taip;4;2;0;6
1484;Drugelis;MUMINUKŲ;44627668646;Ne;0;1;0;1
1485;Drugelis;MUMINUKŲ;78311619943;Taip;0;2;0;2
1486;Drugelis;MUMINUKŲ;35386244403;Taip;2;6;0;8
1487;Drugelis;MUMINUKŲ;16512391370;Taip;0;3;0;3
1488;Drugelis;MUMINUKŲ;88073976875;Ne;2;2;0;4
1489;Drugelis;MUMINUKŲ;85362607749;Taip;0;3;0;3
1490;Drugelis;MUMINUKŲ;13989264253;Taip;3;0;0;3
1491;Drugelis;MUMINUKŲ;25002448923;Taip;0;7;0;7
1492;Drugelis;MUMINUKŲ;55339135155;Ne;0;3;0;3
1493;Drugelis;MUMINUKŲ;82465836364;Taip;7;0;0;7
1494;Drugelis;MUMINUKŲ;63173368598;Taip;0;1;0;1
1495;Drugelis;MUMINUKŲ;29713921940;Taip;10;0;0;10
1496;Drugelis;MUMINUKŲ;82441447907;Taip;0;0;2;2
1497;Drugelis;MUMINUKŲ;70288969200;Taip;0;3;0;3
1498;Drugelis;MUMINUKŲ;72147158912;Taip;0;2;0;2
1499;Drugelis;MUMINUKŲ;1240607928;Taip;0;4;0;4
1500;Drugelis;PŪKUOTUKAI;49035429728;Taip;0;6;0;6
1501;Drugelis;PŪKUOTUKAI;3156382280;Taip;0;2;0;2
1502;Drugelis;PŪKUOTUKAI;26436464504;Taip;0;1;0;1
1503;Drugelis;PŪKUOTUKAI;1657445173;Taip;0;0;7;7
1504;Drugelis;PŪKUOTUKAI;27379769302;Taip;2;0;1;3
1505;Drugelis;PŪKUOTUKAI;91538620813;Taip;3;4;0;7
1506;Drugelis;PŪKUOTUKAI;68716515660;Taip;0;1;0;1
1507;Drugelis;PŪKUOTUKAI;1162058481;Taip;4;4;0;8
1508;Drugelis;PŪKUOTUKAI;1667056936;Taip;0;1;3;4
1509;Drugelis;PŪKUOTUKAI;63777226415;Taip;0;7;0;7
1510;Drugelis;PŪKUOTUKAI;1005872691;Taip;6;3;0;9
1511;Drugelis;PŪKUOTUKAI;49678120281;Taip;11;0;0;11
1512;Drugelis;PŪKUOTUKAI;3403116175;Taip;0;0;10;10
1513;Drugelis;PŪKUOTUKAI;9654611393;Taip;0;1;0;1
1514;Drugelis;PŪKUOTUKAI;1651512363;Taip;0;0;2;2
1515;Drugelis;PŪKUOTUKAI;67282950717;Taip;9;0;0;9
1516;Drugelis;PŪKUOTUKAI;1546655542;Taip;4;0;1;5
1517;Drugelis;SPINDULIUKAI;6890441262;Taip;1;2;0;3
1518;Drugelis;SPINDULIUKAI;1858504360;Taip;0;3;0;3
1519;Drugelis;SPINDULIUKAI;1666992752;Taip;0;1;0;1
1520;Drugelis;SPINDULIUKAI;9029137302;Taip;6;0;0;6
1521;Drugelis;SPINDULIUKAI;9907121223;Taip;10;0;0;10
1522;Drugelis;SPINDULIUKAI;3293212749;Taip;0;5;0;5
1523;Drugelis;SPINDULIUKAI;8366330478;Taip;9;0;0;9
1524;Drugelis;SPINDULIUKAI;8500348389;Taip;2;0;0;2
1525;Drugelis;SPINDULIUKAI;2196445523;Taip;3;4;0;7
1526;Drugelis;SPINDULIUKAI;3645668411;Taip;3;4;0;7
1527;Drugelis;SPINDULIUKAI;3261462674;Taip;6;4;0;10
1528;Drugelis;SPINDULIUKAI;9510744779;Taip;0;6;0;6
1529;Drugelis;SPINDULIUKAI;5515894973;Taip;0;2;0;2
1530;Drugelis;KIŠKUČIAI;9851124145;Taip;3;10;0;13
1531;Drugelis;KIŠKUČIAI;6321332888;Ne;11;9;0;20
1532;Drugelis;KIŠKUČIAI;3311620018;Ne;8;0;0;8
1533;Drugelis;KIŠKUČIAI;5902687211;Taip;0;0;2;2
1534;Drugelis;KIŠKUČIAI;7253876812;Taip;7;1;0;8
1535;Drugelis;KIŠKUČIAI;7390061272;Taip;0;14;0;14
1536;Drugelis;KIŠKUČIAI;2146963673;Taip;7;0;0;7
1537;Drugelis;KIŠKUČIAI;2256221485;Taip;18;1;0;19
1538;Drugelis;KIŠKUČIAI;8812550811;Taip;0;2;0;2
1539;Drugelis;KIŠKUČIAI;3085309902;Taip;0;0;2;2
1540;Drugelis;KIŠKUČIAI;5661335344;Taip;8;0;0;8
1541;Drugelis;KIŠKUČIAI;3037496936;Taip;0;15;0;15
1542;Drugelis;KIŠKUČIAI;9345527734;Taip;0;5;0;5
1543;Drugelis;KIŠKUČIAI;6038184222;Taip;0;2;1;3
1544;Drugelis;KIŠKUČIAI;1816845006;Taip;8;0;0;8
1545;Drugelis;KIŠKUČIAI;8591548746;Taip;4;9;0;13
1546;"Du gaideliai";Uodelių;3247101840;Taip;3;0;6;9
1547;"Du gaideliai";Uodelių;3507387826;Ne;8;10;0;18
1548;"Du gaideliai";Uodelių;4144269068;Taip;0;11;0;11
1549;"Du gaideliai";Uodelių;1785976627;Taip;0;0;5;5
1550;"Du gaideliai";Uodelių;2921485707;Taip;1;0;1;2
1551;"Du gaideliai";Uodelių;5894974508;Taip;0;6;0;6
1552;"Du gaideliai";Uodelių;1135098595;Taip;0;2;0;2
1553;"Du gaideliai";Uodelių;3370029981;Taip;0;2;1;3
1554;"Du gaideliai";Uodelių;5652662610;Taip;7;0;0;7
1555;"Du gaideliai";Uodelių;6348951959;Taip;8;0;0;8
1556;"Du gaideliai";Uodelių;4378924981;Taip;0;4;0;4
1557;"Du gaideliai";Uodelių;3854355215;Taip;0;12;0;12
1558;"Du gaideliai";Uodelių;3849899284;Taip;4;2;0;6
1559;"Du gaideliai";Uodelių;7373413569;Taip;0;2;0;2
1560;"Du gaideliai";Uodelių;2262425557;Taip;9;0;0;9
1561;"Du gaideliai";Uodelių;2240947701;Taip;7;0;5;12
1562;"Du gaideliai";Uodelių;6247706405;Taip;11;0;0;11
1563;"Du gaideliai";Uodelių;1268479215;Taip;15;2;0;17
1564;"Du gaideliai";Uodelių;3216423543;Taip;14;0;8;22
1565;"Du gaideliai";OŽIUKŲ;2159833613;Taip;0;21;0;21
1566;"Du gaideliai";OŽIUKŲ;1549762923;Ne;0;1;0;1
1567;"Du gaideliai";OŽIUKŲ;6750787450;Taip;0;1;0;1
1568;"Du gaideliai";OŽIUKŲ;4387568448;Taip;0;1;3;4
1569;"Du gaideliai";OŽIUKŲ;1500684755;Taip;0;7;0;7
1570;"Du gaideliai";OŽIUKŲ;9324740716;Ne;4;0;2;6
1571;"Du gaideliai";OŽIUKŲ;1230622413;Taip;0;4;0;4
1572;"Du gaideliai";OŽIUKŲ;94639433266;Taip;0;2;3;5
1573;"Du gaideliai";OŽIUKŲ;7783203480;Taip;0;2;0;2
1574;"Du gaideliai";OŽIUKŲ;1758546983;Taip;0;4;0;4
1575;"Du gaideliai";OŽIUKŲ;1074783418;Ne;3;0;1;4
1576;"Du gaideliai";OŽIUKŲ;6203383711;Taip;0;1;0;1
1577;"Du gaideliai";OŽIUKŲ;1557413692;Taip;0;12;0;12
1578;"Du gaideliai";OŽIUKŲ;3560637865;Taip;18;1;0;19
1579;"Du gaideliai";OŽIUKŲ;3771563320;Ne;0;2;0;2
1580;"Du gaideliai";Vištyčių;1791530261;Taip;0;9;0;9
1581;"Du gaideliai";Vištyčių;1479672134;Taip;0;1;0;1
1582;"Du gaideliai";Vištyčių;50087080642;Taip;5;2;0;7
1583;"Du gaideliai";Vištyčių;25738622801;Taip;5;3;0;8
1584;"Du gaideliai";Vištyčių;1628346439;Taip;0;10;0;10
1585;"Du gaideliai";Vištyčių;14681393632;Taip;0;2;0;2
1586;"Du gaideliai";Vištyčių;1128234653;Taip;0;2;1;3
1587;"Du gaideliai";Vištyčių;60934378499;Taip;0;4;0;4
1588;"Du gaideliai";Vištyčių;6161829923;Taip;0;21;0;21
1589;"Du gaideliai";Vištyčių;30562958921;Ne;0;4;1;5
1590;"Du gaideliai";Vištyčių;85962801220;Taip;0;0;1;1
1591;"Du gaideliai";Vištyčių;1261678548;Taip;0;3;0;3
1592;"Du gaideliai";Vištyčių;73447542654;Taip;0;1;0;1
1593;"Du gaideliai";Vištyčių;1304400387;Taip;0;1;0;1
1594;"Du gaideliai";Vištyčių;1291620608;Taip;0;2;0;2
1595;"Du gaideliai";Vištyčių;1923863232;Taip;5;0;0;5
1596;"Du gaideliai";Vištyčių;1906486044;Taip;0;1;0;1
1597;"Du gaideliai";Vištyčių;13384312035;Taip;0;2;2;4
1598;"Du gaideliai";GAIDŽIUKŲ;2157315097;Taip;0;1;0;1
1599;"Du gaideliai";GAIDŽIUKŲ;25898248315;Taip;0;6;0;6
1600;"Du gaideliai";GAIDŽIUKŲ;14599820571;Taip;5;0;0;5
1601;"Du gaideliai";GAIDŽIUKŲ;1258859998;Taip;0;2;0;2
1602;"Du gaideliai";GAIDŽIUKŲ;56826255179;Ne;0;0;1;1
1603;"Du gaideliai";GAIDŽIUKŲ;9173656753;Ne;0;2;0;2
1604;"Du gaideliai";GAIDŽIUKŲ;1888402861;Taip;0;0;3;3
1605;"Du gaideliai";GAIDŽIUKŲ;8087660692;Taip;12;0;0;12
1606;"Du gaideliai";GAIDŽIUKŲ;31139048776;Taip;0;9;0;9
1607;"Du gaideliai";GAIDŽIUKŲ;59558745879;Ne;4;0;1;5
1608;"Du gaideliai";GAIDŽIUKŲ;46193129936;Taip;0;4;0;4
1609;"Du gaideliai";GAIDŽIUKŲ;1850550387;Ne;0;3;0;3
1610;"Du gaideliai";GAIDŽIUKŲ;11621795110;Taip;2;3;0;5
1611;"Du gaideliai";GAIDŽIUKŲ;8634553012;Ne;0;1;0;1
1612;"Du gaideliai";Musyčių;1633544390;Taip;9;1;0;10
1613;"Du gaideliai";Musyčių;7033276798;Taip;7;1;0;8
1614;"Du gaideliai";Musyčių;5998344519;Taip;2;8;0;10
1615;"Du gaideliai";Musyčių;4798503931;Taip;12;0;0;12
1616;"Du gaideliai";Musyčių;6870356241;Taip;4;0;0;4
1617;"Du gaideliai";Musyčių;6053941133;Taip;0;2;0;2
1618;"Du gaideliai";Musyčių;6120647567;Taip;0;7;0;7
1619;"Du gaideliai";Musyčių;8043896286;Taip;2;3;0;5
1620;"Du gaideliai";Musyčių;1156396094;Taip;22;0;0;22
1621;"Du gaideliai";Musyčių;7297661383;Taip;13;1;0;14
1622;"Du gaideliai";Musyčių;9356275460;Taip;7;0;0;7
1623;"Du gaideliai";Musyčių;6204233540;Taip;0;8;0;8
1624;"Du gaideliai";Musyčių;6015360076;Taip;0;11;0;11
1625;"Du gaideliai";Musyčių;5788923258;Taip;0;3;0;3
1626;"Du gaideliai";Musyčių;8047413507;Taip;6;1;0;7
1627;"Du gaideliai";MALŪNO;1968978650;Taip;10;0;0;10
1628;"Du gaideliai";MALŪNO;2100449108;Taip;0;10;1;11
1629;"Du gaideliai";MALŪNO;2905083899;Taip;10;0;0;10
1630;"Du gaideliai";MALŪNO;3019797369;Taip;15;0;0;15
1631;"Du gaideliai";MALŪNO;2151825222;Taip;0;7;0;7
1632;"Du gaideliai";MALŪNO;7575534590;Taip;5;0;0;5
1633;"Du gaideliai";MALŪNO;5728374219;Taip;0;6;0;6
1634;"Du gaideliai";MALŪNO;7726490359;Taip;14;0;0;14
1635;"Du gaideliai";MALŪNO;2845145754;Taip;0;11;0;11
1636;Eglutė;PELĖDŽIUKAI;60257242941;Taip;0;8;0;8
1637;Eglutė;PELĖDŽIUKAI;1909791840;Ne;0;0;1;1
1638;Eglutė;PELĖDŽIUKAI;2045454657;Ne;0;0;1;1
1639;Eglutė;PELĖDŽIUKAI;2395506996;Ne;6;0;3;9
1640;Eglutė;PELĖDŽIUKAI;43151626858;Taip;0;4;0;4
1641;Eglutė;PELĖDŽIUKAI;6323002362;Taip;0;0;1;1
1642;Eglutė;PELĖDŽIUKAI;64518610112;Taip;0;0;1;1
1643;Eglutė;PELĖDŽIUKAI;1954232966;Ne;5;0;0;5
1644;Eglutė;PELĖDŽIUKAI;18202528233;Taip;0;0;6;6
1645;Eglutė;PELĖDŽIUKAI;55334393780;Taip;0;8;0;8
1646;Eglutė;PELĖDŽIUKAI;40880035310;Taip;0;1;5;6
1647;Eglutė;PELĖDŽIUKAI;5214574745;Ne;0;8;0;8
1648;Eglutė;PELĖDŽIUKAI;82988135134;Taip;0;0;2;2
1649;Eglutė;PELĖDŽIUKAI;93427464717;Taip;11;0;0;11
1650;Eglutė;PELĖDŽIUKAI;37576322876;Taip;0;0;2;2
1651;Eglutė;PELĖDŽIUKAI;46002742287;Ne;0;0;4;4
1652;Eglutė;PELĖDŽIUKAI;3997033;Ne;0;13;0;13
1653;Eglutė;PELĖDŽIUKAI;75229333120;Ne;0;4;0;4
1654;Eglutė;PELĖDŽIUKAI;44421461989;Taip;0;4;1;5
1655;Eglutė;PELĖDŽIUKAI;84721839602;Taip;0;0;2;2
1656;Eglutė;KODĖLČIUKAI;85964105325;Taip;7;0;0;7
1657;Eglutė;KODĖLČIUKAI;1939447097;Ne;0;1;0;1
1658;Eglutė;KODĖLČIUKAI;1881111005;Ne;0;1;0;1
1659;Eglutė;KODĖLČIUKAI;1100326735;Ne;3;1;1;5
1660;Eglutė;KODĖLČIUKAI;1398611395;Taip;0;4;0;4
1661;Eglutė;KODĖLČIUKAI;2041825568;Taip;5;1;0;6
1662;Eglutė;KODĖLČIUKAI;1814357743;Ne;0;0;3;3
1663;Eglutė;KODĖLČIUKAI;2147042152;Taip;0;3;4;7
1664;Eglutė;KODĖLČIUKAI;78489473446;Taip;0;1;0;1
1665;Eglutė;KODĖLČIUKAI;63268716266;Taip;0;3;0;3
1666;Eglutė;KODĖLČIUKAI;1418516444;Taip;0;1;0;1
1667;Eglutė;KODĖLČIUKAI;2112417439;Ne;0;6;0;6
1668;Eglutė;KODĖLČIUKAI;1426211949;Ne;0;4;0;4
1669;Eglutė;KODĖLČIUKAI;1120848949;Taip;0;2;0;2
1670;Eglutė;KODĖLČIUKAI;1882915662;Taip;0;1;1;2
1671;Eglutė;KODĖLČIUKAI;1747424609;Taip;0;0;1;1
1672;Eglutė;KODĖLČIUKAI;1187563631;Taip;6;5;0;11
1673;Eglutė;KODĖLČIUKAI;90878878800;Taip;4;1;1;6
1674;Eglutė;KODĖLČIUKAI;7132999520;Taip;0;6;0;6
1675;Eglutė;KODĖLČIUKAI;7149060118;Ne;0;1;0;1
1676;Eglutė;OBUOLIUKAI;7047262367;Taip;5;2;0;7
1677;Eglutė;OBUOLIUKAI;3584247594;Taip;0;6;0;6
1678;Eglutė;OBUOLIUKAI;9967488317;Taip;8;0;0;8
1679;Eglutė;OBUOLIUKAI;6362265057;Taip;0;0;7;7
1680;Eglutė;OBUOLIUKAI;7404631298;Taip;17;0;0;17
1681;Eglutė;OBUOLIUKAI;1759383841;Taip;0;4;0;4
1682;Eglutė;OBUOLIUKAI;5924994736;Taip;0;0;7;7
1683;Eglutė;OBUOLIUKAI;7446423510;Taip;9;0;5;14
1684;Eglutė;OBUOLIUKAI;3390360525;Taip;0;0;1;1
1685;Eglutė;OBUOLIUKAI;7758643349;Taip;6;10;2;18
1686;Eglutė;OBUOLIUKAI;4348313801;Taip;0;0;9;9
1687;Eglutė;OBUOLIUKAI;4176597208;Taip;4;0;3;7
1688;Eglutė;OBUOLIUKAI;3883122650;Taip;4;2;0;6
1689;Eglutė;OBUOLIUKAI;9402686801;Taip;5;10;0;15
1690;Eglutė;OBUOLIUKAI;8165126017;Taip;4;0;0;4
1691;Eglutė;OBUOLIUKAI;8943684351;Taip;3;0;2;5
1692;Eglutė;OBUOLIUKAI;9046652370;Taip;0;0;18;18
1693;Eglutė;OBUOLIUKAI;6597261061;Taip;0;10;0;10
1694;Eglutė;OBUOLIUKAI;6483580751;Ne;0;2;0;2
1695;Eglutė;OBUOLIUKAI;7859815752;Taip;14;3;5;22
1696;Eglutė;OBUOLIUKAI;9356785605;Ne;0;14;0;14
1697;Eglutė;EŽIUKAI;20502611523;Taip;0;0;1;1
1698;Eglutė;EŽIUKAI;6570561861;Taip;0;0;1;1
1699;Eglutė;EŽIUKAI;8213137021;Taip;0;0;1;1
1700;Eglutė;EŽIUKAI;5604605766;Taip;4;0;3;7
1701;Eglutė;EŽIUKAI;4846517870;Taip;0;0;2;2
1702;Eglutė;EŽIUKAI;51884188642;Taip;0;0;4;4
1703;Eglutė;EŽIUKAI;62257831469;Taip;0;0;6;6
1704;Eglutė;EŽIUKAI;15019818974;Taip;0;5;0;5
1705;Eglutė;EŽIUKAI;9169758481;Ne;0;0;1;1
1706;Eglutė;EŽIUKAI;3725462135;Taip;0;1;0;1
1707;Eglutė;EŽIUKAI;92489023262;Taip;3;0;5;8
1708;Eglutė;EŽIUKAI;77296894224;Taip;5;3;0;8
1709;Eglutė;EŽIUKAI;6542189095;Ne;0;2;3;5
1710;Eglutė;EŽIUKAI;7506194777;Taip;0;10;0;10
1711;Eglutė;EŽIUKAI;1905376778;Taip;0;0;1;1
1712;Eglutė;EŽIUKAI;1308252968;Taip;0;0;1;1
1713;Eglutė;EŽIUKAI;60500002903;Taip;0;0;3;3
1714;Eglutė;EŽIUKAI;59228063911;Taip;0;0;3;3
1715;Eglutė;EŽIUKAI;12750056416;Taip;0;0;1;1
1716;Eglutė;EŽIUKAI;4570145972;Taip;0;0;2;2
1717;Eglutė;EŽIUKAI;89786711506;Taip;0;0;9;9
1718;Eglutė;GILĖ;7148210944;Ne;0;5;0;5
1719;Eglutė;GILĖ;3616979217;Ne;0;3;0;3
1720;Eglutė;GILĖ;9333028072;Taip;0;0;2;2
1721;Eglutė;GILĖ;2638807860;Taip;0;0;7;7
1722;Eglutė;GILĖ;8033370429;Ne;0;0;1;1
1723;Eglutė;GILĖ;3203786388;Taip;9;0;1;10
1724;Eglutė;GILĖ;9950953029;Taip;0;0;1;1
1725;Eglutė;GILĖ;3178489517;Taip;0;0;2;2
1726;Eglutė;GILĖ;6518497374;Ne;7;1;0;8
1727;Eglutė;GILĖ;6835296034;Taip;0;1;1;2
1728;Eglutė;GILĖ;8606991706;Taip;0;0;3;3
1729;Eglutė;GILĖ;1324622835;Taip;0;0;1;1
1730;Eglutė;GILĖ;2082716398;Taip;0;0;1;1
1731;Eglutė;GILĖ;1510706652;Taip;0;3;0;3
1732;Eglutė;GILĖ;1695732622;Taip;0;3;0;3
1733;Eglutė;GILĖ;3393414294;Taip;0;1;0;1
1734;Eglutė;GILĖ;9066178904;Taip;9;0;0;9
1735;Eglutė;GILĖ;5856250605;Ne;5;10;0;15
1736;Eglutė;ŠARKELĖ;1932785408;Taip;0;5;8;13
1737;Eglutė;ŠARKELĖ;4490295754;Taip;0;1;0;1
1738;Eglutė;NYKŠTUKAI;9686836846;Taip;14;1;2;17
1739;Eglutė;NYKŠTUKAI;5166183300;Taip;0;7;0;7
1740;Eglutė;NYKŠTUKAI;8534997648;Taip;9;0;4;13
1741;Eglutė;ŽIRNIUKAI;6924344686;Taip;22;0;0;22
1742;Eglutė;ŽIRNIUKAI;5190045146;Taip;0;2;0;2
1743;Eglutė;ŽIRNIUKAI;1393626624;Taip;0;0;2;2
1744;Eglutė;ŽIRNIUKAI;6272115803;Ne;5;0;0;5
1745;Eglutė;ŽIRNIUKAI;2857760751;Taip;7;0;0;7
1746;Eglutė;ŽIRNIUKAI;8888784168;Taip;0;3;0;3
1747;Eglutė;ŽIRNIUKAI;9439982416;Taip;0;7;1;8
1748;Eglutė;ŽIRNIUKAI;2621445549;Taip;10;2;0;12
1749;Eglutė;ŽIRNIUKAI;9172488122;Taip;0;8;0;8
1750;Eglutė;ŽIRNIUKAI;1550045866;Taip;0;5;1;6
1751;Eglutė;ŽIRNIUKAI;3605053253;Taip;16;0;0;16
1752;Eglutė;ŽIRNIUKAI;2240154775;Taip;0;0;3;3
1753;Eglutė;ŽIRNIUKAI;8797889347;Taip;1;0;0;1
1754;Eglutė;ŽIRNIUKAI;8129230197;Taip;7;1;0;8
1755;Eglutė;ŽIRNIUKAI;5006042568;Taip;0;9;0;9
1756;Eglutė;ŽIRNIUKAI;5275306818;Taip;0;19;0;19
1757;Eglutė;BORUŽIUKAI;1122907387;Taip;1;0;0;1
1758;Eglutė;BORUŽIUKAI;2816913563;Taip;6;0;4;10
1759;Eglutė;BORUŽIUKAI;1842517164;Taip;0;0;22;22
1760;Eglutė;BORUŽIUKAI;2357276888;Taip;2;6;0;8
1761;Eglutė;BORUŽIUKAI;6899575758;Taip;0;10;0;10
1762;Eglutė;BORUŽIUKAI;7530638623;Taip;0;17;0;17
1763;Eglutė;BORUŽIUKAI;8520403894;Taip;6;0;0;6
1764;Eglutė;BORUŽIUKAI;8711567312;Taip;0;0;22;22
1765;Eglutė;BORUŽIUKAI;3237476593;Taip;13;0;0;13
1766;Eglutė;BORUŽIUKAI;6328900251;Taip;0;1;0;1
1767;Eglutė;BORUŽIUKAI;1531942494;Taip;0;13;2;15
1768;Eglutė;BORUŽIUKAI;9661883776;Ne;0;15;0;15
1769;Eglutė;BORUŽIUKAI;5505398901;Taip;0;16;0;16
1770;Eglutė;BORUŽIUKAI;1872459729;Taip;0;0;10;10
1771;Eglutė;BORUŽIUKAI;5650957826;Ne;9;5;0;14
1772;"Geniukų kalvė";SAULUTĖS;4691978116;Ne;0;11;0;11
1773;"Geniukų kalvė";SAULUTĖS;2271582954;Taip;10;0;0;10
1774;"Geniukų kalvė";SAULUTĖS;9557055841;Ne;22;0;0;22
1775;"Geniukų kalvė";SAULUTĖS;3111400962;Taip;10;0;0;10
1776;"Geniukų kalvė";SAULUTĖS;4329782598;Taip;0;11;2;13
1777;"Geniukų kalvė";SAULUTĖS;8932671578;Taip;6;0;1;7
1778;"Geniukų kalvė";SAULUTĖS;9711047774;Taip;0;0;1;1
1779;"Geniukų kalvė";SAULUTĖS;1910363787;Taip;0;2;0;2
1780;"Geniukų kalvė";SAULUTĖS;7940706717;Taip;6;0;4;10
1781;"Geniukų kalvė";SAULUTĖS;9522911738;Ne;14;4;0;18
1782;"Geniukų kalvė";SAULUTĖS;4603185679;Taip;0;14;8;22
1783;"Geniukų kalvė";SAULUTĖS;5348211316;Taip;0;5;0;5
1784;"Geniukų kalvė";SAULUTĖS;7886553419;Taip;0;4;0;4
1785;"Geniukų kalvė";SAULUTĖS;6384832317;Taip;9;0;9;18
1786;"Geniukų kalvė";SAULUTĖS;4946218794;Taip;0;0;1;1
1787;"Geniukų kalvė";SAULUTĖS;7289942679;Ne;15;0;3;18
1788;"Geniukų kalvė";SAULUTĖS;4745451344;Taip;0;0;3;3
1789;"Geniukų kalvė";SAULUTĖS;7889781552;Taip;0;0;6;6
1790;"Geniukų kalvė";SAULUTĖS;3889643236;Ne;8;0;0;8
1791;"Geniukų kalvė";BITUTĖS;7745656622;Ne;0;1;0;1
1792;"Geniukų kalvė";BITUTĖS;6520429663;Taip;0;3;0;3
1793;"Geniukų kalvė";BITUTĖS;2718961466;Taip;0;9;0;9
1794;"Geniukų kalvė";BITUTĖS;4967513360;Ne;0;1;0;1
1795;"Geniukų kalvė";BITUTĖS;2016254460;Taip;0;8;0;8
1796;"Geniukų kalvė";BITUTĖS;4105170344;Taip;0;1;0;1
1797;"Geniukų kalvė";BITUTĖS;8872900558;Taip;0;2;0;2
1798;"Geniukų kalvė";BITUTĖS;6511955882;Taip;0;5;0;5
1799;"Geniukų kalvė";BITUTĖS;6500641378;Taip;0;2;0;2
1800;"Geniukų kalvė";BITUTĖS;3984265624;Taip;15;0;0;15
1801;"Geniukų kalvė";BITUTĖS;4813232640;Taip;0;5;1;6
1802;"Geniukų kalvė";BITUTĖS;9676782662;Ne;0;1;0;1
1803;"Geniukų kalvė";BITUTĖS;2031800114;Taip;0;1;0;1
1804;"Geniukų kalvė";BITUTĖS;5542539934;Taip;0;0;1;1
1805;"Geniukų kalvė";KIŠKUČIAI;1568133009;Ne;11;5;0;16
1806;"Geniukų kalvė";KIŠKUČIAI;7664689396;Taip;4;0;0;4
1807;"Geniukų kalvė";KIŠKUČIAI;4844734556;Taip;0;1;0;1
1808;"Geniukų kalvė";KIŠKUČIAI;4758435835;Taip;5;1;0;6
1809;"Geniukų kalvė";KIŠKUČIAI;2729442911;Ne;0;1;0;1
1810;"Geniukų kalvė";KIŠKUČIAI;4661051023;Taip;2;1;0;3
1811;"Geniukų kalvė";KIŠKUČIAI;23023070502;Taip;0;4;0;4
1812;"Geniukų kalvė";KIŠKUČIAI;8668696743;Ne;6;2;0;8
1813;"Geniukų kalvė";KIŠKUČIAI;2262014110;Taip;0;2;0;2
1814;"Geniukų kalvė";KIŠKUČIAI;1947173142;Taip;0;5;0;5
1815;"Geniukų kalvė";KIŠKUČIAI;43097490633;Taip;0;5;0;5
1816;"Geniukų kalvė";KIŠKUČIAI;2043786151;Taip;2;2;0;4
1817;"Geniukų kalvė";KIŠKUČIAI;8939171238;Ne;0;1;0;1
1818;"Geniukų kalvė";KIŠKUČIAI;2140334255;Taip;5;1;0;6
1819;"Geniukų kalvė";KIŠKUČIAI;2301758912;Taip;2;1;4;7
1820;"Geniukų kalvė";KIŠKUČIAI;8635708009;Taip;22;0;0;22
1821;"Geniukų kalvė";KIŠKUČIAI;9081596975;Ne;5;0;0;5
1822;"Geniukų kalvė";KIŠKUČIAI;30932565379;Taip;0;2;1;3
1823;"Geniukų kalvė";KIŠKUČIAI;2337226175;Taip;0;3;0;3
1824;"Geniukų kalvė";VYTURĖLIAI;37670000746;Taip;0;2;1;3
1825;"Geniukų kalvė";VYTURĖLIAI;14839311346;Taip;0;4;0;4
1826;"Geniukų kalvė";VYTURĖLIAI;31140342871;Taip;7;2;1;10
1827;"Geniukų kalvė";VYTURĖLIAI;70097449722;Taip;5;2;0;7
1828;"Geniukų kalvė";VYTURĖLIAI;11476134327;Taip;0;1;0;1
1829;"Geniukų kalvė";VYTURĖLIAI;68752448767;Taip;0;1;2;3
1830;"Geniukų kalvė";VYTURĖLIAI;57595197116;Taip;0;5;0;5
1831;"Geniukų kalvė";VYTURĖLIAI;61225085978;Taip;0;0;13;13
1832;"Geniukų kalvė";VYTURĖLIAI;83623361401;Ne;0;2;1;3
1833;"Geniukų kalvė";VYTURĖLIAI;87751274075;Taip;0;5;0;5
1834;"Geniukų kalvė";VYTURĖLIAI;91734868433;Ne;0;2;2;4
1835;"Geniukų kalvė";VYTURĖLIAI;1829858221;Taip;0;8;0;8
1836;"Geniukų kalvė";VYTURĖLIAI;1624933726;Taip;21;0;0;21
1837;"Geniukų kalvė";VYTURĖLIAI;1658082075;Taip;0;0;11;11
1838;"Geniukų kalvė";VYTURĖLIAI;1239061261;Taip;0;10;0;10
1839;"Geniukų kalvė";DRUGELIAI;1073117547;Ne;0;0;1;1
1840;"Geniukų kalvė";DRUGELIAI;51353124475;Ne;0;6;0;6
1841;"Geniukų kalvė";DRUGELIAI;30865528880;Taip;0;1;0;1
1842;"Geniukų kalvė";DRUGELIAI;66632618838;Taip;0;2;0;2
1843;"Geniukų kalvė";DRUGELIAI;35180545728;Taip;6;0;1;7
1844;"Geniukų kalvė";DRUGELIAI;88543141650;Taip;2;0;0;2
1845;"Geniukų kalvė";DRUGELIAI;27479616927;Taip;8;0;0;8
1846;"Geniukų kalvė";DRUGELIAI;30015301622;Taip;0;0;3;3
1847;"Geniukų kalvė";DRUGELIAI;74161080879;Taip;3;0;1;4
1848;"Geniukų kalvė";DRUGELIAI;50218457812;Ne;8;1;0;9
1849;"Geniukų kalvė";DRUGELIAI;2038860438;Ne;3;0;10;13
1850;"Geniukų kalvė";DRUGELIAI;93542861144;Taip;0;5;1;6
1851;"Geniukų kalvė";DRUGELIAI;1923449545;Ne;0;1;2;3
1852;"Geniukų kalvė";DRUGELIAI;1246234700;Ne;4;0;1;5
1853;"Geniukų kalvė";"SAULĖS ZUIKUČIAI";49352255237;Ne;0;1;0;1
1854;"Geniukų kalvė";"SAULĖS ZUIKUČIAI";90227736128;Taip;0;5;0;5
1855;"Geniukų kalvė";"SAULĖS ZUIKUČIAI";1806626063;Taip;0;4;0;4
1856;"Geniukų kalvė";"SAULĖS ZUIKUČIAI";1776042329;Taip;17;0;0;17
1857;"Geniukų kalvė";"SAULĖS ZUIKUČIAI";1716204178;Ne;3;1;9;13
1858;"Geniukų kalvė";"SAULĖS ZUIKUČIAI";1774738349;Taip;0;1;0;1
1859;"Geniukų kalvė";"SAULĖS ZUIKUČIAI";2120890722;Taip;0;16;0;16
1860;"Geniukų kalvė";"SAULĖS ZUIKUČIAI";87718471880;Taip;3;0;4;7
1861;"Geniukų kalvė";"SAULĖS ZUIKUČIAI";1415719190;Ne;5;8;0;13
1862;"Geniukų kalvė";"SAULĖS ZUIKUČIAI";83443339743;Taip;5;0;5;10
1863;"Geniukų kalvė";"SAULĖS ZUIKUČIAI";26215340428;Taip;0;5;0;5
1864;"Geniukų kalvė";"SAULĖS ZUIKUČIAI";1084055203;Taip;0;3;1;4
1865;"Geniukų kalvė";"SAULĖS ZUIKUČIAI";1810973279;Ne;0;2;0;2
1866;"Geniukų kalvė";"SAULĖS ZUIKUČIAI";2094764804;Ne;10;0;0;10
1867;"Geniukų kalvė";"SAULĖS ZUIKUČIAI";3553253934;Taip;6;0;2;8
1868;"Geniukų kalvė";"SAULĖS ZUIKUČIAI";9669281441;Taip;6;0;1;7
1869;"Geniukų kalvė";"SAULĖS ZUIKUČIAI";3599151643;Taip;5;0;2;7
1870;"Geniukų kalvė";"SAULĖS ZUIKUČIAI";1818485774;Taip;0;1;1;2
1871;"Geniukų kalvė";SMALSUČIAI;44345867922;Taip;14;1;0;15
1872;"Geniukų kalvė";SMALSUČIAI;6928979691;Ne;15;0;0;15
1873;"Geniukų kalvė";SMALSUČIAI;82277353185;Taip;0;0;5;5
1874;"Geniukų kalvė";SMALSUČIAI;19181427380;Taip;9;3;0;12
1875;"Geniukų kalvė";SMALSUČIAI;1684481833;Taip;6;0;0;6
1876;"Geniukų kalvė";SMALSUČIAI;14939415217;Taip;9;0;2;11
1877;"Geniukų kalvė";SMALSUČIAI;1990303616;Taip;0;1;2;3
1878;"Geniukų kalvė";SMALSUČIAI;62774512989;Ne;22;0;0;22
1879;"Geniukų kalvė";SMALSUČIAI;45542289762;Taip;0;6;0;6
1880;"Geniukų kalvė";SMALSUČIAI;23964009189;Taip;7;11;0;18
1881;"Geniukų kalvė";SMALSUČIAI;42328019754;Taip;0;7;1;8
1882;"Geniukų kalvė";SMALSUČIAI;90435684305;Taip;0;6;0;6
1883;"Geniukų kalvė";SMALSUČIAI;84974376966;Taip;2;0;0;2
1884;"Geniukų kalvė";SMALSUČIAI;97616612192;Ne;0;8;0;8
1885;"Geniukų kalvė";SMALSUČIAI;67762121244;Ne;5;2;0;7
1886;"Geniukų kalvė";SMALSUČIAI;2003986836;Taip;11;4;0;15
1887;"Geniukų kalvė";SMALSUČIAI;5792552722;Taip;0;9;1;10
1888;"Geniukų kalvė";SMALSUČIAI;6253940549;Taip;2;0;3;5
1889;"Geniukų kalvė";SMALSUČIAI;9416843495;Taip;2;0;0;2
1890;"Geniukų kalvė";RUDNOSIUKAI;2082749897;Taip;0;12;0;12
1891;"Geniukų kalvė";RUDNOSIUKAI;7352976665;Ne;0;0;9;9
1892;"Geniukų kalvė";RUDNOSIUKAI;12109348143;Taip;0;1;0;1
1893;"Geniukų kalvė";RUDNOSIUKAI;87858628237;Taip;0;2;0;2
1894;"Geniukų kalvė";RUDNOSIUKAI;36553641202;Taip;0;2;0;2
1895;"Geniukų kalvė";RUDNOSIUKAI;36295276899;Ne;0;2;0;2
1896;"Geniukų kalvė";RUDNOSIUKAI;16810843163;Taip;0;0;2;2
1897;"Geniukų kalvė";RUDNOSIUKAI;56705168000;Taip;8;0;1;9
1898;"Geniukų kalvė";RUDNOSIUKAI;75926614045;Ne;0;1;0;1
1899;"Geniukų kalvė";RUDNOSIUKAI;96448080708;Taip;0;10;0;10
1900;"Geniukų kalvė";RUDNOSIUKAI;1794537433;Taip;0;3;0;3
1901;"Geniukų kalvė";RUDNOSIUKAI;29353737550;Taip;0;2;0;2
1902;"Geniukų kalvė";RUDNOSIUKAI;22074236863;Taip;5;0;0;5
1903;"Geniukų kalvė";RUDNOSIUKAI;7269049874;Taip;0;13;0;13
1904;"Geniukų kalvė";PELĖDŽIUKAI;3826265557;Taip;17;0;0;17
1905;"Geniukų kalvė";PELĖDŽIUKAI;8271041553;Ne;0;1;0;1
1906;"Geniukų kalvė";PELĖDŽIUKAI;1237228692;Taip;0;0;7;7
1907;"Geniukų kalvė";PELĖDŽIUKAI;2938446054;Taip;0;1;0;1
1908;"Geniukų kalvė";PELĖDŽIUKAI;9976423099;Taip;19;0;0;19
1909;"Geniukų kalvė";PELĖDŽIUKAI;9990243525;Taip;0;0;5;5
1910;"Geniukų kalvė";PELĖDŽIUKAI;1051563985;Taip;3;3;0;6
1911;"Geniukų kalvė";PELĖDŽIUKAI;6174114461;Ne;9;0;0;9
1912;"Geniukų kalvė";PELĖDŽIUKAI;2659298240;Taip;0;5;0;5
1913;"Geniukų kalvė";PELĖDŽIUKAI;6024288147;Taip;0;1;0;1
1914;"Geniukų kalvė";PELĖDŽIUKAI;6737863183;Taip;4;12;0;16
1915;"Geniukų kalvė";PELĖDŽIUKAI;5704223824;Taip;0;3;0;3
1916;"Geniukų kalvė";PELĖDŽIUKAI;1811866428;Ne;9;2;0;11
1917;"Geniukų kalvė";PELĖDŽIUKAI;6410008429;Taip;0;1;0;1
1918;"Geniukų kalvė";PELĖDŽIUKAI;4843411757;Taip;8;4;0;12
1919;"Geniukų kalvė";PELĖDŽIUKAI;8770345339;Taip;8;9;0;17
1920;"Geniukų kalvė";BORUŽĖLĖS;9613720001;Taip;0;5;0;5
1921;"Geniukų kalvė";BORUŽĖLĖS;4958738745;Taip;0;7;0;7
1922;"Geniukų kalvė";BORUŽĖLĖS;4271763719;Taip;5;0;2;7
1923;"Geniukų kalvė";BORUŽĖLĖS;9069256760;Ne;11;0;1;12
1924;"Geniukų kalvė";BORUŽĖLĖS;5161535756;Taip;6;5;0;11
1925;"Geniukų kalvė";BORUŽĖLĖS;3493492581;Taip;0;6;0;6
1926;"Geniukų kalvė";BORUŽĖLĖS;3085228868;Taip;5;0;0;5
1927;"Geniukų kalvė";BORUŽĖLĖS;3180116136;Taip;0;9;7;16
1928;"Geniukų kalvė";BORUŽĖLĖS;2904091819;Ne;0;2;2;4
1929;"Geniukų kalvė";BORUŽĖLĖS;6794151223;Taip;0;2;0;2
1930;"Geniukų kalvė";BORUŽĖLĖS;4777155321;Taip;14;1;0;15
1931;"Geniukų kalvė";BORUŽĖLĖS;1037854104;Ne;5;2;1;8
1932;"Geniukų kalvė";BORUŽĖLĖS;2180860623;Ne;0;2;0;2
1933;"Geniukų kalvė";BORUŽĖLĖS;7471964981;Ne;2;0;15;17
1934;"Geniukų kalvė";BORUŽĖLĖS;8769761434;Taip;2;9;0;11
1935;"Geniukų kalvė";BORUŽĖLĖS;1891205998;Ne;0;6;0;6
1936;"Geniukų kalvė";BORUŽĖLĖS;9643242164;Ne;0;13;0;13
1937;"Geniukų kalvė";BORUŽĖLĖS;2665955524;Taip;2;0;0;2
1938;"Geniukų kalvė";BORUŽĖLĖS;4872435715;Taip;0;0;6;6
1939;"Geniukų kalvė";PAGRANDUKAI;9696452101;Taip;0;1;0;1
1940;"Geniukų kalvė";PAGRANDUKAI;2165793561;Taip;0;2;0;2
1941;"Geniukų kalvė";PAGRANDUKAI;1229056613;Taip;0;8;0;8
1942;"Geniukų kalvė";PAGRANDUKAI;7300853810;Taip;5;0;1;6
1943;"Geniukų kalvė";PAGRANDUKAI;2839299179;Taip;9;0;0;9
1944;"Geniukų kalvė";PAGRANDUKAI;6623491459;Taip;8;0;0;8
1945;"Geniukų kalvė";PAGRANDUKAI;2836282651;Ne;7;0;0;7
1946;"Geniukų kalvė";PAGRANDUKAI;9847003556;Ne;7;0;0;7
1947;"Geniukų kalvė";PAGRANDUKAI;3852896932;Taip;9;0;4;13
1948;"Geniukų kalvė";PAGRANDUKAI;1587839122;Taip;3;0;0;3
1949;"Geniukų kalvė";PAGRANDUKAI;4664026888;Taip;3;0;0;3
1950;"Geniukų kalvė";PAGRANDUKAI;5443596677;Taip;0;1;0;1
1951;"Geniukų kalvė";PAGRANDUKAI;5205178173;Taip;19;0;0;19
1952;"Geniukų kalvė";PAGRANDUKAI;7057284039;Taip;17;0;0;17
1953;"Geniukų kalvė";NYKŠTUKAI;4633553106;Taip;10;0;0;10
1954;"Geniukų kalvė";NYKŠTUKAI;5245434552;Taip;0;1;2;3
1955;"Geniukų kalvė";NYKŠTUKAI;1375674317;Taip;8;0;0;8
1956;"Geniukų kalvė";NYKŠTUKAI;7744441981;Taip;2;0;2;4
1957;"Geniukų kalvė";NYKŠTUKAI;1209268848;Taip;2;0;0;2
1958;"Geniukų kalvė";NYKŠTUKAI;5512172533;Taip;0;6;0;6
1959;"Geniukų kalvė";NYKŠTUKAI;1499735818;Taip;12;4;0;16
1960;"Geniukų kalvė";NYKŠTUKAI;2110578252;Taip;0;1;2;3
1961;"Geniukų kalvė";NYKŠTUKAI;1718428600;Taip;7;0;0;7
1962;"Geniukų kalvė";NYKŠTUKAI;5725034297;Taip;12;0;0;12
1963;"Geniukų kalvė";NYKŠTUKAI;8071493871;Taip;12;3;0;15
1964;"Geniukų kalvė";NYKŠTUKAI;2816691996;Taip;0;9;2;11
1965;"Geniukų kalvė";NYKŠTUKAI;5763009912;Taip;0;0;2;2
1966;"Geniukų kalvė";NYKŠTUKAI;6016585056;Taip;6;3;0;9
1967;Gelvonėlis;ĄŽUOLIUKAI;7919814808;Ne;5;3;0;8
1968;Gelvonėlis;ĄŽUOLIUKAI;3830940009;Taip;0;7;0;7
1969;Gelvonėlis;ĄŽUOLIUKAI;3147489259;Taip;0;3;0;3
1970;Gelvonėlis;ĄŽUOLIUKAI;2140799517;Taip;15;0;1;16
1971;Gelvonėlis;ĄŽUOLIUKAI;1284359362;Taip;0;8;0;8
1972;Gelvonėlis;ĄŽUOLIUKAI;9798684265;Taip;2;5;0;7
1973;Gelvonėlis;ĄŽUOLIUKAI;8775661719;Taip;0;1;0;1
1974;Gelvonėlis;ĄŽUOLIUKAI;21684706944;Taip;4;0;0;4
1975;Gelvonėlis;ĄŽUOLIUKAI;75676389361;Taip;6;0;0;6
1976;Gelvonėlis;ĄŽUOLIUKAI;2077783219;Taip;5;1;1;7
1977;Gelvonėlis;ĄŽUOLIUKAI;3089755141;Taip;9;3;0;12
1978;Gelvonėlis;ĄŽUOLIUKAI;1408313697;Taip;0;0;2;2
1979;Gelvonėlis;ĄŽUOLIUKAI;3670612781;Ne;10;1;0;11
1980;Gelvonėlis;ĄŽUOLIUKAI;69073786634;Taip;9;2;0;11
1981;Gelvonėlis;ĄŽUOLIUKAI;29928181395;Taip;0;5;0;5
1982;Gelvonėlis;ĄŽUOLIUKAI;6255253658;Taip;3;3;2;8
1983;Gelvonėlis;ĄŽUOLIUKAI;5511174729;Taip;10;0;5;15
1984;Gelvonėlis;ĄŽUOLIUKAI;1624125024;Taip;0;3;2;5
1985;Gelvonėlis;ĄŽUOLIUKAI;9387523651;Ne;0;5;0;5
1986;Gelvonėlis;ŽVIRBLIUKAI;1772713183;Taip;11;0;0;11
1987;Gelvonėlis;ŽVIRBLIUKAI;1801724527;Taip;0;2;0;2
1988;Gelvonėlis;ŽVIRBLIUKAI;23181505838;Taip;0;10;0;10
1989;Gelvonėlis;ŽVIRBLIUKAI;2997738880;Taip;0;5;0;5
1990;Gelvonėlis;ŽVIRBLIUKAI;1373771258;Taip;0;3;0;3
1991;Gelvonėlis;ŽVIRBLIUKAI;92420286100;Taip;4;2;1;7
1992;Gelvonėlis;ŽVIRBLIUKAI;87746258537;Taip;0;3;0;3
1993;Gelvonėlis;ŽVIRBLIUKAI;6635285387;Taip;2;0;0;2
1994;Gelvonėlis;ŽVIRBLIUKAI;1938913528;Taip;0;7;0;7
1995;Gelvonėlis;ŽVIRBLIUKAI;2096702999;Taip;0;1;0;1
1996;Gelvonėlis;ŽVIRBLIUKAI;17044138057;Taip;5;0;5;10
1997;Gelvonėlis;ŽVIRBLIUKAI;84863800926;Taip;0;7;0;7
1998;Gelvonėlis;ŽVIRBLIUKAI;1355742622;Ne;11;5;0;16
1999;Gelvonėlis;ŽVIRBLIUKAI;90961913967;Taip;0;0;4;4
2000;Gelvonėlis;ŽVIRBLIUKAI;1827511187;Taip;5;0;0;5
2001;Gelvonėlis;ŽVIRBLIUKAI;1835508505;Taip;0;0;1;1
2002;Gelvonėlis;ŽVIRBLIUKAI;9784762153;Taip;0;2;6;8
2003;Gelvonėlis;ŽVIRBLIUKAI;9919860358;Taip;7;4;0;11
2004;Gelvonėlis;ŽVIRBLIUKAI;86895427397;Ne;12;0;0;12
2005;Gelvonėlis;RASELĖS;3325116198;Taip;0;0;2;2
2006;Gelvonėlis;RASELĖS;9847156800;Ne;6;9;0;15
2007;Gelvonėlis;RASELĖS;2153676615;Ne;10;1;0;11
2008;Gelvonėlis;RASELĖS;47302438188;Taip;15;0;0;15
2009;Gelvonėlis;RASELĖS;32893563601;Taip;0;6;0;6
2010;Gelvonėlis;RASELĖS;11697172905;Ne;0;6;0;6
2011;Gelvonėlis;RASELĖS;1221420212;Taip;11;0;0;11
2012;Gelvonėlis;RASELĖS;43145774484;Taip;5;0;0;5
2013;Gelvonėlis;RASELĖS;18237108866;Taip;0;2;0;2
2014;Gelvonėlis;RASELĖS;3271118581;Taip;3;0;1;4
2015;Gelvonėlis;RASELĖS;79607769503;Ne;0;2;0;2
2016;Gelvonėlis;RASELĖS;96792124844;Ne;0;2;0;2
2017;Gelvonėlis;RASELĖS;1400871061;Taip;0;0;3;3
2018;Gelvonėlis;RASELĖS;69221565557;Ne;0;0;1;1
2019;Gelvonėlis;RASELĖS;79899652046;Taip;0;6;1;7
2020;Gelvonėlis;RASELĖS;9108760720;Taip;0;5;0;5
2021;Gelvonėlis;RASELĖS;1776015014;Taip;9;0;0;9
2022;Gelvonėlis;SAULUTĖ;72859950160;Taip;0;1;0;1
2023;Gelvonėlis;SAULUTĖ;1512245903;Taip;9;0;0;9
2024;Gelvonėlis;SAULUTĖ;9396676137;Taip;6;0;0;6
2025;Gelvonėlis;SAULUTĖ;9353066785;Taip;5;1;0;6
2026;Gelvonėlis;SAULUTĖ;3121251271;Taip;0;11;0;11
2027;Gelvonėlis;SAULUTĖ;1750552925;Ne;0;7;0;7
2028;Gelvonėlis;SAULUTĖ;5098282548;Ne;18;0;0;18
2029;Gelvonėlis;SAULUTĖ;59592904001;Taip;7;0;0;7
2030;Gelvonėlis;SAULUTĖ;19782508652;Ne;0;5;0;5
2031;Gelvonėlis;SAULUTĖ;3859776410;Taip;0;15;0;15
2032;Gelvonėlis;SAULUTĖ;19955601762;Taip;9;5;0;14
2033;Gelvonėlis;SAULUTĖ;9595350871;Taip;8;0;0;8
2034;Gelvonėlis;SAULUTĖ;71806077882;Taip;0;15;0;15
2035;Gelvonėlis;SAULUTĖ;8475204684;Taip;0;14;0;14
2036;Gelvonėlis;SAULUTĖ;2622967319;Taip;9;0;0;9
2037;Gelvonėlis;SAULUTĖ;4830374546;Taip;0;13;0;13
2038;Gelvonėlis;SAULUTĖ;6226970200;Taip;7;3;0;10
2039;Gelvonėlis;SAULUTĖ;5759356754;Taip;3;7;0;10
2040;Gelvonėlis;SAULUTĖ;1042715433;Ne;9;6;0;15
2041;Gelvonėlis;PELĖDŽIUKAI;87693970225;Taip;0;13;0;13
2042;Gelvonėlis;PELĖDŽIUKAI;17021411833;Taip;4;5;0;9
2043;Gelvonėlis;PELĖDŽIUKAI;22201650331;Ne;0;3;0;3
2044;Gelvonėlis;PELĖDŽIUKAI;98009116912;Taip;4;0;0;4
2045;Gelvonėlis;PELĖDŽIUKAI;51375531815;Taip;0;0;2;2
2046;Gelvonėlis;PELĖDŽIUKAI;70550528579;Taip;0;2;0;2
2047;Gelvonėlis;PELĖDŽIUKAI;91507293029;Taip;0;1;0;1
2048;Gelvonėlis;PELĖDŽIUKAI;79847096929;Taip;0;0;3;3
2049;Gelvonėlis;PELĖDŽIUKAI;71199691102;Taip;11;0;6;17
2050;Gelvonėlis;PELĖDŽIUKAI;43250059460;Taip;1;3;0;4
2051;Gelvonėlis;PELĖDŽIUKAI;7277516341;Ne;2;0;0;2
2052;Gelvonėlis;PELĖDŽIUKAI;5393404051;Taip;0;0;1;1
2053;Gelvonėlis;PELĖDŽIUKAI;9970883470;Taip;9;3;0;12
2054;Gelvonėlis;PELĖDŽIUKAI;1902998389;Taip;0;0;2;2
2055;Gelvonėlis;PELĖDŽIUKAI;71076083278;Taip;4;0;3;7
2056;Gelvonėlis;DRUGELIAI;8209225630;Taip;10;0;0;10
2057;Gelvonėlis;DRUGELIAI;7936622964;Taip;12;5;0;17
2058;Gelvonėlis;DRUGELIAI;6856800484;Taip;3;0;0;3
2059;Gelvonėlis;DRUGELIAI;6554989142;Taip;3;4;0;7
2060;Gelvonėlis;DRUGELIAI;2698853686;Ne;3;12;0;15
2061;Gelvonėlis;DRUGELIAI;4112607183;Taip;0;1;0;1
2062;Gelvonėlis;DRUGELIAI;6585504578;Taip;14;6;0;20
2063;Gelvonėlis;DRUGELIAI;6243360625;Taip;0;8;0;8
2064;Gelvonėlis;DRUGELIAI;1587584701;Taip;5;2;0;7
2065;Gelvonėlis;DRUGELIAI;8515746171;Taip;0;1;0;1
2066;Gelvonėlis;DRUGELIAI;3719670896;Taip;9;1;0;10
2067;Gelvonėlis;VARPELIAI;3059903126;Taip;0;0;4;4
2068;Gelvonėlis;VARPELIAI;9149117970;Taip;0;0;3;3
2069;Gelvonėlis;VARPELIAI;3483144401;Taip;0;0;2;2
2070;Gelvonėlis;VARPELIAI;6451557430;Ne;0;9;0;9
2071;Gelvonėlis;VARPELIAI;6225854165;Taip;0;0;2;2
2072;Gelvonėlis;VARPELIAI;2791652988;Taip;7;0;0;7
2073;Gelvonėlis;VARPELIAI;2638430817;Ne;0;0;9;9
2074;Gelvonėlis;VARPELIAI;9600526942;Taip;0;9;0;9
2075;Gelvonėlis;VARPELIAI;1387948936;Taip;0;2;0;2
2076;Gelvonėlis;VARPELIAI;1462716950;Taip;7;0;1;8
2077;Gelvonėlis;VARPELIAI;6949090250;Taip;20;0;0;20
2078;Gelvonėlis;VARPELIAI;9622818893;Taip;6;0;1;7
2079;Gelvonėlis;VARPELIAI;7194091189;Ne;0;0;1;1
2080;Gelvonėlis;VARPELIAI;3446593424;Taip;10;0;1;11
2081;Gelvonėlis;VARPELIAI;5207153784;Taip;8;0;3;11
2082;Gelvonėlis;VARPELIAI;3730493822;Taip;0;0;2;2
2083;Gelvonėlis;BORUŽĖLĖS;1030246127;Taip;0;5;0;5
2084;Gelvonėlis;BORUŽĖLĖS;3379601736;Taip;5;13;0;18
2085;Gelvonėlis;BORUŽĖLĖS;1597669426;Taip;0;6;0;6
2086;Gelvonėlis;BORUŽĖLĖS;31744699590;Taip;10;0;0;10
2087;Gelvonėlis;BORUŽĖLĖS;4917453676;Ne;5;0;0;5
2088;Gelvonėlis;BORUŽĖLĖS;9777094764;Taip;8;0;0;8
2089;Gelvonėlis;BORUŽĖLĖS;3936144045;Taip;0;2;0;2
2090;Gelvonėlis;BORUŽĖLĖS;12715604772;Taip;0;6;0;6
2091;Gelvonėlis;BORUŽĖLĖS;8050788182;Taip;4;8;0;12
2092;Gelvonėlis;BORUŽĖLĖS;1183745610;Taip;0;13;0;13
2093;Gelvonėlis;BORUŽĖLĖS;6266298514;Ne;0;6;0;6
2094;Gelvonėlis;BORUŽĖLĖS;3284385491;Taip;0;16;0;16
2095;Gelvonėlis;BORUŽĖLĖS;1610362831;Ne;0;5;0;5
2096;Gelvonėlis;BORUŽĖLĖS;7903272826;Taip;4;0;1;5
2097;Gelvonėlis;NYKŠTUKAI;6604992169;Taip;1;4;0;5
2098;Gelvonėlis;NYKŠTUKAI;6556472766;Taip;3;1;2;6
2099;Gelvonėlis;NYKŠTUKAI;7182180008;Taip;0;8;0;8
2100;Gelvonėlis;NYKŠTUKAI;6598178467;Taip;3;4;1;8
2101;Gelvonėlis;NYKŠTUKAI;8885088900;Taip;0;1;0;1
2102;Gelvonėlis;NYKŠTUKAI;8622621570;Taip;19;0;3;22
2103;Gelvonėlis;NYKŠTUKAI;2400289466;Ne;6;5;0;11
2104;Gelvonėlis;NYKŠTUKAI;5129492284;Taip;4;2;0;6
2105;Gelvonėlis;NYKŠTUKAI;9493536517;Taip;2;0;1;3
2106;Gelvonėlis;NYKŠTUKAI;2288951845;Taip;8;0;0;8
2107;Gelvonėlis;NYKŠTUKAI;2515471132;Ne;12;0;5;17
2108;Gelvonėlis;NYKŠTUKAI;6319058542;Ne;8;3;0;11
2109;Gelvonėlis;NYKŠTUKAI;9538571448;Taip;2;7;0;9
2110;Gelvonėlis;NYKŠTUKAI;9147186080;Taip;3;0;0;3
2111;Gelvonėlis;NYKŠTUKAI;7620280474;Taip;11;1;0;12
2112;Gelvonėlis;NYKŠTUKAI;9059244134;Taip;0;1;0;1
2113;Gelvonėlis;NYKŠTUKAI;1987204544;Taip;0;9;0;9
2114;Gelvonėlis;NYKŠTUKAI;1085845218;Taip;6;0;0;6
2115;Gelvonėlis;NYKŠTUKAI;7195164378;Taip;5;0;0;5
2116;Gelvonėlis;NYKŠTUKAI;6153902752;Taip;0;0;22;22
2117;Gelvonėlis;BITUTĖS;7759317220;Ne;0;2;0;2
2118;Gelvonėlis;BITUTĖS;6196065515;Taip;0;3;0;3
2119;Gelvonėlis;BITUTĖS;2504468098;Taip;0;9;0;9
2120;Gelvonėlis;BITUTĖS;7983982378;Taip;0;2;0;2
2121;Gelvonėlis;BITUTĖS;5721858659;Taip;0;3;0;3
2122;Gelvonėlis;BITUTĖS;9667024635;Taip;8;0;0;8
2123;Gelvonėlis;BITUTĖS;2108690954;Taip;0;6;0;6
2124;Gelvonėlis;BITUTĖS;4855800131;Taip;0;3;0;3
2125;Gelvonėlis;BITUTĖS;1753617545;Taip;0;3;0;3
2126;Gelvonėlis;BITUTĖS;6189110767;Taip;7;7;0;14
2127;Gelvonėlis;BITUTĖS;3843881329;Taip;0;8;0;8
2128;Gelvonėlis;BITUTĖS;6317822775;Taip;0;0;1;1
2129;Gelvonėlis;BITUTĖS;9184192787;Taip;8;0;0;8
2130;Gelvonėlis;BITUTĖS;9369121356;Ne;8;0;0;8
2131;Gelvonėlis;BITUTĖS;2119550116;Taip;0;0;2;2
2132;Gelvonėlis;BITUTĖS;7826522180;Taip;0;0;2;2
2133;Gelvonėlis;BITUTĖS;9286500887;Taip;0;0;3;3
2134;Gelvonėlis;BITUTĖS;5095782784;Taip;8;0;0;8
2135;Gelvonėlis;BITUTĖS;1516164123;Taip;9;2;0;11
2136;Gelvonėlis;BITUTĖS;7226051965;Taip;6;0;0;6
2137;Gelvonėlis;BITUTĖS;3788522708;Taip;3;0;1;4
2138;Gelvonėlis;BITUTĖS;5047022305;Ne;0;0;5;5
2139;Gelvonėlis;RAMUNĖLĖS;3368423382;Taip;0;4;0;4
2140;Gelvonėlis;RAMUNĖLĖS;3973248307;Taip;11;0;0;11
2141;Gelvonėlis;RAMUNĖLĖS;5759407291;Taip;3;1;0;4
2142;Gelvonėlis;RAMUNĖLĖS;2163976198;Taip;21;0;0;21
2143;Gelvonėlis;RAMUNĖLĖS;5986018609;Taip;16;0;0;16
2144;Gelvonėlis;RAMUNĖLĖS;8766702456;Taip;0;5;0;5
2145;Gelvonėlis;RAMUNĖLĖS;1266479895;Taip;13;2;0;15
2146;Gelvonėlis;RAMUNĖLĖS;1004686756;Taip;9;0;0;9
2147;Gelvonėlis;RAMUNĖLĖS;5934077931;Taip;1;2;0;3
2148;Gelvonėlis;RAMUNĖLĖS;2734462553;Taip;4;1;0;5
2149;Gelvonėlis;RAMUNĖLĖS;4083370462;Taip;3;1;0;4
2150;Gelvonėlis;RAMUNĖLĖS;6068473734;Taip;5;3;0;8
2151;Gelvonėlis;RAMUNĖLĖS;8987012601;Taip;17;0;0;17
2152;Gervelė;ŽIRNIUKAI;9977349707;Taip;0;8;0;8
2153;Gervelė;ŽIRNIUKAI;7317091881;Taip;14;0;0;14
2154;Gervelė;ŽIRNIUKAI;4038179503;Taip;12;7;0;19
2155;Gervelė;ŽIRNIUKAI;4295743997;Taip;0;3;0;3
2156;Gervelė;ŽIRNIUKAI;7020599764;Taip;7;0;1;8
2157;Gervelė;ŽIRNIUKAI;4394752176;Taip;0;3;0;3
2158;Gervelė;ŽIRNIUKAI;6951455424;Taip;4;0;0;4
2159;Gervelė;ŽIRNIUKAI;9970293084;Taip;0;1;0;1
2160;Gervelė;ŽIRNIUKAI;8012122042;Taip;0;1;0;1
2161;Gervelė;ŽIRNIUKAI;1400044294;Taip;2;0;2;4
2162;Gervelė;ŽIRNIUKAI;5267617723;Taip;0;2;0;2
2163;Gervelė;ŽIRNIUKAI;5953552777;Taip;0;5;0;5
2164;Gervelė;ŽIRNIUKAI;6263562066;Ne;0;5;0;5
2165;Gervelė;ŽIRNIUKAI;6987657237;Taip;4;0;0;4
2166;Gervelė;LAŠIUKAI;8062089041;Taip;0;3;0;3
2167;Gervelė;LAŠIUKAI;2551280794;Taip;5;7;0;12
2168;Gervelė;LAŠIUKAI;1616949023;Taip;9;7;0;16
2169;Gervelė;LAŠIUKAI;3427400844;Taip;1;0;7;8
2170;Gervelė;LAŠIUKAI;8152446576;Taip;0;11;0;11
2171;Gervelė;LAŠIUKAI;6967078836;Taip;0;2;0;2
2172;Gervelė;LAŠIUKAI;7302238728;Ne;0;3;0;3
2173;Gervelė;LAŠIUKAI;5989713844;Taip;10;2;0;12
2174;Gervelė;LAŠIUKAI;4560752068;Taip;0;11;0;11
2175;Gervelė;LAŠIUKAI;1704033440;Taip;8;2;0;10
2176;Gervelė;LAŠIUKAI;4705514590;Ne;0;16;0;16
2177;Gervelė;LAŠIUKAI;89076506192;Taip;9;0;2;11
2178;Gervelė;LAŠIUKAI;87619285504;Taip;6;3;1;10
2179;Gervelė;LAŠIUKAI;1991238577;Taip;0;12;0;12
2180;Gervelė;LAŠIUKAI;2167744244;Taip;0;2;0;2
2181;Gervelė;LAŠIUKAI;3525060645;Taip;3;13;0;16
2182;Gervelė;PABIRUČIAI;2019214634;Taip;19;0;0;19
2183;Gervelė;PABIRUČIAI;88273293270;Taip;0;10;0;10
2184;Gervelė;PABIRUČIAI;3278950938;Taip;0;4;0;4
2185;Gervelė;PABIRUČIAI;52142182972;Ne;8;0;3;11
2186;Gervelė;PABIRUČIAI;62782512806;Ne;10;5;0;15
2187;Gervelė;PABIRUČIAI;1921567602;Taip;0;0;1;1
2188;Gervelė;PABIRUČIAI;8454703111;Taip;0;2;0;2
2189;Gervelė;PABIRUČIAI;1617055167;Taip;0;0;5;5
2190;Gervelė;PABIRUČIAI;1697536098;Taip;0;1;0;1
2191;Gervelė;PABIRUČIAI;2632272974;Ne;3;0;0;3
2192;Gervelė;PABIRUČIAI;1860333208;Taip;11;0;0;11
2193;Gervelė;PABIRUČIAI;2798349541;Ne;0;4;0;4
2194;Gervelė;PABIRUČIAI;6349428106;Taip;0;11;0;11
2195;Gervelė;PABIRUČIAI;73803372762;Taip;0;3;2;5
2196;Gervelė;PABIRUČIAI;8035942210;Taip;7;5;0;12
2197;Gervelė;BITUTĖS;1792726318;Ne;12;1;0;13
2198;Gervelė;BITUTĖS;44678807307;Ne;0;8;1;9
2199;Gervelė;BITUTĖS;1371549808;Taip;0;0;2;2
2200;Gervelė;BITUTĖS;15891512215;Taip;8;0;1;9
2201;Gervelė;BITUTĖS;48497142461;Ne;0;2;1;3
2202;Gervelė;BITUTĖS;76731434799;Ne;0;0;4;4
2203;Gervelė;BITUTĖS;24724452164;Taip;0;0;6;6
2204;Gervelė;BITUTĖS;27435616549;Taip;0;1;0;1
2205;Gervelė;BITUTĖS;1303396562;Taip;0;0;5;5
2206;Gervelė;BITUTĖS;32101040739;Taip;7;0;6;13
2207;Gervelė;BITUTĖS;97418410809;Ne;0;1;0;1
2208;Gervelė;BITUTĖS;65751519550;Ne;10;0;0;10
2209;Gervelė;BITUTĖS;1413157604;Taip;2;0;0;2
2210;Gervelė;BITUTĖS;81112128210;Taip;0;3;0;3
2211;Gervelė;BITUTĖS;65086547895;Taip;0;1;0;1
2212;Gervelė;BITUTĖS;8302493906;Ne;0;5;0;5
2213;Gervelė;BURATINO;1815418720;Taip;0;9;0;9
2214;Gervelė;BURATINO;6168558862;Taip;0;11;0;11
2215;Gervelė;BURATINO;92859033264;Taip;5;0;0;5
2216;Gervelė;BURATINO;1083567209;Taip;10;0;0;10
2217;Gervelė;BURATINO;3946391650;Taip;0;2;0;2
2218;Gervelė;BURATINO;7620764911;Taip;13;3;0;16
2219;Gervelė;BURATINO;5440557094;Taip;7;1;0;8
2220;Gervelė;BURATINO;9202293067;Taip;16;0;0;16
2221;Gervelė;BURATINO;9909794030;Taip;14;2;0;16
2222;Gervelė;BURATINO;2646901307;Taip;18;0;0;18
2223;Gervelė;BURATINO;9564303781;Taip;0;2;0;2
2224;Gervelė;BURATINO;78122408360;Taip;0;1;0;1
2225;Gervelė;BURATINO;9771780358;Taip;0;16;0;16
2226;Gervelė;BURATINO;9239897472;Taip;0;10;0;10
2227;Gervelė;BURATINO;8997525194;Taip;0;5;0;5
2228;Gervelė;VIŠČIUKŲ;6844406500;Taip;13;0;0;13
2229;Gervelė;VIŠČIUKŲ;8157865822;Taip;20;0;0;20
2230;Gervelė;VIŠČIUKŲ;2359854614;Taip;18;0;0;18
2231;Gervelė;VIŠČIUKŲ;8533480337;Taip;0;1;0;1
2232;Gervelė;VIŠČIUKŲ;2523056808;Taip;0;0;5;5
2233;Gervelė;VIŠČIUKŲ;1637204236;Taip;9;0;1;10
2234;Gervelė;VIŠČIUKŲ;2413995770;Taip;12;0;0;12
2235;Gervelė;VIŠČIUKŲ;6058944385;Taip;0;7;0;7
2236;Gervelė;VIŠČIUKŲ;1323074335;Taip;7;0;3;10
2237;Gervelė;VIŠČIUKŲ;3702908570;Taip;14;0;0;14
2238;Gervelė;VIŠČIUKŲ;4294916559;Taip;16;0;0;16
2239;Gervelė;VIŠČIUKŲ;3449674095;Taip;0;7;0;7
2240;Gervelė;VIŠČIUKŲ;5767158743;Taip;5;0;3;8
2241;Gervelė;VIŠČIUKŲ;4775822341;Taip;4;8;0;12
2242;Gervelė;VIŠČIUKŲ;3723783633;Taip;0;3;0;3
2243;Gervelė;VIŠČIUKŲ;6227091658;Taip;0;2;0;2
2244;Gilužis;Skruzdėliukų;35511006307;Taip;0;4;2;6
2245;Gilužis;Skruzdėliukų;44807904472;Taip;6;0;0;6
2246;Gilužis;Skruzdėliukų;1615293331;Taip;7;2;0;9
2247;Gilužis;Skruzdėliukų;9474400084;Taip;7;4;0;11
2248;Gilužis;Skruzdėliukų;5161095299;Taip;0;0;1;1
2249;Gilužis;Skruzdėliukų;70959404439;Taip;3;1;0;4
2250;Gilužis;Skruzdėliukų;8120898865;Taip;0;5;0;5
2251;Gilužis;Skruzdėliukų;8840822243;Taip;3;2;0;5
2252;Gilužis;Skruzdėliukų;4611735601;Taip;0;2;5;7
2253;Gilužis;Skruzdėliukų;4747769984;Taip;9;1;0;10
2254;Gilužis;Skruzdėliukų;5920357223;Taip;5;2;0;7
2255;Gilužis;Skruzdėliukų;8595541498;Taip;1;1;1;3
2256;Gilužis;Skruzdėliukų;5365582271;Taip;11;2;1;14
2257;Gilužis;Skruzdėliukų;7364297673;Taip;2;0;7;9
2258;Gilužis;Skruzdėliukų;4362244070;Ne;0;1;0;1
2259;Gilužis;Skruzdėliukų;2042514241;Taip;4;5;0;9
2260;Gilužis;Skruzdėliukų;3216004438;Taip;9;2;1;12
2261;Gilužis;Skruzdėliukų;7766747590;Taip;0;0;1;1
2262;Gilužis;Skruzdėliukų;4777937216;Ne;0;1;0;1
2263;Gilužis;Skruzdėliukų;48365991937;Ne;14;4;0;18
2264;Gilužis;Nykštukų;7937643339;Ne;2;0;0;2
2265;Gilužis;Nykštukų;3473889426;Taip;14;0;0;14
2266;Gilužis;Nykštukų;9362581908;Taip;14;0;0;14
2267;Gilužis;Nykštukų;8899557365;Taip;9;0;0;9
2268;Gilužis;Nykštukų;2661894041;Ne;20;0;0;20
2269;Gilužis;Nykštukų;5109935385;Taip;8;1;0;9
2270;Gilužis;Nykštukų;7228498662;Taip;5;1;0;6
2271;Gilužis;Nykštukų;3335512812;Taip;0;4;0;4
2272;Gilužis;Nykštukų;1459273692;Taip;0;8;0;8
2273;Gilužis;Nykštukų;6093514885;Taip;22;0;0;22
2274;Gilužis;Nykštukų;4156613717;Ne;9;1;1;11
2275;Gilužis;Nykštukų;5713786735;Ne;10;0;0;10
2276;Gilužis;Nykštukų;2784416935;Ne;0;6;4;10
2277;Gilužis;Nykštukų;6315155554;Ne;11;1;0;12
2278;Gilužis;Nykštukų;1146713023;Taip;0;5;0;5
2279;Gilužis;Nykštukų;9332056404;Taip;3;0;1;4
2280;Gilužis;Nykštukų;4541291716;Taip;0;0;4;4
2281;Gilužis;Nykštukų;8522552650;Ne;4;2;1;7
2282;Gilužis;Nykštukų;3176305306;Ne;0;3;0;3
2283;Gilužis;Bitučių;7667792304;Taip;5;6;0;11
2284;Gilužis;Bitučių;33601993265;Taip;0;3;0;3
2285;Gilužis;Bitučių;36591400178;Taip;0;5;0;5
2286;Gilužis;Bitučių;79835099585;Taip;4;0;0;4
2287;Gilužis;Bitučių;86856314276;Taip;3;5;0;8
2288;Gilužis;Bitučių;86204525039;Taip;3;1;0;4
2289;Gilužis;Bitučių;66936354561;Taip;0;6;0;6
2290;Gilužis;Bitučių;37713407129;Taip;0;1;0;1
2291;Gilužis;Bitučių;67925251330;Taip;0;2;0;2
2292;Gilužis;Bitučių;75877736009;Taip;0;2;0;2
2293;Gilužis;Bitučių;98929035480;Taip;0;4;0;4
2294;Gilužis;Bitučių;60029145569;Taip;5;1;0;6
2295;Gilužis;Bitučių;44591290522;Taip;0;5;3;8
2296;Gilužis;Kačiukų;64044950817;Taip;5;7;0;12
2297;Gilužis;Kačiukų;97044945526;Taip;9;0;1;10
2298;Gilužis;Kačiukų;98833692687;Taip;0;1;8;9
2299;Gilužis;Kačiukų;90653192774;Taip;1;0;0;1
2300;Gilužis;Kačiukų;43427840545;Taip;3;0;0;3
2301;Gilužis;Kačiukų;69179380194;Taip;0;1;0;1
2302;Gilužis;Kačiukų;27145205823;Taip;4;0;0;4
2303;Gilužis;Kačiukų;11999596704;Taip;0;7;0;7
2304;Gilužis;Kačiukų;40327951625;Ne;0;0;4;4
2305;Gilužis;Kačiukų;32385951346;Taip;0;7;0;7
2306;Gilužis;Kačiukų;69814504535;Ne;0;1;1;2
2307;Gilužis;Kačiukų;2826672081;Taip;0;1;0;1
2308;Gilužis;Kačiukų;48813257365;Ne;0;7;0;7
2309;Gilužis;Kačiukų;71678818697;Taip;7;0;0;7
2310;Gilužis;Kačiukų;90150093965;Taip;0;3;0;3
2311;Gilužis;Kačiukų;88997906780;Taip;9;0;1;10
2312;Gilužis;Kačiukų;51801100240;Taip;0;3;0;3
2313;Gilužis;Pelėdžiukų;5217748032;Ne;0;11;0;11
2314;Gilužis;Pelėdžiukų;5989314494;Taip;5;0;4;9
2315;Gilužis;Pelėdžiukų;7998695149;Taip;12;0;0;12
2316;Gilužis;Pelėdžiukų;7742783427;Taip;12;0;0;12
2317;Gilužis;Pelėdžiukų;7358572344;Taip;0;6;0;6
2318;Gilužis;Pelėdžiukų;4617259961;Ne;3;0;0;3
2319;Gilužis;Pelėdžiukų;1222370750;Ne;8;4;0;12
2320;Gilužis;Pelėdžiukų;9503516686;Taip;1;1;0;2
2321;Gilužis;Pelėdžiukų;9833451628;Taip;10;0;0;10
2322;Gilužis;Pelėdžiukų;7505729606;Taip;14;0;0;14
2323;Gilužis;Pelėdžiukų;4051726208;Taip;4;3;0;7
2324;Gilužis;Pelėdžiukų;1804218972;Taip;0;2;0;2
2325;Gilužis;Pelėdžiukų;1832039250;Taip;0;0;5;5
2326;Gilužis;Pelėdžiukų;5070988982;Taip;10;9;0;19
2327;Gilužis;Pelėdžiukų;7899274495;Taip;0;13;0;13
2328;Gilužis;Pelėdžiukų;6469454991;Ne;0;0;3;3
2329;Gilužis;Drugelių;1437220475;Taip;0;3;0;3
2330;Gilužis;Drugelių;9763902423;Ne;0;0;1;1
2331;Gilužis;Drugelių;6567065609;Taip;8;0;1;9
2332;Gilužis;Drugelių;1908578050;Taip;0;1;0;1
2333;Gilužis;Drugelių;6000255910;Taip;0;0;3;3
2334;Gilužis;Drugelių;96882209197;Ne;5;1;0;6
2335;Gilužis;Drugelių;79340379786;Ne;0;1;0;1
2336;Gilužis;Drugelių;6622443065;Ne;0;2;4;6
2337;Gilužis;Drugelių;1774912517;Taip;8;0;0;8
2338;Gilužis;Drugelių;80556519366;Taip;0;1;0;1
2339;Gilužis;Drugelių;1335467227;Taip;7;0;1;8
2340;Gilužis;Drugelių;2102777576;Taip;5;0;4;9
2341;Gilužis;Drugelių;82153346966;Ne;6;0;0;6
2342;Gilužis;Drugelių;7244188057;Ne;0;1;5;6
2343;Gilužis;Drugelių;93587767496;Taip;11;0;0;11
2344;Gilužis;Drugelių;55062344648;Taip;5;0;0;5
2345;Gilužis;Drugelių;2118119414;Ne;0;0;1;1
2346;Gilužis;Drugelių;82030031331;Taip;0;0;1;1
2347;Gilužis;Drugelių;7127446066;Ne;0;0;1;1
2348;Gilužis;Drugelių;73711363249;Taip;0;0;2;2
2349;Gilužis;Saulučių;17896774143;Taip;0;11;0;11
2350;Gilužis;Saulučių;9918995545;Taip;2;1;0;3
2351;Gilužis;Saulučių;4209000927;Taip;7;0;0;7
2352;Gilužis;Saulučių;8595551150;Taip;0;1;0;1
2353;Gilužis;Saulučių;4575619425;Taip;4;2;0;6
2354;Gilužis;Saulučių;4473810097;Taip;7;0;0;7
2355;Gilužis;Saulučių;1649256496;Taip;0;1;0;1
2356;Gilužis;Saulučių;96550272401;Taip;7;4;0;11
2357;Gilužis;Saulučių;69504888193;Taip;16;1;0;17
2358;Gilužis;Saulučių;2391630554;Taip;0;5;0;5
2359;Gilužis;Saulučių;18997894859;Taip;21;0;0;21
2360;Gilužis;Saulučių;7744997250;Taip;13;1;0;14
2361;Gilužis;Saulučių;32730847948;Taip;5;6;0;11
2362;Gilužis;Saulučių;3181765606;Taip;11;0;0;11
2363;Gilužis;Saulučių;79805583046;Taip;17;0;0;17
2364;Gilužis;Saulučių;28447690974;Taip;4;0;0;4
2365;Gilužis;Saulučių;35650138667;Taip;0;2;0;2
2366;Gilužis;Saulučių;9367673896;Taip;0;8;0;8
2367;Gilužis;Paukštelių;1911733577;Ne;0;1;0;1
2368;Gilužis;Paukštelių;1124568431;Ne;0;1;0;1
2369;Gilužis;Paukštelių;1772207635;Taip;0;12;0;12
2370;Gilužis;Paukštelių;9252084783;Taip;0;4;0;4
2371;Gilužis;Paukštelių;4265465127;Taip;0;1;0;1
2372;Gilužis;Paukštelių;1797199356;Taip;0;2;0;2
2373;Gilužis;Paukštelių;93844800610;Ne;11;0;0;11
2374;Gilužis;Paukštelių;92163197528;Taip;0;0;2;2
2375;Gilužis;Paukštelių;1962922981;Taip;5;0;0;5
2376;Gilužis;Paukštelių;2769830772;Taip;0;0;9;9
2377;Gilužis;Paukštelių;1259168003;Taip;0;3;0;3
2378;Gilužis;Paukštelių;91148708775;Taip;8;0;1;9
2379;Gilužis;Paukštelių;8933516128;Taip;1;0;0;1
2380;Gilužis;Paukštelių;49114819476;Ne;0;0;4;4
2381;Gilužis;Paukštelių;65698608589;Taip;5;0;0;5
2382;Gilužis;Paukštelių;1413931545;Taip;7;0;3;10
2383;Gilužis;Paukštelių;4754994261;Ne;0;11;0;11
2384;Gilužis;Paukštelių;49793977825;Taip;0;11;0;11
2385;Gilužis;Obuoliukų;72582220264;Taip;0;2;0;2
2386;Gilužis;Obuoliukų;1840213846;Taip;0;2;0;2
2387;Gilužis;Obuoliukų;1637726675;Taip;6;4;0;10
2388;Gilužis;Obuoliukų;1404236599;Taip;0;12;0;12
2389;Gilužis;Obuoliukų;2031851095;Taip;0;1;0;1
2390;Gilužis;Obuoliukų;96799037695;Taip;2;1;0;3
2391;Gilužis;Obuoliukų;1236164928;Taip;0;1;0;1
2392;Gilužis;Obuoliukų;84834458261;Taip;10;0;0;10
2393;Gilužis;Obuoliukų;5121769570;Taip;0;3;4;7
2394;Gilužis;Obuoliukų;1428994411;Taip;0;3;1;4
2395;Gilužis;Obuoliukų;5899163275;Taip;0;3;0;3
2396;Gilužis;Obuoliukų;2126527730;Taip;0;1;0;1
2397;Gilužis;Obuoliukų;1067512693;Ne;0;9;1;10
2398;Gilužis;KIŠKUČIŲ;1017937594;Taip;0;0;1;1
2399;Gilužis;KIŠKUČIŲ;1191967409;Ne;7;5;0;12
2400;Gilužis;KIŠKUČIŲ;1025400197;Taip;0;0;4;4
2401;Gilužis;KIŠKUČIŲ;1452016675;Taip;4;0;1;5
2402;Gilužis;KIŠKUČIŲ;24558082285;Taip;4;13;0;17
2403;Gilužis;KIŠKUČIŲ;31157032738;Taip;0;2;0;2
2404;Gilužis;KIŠKUČIŲ;69205729963;Taip;0;1;0;1
2405;Gilužis;KIŠKUČIŲ;1869058578;Taip;3;0;0;3
2406;Gilužis;KIŠKUČIŲ;1464348972;Taip;0;1;1;2
2407;Gilužis;KIŠKUČIŲ;7740703388;Taip;0;0;7;7
2408;Gilužis;KIŠKUČIŲ;1589884646;Taip;0;0;6;6
2409;Gilužis;KIŠKUČIŲ;54636558233;Taip;1;2;0;3
2410;Gilužis;KIŠKUČIŲ;1453976300;Taip;0;2;0;2
2411;Gilužis;KIŠKUČIŲ;57074114440;Taip;0;3;0;3
2412;Gilužis;KIŠKUČIŲ;15192433393;Taip;0;1;0;1
2413;Gilužis;KIŠKUČIŲ;1307302669;Taip;7;0;4;11
2414;Gilužis;KIŠKUČIŲ;1569805585;Taip;0;3;0;3
2415;Gilužis;Meškučių;82153247890;Taip;0;8;0;8
2416;Gilužis;Meškučių;9104396905;Taip;1;7;0;8
2417;Gilužis;Meškučių;8278207628;Ne;4;3;0;7
2418;Gilužis;Meškučių;2144919007;Taip;10;0;0;10
2419;Gilužis;Meškučių;6840555273;Taip;0;6;0;6
2420;Gilužis;Meškučių;2111997678;Taip;0;3;0;3
2421;Gilužis;Meškučių;1201973661;Taip;0;3;0;3
2422;Gilužis;Meškučių;93541096118;Taip;0;4;0;4
2423;Gilužis;Meškučių;41791785706;Ne;0;22;0;22
2424;Gilužis;Meškučių;3104707033;Ne;0;7;0;7
2425;Gilužis;Meškučių;3884351522;Ne;2;0;0;2
2426;Gilužis;Meškučių;1003733551;Taip;0;4;0;4
2427;Gilužis;Meškučių;57285847418;Taip;7;1;0;8
2428;Gilužis;Meškučių;37771334557;Taip;0;13;0;13
2429;Gilužis;Meškučių;3451034791;Ne;0;2;2;4
2430;Gilužis;Meškučių;1642252063;Taip;0;6;1;7
2431;Gilužis;Pagrandukai;6966795180;Ne;4;0;2;6
2432;Gilužis;Pagrandukai;7330938312;Taip;12;0;0;12
2433;Gilužis;Pagrandukai;6571132974;Taip;0;22;0;22
2434;Gilužis;Pagrandukai;5128383851;Taip;0;0;3;3
2435;Gilužis;Pagrandukai;7731169885;Ne;5;1;0;6
2436;Gilužis;Pagrandukai;1582241363;Taip;16;1;0;17
2437;Gilužis;Pagrandukai;8244385001;Taip;9;8;0;17
2438;Gilužis;Pagrandukai;4909329417;Taip;9;8;0;17
2439;Gilužis;Pagrandukai;4978922821;Taip;6;8;0;14
2440;Gilužis;Pagrandukai;2945406185;Taip;6;8;0;14
2441;Gilužis;Pagrandukai;9034842169;Taip;17;0;0;17
2442;Gilužis;Pagrandukai;7001112696;Taip;12;0;0;12
2443;Gilužis;Pagrandukai;8318405114;Taip;7;3;0;10
2444;Gilužis;Pagrandukai;6786334223;Taip;5;0;0;5
2445;Gilužis;Pagrandukai;1093643746;Taip;11;0;0;11
2446;Gilužis;Pagrandukai;6429142049;Ne;4;0;0;4
2447;Gilužis;Boružėlių;9421351780;Taip;4;0;1;5
2448;Gilužis;Boružėlių;4360261750;Ne;0;0;1;1
2449;Gilužis;Boružėlių;1634295583;Ne;3;0;13;16
2450;Gilužis;Boružėlių;9186274541;Taip;17;0;0;17
2451;Gilužis;Boružėlių;6121625070;Taip;3;8;0;11
2452;Gilužis;Boružėlių;3419281756;Taip;10;1;0;11
2453;Gilužis;Boružėlių;4403218878;Taip;0;6;0;6
2454;Gilužis;Boružėlių;9097165155;Taip;0;8;0;8
2455;Gilužis;Boružėlių;1862524255;Taip;14;0;0;14
2456;Gilužis;Boružėlių;6960673767;Taip;3;1;0;4
2457;Gilužis;Boružėlių;5728341732;Taip;0;0;1;1
2458;Gilužis;Boružėlių;4841014668;Taip;16;0;0;16
2459;Gilužis;Boružėlių;2585736095;Ne;10;12;0;22
2460;Gilužis;Boružėlių;7826015897;Taip;8;2;0;10
2461;Gintarėlis;PAPŪGĖLĖS;8498936096;Taip;8;7;0;15
2462;Gintarėlis;PAPŪGĖLĖS;8913652291;Taip;0;4;0;4
2463;Gintarėlis;PAPŪGĖLĖS;1033624080;Ne;4;2;0;6
2464;Gintarėlis;PAPŪGĖLĖS;2919700367;Ne;0;6;0;6
2465;Gintarėlis;PAPŪGĖLĖS;1768789948;Taip;0;0;1;1
2466;Gintarėlis;PAPŪGĖLĖS;2595566032;Taip;0;4;0;4
2467;Gintarėlis;PAPŪGĖLĖS;9141438560;Taip;0;3;0;3
2468;Gintarėlis;PAPŪGĖLĖS;2235045173;Taip;5;0;0;5
2469;Gintarėlis;PAPŪGĖLĖS;9494521554;Taip;0;16;0;16
2470;Gintarėlis;PAPŪGĖLĖS;7494884360;Taip;3;4;0;7
2471;Gintarėlis;PAPŪGĖLĖS;7147842224;Taip;0;2;0;2
2472;Gintarėlis;PAPŪGĖLĖS;9648982613;Ne;0;2;0;2
2473;Gintarėlis;PAPŪGĖLĖS;5783939567;Ne;0;2;0;2
2474;Gintarėlis;PAPŪGĖLĖS;7674351459;Taip;0;1;0;1
2475;Gintarėlis;PAPŪGĖLĖS;6292664833;Taip;0;0;9;9
2476;Gintarėlis;PAPŪGĖLĖS;8610886062;Taip;5;1;0;6
2477;Gintarėlis;PAPŪGĖLĖS;5811396263;Taip;0;1;0;1
2478;Gintarėlis;PAPŪGĖLĖS;4904966263;Taip;6;2;0;8
2479;Gintarėlis;PAPŪGĖLĖS;1648843117;Ne;11;2;0;13
2480;Gintarėlis;PAPŪGĖLĖS;1861324153;Taip;0;7;0;7
2481;Gintarėlis;PAPŪGĖLĖS;3457974670;Ne;4;2;5;11
2482;Gintarėlis;PAPŪGĖLĖS;9382662838;Taip;7;2;0;9
2483;Gintarėlis;PAPŪGĖLĖS;1511718436;Ne;0;11;0;11
2484;Gintarėlis;SPINDULIUKAI;96694096944;Taip;0;7;0;7
2485;Gintarėlis;SPINDULIUKAI;33863655816;Ne;0;2;0;2
2486;Gintarėlis;SPINDULIUKAI;11384063236;Taip;0;1;0;1
2487;Gintarėlis;SPINDULIUKAI;27532374357;Taip;0;1;0;1
2488;Gintarėlis;SPINDULIUKAI;8112379741;Ne;0;2;1;3
2489;Gintarėlis;SPINDULIUKAI;37848651606;Taip;1;0;0;1
2490;Gintarėlis;SPINDULIUKAI;56701557907;Ne;5;10;1;16
2491;Gintarėlis;SPINDULIUKAI;92436759875;Taip;0;4;0;4
2492;Gintarėlis;SPINDULIUKAI;1360843628;Taip;0;0;3;3
2493;Gintarėlis;SPINDULIUKAI;63037561278;Taip;0;9;0;9
2494;Gintarėlis;SPINDULIUKAI;92996401082;Taip;0;2;1;3
2495;Gintarėlis;SPINDULIUKAI;19506557567;Ne;0;2;0;2
2496;Gintarėlis;SPINDULIUKAI;24915581271;Taip;0;1;5;6
2497;Gintarėlis;SPINDULIUKAI;18222675927;Ne;0;4;0;4
2498;Gintarėlis;SPINDULIUKAI;3035023250;Taip;0;10;0;10
2499;Gintarėlis;SPINDULIUKAI;99077732058;Taip;0;8;0;8
2500;Gintarėlis;LAŠIUKAI;6893183889;Taip;0;2;0;2
2501;Gintarėlis;LAŠIUKAI;5880091191;Taip;0;2;0;2
2502;Gintarėlis;LAŠIUKAI;9584956349;Taip;0;2;8;10
2503;Gintarėlis;LAŠIUKAI;94354056029;Ne;0;8;0;8
2504;Gintarėlis;LAŠIUKAI;78359050717;Taip;0;0;1;1
2505;Gintarėlis;LAŠIUKAI;6457288028;Taip;0;4;0;4
2506;Gintarėlis;LAŠIUKAI;1002155392;Taip;0;2;3;5
2507;Gintarėlis;LAŠIUKAI;3504738389;Taip;0;0;1;1
2508;Gintarėlis;LAŠIUKAI;9130659549;Taip;0;2;1;3
2509;Gintarėlis;LAŠIUKAI;4660854883;Taip;0;0;1;1
2510;Gintarėlis;LAŠIUKAI;3799412062;Ne;0;2;0;2
2511;Gintarėlis;LAŠIUKAI;25210675029;Taip;3;0;0;3
2512;Gintarėlis;LAŠIUKAI;7192722296;Ne;5;0;0;5
2513;Gintarėlis;LAŠIUKAI;5024727902;Ne;0;8;0;8
2514;Gintarėlis;LAŠIUKAI;8055928882;Taip;0;9;0;9
2515;Gintarėlis;LAŠIUKAI;7644607132;Taip;5;0;0;5
2516;Gintarėlis;LAŠIUKAI;2088008759;Taip;0;11;0;11
2517;Gintarėlis;LAŠIUKAI;2036488789;Taip;5;8;0;13
2518;Gintarėlis;GAIDŽIUKAI;29645999843;Taip;10;1;0;11
2519;Gintarėlis;GAIDŽIUKAI;45480802894;Taip;0;2;0;2
2520;Gintarėlis;GAIDŽIUKAI;1539226211;Taip;0;11;0;11
2521;Gintarėlis;GAIDŽIUKAI;2043878016;Taip;5;0;0;5
2522;Gintarėlis;GAIDŽIUKAI;1770479969;Taip;5;2;0;7
2523;Gintarėlis;GAIDŽIUKAI;53971205498;Taip;0;2;0;2
2524;Gintarėlis;GAIDŽIUKAI;77591601744;Taip;5;0;0;5
2525;Gintarėlis;GAIDŽIUKAI;1076400051;Taip;0;3;0;3
2526;Gintarėlis;GAIDŽIUKAI;3794027499;Taip;4;0;0;4
2527;Gintarėlis;GAIDŽIUKAI;8206947475;Taip;0;6;0;6
2528;Gintarėlis;GAIDŽIUKAI;5916948150;Ne;0;2;0;2
2529;Gintarėlis;GAIDŽIUKAI;2203238888;Taip;0;1;0;1
2530;Gintarėlis;GAIDŽIUKAI;3978892232;Taip;0;1;0;1
2531;Gintarėlis;GAIDŽIUKAI;7942036741;Taip;1;0;0;1
2532;Gintarėlis;GAIDŽIUKAI;6785086096;Ne;4;3;0;7
2533;Gintarėlis;MEŠKUČIAI;12332079305;Taip;0;2;0;2
2534;Gintarėlis;MEŠKUČIAI;28514742083;Taip;0;7;0;7
2535;Gintarėlis;MEŠKUČIAI;8518137062;Taip;0;0;1;1
2536;Gintarėlis;MEŠKUČIAI;25360163411;Taip;0;11;0;11
2537;Gintarėlis;MEŠKUČIAI;1943647795;Ne;0;7;0;7
2538;Gintarėlis;MEŠKUČIAI;2529363136;Taip;2;0;2;4
2539;Gintarėlis;MEŠKUČIAI;10771368524;Taip;0;2;0;2
2540;Gintarėlis;MEŠKUČIAI;47480197789;Ne;0;6;0;6
2541;Gintarėlis;MEŠKUČIAI;36019373990;Ne;0;3;0;3
2542;Gintarėlis;DRUGELIAI;14840692502;Ne;0;3;0;3
2543;Gintarėlis;DRUGELIAI;1462949250;Taip;5;2;10;17
2544;Gintarėlis;DRUGELIAI;9737200226;Taip;0;2;3;5
2545;Gintarėlis;DRUGELIAI;6655809299;Taip;4;0;1;5
2546;Gintarėlis;DRUGELIAI;2614258442;Taip;5;5;0;10
2547;Gintarėlis;DRUGELIAI;1452402931;Ne;0;6;0;6
2548;Gintarėlis;DRUGELIAI;4217329880;Ne;0;5;0;5
2549;Gintarėlis;DRUGELIAI;1759217543;Taip;0;4;0;4
2550;Gintarėlis;DRUGELIAI;7571352126;Taip;0;1;0;1
2551;Gintarėlis;DRUGELIAI;1042222561;Taip;0;4;0;4
2552;Gintarėlis;DRUGELIAI;9687974376;Taip;0;1;0;1
2553;Gintarėlis;DRUGELIAI;8704248985;Taip;0;14;0;14
2554;Gintarėlis;DRUGELIAI;6655645997;Taip;0;2;2;4
2555;Gintarėlis;DRUGELIAI;6080108998;Taip;0;2;2;4
2556;Gintarėlis;DRUGELIAI;7449437199;Taip;0;1;0;1
2557;Gintarėlis;DRUGELIAI;4076421692;Ne;0;4;0;4
2558;Gintarėlis;DRUGELIAI;5355691986;Ne;0;3;0;3
2559;Gintarėlis;DRUGELIAI;8116557698;Taip;0;10;0;10
2560;Gintarėlis;KAČIUKAI;5451653510;Taip;0;9;4;13
2561;Gintarėlis;KAČIUKAI;63243392161;Taip;0;1;0;1
2562;Gintarėlis;KAČIUKAI;37612987791;Ne;0;2;0;2
2563;Gintarėlis;KAČIUKAI;26259581924;Taip;0;10;0;10
2564;Gintarėlis;KAČIUKAI;31365533022;Ne;0;2;0;2
2565;Gintarėlis;KAČIUKAI;50715082496;Taip;0;6;1;7
2566;Gintarėlis;KAČIUKAI;1159773367;Taip;0;6;1;7
2567;Gintarėlis;KAČIUKAI;2050020230;Taip;0;4;0;4
2568;Gintarėlis;KAČIUKAI;54145290842;Ne;0;0;20;20
2569;Gintarėlis;KAČIUKAI;19813827223;Taip;0;5;0;5
2570;Gintarėlis;KAČIUKAI;98684742007;Ne;0;0;10;10
2571;Gintarėlis;KAČIUKAI;2000986290;Taip;0;4;5;9
2572;Gintarėlis;KAČIUKAI;6421537455;Ne;0;11;0;11
2573;Gintarėlis;KAČIUKAI;1595816431;Taip;0;7;0;7
2574;Gintarėlis;KAČIUKAI;30446888177;Taip;7;0;0;7
2575;Gintarėlis;KAČIUKAI;63221497564;Taip;0;8;0;8
2576;Gintarėlis;KAČIUKAI;81135362098;Taip;0;2;0;2
2577;Gintarėlis;KAČIUKAI;58701768194;Taip;5;12;0;17
2578;Gintarėlis;KAČIUKAI;29480359781;Taip;0;2;5;7
2579;Gintarėlis;KIŠKUČIAI;8665467175;Taip;0;2;1;3
2580;Gintarėlis;KIŠKUČIAI;83754732536;Taip;7;4;0;11
2581;Gintarėlis;KIŠKUČIAI;89051269756;Taip;0;3;0;3
2582;Gintarėlis;KIŠKUČIAI;1642627920;Taip;0;11;0;11
2583;Gintarėlis;KIŠKUČIAI;1593455162;Taip;0;8;0;8
2584;Gintarėlis;KIŠKUČIAI;2043405414;Ne;0;1;0;1
2585;Gintarėlis;KIŠKUČIAI;3828845515;Taip;0;1;0;1
2586;Gintarėlis;KIŠKUČIAI;1069395570;Taip;0;2;0;2
2587;Gintarėlis;KIŠKUČIAI;78697777550;Taip;0;0;1;1
2588;Gintarėlis;KIŠKUČIAI;85557344192;Taip;0;4;0;4
2589;Gintarėlis;KIŠKUČIAI;2970527490;Ne;0;4;0;4
2590;Gintarėlis;KIŠKUČIAI;2032900352;Taip;0;3;1;4
2591;Gintarėlis;KIŠKUČIAI;3292572563;Taip;0;4;0;4
2592;Gintarėlis;KIŠKUČIAI;1543013649;Taip;0;10;0;10
2593;Gintarėlis;KIŠKUČIAI;24774460882;Ne;0;1;0;1
2594;Gintarėlis;KIŠKUČIAI;1028456578;Taip;7;0;0;7
2595;Gintarėlis;VYTURIUKAI;1553747935;Taip;7;12;0;19
2596;Gintarėlis;VYTURIUKAI;22394648690;Taip;0;1;0;1
2597;Gintarėlis;VYTURIUKAI;4902086873;Taip;9;0;0;9
2598;Gintarėlis;VYTURIUKAI;34606130829;Taip;0;4;0;4
2599;Gintarėlis;VYTURIUKAI;21658913551;Ne;0;4;0;4
2600;Gintarėlis;VYTURIUKAI;8405210216;Ne;0;1;0;1
2601;Gintarėlis;VYTURIUKAI;2721386855;Taip;0;13;0;13
2602;Gintarėlis;BORUŽĖLĖS;4971574875;Taip;0;2;0;2
2603;Gintarėlis;BORUŽĖLĖS;6277010268;Taip;4;0;0;4
2604;Gintarėlis;BORUŽĖLĖS;1771868868;Ne;0;7;0;7
2605;Gintarėlis;BORUŽĖLĖS;39372328122;Taip;0;3;0;3
2606;Gintarėlis;BORUŽĖLĖS;25451522701;Taip;3;2;0;5
2607;Gintarėlis;BORUŽĖLĖS;82344200095;Taip;0;2;0;2
2608;Gintarėlis;BORUŽĖLĖS;1168158494;Taip;0;2;0;2
2609;Gintarėlis;BORUŽĖLĖS;9255623049;Taip;0;2;0;2
2610;Gintarėlis;BORUŽĖLĖS;88451515187;Taip;0;1;0;1
2611;Gintarėlis;BORUŽĖLĖS;7703150488;Taip;4;0;0;4
2612;Gintarėlis;BORUŽĖLĖS;2145479870;Taip;5;1;0;6
2613;Gintarėlis;BORUŽĖLĖS;30066476338;Ne;0;2;0;2
2614;Gintarėlis;BORUŽĖLĖS;63146841406;Taip;0;22;0;22
2615;Gintarėlis;BORUŽĖLĖS;30334064319;Taip;0;5;0;5
2616;Gintarėlis;BORUŽĖLĖS;91798408335;Taip;0;14;0;14
2617;Gintarėlis;BORUŽĖLĖS;25684002087;Taip;0;6;0;6
2618;Gintarėlis;BORUŽĖLĖS;10826255781;Ne;0;9;0;9
2619;Gintarėlis;BORUŽĖLĖS;1505703905;Taip;0;8;0;8
2620;Gintarėlis;BORUŽĖLĖS;1212639078;Taip;2;2;0;4
2621;Gintarėlis;EŽIUKAI;1793785936;Taip;8;1;0;9
2622;Gintarėlis;EŽIUKAI;1856031326;Taip;1;0;0;1
2623;Gintarėlis;EŽIUKAI;27890184523;Taip;0;9;0;9
2624;Gintarėlis;EŽIUKAI;8074941282;Taip;3;8;0;11
2625;Gintarėlis;EŽIUKAI;2040989572;Taip;5;2;3;10
2626;Gintarėlis;EŽIUKAI;1312688961;Taip;0;6;0;6
2627;Gintarėlis;EŽIUKAI;1672037617;Taip;0;2;0;2
2628;Gintarėlis;EŽIUKAI;51418692259;Taip;0;1;0;1
2629;Gintarėlis;EŽIUKAI;1398810524;Taip;0;17;0;17
2630;Gintarėlis;EŽIUKAI;74295947670;Taip;0;1;0;1
2631;Gintarėlis;EŽIUKAI;2732338838;Taip;0;1;0;1
2632;Gintarėlis;EŽIUKAI;7731823367;Ne;0;9;0;9
2633;Gintarėlis;EŽIUKAI;7053099543;Taip;0;0;4;4
2634;Gintarėlis;EŽIUKAI;9705808868;Ne;0;10;0;10
2635;Gintarėlis;EŽIUKAI;13416505188;Taip;0;2;0;2
2636;Gintarėlis;EŽIUKAI;36350623756;Taip;0;10;0;10
2637;Gintarėlis;EŽIUKAI;96404879029;Taip;14;0;0;14
2638;Gintarėlis;EŽIUKAI;1725007540;Ne;0;0;2;2
2639;Gintarėlis;VIŠČIUKAI;5921751507;Taip;0;2;0;2
2640;Gintarėlis;VIŠČIUKAI;9963329170;Ne;0;2;0;2
2641;Gintarėlis;VIŠČIUKAI;5569843168;Taip;0;1;0;1
2642;Gintarėlis;VIŠČIUKAI;3665764153;Taip;0;2;0;2
2643;Gintarėlis;VIŠČIUKAI;9774056578;Taip;0;2;0;2
2644;Gintarėlis;VIŠČIUKAI;3825700024;Taip;6;3;0;9
2645;Gintarėlis;VIŠČIUKAI;7057877483;Taip;6;3;0;9
2646;Gintarėlis;VIŠČIUKAI;7875981690;Taip;13;3;0;16
2647;Gintarėlis;VIŠČIUKAI;2544338275;Taip;13;3;0;16
2648;Gintarėlis;VIŠČIUKAI;7182964126;Taip;0;2;0;2
2649;Gintarėlis;VIŠČIUKAI;1011749698;Taip;1;0;0;1
2650;Gintarėlis;VIŠČIUKAI;8261770154;Taip;0;16;0;16
2651;Gintarėlis;VIŠČIUKAI;9450900915;Taip;5;0;3;8
2652;Gintarėlis;VIŠČIUKAI;9825811100;Taip;9;0;3;12
2653;Gintarėlis;"SAULĖS ZUIKUČIAI";8287685690;Taip;9;9;0;18
2654;Gintarėlis;"SAULĖS ZUIKUČIAI";6914904213;Taip;6;2;1;9
2655;Gintarėlis;"SAULĖS ZUIKUČIAI";1696337909;Taip;6;2;1;9
2656;Gintarėlis;"SAULĖS ZUIKUČIAI";1778573935;Taip;0;9;0;9
2657;Gintarėlis;"SAULĖS ZUIKUČIAI";5796729245;Taip;0;8;0;8
2658;Gintarėlis;"SAULĖS ZUIKUČIAI";9915887420;Taip;0;8;0;8
2659;Gintarėlis;"SAULĖS ZUIKUČIAI";3398936974;Ne;0;15;0;15
2660;Gintarėlis;"SAULĖS ZUIKUČIAI";5153948767;Taip;0;2;0;2
2661;Gintarėlis;"SAULĖS ZUIKUČIAI";9675201979;Taip;0;2;1;3
2662;Gintarėlis;"SAULĖS ZUIKUČIAI";7971810025;Ne;18;0;0;18
2663;Gintarėlis;"SAULĖS ZUIKUČIAI";2814569415;Ne;0;5;5;10
2664;Gintarėlis;"SAULĖS ZUIKUČIAI";6862629244;Ne;0;11;0;11
2665;Gintarėlis;"SAULĖS ZUIKUČIAI";8000297636;Taip;0;1;0;1
2666;Gintarėlis;"SAULĖS ZUIKUČIAI";6142819210;Taip;1;1;0;2
2667;Gintarėlis;"SAULĖS ZUIKUČIAI";3359584322;Taip;0;2;1;3
2668;Gintarėlis;"SAULĖS ZUIKUČIAI";3814485627;Taip;0;11;0;11
2669;Gintarėlis;"SAULĖS ZUIKUČIAI";2165332442;Ne;0;6;0;6
2670;Gintarėlis;"SAULĖS ZUIKUČIAI";5919205817;Taip;1;1;0;2
2671;Gintarėlis;"SAULĖS ZUIKUČIAI";1571260478;Ne;0;22;0;22
2672;Gintarėlis;"SAULĖS ZUIKUČIAI";7143014339;Taip;0;1;0;1
2673;Giraitė;Aviliukas;67009533810;Taip;0;1;0;1
2674;Giraitė;Aviliukas;68804588518;Taip;0;3;0;3
2675;Giraitė;Aviliukas;42330865487;Taip;2;1;0;3
2676;Giraitė;Aviliukas;34957067197;Taip;0;1;0;1
2677;Giraitė;Aviliukas;39627499338;Taip;0;0;2;2
2678;Giraitė;Aviliukas;10778161174;Taip;0;1;0;1
2679;Giraitė;Aviliukas;94618756885;Taip;0;0;4;4
2680;Giraitė;Aviliukas;12568042778;Taip;0;10;0;10
2681;Giraitė;Aviliukas;45633008605;Taip;0;0;1;1
2682;Giraitė;Aviliukas;32804353567;Taip;2;0;0;2
2683;Giraitė;Aviliukas;24903085449;Taip;0;1;0;1
2684;Giraitė;Aviliukas;5038998112;Ne;0;0;4;4
2685;Giraitė;Aviliukas;8423424896;Taip;0;6;2;8
2686;Giraitė;LapiukaI;6141730004;Taip;3;0;0;3
2687;Giraitė;LapiukaI;7831526566;Taip;14;0;0;14
2688;Giraitė;LapiukaI;5030697729;Taip;1;0;0;1
2689;Giraitė;LapiukaI;1921430434;Ne;5;3;0;8
2690;Giraitė;LapiukaI;5006156109;Taip;5;3;0;8
2691;Giraitė;LapiukaI;2393713210;Taip;0;3;1;4
2692;Giraitė;LapiukaI;4663343304;Ne;16;0;0;16
2693;Giraitė;LapiukaI;5382004098;Taip;0;4;0;4
2694;Giraitė;LapiukaI;4811513778;Taip;11;0;0;11
2695;Giraitė;LapiukaI;9768754737;Ne;9;0;2;11
2696;Giraitė;LapiukaI;4296449093;Taip;0;2;0;2
2697;Giraitė;LapiukaI;7428833348;Taip;7;1;0;8
2698;Giraitė;LapiukaI;4076402180;Taip;12;0;0;12
2699;Giraitė;LapiukaI;5902161665;Taip;0;8;0;8
2700;Giraitė;LapiukaI;4955786826;Taip;3;1;0;4
2701;Giraitė;LapiukaI;4260343903;Taip;7;0;0;7
2702;Giraitė;Voveriukai;7354834895;Taip;0;12;0;12
2703;Giraitė;Voveriukai;4387282125;Taip;0;1;0;1
2704;Giraitė;Voveriukai;2699984170;Taip;13;2;0;15
2705;Giraitė;Voveriukai;4822168634;Taip;0;0;1;1
2706;Giraitė;Voveriukai;6963656869;Ne;0;5;3;8
2707;Giraitė;Voveriukai;2088867630;Taip;0;0;1;1
2708;Giraitė;Voveriukai;3875214088;Taip;6;4;0;10
2709;Giraitė;Voveriukai;5202562049;Ne;4;0;0;4
2710;Giraitė;Voveriukai;7481895278;Taip;6;0;0;6
2711;Giraitė;Voveriukai;3607198556;Taip;7;0;1;8
2712;Giraitė;Voveriukai;6225092500;Taip;15;0;0;15
2713;Giraitė;Voveriukai;4137699629;Taip;7;0;0;7
2714;Giraitė;Voveriukai;7919088987;Taip;2;2;1;5
2715;Giraitė;Voveriukai;5616242311;Taip;0;0;1;1
2716;Giraitė;Voveriukai;7739516049;Taip;0;0;1;1
2717;Giraitė;Grybukai;61477798910;Ne;0;4;1;5
2718;Giraitė;Grybukai;83995022535;Taip;0;0;1;1
2719;Giraitė;Grybukai;70668076883;Taip;0;0;1;1
2720;Giraitė;Grybukai;482311593;Taip;3;0;2;5
2721;Giraitė;Grybukai;34413917793;Taip;4;0;0;4
2722;Giraitė;Grybukai;10108398683;Ne;0;2;2;4
2723;Giraitė;Grybukai;5824936903;Taip;0;1;0;1
2724;Giraitė;Grybukai;68502311448;Taip;0;0;1;1
2725;Giraitė;Grybukai;1965752607;Taip;0;6;2;8
2726;Giraitė;Riešutėliai;3683700626;Taip;9;2;0;11
2727;Giraitė;Riešutėliai;8596389737;Taip;0;1;3;4
2728;Giraitė;Riešutėliai;5167002022;Ne;0;0;3;3
2729;Giraitė;Riešutėliai;4336519836;Ne;0;10;0;10
2730;Giraitė;Riešutėliai;9026736929;Taip;6;0;0;6
2731;Giraitė;Riešutėliai;9882372025;Taip;3;6;0;9
2732;Giraitė;Riešutėliai;5721669627;Taip;0;0;7;7
2733;Giraitė;Riešutėliai;4785524898;Taip;0;2;0;2
2734;Giraitė;Riešutėliai;4839351300;Taip;0;4;0;4
2735;Giraitė;Riešutėliai;1817075429;Taip;2;0;4;6
2736;Giraitė;Riešutėliai;4687228561;Taip;0;0;2;2
2737;Giraitė;Riešutėliai;9652807467;Ne;2;0;0;2
2738;Giraitė;Meškiukai;5367392810;Taip;4;3;0;7
2739;Giraitė;Meškiukai;1608876140;Taip;0;1;0;1
2740;Giraitė;Meškiukai;5461837332;Taip;0;0;4;4
2741;Giraitė;Meškiukai;1355594003;Taip;2;1;0;3
2742;Giraitė;Meškiukai;1560868105;Taip;0;0;1;1
2743;Giraitė;Meškiukai;1050699551;Taip;0;0;1;1
2744;Giraitė;Meškiukai;1876815077;Ne;0;1;1;2
2745;Giraitė;Meškiukai;1063628206;Taip;0;8;2;10
2746;Giraitė;Meškiukai;1846118720;Taip;4;0;0;4
2747;Giraitė;Meškiukai;1704154980;Taip;0;1;0;1
2748;Giraitė;Meškiukai;2571892050;Taip;22;0;0;22
2749;Giraitė;Meškiukai;1594965200;Ne;15;0;7;22
2750;Giraitė;Meškiukai;9723242940;Taip;22;0;0;22
2751;Giraitė;Meškiukai;5726182600;Taip;0;0;1;1
2752;Giraitė;Meškiukai;1772790396;Ne;5;0;1;6
2753;Giraitė;Uogelės;3031181239;Taip;0;4;0;4
2754;Giraitė;Uogelės;99494458394;Taip;6;0;0;6
2755;Giraitė;Uogelės;1103462199;Taip;4;0;0;4
2756;Giraitė;Uogelės;1447893912;Taip;4;1;0;5
2757;Giraitė;Uogelės;49193108666;Ne;9;11;0;20
2758;Giraitė;Uogelės;31110630088;Taip;3;0;3;6
2759;Giraitė;Uogelės;1312761239;Taip;14;2;0;16
2760;Giraitė;Uogelės;43475840493;Taip;0;2;0;2
2761;Giraitė;Uogelės;30804922053;Taip;14;6;0;20
2762;Giraitė;Uogelės;2083472940;Taip;5;0;0;5
2763;Giraitė;Uogelės;1848908894;Taip;3;0;0;3
2764;Giraitė;Uogelės;99146206772;Taip;4;0;0;4
2765;Giraitė;Uogelės;5378240128;Taip;0;10;0;10
2766;Giraitė;Uogelės;43468579365;Taip;2;0;0;2
2767;Giraitė;Uogelės;74256775397;Ne;9;0;0;9
2768;Giraitė;Uogelės;65392345188;Taip;9;1;0;10
2769;Giraitė;Uogelės;8824642760;Taip;9;0;0;9
2770;Giraitė;Uogelės;1110792632;Taip;2;6;0;8
2771;Giraitė;Uogelės;8590987283;Taip;0;0;7;7
2772;Giraitė;Šaltinėlis;66760677758;Taip;3;1;1;5
2773;Giraitė;Šaltinėlis;33507817372;Taip;0;1;0;1
2774;Giraitė;Šaltinėlis;94197982724;Taip;0;6;0;6
2775;Giraitė;Šaltinėlis;22783526738;Taip;0;0;10;10
2776;Giraitė;Šaltinėlis;79459838218;Taip;6;2;0;8
2777;Giraitė;Šaltinėlis;1690407683;Taip;0;0;3;3
2778;Giraitė;Šaltinėlis;26202357668;Taip;0;2;0;2
2779;Giraitė;Šaltinėlis;260305509;Taip;0;8;0;8
2780;Giraitė;Šaltinėlis;8986196352;Ne;0;8;2;10
2781;Giraitė;Šaltinėlis;9493194946;Taip;0;1;0;1
2782;Giraitė;Šaltinėlis;17883856522;Taip;2;0;0;2
2783;Giraitė;Šaltinėlis;42953220489;Ne;0;2;0;2
2784;Giraitė;Šaltinėlis;1533533163;Taip;0;7;1;8
2785;Giraitė;Šaltinėlis;1816297607;Taip;0;7;0;7
2786;Giraitė;Šaltinėlis;3281237081;Ne;0;0;1;1
2787;Giraitė;Boružėlės;5471577047;Taip;0;2;0;2
2788;Giraitė;Boružėlės;2307307454;Taip;14;0;0;14
2789;Giraitė;Boružėlės;9931533006;Taip;3;0;0;3
2790;Giraitė;Boružėlės;7094750784;Taip;0;11;0;11
2791;Giraitė;Boružėlės;2102237550;Ne;1;0;1;2
2792;Giraitė;Boružėlės;1729871315;Taip;13;0;0;13
2793;Giraitė;Boružėlės;4121361794;Taip;3;0;0;3
2794;Giraitė;Boružėlės;6065010363;Taip;3;0;0;3
2795;Giraitė;Boružėlės;4450822125;Taip;8;0;0;8
2796;Giraitė;Boružėlės;4317544803;Taip;5;0;0;5
2797;Giraitė;Boružėlės;5255040944;Taip;1;0;0;1
2798;Giraitė;Boružėlės;4843415587;Ne;0;3;0;3
2799;Giraitė;Boružėlės;2732715332;Taip;14;0;0;14
2800;Giraitė;Boružėlės;9927102264;Taip;14;0;0;14
2801;Giraitė;Boružėlės;7931998640;Taip;4;1;0;5
2802;Giraitė;Boružėlės;8908602761;Taip;0;1;0;1
2803;Giraitė;Boružėlės;4717851198;Taip;8;0;0;8
2804;Giraitė;Boružėlės;3082550878;Taip;12;0;0;12
2805;Giraitė;Gandriukai;69883334049;Taip;8;0;1;9
2806;Giraitė;Gandriukai;1025627643;Taip;0;0;1;1
2807;Giraitė;Gandriukai;26032013284;Taip;9;0;0;9
2808;Giraitė;Gandriukai;36650870278;Taip;0;0;5;5
2809;Giraitė;Gandriukai;82915040164;Taip;9;0;0;9
2810;Giraitė;Gandriukai;18968645937;Ne;0;1;0;1
2811;Giraitė;Gandriukai;64357457379;Ne;19;0;0;19
2812;Giraitė;Gandriukai;1022899992;Ne;0;0;7;7
2813;Giraitė;Gandriukai;1238299747;Ne;10;0;0;10
2814;Giraitė;Gandriukai;1111614295;Taip;0;6;2;8
2815;Giraitė;Gandriukai;9918028862;Taip;15;2;0;17
2816;Giraitė;Gandriukai;4031993742;Taip;13;0;1;14
2817;Giraitė;Gandriukai;2190246729;Ne;0;8;0;8
2818;Giraitė;Gandriukai;5810648237;Taip;0;0;5;5
2819;Giraitė;Gandriukai;5862292995;Taip;12;2;0;14
2820;Giraitė;Gandriukai;1375377927;Ne;0;0;2;2
2821;Giraitė;ŽVIRBLIUKAI;4444292550;Taip;0;0;1;1
2822;Giraitė;ŽVIRBLIUKAI;1958553421;Taip;0;0;1;1
2823;Giraitė;ŽVIRBLIUKAI;77765768952;Taip;0;1;0;1
2824;Giraitė;ŽVIRBLIUKAI;56380808064;Taip;6;5;0;11
2825;Giraitė;ŽVIRBLIUKAI;1181578380;Ne;16;1;0;17
2826;Giraitė;ŽVIRBLIUKAI;1547711379;Taip;0;0;1;1
2827;Giraitė;ŽVIRBLIUKAI;1234136698;Taip;5;0;2;7
2828;Giraitė;ŽVIRBLIUKAI;2065944230;Taip;12;0;0;12
2829;Giraitė;ŽVIRBLIUKAI;1858146807;Taip;0;0;1;1
2830;Giraitė;ŽVIRBLIUKAI;1435017557;Taip;19;0;0;19
2831;Giraitė;ŽVIRBLIUKAI;3628448974;Ne;0;6;0;6
2832;Giraitė;ŽVIRBLIUKAI;6197641912;Taip;0;0;1;1
2833;Giraitė;ŽVIRBLIUKAI;6973378079;Taip;4;0;1;5
2834;Giraitė;ŽVIRBLIUKAI;8000958461;Taip;5;0;1;6
2835;Giraitė;ŽVIRBLIUKAI;2990968206;Taip;0;2;4;6
2836;Giraitė;Kiškeliai;1583733838;Taip;3;0;0;3
2837;Giraitė;Kiškeliai;4009092043;Taip;4;1;0;5
2838;Giraitė;Kiškeliai;9392127689;Taip;15;0;2;17
2839;Giraitė;Kiškeliai;6677278422;Taip;0;22;0;22
2840;Giraitė;Kiškeliai;6715354865;Ne;11;0;1;12
2841;Giraitė;Kiškeliai;8461725999;Taip;0;0;2;2
2842;Giraitė;Kiškeliai;5086296808;Taip;4;8;1;13
2843;Giraitė;Kiškeliai;7395332578;Taip;19;0;0;19
2844;Giraitė;Kiškeliai;9471560738;Taip;0;1;0;1
2845;Giraitė;Kiškeliai;7230351549;Taip;8;0;3;11
2846;Giraitė;Kiškeliai;7678134658;Taip;2;0;0;2
2847;Giraitė;Kiškeliai;8873231715;Taip;0;0;4;4
2848;Giraitė;Kiškeliai;2416162886;Taip;14;1;0;15
2849;Gudrutis;Gandriukų;6742455931;Ne;0;0;2;2
2850;Gudrutis;Gandriukų;4193661251;Ne;0;7;0;7
2851;Gudrutis;Gandriukų;5574287734;Taip;0;2;0;2
2852;Gudrutis;Gandriukų;7116979528;Taip;0;2;0;2
2853;Gudrutis;Gandriukų;6747372184;Taip;0;0;3;3
2854;Gudrutis;Gandriukų;1693306014;Taip;2;6;0;8
2855;Gudrutis;Gandriukų;2865995680;Taip;0;0;2;2
2856;Gudrutis;Gandriukų;2074151024;Taip;7;2;0;9
2857;Gudrutis;Gandriukų;1991658503;Ne;0;5;1;6
2858;Gudrutis;Gandriukų;9841172472;Taip;10;0;0;10
2859;Gudrutis;Gandriukų;3359028602;Taip;0;6;0;6
2860;Gudrutis;Gandriukų;1445657342;Taip;0;1;2;3
2861;Gudrutis;Gandriukų;4945755164;Taip;0;3;0;3
2862;Gudrutis;Gandriukų;1190408818;Taip;0;0;16;16
2863;Gudrutis;Gandriukų;6443631536;Taip;4;1;0;5
2864;Gudrutis;Gandriukų;3363824185;Taip;1;0;0;1
2865;Gudrutis;Gandriukų;8398961969;Taip;0;1;0;1
2866;Gudrutis;"Saulės zuikučių";6835038962;Taip;0;0;6;6
2867;Gudrutis;"Saulės zuikučių";2118727861;Ne;13;0;0;13
2868;Gudrutis;"Saulės zuikučių";1725920873;Taip;0;0;1;1
2869;Gudrutis;"Saulės zuikučių";1901358996;Taip;4;0;0;4
2870;Gudrutis;"Saulės zuikučių";7664517480;Taip;4;0;6;10
2871;Gudrutis;"Saulės zuikučių";9701111916;Taip;0;0;6;6
2872;Gudrutis;"Saulės zuikučių";1228190677;Taip;0;0;10;10
2873;Gudrutis;"Saulės zuikučių";6198012431;Taip;0;1;7;8
2874;Gudrutis;"Saulės zuikučių";3646335609;Taip;4;0;6;10
2875;Gudrutis;"Saulės zuikučių";7871991275;Taip;0;0;7;7
2876;Gudrutis;"Saulės zuikučių";5580618896;Taip;0;0;7;7
2877;Gudrutis;"Saulės zuikučių";3625838131;Taip;0;4;0;4
2878;Gudrutis;"Saulės zuikučių";2337493193;Taip;6;1;0;7
2879;Gudrutis;"Saulės zuikučių";2764843216;Taip;0;7;3;10
2880;Gudrutis;"Saulės zuikučių";7955353991;Taip;0;13;0;13
2881;Gudrutis;"Saulės zuikučių";2468434676;Taip;0;19;0;19
2882;Gudrutis;Pelėdžiukų;1490739175;Taip;0;3;2;5
2883;Gudrutis;Pelėdžiukų;1823786522;Taip;0;6;1;7
2884;Gudrutis;Pelėdžiukų;1204945185;Taip;0;5;0;5
2885;Gudrutis;Pelėdžiukų;1436950588;Taip;0;0;1;1
2886;Gudrutis;Pelėdžiukų;2453989647;Taip;0;0;6;6
2887;Gudrutis;Pelėdžiukų;1592255250;Taip;0;0;10;10
2888;Gudrutis;Pelėdžiukų;4392872175;Taip;0;1;1;2
2889;Gudrutis;Pelėdžiukų;1618442704;Taip;0;0;4;4
2890;Gudrutis;Pelėdžiukų;77776725399;Taip;0;1;0;1
2891;Gudrutis;Pelėdžiukų;8768627605;Taip;4;2;2;8
2892;Gudrutis;Pelėdžiukų;8085295588;Taip;0;5;0;5
2893;Gudrutis;Pelėdžiukų;21494647270;Taip;0;4;0;4
2894;Gudrutis;Pelėdžiukų;18320321051;Taip;6;0;0;6
2895;Gudrutis;Pelėdžiukų;1156575830;Taip;0;0;1;1
2896;Gudrutis;Pelėdžiukų;74605225026;Taip;14;0;1;15
2897;Gudrutis;Pelėdžiukų;11383212272;Taip;0;8;0;8
2898;Gudrutis;Pelėdžiukų;1434565790;Taip;0;7;5;12
2899;Gudrutis;Pelėdžiukų;1238607523;Taip;0;13;0;13
2900;Gudrutis;Pelėdžiukų;8128313792;Taip;0;0;3;3
2901;Gudrutis;Pelėdžiukų;1998630017;Taip;0;1;4;5
2902;Gudrutis;BITUČIŲ;98473509715;Taip;0;0;8;8
2903;Gudrutis;BITUČIŲ;2012092629;Taip;0;0;13;13
2904;Gudrutis;BITUČIŲ;4727651235;Ne;9;0;1;10
2905;Gudrutis;BITUČIŲ;75589819850;Taip;0;0;1;1
2906;Gudrutis;BITUČIŲ;18813895572;Taip;0;2;2;4
2907;Gudrutis;BITUČIŲ;28075147728;Ne;0;0;13;13
2908;Gudrutis;BITUČIŲ;69437346100;Ne;4;0;0;4
2909;Gudrutis;BITUČIŲ;38591847769;Taip;0;5;0;5
2910;Gudrutis;BITUČIŲ;14626533681;Taip;0;0;3;3
2911;Gudrutis;BITUČIŲ;1174040508;Taip;0;0;1;1
2912;Gudrutis;BITUČIŲ;1013150817;Taip;0;2;1;3
2913;Gudrutis;BITUČIŲ;71306450171;Taip;0;0;1;1
2914;Gudrutis;BITUČIŲ;13755502342;Taip;0;1;1;2
2915;Gudrutis;BITUČIŲ;1261390117;Ne;6;0;0;6
2916;Gudrutis;BITUČIŲ;33123804925;Taip;6;0;1;7
2917;Gudrutis;BITUČIŲ;11324963268;Ne;0;5;0;5
2918;Gudrutis;BITUČIŲ;15665148606;Taip;0;7;1;8
2919;Gudrutis;BITUČIŲ;21999129886;Taip;0;5;0;5
2920;Gudrutis;BITUČIŲ;74606626459;Taip;0;0;5;5
2921;Gudrutis;BITUČIŲ;3363640861;Taip;1;0;0;1
2922;Gudrutis;Boružėlių;7934673005;Taip;15;0;0;15
2923;Gudrutis;Boružėlių;7006545234;Ne;11;0;0;11
2924;Gudrutis;Boružėlių;2199222671;Taip;3;0;1;4
2925;Gudrutis;Boružėlių;4814488445;Taip;7;0;0;7
2926;Gudrutis;Boružėlių;5241856014;Taip;18;0;0;18
2927;Gudrutis;Boružėlių;8500911420;Taip;0;3;0;3
2928;Gudrutis;Boružėlių;5728436444;Taip;10;0;0;10
2929;Gudrutis;Boružėlių;9041133527;Taip;6;3;0;9
2930;Gudrutis;Boružėlių;9328365491;Taip;12;3;0;15
2931;Gudrutis;Boružėlių;2291393238;Taip;0;0;2;2
2932;Gudrutis;Boružėlių;1384696362;Taip;0;14;0;14
2933;Gudrutis;Boružėlių;2619718027;Taip;5;0;1;6
2934;Gudrutis;Drugeliai;2487363252;Ne;0;0;2;2
2935;Gudrutis;Drugeliai;8165828215;Taip;7;0;0;7
2936;Gudrutis;Drugeliai;1701035039;Ne;0;4;0;4
2937;Gudrutis;Drugeliai;1012579870;Taip;22;0;0;22
2938;Gudrutis;Drugeliai;5508723821;Taip;9;1;0;10
2939;Gudrutis;Drugeliai;7755882832;Ne;3;0;0;3
2940;Gudrutis;Drugeliai;8512130106;Taip;0;1;0;1
2941;Gudrutis;Drugeliai;3814794448;Taip;22;0;0;22
2942;Gudrutis;Drugeliai;3919786807;Taip;0;0;4;4
2943;Gudrutis;Drugeliai;8807008147;Taip;10;0;6;16
2944;Gudrutis;Drugeliai;9249913155;Taip;4;0;0;4
2945;Gudrutis;Drugeliai;2197278086;Ne;4;1;4;9
2946;Jurginėlis;Ąžuoliukai;7753784918;Ne;0;0;6;6
2947;Jurginėlis;Ąžuoliukai;4852619394;Taip;11;9;0;20
2948;Jurginėlis;Ąžuoliukai;8972814655;Taip;8;0;3;11
2949;Jurginėlis;Ąžuoliukai;1361108271;Taip;0;0;3;3
2950;Jurginėlis;Ąžuoliukai;1829089083;Taip;0;5;0;5
2951;Jurginėlis;Ąžuoliukai;8784076886;Taip;2;0;1;3
2952;Jurginėlis;Ąžuoliukai;47243459592;Taip;4;0;0;4
2953;Jurginėlis;Ąžuoliukai;1954364886;Taip;17;0;0;17
2954;Jurginėlis;Ąžuoliukai;1563317396;Taip;0;0;3;3
2955;Jurginėlis;Ąžuoliukai;1701720412;Taip;0;0;1;1
2956;Jurginėlis;Ąžuoliukai;6111863896;Taip;0;10;0;10
2957;Jurginėlis;Ąžuoliukai;4851923549;Taip;0;0;4;4
2958;Jurginėlis;Ąžuoliukai;1467200002;Taip;0;5;0;5
2959;Jurginėlis;Ąžuoliukai;1758862051;Taip;0;2;0;2
2960;Jurginėlis;Ąžuoliukai;1974388885;Taip;0;14;0;14
2961;Jurginėlis;Ąžuoliukai;9589394406;Taip;0;5;0;5
2962;Jurginėlis;Ąžuoliukai;2171115974;Taip;0;0;3;3
2963;Jurginėlis;Ąžuoliukai;8920304044;Taip;0;8;1;9
2964;Jurginėlis;Žiogeliai;5892180334;Taip;9;3;0;12
2965;Jurginėlis;Žiogeliai;8144038013;Taip;6;2;0;8
2966;Jurginėlis;Žiogeliai;7928799065;Taip;0;2;0;2
2967;Jurginėlis;Žiogeliai;2624313807;Taip;18;0;0;18
2968;Jurginėlis;Žiogeliai;9646318532;Taip;0;6;0;6
2969;Jurginėlis;Žiogeliai;5242359650;Taip;0;4;0;4
2970;Jurginėlis;Žiogeliai;1759218238;Taip;6;1;0;7
2971;Jurginėlis;Žiogeliai;1102466152;Taip;0;5;0;5
2972;Jurginėlis;Žiogeliai;4806248290;Taip;0;2;0;2
2973;Jurginėlis;Žiogeliai;1082593212;Taip;0;8;0;8
2974;Jurginėlis;Žiogeliai;1175441410;Taip;0;7;0;7
2975;Jurginėlis;Žiogeliai;1983924909;Taip;6;6;0;12
2976;Jurginėlis;Žiogeliai;2710889915;Taip;1;1;0;2
2977;Jurginėlis;Žiogeliai;1586599624;Taip;0;11;0;11
2978;Jurginėlis;Žiogeliai;7297672386;Taip;0;7;0;7
2979;Jurginėlis;Žiogeliai;1787311340;Taip;0;5;0;5
2980;Jurginėlis;Žiogeliai;2535601005;Taip;8;0;0;8
2981;Jurginėlis;Žiogeliai;2639125463;Taip;5;3;0;8
2982;Jurginėlis;Žiogeliai;6413324051;Taip;0;2;0;2
2983;Jurginėlis;Žiogeliai;3708774681;Taip;5;7;0;12
2984;Jurginėlis;Pelėdžiukų;49181526821;Taip;0;1;0;1
2985;Jurginėlis;Pelėdžiukų;35653034443;Taip;0;12;0;12
2986;Jurginėlis;Pelėdžiukų;59935106302;Taip;0;0;1;1
2987;Jurginėlis;Pelėdžiukų;52877525045;Taip;0;15;0;15
2988;Jurginėlis;Pelėdžiukų;36829106143;Taip;0;0;1;1
2989;Jurginėlis;Pelėdžiukų;45200409204;Taip;0;10;1;11
2990;Jurginėlis;Pelėdžiukų;2544904907;Ne;9;0;3;12
2991;Jurginėlis;Pelėdžiukų;8414893303;Taip;0;10;0;10
2992;Jurginėlis;Pelėdžiukų;70733592257;Taip;0;12;2;14
2993;Jurginėlis;Pelėdžiukų;54494144846;Taip;0;5;0;5
2994;Jurginėlis;Pelėdžiukų;6072633581;Taip;0;5;0;5
2995;Jurginėlis;Pelėdžiukų;1295024976;Taip;0;0;4;4
2996;Jurginėlis;Pelėdžiukų;1416995981;Taip;0;0;2;2
2997;Jurginėlis;Boružėlių;92559573466;Ne;0;8;0;8
2998;Jurginėlis;Boružėlių;7798931951;Taip;0;3;0;3
2999;Jurginėlis;Boružėlių;59618430487;Taip;3;3;0;6
3000;Jurginėlis;Boružėlių;8217773164;Taip;0;10;0;10
3001;Jurginėlis;Boružėlių;29601247012;Taip;0;11;0;11
3002;Jurginėlis;Boružėlių;75192831969;Taip;0;3;0;3
3003;Jurginėlis;Boružėlių;29155768493;Taip;0;1;0;1
3004;Jurginėlis;Boružėlių;10095155757;Taip;0;5;0;5
3005;Jurginėlis;Boružėlių;67578476769;Taip;0;9;0;9
3006;Jurginėlis;Boružėlių;64852957209;Taip;0;9;0;9
3007;Jurginėlis;Boružėlių;64641268493;Taip;0;1;0;1
3008;Jurginėlis;Boružėlių;56382554421;Taip;0;4;0;4
3009;Jurginėlis;Boružėlių;51856181602;Ne;10;0;0;10
3010;Jurginėlis;Boružėlių;23049094719;Taip;0;1;0;1
3011;Jurginėlis;Boružėlių;1742217696;Ne;0;14;0;14
3012;Jurginėlis;Boružėlių;52105378503;Taip;0;1;0;1
3013;Jurginėlis;Bitučių;2106937059;Taip;5;3;0;8
3014;Jurginėlis;Bitučių;93055778306;Taip;0;6;0;6
3015;Jurginėlis;Bitučių;92688596347;Ne;1;13;0;14
3016;Jurginėlis;Bitučių;1175198086;Taip;0;1;0;1
3017;Jurginėlis;Bitučių;96017651718;Taip;0;0;3;3
3018;Jurginėlis;Bitučių;87566883270;Taip;0;9;0;9
3019;Jurginėlis;Bitučių;84691244839;Taip;0;4;0;4
3020;Jurginėlis;Bitučių;53783266582;Taip;0;2;0;2
3021;Jurginėlis;Bitučių;55253928424;Taip;0;8;0;8
3022;Jurginėlis;Bitučių;2557687323;Taip;1;0;0;1
3023;Jurginėlis;Bitučių;8149405217;Taip;0;8;0;8
3024;Jurginėlis;Bitučių;53924769958;Taip;7;0;1;8
3025;Jurginėlis;Bitučių;60988201430;Taip;0;2;0;2
3026;Jurginėlis;Bitučių;1421681717;Taip;1;0;3;4
3027;Jurginėlis;Bitučių;24615714793;Ne;7;8;0;15
3028;Jurginėlis;Bitučių;1058274970;Taip;4;0;2;6
3029;Jurginėlis;Bitučių;64524305038;Taip;0;6;0;6
3030;Jurginėlis;Bitučių;90786336005;Taip;0;2;0;2
3031;Jurginėlis;Bitučių;1041294212;Taip;0;0;1;1
3032;Jurginėlis;Bitučių;1191021311;Taip;0;9;0;9
3033;Jurginėlis;Skruzdeliukų;1400142372;Taip;0;5;0;5
3034;Jurginėlis;Skruzdeliukų;92602685294;Taip;0;2;0;2
3035;Jurginėlis;Skruzdeliukų;1485725580;Ne;8;1;0;9
3036;Jurginėlis;Skruzdeliukų;51685299187;Ne;11;3;0;14
3037;Jurginėlis;Skruzdeliukų;1881790340;Taip;0;13;0;13
3038;Jurginėlis;Skruzdeliukų;31143311410;Taip;4;0;0;4
3039;Jurginėlis;Skruzdeliukų;94107758268;Taip;0;12;0;12
3040;Jurginėlis;Skruzdeliukų;1258821883;Ne;12;0;0;12
3041;Jurginėlis;Skruzdeliukų;38755774035;Taip;4;1;0;5
3042;Jurginėlis;Skruzdeliukų;68109772993;Ne;0;1;0;1
3043;Jurginėlis;Skruzdeliukų;81064432153;Taip;9;0;0;9
3044;Jurginėlis;Skruzdeliukų;12659496203;Taip;9;0;2;11
3045;Jurginėlis;Skruzdeliukų;17286700686;Ne;0;0;2;2
3046;Jurginėlis;Skruzdeliukų;1506649972;Taip;0;14;0;14
3047;Jurginėlis;Skruzdeliukų;87991288027;Ne;22;0;0;22
3048;Jurginėlis;Drugelių;6181547354;Taip;22;0;0;22
3049;Jurginėlis;Drugelių;2221708420;Ne;20;0;0;20
3050;Jurginėlis;Drugelių;1340689348;Taip;14;0;0;14
3051;Jurginėlis;Drugelių;2925253653;Taip;10;0;0;10
3052;Jurginėlis;Drugelių;4967548277;Taip;0;10;12;22
3053;Jurginėlis;Drugelių;8443412187;Ne;3;0;0;3
3054;Jurginėlis;Drugelių;8779807396;Taip;5;0;0;5
3055;Jurginėlis;Drugelių;9507571301;Taip;4;0;0;4
3056;Jurginėlis;Drugelių;4292932046;Ne;3;0;0;3
3057;Jurginėlis;Drugelių;6968528293;Taip;9;1;0;10
3058;Jurginėlis;Drugelių;2417314519;Taip;5;1;0;6
3059;Jurginėlis;Drugelių;7809274980;Taip;15;0;0;15
3060;Jurginėlis;Drugelių;9946892497;Taip;10;0;0;10
3061;Jurginėlis;Drugelių;1455749921;Ne;13;9;0;22
3062;Jurginėlis;Drugelių;3079495897;Taip;3;0;1;4
3063;Jurginėlis;Drugelių;5984893389;Taip;0;5;0;5
3064;Jurginėlis;Drugelių;2490875633;Taip;22;0;0;22
3065;Jurginėlis;Drugelių;8727844649;Taip;4;0;10;14
3066;Jurginėlis;Drugelių;8876608072;Taip;0;12;0;12
3067;Jurginėlis;Žibučių;3284464951;Taip;10;4;0;14
3068;Jurginėlis;Žibučių;4158502752;Taip;0;18;0;18
3069;Jurginėlis;Žibučių;7990015623;Ne;9;1;2;12
3070;Jurginėlis;Žibučių;6579565337;Taip;4;0;0;4
3071;Jurginėlis;Žibučių;5921714669;Taip;0;1;0;1
3072;Jurginėlis;Žibučių;4463258777;Taip;11;0;1;12
3073;Jurginėlis;Žibučių;4827340942;Ne;10;0;0;10
3074;Jurginėlis;Žibučių;2627736026;Taip;22;0;0;22
3075;Jurginėlis;Žibučių;2548920722;Taip;4;0;2;6
3076;Jurginėlis;Žibučių;6806704355;Taip;8;0;0;8
3077;Jurginėlis;Žibučių;9288380246;Taip;5;4;0;9
3078;Jurginėlis;Žibučių;3627487971;Taip;0;0;2;2
3079;Jurginėlis;Žibučių;2214809186;Ne;4;0;0;4
3080;Jurginėlis;Žibučių;2225892248;Taip;9;0;0;9
3081;Jurginėlis;Žibučių;1414888906;Taip;4;0;2;6
3082;Jurginėlis;Žibučių;7288921301;Ne;14;0;2;16
3083;Jurginėlis;Žibučių;3031725530;Taip;4;1;0;5
3084;Jurginėlis;Zuikučių;1656300401;Taip;0;12;0;12
3085;Jurginėlis;Zuikučių;1759031589;Taip;0;6;0;6
3086;Jurginėlis;Zuikučių;1945098580;Taip;5;1;0;6
3087;Jurginėlis;Zuikučių;1409480187;Taip;0;2;0;2
3088;Jurginėlis;Zuikučių;1780106633;Taip;0;5;0;5
3089;Jurginėlis;Zuikučių;8793129805;Taip;7;3;0;10
3090;Jurginėlis;Zuikučių;74303787465;Ne;0;12;0;12
3091;Jurginėlis;Zuikučių;8227660508;Taip;0;12;0;12
3092;Jurginėlis;Zuikučių;2446630485;Taip;0;2;0;2
3093;Jurginėlis;Zuikučių;7293372539;Ne;0;2;0;2
3094;Jurginėlis;Zuikučių;5386710069;Taip;6;1;0;7
3095;Jurginėlis;Zuikučių;7920082372;Ne;4;15;0;19
3096;Jurginėlis;Zuikučių;5756997642;Ne;0;8;0;8
3097;Jurginėlis;Zuikučių;77480957625;Taip;0;1;0;1
3098;Jurginėlis;Viščiukų;6729212950;Taip;7;0;0;7
3099;Jurginėlis;Viščiukų;6636147085;Taip;0;1;4;5
3100;Jurginėlis;Viščiukų;5734506036;Ne;9;4;0;13
3101;Jurginėlis;Viščiukų;1726968598;Taip;7;14;0;21
3102;Jurginėlis;Viščiukų;4979618298;Taip;0;1;0;1
3103;Jurginėlis;Viščiukų;5180951251;Taip;22;0;0;22
3104;Jurginėlis;Viščiukų;9550110246;Ne;0;19;0;19
3105;Jurginėlis;Viščiukų;9506129699;Taip;4;0;0;4
3106;Jurginėlis;Viščiukų;3038732180;Taip;18;0;0;18
3107;Jurginėlis;Viščiukų;9961083854;Taip;0;8;0;8
3108;Jurginėlis;Viščiukų;3699180485;Taip;0;11;0;11
3109;Jurginėlis;Viščiukų;4536086996;Ne;4;0;0;4
3110;Jurginėlis;Viščiukų;6542567172;Taip;15;5;0;20
3111;Jurginėlis;Viščiukų;4944292549;Taip;2;10;0;12
3112;Jurginėlis;Meškiukų;8017976529;Ne;22;0;0;22
3113;Jurginėlis;Meškiukų;9289922622;Taip;22;0;0;22
3114;Jurginėlis;Meškiukų;6202225321;Taip;11;0;0;11
3115;Jurginėlis;Meškiukų;3530906368;Ne;1;0;0;1
3116;Jurginėlis;Meškiukų;6587382160;Taip;3;0;4;7
3117;Jurginėlis;Meškiukų;1351306981;Taip;5;3;1;9
3118;Jurginėlis;Meškiukų;4432849717;Taip;0;3;0;3
3119;Jurginėlis;Meškiukų;6671759364;Taip;4;0;0;4
3120;Jurginėlis;Meškiukų;9146039217;Taip;1;0;0;1
3121;Jurginėlis;Meškiukų;3558752347;Taip;0;9;0;9
3122;Jurginėlis;Meškiukų;8097652962;Taip;4;0;0;4
3123;Jurginėlis;Meškiukų;8161347781;Taip;0;10;0;10
3124;Jurginėlis;Meškiukų;4113264904;Taip;9;0;0;9
3125;Jurginėlis;Gandriukų;7419836868;Ne;0;11;0;11
3126;Jurginėlis;Gandriukų;51603579121;Ne;0;8;0;8
3127;Jurginėlis;Gandriukų;87444065733;Taip;4;11;0;15
3128;Jurginėlis;Gandriukų;2264351097;Taip;5;0;0;5
3129;Jurginėlis;Gandriukų;78496894090;Ne;0;1;14;15
3130;Jurginėlis;Gandriukų;99523320519;Taip;5;0;5;10
3131;Jurginėlis;Gandriukų;1498351759;Ne;11;1;1;13
3132;Jurginėlis;Gandriukų;75383941896;Taip;2;4;2;8
3133;Jurginėlis;Gandriukų;1508705709;Taip;0;6;0;6
3134;Jurginėlis;Gandriukų;1773100970;Taip;11;5;0;16
3135;Jurginėlis;Gandriukų;1500087367;Taip;11;5;0;16
3136;Jurginėlis;Gandriukų;8178112926;Taip;5;4;0;9
3137;Jurginėlis;Gandriukų;6475508583;Taip;9;0;5;14
3138;Jurginėlis;Gandriukų;9714764714;Taip;4;0;11;15
3139;Jurginėlis;Gandriukų;1762685527;Ne;0;3;0;3
3140;Karusėlė;PAGRANDUKAS;1621482372;Taip;11;1;0;12
3141;Karusėlė;PAGRANDUKAS;3330374479;Taip;16;0;0;16
3142;Karusėlė;PAGRANDUKAS;6183785840;Taip;0;4;0;4
3143;Karusėlė;PAGRANDUKAS;3984262482;Taip;10;8;0;18
3144;Karusėlė;PAGRANDUKAS;9130534156;Taip;11;0;0;11
3145;Karusėlė;PAGRANDUKAS;3660843696;Ne;0;0;2;2
3146;Karusėlė;PAGRANDUKAS;1412890120;Taip;22;0;0;22
3147;Karusėlė;PAGRANDUKAS;5132581245;Taip;4;4;0;8
3148;Karusėlė;PAGRANDUKAS;2160071272;Taip;0;5;0;5
3149;Karusėlė;PAGRANDUKAS;9462242426;Taip;22;0;0;22
3150;Karusėlė;PAGRANDUKAS;2412418335;Taip;0;3;0;3
3151;Karusėlė;PAGRANDUKAS;7393434659;Taip;4;0;1;5
3152;Karusėlė;PAGRANDUKAS;6826455161;Taip;0;8;1;9
3153;Karusėlė;PAGRANDUKAS;5695697634;Taip;3;0;4;7
3154;Karusėlė;PAGRANDUKAS;8127218866;Taip;6;0;0;6
3155;Karusėlė;PAGRANDUKAS;6062361348;Taip;0;4;0;4
3156;Karusėlė;PAGRANDUKAS;3620722907;Taip;9;0;0;9
3157;Karusėlė;PAGRANDUKAS;7013765804;Ne;0;13;0;13
3158;Karusėlė;PAGRANDUKAS;3429495073;Taip;11;0;0;11
3159;Karusėlė;PAGRANDUKAS;5951045233;Taip;3;0;0;3
3160;Karusėlė;PAGRANDUKAS;6252613489;Taip;0;7;0;7
3161;Karusėlė;PAGRANDUKAS;5595950213;Taip;4;0;1;5
3162;Karusėlė;PAGRANDUKAS;6004882312;Taip;0;13;0;13
3163;Karusėlė;NYKŠTUKAS;1560316431;Taip;0;6;0;6
3164;Karusėlė;NYKŠTUKAS;82963400142;Taip;5;1;1;7
3165;Karusėlė;NYKŠTUKAS;77290004668;Ne;0;0;2;2
3166;Karusėlė;NYKŠTUKAS;64652121316;Taip;0;6;0;6
3167;Karusėlė;NYKŠTUKAS;1250530261;Taip;10;3;0;13
3168;Karusėlė;NYKŠTUKAS;1397009220;Taip;0;10;0;10
3169;Karusėlė;NYKŠTUKAS;62938709605;Taip;0;0;1;1
3170;Karusėlė;NYKŠTUKAS;1680275369;Ne;5;0;0;5
3171;Karusėlė;NYKŠTUKAS;17728195505;Taip;4;1;0;5
3172;Karusėlė;NYKŠTUKAS;1534689679;Taip;4;0;2;6
3173;Karusėlė;NYKŠTUKAS;1226371512;Taip;3;0;2;5
3174;Karusėlė;NYKŠTUKAS;68739693482;Taip;17;0;0;17
3175;Karusėlė;NYKŠTUKAS;9377426384;Taip;0;1;0;1
3176;Karusėlė;NYKŠTUKAS;1311631554;Ne;11;0;0;11
3177;Karusėlė;NYKŠTUKAS;5481354767;Taip;4;4;0;8
3178;Karusėlė;NYKŠTUKAS;1135386852;Taip;17;0;1;18
3179;Karusėlė;NYKŠTUKAS;8419242504;Taip;14;0;5;19
3180;Karusėlė;NYKŠTUKAS;3875204515;Taip;3;4;0;7
3181;Karusėlė;NYKŠTUKAS;45634061915;Taip;0;9;0;9
3182;Karusėlė;BITUTĖ;2526585854;Taip;0;10;0;10
3183;Karusėlė;BITUTĖ;15575896909;Taip;0;14;0;14
3184;Karusėlė;BITUTĖ;1839186035;Ne;5;7;0;12
3185;Karusėlė;BITUTĖ;2653604193;Taip;4;0;0;4
3186;Karusėlė;BITUTĖ;1065703569;Taip;0;9;0;9
3187;Karusėlė;BITUTĖ;1295435839;Taip;0;3;0;3
3188;Karusėlė;BITUTĖ;1883944064;Ne;0;5;0;5
3189;Karusėlė;BITUTĖ;3870601809;Taip;2;1;0;3
3190;Karusėlė;BITUTĖ;2001623432;Taip;6;3;0;9
3191;Karusėlė;BITUTĖ;8033732937;Taip;0;2;0;2
3192;Karusėlė;BITUTĖ;1798723081;Ne;0;6;1;7
3193;Karusėlė;BITUTĖ;88371238657;Taip;0;3;0;3
3194;Karusėlė;BITUTĖ;1593728369;Ne;12;1;0;13
3195;Karusėlė;BITUTĖ;1809033214;Taip;0;13;0;13
3196;Karusėlė;BITUTĖ;9065247151;Taip;0;15;0;15
3197;Karusėlė;BITUTĖ;75574841532;Ne;7;2;0;9
3198;Karusėlė;BITUTĖ;25581881402;Taip;3;5;0;8
3199;Karusėlė;BITUTĖ;6417699445;Taip;4;0;0;4
3200;Karusėlė;BITUTĖ;1193711193;Taip;0;8;0;8
3201;Karusėlė;BORUŽĖLĖ;1705790474;Taip;5;0;0;5
3202;Karusėlė;BORUŽĖLĖ;8608177987;Taip;10;2;0;12
3203;Karusėlė;BORUŽĖLĖ;4890393582;Taip;0;10;0;10
3204;Karusėlė;BORUŽĖLĖ;1311907441;Taip;0;1;0;1
3205;Karusėlė;BORUŽĖLĖ;6313010762;Taip;8;2;0;10
3206;Karusėlė;BORUŽĖLĖ;37349219339;Taip;6;2;0;8
3207;Karusėlė;BORUŽĖLĖ;49110267692;Taip;14;0;0;14
3208;Karusėlė;BORUŽĖLĖ;6811862463;Taip;11;6;0;17
3209;Karusėlė;BORUŽĖLĖ;5471989295;Taip;14;2;0;16
3210;Karusėlė;BORUŽĖLĖ;9753876554;Taip;8;2;0;10
3211;Karusėlė;BORUŽĖLĖ;1204919995;Taip;22;0;0;22
3212;Karusėlė;BORUŽĖLĖ;8717484092;Ne;15;0;0;15
3213;Karusėlė;BORUŽĖLĖ;5351690991;Taip;14;2;2;18
3214;Karusėlė;BORUŽĖLĖ;1994682683;Taip;11;0;4;15
3215;Karusėlė;BORUŽĖLĖ;5632697184;Taip;12;0;0;12
3216;Karusėlė;BORUŽĖLĖ;4262640017;Ne;8;1;0;9
3217;Karusėlė;BORUŽĖLĖ;4845558814;Taip;15;4;0;19
3218;Karusėlė;BORUŽĖLĖ;8406462155;Ne;15;0;0;15
3219;Karusėlė;BORUŽĖLĖ;6495631086;Ne;12;2;0;14
3220;Karusėlė;BORUŽĖLĖ;1183484176;Taip;7;3;0;10
3221;Karusėlė;UOGELĖ;9805481603;Taip;0;2;0;2
3222;Karusėlė;UOGELĖ;8182071103;Ne;3;8;0;11
3223;Karusėlė;UOGELĖ;8175498192;Taip;2;1;2;5
3224;Karusėlė;UOGELĖ;3053539045;Taip;3;0;0;3
3225;Karusėlė;UOGELĖ;9992989896;Taip;10;0;0;10
3226;Karusėlė;UOGELĖ;2084276906;Taip;8;0;0;8
3227;Karusėlė;UOGELĖ;1098106063;Taip;0;1;3;4
3228;Karusėlė;UOGELĖ;8665314366;Taip;0;7;0;7
3229;Karusėlė;UOGELĖ;5651238035;Taip;5;0;0;5
3230;Karusėlė;UOGELĖ;4121668687;Taip;4;0;1;5
3231;Karusėlė;UOGELĖ;8316147204;Taip;5;1;0;6
3232;Karusėlė;UOGELĖ;5504719953;Taip;0;0;17;17
3233;Karusėlė;UOGELĖ;5919009583;Taip;14;0;5;19
3234;Karusėlė;UOGELĖ;4199597984;Taip;0;7;0;7
3235;Karusėlė;UOGELĖ;2383023280;Taip;11;3;0;14
3236;Karusėlė;UOGELĖ;1575408822;Taip;0;6;0;6
3237;Karusėlė;UOGELĖ;3917113787;Taip;8;0;0;8
3238;Karusėlė;UOGELĖ;4068106379;Taip;0;0;8;8
3239;Karusėlė;UOGELĖ;1428516421;Taip;0;0;3;3
3240;Karusėlė;UOGELĖ;4638918427;Taip;3;0;0;3
3241;Karusėlė;UOGELĖ;3615957761;Taip;10;2;0;12
3242;Karusėlė;UOGELĖ;3514026443;Taip;10;0;0;10
3243;Karusėlė;UOGELĖ;1891147022;Taip;0;1;0;1
3244;Karusėlė;UOGELĖ;9389017016;Taip;11;0;0;11
3245;Karusėlė;GINTARĖLIS;89669425763;Taip;0;0;11;11
3246;Karusėlė;GINTARĖLIS;1058129883;Taip;0;1;4;5
3247;Karusėlė;GINTARĖLIS;1625704473;Taip;0;1;0;1
3248;Karusėlė;GINTARĖLIS;5267055924;Ne;0;8;0;8
3249;Karusėlė;GINTARĖLIS;17254955427;Taip;10;1;0;11
3250;Karusėlė;GINTARĖLIS;1467237683;Taip;0;1;0;1
3251;Karusėlė;GINTARĖLIS;33935704865;Taip;0;4;0;4
3252;Karusėlė;GINTARĖLIS;92286460424;Taip;0;11;0;11
3253;Karusėlė;GINTARĖLIS;80377577910;Taip;0;5;0;5
3254;Karusėlė;GINTARĖLIS;1302846796;Taip;22;0;0;22
3255;Karusėlė;GINTARĖLIS;6181109173;Ne;0;1;0;1
3256;Karusėlė;GINTARĖLIS;90635580825;Taip;15;4;0;19
3257;Karusėlė;GINTARĖLIS;93635113154;Taip;0;1;3;4
3258;Karusėlė;GINTARĖLIS;2386140324;Taip;0;13;0;13
3259;Karusėlė;GINTARĖLIS;90731574209;Ne;0;7;0;7
3260;Karusėlė;GINTARĖLIS;6596029324;Taip;0;2;0;2
3261;Karusėlė;GINTARĖLIS;1477282992;Taip;5;3;0;8
3262;Karusėlė;GINTARĖLIS;1487641646;Taip;0;2;1;3
3263;Karusėlė;GINTARĖLIS;9274456755;Taip;0;1;0;1
3264;Karusėlė;SAULUTĖ;1705251019;Taip;0;3;1;4
3265;Karusėlė;SAULUTĖ;64855471225;Taip;0;0;2;2
3266;Karusėlė;SAULUTĖ;45701480267;Taip;5;0;0;5
3267;Karusėlė;SAULUTĖ;35910852843;Taip;0;2;3;5
3268;Karusėlė;SAULUTĖ;1223992311;Taip;0;4;1;5
3269;Karusėlė;SAULUTĖ;1239411995;Ne;0;1;0;1
3270;Karusėlė;SAULUTĖ;4806666157;Ne;0;1;0;1
3271;Karusėlė;SAULUTĖ;10539595272;Taip;2;0;0;2
3272;Karusėlė;SAULUTĖ;52452661421;Taip;0;1;0;1
3273;Karusėlė;SAULUTĖ;2606829789;Ne;3;1;0;4
3274;Karusėlė;SAULUTĖ;63044693440;Taip;1;4;0;5
3275;Karusėlė;SAULUTĖ;23662916408;Taip;0;5;1;6
3276;Karusėlė;SAULUTĖ;99462674291;Ne;0;0;12;12
3277;Karusėlė;SAULUTĖ;59790578013;Taip;0;1;0;1
3278;Karusėlė;SAULUTĖ;2025180617;Taip;0;1;0;1
3279;Karusėlė;SAULUTĖ;7977835762;Taip;0;6;0;6
3280;Karusėlė;SAULUTĖ;1273810363;Taip;5;2;0;7
3281;Karusėlė;SAULUTĖ;25328680614;Taip;0;1;0;1
3282;Karusėlė;SAULUTĖ;2038274137;Taip;7;0;0;7
3283;Karusėlė;TIGRIUKAS;1982126099;Taip;0;1;0;1
3284;Karusėlė;TIGRIUKAS;1292576152;Taip;0;1;0;1
3285;Karusėlė;TIGRIUKAS;18831943978;Taip;7;0;0;7
3286;Karusėlė;TIGRIUKAS;1305485683;Taip;11;1;0;12
3287;Karusėlė;TIGRIUKAS;1817869518;Taip;12;0;0;12
3288;Karusėlė;TIGRIUKAS;1773362652;Taip;6;2;0;8
3289;Karusėlė;TIGRIUKAS;3752570475;Ne;0;3;0;3
3290;Karusėlė;TIGRIUKAS;8881750322;Taip;5;1;0;6
3291;Karusėlė;TIGRIUKAS;8946147763;Taip;14;0;0;14
3292;Karusėlė;TIGRIUKAS;3960354989;Taip;3;0;0;3
3293;Karusėlė;TIGRIUKAS;1947403400;Taip;6;2;0;8
3294;Karusėlė;TIGRIUKAS;3690179876;Ne;16;0;0;16
3295;Karusėlė;TIGRIUKAS;7947148051;Taip;0;3;0;3
3296;Karusėlė;TIGRIUKAS;8076851284;Ne;4;3;0;7
3297;Karusėlė;TIGRIUKAS;5135054911;Taip;6;9;0;15
3298;Karusėlė;TIGRIUKAS;4426462711;Taip;0;3;0;3
3299;Karusėlė;TIGRIUKAS;8656806219;Taip;0;0;2;2
3300;Karusėlė;TIGRIUKAS;9484773068;Ne;10;0;0;10
3301;Karusėlė;TIGRIUKAS;8678437720;Ne;7;3;0;10
3302;Karusėlė;TIGRIUKAS;9868386182;Taip;3;0;0;3
3303;Karusėlė;TIGRIUKAS;1698478530;Taip;11;1;0;12
3304;Karusėlė;VAIVORYKŠTĖ;89727334417;Taip;0;13;0;13
3305;Karusėlė;VAIVORYKŠTĖ;21474974272;Taip;0;5;0;5
3306;Karusėlė;VAIVORYKŠTĖ;1629901230;Taip;0;4;0;4
3307;Karusėlė;VAIVORYKŠTĖ;2092642601;Taip;0;3;0;3
3308;Karusėlė;VAIVORYKŠTĖ;1097025436;Taip;0;2;0;2
3309;Karusėlė;VAIVORYKŠTĖ;1886562437;Taip;0;2;0;2
3310;Karusėlė;VAIVORYKŠTĖ;1915396083;Taip;0;1;0;1
3311;Karusėlė;VAIVORYKŠTĖ;1094853107;Taip;0;13;0;13
3312;Karusėlė;VAIVORYKŠTĖ;40499469616;Ne;0;3;0;3
3313;Karusėlė;VAIVORYKŠTĖ;26373120499;Taip;0;2;0;2
3314;Karusėlė;VAIVORYKŠTĖ;78971949838;Taip;0;11;0;11
3315;Karusėlė;VAIVORYKŠTĖ;25859211954;Taip;4;0;1;5
3316;Karusėlė;VAIVORYKŠTĖ;47751458940;Taip;5;1;0;6
3317;Karusėlė;VAIVORYKŠTĖ;4878805177;Taip;0;0;1;1
3318;Karusėlė;VAIVORYKŠTĖ;68537797465;Taip;0;3;0;3
3319;Karusėlė;VAIVORYKŠTĖ;11336671763;Ne;0;10;0;10
3320;Karusėlė;VAIVORYKŠTĖ;9482894921;Ne;22;0;0;22
3321;Karusėlė;VAIVORYKŠTĖ;6580115367;Taip;0;1;0;1
3322;Karusėlė;VAIVORYKŠTĖ;1982350605;Taip;3;0;1;4
3323;Karusėlė;VAIVORYKŠTĖ;2098165226;Ne;0;1;2;3
3324;Karusėlė;"AUKSINĖ ŽUVELĖ";5704218177;Taip;14;0;0;14
3325;Karusėlė;"AUKSINĖ ŽUVELĖ";1289442716;Ne;10;2;0;12
3326;Karusėlė;"AUKSINĖ ŽUVELĖ";5627583683;Taip;22;0;0;22
3327;Karusėlė;"AUKSINĖ ŽUVELĖ";9561892809;Taip;14;8;0;22
3328;Karusėlė;"AUKSINĖ ŽUVELĖ";4445214427;Taip;0;4;0;4
3329;Karusėlė;"AUKSINĖ ŽUVELĖ";9726299722;Taip;3;5;0;8
3330;Karusėlė;"AUKSINĖ ŽUVELĖ";2894817418;Taip;22;0;0;22
3331;Karusėlė;"AUKSINĖ ŽUVELĖ";1576201225;Taip;18;0;0;18
3332;Karusėlė;"AUKSINĖ ŽUVELĖ";6546648346;Taip;0;9;0;9
3333;Karusėlė;"AUKSINĖ ŽUVELĖ";1581504806;Taip;0;3;0;3
3334;Karusėlė;"AUKSINĖ ŽUVELĖ";5985915835;Taip;8;0;0;8
3335;Karusėlė;"AUKSINĖ ŽUVELĖ";8063412271;Taip;16;0;0;16
3336;Karusėlė;"AUKSINĖ ŽUVELĖ";2242659064;Taip;9;0;0;9
3337;Karusėlė;"AUKSINĖ ŽUVELĖ";3514315636;Taip;12;0;0;12
3338;Karusėlė;"AUKSINĖ ŽUVELĖ";8085919723;Taip;12;0;0;12
3339;Karusėlė;"AUKSINĖ ŽUVELĖ";5444753290;Taip;17;1;0;18
3340;Karusėlė;RAMUNĖ;9344514262;Taip;18;0;0;18
3341;Karusėlė;RAMUNĖ;2215367063;Ne;0;5;0;5
3342;Karusėlė;RAMUNĖ;5146709341;Taip;16;0;0;16
3343;Karusėlė;RAMUNĖ;8331985564;Ne;1;3;1;5
3344;Karusėlė;RAMUNĖ;5803808409;Taip;3;6;0;9
3345;Karusėlė;RAMUNĖ;9400171357;Ne;16;2;0;18
3346;Karusėlė;RAMUNĖ;5766390337;Taip;11;1;0;12
3347;Karusėlė;RAMUNĖ;2007411601;Taip;7;0;0;7
3348;Karusėlė;RAMUNĖ;9996567374;Taip;0;2;1;3
3349;Karusėlė;RAMUNĖ;3696178849;Taip;17;0;3;20
3350;Karusėlė;RAMUNĖ;7814525717;Taip;4;1;0;5
3351;Karusėlė;RAMUNĖ;7489136297;Taip;8;1;0;9
3352;Karusėlė;RAMUNĖ;6424622497;Taip;2;0;3;5
3353;Karusėlė;RAMUNĖ;4879654321;Ne;3;1;5;9
3354;Karusėlė;RAMUNĖ;9656723409;Taip;4;0;2;6
3355;Kaštonas;NYKŠTUKAI;81834426663;Taip;0;4;0;4
3356;Kaštonas;NYKŠTUKAI;4806350914;Taip;18;0;0;18
3357;Kaštonas;NYKŠTUKAI;1781481896;Taip;0;4;0;4
3358;Kaštonas;NYKŠTUKAI;6701145026;Taip;0;1;0;1
3359;Kaštonas;NYKŠTUKAI;9287426151;Taip;0;2;0;2
3360;Kaštonas;NYKŠTUKAI;9168456496;Taip;0;4;0;4
3361;Kaštonas;NYKŠTUKAI;3059036526;Taip;0;8;0;8
3362;Kaštonas;NYKŠTUKAI;8990194475;Taip;0;10;0;10
3363;Kaštonas;NYKŠTUKAI;9702914628;Taip;4;3;0;7
3364;Kaštonas;NYKŠTUKAI;3773227028;Taip;0;9;0;9
3365;Kaštonas;NYKŠTUKAI;8564586014;Taip;0;12;0;12
3366;Kaštonas;NYKŠTUKAI;8166925991;Taip;6;5;0;11
3367;Kaštonas;NYKŠTUKAI;2165890763;Taip;12;2;0;14
3368;Kaštonas;NYKŠTUKAI;7519302152;Ne;0;12;0;12
3369;Kaštonas;NYKŠTUKAI;5884427036;Taip;4;11;0;15
3370;Kaštonas;DRUGELIAI;17123843027;Taip;0;5;0;5
3371;Kaštonas;DRUGELIAI;16395082273;Taip;0;2;0;2
3372;Kaštonas;DRUGELIAI;7229267783;Taip;0;1;0;1
3373;Kaštonas;DRUGELIAI;52064859848;Taip;0;5;0;5
3374;Kaštonas;DRUGELIAI;8748600333;Taip;0;2;0;2
3375;Kaštonas;DRUGELIAI;87941682538;Taip;0;1;0;1
3376;Kaštonas;DRUGELIAI;37382772659;Ne;0;5;0;5
3377;Kaštonas;DRUGELIAI;1186956315;Taip;0;6;0;6
3378;Kaštonas;DRUGELIAI;7481170301;Ne;0;12;0;12
3379;Kaštonas;DRUGELIAI;1313119270;Ne;1;0;0;1
3380;Kaštonas;DRUGELIAI;41926955433;Taip;0;4;0;4
3381;Kaštonas;DRUGELIAI;1023364928;Taip;0;7;0;7
3382;Kaštonas;DRUGELIAI;1668826784;Taip;0;1;0;1
3383;Kaštonas;DRUGELIAI;1152555202;Taip;0;8;0;8
3384;Kaštonas;DRUGELIAI;46191613797;Ne;5;0;0;5
3385;Kaštonas;DRUGELIAI;1626798162;Taip;9;2;0;11
3386;Kaštonas;DRUGELIAI;1931800904;Ne;0;5;0;5
3387;Kaštonas;BITUTĖS;2146285017;Taip;0;0;2;2
3388;Kaštonas;BITUTĖS;1162926887;Taip;0;9;0;9
3389;Kaštonas;BITUTĖS;1459614385;Taip;0;9;0;9
3390;Kaštonas;BITUTĖS;2801321116;Taip;0;4;0;4
3391;Kaštonas;BITUTĖS;9967553882;Taip;0;5;0;5
3392;Kaštonas;BITUTĖS;27082059521;Taip;14;0;0;14
3393;Kaštonas;BITUTĖS;1465714333;Taip;0;8;0;8
3394;Kaštonas;BITUTĖS;1252815477;Taip;0;9;0;9
3395;Kaštonas;BITUTĖS;9215070593;Taip;8;3;0;11
3396;Kaštonas;BITUTĖS;2149717496;Ne;0;22;0;22
3397;Kaštonas;BITUTĖS;2504312724;Taip;0;4;0;4
3398;Kaštonas;BITUTĖS;57362664278;Taip;0;2;0;2
3399;Kaštonas;BITUTĖS;1747580231;Ne;0;7;0;7
3400;Kaštonas;BITUTĖS;4449017708;Ne;0;9;0;9
3401;Kaštonas;BITUTĖS;3638565578;Ne;0;6;0;6
3402;Kaštonas;BITUTĖS;8906976150;Taip;9;4;0;13
3403;Kaštonas;BITUTĖS;2539596633;Taip;0;0;1;1
3404;Kaštonas;BITUTĖS;7776071299;Taip;7;3;0;10
3405;Kaštonas;BITUTĖS;3039980710;Taip;11;5;0;16
3406;Kaštonas;BITUTĖS;3507672150;Taip;0;7;0;7
3407;Kaštonas;BITUTĖS;1826015013;Ne;0;3;0;3
3408;Kaštonas;BITUTĖS;5630659056;Taip;4;3;0;7
3409;Kaštonas;BITUTĖS;2007064959;Taip;0;22;0;22
3410;Kaštonas;BITUTĖS;1859126564;Ne;0;19;0;19
3411;Kaštonas;BITUTĖS;2797443202;Taip;4;9;0;13
3412;Kaštonas;BITUTĖS;8446233414;Taip;9;13;0;22
3413;Kaštonas;MEŠKIUKAI;8042807487;Ne;15;0;0;15
3414;Kaštonas;MEŠKIUKAI;8297662673;Ne;5;2;0;7
3415;Kaštonas;MEŠKIUKAI;2711819539;Ne;0;7;0;7
3416;Kaštonas;MEŠKIUKAI;1367704050;Taip;7;1;0;8
3417;Kaštonas;MEŠKIUKAI;5722934228;Ne;0;2;0;2
3418;Kaštonas;MEŠKIUKAI;1049699735;Taip;0;8;0;8
3419;Kaštonas;MEŠKIUKAI;5557487532;Taip;0;2;0;2
3420;Kaštonas;MEŠKIUKAI;2760501432;Ne;0;8;0;8
3421;Kaštonas;MEŠKIUKAI;70838449788;Ne;0;1;0;1
3422;Kaštonas;MEŠKIUKAI;8797584508;Taip;17;0;0;17
3423;Kaštonas;MEŠKIUKAI;7138581709;Taip;3;3;0;6
3424;Kaštonas;MEŠKIUKAI;9965517774;Taip;3;3;0;6
3425;Kaštonas;MEŠKIUKAI;1249299633;Taip;0;0;3;3
3426;Kaštonas;MEŠKIUKAI;1196590128;Taip;4;2;0;6
3427;Kaštonas;MEŠKIUKAI;1385352925;Taip;0;6;0;6
3428;Kaštonas;MEŠKIUKAI;69883785412;Ne;5;1;0;6
3429;Kaštonas;MEŠKIUKAI;2125410714;Ne;0;10;0;10
3430;Kaštonas;MEŠKIUKAI;6606094891;Taip;0;4;0;4
3431;Kaštonas;MEŠKIUKAI;1364391105;Taip;0;4;0;4
3432;Kaštonas;MEŠKIUKAI;6967725663;Taip;0;11;0;11
3433;Kaštonas;MEŠKIUKAI;5153948802;Taip;0;2;0;2
3434;Kaštonas;MEŠKIUKAI;5157500600;Ne;0;2;0;2
3435;Kaštonas;BORUŽĖLĖS;9069518153;Ne;8;5;0;13
3436;Kaštonas;BORUŽĖLĖS;8214699601;Taip;0;9;0;9
3437;Kaštonas;BORUŽĖLĖS;2106924435;Taip;4;2;0;6
3438;Kaštonas;BORUŽĖLĖS;5307755844;Taip;0;8;0;8
3439;Kaštonas;BORUŽĖLĖS;7408901858;Taip;0;20;0;20
3440;Kaštonas;BORUŽĖLĖS;1761520786;Taip;0;17;0;17
3441;Kaštonas;BORUŽĖLĖS;8483888152;Taip;0;3;0;3
3442;Kaštonas;BORUŽĖLĖS;2877124424;Taip;0;8;0;8
3443;Kaštonas;BORUŽĖLĖS;8275673303;Taip;0;3;0;3
3444;Kaštonas;BORUŽĖLĖS;6289073634;Ne;0;16;0;16
3445;Kaštonas;BORUŽĖLĖS;8582453109;Taip;0;8;0;8
3446;Kaštonas;BORUŽĖLĖS;5391954600;Taip;5;3;0;8
3447;Kaštonas;BORUŽĖLĖS;4616084852;Taip;6;0;0;6
3448;Kaštonas;BORUŽĖLĖS;1748975865;Taip;0;12;0;12
3449;Kaštonas;BORUŽĖLĖS;9285927858;Taip;0;7;0;7
3450;Kaštonas;BORUŽĖLĖS;2434765663;Taip;10;0;0;10
3451;Kaštonas;BORUŽĖLĖS;4837002666;Taip;14;8;0;22
3452;Kaštonas;BORUŽĖLĖS;3228788999;Taip;0;6;0;6
3453;Kaštonas;BORUŽĖLĖS;5659508302;Taip;3;1;0;4
3454;Krivūlė;SPINDULIUKAI;59978148537;Taip;0;0;5;5
3455;Krivūlė;SPINDULIUKAI;45328749559;Ne;0;5;0;5
3456;Krivūlė;SPINDULIUKAI;88714209343;Ne;0;0;6;6
3457;Krivūlė;SPINDULIUKAI;43180342657;Taip;0;5;0;5
3458;Krivūlė;SPINDULIUKAI;78895964424;Taip;0;0;3;3
3459;Krivūlė;SPINDULIUKAI;58431942;Taip;0;0;2;2
3460;Krivūlė;SPINDULIUKAI;48514609257;Taip;0;0;3;3
3461;Krivūlė;SPINDULIUKAI;49698343392;Taip;0;2;0;2
3462;Krivūlė;SPINDULIUKAI;3157698386;Taip;0;2;2;4
3463;Krivūlė;SPINDULIUKAI;26046598666;Taip;0;0;5;5
3464;Krivūlė;SPINDULIUKAI;52632731467;Taip;0;0;3;3
3465;Krivūlė;SPINDULIUKAI;1443815293;Taip;0;0;3;3
3466;Krivūlė;SPINDULIUKAI;1980001276;Taip;0;0;6;6
3467;Krivūlė;SPINDULIUKAI;14824959974;Taip;0;2;0;2
3468;Krivūlė;BORUŽĖLĖS;4969782237;Taip;0;1;0;1
3469;Krivūlė;BORUŽĖLĖS;3605506478;Taip;0;0;3;3
3470;Krivūlė;BORUŽĖLĖS;4896656209;Taip;0;0;3;3
3471;Krivūlė;BORUŽĖLĖS;4845515196;Taip;0;1;0;1
3472;Krivūlė;BORUŽĖLĖS;5676562063;Ne;9;0;1;10
3473;Krivūlė;BORUŽĖLĖS;6935969502;Ne;4;0;3;7
3474;Krivūlė;BORUŽĖLĖS;4972360440;Taip;3;5;0;8
3475;Krivūlė;BORUŽĖLĖS;7318064702;Taip;0;1;13;14
3476;Krivūlė;BORUŽĖLĖS;3246787504;Ne;0;0;1;1
3477;Krivūlė;BORUŽĖLĖS;5531566792;Taip;2;0;2;4
3478;Krivūlė;BORUŽĖLĖS;2386053480;Taip;0;3;0;3
3479;Krivūlė;BORUŽĖLĖS;8586287004;Taip;5;0;2;7
3480;Krivūlė;BORUŽĖLĖS;4540069843;Ne;0;0;2;2
3481;Krivūlė;BORUŽĖLĖS;4297876008;Taip;1;6;2;9
3482;Krivūlė;BORUŽĖLĖS;4257468922;Taip;0;0;4;4
3483;Krivūlė;BORUŽĖLĖS;4177660973;Taip;0;4;0;4
3484;Krivūlė;BORUŽĖLĖS;2517785727;Taip;4;0;0;4
3485;Krivūlė;BORUŽĖLĖS;2711010212;Taip;4;2;0;6
3486;Krivūlė;BORUŽĖLĖS;4025821636;Ne;3;5;0;8
3487;Krivūlė;DRUGELIŲ;1414837177;Taip;0;0;1;1
3488;Krivūlė;DRUGELIŲ;42861843152;Taip;0;1;1;2
3489;Krivūlė;DRUGELIŲ;37447518757;Taip;0;2;3;5
3490;Krivūlė;DRUGELIŲ;91645642209;Ne;0;0;2;2
3491;Krivūlė;DRUGELIŲ;1091759903;Taip;4;2;0;6
3492;Krivūlė;DRUGELIŲ;8646753324;Ne;0;0;1;1
3493;Krivūlė;DRUGELIŲ;3594180341;Ne;0;0;2;2
3494;Krivūlė;DRUGELIŲ;7042541581;Ne;3;0;1;4
3495;Krivūlė;DRUGELIŲ;50967415904;Taip;0;0;4;4
3496;Krivūlė;DRUGELIŲ;1265788772;Taip;0;1;0;1
3497;Krivūlė;DRUGELIŲ;8463621294;Ne;0;0;1;1
3498;Krivūlė;DRUGELIŲ;55356606791;Taip;6;2;0;8
3499;Krivūlė;DRUGELIŲ;98620856056;Taip;0;4;1;5
3500;Krivūlė;DRUGELIŲ;4824008306;Ne;5;3;1;9
3501;Krivūlė;DRUGELIŲ;8500798014;Taip;0;0;1;1
3502;Krivūlė;DRUGELIŲ;5825154729;Taip;0;0;1;1
3503;Krivūlė;"BITUTĖS (VALDOFRO)";46337826378;Taip;0;5;1;6
3504;Krivūlė;"BITUTĖS (VALDOFRO)";1588621536;Taip;0;0;4;4
3505;Krivūlė;"BITUTĖS (VALDOFRO)";97075230746;Taip;0;0;3;3
3506;Krivūlė;"BITUTĖS (VALDOFRO)";2425023811;Taip;0;1;0;1
3507;Krivūlė;"BITUTĖS (VALDOFRO)";4838666934;Taip;8;0;0;8
3508;Krivūlė;"BITUTĖS (VALDOFRO)";3994278221;Taip;8;0;0;8
3509;Krivūlė;"BITUTĖS (VALDOFRO)";18486357195;Taip;5;0;2;7
3510;Krivūlė;"BITUTĖS (VALDOFRO)";4248042049;Taip;0;22;0;22
3511;Krivūlė;"BITUTĖS (VALDOFRO)";4982146852;Taip;0;22;0;22
3512;Krivūlė;"BITUTĖS (VALDOFRO)";3769812444;Taip;0;0;2;2
3513;Krivūlė;"BITUTĖS (VALDOFRO)";5128760019;Taip;0;0;2;2
3514;Krivūlė;"BITUTĖS (VALDOFRO)";2647149927;Ne;5;2;0;7
3515;Krivūlė;"BITUTĖS (VALDOFRO)";5113297248;Taip;0;1;8;9
3516;Krivūlė;"BITUTĖS (VALDOFRO)";9632352765;Ne;5;2;0;7
3517;Krivūlė;"BITUTĖS (VALDOFRO)";7848471009;Taip;0;0;1;1
3518;Krivūlė;EŽIUKAI;10433396718;Taip;0;1;0;1
3519;Krivūlė;EŽIUKAI;2302809484;Ne;0;0;2;2
3520;Krivūlė;EŽIUKAI;44741515819;Taip;0;1;0;1
3521;Krivūlė;EŽIUKAI;2099607493;Taip;0;5;4;9
3522;Krivūlė;EŽIUKAI;1290759541;Taip;8;0;8;16
3523;Krivūlė;EŽIUKAI;28308524979;Taip;10;0;2;12
3524;Krivūlė;EŽIUKAI;1699961817;Taip;0;0;3;3
3525;Krivūlė;EŽIUKAI;66981981114;Taip;0;0;6;6
3526;Krivūlė;EŽIUKAI;1113101710;Taip;0;0;1;1
3527;Krivūlė;EŽIUKAI;86659723162;Taip;0;0;1;1
3528;Krivūlė;EŽIUKAI;2125078552;Taip;0;0;7;7
3529;Krivūlė;EŽIUKAI;6753080815;Ne;0;0;17;17
3530;Krivūlė;EŽIUKAI;2903062788;Taip;0;0;1;1
3531;Krivūlė;EŽIUKAI;81401012140;Ne;0;2;1;3
3532;Krivūlė;EŽIUKAI;1039316424;Taip;0;0;1;1
3533;Krivūlė;EŽIUKAI;4648003100;Ne;0;3;0;3
3534;Krivūlė;EŽIUKAI;3787326918;Taip;0;0;4;4
3535;Krivūlė;NYKŠTUKAI;37502093836;Taip;0;2;3;5
3536;Krivūlė;NYKŠTUKAI;83840444975;Taip;0;2;3;5
3537;Krivūlė;NYKŠTUKAI;701438210;Taip;5;0;0;5
3538;Krivūlė;NYKŠTUKAI;3015266398;Ne;0;0;7;7
3539;Krivūlė;NYKŠTUKAI;7873123757;Taip;13;0;0;13
3540;Krivūlė;NYKŠTUKAI;97398901468;Taip;0;9;0;9
3541;Krivūlė;NYKŠTUKAI;10005041572;Taip;0;0;1;1
3542;Krivūlė;NYKŠTUKAI;1515185307;Taip;0;1;2;3
3543;Krivūlė;NYKŠTUKAI;1217856292;Ne;8;3;1;12
3544;Krivūlė;NYKŠTUKAI;3064591570;Taip;0;0;3;3
3545;Krivūlė;NYKŠTUKAI;9311270695;Taip;0;9;1;10
3546;Krivūlė;NYKŠTUKAI;6861483854;Ne;9;0;5;14
3547;Krivūlė;NYKŠTUKAI;3694497590;Taip;0;0;1;1
3548;Krivūlė;NYKŠTUKAI;6004925249;Taip;0;0;1;1
3549;Krivūlė;NYKŠTUKAI;7052198958;Taip;0;4;1;5
3550;Krivūlė;NYKŠTUKAI;5818988913;Taip;4;2;0;6
3551;Krivūlė;"PABIRUČIŲ (Vokiečių g. 1)";2654066358;Taip;0;4;3;7
3552;Krivūlė;"PABIRUČIŲ (Vokiečių g. 1)";5753204752;Ne;9;0;0;9
3553;Krivūlė;"PABIRUČIŲ (Vokiečių g. 1)";2834012936;Taip;4;0;3;7
3554;Krivūlė;"PABIRUČIŲ (Vokiečių g. 1)";6241144079;Ne;0;0;4;4
3555;Krivūlė;"PABIRUČIŲ (Vokiečių g. 1)";2659604299;Taip;0;0;1;1
3556;Krivūlė;"PABIRUČIŲ (Vokiečių g. 1)";2536472220;Taip;0;0;8;8
3557;Krivūlė;"PABIRUČIŲ (Vokiečių g. 1)";7436569684;Ne;5;0;1;6
3558;Krivūlė;"PABIRUČIŲ (Vokiečių g. 1)";1987255206;Ne;0;0;2;2
3559;Krivūlė;"PABIRUČIŲ (Vokiečių g. 1)";6072261879;Ne;0;13;3;16
3560;Krivūlė;"PABIRUČIŲ (Vokiečių g. 1)";5149419581;Taip;5;0;3;8
3561;Krivūlė;"PABIRUČIŲ (Vokiečių g. 1)";7789605738;Taip;0;0;4;4
3562;Krivūlė;"PABIRUČIŲ (Vokiečių g. 1)";2594217776;Taip;3;0;0;3
3563;Krivūlė;"PABIRUČIŲ (Vokiečių g. 1)";9693693101;Taip;6;0;8;14
3564;Krivūlė;"PABIRUČIŲ (Vokiečių g. 1)";5462491857;Taip;0;1;2;3
3565;Krivūlė;"PABIRUČIŲ (Vokiečių g. 1)";1622495013;Taip;7;0;8;15
3566;Krivūlė;"SMALSUČIŲ (Vokiečių g.1)";1113026818;Taip;0;0;1;1
3567;Krivūlė;"SMALSUČIŲ (Vokiečių g.1)";38355661182;Taip;3;0;4;7
3568;Krivūlė;"SMALSUČIŲ (Vokiečių g.1)";3405470634;Ne;4;0;0;4
3569;Krivūlė;"SMALSUČIŲ (Vokiečių g.1)";1371753067;Ne;0;0;1;1
3570;Krivūlė;"SMALSUČIŲ (Vokiečių g.1)";8301938009;Ne;3;0;0;3
3571;Krivūlė;"SMALSUČIŲ (Vokiečių g.1)";2769668641;Ne;3;0;1;4
3572;Krivūlė;"SMALSUČIŲ (Vokiečių g.1)";4668155071;Taip;0;0;6;6
3573;Krivūlė;"SMALSUČIŲ (Vokiečių g.1)";1774829898;Taip;9;0;3;12
3574;Krivūlė;"SMALSUČIŲ (Vokiečių g.1)";55527703561;Ne;0;0;1;1
3575;Krivūlė;"SMALSUČIŲ (Vokiečių g.1)";20999997254;Ne;0;10;1;11
3576;Krivūlė;"SMALSUČIŲ (Vokiečių g.1)";3583848327;Ne;0;0;11;11
3577;Krivūlė;"SMALSUČIŲ (Vokiečių g.1)";16591459661;Ne;7;0;2;9
3578;Krivūlė;"SMALSUČIŲ (Vokiečių g.1)";6429160371;Taip;5;0;1;6
3579;Krivūlė;"SMALSUČIŲ (Vokiečių g.1)";3924127476;Taip;9;2;0;11
3580;Krivūlė;"SMALSUČIŲ (Vokiečių g.1)";4261133734;Taip;4;0;5;9
3581;Krivūlė;"SMALSUČIŲ (Vokiečių g.1)";9388057389;Taip;0;0;7;7
3582;Krivūlė;"SMALSUČIŲ (Vokiečių g.1)";9801268758;Ne;0;0;6;6
3583;Krivūlė;"SMALSUČIŲ (Vokiečių g.1)";20743334216;Ne;0;0;3;3
3584;Krivūlė;"GUDRUČIŲ (Vokiečių g. 1)";8285580095;Taip;0;0;14;14
3585;Krivūlė;"GUDRUČIŲ (Vokiečių g. 1)";29755294214;Taip;0;0;8;8
3586;Krivūlė;"GUDRUČIŲ (Vokiečių g. 1)";6687699907;Taip;5;0;1;6
3587;Krivūlė;"GUDRUČIŲ (Vokiečių g. 1)";1587218379;Taip;3;4;0;7
3588;Krivūlė;"GUDRUČIŲ (Vokiečių g. 1)";2096927238;Ne;5;4;0;9
3589;Krivūlė;"GUDRUČIŲ (Vokiečių g. 1)";8301904575;Ne;16;0;0;16
3590;Krivūlė;"GUDRUČIŲ (Vokiečių g. 1)";76285364171;Ne;6;0;1;7
3591;Krivūlė;"GUDRUČIŲ (Vokiečių g. 1)";49106308532;Taip;0;2;0;2
3592;Krivūlė;"GUDRUČIŲ (Vokiečių g. 1)";1600378710;Taip;0;1;1;2
3593;Krivūlė;"GUDRUČIŲ (Vokiečių g. 1)";1974755599;Taip;0;1;0;1
3594;Krivūlė;"GUDRUČIŲ (Vokiečių g. 1)";7477773004;Taip;0;0;2;2
3595;Krivūlė;"GUDRUČIŲ (Vokiečių g. 1)";2077383621;Taip;0;0;3;3
3596;Krivūlė;"GUDRUČIŲ (Vokiečių g. 1)";27151485531;Taip;15;0;0;15
3597;Krivūlė;"GUDRUČIŲ (Vokiečių g. 1)";1180183091;Taip;0;12;0;12
3598;Krivūlė;"GUDRUČIŲ (Vokiečių g. 1)";6543038595;Taip;0;1;2;3
3599;Krivūlė;"GUDRUČIŲ (Vokiečių g. 1)";1616662586;Ne;0;0;3;3
3600;Krivūlė;"GUDRUČIŲ (Vokiečių g. 1)";50186813736;Taip;4;0;1;5
3601;Kodėlčiukas;Saulutės;6517880481;Taip;0;0;1;1
3602;Kodėlčiukas;Saulutės;7080578299;Taip;13;0;0;13
3603;Kodėlčiukas;Saulutės;1725624698;Taip;0;3;0;3
3604;Kodėlčiukas;Saulutės;8393893311;Taip;7;0;0;7
3605;Kodėlčiukas;Saulutės;7509476161;Taip;0;0;1;1
3606;Kodėlčiukas;Saulutės;7327247516;Taip;0;0;1;1
3607;Kodėlčiukas;Saulutės;1645680526;Taip;0;0;1;1
3608;Kodėlčiukas;Saulutės;8992265000;Taip;0;7;0;7
3609;Kodėlčiukas;Saulutės;6285018663;Taip;3;0;0;3
3610;Kodėlčiukas;Saulutės;1033969800;Taip;21;0;0;21
3611;Kodėlčiukas;Saulutės;4179140476;Taip;22;0;0;22
3612;Kodėlčiukas;Saulutės;2433094435;Ne;3;0;0;3
3613;Kodėlčiukas;Saulutės;9042404309;Taip;0;0;3;3
3614;Kodėlčiukas;Saulutės;3276075664;Taip;0;0;2;2
3615;Kodėlčiukas;Saulutės;3141225891;Taip;0;0;7;7
3616;Kodėlčiukas;Saulutės;3315824027;Ne;0;0;17;17
3617;Kodėlčiukas;Saulutės;7611485881;Taip;8;0;0;8
3618;Kodėlčiukas;Saulutės;7561763602;Taip;6;0;4;10
3619;Kodėlčiukas;Nežiniukai;6045564826;Ne;12;0;0;12
3620;Kodėlčiukas;Nežiniukai;7971932716;Taip;0;0;1;1
3621;Kodėlčiukas;Nežiniukai;7282579315;Taip;4;0;1;5
3622;Kodėlčiukas;Nežiniukai;6905424567;Taip;4;0;0;4
3623;Kodėlčiukas;Nežiniukai;1233880820;Taip;14;0;1;15
3624;Kodėlčiukas;Nežiniukai;5443377251;Taip;0;7;0;7
3625;Kodėlčiukas;Nežiniukai;3150006441;Taip;11;0;1;12
3626;Kodėlčiukas;Nežiniukai;7626940433;Taip;0;3;0;3
3627;Kodėlčiukas;Nežiniukai;4917910801;Taip;0;0;3;3
3628;Kodėlčiukas;Nežiniukai;6248137523;Ne;0;5;1;6
3629;Kodėlčiukas;Nežiniukai;3473981974;Taip;0;9;3;12
3630;Kodėlčiukas;Nežiniukai;4038168647;Ne;22;0;0;22
3631;Kodėlčiukas;Nežiniukai;8378295683;Taip;8;6;0;14
3632;Kodėlčiukas;Nežiniukai;6000831611;Taip;0;5;0;5
3633;Kodėlčiukas;Nežiniukai;7286497455;Taip;14;0;0;14
3634;Kodėlčiukas;Nežiniukai;1603752483;Taip;22;0;0;22
3635;Kodėlčiukas;Nežiniukai;6074758814;Ne;5;7;0;12
3636;Kodėlčiukas;Gintarėliai;2560864315;Taip;3;0;0;3
3637;Kodėlčiukas;Gintarėliai;58406224468;Taip;0;0;14;14
3638;Kodėlčiukas;Gintarėliai;1485012710;Ne;0;0;2;2
3639;Kodėlčiukas;Gintarėliai;2062878300;Ne;12;3;4;19
3640;Kodėlčiukas;Gintarėliai;20084022099;Taip;0;1;0;1
3641;Kodėlčiukas;Gintarėliai;1950934087;Taip;7;0;0;7
3642;Kodėlčiukas;Gintarėliai;9686497547;Taip;0;1;0;1
3643;Kodėlčiukas;Gintarėliai;4884104023;Taip;0;0;3;3
3644;Kodėlčiukas;Gintarėliai;1632458573;Taip;0;4;0;4
3645;Kodėlčiukas;Gintarėliai;9332136116;Taip;10;0;0;10
3646;Kodėlčiukas;Gintarėliai;4944791330;Taip;0;0;1;1
3647;Kodėlčiukas;Gintarėliai;8219424737;Taip;0;5;0;5
3648;Kodėlčiukas;Gintarėliai;4849314647;Taip;0;7;2;9
3649;Kodėlčiukas;Gintarėliai;5202375085;Taip;0;4;0;4
3650;Kodėlčiukas;Gintarėliai;8647609373;Taip;22;0;0;22
3651;Kodėlčiukas;Gintarėliai;5093139270;Taip;0;0;1;1
3652;Kodėlčiukas;Gintarėliai;4738357524;Taip;7;0;1;8
3653;Kodėlčiukas;Gintarėliai;8075591032;Taip;0;0;2;2
3654;Kodėlčiukas;Gintarėliai;8873629130;Taip;17;0;0;17
3655;Kodėlčiukas;Šnekučiai;1844016431;Taip;3;0;0;3
3656;Kodėlčiukas;Šnekučiai;1550915654;Taip;0;9;6;15
3657;Kodėlčiukas;Šnekučiai;1935757837;Taip;0;5;0;5
3658;Kodėlčiukas;Šnekučiai;8114859362;Taip;9;0;4;13
3659;Kodėlčiukas;Šnekučiai;1666743304;Ne;11;0;0;11
3660;Kodėlčiukas;Šnekučiai;1432342305;Taip;0;0;5;5
3661;Kodėlčiukas;Šnekučiai;1584936719;Taip;0;0;1;1
3662;Kodėlčiukas;Šnekučiai;9178209049;Taip;0;0;4;4
3663;Kodėlčiukas;Šnekučiai;5988863934;Taip;6;5;0;11
3664;Kodėlčiukas;Šnekučiai;2742365461;Taip;0;6;0;6
3665;Kodėlčiukas;Šnekučiai;76164689333;Ne;9;0;1;10
3666;Kodėlčiukas;Šnekučiai;5386820408;Ne;5;3;0;8
3667;Kodėlčiukas;Šnekučiai;6194726931;Taip;8;5;0;13
3668;Kodėlčiukas;Šnekučiai;7074381835;Ne;17;3;0;20
3669;Kodėlčiukas;Šnekučiai;7757494295;Taip;9;5;0;14
3670;Kodėlčiukas;Šnekučiai;2988674717;Taip;2;3;1;6
3671;Kodėlčiukas;Šnekučiai;1834696935;Taip;0;0;1;1
3672;Kodėlčiukas;Šnekučiai;4273202718;Taip;9;0;0;9
3673;Kodėlčiukas;Pabiručiai;7630180473;Taip;22;0;0;22
3674;Kodėlčiukas;Pabiručiai;8140940288;Ne;0;0;1;1
3675;Kodėlčiukas;Pabiručiai;7246243975;Ne;5;0;0;5
3676;Kodėlčiukas;Pabiručiai;1600501494;Taip;0;0;3;3
3677;Kodėlčiukas;Pabiručiai;3782714343;Taip;0;0;5;5
3678;Kodėlčiukas;Pabiručiai;3880019350;Taip;0;0;12;12
3679;Kodėlčiukas;Pabiručiai;4818678923;Ne;4;4;0;8
3680;Kodėlčiukas;Pabiručiai;9589692031;Taip;15;0;0;15
3681;Kodėlčiukas;Pabiručiai;1906128091;Taip;12;0;4;16
3682;Kodėlčiukas;Pabiručiai;8302606312;Taip;0;1;2;3
3683;Kodėlčiukas;Pabiručiai;9460792167;Taip;14;0;2;16
3684;Kodėlčiukas;Pabiručiai;1218904283;Taip;0;0;7;7
3685;Kodėlčiukas;Pabiručiai;2929946390;Taip;3;1;0;4
3686;Kodėlčiukas;Pabiručiai;7324303899;Taip;0;0;5;5
3687;Kodėlčiukas;Pabiručiai;1256650715;Taip;19;0;0;19
3688;Kodėlčiukas;Pabiručiai;1052656432;Taip;0;3;2;5
3689;Kodėlčiukas;Pabiručiai;9794875862;Taip;11;0;2;13
3690;Kodėlčiukas;Pabiručiai;9528997865;Taip;13;3;2;18
3691;Kodėlčiukas;Pabiručiai;1919722425;Taip;3;0;1;4
3692;Kodėlčiukas;Pabiručiai;2593524511;Taip;0;0;5;5
3693;Kodėlčiukas;Pabiručiai;8879977943;Taip;0;17;0;17
3694;Kodėlčiukas;Smalsučiai;49317624340;Taip;18;0;0;18
3695;Kodėlčiukas;Smalsučiai;69860272843;Taip;0;2;0;2
3696;Kodėlčiukas;Smalsučiai;52040715568;Ne;0;8;0;8
3697;Kodėlčiukas;Smalsučiai;37852137155;Taip;0;0;1;1
3698;Kodėlčiukas;Smalsučiai;86134523927;Taip;0;3;0;3
3699;Kodėlčiukas;Smalsučiai;33432780322;Ne;12;4;0;16
3700;Kodėlčiukas;Smalsučiai;96270550335;Taip;0;6;0;6
3701;Kodėlčiukas;Smalsučiai;53066448447;Ne;0;1;0;1
3702;Kodėlčiukas;Smalsučiai;1518135854;Ne;0;0;5;5
3703;Kodėlčiukas;Smalsučiai;93698504377;Taip;9;0;7;16
3704;Kodėlčiukas;Smalsučiai;1951603132;Taip;0;0;2;2
3705;Kodėlčiukas;Smalsučiai;1614088526;Taip;0;5;0;5
3706;Kodėlčiukas;Smalsučiai;15211280060;Taip;0;2;0;2
3707;Kodėlčiukas;Giliukai;26010333641;Taip;5;0;0;5
3708;Kodėlčiukas;Giliukai;99164081259;Taip;3;0;0;3
3709;Kodėlčiukas;Giliukai;93684599166;Taip;0;1;2;3
3710;Kodėlčiukas;Giliukai;88371652763;Taip;0;0;4;4
3711;Kodėlčiukas;Giliukai;80767435810;Taip;0;9;0;9
3712;Kodėlčiukas;Giliukai;1825630143;Taip;9;0;12;21
3713;Kodėlčiukas;Giliukai;11130172902;Ne;0;9;0;9
3714;Kodėlčiukas;Giliukai;29830674331;Taip;0;0;1;1
3715;Kodėlčiukas;Giliukai;84905680496;Taip;0;7;0;7
3716;Kodėlčiukas;Giliukai;58893099621;Taip;7;0;3;10
3717;Kodėlčiukas;Giliukai;2637712514;Taip;7;0;1;8
3718;Kodėlčiukas;Giliukai;1354133871;Ne;0;0;8;8
3719;Kodėlčiukas;Giliukai;45393129631;Taip;0;0;7;7
3720;Kodėlčiukas;Giliukai;47667750562;Taip;0;7;0;7
3721;Kodėlčiukas;Giliukai;8204069897;Taip;0;1;1;2
3722;Kodėlčiukas;Giliukai;1938753417;Taip;0;5;2;7
3723;Kodėlčiukas;Giliukai;29319461634;Taip;0;4;0;4
3724;Kodėlčiukas;Gudručiai;20467065338;Ne;0;0;2;2
3725;Kodėlčiukas;Gudručiai;15580950604;Taip;0;0;1;1
3726;Kodėlčiukas;Gudručiai;32318234528;Ne;0;0;6;6
3727;Kodėlčiukas;Gudručiai;9315712284;Taip;0;0;3;3
3728;Kodėlčiukas;Gudručiai;3542081571;Taip;0;0;2;2
3729;Kodėlčiukas;Gudručiai;84450296241;Taip;19;0;0;19
3730;Kodėlčiukas;Gudručiai;1234971388;Ne;0;0;5;5
3731;Kodėlčiukas;Gudručiai;1048653620;Ne;0;4;0;4
3732;Kodėlčiukas;Gudručiai;1662717348;Taip;8;0;1;9
3733;Kodėlčiukas;Gudručiai;1978279511;Taip;8;0;2;10
3734;Kodėlčiukas;Gudručiai;6186365121;Taip;10;0;0;10
3735;Kodėlčiukas;Gudručiai;70940790491;Taip;0;0;5;5
3736;Kodėlčiukas;Gudručiai;6168432879;Taip;5;0;1;6
3737;Kodėlčiukas;Gudručiai;1106092960;Taip;22;0;0;22
3738;Kodėlčiukas;Gudručiai;8393750817;Ne;0;0;17;17
3739;Kodėlčiukas;Gudručiai;2061169442;Taip;0;0;4;4
3740;Kodėlčiukas;Gudručiai;1723716524;Taip;6;0;1;7
3741;Kodėlčiukas;Gudručiai;87784905691;Ne;6;0;0;6
3742;Kodėlčiukas;Žirniukai;6988515253;Taip;22;0;0;22
3743;Kodėlčiukas;Žirniukai;3385551650;Taip;4;0;1;5
3744;Kodėlčiukas;Žirniukai;7116594055;Taip;0;0;3;3
3745;Kodėlčiukas;Žirniukai;4687333060;Taip;0;1;0;1
3746;Kodėlčiukas;Žirniukai;2216791610;Taip;0;0;4;4
3747;Kodėlčiukas;Žirniukai;9483378853;Ne;16;3;0;19
3748;Kodėlčiukas;Žirniukai;3427610168;Taip;22;0;0;22
3749;Kodėlčiukas;Žirniukai;4543838852;Ne;0;8;1;9
3750;Kodėlčiukas;Žirniukai;7318908956;Taip;17;0;3;20
3751;Kodėlčiukas;Žirniukai;7326475644;Taip;14;0;0;14
3752;Kodėlčiukas;Žirniukai;9865803714;Taip;0;0;7;7
3753;Kodėlčiukas;Katinėliai;2904858964;Taip;19;0;0;19
3754;Kodėlčiukas;Katinėliai;2987907651;Taip;0;0;1;1
3755;Kodėlčiukas;Katinėliai;3413659259;Taip;0;0;2;2
3756;Kodėlčiukas;Katinėliai;9278139998;Taip;9;0;0;9
3757;Kodėlčiukas;Katinėliai;5359866071;Taip;9;0;0;9
3758;Kodėlčiukas;Katinėliai;8784531004;Taip;17;0;0;17
3759;Kodėlčiukas;Katinėliai;9511144369;Taip;3;5;3;11
3760;Kodėlčiukas;Katinėliai;6014084915;Taip;0;7;0;7
3761;Kodėlčiukas;Katinėliai;1588132166;Taip;14;0;0;14
3762;Kodėlčiukas;Katinėliai;1180399735;Taip;13;0;0;13
3763;Kodėlčiukas;Katinėliai;8189938439;Taip;0;16;0;16
3764;Kodėlčiukas;Katinėliai;2964318343;Taip;4;0;2;6
3765;Kodėlčiukas;Katinėliai;1039982141;Taip;7;0;0;7
3766;Kodėlčiukas;Katinėliai;8427457478;Taip;4;11;1;16
3767;Kodėlčiukas;Katinėliai;9028856983;Taip;6;1;5;12
3768;Kodėlčiukas;Nykštukai;5342852235;Ne;12;0;2;14
3769;Kodėlčiukas;Nykštukai;3315862631;Taip;0;8;0;8
3770;Kodėlčiukas;Nykštukai;1705030069;Taip;0;0;2;2
3771;Kodėlčiukas;Nykštukai;9645987751;Taip;10;0;0;10
3772;Kodėlčiukas;Nykštukai;5860975805;Taip;3;0;0;3
3773;Kodėlčiukas;Nykštukai;8782155591;Taip;1;0;0;1
3774;Kodėlčiukas;Nykštukai;8104220950;Taip;0;13;0;13
3775;Kodėlčiukas;Nykštukai;2005453189;Taip;0;0;2;2
3776;Kodėlčiukas;Nykštukai;8563412043;Taip;3;0;2;5
3777;Kodėlčiukas;Nykštukai;1683506414;Taip;3;0;0;3
3778;Kodėlčiukas;Nykštukai;7946010973;Taip;11;2;0;13
3779;Kodėlčiukas;Nykštukai;8971395173;Taip;19;0;2;21
3780;Kodėlčiukas;Nykštukai;8208448849;Taip;15;0;0;15
3781;Kodėlčiukas;Nykštukai;5896726125;Taip;10;0;0;10
3782;Kodėlčiukas;Nykštukai;3168418461;Taip;8;4;0;12
3783;Kodėlčiukas;Nykštukai;3068084704;Taip;22;0;0;22
3784;Kodėlčiukas;Nykštukai;5173730926;Taip;22;0;0;22
3785;Kodėlčiukas;Nykštukai;1289342844;Taip;0;11;0;11
3786;Kodėlčiukas;ŽIOGELIAI;2921181385;Ne;10;0;0;10
3787;Kodėlčiukas;ŽIOGELIAI;8263945732;Taip;8;0;1;9
3788;Kodėlčiukas;ŽIOGELIAI;4218096561;Taip;0;7;7;14
3789;Kodėlčiukas;ŽIOGELIAI;4514764005;Taip;0;0;1;1
3790;Kodėlčiukas;ŽIOGELIAI;2169307879;Taip;14;0;0;14
3791;Kodėlčiukas;ŽIOGELIAI;4585226357;Taip;7;0;1;8
3792;Kodėlčiukas;ŽIOGELIAI;4884233329;Taip;9;0;10;19
3793;Kodėlčiukas;ŽIOGELIAI;4937929385;Taip;0;7;0;7
3794;Kodėlčiukas;ŽIOGELIAI;4165123345;Taip;15;0;0;15
3795;Kodėlčiukas;ŽIOGELIAI;9135807341;Ne;18;0;0;18
3796;Kodėlčiukas;ŽIOGELIAI;6476445296;Ne;6;0;0;6
3797;Kodėlčiukas;ŽIOGELIAI;6714818379;Taip;0;5;0;5
3798;Kodėlčiukas;ŽIOGELIAI;2808361570;Taip;2;5;0;7
3799;Kodėlčiukas;ŽIOGELIAI;2448536092;Taip;15;0;0;15
3800;Kodėlčiukas;BITUTĖS;3240221130;Taip;5;0;1;6
3801;Kodėlčiukas;BITUTĖS;5772071707;Taip;20;0;0;20
3802;Kodėlčiukas;BITUTĖS;5577154148;Taip;13;0;0;13
3803;Kodėlčiukas;BITUTĖS;9139424911;Taip;5;0;1;6
3804;Kodėlčiukas;BITUTĖS;5197946954;Taip;14;0;3;17
3805;Kodėlčiukas;BITUTĖS;7587203481;Taip;4;0;2;6
3806;Kodėlčiukas;BITUTĖS;2140552221;Taip;5;0;0;5
3807;Kodėlčiukas;BITUTĖS;4777496709;Taip;0;0;1;1
3808;Kodėlčiukas;BITUTĖS;7714816675;Taip;17;0;0;17
3809;Kodėlčiukas;BITUTĖS;6103959702;Taip;0;0;2;2
3810;Kodėlčiukas;BITUTĖS;3267687337;Taip;6;9;2;17
3811;Kodėlčiukas;BITUTĖS;4202423480;Taip;0;4;2;6
3812;Kodėlčiukas;BITUTĖS;9664432781;Taip;8;0;0;8
3813;Kodėlčiukas;BITUTĖS;8547039654;Taip;6;0;0;6
3814;Kodėlčiukas;BITUTĖS;5505788210;Taip;8;0;0;8
3815;Kodėlčiukas;BITUTĖS;6106526012;Taip;0;22;0;22
3816;Kodėlčiukas;BITUTĖS;2353960861;Taip;0;0;1;1
3817;Kodėlčiukas;VYŠNIUKAI;2162480212;Taip;0;0;3;3
3818;Kodėlčiukas;VYŠNIUKAI;3482802557;Taip;4;0;2;6
3819;Kodėlčiukas;VYŠNIUKAI;3778271049;Ne;0;0;10;10
3820;Kodėlčiukas;VYŠNIUKAI;1074477043;Ne;10;0;1;11
3821;Kodėlčiukas;VYŠNIUKAI;2542104903;Taip;0;3;0;3
3822;Kodėlčiukas;VYŠNIUKAI;7510273691;Ne;9;0;1;10
3823;Kodėlčiukas;VYŠNIUKAI;4490196764;Ne;5;0;0;5
3824;Kodėlčiukas;VYŠNIUKAI;9527296531;Taip;0;6;0;6
3825;Kodėlčiukas;VYŠNIUKAI;2351468626;Taip;0;8;0;8
3826;Kodėlčiukas;VYŠNIUKAI;6764015170;Ne;22;0;0;22
3827;Kodėlčiukas;VYŠNIUKAI;8447045958;Taip;0;5;2;7
3828;Kodėlčiukas;VYŠNIUKAI;3403889915;Taip;0;11;0;11
3829;Kodėlčiukas;VYŠNIUKAI;1160612316;Taip;22;0;0;22
3830;Kodėlčiukas;VYŠNIUKAI;8606551477;Taip;0;0;2;2
3831;Kodėlčiukas;VYŠNIUKAI;8070400563;Taip;0;0;3;3
3832;Kodėlčiukas;VYŠNIUKAI;1992569595;Ne;8;0;4;12
3833;Kodėlčiukas;BORUŽĖLĖS;9109362006;Taip;4;0;1;5
3834;Kodėlčiukas;BORUŽĖLĖS;9169500252;Ne;22;0;0;22
3835;Kodėlčiukas;BORUŽĖLĖS;9724373368;Taip;0;9;0;9
3836;Kodėlčiukas;BORUŽĖLĖS;6941978169;Taip;9;0;0;9
3837;Kodėlčiukas;BORUŽĖLĖS;5075801618;Taip;10;0;1;11
3838;Kodėlčiukas;BORUŽĖLĖS;2819860331;Taip;0;2;0;2
3839;Kodėlčiukas;BORUŽĖLĖS;4941186694;Ne;0;16;0;16
3840;Kodėlčiukas;BORUŽĖLĖS;4866089623;Ne;7;0;7;14
3841;Kodėlčiukas;BORUŽĖLĖS;5952121209;Taip;3;10;1;14
3842;Kodėlčiukas;BORUŽĖLĖS;4230906452;Ne;0;6;0;6
3843;Kodėlčiukas;BORUŽĖLĖS;5985806014;Ne;16;0;0;16
3844;Kodėlčiukas;BORUŽĖLĖS;8779350309;Taip;8;0;0;8
3845;Kodėlčiukas;BORUŽĖLĖS;9208137169;Ne;0;1;7;8
3846;Kodėlčiukas;BORUŽĖLĖS;5876187643;Taip;6;0;0;6
3847;Kodėlčiukas;BORUŽĖLĖS;1206798597;Taip;0;0;1;1
3848;Kodėlčiukas;BORUŽĖLĖS;1827752731;Taip;5;0;2;7
3849;Kodėlčiukas;BORUŽĖLĖS;1005178052;Taip;16;0;0;16
3850;Kodėlčiukas;BORUŽĖLĖS;9252478832;Taip;10;0;0;10
3851;Kodėlčiukas;BORUŽĖLĖS;1889809198;Taip;3;0;0;3
3852;Kodėlčiukas;VYTURĖLIAI;79742559803;Taip;1;0;0;1
3853;Kodėlčiukas;VYTURĖLIAI;68236236113;Taip;0;0;1;1
3854;Kodėlčiukas;VYTURĖLIAI;62309098505;Taip;0;0;3;3
3855;Kodėlčiukas;VYTURĖLIAI;14611425618;Ne;0;6;0;6
3856;Kodėlčiukas;VYTURĖLIAI;43335982030;Taip;0;0;1;1
3857;Kodėlčiukas;VYTURĖLIAI;23065888472;Taip;0;6;0;6
3858;Kodėlčiukas;VYTURĖLIAI;1905426469;Taip;0;2;0;2
3859;Kodėlčiukas;VYTURĖLIAI;1730913401;Taip;0;0;2;2
3860;Kodėlčiukas;VYTURĖLIAI;66109277013;Taip;0;4;0;4
3861;Kodėlčiukas;VYTURĖLIAI;1608321100;Taip;0;1;0;1
3862;Kodėlčiukas;VYTURĖLIAI;45910018746;Taip;0;3;0;3
3863;Kodėlčiukas;VYTURĖLIAI;48669541733;Taip;0;1;0;1
3864;Kodėlčiukas;VYTURĖLIAI;30952731344;Taip;0;0;1;1
3865;Kodėlčiukas;VYTURĖLIAI;1290630625;Taip;0;0;2;2
3866;Kodėlčiukas;VYTURĖLIAI;9323563664;Taip;2;3;0;5
3867;Kodėlčiukas;VYTURĖLIAI;79090323340;Taip;0;6;0;6
3868;Kodėlčiukas;VYTURĖLIAI;49784617790;Taip;0;6;0;6
3869;Kodėlčiukas;DRUGELIAI;1850261935;Taip;0;0;17;17
3870;Kodėlčiukas;DRUGELIAI;6612336444;Taip;8;0;0;8
3871;Kodėlčiukas;DRUGELIAI;1645423279;Ne;8;0;1;9
3872;Kodėlčiukas;DRUGELIAI;1215911875;Taip;10;0;1;11
3873;Kodėlčiukas;DRUGELIAI;7479165635;Taip;0;11;0;11
3874;Kodėlčiukas;DRUGELIAI;56907458719;Ne;0;0;6;6
3875;Kodėlčiukas;DRUGELIAI;9645382151;Taip;0;7;2;9
3876;Kodėlčiukas;DRUGELIAI;1208194459;Taip;7;0;0;7
3877;Kodėlčiukas;DRUGELIAI;1111723773;Taip;7;0;0;7
3878;Kodėlčiukas;DRUGELIAI;1550337708;Taip;11;0;0;11
3879;Kodėlčiukas;DRUGELIAI;44431255380;Taip;10;0;1;11
3880;Kodėlčiukas;DRUGELIAI;93275059990;Taip;12;5;0;17
3881;Kodėlčiukas;DRUGELIAI;82927457803;Taip;0;0;2;2
3882;Kodėlčiukas;DRUGELIAI;50411894014;Ne;0;0;2;2
3883;Kodėlčiukas;DRUGELIAI;4030981879;Taip;5;1;0;6
3884;Kodėlčiukas;DRUGELIAI;1782784297;Taip;0;7;0;7
3885;Kodėlčiukas;DRUGELIAI;37250933602;Taip;10;8;0;18
3886;Klevelis;Gėlytės;1953918266;Taip;6;10;0;16
3887;Klevelis;Gėlytės;68457250471;Ne;8;0;1;9
3888;Klevelis;Gėlytės;1942666372;Taip;0;22;0;22
3889;Klevelis;Gėlytės;50441219517;Taip;0;6;0;6
3890;Klevelis;Gėlytės;8154620920;Ne;0;16;0;16
3891;Klevelis;Gėlytės;5075314234;Taip;8;0;0;8
3892;Klevelis;Gėlytės;8584120396;Taip;4;1;1;6
3893;Klevelis;Gėlytės;9689230151;Taip;7;0;0;7
3894;Klevelis;Gėlytės;1757321892;Taip;1;1;0;2
3895;Klevelis;Gėlytės;23520576240;Taip;0;4;0;4
3896;Klevelis;Gėlytės;1851385706;Taip;0;5;0;5
3897;Klevelis;Gėlytės;5024289280;Taip;0;1;2;3
3898;Klevelis;Gėlytės;1685710938;Taip;4;1;0;5
3899;Klevelis;Gėlytės;5354831337;Ne;14;0;3;17
3900;Klevelis;Gėlytės;1161906832;Taip;2;0;0;2
3901;Klevelis;Gėlytės;2744433344;Taip;5;1;1;7
3902;Klevelis;Gėlytės;1606294984;Taip;5;0;2;7
3903;Klevelis;Gėlytės;2043650571;Ne;0;5;0;5
3904;Klevelis;Paukšteliai;4424095457;Taip;4;0;0;4
3905;Klevelis;Paukšteliai;7855598075;Taip;0;8;0;8
3906;Klevelis;Paukšteliai;5402403433;Taip;10;3;0;13
3907;Klevelis;Paukšteliai;1749117711;Taip;8;1;0;9
3908;Klevelis;Paukšteliai;3873345138;Ne;22;0;0;22
3909;Klevelis;Paukšteliai;9291855374;Taip;6;2;0;8
3910;Klevelis;Paukšteliai;7115198351;Taip;4;0;0;4
3911;Klevelis;Paukšteliai;8357021249;Taip;0;12;0;12
3912;Klevelis;Paukšteliai;4051246539;Ne;8;0;0;8
3913;Klevelis;Paukšteliai;6621769160;Taip;17;1;0;18
3914;Klevelis;Paukšteliai;5518309115;Taip;22;0;0;22
3915;Klevelis;Paukšteliai;4832348492;Taip;8;4;0;12
3916;Klevelis;Paukšteliai;9865628172;Ne;0;3;0;3
3917;Klevelis;Paukšteliai;8777858708;Ne;0;8;0;8
3918;Klevelis;Paukšteliai;6172016747;Taip;22;0;0;22
3919;Klevelis;Paukšteliai;4930308435;Taip;0;1;0;1
3920;Klevelis;Paukšteliai;4895554383;Taip;0;18;0;18
3921;Klevelis;Spindulėliai;36733972781;Ne;6;1;0;7
3922;Klevelis;Spindulėliai;71637673796;Taip;0;1;0;1
3923;Klevelis;Spindulėliai;85910214189;Ne;4;3;0;7
3924;Klevelis;Spindulėliai;27776527268;Ne;5;4;0;9
3925;Klevelis;Spindulėliai;1299222411;Taip;2;3;0;5
3926;Klevelis;Spindulėliai;2041814549;Taip;4;1;0;5
3927;Klevelis;Spindulėliai;1608781752;Taip;0;7;0;7
3928;Klevelis;Spindulėliai;32063805512;Ne;8;7;0;15
3929;Klevelis;Spindulėliai;5786557195;Taip;7;0;0;7
3930;Klevelis;Spindulėliai;1980755137;Taip;0;2;0;2
3931;Klevelis;Spindulėliai;88565114332;Ne;3;1;0;4
3932;Klevelis;Spindulėliai;4400576631;Ne;5;1;0;6
3933;Klevelis;Spindulėliai;2207041148;Taip;8;10;0;18
3934;Klevelis;Spindulėliai;58302265771;Ne;3;1;0;4
3935;Klevelis;Spindulėliai;4733970252;Taip;1;1;1;3
3936;Klevelis;Spindulėliai;9125827523;Taip;0;4;0;4
3937;Klevelis;Spindulėliai;3397741232;Ne;10;1;0;11
3938;Klevelis;Spindulėliai;1520846063;Taip;0;6;0;6
3939;Klevelis;Spindulėliai;4558350854;Ne;6;3;0;9
3940;Klevelis;Spindulėliai;1020095914;Taip;5;0;0;5
3941;Klevelis;Spindulėliai;5705915729;Taip;10;0;0;10
3942;Klevelis;BORUŽĖLĖS;5966215998;Taip;17;3;0;20
3943;Klevelis;BORUŽĖLĖS;4347007911;Taip;0;6;0;6
3944;Klevelis;BORUŽĖLĖS;2418583962;Taip;13;0;0;13
3945;Klevelis;BORUŽĖLĖS;1751440418;Taip;5;2;0;7
3946;Klevelis;BORUŽĖLĖS;5887929703;Taip;10;0;0;10
3947;Klevelis;BORUŽĖLĖS;5028027797;Taip;3;2;0;5
3948;Klevelis;BORUŽĖLĖS;9585785202;Taip;13;0;0;13
3949;Klevelis;BORUŽĖLĖS;7463376031;Taip;9;6;0;15
3950;Klevelis;BORUŽĖLĖS;6822089289;Taip;0;11;0;11
3951;Klevelis;BORUŽĖLĖS;6241611652;Taip;3;0;0;3
3952;Klevelis;BORUŽĖLĖS;3567687304;Taip;0;11;0;11
3953;Klevelis;BORUŽĖLĖS;6372245141;Taip;0;5;0;5
3954;Klevelis;BORUŽĖLĖS;2031118410;Taip;0;0;2;2
3955;Klevelis;BORUŽĖLĖS;6488139414;Taip;4;2;0;6
3956;Klevelis;BORUŽĖLĖS;7559183263;Taip;0;8;0;8
3957;Kurpaitė;Viščiukų;6568580994;Taip;0;10;0;10
3958;Kurpaitė;Viščiukų;1095697246;Taip;0;5;0;5
3959;Kurpaitė;Viščiukų;7703075096;Taip;5;0;0;5
3960;Kurpaitė;Viščiukų;6466518987;Taip;0;20;0;20
3961;Kurpaitė;Viščiukų;9769835612;Taip;9;0;0;9
3962;Kurpaitė;Viščiukų;1273426668;Taip;0;1;0;1
3963;Kurpaitė;Viščiukų;4592795281;Taip;0;14;0;14
3964;Kurpaitė;Viščiukų;8868415451;Taip;0;2;0;2
3965;Kurpaitė;Viščiukų;4684525618;Taip;0;1;0;1
3966;Kurpaitė;Gėlyčių;7897713994;Taip;7;0;0;7
3967;Kurpaitė;Gėlyčių;1660650556;Taip;0;11;0;11
3968;Kurpaitė;Gėlyčių;1457318954;Taip;7;4;0;11
3969;Kurpaitė;Gėlyčių;9063294667;Ne;0;1;0;1
3970;Kurpaitė;Gėlyčių;4964063637;Taip;0;8;0;8
3971;Kurpaitė;Gėlyčių;7546409044;Taip;0;15;0;15
3972;Kurpaitė;Gėlyčių;5609161523;Ne;3;0;0;3
3973;Kurpaitė;Gėlyčių;8669676262;Taip;0;13;0;13
3974;Kurpaitė;Gėlyčių;9480290430;Taip;0;2;0;2
3975;Kurpaitė;Gėlyčių;3634641300;Taip;0;5;0;5
3976;Kurpaitė;Gėlyčių;9200404698;Ne;0;2;0;2
3977;Kurpaitė;Gėlyčių;4602268315;Taip;14;0;0;14
3978;Kurpaitė;Gėlyčių;4168882748;Taip;5;0;0;5
3979;Kurpaitė;Drugelių;1236147310;Ne;14;0;0;14
3980;Kurpaitė;Drugelių;6826856088;Taip;4;0;0;4
3981;Kurpaitė;Drugelių;1202869338;Taip;10;0;0;10
3982;Kurpaitė;Drugelių;24410351286;Ne;0;17;0;17
3983;Kurpaitė;Drugelių;58127430940;Taip;10;6;0;16
3984;Kurpaitė;Drugelių;1606617694;Taip;0;19;0;19
3985;Kurpaitė;Drugelių;2359555461;Taip;9;0;0;9
3986;Kurpaitė;Drugelių;2116580903;Taip;0;10;0;10
3987;Kurpaitė;Drugelių;65434834152;Taip;0;8;0;8
3988;Kurpaitė;Drugelių;72710210157;Taip;0;8;0;8
3989;Kurpaitė;Drugelių;1218040871;Taip;0;20;0;20
3990;Kurpaitė;Drugelių;3660687688;Taip;0;2;0;2
3991;Kurpaitė;Drugelių;9435979008;Taip;0;9;0;9
3992;Kurpaitė;Drugelių;7431793716;Taip;0;22;0;22
3993;Kurpaitė;Drugelių;1505783589;Taip;0;6;0;6
3994;Kurpaitė;Drugelių;7249931704;Taip;0;15;0;15
3995;Kurpaitė;Drugelių;3102257512;Taip;8;0;0;8
3996;Kurpaitė;Pelyčių;5442955475;Taip;0;3;0;3
3997;Kurpaitė;Pelyčių;53385228310;Ne;0;3;0;3
3998;Kurpaitė;Pelyčių;35412773640;Taip;4;0;0;4
3999;Kurpaitė;Pelyčių;42230129130;Taip;0;8;0;8
4000;Kurpaitė;Pelyčių;28569380108;Taip;0;14;0;14
4001;Kurpaitė;Pelyčių;1936055251;Taip;7;2;0;9
4002;Kurpaitė;Pelyčių;5902371603;Taip;0;5;0;5
4003;Kurpaitė;Pelyčių;54840686231;Taip;0;10;0;10
4004;Kurpaitė;Pelyčių;49970457589;Ne;0;10;0;10
4005;Kurpaitė;Pelyčių;48526842780;Taip;0;9;0;9
4006;Kurpaitė;Pelyčių;38605683298;Taip;0;7;0;7
4007;Kurpaitė;Pelyčių;85698687930;Taip;4;0;0;4
4008;Kurpaitė;Pelyčių;48538300542;Taip;4;0;0;4
4009;Kurpaitė;Pelyčių;1730735673;Taip;0;12;0;12
4010;Kurpaitė;Pelyčių;52852801754;Taip;0;3;0;3
4011;Kurpaitė;Pelyčių;43247754405;Taip;0;20;0;20
4012;Kurpaitė;Pelyčių;51115562424;Taip;5;0;0;5
4013;Kurpaitė;Pelyčių;5394176979;Taip;17;0;0;17
4014;Kūlverstukas;Saulutės;74829986958;Taip;12;6;1;19
4015;Kūlverstukas;Saulutės;2072009099;Taip;0;0;4;4
4016;Kūlverstukas;Saulutės;1000393691;Taip;4;0;0;4
4017;Kūlverstukas;Saulutės;6577897961;Taip;12;0;2;14
4018;Kūlverstukas;Saulutės;3937419139;Taip;8;0;1;9
4019;Kūlverstukas;Saulutės;3162189859;Taip;9;0;1;10
4020;Kūlverstukas;Saulutės;1452422691;Taip;9;0;2;11
4021;Kūlverstukas;Saulutės;1240006602;Taip;4;0;0;4
4022;Kūlverstukas;Saulutės;2130099456;Taip;0;9;0;9
4023;Kūlverstukas;Saulutės;1226883894;Taip;7;0;0;7
4024;Kūlverstukas;Saulutės;37991935289;Taip;13;1;0;14
4025;Kūlverstukas;Saulutės;1699783763;Taip;0;6;0;6
4026;Kūlverstukas;Saulutės;3991821717;Taip;9;0;1;10
4027;Kūlverstukas;Saulutės;5488011852;Taip;14;0;0;14
4028;Kūlverstukas;Saulutės;8891671739;Taip;0;0;1;1
4029;Kūlverstukas;Saulutės;1617844709;Taip;10;0;9;19
4030;Kūlverstukas;Saulutės;4396230034;Ne;0;0;10;10
4031;Kūlverstukas;Saulutės;6975324309;Ne;0;0;12;12
4032;Kūlverstukas;Saulutės;9396183748;Taip;0;0;7;7
4033;Kūlverstukas;Saulutės;7359354944;Taip;6;0;0;6
4034;Kūlverstukas;Peledžiukai;4028937969;Taip;0;17;0;17
4035;Kūlverstukas;Peledžiukai;85330859485;Taip;10;0;0;10
4036;Kūlverstukas;Peledžiukai;2179050825;Taip;5;0;3;8
4037;Kūlverstukas;Peledžiukai;46254945540;Ne;8;0;0;8
4038;Kūlverstukas;Peledžiukai;1260193245;Taip;0;0;5;5
4039;Kūlverstukas;Peledžiukai;10716234461;Ne;0;2;0;2
4040;Kūlverstukas;Peledžiukai;89179106633;Ne;4;4;0;8
4041;Kūlverstukas;Peledžiukai;79760811110;Taip;0;3;0;3
4042;Kūlverstukas;Peledžiukai;46862868133;Taip;0;1;0;1
4043;Kūlverstukas;Peledžiukai;1816105412;Taip;5;2;0;7
4044;Kūlverstukas;Peledžiukai;1570383265;Taip;0;8;2;10
4045;Kūlverstukas;Peledžiukai;3737085009;Taip;0;0;4;4
4046;Kūlverstukas;Peledžiukai;47399326083;Taip;0;0;1;1
4047;Kūlverstukas;Peledžiukai;49788909084;Taip;5;0;2;7
4048;Kūlverstukas;Peledžiukai;1109035765;Taip;0;0;2;2
4049;Kūlverstukas;Peledžiukai;1471794813;Taip;0;0;1;1
4050;Kūlverstukas;Peledžiukai;1396533792;Ne;0;0;5;5
4051;Kūlverstukas;Peledžiukai;1009117653;Taip;16;0;0;16
4052;Kūlverstukas;Peledžiukai;8362459952;Taip;4;0;10;14
4053;Kūlverstukas;Gelytės;6287636806;Ne;4;3;1;8
4054;Kūlverstukas;Gelytės;2101490038;Taip;14;0;0;14
4055;Kūlverstukas;Gelytės;2450625415;Taip;14;0;0;14
4056;Kūlverstukas;Gelytės;8092104136;Taip;7;4;0;11
4057;Kūlverstukas;Gelytės;7480593611;Ne;9;0;0;9
4058;Kūlverstukas;Gelytės;5372936730;Taip;4;0;0;4
4059;Kūlverstukas;Gelytės;8243342948;Taip;6;0;1;7
4060;Kūlverstukas;Gelytės;4285624305;Ne;5;0;1;6
4061;Kūlverstukas;Gelytės;4073233921;Taip;0;0;1;1
4062;Kūlverstukas;Gelytės;2087570702;Taip;0;0;3;3
4063;Kūlverstukas;Gelytės;1932066021;Ne;3;0;0;3
4064;Kūlverstukas;Gelytės;5488852698;Taip;0;0;1;1
4065;Kūlverstukas;Gelytės;3069047204;Taip;0;0;10;10
4066;Kūlverstukas;Gelytės;5345423038;Taip;0;5;0;5
4067;Kūlverstukas;Gelytės;3270176280;Taip;5;4;0;9
4068;Kūlverstukas;Gelytės;2169480822;Ne;0;0;9;9
4069;Kūlverstukas;Gelytės;4173514390;Taip;4;0;0;4
4070;Kūlverstukas;Gelytės;3238807604;Taip;0;3;0;3
4071;Kūlverstukas;Gelytės;9655585527;Taip;12;0;1;13
4072;Kūlverstukas;Bitutės;9096819614;Ne;6;0;2;8
4073;Kūlverstukas;Bitutės;4532151103;Ne;12;0;0;12
4074;Kūlverstukas;Bitutės;7505926208;Taip;0;4;0;4
4075;Kūlverstukas;Bitutės;1014630718;Taip;0;4;0;4
4076;Kūlverstukas;Bitutės;5103259175;Taip;0;0;4;4
4077;Kūlverstukas;Bitutės;9167460438;Taip;7;0;1;8
4078;Kūlverstukas;Bitutės;1898905623;Taip;12;0;0;12
4079;Kūlverstukas;Bitutės;8319255735;Taip;0;0;14;14
4080;Kūlverstukas;Bitutės;6598688551;Taip;0;0;9;9
4081;Kūlverstukas;Bitutės;8556086501;Taip;0;1;5;6
4082;Kūlverstukas;Bitutės;7970898546;Taip;5;0;0;5
4083;Kūlverstukas;Bitutės;3162808486;Taip;2;0;0;2
4084;Kūlverstukas;Bitutės;1067182820;Taip;9;0;0;9
4085;Lakštingala;Saulutės;31221126819;Taip;0;0;3;3
4086;Lakštingala;Saulutės;3426133948;Taip;0;15;0;15
4087;Lakštingala;Saulutės;79652151224;Ne;0;4;0;4
4088;Lakštingala;Saulutės;50868279016;Taip;0;3;0;3
4089;Lakštingala;Saulutės;45850246980;Taip;7;0;4;11
4090;Lakštingala;Saulutės;2430795418;Ne;0;0;3;3
4091;Lakštingala;Saulutės;96792864646;Taip;0;1;0;1
4092;Lakštingala;Saulutės;74001349345;Taip;0;1;1;2
4093;Lakštingala;Saulutės;37722153251;Taip;5;1;0;6
4094;Lakštingala;Saulutės;79583726414;Ne;0;2;0;2
4095;Lakštingala;Saulutės;68037499606;Taip;0;0;3;3
4096;Lakštingala;Saulutės;51586922715;Taip;0;11;0;11
4097;Lakštingala;Saulutės;89747320378;Taip;0;0;1;1
4098;Lakštingala;Bitutės;3544861594;Taip;0;4;0;4
4099;Lakštingala;Bitutės;1422696792;Taip;0;0;7;7
4100;Lakštingala;Bitutės;16039738423;Taip;0;0;2;2
4101;Lakštingala;Bitutės;95149875628;Taip;5;4;0;9
4102;Lakštingala;Bitutės;2106666739;Taip;11;9;0;20
4103;Lakštingala;Bitutės;91158318909;Taip;0;1;0;1
4104;Lakštingala;Bitutės;92129853333;Taip;0;1;0;1
4105;Lakštingala;Bitutės;14826956710;Ne;5;2;3;10
4106;Lakštingala;Bitutės;44713607631;Taip;0;2;1;3
4107;Lakštingala;Bitutės;63698553352;Taip;0;5;0;5
4108;Lakštingala;Bitutės;19356167631;Taip;0;2;0;2
4109;Lakštingala;Bitutės;45199150020;Taip;0;3;0;3
4110;Lakštingala;Bitutės;24905526995;Ne;0;8;0;8
4111;Lakštingala;Bitutės;1056248263;Taip;4;0;0;4
4112;Lakštingala;Bitutės;56646163756;Taip;8;3;0;11
4113;Lakštingala;Bitutės;9610324086;Taip;0;0;1;1
4114;Lakštingala;Bitutės;7860949054;Taip;5;0;0;5
4115;Lakštingala;Bitutės;82319560992;Taip;0;7;0;7
4116;Lakštingala;Bitutės;2138306323;Taip;0;2;0;2
4117;Lakštingala;Pūkeliai;5598711072;Taip;11;6;0;17
4118;Lakštingala;Pūkeliai;8171357606;Taip;0;10;0;10
4119;Lakštingala;Pūkeliai;9774836470;Taip;4;2;1;7
4120;Lakštingala;Pūkeliai;1958696382;Taip;0;2;1;3
4121;Lakštingala;Pūkeliai;4542992319;Taip;11;0;0;11
4122;Lakštingala;Pūkeliai;9346986726;Taip;9;0;0;9
4123;Lakštingala;Pūkeliai;2593030897;Taip;8;0;0;8
4124;Lakštingala;Pūkeliai;6908873466;Taip;6;2;0;8
4125;Lakštingala;Pūkeliai;7929034243;Taip;3;2;2;7
4126;Lakštingala;Pūkeliai;5854794141;Taip;9;3;0;12
4127;Lakštingala;Pūkeliai;2130192341;Taip;17;0;0;17
4128;Lakštingala;Pūkeliai;8165998647;Taip;8;10;0;18
4129;Lakštingala;Pūkeliai;1458348357;Taip;11;0;0;11
4130;Lakštingala;Pūkeliai;4465752871;Ne;0;1;0;1
4131;Lakštingala;Pūkeliai;2430891944;Taip;9;1;0;10
4132;Lakštingala;Pūkeliai;5379344261;Taip;5;0;0;5
4133;Lakštingala;Pūkeliai;4722328994;Ne;4;0;0;4
4134;Lakštingala;Pūkeliai;7272454093;Taip;8;0;0;8
4135;Lakštingala;Pūkeliai;1587899391;Ne;19;0;0;19
4136;Lakštingala;Boružiukai;3280380015;Taip;0;9;0;9
4137;Lakštingala;Boružiukai;9004336424;Taip;0;1;2;3
4138;Lakštingala;Boružiukai;87470014156;Taip;0;6;8;14
4139;Lakštingala;Boružiukai;8820053026;Taip;2;0;0;2
4140;Lakštingala;Boružiukai;4811759034;Taip;8;0;0;8
4141;Lakštingala;Boružiukai;1898853302;Ne;9;0;0;9
4142;Lakštingala;Boružiukai;7443563000;Taip;0;0;5;5
4143;Lakštingala;Boružiukai;2792618575;Taip;0;0;21;21
4144;Lakštingala;Boružiukai;55720630870;Taip;10;0;0;10
4145;Lakštingala;Boružiukai;1444534032;Taip;0;0;6;6
4146;Lakštingala;Boružiukai;6150013105;Taip;0;2;0;2
4147;Lakštingala;Boružiukai;9724531753;Taip;5;1;2;8
4148;Lakštingala;Boružiukai;3602820204;Ne;0;22;0;22
4149;Lakštingala;"KIŠKUČIAI (SAV.)";64992551832;Taip;0;6;0;6
4150;Lakštingala;"KIŠKUČIAI (SAV.)";1169891428;Taip;6;0;0;6
4151;Lakštingala;"KIŠKUČIAI (SAV.)";1409132656;Taip;0;3;0;3
4152;Lakštingala;"KIŠKUČIAI (SAV.)";1236087612;Taip;0;4;0;4
4153;Lakštingala;"KIŠKUČIAI (SAV.)";80762133625;Ne;0;4;0;4
4154;Lakštingala;"KIŠKUČIAI (SAV.)";1128658722;Taip;0;4;0;4
4155;Lakštingala;"KIŠKUČIAI (SAV.)";40853872375;Taip;0;3;0;3
4156;Lakštingala;"KIŠKUČIAI (SAV.)";3660645944;Ne;0;22;0;22
4157;Lakštingala;"KIŠKUČIAI (SAV.)";7038977283;Ne;9;0;0;9
4158;Lakštingala;"KIŠKUČIAI (SAV.)";7623300327;Taip;3;4;0;7
4159;Lakštingala;"KIŠKUČIAI (SAV.)";2241000661;Taip;3;4;0;7
4160;Lakštingala;"KIŠKUČIAI (SAV.)";78648398334;Ne;0;2;0;2
4161;Lakštingala;"KIŠKUČIAI (SAV.)";709506281;Taip;4;1;0;5
4162;Lakštingala;"KIŠKUČIAI (SAV.)";1408127186;Taip;0;2;2;4
4163;Lakštingala;"KIŠKUČIAI (SAV.)";8645237294;Taip;6;0;0;6
4164;Lakštingala;Žiogeliai;2104150466;Taip;2;0;0;2
4165;Lakštingala;Žiogeliai;9395512638;Taip;0;2;0;2
4166;Lakštingala;Žiogeliai;9689911725;Taip;0;2;0;2
4167;Lakštingala;Žiogeliai;1411121466;Taip;5;0;4;9
4168;Lakštingala;Žiogeliai;9897713625;Taip;0;4;0;4
4169;Lakštingala;Žiogeliai;70798601578;Taip;0;3;0;3
4170;Lakštingala;Žiogeliai;1736130324;Taip;0;0;1;1
4171;Lakštingala;Žiogeliai;2039579203;Taip;0;0;1;1
4172;Lakštingala;Žiogeliai;6576202365;Taip;0;0;12;12
4173;Lakštingala;Žiogeliai;8470575927;Taip;0;3;0;3
4174;Lakštingala;Žiogeliai;1265027238;Taip;0;1;0;1
4175;Lakštingala;SPINDULIUKAI;19003276281;Taip;0;1;0;1
4176;Lakštingala;SPINDULIUKAI;31911078405;Taip;0;1;0;1
4177;Lakštingala;SPINDULIUKAI;59343571746;Taip;0;4;0;4
4178;Lakštingala;SPINDULIUKAI;601001178;Taip;0;2;8;10
4179;Lakštingala;SPINDULIUKAI;1263184555;Taip;0;0;3;3
4180;Lakštingala;SPINDULIUKAI;42012300013;Taip;0;1;0;1
4181;Lakštingala;SPINDULIUKAI;2002196654;Taip;3;0;0;3
4182;Lakštingala;SPINDULIUKAI;58847206918;Taip;10;0;0;10
4183;Lakštingala;SPINDULIUKAI;5033145687;Taip;4;4;0;8
4184;Lakštingala;SPINDULIUKAI;26288159700;Taip;5;0;0;5
4185;Lakštingala;SPINDULIUKAI;11399672681;Taip;0;13;0;13
4186;Lakštingala;SPINDULIUKAI;95832669291;Taip;0;14;0;14
4187;Lakštingala;SPINDULIUKAI;4183492894;Taip;0;5;0;5
4188;Lakštingala;SPINDULIUKAI;65408046990;Taip;0;0;5;5
4189;Lakštingala;SPINDULIUKAI;48160996499;Ne;0;0;3;3
4190;Lakštingala;SPINDULIUKAI;70748679017;Taip;0;5;0;5
4191;Lakštingala;SPINDULIUKAI;4770775472;Taip;0;2;1;3
4192;Lakštingala;SPINDULIUKAI;8838078447;Ne;0;2;2;4
4193;Lakštingala;SPINDULIUKAI;7448175606;Taip;0;1;5;6
4194;Lakštingala;SPINDULIUKAI;73039119839;Taip;0;0;16;16
4195;Lakštingala;Pėledžiukai;98609129644;Taip;0;4;0;4
4196;Lakštingala;Pėledžiukai;2635399411;Taip;0;0;1;1
4197;Lakštingala;Pėledžiukai;7325183642;Ne;22;0;0;22
4198;Lakštingala;Pėledžiukai;1297637335;Ne;0;3;0;3
4199;Lakštingala;Pėledžiukai;1271455798;Taip;0;0;1;1
4200;Lakštingala;Pėledžiukai;1868573076;Taip;0;0;2;2
4201;Lakštingala;Pėledžiukai;14410791110;Taip;0;5;1;6
4202;Lakštingala;Pėledžiukai;1676655778;Taip;0;0;4;4
4203;Lakštingala;Pėledžiukai;9381815353;Taip;0;12;0;12
4204;Lakštingala;Pėledžiukai;25449089230;Taip;0;6;0;6
4205;Lakštingala;Pėledžiukai;36367286465;Taip;0;0;1;1
4206;Lakštingala;Pėledžiukai;1347480198;Taip;0;1;0;1
4207;Lakštingala;Pėledžiukai;88947243829;Taip;0;4;6;10
4208;Lakštingala;Pėledžiukai;6329787217;Taip;0;6;0;6
4209;Lakštingala;Pėledžiukai;58056130761;Taip;0;7;0;7
4210;Lakštingala;Pėledžiukai;1310400524;Taip;0;0;1;1
4211;Lakštingala;Pėledžiukai;2013216779;Taip;0;0;1;1
4212;Lakštingala;Pėledžiukai;8890852891;Taip;0;0;7;7
4213;Lakštingala;Pėledžiukai;9998322501;Taip;0;0;14;14
4214;Lakštingala;Katinėliai;6780591792;Ne;22;0;0;22
4215;Lakštingala;Katinėliai;8422745100;Taip;8;0;4;12
4216;Lakštingala;Katinėliai;2022621678;Taip;0;0;8;8
4217;Lakštingala;Katinėliai;9762500668;Taip;0;0;4;4
4218;Lakštingala;Katinėliai;8703818797;Taip;21;0;0;21
4219;Lakštingala;Katinėliai;4365413054;Taip;3;0;0;3
4220;Lakštingala;Katinėliai;7455063702;Ne;0;0;16;16
4221;Lakštingala;Katinėliai;7640007392;Taip;22;0;0;22
4222;Lakštingala;Katinėliai;4784677514;Taip;6;0;1;7
4223;Lakštingala;Katinėliai;1619201521;Taip;0;4;0;4
4224;Lakštingala;Katinėliai;8429523368;Taip;0;0;18;18
4225;Lakštingala;Katinėliai;1767414096;Taip;0;0;1;1
4226;Lakštingala;Katinėliai;6668075753;Taip;9;0;0;9
4227;Lakštingala;Katinėliai;9081653166;Taip;8;1;0;9
4228;Lakštingala;Katinėliai;8160825203;Taip;0;5;0;5
4229;Lakštingala;Katinėliai;2371619895;Taip;0;0;1;1
4230;Lakštingala;Katinėliai;7404386777;Taip;0;0;15;15
4231;Lakštingala;Katinėliai;4698879435;Taip;0;6;0;6
4232;Lakštingala;Katinėliai;1220858944;Taip;0;1;0;1
4233;Lakštingala;Katinėliai;7367305924;Ne;5;0;0;5
4234;Lakštingala;Deimantėliai;3568151046;Taip;13;1;0;14
4235;Lakštingala;Deimantėliai;3369263112;Taip;4;0;0;4
4236;Lakštingala;Deimantėliai;4774354751;Taip;0;0;20;20
4237;Lakštingala;Deimantėliai;3766779594;Taip;0;1;0;1
4238;Lakštingala;Deimantėliai;7139669240;Taip;0;0;8;8
4239;Lakštingala;Deimantėliai;3050655193;Taip;0;10;3;13
4240;Lakštingala;Deimantėliai;2738882466;Taip;0;14;0;14
4241;Lakštingala;Deimantėliai;2663268027;Taip;0;0;20;20
4242;Lakštingala;Deimantėliai;6135103377;Taip;2;1;5;8
4243;Lakštingala;Deimantėliai;8075192528;Taip;0;0;18;18
4244;Lakštingala;Deimantėliai;9297542026;Taip;6;8;0;14
4245;Lakštingala;Deimantėliai;2723364075;Taip;0;0;20;20
4246;Lakštingala;Deimantėliai;8375506323;Taip;0;1;2;3
4247;Lakštingala;Deimantėliai;8717764626;Taip;4;0;0;4
4248;Lakštingala;Deimantėliai;2962846236;Taip;7;4;5;16
4249;Lakštingala;Deimantėliai;1474796466;Taip;13;0;0;13
4250;Lakštingala;Deimantėliai;6369696598;Taip;5;0;0;5
4251;Lašelis;VIŠČIUKAI;3982877012;Ne;10;0;1;11
4252;Lašelis;VIŠČIUKAI;1108744283;Taip;0;0;2;2
4253;Lašelis;VIŠČIUKAI;6136792125;Taip;0;8;0;8
4254;Lašelis;VIŠČIUKAI;8324581018;Ne;0;0;7;7
4255;Lašelis;VIŠČIUKAI;6977000987;Ne;0;0;2;2
4256;Lašelis;VIŠČIUKAI;1417989409;Taip;0;0;7;7
4257;Lašelis;VIŠČIUKAI;6090290046;Taip;0;3;0;3
4258;Lašelis;VIŠČIUKAI;1578956182;Taip;0;5;0;5
4259;Lašelis;VIŠČIUKAI;2500332755;Taip;7;3;0;10
4260;Lašelis;VIŠČIUKAI;1739797553;Taip;0;3;0;3
4261;Lašelis;VIŠČIUKAI;5046619730;Ne;8;4;0;12
4262;Lašelis;VIŠČIUKAI;1193336600;Taip;0;9;0;9
4263;Lašelis;VIŠČIUKAI;3741905080;Ne;0;0;15;15
4264;Lašelis;VIŠČIUKAI;6492909546;Ne;0;3;0;3
4265;Lašelis;VIŠČIUKAI;7471332824;Taip;0;4;0;4
4266;Lašelis;VIŠČIUKAI;4062516422;Taip;0;5;0;5
4267;Lašelis;VIŠČIUKAI;4599789649;Ne;5;7;0;12
4268;Lašelis;VIŠČIUKAI;1224648193;Ne;0;9;2;11
4269;Lašelis;ŠYPSENA;2204859014;Taip;9;4;0;13
4270;Lašelis;ŠYPSENA;3239288878;Taip;3;0;2;5
4271;Lašelis;ŠYPSENA;3144718477;Taip;0;0;5;5
4272;Lašelis;ŠYPSENA;1777442316;Taip;4;8;0;12
4273;Lašelis;ŠYPSENA;7998812497;Taip;10;5;1;16
4274;Lašelis;ŠYPSENA;6669130831;Taip;12;0;0;12
4275;Lašelis;ŠYPSENA;7351939034;Taip;0;1;0;1
4276;Lašelis;ŠYPSENA;7802622810;Taip;4;1;0;5
4277;Lašelis;ŠYPSENA;1886540733;Taip;0;0;2;2
4278;Lašelis;ŠYPSENA;6553762186;Taip;3;12;3;18
4279;Lašelis;ŠYPSENA;1085400709;Taip;0;7;0;7
4280;Lašelis;ŠYPSENA;6127747445;Taip;0;6;1;7
4281;Lašelis;ŠYPSENA;2912232814;Taip;4;3;1;8
4282;Lašelis;ŠYPSENA;4151582358;Taip;0;13;0;13
4283;Lašelis;ŠYPSENA;1646912457;Taip;5;3;0;8
4284;Lašelis;ŠYPSENA;6080664872;Taip;7;0;2;9
4285;Lašelis;ŠYPSENA;6829438486;Taip;0;4;4;8
4286;Lašelis;ŠYPSENA;1515920896;Ne;2;0;3;5
4287;Lašelis;ŠYPSENA;8889959782;Ne;5;0;2;7
4288;Lašelis;NYKŠTUKAI;4320017329;Taip;5;0;0;5
4289;Lašelis;NYKŠTUKAI;60394164372;Taip;4;0;0;4
4290;Lašelis;NYKŠTUKAI;1584708183;Taip;10;1;0;11
4291;Lašelis;NYKŠTUKAI;713862923;Ne;0;0;1;1
4292;Lašelis;NYKŠTUKAI;2118500745;Taip;0;0;4;4
4293;Lašelis;NYKŠTUKAI;14934740494;Ne;0;11;0;11
4294;Lašelis;NYKŠTUKAI;7349722463;Taip;0;3;0;3
4295;Lašelis;NYKŠTUKAI;8332516807;Taip;6;0;1;7
4296;Lašelis;NYKŠTUKAI;10694830733;Ne;10;0;0;10
4297;Lašelis;NYKŠTUKAI;1282991939;Taip;9;0;0;9
4298;Lašelis;NYKŠTUKAI;82073061357;Taip;0;4;0;4
4299;Lašelis;NYKŠTUKAI;58391864442;Taip;0;3;0;3
4300;Lašelis;NYKŠTUKAI;8873895533;Taip;9;0;2;11
4301;Lašelis;NYKŠTUKAI;2429224297;Ne;0;5;0;5
4302;Lašelis;NYKŠTUKAI;1383759549;Taip;8;3;0;11
4303;Lašelis;NYKŠTUKAI;86191407652;Taip;8;0;0;8
4304;Lašelis;NYKŠTUKAI;9391594216;Taip;0;11;0;11
4305;Lašelis;NYKŠTUKAI;1987591278;Ne;15;4;0;19
4306;Lašelis;SAULUTĖ;1171647193;Ne;0;0;1;1
4307;Lašelis;SAULUTĖ;1711262987;Ne;0;0;2;2
4308;Lašelis;SAULUTĖ;29417065142;Taip;0;11;0;11
4309;Lašelis;SAULUTĖ;37726695989;Taip;0;7;0;7
4310;Lašelis;SAULUTĖ;28071639285;Taip;0;7;0;7
4311;Lašelis;SAULUTĖ;85641710509;Ne;0;0;3;3
4312;Lašelis;SAULUTĖ;1635550414;Taip;0;8;0;8
4313;Lašelis;SAULUTĖ;1833121579;Taip;0;1;0;1
4314;Lašelis;SAULUTĖ;1917927039;Ne;0;4;0;4
4315;Lašelis;SAULUTĖ;38601962350;Taip;0;5;0;5
4316;Lašelis;SAULUTĖ;1099685342;Taip;0;5;0;5
4317;Lašelis;SAULUTĖ;40927906931;Taip;0;0;1;1
4318;Lašelis;SAULUTĖ;34947111596;Taip;0;3;0;3
4319;Lašelis;BORUŽĖLĖS;2886967297;Taip;0;4;0;4
4320;Lašelis;BORUŽĖLĖS;8132517365;Taip;6;0;1;7
4321;Lašelis;BORUŽĖLĖS;1175045927;Taip;5;8;0;13
4322;Lašelis;BORUŽĖLĖS;2401058384;Ne;4;0;2;6
4323;Lašelis;BORUŽĖLĖS;1244168190;Taip;9;0;1;10
4324;Lašelis;BORUŽĖLĖS;2034007263;Taip;4;0;1;5
4325;Lašelis;BORUŽĖLĖS;8318512396;Taip;0;3;0;3
4326;Lašelis;BORUŽĖLĖS;7657786815;Ne;15;0;1;16
4327;Lašelis;BORUŽĖLĖS;7107685761;Taip;2;0;0;2
4328;Lašelis;BORUŽĖLĖS;3495676199;Taip;4;0;0;4
4329;Lašelis;BORUŽĖLĖS;3843163586;Taip;0;5;1;6
4330;Lašelis;BORUŽĖLĖS;6304391719;Taip;8;0;0;8
4331;Lašelis;BORUŽĖLĖS;1085950130;Taip;13;0;1;14
4332;Lašelis;BORUŽĖLĖS;6041192600;Taip;22;0;0;22
4333;Lašelis;SKRUZDELIUKAI;3564781987;Taip;0;10;0;10
4334;Lašelis;SKRUZDELIUKAI;5392759654;Taip;22;0;0;22
4335;Lašelis;SKRUZDELIUKAI;1635921119;Ne;6;0;0;6
4336;Lašelis;SKRUZDELIUKAI;1824418095;Taip;0;8;0;8
4337;Lašelis;SKRUZDELIUKAI;7137348151;Taip;0;0;1;1
4338;Lašelis;SKRUZDELIUKAI;3995905195;Taip;10;0;0;10
4339;Lašelis;SKRUZDELIUKAI;2223293390;Taip;22;0;0;22
4340;Lašelis;SKRUZDELIUKAI;2306501498;Ne;3;0;0;3
4341;Lašelis;SKRUZDELIUKAI;9664015801;Taip;0;11;0;11
4342;Lazdynėlis;BITUTĖS;4881322530;Taip;15;0;0;15
4343;Lazdynėlis;BITUTĖS;6643600680;Taip;5;3;1;9
4344;Lazdynėlis;BITUTĖS;5182241318;Ne;3;0;0;3
4345;Lazdynėlis;BITUTĖS;6762312809;Taip;0;11;1;12
4346;Lazdynėlis;BITUTĖS;8008332680;Taip;0;3;3;6
4347;Lazdynėlis;BITUTĖS;1748260780;Taip;3;0;7;10
4348;Lazdynėlis;BITUTĖS;4462819848;Taip;3;1;0;4
4349;Lazdynėlis;BITUTĖS;1574847460;Taip;0;0;6;6
4350;Lazdynėlis;BITUTĖS;8159928299;Taip;4;0;0;4
4351;Lazdynėlis;BITUTĖS;9761942869;Taip;0;6;0;6
4352;Lazdynėlis;BITUTĖS;7911328294;Taip;0;0;3;3
4353;Lazdynėlis;BITUTĖS;1450181711;Taip;7;0;0;7
4354;Lazdynėlis;BITUTĖS;2044188250;Taip;5;1;0;6
4355;Lazdynėlis;BITUTĖS;4142277927;Taip;0;4;0;4
4356;Lazdynėlis;BITUTĖS;4826167852;Taip;0;0;3;3
4357;Lazdynėlis;BITUTĖS;2802505435;Taip;0;0;4;4
4358;Lazdynėlis;BITUTĖS;2586187455;Taip;5;2;0;7
4359;Lazdynėlis;BITUTĖS;2013752858;Taip;0;0;4;4
4360;Lazdynėlis;BITUTĖS;4545757725;Taip;3;0;0;3
4361;Lazdynėlis;EŽIUKAI;6086766393;Taip;0;0;1;1
4362;Lazdynėlis;EŽIUKAI;3091067158;Taip;0;0;3;3
4363;Lazdynėlis;EŽIUKAI;2041709821;Taip;0;22;0;22
4364;Lazdynėlis;EŽIUKAI;32856469893;Taip;6;4;5;15
4365;Lazdynėlis;EŽIUKAI;6542840562;Taip;0;3;0;3
4366;Lazdynėlis;EŽIUKAI;8975341347;Taip;4;0;0;4
4367;Lazdynėlis;EŽIUKAI;5301460250;Taip;0;9;2;11
4368;Lazdynėlis;EŽIUKAI;1265404063;Taip;0;10;0;10
4369;Lazdynėlis;EŽIUKAI;83586382037;Taip;0;0;5;5
4370;Lazdynėlis;EŽIUKAI;9081770664;Taip;16;0;0;16
4371;Lazdynėlis;EŽIUKAI;1479568714;Taip;5;0;1;6
4372;Lazdynėlis;EŽIUKAI;8271766964;Ne;9;0;0;9
4373;Lazdynėlis;EŽIUKAI;9668839027;Ne;0;10;0;10
4374;Lazdynėlis;EŽIUKAI;47861078891;Taip;9;8;0;17
4375;Lazdynėlis;EŽIUKAI;2841262230;Taip;0;22;0;22
4376;Lazdynėlis;EŽIUKAI;7499322078;Taip;0;8;0;8
4377;Lazdynėlis;EŽIUKAI;92889991874;Taip;4;0;0;4
4378;Lazdynėlis;EŽIUKAI;91720096560;Taip;3;1;0;4
4379;Lazdynėlis;EŽIUKAI;4842228703;Taip;7;0;0;7
4380;Lazdynėlis;BORUŽIUKAI;2168516394;Taip;3;0;1;4
4381;Lazdynėlis;BORUŽIUKAI;4961149717;Taip;0;0;7;7
4382;Lazdynėlis;BORUŽIUKAI;99475014554;Taip;0;0;3;3
4383;Lazdynėlis;BORUŽIUKAI;6156638726;Ne;0;12;0;12
4384;Lazdynėlis;BORUŽIUKAI;1321841783;Taip;9;0;0;9
4385;Lazdynėlis;BORUŽIUKAI;9570299877;Taip;0;22;0;22
4386;Lazdynėlis;BORUŽIUKAI;50390821034;Taip;0;1;0;1
4387;Lazdynėlis;BORUŽIUKAI;1789237348;Taip;0;12;0;12
4388;Lazdynėlis;BORUŽIUKAI;2105998927;Taip;2;0;1;3
4389;Lazdynėlis;BORUŽIUKAI;29288665418;Taip;22;0;0;22
4390;Lazdynėlis;BORUŽIUKAI;11379612306;Taip;0;0;3;3
4391;Lazdynėlis;BORUŽIUKAI;8945282683;Taip;0;0;4;4
4392;Lazdynėlis;BORUŽIUKAI;5838945434;Taip;0;7;0;7
4393;Lazdynėlis;BORUŽIUKAI;6230420677;Taip;0;10;0;10
4394;Lazdynėlis;KAČIUKAI;66134107213;Taip;16;0;0;16
4395;Lazdynėlis;KAČIUKAI;67819115627;Taip;0;0;4;4
4396;Lazdynėlis;KAČIUKAI;97795271362;Taip;10;0;2;12
4397;Lazdynėlis;KAČIUKAI;55167939220;Taip;0;0;4;4
4398;Lazdynėlis;KAČIUKAI;56747379453;Taip;0;0;5;5
4399;Lazdynėlis;KAČIUKAI;65438421685;Taip;0;2;0;2
4400;Lazdynėlis;KAČIUKAI;78302777769;Ne;0;1;7;8
4401;Lazdynėlis;KAČIUKAI;85340642919;Taip;0;0;1;1
4402;Lazdynėlis;KAČIUKAI;77950321376;Taip;0;0;1;1
4403;Lazdynėlis;KAČIUKAI;5068598385;Taip;0;0;3;3
4404;Lazdynėlis;KAČIUKAI;2491872016;Taip;0;0;3;3
4405;Lazdynėlis;KAČIUKAI;2740122426;Taip;0;0;5;5
4406;Lazdynėlis;KAČIUKAI;79847018203;Taip;5;0;1;6
4407;Lazdynėlis;KAČIUKAI;1126756897;Ne;0;0;1;1
4408;Lazdynėlis;KAČIUKAI;9881554733;Ne;0;6;0;6
4409;Lazdynėlis;KAČIUKAI;79583491543;Taip;0;0;1;1
4410;Lazdynėlis;KAČIUKAI;7242681767;Taip;0;1;0;1
4411;Lazdynėlis;VOVERIUKAI;4425724586;Taip;0;0;1;1
4412;Lazdynėlis;VOVERIUKAI;6684940385;Taip;0;0;4;4
4413;Lazdynėlis;VOVERIUKAI;9187681789;Taip;0;0;1;1
4414;Lazdynėlis;VOVERIUKAI;25596458181;Taip;0;22;0;22
4415;Lazdynėlis;VOVERIUKAI;24978945607;Taip;0;6;0;6
4416;Lazdynėlis;VOVERIUKAI;18498032472;Taip;0;6;0;6
4417;Lazdynėlis;VOVERIUKAI;1852865534;Taip;1;0;2;3
4418;Lazdynėlis;VOVERIUKAI;7789345652;Taip;4;0;0;4
4419;Lazdynėlis;VOVERIUKAI;8822378464;Ne;5;0;1;6
4420;Lazdynėlis;VOVERIUKAI;2587142646;Taip;15;0;0;15
4421;Lazdynėlis;VOVERIUKAI;2603427970;Taip;22;0;0;22
4422;Lazdynėlis;VOVERIUKAI;2441835588;Taip;0;0;1;1
4423;Lazdynėlis;VOVERIUKAI;3043350186;Taip;0;0;2;2
4424;Lazdynėlis;VOVERIUKAI;44510351979;Taip;0;0;10;10
4425;Lazdynėlis;VOVERIUKAI;1424382629;Ne;0;1;0;1
4426;Lazdynėlis;RIEŠUTĖLIAI;53141612488;Taip;0;0;2;2
4427;Lazdynėlis;RIEŠUTĖLIAI;81489861336;Taip;0;1;0;1
4428;Lazdynėlis;RIEŠUTĖLIAI;24433496244;Taip;4;9;0;13
4429;Lazdynėlis;RIEŠUTĖLIAI;99158632198;Taip;4;0;1;5
4430;Lazdynėlis;RIEŠUTĖLIAI;91895608057;Taip;0;1;4;5
4431;Lazdynėlis;RIEŠUTĖLIAI;95091154108;Taip;2;0;0;2
4432;Lazdynėlis;RIEŠUTĖLIAI;95539787778;Taip;0;13;0;13
4433;Lazdynėlis;RIEŠUTĖLIAI;3000783343;Ne;0;2;0;2
4434;Lazdynėlis;RIEŠUTĖLIAI;75017112973;Taip;0;0;1;1
4435;Lazdynėlis;RIEŠUTĖLIAI;93311489447;Taip;0;11;0;11
4436;Lazdynėlis;RIEŠUTĖLIAI;3980826951;Taip;0;1;1;2
4437;Lazdynėlis;RIEŠUTĖLIAI;1213657708;Ne;0;1;1;2
4438;Lazdynėlis;RIEŠUTĖLIAI;1169424024;Taip;0;1;0;1
4439;Lazdynėlis;RIEŠUTĖLIAI;1257093165;Taip;0;0;8;8
4440;Lazdynėlis;RIEŠUTĖLIAI;42460029042;Taip;0;0;1;1
4441;Lazdynėlis;RIEŠUTĖLIAI;58985240094;Taip;0;10;0;10
4442;Lazdynėlis;RIEŠUTĖLIAI;7044338769;Taip;0;1;0;1
4443;Lazdynėlis;RIEŠUTĖLIAI;9186165264;Taip;22;0;0;22
4444;Lazdynėlis;RIEŠUTĖLIAI;90528749634;Ne;5;0;2;7
4445;Lazdynėlis;ANČIUKAI;5557752248;Taip;0;1;0;1
4446;Lazdynėlis;ANČIUKAI;5888646355;Taip;3;1;2;6
4447;Lazdynėlis;ANČIUKAI;8295967906;Taip;4;0;0;4
4448;Lazdynėlis;ANČIUKAI;7076664657;Taip;0;4;1;5
4449;Lazdynėlis;ANČIUKAI;8435203145;Taip;0;22;0;22
4450;Lazdynėlis;ANČIUKAI;4779025603;Taip;0;1;0;1
4451;Lazdynėlis;ANČIUKAI;1335000592;Ne;4;0;0;4
4452;Lazdynėlis;ANČIUKAI;3062408541;Ne;9;0;0;9
4453;Lazdynėlis;ANČIUKAI;7941793866;Taip;3;1;0;4
4454;Lazdynėlis;ANČIUKAI;5708643953;Taip;0;0;1;1
4455;Lazdynėlis;ANČIUKAI;7545621720;Ne;0;2;1;3
4456;Lazdynėlis;ANČIUKAI;9231049001;Taip;0;0;2;2
4457;Lazdynėlis;ANČIUKAI;6164180360;Taip;4;0;0;4
4458;Lazdynėlis;ANČIUKAI;6276697479;Taip;6;1;1;8
4459;Lazdynėlis;GUDRUČIAI;1543682603;Taip;0;4;0;4
4460;Lazdynėlis;GUDRUČIAI;96599967318;Taip;0;6;0;6
4461;Lazdynėlis;GUDRUČIAI;16456265624;Taip;0;8;0;8
4462;Lazdynėlis;GUDRUČIAI;44974714364;Taip;3;0;0;3
4463;Lazdynėlis;GUDRUČIAI;57619129301;Ne;0;4;0;4
4464;Lazdynėlis;GUDRUČIAI;64086512959;Taip;3;1;0;4
4465;Lazdynėlis;GUDRUČIAI;56719158862;Taip;0;4;5;9
4466;Lazdynėlis;GUDRUČIAI;1349582895;Ne;0;7;0;7
4467;Lazdynėlis;GUDRUČIAI;34657435789;Taip;0;8;0;8
4468;Lazdynėlis;GUDRUČIAI;34619798427;Taip;0;8;0;8
4469;Lazdynėlis;GUDRUČIAI;2496563388;Taip;5;0;1;6
4470;Lazdynėlis;GUDRUČIAI;28670815274;Taip;0;0;3;3
4471;Lazdynėlis;MEŠKIUKAI;3667994076;Taip;9;2;8;19
4472;Lazdynėlis;MEŠKIUKAI;3239107488;Ne;0;1;0;1
4473;Lazdynėlis;MEŠKIUKAI;1325204410;Taip;2;0;3;5
4474;Lazdynėlis;MEŠKIUKAI;3604282352;Taip;10;0;3;13
4475;Lazdynėlis;MEŠKIUKAI;3062924645;Taip;0;0;1;1
4476;Lazdynėlis;MEŠKIUKAI;8179584161;Taip;0;0;2;2
4477;Lazdynėlis;MEŠKIUKAI;8942906327;Ne;0;22;0;22
4478;Lazdynėlis;MEŠKIUKAI;7523052754;Taip;0;2;1;3
4479;Lazdynėlis;MEŠKIUKAI;8248185061;Taip;22;0;0;22
4480;Lazdynėlis;MEŠKIUKAI;8627994583;Taip;0;22;0;22
4481;Lazdynėlis;MEŠKIUKAI;8337458289;Taip;0;22;0;22
4482;Lazdynėlis;MEŠKIUKAI;3040417651;Taip;0;22;0;22
4483;Lazdynėlis;MEŠKIUKAI;7464997080;Taip;0;9;0;9
4484;Lazdynėlis;MEŠKIUKAI;4055450300;Ne;12;0;0;12
4485;Lazdynėlis;MEŠKIUKAI;1668899344;Ne;4;0;1;5
4486;Lazdynėlis;MEŠKIUKAI;9582702244;Taip;0;10;0;10
4487;Linelis;Giliukai;79543604124;Taip;0;0;1;1
4488;Linelis;Giliukai;3300710386;Taip;0;0;1;1
4489;Linelis;Giliukai;1505058152;Ne;0;0;12;12
4490;Linelis;Giliukai;4644771654;Taip;9;4;0;13
4491;Linelis;Giliukai;94514045159;Taip;0;0;8;8
4492;Linelis;Giliukai;1270931913;Taip;0;0;6;6
4493;Linelis;Giliukai;1270843542;Taip;2;0;0;2
4494;Linelis;Giliukai;1159267747;Taip;0;7;1;8
4495;Linelis;Giliukai;5903547677;Taip;0;0;3;3
4496;Linelis;Giliukai;58467930454;Taip;0;14;1;15
4497;Linelis;Giliukai;37069004807;Taip;4;0;1;5
4498;Linelis;Giliukai;5075219728;Taip;0;0;2;2
4499;Linelis;Giliukai;5302605429;Taip;0;5;5;10
4500;Linelis;Giliukai;1891722948;Ne;0;0;4;4
4501;Linelis;Giliukai;71647031404;Ne;9;0;1;10
4502;Linelis;Giliukai;1148540808;Taip;0;3;0;3
4503;Linelis;Giliukai;46788785414;Taip;0;7;3;10
4504;Linelis;Giliukai;3483401448;Ne;10;0;5;15
4505;Linelis;Giliukai;61862257310;Taip;0;0;1;1
4506;Linelis;Giliukai;1526473615;Ne;5;0;1;6
4507;Linelis;Saulutė;1623356368;Ne;0;0;2;2
4508;Linelis;Saulutė;1374116898;Ne;0;0;4;4
4509;Linelis;Saulutė;77154624822;Taip;0;6;0;6
4510;Linelis;Saulutė;54594020356;Ne;0;0;7;7
4511;Linelis;Saulutė;4425214681;Taip;0;0;1;1
4512;Linelis;Saulutė;92658776822;Taip;0;7;0;7
4513;Linelis;Saulutė;29074930927;Taip;0;0;11;11
4514;Linelis;Saulutė;1539102468;Taip;0;0;2;2
4515;Linelis;Saulutė;1646521870;Ne;0;0;12;12
4516;Linelis;Saulutė;53442382594;Taip;2;4;1;7
4517;Linelis;Saulutė;87947273588;Taip;0;0;3;3
4518;Linelis;Saulutė;93959783827;Taip;0;0;1;1
4519;Linelis;Saulutė;73386013083;Taip;0;0;13;13
4520;Linelis;Saulutė;32821891070;Ne;0;16;0;16
4521;Linelis;Saulutė;18414199111;Taip;14;0;4;18
4522;Linelis;Saulutė;1908259203;Taip;0;0;3;3
4523;Linelis;Nykštukai;2194387139;Taip;5;0;0;5
4524;Linelis;Nykštukai;8339073780;Taip;0;0;1;1
4525;Linelis;Nykštukai;7530950218;Ne;2;0;0;2
4526;Linelis;Nykštukai;1194624252;Taip;0;1;3;4
4527;Linelis;Nykštukai;2391319590;Taip;0;2;0;2
4528;Linelis;Nykštukai;9666785036;Ne;0;1;1;2
4529;Linelis;Nykštukai;8095635609;Ne;0;1;1;2
4530;Linelis;Nykštukai;3158789663;Taip;2;1;0;3
4531;Linelis;Nykštukai;8837847094;Ne;14;0;0;14
4532;Linelis;Nykštukai;3189188757;Taip;5;0;0;5
4533;Linelis;Nykštukai;1351957198;Taip;7;0;1;8
4534;Linelis;Nykštukai;3682550072;Taip;13;0;3;16
4535;Linelis;Nykštukai;6130634131;Taip;3;0;0;3
4536;Linelis;Nykštukai;8654487151;Taip;0;4;1;5
4537;Linelis;Nykštukai;6160295507;Taip;3;0;3;6
4538;Linelis;Nykštukai;6374352500;Taip;8;0;1;9
4539;Linelis;Daigiukai;4464615995;Taip;11;0;0;11
4540;Linelis;Daigiukai;9775865557;Taip;15;3;0;18
4541;Linelis;Daigiukai;4456549120;Ne;0;4;0;4
4542;Linelis;Daigiukai;7320085613;Taip;2;5;0;7
4543;Linelis;Daigiukai;6460217912;Taip;0;0;1;1
4544;Linelis;Daigiukai;5668765825;Taip;11;0;0;11
4545;Linelis;Daigiukai;1612049897;Taip;11;0;0;11
4546;Linelis;Daigiukai;3954867816;Taip;0;0;5;5
4547;Linelis;Daigiukai;2228682366;Taip;4;6;0;10
4548;Linelis;Daigiukai;7011836009;Taip;21;0;0;21
4549;Linelis;Daigiukai;6735037523;Taip;0;0;1;1
4550;Linelis;Daigiukai;7881263225;Taip;2;0;0;2
4551;Linelis;Daigiukai;9147558926;Taip;0;0;2;2
4552;Linelis;Daigiukai;9920959446;Taip;0;3;0;3
4553;Linelis;Daigiukai;8623441952;Ne;0;0;13;13
4554;Markučiai;Žirniukų;4934200922;Taip;0;2;0;2
4555;Markučiai;Žirniukų;61354140820;Taip;0;2;0;2
4556;Markučiai;Žirniukų;86073430849;Taip;0;0;7;7
4557;Markučiai;Žirniukų;59514770545;Taip;4;3;0;7
4558;Markučiai;Žirniukų;62276512687;Taip;0;0;1;1
4559;Markučiai;Žirniukų;95776655287;Taip;4;0;1;5
4560;Markučiai;Žirniukų;47122307518;Ne;0;0;3;3
4561;Markučiai;Žirniukų;95347461846;Taip;0;2;0;2
4562;Markučiai;Žirniukų;1962169822;Taip;2;0;0;2
4563;Markučiai;Žirniukų;1986626575;Taip;5;0;0;5
4564;Markučiai;Žirniukų;2397953983;Taip;10;0;0;10
4565;Markučiai;Žirniukų;4256825722;Ne;2;1;1;4
4566;Markučiai;Nykštukų;46647877230;Taip;2;6;0;8
4567;Markučiai;Nykštukų;37101160556;Taip;0;2;4;6
4568;Markučiai;Nykštukų;1473258832;Taip;6;2;0;8
4569;Markučiai;Nykštukų;92394309416;Taip;2;1;0;3
4570;Markučiai;Nykštukų;5026941590;Taip;0;0;1;1
4571;Markučiai;Nykštukų;6915912992;Taip;2;1;0;3
4572;Markučiai;Nykštukų;52920975294;Taip;0;0;1;1
4573;Markučiai;Nykštukų;88304161598;Taip;0;7;0;7
4574;Markučiai;Nykštukų;76003071176;Taip;0;11;0;11
4575;Markučiai;Nykštukų;1464123752;Ne;12;0;0;12
4576;Markučiai;Nykštukų;1937352406;Taip;0;0;1;1
4577;Markučiai;Nykštukų;1821127640;Taip;0;0;1;1
4578;Markučiai;Nykštukų;6639579832;Taip;4;1;0;5
4579;Markučiai;Nykštukų;9985442003;Taip;2;4;0;6
4580;Markučiai;Nykštukų;1507368475;Taip;5;1;0;6
4581;Markučiai;Nykštukų;1817367317;Taip;4;2;0;6
4582;Markučiai;Nykštukų;5954207590;Ne;11;0;0;11
4583;Markučiai;Pelėdžiukų;3386071459;Taip;12;0;0;12
4584;Markučiai;Pelėdžiukų;4653663237;Ne;5;0;1;6
4585;Markučiai;Pelėdžiukų;6260010822;Taip;0;3;11;14
4586;Markučiai;Pelėdžiukų;5727655114;Taip;3;0;1;4
4587;Markučiai;Pelėdžiukų;6740434675;Taip;9;0;1;10
4588;Markučiai;Pelėdžiukų;6707310242;Taip;12;0;3;15
4589;Markučiai;Pelėdžiukų;2256262371;Taip;3;3;0;6
4590;Markučiai;Pelėdžiukų;7947287013;Ne;13;0;1;14
4591;Markučiai;Pelėdžiukų;2543313198;Taip;0;0;2;2
4592;Markučiai;Pelėdžiukų;4418580273;Taip;9;0;1;10
4593;Markučiai;Pelėdžiukų;5522654429;Taip;3;5;7;15
4594;Markučiai;Pelėdžiukų;4860961508;Taip;9;0;2;11
4595;Markučiai;Pelėdžiukų;9219710045;Ne;7;0;2;9
4596;Markučiai;Pelėdžiukų;3525681034;Taip;17;0;0;17
4597;Markučiai;Pelėdžiukų;7312533881;Taip;17;0;0;17
4598;Markučiai;Boružėlių;9059302464;Taip;5;0;0;5
4599;Markučiai;Boružėlių;9220749889;Taip;12;0;0;12
4600;Markučiai;Boružėlių;2962530721;Taip;11;0;0;11
4601;Markučiai;Boružėlių;6574037877;Taip;0;14;1;15
4602;Markučiai;Boružėlių;5752762229;Taip;0;1;0;1
4603;Markučiai;Boružėlių;4383421917;Taip;0;2;0;2
4604;Markučiai;Boružėlių;9789274040;Taip;9;1;0;10
4605;Markučiai;Boružėlių;1146968021;Taip;1;0;1;2
4606;Markučiai;Boružėlių;1171899107;Taip;10;0;0;10
4607;Markučiai;Boružėlių;8092642447;Taip;3;0;3;6
4608;Markučiai;Boružėlių;8078777204;Taip;4;0;0;4
4609;Markučiai;Boružėlių;8605357678;Taip;4;0;0;4
4610;Markučiai;Boružėlių;3755794133;Taip;6;1;0;7
4611;Markučiai;Boružėlių;8244065962;Ne;6;4;0;10
4612;Markučiai;Boružėlių;5902165968;Taip;10;0;0;10
4613;Markučiai;Boružėlių;4356736070;Taip;8;0;0;8
4614;Markučiai;Boružėlių;6055058096;Taip;10;0;1;11
4615;Markučiai;Boružėlių;5981692282;Taip;0;2;0;2
4616;Markučiai;Boružėlių;3739566642;Taip;12;0;1;13
4617;Markučiai;Boružėlių;6868394315;Taip;0;0;1;1
4618;Markučiai;Bitučių;1720541082;Ne;7;0;2;9
4619;Markučiai;Bitučių;8792524832;Taip;0;2;1;3
4620;Markučiai;Bitučių;1717624510;Taip;11;0;0;11
4621;Markučiai;Bitučių;9518247571;Taip;5;0;3;8
4622;Markučiai;Bitučių;4836298058;Taip;0;0;1;1
4623;Markučiai;Bitučių;9027071539;Taip;0;1;0;1
4624;Markučiai;Bitučių;8748794886;Taip;3;0;0;3
4625;Markučiai;Bitučių;7387460586;Taip;0;0;3;3
4626;Markučiai;Bitučių;8950442843;Taip;14;0;8;22
4627;Markučiai;Bitučių;2840564082;Ne;0;0;7;7
4628;Markučiai;Bitučių;3926993383;Taip;6;0;7;13
4629;Markučiai;Bitučių;6530101961;Taip;8;0;0;8
4630;Markučiai;Bitučių;1908302738;Taip;0;0;7;7
4631;Markučiai;Bitučių;7056367646;Taip;8;0;1;9
4632;Markučiai;Bitučių;2049497686;Taip;4;4;1;9
4633;Markučiai;Bitučių;9303448709;Taip;0;0;19;19
4634;Markučiai;Bitučių;8541042547;Taip;0;0;6;6
4635;Markučiai;Bitučių;1447116821;Taip;7;0;1;8
4636;Markučiai;Bitučių;6600535396;Taip;0;0;4;4
4637;Markučiai;Drugelių;2851424931;Taip;0;0;1;1
4638;Markučiai;Drugelių;1719927769;Taip;5;0;0;5
4639;Markučiai;Drugelių;63211076619;Taip;5;0;0;5
4640;Markučiai;Drugelių;2608111078;Ne;0;1;0;1
4641;Markučiai;Drugelių;9428254633;Taip;4;0;0;4
4642;Markučiai;Drugelių;61666612833;Taip;0;1;1;2
4643;Markučiai;Drugelių;20261053601;Taip;0;1;1;2
4644;Markučiai;Drugelių;4573605085;Ne;5;0;0;5
4645;Markučiai;Drugelių;19415636420;Taip;4;0;0;4
4646;Markučiai;Drugelių;24315961901;Taip;10;0;1;11
4647;Markučiai;Drugelių;45698891062;Taip;0;6;2;8
4648;Markučiai;Drugelių;22197471483;Taip;11;1;0;12
4649;Markučiai;Drugelių;9028932081;Taip;18;0;1;19
4650;Markučiai;Drugelių;11203825718;Taip;4;9;1;14
4651;Markučiai;Drugelių;7194049189;Taip;0;0;2;2
4652;Markučiai;Drugelių;1964223995;Taip;15;0;2;17
4653;Markučiai;Drugelių;23081602011;Ne;7;0;6;13
4654;Markučiai;Drugelių;9295954145;Ne;5;0;5;10
4655;Markučiai;Skruzdėliukų;1471334430;Taip;5;0;4;9
4656;Markučiai;Skruzdėliukų;9825799013;Ne;0;0;4;4
4657;Markučiai;Skruzdėliukų;8803226424;Taip;4;0;3;7
4658;Markučiai;Skruzdėliukų;20702694553;Taip;0;15;0;15
4659;Markučiai;Skruzdėliukų;55093673733;Taip;0;0;6;6
4660;Markučiai;Skruzdėliukų;39971140989;Taip;0;0;2;2
4661;Markučiai;Skruzdėliukų;54732351634;Taip;0;0;6;6
4662;Markučiai;Skruzdėliukų;1419433247;Taip;13;3;0;16
4663;Markučiai;Skruzdėliukų;1089500743;Taip;0;9;2;11
4664;Markučiai;Skruzdėliukų;2939795063;Taip;0;0;2;2
4665;Markučiai;Skruzdėliukų;9285037135;Taip;3;0;2;5
4666;Markučiai;Skruzdėliukų;1699369138;Taip;10;0;12;22
4667;Markučiai;Skruzdėliukų;1881218133;Taip;4;0;0;4
4668;Markučiai;Skruzdėliukų;8863238710;Ne;11;0;2;13
4669;Markučiai;Skruzdėliukų;92854605649;Ne;3;0;4;7
4670;Markučiai;Skruzdėliukų;1529531638;Taip;0;0;3;3
4671;Markučiai;Skruzdėliukų;4511936094;Taip;0;0;4;4
4672;Markučiai;ZUIKUČIŲ;2045207175;Taip;2;3;0;5
4673;Markučiai;ZUIKUČIŲ;7729045227;Taip;7;0;0;7
4674;Markučiai;ZUIKUČIŲ;1392582514;Taip;0;5;0;5
4675;Markučiai;ZUIKUČIŲ;6453095915;Taip;0;0;1;1
4676;Markučiai;ZUIKUČIŲ;6808291628;Ne;12;4;0;16
4677;Markučiai;ZUIKUČIŲ;5387571295;Taip;3;0;0;3
4678;Markučiai;ZUIKUČIŲ;3794643964;Taip;0;4;2;6
4679;Markučiai;ZUIKUČIŲ;91228262895;Taip;1;0;6;7
4680;Markučiai;ZUIKUČIŲ;7481923902;Taip;0;0;5;5
4681;Markučiai;ZUIKUČIŲ;1025406111;Taip;0;11;0;11
4682;Markučiai;ZUIKUČIŲ;5749873170;Taip;16;0;0;16
4683;Markučiai;ZUIKUČIŲ;7778551869;Ne;0;0;18;18
4684;Markučiai;ŽIOGELIŲ;5099997904;Ne;0;22;0;22
4685;Markučiai;ŽIOGELIŲ;3163226803;Taip;6;9;0;15
4686;Markučiai;ŽIOGELIŲ;1244026489;Taip;9;0;3;12
4687;Markučiai;ŽIOGELIŲ;1323922187;Taip;0;2;0;2
4688;Markučiai;ŽIOGELIŲ;54892037118;Taip;11;1;0;12
4689;Markučiai;ŽIOGELIŲ;1054802708;Taip;5;0;0;5
4690;Markučiai;ŽIOGELIŲ;1007919702;Taip;0;10;0;10
4691;Markučiai;ŽIOGELIŲ;1923521405;Taip;18;0;0;18
4692;Markučiai;ŽIOGELIŲ;1164386108;Taip;18;0;0;18
4693;Markučiai;ŽIOGELIŲ;7850311496;Taip;0;1;0;1
4694;Markučiai;ŽIOGELIŲ;2169583290;Taip;0;8;0;8
4695;Markučiai;ŽIOGELIŲ;3340385503;Taip;0;0;6;6
4696;Markučiai;ŽIOGELIŲ;4152184290;Taip;4;0;3;7
4697;Markučiai;ŽIOGELIŲ;23267867195;Taip;0;0;1;1
4698;Markučiai;Ežiukių;1827829954;Taip;8;4;0;12
4699;Markučiai;Ežiukių;4925856706;Taip;0;21;0;21
4700;Markučiai;Ežiukių;6570638672;Taip;6;2;0;8
4701;Markučiai;Ežiukių;1648283497;Taip;12;4;0;16
4702;Markučiai;Ežiukių;4186684938;Taip;10;0;0;10
4703;Markučiai;Ežiukių;5975331223;Taip;0;6;0;6
4704;Markučiai;Ežiukių;2687320408;Ne;7;0;0;7
4705;Markučiai;Ežiukių;1309122110;Ne;9;1;0;10
4706;Markučiai;Ežiukių;8990923872;Taip;0;0;1;1
4707;Markučiai;Ežiukių;2738553283;Taip;22;0;0;22
4708;Markučiai;Ežiukių;5246980173;Ne;6;0;0;6
4709;Markučiai;Ežiukių;1599633295;Ne;10;10;0;20
4710;Markučiai;Ežiukių;6308368050;Ne;9;0;1;10
4711;Markučiai;Ežiukių;4249158803;Taip;5;0;0;5
4712;Markučiai;Ežiukių;5958705106;Taip;18;0;0;18
4713;Markučiai;Ežiukių;1989923269;Taip;0;0;1;1
4714;Markučiai;Ežiukių;1769984489;Taip;0;0;1;1
4715;Markučiai;Ežiukių;7539605426;Taip;19;0;3;22
4716;Markučiai;Ežiukių;7791500322;Ne;1;1;0;2
4717;Mažylis;"2 DARŽELIO GR.";2979849055;Ne;3;0;3;6
4718;Mažylis;"2 DARŽELIO GR.";4503734408;Taip;17;0;0;17
4719;Mažylis;"2 DARŽELIO GR.";6162880220;Taip;6;0;2;8
4720;Mažylis;"2 DARŽELIO GR.";9362249595;Taip;12;0;1;13
4721;Mažylis;"2 DARŽELIO GR.";1077493584;Taip;0;3;1;4
4722;Mažylis;"2 DARŽELIO GR.";6854350717;Taip;0;0;4;4
4723;Mažylis;"2 DARŽELIO GR.";2704741847;Taip;14;0;0;14
4724;Mažylis;"2 DARŽELIO GR.";7185347381;Taip;0;0;1;1
4725;Mažylis;"2 DARŽELIO GR.";3327673298;Ne;0;0;1;1
4726;Mažylis;"2 DARŽELIO GR.";4280547746;Taip;3;0;7;10
4727;Mažylis;"2 DARŽELIO GR.";9447747294;Taip;0;0;6;6
4728;Mažylis;"2 DARŽELIO GR.";2126108232;Taip;0;0;8;8
4729;Mažylis;"2 DARŽELIO GR.";9382248260;Taip;17;0;1;18
4730;Mažylis;"2 DARŽELIO GR.";1762105763;Taip;0;0;6;6
4731;Mažylis;"2 DARŽELIO GR.";2672500259;Taip;0;0;7;7
4732;Mažylis;"2 DARŽELIO GR.";8135596731;Taip;3;8;0;11
4733;Mažylis;"2 DARŽELIO GR.";8866980930;Ne;9;1;1;11
4734;Mažylis;"2 DARŽELIO GR.";4542742002;Taip;0;0;9;9
4735;Mažylis;"4 PRIEŠMOKYKLINĖ GR.";38333694019;Taip;0;0;3;3
4736;Mažylis;"4 PRIEŠMOKYKLINĖ GR.";1217081615;Taip;0;0;8;8
4737;Mažylis;"4 PRIEŠMOKYKLINĖ GR.";67697608754;Taip;0;0;1;1
4738;Mažylis;"4 PRIEŠMOKYKLINĖ GR.";71414598607;Taip;0;0;4;4
4739;Mažylis;"4 PRIEŠMOKYKLINĖ GR.";2249845212;Ne;0;0;2;2
4740;Mažylis;"4 PRIEŠMOKYKLINĖ GR.";99612915803;Ne;6;0;10;16
4741;Mažylis;"4 PRIEŠMOKYKLINĖ GR.";88409362086;Taip;5;0;0;5
4742;Mažylis;"4 PRIEŠMOKYKLINĖ GR.";34677678888;Ne;0;10;0;10
4743;Mažylis;"4 PRIEŠMOKYKLINĖ GR.";44917962136;Taip;4;0;3;7
4744;Mažylis;"4 PRIEŠMOKYKLINĖ GR.";1023886258;Ne;0;0;10;10
4745;Mažylis;"4 PRIEŠMOKYKLINĖ GR.";1418120714;Taip;9;0;1;10
4746;Mažylis;"4 PRIEŠMOKYKLINĖ GR.";1381948803;Ne;0;0;6;6
4747;Mažylis;"4 PRIEŠMOKYKLINĖ GR.";33428832459;Taip;0;0;1;1
4748;Mažylis;"4 PRIEŠMOKYKLINĖ GR.";1355103006;Taip;0;6;0;6
4749;Mažylis;"4 PRIEŠMOKYKLINĖ GR.";5570166468;Taip;0;0;2;2
4750;Mažylis;"3 DARŽELIO GR.";98057700570;Taip;0;0;3;3
4751;Mažylis;"3 DARŽELIO GR.";1643460270;Taip;0;0;2;2
4752;Mažylis;"3 DARŽELIO GR.";24303144913;Taip;0;5;0;5
4753;Mažylis;"3 DARŽELIO GR.";69238700097;Taip;0;0;2;2
4754;Mažylis;"3 DARŽELIO GR.";50868656860;Taip;0;0;4;4
4755;Mažylis;"3 DARŽELIO GR.";81907805809;Taip;20;0;0;20
4756;Mažylis;"3 DARŽELIO GR.";1999937720;Taip;12;0;0;12
4757;Mažylis;"3 DARŽELIO GR.";90336289067;Ne;0;0;2;2
4758;Mažylis;"3 DARŽELIO GR.";1021183555;Taip;0;1;4;5
4759;Mažylis;"3 DARŽELIO GR.";1910064549;Taip;3;0;0;3
4760;Mažylis;"3 DARŽELIO GR.";2520667095;Taip;0;0;3;3
4761;Mažylis;"3 DARŽELIO GR.";2299288258;Taip;0;0;2;2
4762;Mažylis;"3 DARŽELIO GR.";5479496104;Taip;3;0;0;3
4763;Mažylis;"3 DARŽELIO GR.";1520251270;Taip;0;0;9;9
4764;Mažylis;"6 DARŽELIO GR.";9411559447;Taip;9;0;6;15
4765;Mažylis;"6 DARŽELIO GR.";79181926145;Taip;1;5;1;7
4766;Mažylis;"6 DARŽELIO GR.";45148418456;Taip;0;0;1;1
4767;Mažylis;"6 DARŽELIO GR.";8352202912;Taip;8;0;1;9
4768;Mažylis;"6 DARŽELIO GR.";38277640135;Taip;11;0;0;11
4769;Mažylis;"6 DARŽELIO GR.";1663347167;Ne;16;0;0;16
4770;Mažylis;"6 DARŽELIO GR.";5063094678;Ne;8;0;0;8
4771;Mažylis;"6 DARŽELIO GR.";6920129837;Ne;0;0;1;1
4772;Mažylis;"6 DARŽELIO GR.";1460572347;Taip;0;8;0;8
4773;Mažylis;"6 DARŽELIO GR.";3860760654;Taip;0;0;2;2
4774;Mažylis;"6 DARŽELIO GR.";6851169340;Taip;5;0;1;6
4775;Mažylis;"6 DARŽELIO GR.";4486742281;Taip;0;0;11;11
4776;Mažylis;"6 DARŽELIO GR.";4252408251;Ne;0;0;9;9
4777;Mažylis;"6 DARŽELIO GR.";7416381505;Ne;12;0;1;13
4778;Mažylis;"6 DARŽELIO GR.";1514640197;Ne;0;0;17;17
4779;Mažylis;"6 DARŽELIO GR.";1002832487;Taip;0;0;5;5
4780;Mažylis;"6 DARŽELIO GR.";9608529135;Taip;0;0;3;3
4781;Mažylis;"6 DARŽELIO GR.";4645411379;Taip;0;0;2;2
4782;Mažylis;"1 NAUJA (LOPŠELIS)";6100650710;Taip;0;0;1;1
4783;Mažylis;"1 NAUJA (LOPŠELIS)";2006289999;Taip;9;0;0;9
4784;Mažylis;"1 NAUJA (LOPŠELIS)";5685988186;Ne;0;0;9;9
4785;Mažylis;"1 NAUJA (LOPŠELIS)";7754956214;Taip;0;0;1;1
4786;Mažylis;"1 NAUJA (LOPŠELIS)";8589124394;Taip;22;0;0;22
4787;Mažylis;"1 NAUJA (LOPŠELIS)";8639480781;Taip;0;0;2;2
4788;Mažylis;"1 NAUJA (LOPŠELIS)";2672864291;Taip;0;0;1;1
4789;Mažylis;"1 NAUJA (LOPŠELIS)";9401388775;Taip;0;0;13;13
4790;Mažylis;"1 NAUJA (LOPŠELIS)";6009637985;Ne;0;0;1;1
4791;Mažylis;"1 NAUJA (LOPŠELIS)";3400122626;Taip;0;0;1;1
4792;Mažylis;"1 NAUJA (LOPŠELIS)";6809320247;Taip;0;0;6;6
4793;Mažylis;"1 NAUJA (LOPŠELIS)";7052112957;Taip;0;0;1;1
4794;Mažylis;"1 NAUJA (LOPŠELIS)";9341935211;Taip;0;0;7;7
4795;Mažylis;"1 NAUJA (LOPŠELIS)";4817146074;Taip;0;0;4;4
4796;Mažylis;"1 NAUJA (LOPŠELIS)";1420913875;Taip;9;0;3;12
4797;Mažylis;"5 PRIEŠMOKYKLINĖ GR. ";3436690709;Taip;7;0;6;13
4798;Mažylis;"5 PRIEŠMOKYKLINĖ GR. ";9958976870;Taip;8;0;0;8
4799;Mažylis;"5 PRIEŠMOKYKLINĖ GR. ";9095049088;Taip;4;0;0;4
4800;Mažylis;"5 PRIEŠMOKYKLINĖ GR. ";76814348181;Taip;0;3;0;3
4801;Mažylis;"5 PRIEŠMOKYKLINĖ GR. ";91436869919;Taip;9;0;2;11
4802;Mažylis;"5 PRIEŠMOKYKLINĖ GR. ";1391395429;Taip;0;0;3;3
4803;Mažylis;"5 PRIEŠMOKYKLINĖ GR. ";8318476578;Taip;5;7;1;13
4804;Mažylis;"5 PRIEŠMOKYKLINĖ GR. ";8439933210;Ne;2;0;2;4
4805;Mažylis;"5 PRIEŠMOKYKLINĖ GR. ";56438009944;Ne;0;8;1;9
4806;Mažylis;"5 PRIEŠMOKYKLINĖ GR. ";18640177395;Taip;0;0;2;2
4807;Mažylis;"5 PRIEŠMOKYKLINĖ GR. ";8490035231;Taip;0;10;0;10
4808;Mažylis;"5 PRIEŠMOKYKLINĖ GR. ";37676161966;Ne;0;2;0;2
4809;Mažylis;"5 PRIEŠMOKYKLINĖ GR. ";11471986928;Taip;0;0;2;2
4810;Mažylis;"5 PRIEŠMOKYKLINĖ GR. ";7774469604;Taip;0;0;4;4
4811;Mažylis;"5 PRIEŠMOKYKLINĖ GR. ";87637767247;Taip;0;0;2;2
4812;Mažylis;"5 PRIEŠMOKYKLINĖ GR. ";1692808423;Ne;0;0;10;10
4813;Mažylis;"5 PRIEŠMOKYKLINĖ GR. ";37179412928;Taip;1;0;0;1
4814;Medynėlis;BITUTĖS;1721728772;Taip;6;0;0;6
4815;Medynėlis;BITUTĖS;46570048371;Taip;0;1;1;2
4816;Medynėlis;BITUTĖS;57858019710;Ne;0;0;6;6
4817;Medynėlis;BITUTĖS;13947002802;Taip;0;0;3;3
4818;Medynėlis;BITUTĖS;38838111813;Taip;0;2;0;2
4819;Medynėlis;BITUTĖS;72334464245;Ne;0;2;0;2
4820;Medynėlis;BITUTĖS;44971270687;Taip;7;0;1;8
4821;Medynėlis;BITUTĖS;39476010274;Taip;3;1;0;4
4822;Medynėlis;BITUTĖS;43383127907;Ne;0;0;1;1
4823;Medynėlis;BITUTĖS;2055140361;Ne;0;1;0;1
4824;Medynėlis;BITUTĖS;1663988144;Taip;0;2;0;2
4825;Medynėlis;BITUTĖS;65852278020;Taip;0;1;0;1
4826;Medynėlis;BITUTĖS;34879998108;Taip;0;1;0;1
4827;Medynėlis;DRUGELIAI;29673282359;Taip;0;1;0;1
4828;Medynėlis;DRUGELIAI;56207399170;Taip;2;0;0;2
4829;Medynėlis;DRUGELIAI;77267420461;Taip;3;0;0;3
4830;Medynėlis;DRUGELIAI;64020246327;Taip;0;1;0;1
4831;Medynėlis;DRUGELIAI;82368415455;Taip;0;1;0;1
4832;Medynėlis;DRUGELIAI;22422832248;Taip;4;0;0;4
4833;Medynėlis;DRUGELIAI;69233446672;Taip;0;1;0;1
4834;Medynėlis;DRUGELIAI;1673034349;Ne;0;1;0;1
4835;Medynėlis;DRUGELIAI;22845549109;Taip;0;1;0;1
4836;Medynėlis;DRUGELIAI;20592655649;Taip;0;1;0;1
4837;Medynėlis;DRUGELIAI;64603154583;Taip;16;1;0;17
4838;Medynėlis;DRUGELIAI;27434992072;Ne;0;1;0;1
4839;Medynėlis;DRUGELIAI;68940537831;Taip;0;8;0;8
4840;Medynėlis;DRUGELIAI;75083011184;Taip;5;8;0;13
4841;Medynėlis;DRUGELIAI;76282032727;Taip;0;1;0;1
4842;Medynėlis;DRUGELIAI;97943522374;Taip;5;1;0;6
4843;Medynėlis;DRUGELIAI;1864572888;Taip;5;0;0;5
4844;Medynėlis;DRUGELIAI;1828684971;Taip;9;0;0;9
4845;Medynėlis;DRUGELIAI;30399789674;Taip;4;5;0;9
4846;Medynėlis;SKRUZDĖLIUKAI;4024866819;Taip;0;9;0;9
4847;Medynėlis;SKRUZDĖLIUKAI;5186367833;Taip;0;4;0;4
4848;Medynėlis;SKRUZDĖLIUKAI;2418225089;Taip;6;0;0;6
4849;Medynėlis;SKRUZDĖLIUKAI;9413309043;Taip;0;0;4;4
4850;Medynėlis;SKRUZDĖLIUKAI;4581683292;Taip;4;4;0;8
4851;Medynėlis;SKRUZDĖLIUKAI;9009316740;Taip;0;9;0;9
4852;Medynėlis;SKRUZDĖLIUKAI;1795479738;Taip;0;18;0;18
4853;Medynėlis;SKRUZDĖLIUKAI;5530782065;Taip;0;0;1;1
4854;Medynėlis;SKRUZDĖLIUKAI;5269927048;Taip;4;0;5;9
4855;Medynėlis;SKRUZDĖLIUKAI;2427349194;Taip;2;0;0;2
4856;Medynėlis;SKRUZDĖLIUKAI;7633674694;Taip;0;5;0;5
4857;Medynėlis;SKRUZDĖLIUKAI;7244497661;Ne;4;0;1;5
4858;Medynėlis;SKRUZDĖLIUKAI;5995034919;Ne;9;0;2;11
4859;Medynėlis;SKRUZDĖLIUKAI;8775219704;Taip;0;8;0;8
4860;Medynėlis;SKRUZDĖLIUKAI;1658457155;Taip;3;0;2;5
4861;Medynėlis;SKRUZDĖLIUKAI;33981260502;Taip;4;0;7;11
4862;Medynėlis;SKRUZDĖLIUKAI;3773215372;Taip;6;1;0;7
4863;Medynėlis;SKRUZDĖLIUKAI;6343851636;Ne;9;0;2;11
4864;Medynėlis;VOVERIUKAI;2834559432;Taip;0;0;1;1
4865;Medynėlis;VOVERIUKAI;2310200034;Ne;7;0;0;7
4866;Medynėlis;VOVERIUKAI;90556319090;Taip;0;1;0;1
4867;Medynėlis;VOVERIUKAI;6999562417;Taip;22;0;0;22
4868;Medynėlis;VOVERIUKAI;5586407412;Taip;0;0;7;7
4869;Medynėlis;VOVERIUKAI;7108619017;Taip;0;6;0;6
4870;Medynėlis;VOVERIUKAI;8441104709;Taip;0;4;1;5
4871;Medynėlis;VOVERIUKAI;1820113382;Taip;0;5;0;5
4872;Medynėlis;VOVERIUKAI;9304002459;Taip;2;0;11;13
4873;Medynėlis;VOVERIUKAI;5982453884;Ne;4;0;1;5
4874;Medynėlis;VOVERIUKAI;1173510831;Taip;0;5;0;5
4875;Medynėlis;VOVERIUKAI;6406459222;Taip;5;6;0;11
4876;Medynėlis;VOVERIUKAI;4985243068;Taip;8;0;2;10
4877;Medynėlis;VOVERIUKAI;9073514151;Taip;11;6;0;17
4878;Medynėlis;VOVERIUKAI;4238860287;Ne;7;0;0;7
4879;Medynėlis;VOVERIUKAI;1750775033;Taip;8;3;0;11
4880;Medynėlis;VOVERIUKAI;9800678364;Taip;7;0;7;14
4881;Medynėlis;VOVERIUKAI;1237589979;Taip;5;0;1;6
4882;Medynėlis;MEŠKIUKAI;1434648803;Taip;0;0;4;4
4883;Medynėlis;MEŠKIUKAI;1975763240;Taip;2;0;4;6
4884;Medynėlis;MEŠKIUKAI;5347745655;Taip;2;5;0;7
4885;Medynėlis;MEŠKIUKAI;1781906016;Taip;10;1;0;11
4886;Medynėlis;MEŠKIUKAI;91658912153;Taip;0;3;0;3
4887;Medynėlis;MEŠKIUKAI;1269734734;Taip;0;5;0;5
4888;Medynėlis;MEŠKIUKAI;46445461622;Taip;0;7;0;7
4889;Medynėlis;MEŠKIUKAI;7226012217;Taip;9;0;1;10
4890;Medynėlis;MEŠKIUKAI;5007624930;Taip;5;4;0;9
4891;Medynėlis;MEŠKIUKAI;8629622922;Taip;0;10;1;11
4892;Medynėlis;MEŠKIUKAI;1479759021;Taip;12;0;0;12
4893;Medynėlis;MEŠKIUKAI;2389345601;Taip;3;0;0;3
4894;Medynėlis;MEŠKIUKAI;1635649525;Taip;2;3;0;5
4895;Medynėlis;MEŠKIUKAI;6479758789;Taip;4;0;3;7
4896;Medynėlis;MEŠKIUKAI;12287981032;Taip;12;0;0;12
4897;Medynėlis;MEŠKIUKAI;2326848026;Taip;0;8;0;8
4898;Medynėlis;MEŠKIUKAI;5924711043;Taip;9;0;2;11
4899;Medynėlis;MEŠKIUKAI;8143370943;Taip;0;0;5;5
4900;Medynėlis;MEŠKIUKAI;32683798983;Taip;0;0;1;1
4901;Medynėlis;MEŠKIUKAI;99799126572;Taip;0;8;0;8
4902;Medynėlis;PELĖDŽIUKAI;1829338208;Taip;8;5;0;13
4903;Medynėlis;PELĖDŽIUKAI;88240380945;Ne;8;0;1;9
4904;Medynėlis;PELĖDŽIUKAI;1129265551;Taip;12;0;0;12
4905;Medynėlis;PELĖDŽIUKAI;76668029492;Taip;5;0;0;5
4906;Medynėlis;PELĖDŽIUKAI;1080058205;Taip;4;2;0;6
4907;Medynėlis;PELĖDŽIUKAI;1968892466;Taip;11;1;0;12
4908;Medynėlis;PELĖDŽIUKAI;1194247621;Taip;0;12;0;12
4909;Medynėlis;PELĖDŽIUKAI;37435525923;Taip;5;0;0;5
4910;Medynėlis;PELĖDŽIUKAI;1415208530;Taip;15;0;0;15
4911;Medynėlis;PELĖDŽIUKAI;7804751416;Taip;12;4;0;16
4912;Medynėlis;PELĖDŽIUKAI;6182500688;Taip;5;0;6;11
4913;Medynėlis;PELĖDŽIUKAI;2831484614;Taip;10;0;2;12
4914;Medynėlis;PELĖDŽIUKAI;8122944228;Ne;5;0;4;9
4915;Medynėlis;PELĖDŽIUKAI;1937403950;Ne;0;0;1;1
4916;Medynėlis;PELĖDŽIUKAI;5636967783;Taip;0;0;10;10
4917;Medynėlis;PELĖDŽIUKAI;12150004702;Taip;12;0;0;12
4918;Medynėlis;BORUŽIUKAI;1657676226;Taip;0;1;0;1
4919;Medynėlis;BORUŽIUKAI;1314163134;Taip;3;0;0;3
4920;Medynėlis;BORUŽIUKAI;1010025777;Taip;5;2;1;8
4921;Medynėlis;BORUŽIUKAI;96544597673;Taip;7;2;0;9
4922;Medynėlis;BORUŽIUKAI;79786316561;Taip;0;2;5;7
4923;Medynėlis;BORUŽIUKAI;88550635466;Ne;0;2;0;2
4924;Medynėlis;BORUŽIUKAI;1936328805;Taip;0;2;1;3
4925;Medynėlis;BORUŽIUKAI;1693185124;Taip;0;4;0;4
4926;Medynėlis;BORUŽIUKAI;1563329598;Taip;0;9;0;9
4927;Medynėlis;BORUŽIUKAI;1611512841;Taip;0;3;0;3
4928;Medynėlis;BORUŽIUKAI;55848491611;Taip;4;0;1;5
4929;Medynėlis;BORUŽIUKAI;1192592678;Taip;15;0;0;15
4930;Medynėlis;BORUŽIUKAI;7628899696;Taip;0;2;0;2
4931;Medynėlis;BORUŽIUKAI;6374790540;Taip;0;0;1;1
4932;Medynėlis;EŽIUKAI;3398294520;Ne;0;10;0;10
4933;Medynėlis;EŽIUKAI;2026582294;Taip;0;6;0;6
4934;Medynėlis;EŽIUKAI;1437000615;Taip;0;11;0;11
4935;Medynėlis;EŽIUKAI;31443674861;Taip;11;0;0;11
4936;Medynėlis;EŽIUKAI;3165639252;Taip;10;0;0;10
4937;Medynėlis;EŽIUKAI;1882919126;Taip;0;6;0;6
4938;Medynėlis;EŽIUKAI;1472082682;Ne;0;7;0;7
4939;Medynėlis;EŽIUKAI;50558260808;Taip;2;0;0;2
4940;Medynėlis;EŽIUKAI;61158254770;Taip;0;7;0;7
4941;Medynėlis;EŽIUKAI;1216195798;Ne;0;11;0;11
4942;Medynėlis;EŽIUKAI;3225662051;Taip;0;2;0;2
4943;Medynėlis;EŽIUKAI;1915791061;Taip;0;0;1;1
4944;Medynėlis;EŽIUKAI;1036752305;Taip;0;8;0;8
4945;Medynėlis;ZUIKUČIAI;6706028300;Taip;4;0;0;4
4946;Medynėlis;ZUIKUČIAI;2103255454;Taip;0;0;7;7
4947;Medynėlis;ZUIKUČIAI;9520409342;Taip;13;0;0;13
4948;Medynėlis;ZUIKUČIAI;9438854582;Taip;0;0;1;1
4949;Medynėlis;ZUIKUČIAI;9079900803;Taip;0;0;3;3
4950;Medynėlis;ZUIKUČIAI;3856908872;Ne;0;0;6;6
4951;Medynėlis;ZUIKUČIAI;8074251036;Taip;17;0;1;18
4952;Medynėlis;ZUIKUČIAI;2932544910;Taip;0;0;2;2
4953;Medynėlis;ZUIKUČIAI;6955467123;Taip;13;0;0;13
4954;Medynėlis;ZUIKUČIAI;5785463517;Taip;4;0;0;4
4955;Medynėlis;ZUIKUČIAI;9184868565;Ne;9;0;0;9
4956;Medynėlis;ZUIKUČIAI;1621499650;Taip;15;0;0;15
4957;Medynėlis;ZUIKUČIAI;4222917765;Taip;17;0;0;17
4958;Medynėlis;ZUIKUČIAI;5571641847;Taip;5;0;0;5
4959;Medynėlis;ZUIKUČIAI;6681155625;Taip;4;5;0;9
4960;Medynėlis;ZUIKUČIAI;6073797962;Taip;10;7;0;17
4961;Medynėlis;ZUIKUČIAI;1901805808;Taip;18;0;0;18
4962;Medynėlis;ZUIKUČIAI;5784691118;Taip;18;0;0;18
4963;Medynėlis;KAČIUKAI;7740591575;Taip;11;0;0;11
4964;Medynėlis;KAČIUKAI;3761845905;Taip;2;1;6;9
4965;Medynėlis;KAČIUKAI;1475701065;Taip;5;4;0;9
4966;Medynėlis;KAČIUKAI;7638618099;Ne;0;0;3;3
4967;Medynėlis;KAČIUKAI;2627655353;Ne;8;0;4;12
4968;Medynėlis;KAČIUKAI;4100792567;Taip;0;0;2;2
4969;Medynėlis;KAČIUKAI;2086963376;Taip;6;0;0;6
4970;Medynėlis;KAČIUKAI;1056744101;Taip;8;0;7;15
4971;Medynėlis;KAČIUKAI;7455041214;Taip;9;0;1;10
4972;Medynėlis;KAČIUKAI;3554823424;Ne;8;0;0;8
4973;Medynėlis;KAČIUKAI;7272017225;Ne;0;6;0;6
4974;Medynėlis;KAČIUKAI;4092824377;Taip;4;8;0;12
4975;Medynėlis;KAČIUKAI;6826790492;Ne;19;0;0;19
4976;Medynėlis;KAČIUKAI;4488439037;Ne;14;0;1;15
4977;Medynėlis;KAČIUKAI;6485314750;Ne;0;0;1;1
4978;Medynėlis;KAČIUKAI;6101613567;Ne;0;0;3;3
4979;Medynėlis;KAČIUKAI;2234994999;Taip;3;4;0;7
4980;Medynėlis;PELIUKAI;9314893329;Taip;4;2;0;6
4981;Medynėlis;PELIUKAI;9764215406;Taip;16;0;0;16
4982;Medynėlis;PELIUKAI;3787172254;Taip;9;0;5;14
4983;Medynėlis;PELIUKAI;5051773825;Taip;14;0;0;14
4984;Medynėlis;PELIUKAI;1525185037;Ne;0;0;5;5
4985;Medynėlis;PELIUKAI;1344240019;Taip;7;0;2;9
4986;Medynėlis;PELIUKAI;6218943275;Taip;0;5;2;7
4987;Medynėlis;PELIUKAI;1406029765;Taip;10;0;4;14
4988;Medynėlis;PELIUKAI;1162859552;Taip;0;11;0;11
4989;Medynėlis;PELIUKAI;6032067904;Ne;6;1;0;7
4990;Medynėlis;PELIUKAI;7232396755;Taip;8;4;0;12
4991;Medynėlis;PELIUKAI;9919108302;Taip;17;1;0;18
4992;Medynėlis;PELIUKAI;1463263793;Taip;6;8;0;14
4993;Medynėlis;PELIUKAI;1333848517;Taip;0;0;7;7
4994;Medynėlis;PELIUKAI;3270413614;Taip;13;0;0;13
4995;Medynėlis;PELIUKAI;5532880670;Taip;10;0;4;14
4996;Medynėlis;PELIUKAI;7651663404;Taip;10;0;0;10
4997;Medynėlis;PELIUKAI;5446430319;Taip;0;0;11;11
4998;Medynėlis;PELIUKAI;8271170887;Ne;7;0;2;9
4999;Medynėlis;PELIUKAI;4315717555;Taip;13;0;2;15
5000;Molinukas;NYKŠTUKAI;6353165459;Taip;0;1;0;1
5001;Molinukas;NYKŠTUKAI;5876669121;Taip;2;0;0;2
5002;Molinukas;NYKŠTUKAI;6087698882;Taip;7;0;0;7
5003;Molinukas;NYKŠTUKAI;2211909678;Taip;0;2;0;2
5004;Molinukas;NYKŠTUKAI;2348120316;Taip;8;4;3;15
5005;Molinukas;NYKŠTUKAI;8053608348;Taip;8;0;0;8
5006;Molinukas;NYKŠTUKAI;6014990150;Ne;4;0;5;9
5007;Molinukas;NYKŠTUKAI;7623051674;Taip;0;1;0;1
5008;Molinukas;NYKŠTUKAI;9448910819;Taip;8;1;0;9
5009;Molinukas;NYKŠTUKAI;5580968328;Ne;5;5;2;12
5010;Molinukas;NYKŠTUKAI;8536615996;Ne;3;0;0;3
5011;Molinukas;NYKŠTUKAI;7602239077;Taip;10;3;0;13
5012;Molinukas;NYKŠTUKAI;4171978721;Ne;10;0;0;10
5013;Molinukas;NYKŠTUKAI;7134802574;Taip;0;0;3;3
5014;Molinukas;NYKŠTUKAI;8260101075;Taip;0;0;3;3
5015;Molinukas;NYKŠTUKAI;9293819449;Taip;0;10;0;10
5016;Molinukas;NYKŠTUKAI;5525772579;Taip;1;10;0;11
5017;Molinukas;ZUIKUČIŲ;5387818175;Ne;0;2;0;2
5018;Molinukas;ZUIKUČIŲ;6326031969;Taip;11;2;1;14
5019;Molinukas;ZUIKUČIŲ;7398075402;Taip;0;0;2;2
5020;Molinukas;ZUIKUČIŲ;7377137582;Taip;0;0;5;5
5021;Molinukas;ZUIKUČIŲ;4534279257;Ne;0;1;0;1
5022;Molinukas;ZUIKUČIŲ;8688180482;Ne;17;0;0;17
5023;Molinukas;ZUIKUČIŲ;2324578741;Taip;3;0;9;12
5024;Molinukas;ZUIKUČIŲ;4918181437;Taip;0;0;6;6
5025;Molinukas;ZUIKUČIŲ;8604288346;Ne;14;0;0;14
5026;Molinukas;ZUIKUČIŲ;1856269656;Taip;15;0;0;15
5027;Molinukas;ZUIKUČIŲ;6636118069;Taip;13;1;0;14
5028;Molinukas;ZUIKUČIŲ;2774371800;Ne;8;13;0;21
5029;Molinukas;ZUIKUČIŲ;8913137310;Ne;0;2;1;3
5030;Molinukas;ZUIKUČIŲ;8416644024;Ne;0;0;7;7
5031;Molinukas;SRAIGIUKŲ;24664585525;Taip;0;1;0;1
5032;Molinukas;SRAIGIUKŲ;96140904528;Taip;14;4;0;18
5033;Molinukas;SRAIGIUKŲ;25402100091;Taip;0;0;10;10
5034;Molinukas;SRAIGIUKŲ;62719013867;Taip;5;0;1;6
5035;Molinukas;SRAIGIUKŲ;96366441416;Ne;0;11;0;11
5036;Molinukas;SRAIGIUKŲ;41890709428;Taip;6;0;3;9
5037;Molinukas;SRAIGIUKŲ;94725766823;Taip;0;1;0;1
5038;Molinukas;SRAIGIUKŲ;48613608109;Taip;2;0;0;2
5039;Molinukas;SRAIGIUKŲ;70883949824;Taip;0;0;1;1
5040;Molinukas;SRAIGIUKŲ;46887752521;Taip;0;0;11;11
5041;Molinukas;SRAIGIUKŲ;25562159395;Taip;0;4;0;4
5042;Molinukas;SRAIGIUKŲ;81952213381;Taip;0;0;1;1
5043;Molinukas;SRAIGIUKŲ;51421193001;Taip;9;1;0;10
5044;Molinukas;SRAIGIUKŲ;78355703743;Ne;0;0;1;1
5045;Molinukas;SRAIGIUKŲ;74040038141;Taip;0;0;2;2
5046;Molinukas;SRAIGIUKŲ;21462500359;Ne;2;0;1;3
5047;Molinukas;SRAIGIUKŲ;10647191823;Taip;0;0;2;2
5048;Molinukas;SRAIGIUKŲ;73542178867;Ne;0;7;0;7
5049;Molinukas;SRAIGIUKŲ;11787953136;Taip;5;10;0;15
5050;Molinukas;SRAIGIUKŲ;81983716075;Taip;3;12;0;15
5051;Molinukas;SRAIGIUKŲ;2048642721;Taip;7;3;0;10
5052;Molinukas;SRAIGIUKŲ;2041132581;Taip;0;0;1;1
5053;Molinukas;VOVERIUKAI;49733379099;Taip;0;2;0;2
5054;Molinukas;VOVERIUKAI;7991320348;Taip;0;3;0;3
5055;Molinukas;VOVERIUKAI;1293862946;Taip;0;0;1;1
5056;Molinukas;VOVERIUKAI;1816951665;Taip;4;0;0;4
5057;Molinukas;VOVERIUKAI;8674220663;Taip;3;0;1;4
5058;Molinukas;VOVERIUKAI;1151672597;Taip;5;1;1;7
5059;Molinukas;VOVERIUKAI;13856993048;Taip;5;0;0;5
5060;Molinukas;VOVERIUKAI;41153045448;Taip;0;0;2;2
5061;Molinukas;VOVERIUKAI;43651915331;Taip;0;0;20;20
5062;Molinukas;VOVERIUKAI;12208955611;Taip;0;3;0;3
5063;Molinukas;VOVERIUKAI;44399175317;Taip;0;0;2;2
5064;Molinukas;VOVERIUKAI;10482714545;Taip;0;4;0;4
5065;Molinukas;VOVERIUKAI;1880434477;Taip;0;0;5;5
5066;Molinukas;VOVERIUKAI;45801826827;Taip;9;0;1;10
5067;Molinukas;VOVERIUKAI;93528667925;Taip;5;0;0;5
5068;Molinukas;VOVERIUKAI;7987658567;Ne;0;2;2;4
5069;Molinukas;ŽVIRBLIUKŲ;3207373459;Taip;5;0;3;8
5070;Molinukas;ŽVIRBLIUKŲ;8247270556;Taip;0;1;0;1
5071;Molinukas;ŽVIRBLIUKŲ;9318837973;Taip;4;0;3;7
5072;Molinukas;ŽVIRBLIUKŲ;7378643086;Taip;4;0;1;5
5073;Molinukas;ŽVIRBLIUKŲ;2779700726;Taip;0;5;0;5
5074;Molinukas;ŽVIRBLIUKŲ;1865748733;Ne;4;0;3;7
5075;Molinukas;ŽVIRBLIUKŲ;3030169626;Taip;5;0;0;5
5076;Molinukas;ŽVIRBLIUKŲ;6832647220;Taip;9;0;1;10
5077;Molinukas;ŽVIRBLIUKŲ;4950808381;Taip;0;10;0;10
5078;Molinukas;ŽVIRBLIUKŲ;8865966572;Taip;6;0;1;7
5079;Molinukas;ŽVIRBLIUKŲ;6795839380;Taip;3;0;2;5
5080;Molinukas;ŽVIRBLIUKŲ;5597119459;Taip;0;5;4;9
5081;Molinukas;ŽVIRBLIUKŲ;4209143136;Taip;6;4;0;10
5082;Molinukas;ŽVIRBLIUKŲ;5648861702;Taip;6;4;0;10
5083;Molinukas;KAČIUKŲ;5685582215;Taip;2;6;3;11
5084;Molinukas;KAČIUKŲ;8541456847;Taip;0;6;0;6
5085;Molinukas;KAČIUKŲ;2356814145;Taip;4;0;0;4
5086;Molinukas;KAČIUKŲ;4000190261;Taip;5;0;0;5
5087;Molinukas;KAČIUKŲ;9667704959;Taip;17;0;2;19
5088;Molinukas;KAČIUKŲ;7446607510;Taip;14;0;0;14
5089;Molinukas;KAČIUKŲ;3469196411;Taip;7;0;0;7
5090;Molinukas;KAČIUKŲ;2286586693;Taip;4;0;0;4
5091;Molinukas;KAČIUKŲ;6898958282;Taip;4;8;0;12
5092;Naminukas;Drugeliai;6776805494;Taip;0;7;0;7
5093;Naminukas;Drugeliai;2395070574;Taip;0;3;1;4
5094;Naminukas;Drugeliai;5801695390;Taip;0;1;2;3
5095;Naminukas;Drugeliai;5534073614;Taip;1;8;7;16
5096;Naminukas;Drugeliai;7347998152;Taip;4;4;0;8
5097;Naminukas;Drugeliai;2606742144;Taip;0;1;4;5
5098;Naminukas;Drugeliai;9689866363;Taip;4;0;1;5
5099;Naminukas;Drugeliai;2132345627;Ne;0;5;0;5
5100;Naminukas;Drugeliai;3320805432;Taip;4;9;0;13
5101;Naminukas;Drugeliai;1302119260;Taip;0;2;14;16
5102;Naminukas;Drugeliai;2864905392;Taip;4;5;0;9
5103;Naminukas;Drugeliai;7406775925;Taip;8;0;0;8
5104;Naminukas;Drugeliai;1333462200;Taip;0;0;4;4
5105;Naminukas;Drugeliai;5468218968;Taip;3;0;0;3
5106;Naminukas;Drugeliai;5713661641;Ne;10;0;0;10
5107;Naminukas;Bitutės;4419568254;Taip;4;5;0;9
5108;Naminukas;Bitutės;1956749138;Taip;0;7;0;7
5109;Naminukas;Bitutės;6503569633;Taip;0;17;3;20
5110;Naminukas;Bitutės;3192885665;Taip;6;0;2;8
5111;Naminukas;Bitutės;9530232649;Taip;0;5;0;5
5112;Naminukas;Bitutės;8131328042;Ne;0;12;0;12
5113;Naminukas;Bitutės;2769848640;Ne;0;0;4;4
5114;Naminukas;Bitutės;7176287699;Taip;0;5;3;8
5115;Naminukas;Bitutės;7888950723;Taip;0;0;7;7
5116;Naminukas;Bitutės;1710002948;Taip;6;1;0;7
5117;Naminukas;Bitutės;3994190066;Taip;0;5;0;5
5118;Naminukas;Bitutės;9600303816;Taip;5;6;0;11
5119;Naminukas;Bitutės;5244682030;Taip;5;6;0;11
5120;Naminukas;Bitutės;5195078101;Taip;0;1;0;1
5121;Naminukas;Bitutės;9501202207;Taip;0;7;0;7
5122;Naminukas;Bitutės;2424412518;Taip;10;5;3;18
5123;Naminukas;Bitutės;5493709688;Ne;9;8;0;17
5124;Naminukas;Paukšteliai;37525846039;Taip;0;0;1;1
5125;Naminukas;Paukšteliai;2126182508;Taip;0;10;0;10
5126;Naminukas;Paukšteliai;3603079488;Ne;0;0;2;2
5127;Naminukas;Paukšteliai;1870907311;Taip;3;0;3;6
5128;Naminukas;Paukšteliai;69952843049;Taip;0;4;0;4
5129;Naminukas;Paukšteliai;39747242234;Taip;4;0;0;4
5130;Naminukas;Paukšteliai;1946057668;Ne;14;0;1;15
5131;Naminukas;Paukšteliai;93648945843;Taip;9;0;0;9
5132;Naminukas;Paukšteliai;34168788672;Taip;4;0;0;4
5133;Naminukas;Paukšteliai;2100371376;Taip;0;0;3;3
5134;Naminukas;Paukšteliai;1439033627;Ne;0;0;2;2
5135;Naminukas;Paukšteliai;70836957729;Taip;7;1;0;8
5136;Naminukas;Paukšteliai;3595932330;Taip;21;0;0;21
5137;Naminukas;Paukšteliai;20358771509;Taip;0;5;0;5
5138;Naminukas;"NYKŠTUKAI ";1509433995;Ne;0;7;0;7
5139;Naminukas;"NYKŠTUKAI ";59020433000;Taip;5;1;0;6
5140;Naminukas;"NYKŠTUKAI ";46665774314;Taip;0;7;0;7
5141;Naminukas;"NYKŠTUKAI ";1490712871;Taip;0;0;2;2
5142;Naminukas;"NYKŠTUKAI ";1499464511;Ne;0;5;4;9
5143;Naminukas;"NYKŠTUKAI ";3826149605;Ne;0;4;0;4
5144;Naminukas;"NYKŠTUKAI ";6501046678;Ne;0;0;1;1
5145;Naminukas;"NYKŠTUKAI ";6029194403;Taip;0;10;0;10
5146;Naminukas;"NYKŠTUKAI ";70281612245;Taip;7;0;4;11
5147;Naminukas;"NYKŠTUKAI ";74291965804;Taip;0;0;9;9
5148;Naminukas;"NYKŠTUKAI ";90045007984;Taip;2;4;0;6
5149;Naminukas;"NYKŠTUKAI ";7365310490;Taip;0;13;0;13
5150;Nykštukas;SMAGURIAI;8120626738;Taip;0;1;0;1
5151;Nykštukas;SMAGURIAI;9842748132;Taip;10;7;1;18
5152;Nykštukas;SMAGURIAI;4830484167;Taip;10;1;0;11
5153;Nykštukas;SMAGURIAI;1902253981;Taip;13;0;0;13
5154;Nykštukas;SMAGURIAI;9713859038;Taip;5;1;0;6
5155;Nykštukas;SMAGURIAI;7954996421;Taip;6;2;0;8
5156;Nykštukas;SMAGURIAI;4771072061;Taip;22;0;0;22
5157;Nykštukas;SMAGURIAI;6139988523;Taip;12;0;0;12
5158;Nykštukas;SMAGURIAI;5190754451;Taip;5;0;0;5
5159;Nykštukas;SMAGURIAI;8310484267;Taip;5;1;1;7
5160;Nykštukas;SMAGURIAI;1707956308;Ne;2;9;0;11
5161;Nykštukas;SMAGURIAI;8635571067;Taip;8;9;0;17
5162;Nykštukas;SMAGURIAI;9326131725;Taip;5;1;0;6
5163;Nykštukas;SMAGURIAI;2000207070;Taip;6;0;0;6
5164;Nykštukas;SMAGURIAI;5421090978;Taip;10;1;0;11
5165;Nykštukas;SMAGURIAI;2826079911;Taip;5;0;0;5
5166;Nykštukas;SMAGURIAI;7911842707;Taip;12;1;1;14
5167;Nykštukas;SMAGURIAI;6102907953;Taip;18;0;0;18
5168;Nykštukas;SMAGURIAI;7529677915;Taip;6;1;1;8
5169;Nykštukas;SMAGURIAI;4994727422;Taip;5;7;0;12
5170;Nykštukas;SMALSIUKAI;1213461702;Ne;0;2;0;2
5171;Nykštukas;SMALSIUKAI;5121027981;Taip;14;2;0;16
5172;Nykštukas;SMALSIUKAI;6958596223;Ne;4;1;0;5
5173;Nykštukas;SMALSIUKAI;3002966681;Taip;5;4;0;9
5174;Nykštukas;SMALSIUKAI;4612171029;Ne;12;0;0;12
5175;Nykštukas;SMALSIUKAI;3120577264;Ne;0;10;0;10
5176;Nykštukas;SMALSIUKAI;2696384135;Taip;11;0;0;11
5177;Nykštukas;SMALSIUKAI;9532956150;Taip;0;1;3;4
5178;Nykštukas;SMALSIUKAI;3273579005;Taip;0;1;0;1
5179;Nykštukas;SMALSIUKAI;4040123876;Ne;0;11;0;11
5180;Nykštukas;SMALSIUKAI;3985610575;Taip;7;4;0;11
5181;Nykštukas;SMALSIUKAI;8948554271;Taip;1;2;0;3
5182;Nykštukas;SMALSIUKAI;1102555964;Ne;5;4;0;9
5183;Nykštukas;SMALSIUKAI;4331906712;Taip;0;0;2;2
5184;Nykštukas;SMALSIUKAI;6112448299;Ne;4;1;0;5
5185;Nykštukas;SMALSIUKAI;1930357859;Ne;0;5;0;5
5186;Nykštukas;SMALSIUKAI;9100510105;Taip;8;7;0;15
5187;Nykštukas;SMALSIUKAI;2143857296;Ne;10;0;0;10
5188;Nykštukas;AITVARIUKAI;1144228064;Taip;5;3;0;8
5189;Nykštukas;AITVARIUKAI;6787279403;Taip;0;2;0;2
5190;Nykštukas;AITVARIUKAI;2002197530;Taip;10;1;0;11
5191;Nykštukas;AITVARIUKAI;2113361929;Taip;0;1;0;1
5192;Nykštukas;AITVARIUKAI;4256675710;Taip;7;3;0;10
5193;Nykštukas;AITVARIUKAI;1209871301;Taip;15;0;0;15
5194;Nykštukas;AITVARIUKAI;93527297465;Ne;2;2;0;4
5195;Nykštukas;AITVARIUKAI;1642172676;Taip;0;4;0;4
5196;Nykštukas;AITVARIUKAI;1603960759;Ne;3;11;0;14
5197;Nykštukas;AITVARIUKAI;4487291454;Taip;0;1;0;1
5198;Nykštukas;AITVARIUKAI;6274009442;Taip;6;0;0;6
5199;Nykštukas;AITVARIUKAI;1760718866;Taip;0;2;0;2
5200;Nykštukas;AITVARIUKAI;5772758127;Taip;10;0;0;10
5201;Nykštukas;AITVARIUKAI;9229795383;Ne;9;2;0;11
5202;Nykštukas;AITVARIUKAI;3479582264;Taip;0;6;0;6
5203;Nykštukas;AITVARIUKAI;1643843455;Taip;5;0;0;5
5204;Nykštukas;AITVARIUKAI;1965559069;Taip;4;2;0;6
5205;Nykštukas;AITVARIUKAI;6480026426;Taip;8;1;0;9
5206;Nykštukas;AITVARIUKAI;4556700510;Ne;0;1;0;1
5207;Nykštukas;DAINORĖLIAI;1505896987;Ne;6;0;0;6
5208;Nykštukas;DAINORĖLIAI;1070086244;Taip;16;0;0;16
5209;Nykštukas;DAINORĖLIAI;6105521992;Taip;5;2;0;7
5210;Nykštukas;DAINORĖLIAI;67968815055;Taip;0;6;2;8
5211;Nykštukas;DAINORĖLIAI;8027860617;Taip;4;0;2;6
5212;Nykštukas;DAINORĖLIAI;7498721887;Taip;10;0;0;10
5213;Nykštukas;DAINORĖLIAI;7660848578;Taip;0;2;1;3
5214;Nykštukas;DAINORĖLIAI;2284266953;Taip;9;0;0;9
5215;Nykštukas;DAINORĖLIAI;8370864547;Taip;0;8;0;8
5216;Nykštukas;DAINORĖLIAI;4720226790;Taip;5;9;1;15
5217;Nykštukas;DAINORĖLIAI;7546263542;Taip;22;0;0;22
5218;Nykštukas;DAINORĖLIAI;9778271272;Taip;7;5;0;12
5219;Nykštukas;DAINORĖLIAI;7150793310;Taip;13;6;0;19
5220;Nykštukas;DAINORĖLIAI;7584220414;Taip;5;3;0;8
5221;Nykštukas;DAINORĖLIAI;8323439041;Ne;14;5;0;19
5222;Nykštukas;DAINORĖLIAI;7615678714;Taip;15;3;0;18
5223;Nykštukas;DAINORĖLIAI;9567571526;Taip;0;3;0;3
5224;Nykštukas;DAINORĖLIAI;3970413055;Taip;0;0;1;1
5225;Nykštukas;DAINORĖLIAI;2657373608;Taip;0;1;0;1
5226;Nykštukas;DAINORĖLIAI;1755944368;Taip;6;8;0;14
5227;Nykštukas;DAINORĖLIAI;3904901392;Taip;19;2;0;21
5228;Nykštukas;POKŠTUKAI;40765421180;Taip;18;3;0;21
5229;Nykštukas;POKŠTUKAI;18018106215;Taip;0;5;0;5
5230;Nykštukas;POKŠTUKAI;74234678869;Taip;0;9;0;9
5231;Nykštukas;POKŠTUKAI;28276934404;Ne;5;1;0;6
5232;Nykštukas;POKŠTUKAI;50854821473;Taip;9;1;0;10
5233;Nykštukas;POKŠTUKAI;57664247691;Taip;0;1;0;1
5234;Nykštukas;POKŠTUKAI;26248363243;Ne;0;6;0;6
5235;Nykštukas;POKŠTUKAI;60979950727;Taip;0;2;0;2
5236;Nykštukas;POKŠTUKAI;9779645295;Ne;0;1;0;1
5237;Nykštukas;POKŠTUKAI;50160103840;Taip;0;1;0;1
5238;Nykštukas;POKŠTUKAI;66105021371;Taip;0;2;0;2
5239;Nykštukas;POKŠTUKAI;62768852397;Taip;0;5;0;5
5240;Nykštukas;POKŠTUKAI;38098661273;Taip;0;1;0;1
5241;Nykštukas;POKŠTUKAI;47375659986;Ne;0;1;0;1
5242;Nykštukas;POKŠTUKAI;26952411744;Ne;2;1;0;3
5243;Nykštukas;POKŠTUKAI;9506999469;Taip;0;1;0;1
5244;Nykštukas;KODĖLČIUKAI;1312775821;Taip;0;4;0;4
5245;Nykštukas;KODĖLČIUKAI;22907267392;Taip;0;2;1;3
5246;Nykštukas;KODĖLČIUKAI;51839683425;Taip;0;6;0;6
5247;Nykštukas;KODĖLČIUKAI;49403159088;Ne;0;5;0;5
5248;Nykštukas;KODĖLČIUKAI;279882740;Taip;16;0;0;16
5249;Nykštukas;KODĖLČIUKAI;65431970524;Taip;0;9;3;12
5250;Nykštukas;KODĖLČIUKAI;74269403579;Taip;9;4;0;13
5251;Nykštukas;KODĖLČIUKAI;57158850838;Taip;0;4;0;4
5252;Nykštukas;KODĖLČIUKAI;67215878528;Taip;0;2;2;4
5253;Nykštukas;KODĖLČIUKAI;45998334166;Taip;0;2;1;3
5254;Nykštukas;KODĖLČIUKAI;46457925178;Taip;11;1;0;12
5255;Nykštukas;KODĖLČIUKAI;40507821302;Taip;0;17;0;17
5256;Nykštukas;KODĖLČIUKAI;40791169410;Ne;0;1;0;1
5257;Nykštukas;KODĖLČIUKAI;21793281327;Taip;0;0;2;2
5258;Nykštukas;KODĖLČIUKAI;73015157334;Taip;5;0;0;5
5259;Nykštukas;KODĖLČIUKAI;87788435945;Taip;0;0;4;4
5260;Nykštukas;KODĖLČIUKAI;42662848704;Taip;0;0;1;1
5261;Nykštukas;PASAKORIAI;86393328886;Taip;0;2;0;2
5262;Nykštukas;PASAKORIAI;29414650504;Taip;0;0;3;3
5263;Nykštukas;PASAKORIAI;1412282356;Taip;0;5;0;5
5264;Nykštukas;PASAKORIAI;67209958343;Taip;0;8;0;8
5265;Nykštukas;PASAKORIAI;40012664626;Taip;0;5;0;5
5266;Nykštukas;PASAKORIAI;368045639;Taip;0;4;0;4
5267;Nykštukas;PASAKORIAI;53994799769;Taip;0;1;0;1
5268;Nykštukas;PASAKORIAI;88757197161;Taip;0;12;0;12
5269;Nykštukas;PASAKORIAI;25431679881;Taip;16;0;0;16
5270;Nykštukas;PASAKORIAI;6154158870;Taip;0;10;0;10
5271;Nykštukas;PASAKORIAI;9728270999;Taip;0;1;0;1
5272;Nykštukas;PASAKORIAI;45917705129;Taip;0;10;0;10
5273;Nykštukas;PASAKORIAI;5185856324;Ne;4;0;3;7
5274;Nykštukas;GUDRUČIAI;90969634936;Taip;0;3;0;3
5275;Nykštukas;GUDRUČIAI;66071060125;Taip;2;1;0;3
5276;Nykštukas;GUDRUČIAI;23684742279;Taip;0;6;0;6
5277;Nykštukas;GUDRUČIAI;84800943947;Taip;0;5;0;5
5278;Nykštukas;GUDRUČIAI;25097193002;Taip;0;5;0;5
5279;Nykštukas;GUDRUČIAI;1448977214;Taip;0;0;2;2
5280;Nykštukas;GUDRUČIAI;2109799405;Taip;0;12;0;12
5281;Nykštukas;GUDRUČIAI;9041364129;Taip;0;8;0;8
5282;Nykštukas;GUDRUČIAI;48718365302;Taip;0;10;0;10
5283;Nykštukas;GUDRUČIAI;2121319324;Taip;10;0;0;10
5284;Nykštukas;GUDRUČIAI;40386182073;Taip;0;13;0;13
5285;Nykštukas;GUDRUČIAI;54607001703;Taip;0;1;0;1
5286;Nykštukas;GUDRUČIAI;27701482167;Taip;0;2;0;2
5287;Nykštukas;GUDRUČIAI;56267408803;Taip;4;0;0;4
5288;Nykštukas;GUDRUČIAI;92898851752;Ne;0;12;0;12
5289;Nykštukas;GUDRUČIAI;7325852578;Taip;0;3;0;3
5290;Nykštukas;GUDRUČIAI;1055246536;Taip;0;2;0;2
5291;Nykštukas;NAMINUKAI;1856534241;Ne;0;6;0;6
5292;Nykštukas;NAMINUKAI;34930388032;Ne;0;0;2;2
5293;Nykštukas;NAMINUKAI;1178437485;Taip;0;10;0;10
5294;Nykštukas;NAMINUKAI;1608057875;Taip;0;3;0;3
5295;Nykštukas;NAMINUKAI;1994080785;Taip;0;4;0;4
5296;Nykštukas;NAMINUKAI;37253009284;Taip;0;0;2;2
5297;Nykštukas;NAMINUKAI;1630706629;Ne;6;3;0;9
5298;Nykštukas;NAMINUKAI;1350373348;Taip;0;3;0;3
5299;Nykštukas;NAMINUKAI;27896604498;Taip;0;5;0;5
5300;Nykštukas;NAMINUKAI;9422129964;Taip;4;1;0;5
5301;Nykštukas;NAMINUKAI;7836485289;Taip;0;0;2;2
5302;Nykštukas;NAMINUKAI;30762220262;Ne;9;0;0;9
5303;Nykštukas;NAMINUKAI;9184265280;Taip;2;1;0;3
5304;Nykštukas;NAMINUKAI;1687759661;Taip;0;1;0;1
5305;Nykštukas;NAMINUKAI;61896011340;Taip;0;9;0;9
5306;Nykštukas;NAMINUKAI;4191728865;Taip;0;3;0;3
5307;Nykštukas;NAMINUKAI;7645589206;Taip;0;0;5;5
5308;Nykštukas;NAMINUKAI;44921552171;Taip;0;12;0;12
5309;Nykštukas;NAMINUKAI;58741201573;Taip;0;0;1;1
5310;Nykštukas;KŪLVERSTUKAI;7456007276;Taip;6;0;1;7
5311;Nykštukas;KŪLVERSTUKAI;4064016871;Taip;5;0;0;5
5312;Nykštukas;KŪLVERSTUKAI;9575291096;Taip;0;6;0;6
5313;Nykštukas;KŪLVERSTUKAI;2205400512;Ne;0;14;0;14
5314;Nykštukas;KŪLVERSTUKAI;6106373554;Taip;4;0;0;4
5315;Nykštukas;KŪLVERSTUKAI;4925214655;Taip;9;2;0;11
5316;Nykštukas;KŪLVERSTUKAI;9686815141;Taip;11;2;0;13
5317;Nykštukas;KŪLVERSTUKAI;7976689381;Ne;11;0;5;16
5318;Nykštukas;KŪLVERSTUKAI;9054070492;Taip;9;0;0;9
5319;Nykštukas;KŪLVERSTUKAI;5439925385;Ne;0;1;0;1
5320;Nykštukas;KŪLVERSTUKAI;8625793820;Ne;0;1;0;1
5321;Nykštukas;KŪLVERSTUKAI;4503830456;Taip;4;0;0;4
5322;Nykštukas;KŪLVERSTUKAI;7176519994;Ne;16;0;0;16
5323;Nykštukas;KŪLVERSTUKAI;6338717583;Taip;11;0;3;14
5324;Nykštukas;KŪLVERSTUKAI;2440574056;Ne;4;16;0;20
5325;Nykštukas;KŪLVERSTUKAI;3925958632;Taip;12;0;0;12
5326;Nykštukas;KŪLVERSTUKAI;7494444468;Taip;12;0;0;12
5327;Nykštukas;KŪLVERSTUKAI;5032283848;Ne;10;2;0;12
5328;Nykštukas;KŪLVERSTUKAI;4992654449;Taip;14;0;0;14
5329;Nykštukas;KŪLVERSTUKAI;1579064341;Taip;15;0;0;15
5330;Nykštukas;KŪLVERSTUKAI;6519078450;Taip;9;0;1;10
5331;Nykštukas;TREPSIUKAI;9894698453;Taip;4;0;0;4
5332;Nykštukas;TREPSIUKAI;4795301170;Taip;4;9;0;13
5333;Nykštukas;TREPSIUKAI;2661110617;Taip;8;0;0;8
5334;Nykštukas;TREPSIUKAI;1855278809;Taip;0;2;0;2
5335;Nykštukas;TREPSIUKAI;3040001373;Taip;9;3;0;12
5336;Nykštukas;TREPSIUKAI;5504584349;Taip;7;0;3;10
5337;Nykštukas;TREPSIUKAI;9714310539;Taip;5;1;0;6
5338;Nykštukas;TREPSIUKAI;8640715657;Taip;22;0;0;22
5339;Nykštukas;TREPSIUKAI;7990462246;Taip;0;2;0;2
5340;Nykštukas;TREPSIUKAI;7828733135;Taip;9;0;1;10
5341;Nykštukas;TREPSIUKAI;6039661153;Ne;4;0;3;7
5342;Nykštukas;TREPSIUKAI;3026598985;Ne;10;1;0;11
5343;Nykštukas;TREPSIUKAI;9595654681;Taip;9;0;0;9
5344;Nykštukas;TREPSIUKAI;4480184458;Taip;8;0;0;8
5345;Nykštukas;TREPSIUKAI;9413198245;Taip;0;0;1;1
5346;Nykštukas;TREPSIUKAI;2914822445;Taip;10;2;0;12
5347;Nykštukas;TREPSIUKAI;1379378120;Taip;0;5;0;5
5348;Nykštukas;TREPSIUKAI;4090494707;Taip;7;0;0;7
5349;Nykštukas;TREPSIUKAI;2518342041;Taip;0;8;0;8
5350;Nykštukas;TREPSIUKAI;1088633575;Ne;15;0;0;15
5351;Ozas;Smalsučiai;2641398988;Taip;19;0;0;19
5352;Ozas;Smalsučiai;9227939420;Taip;5;0;0;5
5353;Ozas;Smalsučiai;7917100888;Taip;0;4;0;4
5354;Ozas;Smalsučiai;87218067796;Taip;10;1;0;11
5355;Ozas;Smalsučiai;4397034031;Taip;0;5;0;5
5356;Ozas;Smalsučiai;1974320330;Taip;5;3;0;8
5357;Ozas;Smalsučiai;1173284700;Ne;0;2;0;2
5358;Ozas;Smalsučiai;67987032400;Taip;9;0;0;9
5359;Ozas;Smalsučiai;71695973592;Taip;0;1;0;1
5360;Ozas;Smalsučiai;57069047630;Taip;0;2;0;2
5361;Ozas;Smalsučiai;5150746885;Ne;0;5;0;5
5362;Ozas;Smalsučiai;9595277597;Taip;3;1;0;4
5363;Ozas;Smalsučiai;1893257809;Taip;6;2;0;8
5364;Ozas;Smalsučiai;8072802467;Taip;0;2;1;3
5365;Ozas;Smalsučiai;1248092034;Ne;4;0;0;4
5366;Ozas;Smalsučiai;43381497677;Ne;10;2;0;12
5367;Ozas;Smalsučiai;7351651916;Ne;11;0;0;11
5368;Ozas;Smalsučiai;3286170280;Taip;4;0;1;5
5369;Ozas;Smalsučiai;9521048381;Taip;9;4;0;13
5370;Ozas;Smalsučiai;2053832360;Taip;3;1;0;4
5371;Ozas;Smalsučiai;9905575489;Taip;4;0;0;4
5372;Ozas;Smalsučiai;5342394742;Taip;0;9;0;9
5373;Ozas;Drugeliai;1655808777;Taip;4;5;0;9
5374;Ozas;Drugeliai;7802699257;Taip;0;0;1;1
5375;Ozas;Drugeliai;8176840834;Ne;0;13;0;13
5376;Ozas;Drugeliai;2302999759;Taip;0;2;0;2
5377;Ozas;Drugeliai;8088330187;Taip;0;12;0;12
5378;Ozas;Drugeliai;9073973849;Taip;5;6;0;11
5379;Ozas;Drugeliai;9322806566;Taip;0;5;0;5
5380;Ozas;Drugeliai;2676747542;Taip;5;0;5;10
5381;Ozas;Drugeliai;8289643065;Taip;9;0;0;9
5382;Ozas;Drugeliai;4726019355;Taip;0;9;0;9
5383;Ozas;Drugeliai;9987863302;Ne;0;1;3;4
5384;Ozas;Drugeliai;5503766544;Taip;0;9;0;9
5385;Ozas;Drugeliai;2980799420;Taip;13;0;0;13
5386;Ozas;Drugeliai;8318380547;Taip;0;10;0;10
5387;Ozas;Drugeliai;4884054504;Taip;13;0;0;13
5388;Ozas;Drugeliai;2825614921;Taip;9;1;0;10
5389;Ozas;Drugeliai;43660054250;Taip;0;18;0;18
5390;Ozas;Drugeliai;1871542885;Taip;4;0;0;4
5391;Ozas;Boružėlės;1348960421;Taip;11;0;7;18
5392;Ozas;Boružėlės;1375643969;Ne;0;0;12;12
5393;Ozas;Boružėlės;63852147122;Taip;3;1;0;4
5394;Ozas;Boružėlės;8190314087;Taip;0;9;0;9
5395;Ozas;Boružėlės;3803998816;Taip;4;6;0;10
5396;Ozas;Boružėlės;1212358423;Taip;18;0;0;18
5397;Ozas;Boružėlės;7615907271;Ne;13;0;0;13
5398;Ozas;Boružėlės;1560342499;Taip;5;2;0;7
5399;Ozas;Boružėlės;8529654920;Taip;0;0;3;3
5400;Ozas;Boružėlės;60194872867;Taip;0;2;0;2
5401;Ozas;Boružėlės;7172573921;Taip;0;0;1;1
5402;Ozas;Boružėlės;2527574646;Taip;0;5;0;5
5403;Ozas;Boružėlės;9773251894;Taip;0;0;6;6
5404;Ozas;Boružėlės;36523514229;Taip;6;1;0;7
5405;Ozas;Boružėlės;1367050160;Taip;3;0;2;5
5406;Ozas;Boružėlės;68364031736;Taip;0;4;0;4
5407;Ozas;Boružėlės;2678629892;Taip;0;0;8;8
5408;Ozas;Boružėlės;1109113859;Ne;0;0;1;1
5409;Ozas;Boružėlės;1826499734;Taip;0;1;0;1
5410;Ozas;Boružėlės;6432357144;Taip;0;0;22;22
5411;Ozas;Boružėlės;1498656201;Taip;0;11;0;11
5412;Ozas;Boružėlės;8979747150;Taip;22;0;0;22
5413;Ozas;Boružėlės;1217496635;Taip;5;1;1;7
5414;Ozas;Boružėlės;1682529482;Taip;0;1;0;1
5415;Ozas;Boružėlės;9130645878;Taip;8;9;0;17
5416;Ozas;Žiogeliai;7461521320;Taip;4;0;0;4
5417;Ozas;Žiogeliai;6257625501;Taip;0;1;2;3
5418;Ozas;Žiogeliai;7402290524;Taip;4;7;0;11
5419;Ozas;Žiogeliai;1562277866;Taip;0;0;1;1
5420;Ozas;Žiogeliai;4571583671;Taip;2;1;0;3
5421;Ozas;Žiogeliai;1837947633;Taip;9;0;0;9
5422;Ozas;Žiogeliai;5682027094;Taip;22;0;0;22
5423;Ozas;Žiogeliai;4966355020;Taip;3;5;0;8
5424;Ozas;Žiogeliai;6950802941;Taip;22;0;0;22
5425;Ozas;Žiogeliai;9324647606;Taip;7;0;0;7
5426;Ozas;Žiogeliai;9392526836;Taip;3;1;3;7
5427;Ozas;Žiogeliai;5850824864;Taip;0;2;0;2
5428;Ozas;Žiogeliai;4942550213;Ne;18;0;0;18
5429;Ozas;Žiogeliai;8676986286;Ne;0;0;12;12
5430;Ozas;Žiogeliai;2345112767;Taip;0;4;0;4
5431;Ozas;Žiogeliai;5420952391;Taip;3;10;0;13
5432;Ozas;Žiogeliai;5156383727;Taip;0;9;0;9
5433;Ozas;Žiogeliai;9929822317;Taip;3;1;1;5
5434;Ozas;Žiogeliai;6108049183;Taip;3;2;0;5
5435;Ozas;Žiogeliai;2837228320;Taip;8;8;0;16
5436;Ozas;Žiogeliai;7264789334;Taip;5;0;0;5
5437;Ozas;Žiogeliai;2617258206;Ne;7;0;1;8
5438;Ozas;Bitutės;4220780257;Taip;0;0;1;1
5439;Ozas;Bitutės;1161776624;Taip;5;0;4;9
5440;Ozas;Bitutės;4227555342;Taip;3;3;0;6
5441;Ozas;Bitutės;7499756171;Taip;0;14;0;14
5442;Ozas;Bitutės;7494307084;Taip;0;0;1;1
5443;Ozas;Bitutės;2705294874;Taip;15;0;0;15
5444;Ozas;Bitutės;2369544599;Taip;0;5;1;6
5445;Ozas;Bitutės;3329391600;Taip;9;1;0;10
5446;Ozas;Bitutės;4207160323;Taip;7;0;0;7
5447;Ozas;Bitutės;4254601638;Taip;7;0;4;11
5448;Ozas;Bitutės;8304671844;Taip;2;0;4;6
5449;Ozas;Bitutės;5968428143;Taip;9;0;0;9
5450;Ozas;Bitutės;5381187291;Taip;19;0;3;22
5451;Ozas;Bitutės;1895519949;Taip;0;5;0;5
5452;Ozas;Bitutės;9772085405;Taip;10;0;5;15
5453;Ozas;Bitutės;7051699003;Taip;20;0;0;20
5454;Ozas;Bitutės;7817387800;Taip;15;0;1;16
5455;Ozas;Bitutės;5383877034;Taip;3;7;4;14
5456;Ozas;Bitutės;1117208248;Taip;0;0;1;1
5457;Ozas;Bitutės;9050174230;Taip;0;0;1;1
5458;Ozas;Bitutės;6811181735;Taip;17;0;0;17
5459;Ozas;Aitvarėliai;1653285671;Taip;0;10;0;10
5460;Ozas;Aitvarėliai;25660709486;Ne;9;5;0;14
5461;Ozas;Aitvarėliai;87500216376;Taip;0;13;0;13
5462;Ozas;Aitvarėliai;62542133064;Taip;4;1;0;5
5463;Ozas;Aitvarėliai;77935174855;Taip;0;0;4;4
5464;Ozas;Aitvarėliai;74709964983;Taip;0;4;0;4
5465;Ozas;Aitvarėliai;28736160618;Taip;0;3;0;3
5466;Ozas;Aitvarėliai;81692407050;Taip;0;1;0;1
5467;Ozas;Aitvarėliai;3222282556;Taip;0;15;0;15
5468;Ozas;Aitvarėliai;1556404162;Taip;0;1;1;2
5469;Ozas;Aitvarėliai;20944134865;Taip;0;1;0;1
5470;Ozas;Aitvarėliai;2087307495;Taip;0;0;2;2
5471;Ozas;Aitvarėliai;99211100553;Taip;0;0;1;1
5472;Ozas;Aitvarėliai;56927777775;Taip;0;0;3;3
5473;Ozas;Aitvarėliai;84378491220;Taip;0;1;0;1
5474;Ozas;Aitvarėliai;53609618421;Taip;0;0;3;3
5475;Ozas;Aitvarėliai;83249479846;Taip;4;0;0;4
5476;Ozas;Aitvarėliai;1182573257;Ne;0;9;0;9
5477;Ozas;Aitvarėliai;85075096111;Taip;0;2;0;2
5478;Ozas;Voveraitės;89115682092;Taip;0;2;12;14
5479;Ozas;Voveraitės;97875471586;Taip;0;0;6;6
5480;Ozas;Voveraitės;42030629149;Taip;0;0;5;5
5481;Ozas;Voveraitės;87683044622;Taip;0;0;14;14
5482;Ozas;Voveraitės;94576453630;Taip;0;3;2;5
5483;Ozas;Voveraitės;26834809068;Taip;0;10;0;10
5484;Ozas;Voveraitės;88508505247;Taip;0;2;0;2
5485;Ozas;Voveraitės;47574756201;Taip;0;4;0;4
5486;Ozas;Voveraitės;29411948493;Taip;5;1;0;6
5487;Ozas;Voveraitės;27655773887;Taip;0;2;1;3
5488;Ozas;Voveraitės;88837027397;Taip;0;1;1;2
5489;Ozas;Voveraitės;46431348128;Taip;0;2;0;2
5490;Ozas;Voveraitės;66463185196;Taip;4;1;0;5
5491;Ozas;Voveraitės;93882562685;Taip;0;3;0;3
5492;Ozas;Voveraitės;37505558259;Taip;0;3;0;3
5493;Ozas;Voveraitės;90020306864;Taip;12;0;0;12
5494;Ozas;Voveraitės;34723844399;Taip;0;2;2;4
5495;Ozas;Voveraitės;16101439010;Taip;0;0;3;3
5496;Ozas;Voveraitės;5637273299;Taip;0;0;8;8
5497;Ozas;Voveraitės;1637437696;Ne;0;2;0;2
5498;Ozas;Kodelčiukai;2808066733;Taip;5;15;0;20
5499;Ozas;Kodelčiukai;71351371644;Taip;0;1;0;1
5500;Ozas;Kodelčiukai;13077342836;Taip;7;3;0;10
5501;Ozas;Kodelčiukai;1746778441;Ne;0;3;0;3
5502;Ozas;Kodelčiukai;1110232715;Taip;20;2;0;22
5503;Ozas;Kodelčiukai;28273919775;Taip;0;5;0;5
5504;Ozas;Kodelčiukai;88618151766;Taip;0;8;0;8
5505;Ozas;Kodelčiukai;3637786952;Taip;0;13;0;13
5506;Ozas;Kodelčiukai;39003781970;Taip;0;6;0;6
5507;Ozas;Kodelčiukai;1235925750;Ne;5;0;0;5
5508;Ozas;Kodelčiukai;69756875821;Taip;0;1;0;1
5509;Ozas;Kodelčiukai;19065860134;Taip;0;1;0;1
5510;Ozas;Kodelčiukai;1230455881;Taip;9;1;0;10
5511;Ozas;Kodelčiukai;1684454071;Taip;5;1;0;6
5512;Ozas;Kodelčiukai;1008366446;Ne;4;0;0;4
5513;Ozas;Kodelčiukai;1288477637;Taip;0;2;0;2
5514;Ozas;Kodelčiukai;82373453244;Taip;7;2;0;9
5515;Ozas;Kodelčiukai;94673981368;Taip;0;8;0;8
5516;Ozas;Kodelčiukai;19284606277;Taip;0;3;0;3
5517;Ozas;Kodelčiukai;59125596894;Taip;0;3;0;3
5518;Ozas;Pelėdžiukai;1462541264;Ne;0;8;0;8
5519;Ozas;Pelėdžiukai;3439351594;Taip;19;3;0;22
5520;Ozas;Pelėdžiukai;41795363180;Taip;0;1;1;2
5521;Ozas;Pelėdžiukai;60743195418;Ne;0;9;1;10
5522;Ozas;Pelėdžiukai;1755283948;Taip;0;8;0;8
5523;Ozas;Pelėdžiukai;13375413701;Taip;0;4;0;4
5524;Ozas;Pelėdžiukai;16523707810;Taip;0;0;7;7
5525;Ozas;Pelėdžiukai;47291376629;Ne;0;5;0;5
5526;Ozas;Pelėdžiukai;34330362446;Taip;8;0;2;10
5527;Ozas;Pelėdžiukai;2140385280;Taip;0;2;0;2
5528;Ozas;Pelėdžiukai;1450257399;Taip;0;1;0;1
5529;Ozas;Pelėdžiukai;4765249675;Taip;0;7;1;8
5530;Ozas;Pelėdžiukai;1814400303;Taip;0;9;0;9
5531;Ozas;Pelėdžiukai;1889249743;Taip;0;6;0;6
5532;Ozas;Pelėdžiukai;1099026003;Taip;0;1;1;2
5533;Ozas;Pelėdžiukai;2058548464;Taip;1;0;1;2
5534;Ozas;Pelėdžiukai;4590847831;Taip;0;5;0;5
5535;Ozas;"Kačiukai ";6618249243;Taip;0;6;0;6
5536;Ozas;"Kačiukai ";1151213934;Taip;4;0;0;4
5537;Ozas;"Kačiukai ";2114612776;Taip;0;6;7;13
5538;Ozas;"Kačiukai ";60155732637;Taip;0;7;0;7
5539;Ozas;"Kačiukai ";37159754070;Taip;0;5;0;5
5540;Ozas;"Kačiukai ";61398533877;Taip;0;0;1;1
5541;Ozas;"Kačiukai ";1210902341;Taip;0;3;0;3
5542;Ozas;"Kačiukai ";1316758924;Ne;14;0;0;14
5543;Ozas;"Kačiukai ";2018398634;Taip;0;0;7;7
5544;Ozas;"Kačiukai ";34196440412;Taip;0;0;2;2
5545;Ozas;"Kačiukai ";84277015523;Taip;0;0;1;1
5546;Ozas;"Kačiukai ";1822377180;Taip;4;0;10;14
5547;Ozas;"Kačiukai ";1551028882;Taip;3;0;0;3
5548;Ozas;"Kačiukai ";4400619617;Taip;0;0;5;5
5549;Ozas;"Kačiukai ";9345447142;Taip;2;5;0;7
5550;Ozas;"Kačiukai ";1681367373;Taip;0;0;16;16
5551;Ozas;"Kačiukai ";8248732706;Taip;12;0;1;13
5552;Ozas;"Kačiukai ";84845624912;Ne;4;8;1;13
5553;Ozas;Ančiukų;2635045515;Taip;13;0;1;14
5554;Ozas;Ančiukų;9195536968;Taip;0;0;7;7
5555;Ozas;Ančiukų;5822871838;Taip;0;3;0;3
5556;Ozas;Ančiukų;1997125531;Taip;2;1;0;3
5557;Ozas;Ančiukų;1240233169;Taip;12;0;0;12
5558;Ozas;Ančiukų;6666591428;Taip;3;0;2;5
5559;Ozas;Ančiukų;8874823029;Taip;10;0;0;10
5560;Ozas;Ančiukų;8178298861;Taip;6;0;0;6
5561;Ozas;Ančiukų;1564826076;Taip;0;0;3;3
5562;Ozas;Ančiukų;5016547315;Ne;15;0;1;16
5563;Ozas;Ančiukų;6088757991;Taip;3;5;0;8
5564;Ozas;Ančiukų;2991511872;Taip;10;5;0;15
5565;Ozas;Ančiukų;6053885086;Taip;16;0;0;16
5566;Ozas;Ančiukų;2511477658;Taip;0;3;1;4
5567;Ozas;Ančiukų;6499549095;Taip;4;1;2;7
5568;Ozas;Ančiukų;7978092840;Taip;0;8;2;10
5569;Ozas;Ančiukų;2824133388;Taip;21;0;0;21
5570;Ozas;Ančiukų;2637531106;Taip;9;0;0;9
5571;Ozas;Ančiukų;8470832744;Taip;11;0;2;13
5572;Ozas;Ančiukų;6263062055;Ne;16;0;0;16
5573;Ozas;Nykškukų;2773182934;Taip;7;0;2;9
5574;Ozas;Nykškukų;5642468671;Taip;14;0;0;14
5575;Ozas;Nykškukų;1073755384;Taip;0;0;9;9
5576;Ozas;Nykškukų;7686706482;Taip;13;0;4;17
5577;Ozas;Nykškukų;5769870711;Taip;0;6;0;6
5578;Ozas;Nykškukų;1543683077;Taip;6;0;1;7
5579;Ozas;Nykškukų;2922370952;Taip;0;3;0;3
5580;Ozas;Nykškukų;2395567376;Taip;4;2;2;8
5581;Ozas;Nykškukų;6783755555;Taip;0;1;0;1
5582;Ozas;Nykškukų;8987796218;Taip;3;3;0;6
5583;Ozas;Nykškukų;4357737538;Taip;0;0;3;3
5584;Ozas;Nykškukų;5744027226;Ne;22;0;0;22
5585;Ozas;Nykškukų;2544858937;Ne;11;0;0;11
5586;Ozas;Nykškukų;1045890394;Taip;0;1;14;15
5587;Ozas;Nykškukų;1144679735;Taip;17;0;0;17
5588;Ozas;Nykškukų;5383739203;Taip;9;1;1;11
5589;Pabiručiai;Voveriukų;4069564285;Taip;0;3;0;3
5590;Pabiručiai;Voveriukų;7278334800;Ne;5;2;0;7
5591;Pabiručiai;Voveriukų;9468698553;Taip;0;0;1;1
5592;Pabiručiai;Voveriukų;7066037017;Taip;0;2;0;2
5593;Pabiručiai;Voveriukų;4040533883;Taip;13;0;0;13
5594;Pabiručiai;Voveriukų;2514312233;Taip;0;1;0;1
5595;Pabiručiai;Voveriukų;7606274875;Taip;0;1;0;1
5596;Pabiručiai;Voveriukų;9356327400;Taip;0;8;0;8
5597;Pabiručiai;Voveriukų;1498738549;Taip;0;5;0;5
5598;Pabiručiai;Voveriukų;4312364951;Taip;0;14;0;14
5599;Pabiručiai;Voveriukų;2446697763;Taip;19;0;0;19
5600;Pabiručiai;Voveriukų;4813206044;Taip;10;3;0;13
5601;Pabiručiai;Voveriukų;3936426174;Taip;1;3;4;8
5602;Pabiručiai;Voveriukų;2989580886;Taip;0;6;0;6
5603;Pabiručiai;Voveriukų;7985360502;Taip;1;0;0;1
5604;Pabiručiai;Voveriukų;7403996266;Taip;7;0;0;7
5605;Pabiručiai;Voveriukų;6251432968;Taip;9;0;1;10
5606;Pabiručiai;Boružiukų;6401188653;Taip;0;0;3;3
5607;Pabiručiai;Boružiukų;1673473814;Taip;0;0;3;3
5608;Pabiručiai;Boružiukų;5686769648;Ne;0;10;0;10
5609;Pabiručiai;Boružiukų;7524993271;Ne;0;0;1;1
5610;Pabiručiai;Boružiukų;5708597471;Taip;0;1;0;1
5611;Pabiručiai;Boružiukų;4006783343;Taip;10;0;0;10
5612;Pabiručiai;Boružiukų;7046122545;Taip;3;0;0;3
5613;Pabiručiai;Boružiukų;3096466200;Taip;0;1;0;1
5614;Pabiručiai;Boružiukų;4301904533;Taip;0;1;0;1
5615;Pabiručiai;Boružiukų;8175565139;Ne;3;0;0;3
5616;Pabiručiai;Boružiukų;8106446562;Taip;0;6;0;6
5617;Pabiručiai;Boružiukų;8236964683;Taip;5;1;0;6
5618;Pabiručiai;Boružiukų;1671027282;Taip;5;0;0;5
5619;Pabiručiai;Boružiukų;3759350345;Taip;0;2;0;2
5620;Pabiručiai;Boružiukų;3151360288;Taip;0;4;0;4
5621;Pabiručiai;Boružiukų;9299393363;Taip;0;19;0;19
5622;Pabiručiai;Boružiukų;1484291546;Ne;0;0;2;2
5623;Pabiručiai;Boružiukų;2771769336;Taip;0;3;0;3
5624;Pabiručiai;Boružiukų;2853659708;Ne;5;0;4;9
5625;Pabiručiai;Katinėlių;1670938208;Taip;8;0;0;8
5626;Pabiručiai;Katinėlių;1224986101;Taip;12;0;2;14
5627;Pabiručiai;Katinėlių;3756365293;Taip;7;0;0;7
5628;Pabiručiai;Katinėlių;6283372742;Taip;16;0;0;16
5629;Pabiručiai;Katinėlių;1749155319;Ne;6;1;4;11
5630;Pabiručiai;Katinėlių;34883375155;Taip;11;2;0;13
5631;Pabiručiai;Katinėlių;1705085006;Taip;10;0;0;10
5632;Pabiručiai;Katinėlių;58112415466;Taip;0;14;0;14
5633;Pabiručiai;Katinėlių;42877891797;Taip;0;9;0;9
5634;Pabiručiai;Katinėlių;8284711578;Taip;8;0;0;8
5635;Pabiručiai;Katinėlių;8710389714;Taip;9;2;0;11
5636;Pabiručiai;Katinėlių;4501176225;Taip;0;8;0;8
5637;Pabiručiai;Katinėlių;8503177793;Taip;11;0;9;20
5638;Pabiručiai;Katinėlių;4339607826;Taip;0;12;0;12
5639;Pabiručiai;Katinėlių;8306688649;Taip;10;0;1;11
5640;Pabiručiai;Katinėlių;2572570925;Taip;14;0;2;16
5641;Pabiručiai;Katinėlių;6994301415;Taip;0;17;0;17
5642;Pabiručiai;Katinėlių;4205107384;Taip;0;0;1;1
5643;Pabiručiai;Katinėlių;5513311280;Taip;0;0;3;3
5644;Pabiručiai;Žiogelių;3272576627;Taip;11;0;2;13
5645;Pabiručiai;Žiogelių;5522447437;Taip;10;0;1;11
5646;Pabiručiai;Žiogelių;7974345478;Taip;10;0;0;10
5647;Pabiručiai;Žiogelių;8367889753;Taip;7;0;0;7
5648;Pabiručiai;Žiogelių;8421025940;Taip;0;8;0;8
5649;Pabiručiai;Žiogelių;3028063887;Taip;2;0;3;5
5650;Pabiručiai;Žiogelių;1642658060;Taip;19;0;0;19
5651;Pabiručiai;Žiogelių;3206962828;Taip;12;0;0;12
5652;Pabiručiai;Žiogelių;3355875364;Taip;15;1;0;16
5653;Pabiručiai;Žiogelių;7085036701;Taip;0;9;0;9
5654;Pabiručiai;Žiogelių;8736658575;Taip;7;0;0;7
5655;Pabiručiai;Žiogelių;1311650644;Taip;10;0;0;10
5656;Pabiručiai;Žiogelių;2356833740;Ne;7;0;4;11
5657;Pabiručiai;Žiogelių;5311762824;Taip;9;3;0;12
5658;Pabiručiai;Žiogelių;1587905929;Taip;8;13;0;21
5659;Pabiručiai;Žiogelių;5761888906;Taip;4;7;0;11
5660;Pabiručiai;Žiogelių;4667769378;Taip;16;0;0;16
5661;Pabiručiai;Žiogelių;8025611655;Taip;6;0;0;6
5662;Pabiručiai;Smalsiukai;26744711510;Taip;0;1;0;1
5663;Pabiručiai;Smalsiukai;77665506359;Taip;5;0;0;5
5664;Pabiručiai;Smalsiukai;25404048436;Taip;5;0;0;5
5665;Pabiručiai;Smalsiukai;99245902550;Ne;0;3;3;6
5666;Pabiručiai;Smalsiukai;72030186300;Taip;0;3;0;3
5667;Pabiručiai;Smalsiukai;1461544209;Taip;0;0;3;3
5668;Pabiručiai;Smalsiukai;1749795353;Taip;5;0;3;8
5669;Pabiručiai;Smalsiukai;83758151778;Ne;0;3;0;3
5670;Pabiručiai;Smalsiukai;46891762701;Taip;0;2;0;2
5671;Pabiručiai;Smalsiukai;1052844376;Taip;0;6;0;6
5672;Pabiručiai;Smalsiukai;97516241743;Taip;3;0;1;4
5673;Pabiručiai;Smalsiukai;37299891873;Taip;10;0;0;10
5674;Pabiručiai;Smalsiukai;99612002248;Taip;0;1;0;1
5675;Pabiručiai;Smalsiukai;67029008630;Taip;4;1;0;5
5676;Pabiručiai;Smalsiukai;84458450123;Taip;0;6;0;6
5677;Pabiručiai;Smalsiukai;8690290547;Taip;0;3;0;3
5678;Pabiručiai;Smalsiukai;1961336031;Ne;9;3;0;12
5679;Pabiručiai;Kiškučiai;23334247840;Ne;10;1;0;11
5680;Pabiručiai;Kiškučiai;78055744911;Taip;0;1;0;1
5681;Pabiručiai;Kiškučiai;9756328087;Ne;5;4;0;9
5682;Pabiručiai;Kiškučiai;16153916925;Ne;0;3;0;3
5683;Pabiručiai;Kiškučiai;69948274186;Taip;0;4;0;4
5684;Pabiručiai;Kiškučiai;62817645726;Taip;0;5;0;5
5685;Pabiručiai;Kiškučiai;25986912111;Taip;0;3;0;3
5686;Pabiručiai;Kiškučiai;99405892035;Taip;8;5;0;13
5687;Pabiručiai;Kiškučiai;31043795418;Taip;0;11;0;11
5688;Pabiručiai;Kiškučiai;1189209435;Taip;16;0;0;16
5689;Pabiručiai;Kiškučiai;58410416452;Taip;5;1;0;6
5690;Pabiručiai;Kiškučiai;1457799587;Taip;0;1;0;1
5691;Pabiručiai;Kiškučiai;93595653770;Taip;0;5;0;5
5692;Pabiručiai;Kiškučiai;4463663862;Taip;7;1;0;8
5693;Pabiručiai;Kiškučiai;1780827082;Taip;0;1;0;1
5694;Pabiručiai;Kiškučiai;3767061583;Taip;8;3;0;11
5695;Pabiručiai;Kiškučiai;37991862437;Taip;0;6;0;6
5696;Pabiručiai;Kiškučiai;5327687404;Taip;7;3;0;10
5697;Pabiručiai;"Pėledžiukai ";7457099536;Taip;0;7;0;7
5698;Pabiručiai;"Pėledžiukai ";77273870334;Taip;0;1;0;1
5699;Pabiručiai;"Pėledžiukai ";80756439543;Taip;0;1;0;1
5700;Pabiručiai;"Pėledžiukai ";90849312010;Taip;6;1;0;7
5701;Pabiručiai;"Pėledžiukai ";6112244077;Ne;0;1;0;1
5702;Pabiručiai;"Pėledžiukai ";18356992277;Taip;0;8;0;8
5703;Pabiručiai;"Pėledžiukai ";28121667845;Taip;0;4;0;4
5704;Pabiručiai;"Pėledžiukai ";1474411801;Taip;13;0;0;13
5705;Pabiručiai;"Pėledžiukai ";1591342751;Taip;13;1;0;14
5706;Pabiručiai;"Pėledžiukai ";1078387167;Taip;0;1;0;1
5707;Pabiručiai;"Pėledžiukai ";3733576400;Taip;0;3;0;3
5708;Pabiručiai;"Pėledžiukai ";34215100257;Taip;0;7;0;7
5709;Pabiručiai;"Pėledžiukai ";26940925728;Ne;0;3;0;3
5710;Pabiručiai;"Pėledžiukai ";2944433375;Ne;0;2;3;5
5711;Pabiručiai;"Kodelčiūkai ";1819457592;Taip;0;2;0;2
5712;Pabiručiai;"Kodelčiūkai ";38142737487;Taip;0;8;0;8
5713;Pabiručiai;"Kodelčiūkai ";62923769489;Taip;7;6;0;13
5714;Pabiručiai;"Kodelčiūkai ";65267728282;Taip;0;3;0;3
5715;Pabiručiai;"Kodelčiūkai ";15948930587;Taip;22;0;0;22
5716;Pabiručiai;"Kodelčiūkai ";61144974706;Taip;0;1;0;1
5717;Pabiručiai;"Kodelčiūkai ";78798062773;Taip;0;1;0;1
5718;Pabiručiai;"Kodelčiūkai ";66085180057;Ne;0;9;0;9
5719;Pabiručiai;"Kodelčiūkai ";1718014001;Taip;0;5;0;5
5720;Pabiručiai;"Kodelčiūkai ";2143676810;Taip;3;7;0;10
5721;Pabiručiai;"Kodelčiūkai ";46251218463;Taip;0;1;0;1
5722;Pabiručiai;"Kodelčiūkai ";1029743585;Taip;10;1;0;11
5723;Pabiručiai;"Kodelčiūkai ";1236499374;Taip;15;0;1;16
5724;Pabiručiai;"Kodelčiūkai ";8344476830;Taip;0;8;0;8
5725;Pabiručiai;"Kodelčiūkai ";8359296058;Taip;0;0;3;3
5726;Pabiručiai;"Kodelčiūkai ";4634305371;Taip;0;9;0;9
5727;Pabiručiai;"Kodelčiūkai ";4901977623;Taip;10;0;1;11
5728;Pabiručiai;"Peliukų ";8775727677;Taip;0;4;0;4
5729;Pabiručiai;"Peliukų ";1028312285;Taip;6;0;1;7
5730;Pabiručiai;"Peliukų ";9417138573;Taip;10;0;4;14
5731;Pabiručiai;"Peliukų ";1515270273;Ne;9;0;1;10
5732;Pabiručiai;"Peliukų ";4317656984;Taip;14;0;0;14
5733;Pabiručiai;"Peliukų ";2688728915;Taip;2;0;1;3
5734;Pabiručiai;"Peliukų ";5166525832;Taip;12;0;1;13
5735;Pabiručiai;"Peliukų ";5209535192;Taip;22;0;0;22
5736;Pabiručiai;"Peliukų ";3408518493;Taip;0;0;1;1
5737;Pabiručiai;"Peliukų ";2147165934;Taip;19;0;0;19
5738;Pabiručiai;"Peliukų ";4785878572;Taip;7;0;0;7
5739;Pabiručiai;"Peliukų ";8409455566;Taip;8;5;0;13
5740;Pabiručiai;"Viščiukų ";7090116276;Taip;1;3;0;4
5741;Pabiručiai;"Viščiukų ";8897462614;Taip;2;2;1;5
5742;Pabiručiai;"Viščiukų ";1663953648;Taip;0;7;0;7
5743;Pabiručiai;"Viščiukų ";4408666547;Taip;1;0;0;1
5744;Pabiručiai;"Viščiukų ";2869383175;Taip;1;0;0;1
5745;Pabiručiai;"Viščiukų ";7677235214;Taip;0;0;3;3
5746;Pabiručiai;"Viščiukų ";9676561758;Taip;0;2;0;2
5747;Pabiručiai;"Viščiukų ";7632969321;Ne;4;12;0;16
5748;Pabiručiai;"Viščiukų ";3700401383;Taip;0;22;0;22
5749;Pabiručiai;"Viščiukų ";6935913132;Ne;11;2;0;13
5750;Pabiručiai;"Viščiukų ";7663581089;Taip;4;0;1;5
5751;Pabiručiai;"Viščiukų ";7248314871;Taip;2;0;0;2
5752;Pabiručiai;"Viščiukų ";9610623364;Taip;0;2;0;2
5753;Pabiručiai;"Viščiukų ";1344711015;Ne;4;4;0;8
5754;Pabiručiai;"Drugelių ";4462744848;Taip;5;1;0;6
5755;Pabiručiai;"Drugelių ";9589005897;Taip;0;21;0;21
5756;Pabiručiai;"Drugelių ";1582754284;Ne;7;0;0;7
5757;Pabiručiai;"Drugelių ";5497318373;Taip;7;0;1;8
5758;Pabiručiai;"Drugelių ";8179285338;Taip;0;18;0;18
5759;Pabiručiai;"Drugelių ";6648966721;Taip;5;0;0;5
5760;Pabiručiai;"Drugelių ";4080298620;Taip;8;0;0;8
5761;Pabiručiai;"Drugelių ";6697518151;Taip;8;1;0;9
5762;Pabiručiai;"Drugelių ";3497466298;Taip;0;14;0;14
5763;Pabiručiai;"Drugelių ";3368607302;Taip;12;0;0;12
5764;Pabiručiai;"Drugelių ";9353062804;Taip;20;0;0;20
5765;Pabiručiai;"Drugelių ";5621183663;Taip;0;5;0;5
5766;Pagrandukas;Saulytės;56985738094;Taip;0;8;0;8
5767;Pagrandukas;Saulytės;73747309137;Ne;0;4;0;4
5768;Pagrandukas;Saulytės;25042144265;Taip;0;8;0;8
5769;Pagrandukas;Saulytės;17860708643;Taip;0;11;0;11
5770;Pagrandukas;Saulytės;10275994267;Taip;0;11;0;11
5771;Pagrandukas;Saulytės;53442283517;Ne;0;8;0;8
5772;Pagrandukas;Saulytės;85893187794;Taip;0;3;0;3
5773;Pagrandukas;Saulytės;1735088719;Taip;0;6;0;6
5774;Pagrandukas;Saulytės;2240690677;Taip;0;11;0;11
5775;Pagrandukas;Saulytės;82076379343;Taip;0;2;0;2
5776;Pagrandukas;Saulytės;90244057040;Ne;0;6;0;6
5777;Pagrandukas;Saulytės;5179694773;Taip;0;4;0;4
5778;Pagrandukas;Saulytės;1432860651;Taip;0;1;0;1
5779;Pagrandukas;Saulytės;4550081974;Taip;0;1;0;1
5780;Pagrandukas;Saulytės;61332904191;Taip;0;4;0;4
5781;Pagrandukas;Zuikučiai;7834436515;Taip;0;1;0;1
5782;Pagrandukas;Zuikučiai;7435609306;Taip;4;0;1;5
5783;Pagrandukas;Zuikučiai;5903416384;Taip;6;1;0;7
5784;Pagrandukas;Zuikučiai;2439891231;Taip;0;6;0;6
5785;Pagrandukas;Zuikučiai;6710887776;Taip;0;6;0;6
5786;Pagrandukas;Zuikučiai;5649084353;Ne;18;0;0;18
5787;Pagrandukas;Zuikučiai;7665811353;Taip;5;8;0;13
5788;Pagrandukas;Zuikučiai;2212787835;Taip;2;2;0;4
5789;Pagrandukas;Zuikučiai;2711590019;Taip;0;0;5;5
5790;Pagrandukas;Zuikučiai;6449029299;Taip;7;0;0;7
5791;Pagrandukas;Zuikučiai;1405820070;Ne;4;0;0;4
5792;Pagrandukas;Zuikučiai;1054107640;Ne;4;10;1;15
5793;Pagrandukas;Zuikučiai;1885539883;Ne;0;1;0;1
5794;Pagrandukas;Zuikučiai;1795582354;Taip;0;10;0;10
5795;Pagrandukas;Zuikučiai;2822538227;Taip;0;0;3;3
5796;Pagrandukas;Boružėlių;3888408459;Taip;0;1;0;1
5797;Pagrandukas;Boružėlių;3398225200;Taip;0;4;0;4
5798;Pagrandukas;Boružėlių;5752454925;Ne;9;1;0;10
5799;Pagrandukas;Boružėlių;3587941684;Ne;9;1;0;10
5800;Pagrandukas;Boružėlių;5946007985;Taip;4;0;0;4
5801;Pagrandukas;Boružėlių;7770852445;Taip;4;0;0;4
5802;Pagrandukas;Boružėlių;6304701617;Ne;1;0;0;1
5803;Pagrandukas;Boružėlių;3953844737;Taip;0;3;0;3
5804;Pagrandukas;Boružėlių;7271589727;Taip;7;3;0;10
5805;Pagrandukas;Boružėlių;7064391685;Taip;4;0;0;4
5806;Pagrandukas;Boružėlių;5640182548;Taip;9;1;0;10
5807;Pagrandukas;Boružėlių;1403569615;Ne;6;0;0;6
5808;Pagrandukas;Boružėlių;5511396314;Taip;2;8;0;10
5809;Pagrandukas;Boružėlių;9651789217;Ne;1;5;0;6
5810;Pagrandukas;Boružėlių;6911951786;Taip;3;1;0;4
5811;Pagrandukas;Boružėlių;2926077771;Taip;4;1;0;5
5812;Pagrandukas;Boružėlių;5741021524;Taip;0;0;2;2
5813;Pagrandukas;Boružėlių;2361829423;Ne;0;1;2;3
5814;Pagrandukas;Bitutės;22146063631;Taip;0;10;0;10
5815;Pagrandukas;Bitutės;1654566158;Taip;0;0;4;4
5816;Pagrandukas;Bitutės;44029972943;Taip;0;0;1;1
5817;Pagrandukas;Bitutės;47836927832;Taip;0;0;3;3
5818;Pagrandukas;Bitutės;1707429884;Taip;0;2;3;5
5819;Pagrandukas;Bitutės;91591094393;Ne;0;1;1;2
5820;Pagrandukas;Bitutės;6585880191;Taip;0;0;1;1
5821;Pagrandukas;Bitutės;1503479321;Ne;6;0;0;6
5822;Pagrandukas;Bitutės;9313380552;Ne;1;1;1;3
5823;Pagrandukas;Bitutės;51982253355;Taip;0;6;0;6
5824;Pagrandukas;Bitutės;73259512452;Taip;0;10;0;10
5825;Pagrandukas;Bitutės;80939233319;Taip;0;10;0;10
5826;Pagrandukas;Bitutės;6044667668;Taip;0;0;4;4
5827;Pagrandukas;Bitutės;3227066520;Taip;6;0;0;6
5828;Pagrandukas;Bitutės;1813676320;Taip;0;0;1;1
5829;Pagrandukas;Bitutės;57471531440;Taip;0;12;0;12
5830;Pagrandukas;Bitutės;6315627367;Taip;3;0;0;3
5831;Pagrandukas;Bitutės;8529974367;Taip;0;10;1;11
5832;Pagrandukas;Bitutės;4079711515;Ne;4;1;3;8
5833;Pagrandukas;Pelėdžiukai;21409116617;Taip;1;4;0;5
5834;Pagrandukas;Pelėdžiukai;1590309916;Taip;0;2;0;2
5835;Pagrandukas;Pelėdžiukai;1964310988;Taip;0;2;0;2
5836;Pagrandukas;Pelėdžiukai;44044284874;Taip;8;4;0;12
5837;Pagrandukas;Pelėdžiukai;2066377478;Taip;7;0;7;14
5838;Pagrandukas;Pelėdžiukai;1189453012;Taip;0;4;0;4
5839;Pagrandukas;Pelėdžiukai;43539883053;Taip;0;1;0;1
5840;Pagrandukas;Pelėdžiukai;6364473206;Taip;0;7;3;10
5841;Pagrandukas;Pelėdžiukai;33909593470;Taip;0;4;4;8
5842;Pagrandukas;Pelėdžiukai;7751376696;Taip;0;1;0;1
5843;Pagrandukas;Pelėdžiukai;5818020587;Taip;0;0;1;1
5844;Pagrandukas;Pelėdžiukai;21544489661;Taip;0;1;0;1
5845;Pagrandukas;Pelėdžiukai;93036151205;Taip;0;1;0;1
5846;Pagrandukas;Pelėdžiukai;1232460221;Taip;7;0;0;7
5847;Pagrandukas;Pelėdžiukai;1451503127;Taip;7;0;0;7
5848;Pagrandukas;Žvaigždutė;1904462840;Taip;0;13;0;13
5849;Pagrandukas;Žvaigždutė;75080308291;Taip;0;8;0;8
5850;Pagrandukas;Žvaigždutė;7876029445;Ne;0;13;0;13
5851;Pagrandukas;Žvaigždutė;1313716840;Taip;0;5;0;5
5852;Pagrandukas;Žvaigždutė;14043704729;Taip;0;1;14;15
5853;Pagrandukas;Žvaigždutė;51692261484;Ne;0;5;0;5
5854;Pagrandukas;Žvaigždutė;35830862363;Ne;0;2;0;2
5855;Pagrandukas;Žvaigždutė;2079943643;Ne;0;1;0;1
5856;Pagrandukas;Žvaigždutė;2923517578;Taip;4;1;0;5
5857;Pagrandukas;Žvaigždutė;4724383814;Taip;6;2;0;8
5858;Pagrandukas;Žvaigždutė;7782678159;Ne;5;1;0;6
5859;Pagrandukas;Žvaigždutė;8879549409;Taip;0;8;0;8
5860;Pagrandukas;Žvaigždutė;6299298199;Taip;0;1;0;1
5861;Pagrandukas;Žvaigždutė;7543795007;Taip;0;7;0;7
5862;Pagrandukas;Žvaigždutė;3860781857;Taip;0;5;0;5
5863;Pagrandukas;Žvaigždutė;24287759126;Taip;7;11;0;18
5864;Pagrandukas;Žvaigždutė;2461803626;Ne;6;1;1;8
5865;Pagrandukas;Žvaigždutė;1376514473;Taip;0;5;0;5
5866;Pakalnutė;Pagrandukai;86458592440;Taip;3;0;0;3
5867;Pakalnutė;Pagrandukai;85764245101;Taip;0;0;1;1
5868;Pakalnutė;Pagrandukai;57463392902;Taip;2;0;0;2
5869;Pakalnutė;Pagrandukai;7535589010;Ne;0;0;3;3
5870;Pakalnutė;Pagrandukai;1210432627;Taip;0;8;0;8
5871;Pakalnutė;Pagrandukai;3987920952;Ne;0;10;0;10
5872;Pakalnutė;Pagrandukai;28398386463;Taip;0;10;0;10
5873;Pakalnutė;Pagrandukai;1970792910;Ne;9;0;0;9
5874;Pakalnutė;"Pelėdžiukų ";7110858765;Taip;10;0;2;12
5875;Pakalnutė;"Pelėdžiukų ";8553182620;Ne;9;0;1;10
5876;Pakalnutė;"Pelėdžiukų ";3840499737;Taip;4;5;0;9
5877;Pakalnutė;"Pelėdžiukų ";4523766424;Taip;9;1;1;11
5878;Pakalnutė;"Pelėdžiukų ";6577255841;Ne;6;0;1;7
5879;Pakalnutė;"Pelėdžiukų ";7151877991;Taip;10;5;0;15
5880;Pakalnutė;"Pelėdžiukų ";2992768162;Taip;0;18;0;18
5881;Pakalnutė;"Pelėdžiukų ";9505524183;Taip;9;0;2;11
5882;Pakalnutė;"Pelėdžiukų ";3792697409;Taip;3;0;0;3
5883;Pakalnutė;"Pelėdžiukų ";8823232039;Taip;7;3;0;10
5884;Pakalnutė;"Pelėdžiukų ";8900756351;Taip;6;0;1;7
5885;Pakalnutė;"Pelėdžiukų ";2035060922;Ne;3;0;0;3
5886;Pakalnutė;"Pelėdžiukų ";4220368864;Ne;3;1;0;4
5887;Pakalnutė;"Pelėdžiukų ";1330092247;Taip;0;12;3;15
5888;Pakalnutė;"Pelėdžiukų ";3267680599;Ne;0;3;0;3
5889;Pakalnutė;"Pelėdžiukų ";3365726271;Ne;4;0;0;4
5890;Pakalnutė;"Pelėdžiukų ";4452372238;Taip;5;0;2;7
5891;Pakalnutė;Ežiukai;5058727058;Taip;12;0;0;12
5892;Pakalnutė;Ežiukai;2714905466;Taip;8;0;5;13
5893;Pakalnutė;Ežiukai;4052166895;Taip;6;0;0;6
5894;Pakalnutė;Ežiukai;7962849592;Taip;0;1;0;1
5895;Pakalnutė;Ežiukai;1070172991;Taip;0;0;3;3
5896;Pakalnutė;Ežiukai;3660195990;Taip;4;18;0;22
5897;Pakalnutė;Ežiukai;9323200833;Taip;2;0;0;2
5898;Pakalnutė;Ežiukai;4153294595;Taip;12;0;0;12
5899;Pakalnutė;Ežiukai;7477188659;Taip;8;1;0;9
5900;Pakalnutė;Ežiukai;8155327668;Taip;10;0;0;10
5901;Pakalnutė;Ežiukai;9781993614;Taip;8;0;0;8
5902;Pakalnutė;Ežiukai;7853479591;Ne;9;0;0;9
5903;Pakalnutė;Ežiukai;4747688220;Taip;6;0;2;8
5904;Pakalnutė;Ežiukai;1355954767;Taip;6;0;1;7
5905;Pakalnutė;Ežiukai;4317305712;Taip;5;0;0;5
5906;Pakalnutė;Skruzdėliukų;4033813807;Taip;2;0;0;2
5907;Pakalnutė;Skruzdėliukų;9382160515;Taip;0;1;0;1
5908;Pakalnutė;Skruzdėliukų;5409476517;Taip;0;17;0;17
5909;Pakalnutė;Skruzdėliukų;2670302354;Taip;15;0;0;15
5910;Pakalnutė;Skruzdėliukų;7105369111;Taip;15;0;0;15
5911;Pakalnutė;Skruzdėliukų;6944726166;Ne;10;0;0;10
5912;Pakalnutė;Skruzdėliukų;1195872320;Taip;14;0;0;14
5913;Pakalnutė;Skruzdėliukų;3211633472;Taip;3;1;0;4
5914;Pakalnutė;Skruzdėliukų;4423348418;Taip;4;1;0;5
5915;Pakalnutė;Skruzdėliukų;6934760468;Taip;11;0;0;11
5916;Pakalnutė;Skruzdėliukų;5911381706;Taip;0;2;0;2
5917;Pakalnutė;Skruzdėliukų;8797870379;Taip;12;6;0;18
5918;Pakalnutė;Skruzdėliukų;6055727963;Taip;0;1;0;1
5919;Pakalnutė;Skruzdėliukų;2723284353;Ne;0;4;0;4
5920;Pakalnutė;Bitučių;2993145079;Taip;0;8;0;8
5921;Pakalnutė;Bitučių;2765220889;Ne;0;1;0;1
5922;Pakalnutė;Bitučių;9445909071;Ne;0;0;2;2
5923;Pakalnutė;Bitučių;5532458706;Taip;0;7;0;7
5924;Pakalnutė;Bitučių;7526989580;Taip;5;0;0;5
5925;Pakalnutė;Bitučių;5941955322;Taip;0;2;0;2
5926;Pakalnutė;Bitučių;2095540372;Taip;6;2;1;9
5927;Pakalnutė;Bitučių;5342592825;Taip;0;5;0;5
5928;Pakalnutė;Bitučių;1238121406;Taip;0;0;2;2
5929;Pakalnutė;Bitučių;6117542654;Ne;22;0;0;22
5930;Pakalnutė;Bitučių;5464143742;Taip;0;8;0;8
5931;Pakalnutė;Bitučių;6351193702;Ne;0;0;2;2
5932;Pakalnutė;Bitučių;2070744110;Taip;0;8;0;8
5933;Pakalnutė;Bitučių;9365592664;Taip;0;5;2;7
5934;Pakalnutė;Bitučių;5355198213;Taip;0;0;1;1
5935;Pakalnutė;Boružiukų;7357431226;Taip;8;3;0;11
5936;Pakalnutė;Boružiukų;5039000154;Taip;0;11;0;11
5937;Pakalnutė;Boružiukų;6575909478;Taip;0;8;1;9
5938;Pakalnutė;Boružiukų;7223747714;Taip;3;0;0;3
5939;Pakalnutė;Boružiukų;2835611316;Taip;0;0;1;1
5940;Pakalnutė;Boružiukų;7439220341;Taip;14;0;3;17
5941;Pakalnutė;Boružiukų;4950195858;Taip;4;0;0;4
5942;Pakalnutė;Boružiukų;1870528568;Taip;6;0;2;8
5943;Pakalnutė;Boružiukų;6557165567;Ne;8;7;0;15
5944;Pakalnutė;Boružiukų;3677709759;Taip;4;7;4;15
5945;Pakalnutė;Boružiukų;2597900983;Taip;19;0;1;20
5946;Pakalnutė;Boružiukų;2062721289;Ne;9;0;0;9
5947;Pakalnutė;Boružiukų;1340022702;Ne;9;13;0;22
5948;Pakalnutė;Boružiukų;4550819172;Ne;14;4;0;18
5949;Pakalnutė;Meškiukų;64706392096;Ne;5;2;0;7
5950;Pakalnutė;Meškiukų;2202341545;Taip;0;1;0;1
5951;Pakalnutė;Meškiukų;9355380341;Taip;15;0;0;15
5952;Pakalnutė;Meškiukų;7324846434;Taip;0;2;0;2
5953;Pakalnutė;Meškiukų;1396367371;Taip;6;0;1;7
5954;Pakalnutė;Meškiukų;4256222944;Taip;0;5;0;5
5955;Pakalnutė;Meškiukų;6194464236;Taip;0;0;1;1
5956;Pakalnutė;Meškiukų;7659209862;Taip;20;0;0;20
5957;Pakalnutė;Meškiukų;2101821362;Taip;5;3;0;8
5958;Pakalnutė;Meškiukų;2755412687;Taip;0;13;0;13
5959;Pakalnutė;Meškiukų;4533467194;Ne;9;1;0;10
5960;Pakalnutė;Nykštukai;6769352325;Taip;0;0;4;4
5961;Pakalnutė;Nykštukai;1202301707;Ne;8;0;0;8
5962;Pakalnutė;Nykštukai;72137985328;Taip;0;0;2;2
5963;Pakalnutė;Nykštukai;11183301096;Taip;0;1;0;1
5964;Pakalnutė;Nykštukai;19773872429;Taip;0;10;0;10
5965;Pakalnutė;Nykštukai;85900847069;Taip;6;0;0;6
5966;Pakalnutė;Nykštukai;7389600659;Taip;4;0;0;4
5967;Pakalnutė;Nykštukai;5309195407;Taip;0;11;0;11
5968;Pakalnutė;Nykštukai;1849396954;Taip;11;0;0;11
5969;Pakalnutė;Nykštukai;99344331316;Taip;3;1;0;4
5970;Pakalnutė;Nykštukai;33667858388;Taip;0;10;0;10
5971;Pakalnutė;Nykštukai;2815093249;Ne;4;0;0;4
5972;Pakalnutė;Nykštukai;1372722843;Taip;0;1;0;1
5973;Pakalnutė;Nykštukai;61712002384;Taip;4;6;0;10
5974;Pakalnutė;"Zuikučių ";1198230323;Taip;0;0;2;2
5975;Pakalnutė;"Zuikučių ";6016791282;Taip;1;0;1;2
5976;Pakalnutė;"Zuikučių ";3609982613;Ne;11;2;1;14
5977;Pakalnutė;"Zuikučių ";5958653847;Taip;4;1;0;5
5978;Pakalnutė;"Zuikučių ";8513260520;Taip;7;0;0;7
5979;Pakalnutė;"Zuikučių ";2159430356;Taip;0;0;1;1
5980;Pakalnutė;"Zuikučių ";1147843795;Taip;0;0;1;1
5981;Pakalnutė;"Zuikučių ";6879558965;Taip;0;8;1;9
5982;Pakalnutė;"Zuikučių ";3555822605;Taip;0;0;1;1
5983;Pakalnutė;"Zuikučių ";7563201788;Taip;0;7;0;7
5984;Pakalnutė;"Zuikučių ";1583462733;Taip;0;0;1;1
5985;Pakalnutė;"Zuikučių ";6377564215;Taip;0;0;1;1
5986;Pakalnutė;"Zuikučių ";1610847242;Taip;0;3;0;3
5987;Pakalnutė;"Zuikučių ";8813262660;Ne;16;0;0;16
5988;Pakalnutė;"Zuikučių ";5102345686;Taip;0;0;1;1
5989;Pakalnutė;"Zuikučių ";7949588551;Ne;8;3;0;11
5990;Pakalnutė;"Zuikučių ";81578522887;Ne;5;0;0;5
5991;Pakalnutė;"Zuikučių ";5949298584;Taip;9;3;0;12
5992;Pakalnutė;"Zuikučių ";2002555659;Taip;0;0;2;2
5993;Pakalnutė;"Drugelių ";4046820545;Taip;0;11;0;11
5994;Pakalnutė;"Drugelių ";5973972464;Taip;4;0;2;6
5995;Pakalnutė;"Drugelių ";4742424647;Taip;0;0;2;2
5996;Pakalnutė;"Drugelių ";2075865543;Taip;0;0;1;1
5997;Pakalnutė;"Drugelių ";9562957603;Taip;0;2;0;2
5998;Pakalnutė;"Drugelių ";5435336235;Taip;0;1;3;4
5999;Pakalnutė;"Drugelių ";2050880681;Taip;3;0;1;4
6000;Pakalnutė;"Drugelių ";4514642887;Ne;22;0;0;22
6001;Pakalnutė;"Drugelių ";80818670065;Taip;9;1;2;12
6002;Pakalnutė;"Drugelių ";2049079012;Taip;0;14;0;14
6003;Pakalnutė;"Drugelių ";4681267749;Taip;7;4;0;11
6004;Pakalnutė;"Drugelių ";85356812538;Taip;8;0;0;8
6005;Pakalnutė;"Drugelių ";6771510589;Taip;0;0;5;5
6006;Pakalnutė;"Drugelių ";58670351468;Ne;0;0;7;7
6007;Pakalnutė;"Drugelių ";2901031642;Taip;5;2;1;8
6008;Pakalnutė;"Drugelių ";65174922062;Ne;0;0;3;3
6009;Panerių;Rūtelė;81949147104;Taip;0;0;2;2
6010;Panerių;Rūtelė;21661667266;Ne;0;0;9;9
6011;Panerių;Rūtelė;68313730462;Ne;4;0;1;5
6012;Panerių;Rūtelė;84672957234;Ne;0;8;0;8
6013;Panerių;Rūtelė;60738239005;Ne;8;0;1;9
6014;Panerių;Rūtelė;1017100748;Taip;8;3;0;11
6015;Panerių;Rūtelė;68231938043;Ne;0;0;5;5
6016;Panerių;Rūtelė;78838685571;Taip;0;0;12;12
6017;Panerių;Rūtelė;8666159951;Taip;0;0;2;2
6018;Panerių;Rūtelė;7753488216;Ne;4;0;0;4
6019;Panerių;Rūtelė;6227583229;Ne;0;0;9;9
6020;Panerių;Rūtelė;1303873524;Ne;0;0;5;5
6021;Panerių;Rūtelė;75034220223;Ne;3;0;1;4
6022;Panerių;Rūtelė;2069150261;Taip;6;7;0;13
6023;Panerių;Rūtelė;18963190527;Ne;0;0;2;2
6024;Panerių;Rūtelė;2786775879;Ne;0;9;0;9
6025;Panerių;Rūtelė;9004468035;Taip;5;0;1;6
6026;Panerių;Gėlytės;9268558715;Taip;22;0;0;22
6027;Panerių;Gėlytės;9604335101;Ne;15;0;0;15
6028;Panerių;Gėlytės;1066011221;Taip;0;5;5;10
6029;Panerių;Gėlytės;3843500717;Ne;0;0;1;1
6030;Panerių;Gėlytės;9639587601;Ne;0;1;0;1
6031;Panerių;Gėlytės;5001921323;Taip;0;4;0;4
6032;Panerių;Gėlytės;2608386063;Taip;0;5;8;13
6033;Panerių;Gėlytės;2195332401;Ne;3;0;0;3
6034;Panerių;Gėlytės;4023257875;Ne;0;0;3;3
6035;Panerių;Gėlytės;4689913361;Ne;3;0;0;3
6036;Panerių;Gėlytės;6182126113;Ne;0;8;0;8
6037;Panerių;Gėlytės;2571561865;Ne;0;9;0;9
6038;Panerių;Gėlytės;6908487075;Ne;0;0;4;4
6039;Panerių;Gėlytės;6411372006;Taip;0;21;1;22
6040;Panerių;Boružė;3190117304;Taip;5;5;0;10
6041;Panerių;Boružė;6583134855;Ne;0;1;0;1
6042;Panerių;Boružė;4646173276;Ne;16;0;0;16
6043;Panerių;Boružė;3913395809;Ne;15;0;7;22
6044;Panerių;Boružė;8514805919;Ne;7;0;5;12
6045;Panerių;Boružė;4867297993;Ne;0;0;2;2
6046;Panerių;Boružė;9630302749;Ne;8;0;9;17
6047;Panerių;Boružė;2308739823;Taip;7;0;0;7
6048;Panerių;Boružė;9631684972;Ne;0;0;3;3
6049;Panerių;Boružė;3057714143;Ne;0;7;0;7
6050;Panerių;Boružė;9506008651;Taip;13;0;5;18
6051;Panerių;Boružė;8693113275;Taip;19;0;0;19
6052;Panerių;Boružė;2235123048;Ne;15;0;0;15
6053;Panerių;Boružė;5861312413;Ne;13;1;0;14
6054;Papartis;ZUIKUČIAI;1065234123;Taip;4;0;3;7
6055;Papartis;ZUIKUČIAI;27900855758;Taip;3;0;1;4
6056;Papartis;ZUIKUČIAI;1219140467;Taip;0;1;0;1
6057;Papartis;ZUIKUČIAI;1260151691;Taip;0;5;0;5
6058;Papartis;ZUIKUČIAI;2412700197;Taip;9;0;1;10
6059;Papartis;ZUIKUČIAI;7703070601;Taip;0;3;0;3
6060;Papartis;ZUIKUČIAI;7902130389;Taip;0;5;1;6
6061;Papartis;ZUIKUČIAI;4992305227;Taip;6;1;1;8
6062;Papartis;ZUIKUČIAI;4346817695;Taip;7;0;1;8
6063;Papartis;ZUIKUČIAI;2447926422;Taip;0;3;0;3
6064;Papartis;ZUIKUČIAI;3182457453;Taip;14;0;0;14
6065;Papartis;ZUIKUČIAI;3275123842;Taip;0;3;0;3
6066;Papartis;ZUIKUČIAI;8190458132;Taip;16;1;0;17
6067;Papartis;ZUIKUČIAI;8952917454;Taip;4;1;8;13
6068;Papartis;ZUIKUČIAI;5410369044;Taip;15;2;0;17
6069;Papartis;ZUIKUČIAI;6126912448;Taip;0;7;0;7
6070;Papartis;ZUIKUČIAI;5675537250;Ne;6;0;0;6
6071;Papartis;ZUIKUČIAI;1065128993;Ne;0;2;1;3
6072;Papartis;ZUIKUČIAI;3895487270;Taip;5;6;0;11
6073;Papartis;ZUIKUČIAI;1527263538;Taip;0;2;3;5
6074;Papartis;DRUGELIAI;4508053349;Taip;4;1;0;5
6075;Papartis;DRUGELIAI;7387281720;Taip;4;3;0;7
6076;Papartis;DRUGELIAI;3243869451;Ne;8;0;0;8
6077;Papartis;DRUGELIAI;2778629398;Taip;12;1;1;14
6078;Papartis;DRUGELIAI;3475745012;Ne;9;0;7;16
6079;Papartis;DRUGELIAI;2535412635;Taip;14;0;2;16
6080;Papartis;DRUGELIAI;6797687614;Ne;7;0;6;13
6081;Papartis;DRUGELIAI;7606939822;Taip;6;0;0;6
6082;Papartis;DRUGELIAI;9719465384;Ne;8;0;0;8
6083;Papartis;DRUGELIAI;8148483438;Taip;8;0;3;11
6084;Papartis;DRUGELIAI;5265293240;Taip;17;0;0;17
6085;Papartis;DRUGELIAI;7590170146;Taip;8;0;0;8
6086;Papartis;DRUGELIAI;9134335737;Taip;17;0;0;17
6087;Papartis;DRUGELIAI;1836914270;Taip;1;0;0;1
6088;Papartis;DRUGELIAI;4935694347;Ne;10;0;0;10
6089;Papartis;DRUGELIAI;1672028156;Ne;0;2;3;5
6090;Papartis;DRUGELIAI;4634683589;Taip;9;2;0;11
6091;Papartis;DRUGELIAI;3267416367;Taip;4;0;0;4
6092;Papartis;DRUGELIAI;3107106078;Taip;5;1;0;6
6093;Papartis;DRUGELIAI;1205854439;Ne;9;0;3;12
6094;Papartis;DRUGELIAI;7067369268;Taip;18;0;2;20
6095;Papartis;DRUGELIAI;6746279237;Taip;0;0;22;22
6096;Papartis;DRUGELIAI;42803013754;Taip;0;1;2;3
6097;Papartis;ŽVIRBLIUKAI;19544040390;Ne;7;0;1;8
6098;Papartis;ŽVIRBLIUKAI;32352993438;Taip;0;3;0;3
6099;Papartis;ŽVIRBLIUKAI;67237428983;Taip;0;0;3;3
6100;Papartis;ŽVIRBLIUKAI;89486863055;Taip;0;0;1;1
6101;Papartis;ŽVIRBLIUKAI;20002349512;Taip;4;0;0;4
6102;Papartis;ŽVIRBLIUKAI;4139884005;Ne;0;1;5;6
6103;Papartis;ŽVIRBLIUKAI;81734271362;Taip;6;0;0;6
6104;Papartis;ŽVIRBLIUKAI;87519747220;Ne;0;0;7;7
6105;Papartis;ŽVIRBLIUKAI;87353511647;Taip;0;0;1;1
6106;Papartis;ŽVIRBLIUKAI;25990216006;Taip;0;8;0;8
6107;Papartis;ŽVIRBLIUKAI;26912851152;Taip;5;4;0;9
6108;Papartis;ŽVIRBLIUKAI;60706816641;Taip;0;0;6;6
6109;Papartis;ŽVIRBLIUKAI;77686722867;Taip;0;0;4;4
6110;Papartis;ŽVIRBLIUKAI;1973027294;Taip;0;14;3;17
6111;Papartis;ŽVIRBLIUKAI;1403114386;Taip;0;1;2;3
6112;Papartis;ŽVIRBLIUKAI;2146286089;Taip;4;0;0;4
6113;Papartis;ŽVIRBLIUKAI;7308118576;Taip;5;0;4;9
6114;Papartis;ŽVIRBLIUKAI;45289621684;Taip;0;5;0;5
6115;Papartis;PELĖDŽIUKAI;9038083652;Ne;5;0;0;5
6116;Papartis;PELĖDŽIUKAI;37759125130;Ne;17;0;1;18
6117;Papartis;PELĖDŽIUKAI;20862839950;Taip;0;0;2;2
6118;Papartis;PELĖDŽIUKAI;8564913801;Taip;0;0;2;2
6119;Papartis;PELĖDŽIUKAI;84260015363;Taip;0;1;1;2
6120;Papartis;PELĖDŽIUKAI;67226404925;Taip;17;0;1;18
6121;Papartis;PELĖDŽIUKAI;41330436046;Taip;0;1;0;1
6122;Papartis;PELĖDŽIUKAI;83927324420;Taip;0;2;0;2
6123;Papartis;PELĖDŽIUKAI;93141801552;Taip;10;0;0;10
6124;Papartis;PELĖDŽIUKAI;81006952163;Taip;5;7;0;12
6125;Papartis;PELĖDŽIUKAI;8593823543;Taip;0;0;2;2
6126;Papartis;PELĖDŽIUKAI;1727771667;Taip;0;0;3;3
6127;Papartis;PELĖDŽIUKAI;18164175829;Taip;0;0;8;8
6128;Papartis;PELĖDŽIUKAI;1045629158;Taip;0;0;1;1
6129;Papartis;PELĖDŽIUKAI;1903219436;Ne;0;0;2;2
6130;Papartis;PELĖDŽIUKAI;8958062862;Taip;7;0;1;8
6131;Papartis;SAULUTĖS;2022533158;Taip;4;0;0;4
6132;Papartis;SAULUTĖS;1246604915;Taip;0;3;1;4
6133;Papartis;SAULUTĖS;48182233276;Taip;0;0;1;1
6134;Papartis;SAULUTĖS;18124337938;Taip;8;1;2;11
6135;Papartis;SAULUTĖS;30982681803;Taip;15;1;0;16
6136;Papartis;SAULUTĖS;95139517078;Taip;7;5;0;12
6137;Papartis;SAULUTĖS;55573140983;Taip;22;0;0;22
6138;Papartis;SAULUTĖS;50090482473;Taip;4;0;0;4
6139;Papartis;SAULUTĖS;10078570352;Taip;0;0;2;2
6140;Papartis;SAULUTĖS;88700503601;Taip;5;0;1;6
6141;Papartis;SAULUTĖS;15207322802;Taip;0;3;0;3
6142;Papartis;SAULUTĖS;2115718328;Ne;5;0;0;5
6143;Papartis;SAULUTĖS;1159368221;Ne;22;0;0;22
6144;Papartis;SAULUTĖS;67966766974;Taip;0;1;0;1
6145;Papartis;SAULUTĖS;50658624766;Ne;15;3;0;18
6146;Papartis;SAULUTĖS;79080758672;Ne;0;3;0;3
6147;Papartis;GANDRIUKAI;4878190663;Taip;0;3;0;3
6148;Papartis;GANDRIUKAI;8946678515;Taip;0;0;3;3
6149;Papartis;GANDRIUKAI;2783708905;Taip;0;0;4;4
6150;Papartis;GANDRIUKAI;6883101103;Taip;3;0;0;3
6151;Papartis;GANDRIUKAI;2868899342;Taip;2;0;0;2
6152;Papartis;GANDRIUKAI;7768672610;Ne;0;5;0;5
6153;Papartis;GANDRIUKAI;9384670351;Taip;4;2;0;6
6154;Papartis;GANDRIUKAI;9968072478;Ne;4;1;1;6
6155;Papartis;GANDRIUKAI;2215846642;Taip;11;1;1;13
6156;Papartis;GANDRIUKAI;3320524073;Taip;9;1;1;11
6157;Papartis;GANDRIUKAI;9804863902;Taip;0;9;0;9
6158;Papartis;GANDRIUKAI;1974159967;Taip;0;5;0;5
6159;Papartis;GANDRIUKAI;5732853976;Taip;5;0;2;7
6160;Papartis;GANDRIUKAI;7859096984;Taip;0;5;0;5
6161;Papartis;GANDRIUKAI;7252265838;Taip;0;2;0;2
6162;Papartis;GANDRIUKAI;4279580382;Taip;0;5;0;5
6163;Papartis;GANDRIUKAI;9978625382;Ne;15;1;0;16
6164;Papartis;AITVARELIAI;82454730189;Taip;3;1;0;4
6165;Papartis;AITVARELIAI;2398385967;Taip;3;0;0;3
6166;Papartis;AITVARELIAI;2889259605;Taip;5;0;1;6
6167;Papartis;AITVARELIAI;89525856173;Taip;0;1;0;1
6168;Papartis;AITVARELIAI;1406820323;Taip;0;2;0;2
6169;Papartis;AITVARELIAI;2092191603;Taip;5;2;0;7
6170;Papartis;AITVARELIAI;10659508171;Taip;0;2;2;4
6171;Papartis;AITVARELIAI;2067304804;Taip;0;4;0;4
6172;Papartis;AITVARELIAI;88418552221;Taip;0;4;0;4
6173;Papartis;AITVARELIAI;51899025231;Taip;0;2;0;2
6174;Papartis;AITVARELIAI;1322826573;Taip;0;4;1;5
6175;Papartis;AITVARELIAI;88722771438;Taip;7;1;2;10
6176;Papartis;AITVARELIAI;74734443304;Taip;0;5;0;5
6177;Papartis;AITVARELIAI;63087155760;Ne;0;5;0;5
6178;Papartis;AITVARELIAI;68478260102;Ne;0;9;0;9
6179;Papartis;SMALSUČIAI;6266095782;Taip;3;0;0;3
6180;Papartis;SMALSUČIAI;3054883426;Taip;11;0;0;11
6181;Papartis;SMALSUČIAI;1191546794;Ne;8;0;2;10
6182;Papartis;SMALSUČIAI;8447326505;Ne;0;1;3;4
6183;Papartis;SMALSUČIAI;1919362027;Taip;14;0;0;14
6184;Papartis;SMALSUČIAI;9375751990;Taip;0;11;0;11
6185;Papartis;SMALSUČIAI;5786648402;Ne;7;1;0;8
6186;Papartis;SMALSUČIAI;5776038830;Taip;7;0;1;8
6187;Papartis;SMALSUČIAI;8808902528;Taip;5;0;0;5
6188;Papartis;SMALSUČIAI;9358310527;Taip;14;2;0;16
6189;Papartis;SMALSUČIAI;5361925390;Taip;9;0;0;9
6190;Papartis;SMALSUČIAI;4906248064;Taip;0;9;0;9
6191;Papartis;SMALSUČIAI;4640068595;Ne;12;0;0;12
6192;Papartis;SMALSUČIAI;5579899922;Taip;4;2;0;6
6193;Papartis;"ŽIRNIUKAI ";44833872631;Ne;0;5;0;5
6194;Papartis;"ŽIRNIUKAI ";12406782910;Taip;0;4;1;5
6195;Papartis;"ŽIRNIUKAI ";1271303103;Taip;12;0;0;12
6196;Papartis;"ŽIRNIUKAI ";7845277151;Taip;0;9;0;9
6197;Papartis;"ŽIRNIUKAI ";30041894006;Taip;0;0;8;8
6198;Papartis;"ŽIRNIUKAI ";3630377970;Taip;18;0;2;20
6199;Papartis;"ŽIRNIUKAI ";38896771062;Taip;0;0;2;2
6200;Papartis;"ŽIRNIUKAI ";29789530287;Taip;0;0;4;4
6201;Papartis;"ŽIRNIUKAI ";51588027659;Taip;3;3;0;6
6202;Papartis;"ŽIRNIUKAI ";1703232380;Taip;0;10;0;10
6203;Papartis;"ŽIRNIUKAI ";64345875780;Ne;0;1;0;1
6204;Papartis;"ŽIRNIUKAI ";2598688561;Taip;8;0;0;8
6205;Papartis;"ŽIRNIUKAI ";53040207725;Taip;0;13;0;13
6206;Papartis;"ŽIRNIUKAI ";3991709974;Taip;0;6;0;6
6207;Papartis;"ŽIRNIUKAI ";3367009621;Taip;6;0;0;6
6208;Papartis;"ŽIRNIUKAI ";3408756311;Taip;0;0;12;12
6209;Papartis;BORUŽĖLĖS;4918854899;Taip;0;6;0;6
6210;Papartis;BORUŽĖLĖS;6889782462;Taip;0;0;4;4
6211;Papartis;BORUŽĖLĖS;5252947502;Taip;4;6;0;10
6212;Papartis;BORUŽĖLĖS;4261270064;Taip;8;1;0;9
6213;Papartis;BORUŽĖLĖS;6136213985;Taip;8;0;0;8
6214;Papartis;BORUŽĖLĖS;7107692314;Taip;8;0;0;8
6215;Papartis;BORUŽĖLĖS;5736456872;Taip;12;2;0;14
6216;Papartis;BORUŽĖLĖS;3040269026;Taip;12;2;0;14
6217;Papartis;BORUŽĖLĖS;8891856856;Taip;0;5;0;5
6218;Papartis;BORUŽĖLĖS;8532558577;Taip;0;1;0;1
6219;Papartis;BORUŽĖLĖS;1916222143;Taip;5;0;0;5
6220;Papartis;BORUŽĖLĖS;3100013570;Taip;0;0;7;7
6221;Papartis;BORUŽĖLĖS;6416605464;Taip;7;0;0;7
6222;Papartis;BORUŽĖLĖS;7803854703;Taip;0;3;0;3
6223;Papartis;VARPELIAI;6585372451;Taip;9;0;5;14
6224;Papartis;VARPELIAI;6977513472;Ne;6;0;3;9
6225;Papartis;VARPELIAI;5070767260;Taip;8;0;1;9
6226;Papartis;VARPELIAI;3595627659;Taip;0;0;1;1
6227;Papartis;VARPELIAI;1231594320;Taip;0;0;6;6
6228;Papartis;VARPELIAI;6734567714;Taip;0;0;1;1
6229;Papartis;VARPELIAI;4570512336;Taip;15;0;1;16
6230;Papartis;VARPELIAI;5538433120;Taip;4;4;0;8
6231;Papartis;VARPELIAI;7619963429;Ne;7;1;0;8
6232;Papartis;VARPELIAI;2669085057;Taip;14;0;8;22
6233;Papartis;VARPELIAI;3209491491;Taip;0;7;0;7
6234;Papartis;VARPELIAI;6931780900;Taip;0;7;0;7
6235;Papartis;VARPELIAI;6346776139;Taip;0;4;2;6
6236;Papartis;VARPELIAI;8420752169;Taip;0;0;10;10
6237;Papartis;VARPELIAI;3539507686;Taip;7;0;0;7
6238;Papartis;NYKŠTUKAI;5652769035;Ne;3;5;2;10
6239;Papartis;NYKŠTUKAI;5942160584;Taip;8;0;0;8
6240;Papartis;NYKŠTUKAI;9922091482;Ne;18;0;0;18
6241;Papartis;NYKŠTUKAI;1680412204;Taip;15;0;0;15
6242;Papartis;NYKŠTUKAI;9285319899;Taip;0;0;1;1
6243;Papartis;NYKŠTUKAI;6949120693;Taip;14;0;0;14
6244;Papartis;NYKŠTUKAI;6794076631;Taip;20;0;0;20
6245;Papartis;NYKŠTUKAI;5957889361;Taip;2;0;0;2
6246;Papartis;NYKŠTUKAI;5608868738;Ne;0;9;0;9
6247;Papartis;NYKŠTUKAI;4203241118;Taip;6;0;0;6
6248;Papartis;NYKŠTUKAI;4806652727;Taip;0;3;0;3
6249;Papartis;NYKŠTUKAI;9939850340;Taip;0;3;0;3
6250;Papartis;NYKŠTUKAI;3324647852;Taip;19;0;0;19
6251;Papartis;NYKŠTUKAI;6423401656;Ne;1;0;1;2
6252;Papartis;NYKŠTUKAI;8932290803;Taip;4;14;0;18
6253;Papartis;NYKŠTUKAI;5652560002;Taip;16;0;0;16
6254;Papartis;NYKŠTUKAI;1559196767;Taip;0;0;3;3
6255;Papartis;NYKŠTUKAI;6360881137;Ne;15;0;0;15
6256;Pasaka;Drugelių;19053961847;Ne;0;12;0;12
6257;Pasaka;Drugelių;60248064750;Taip;0;0;8;8
6258;Pasaka;Drugelių;18135410695;Taip;9;1;5;15
6259;Pasaka;Drugelių;1237568934;Taip;0;0;8;8
6260;Pasaka;Drugelių;37149227316;Taip;0;1;4;5
6261;Pasaka;Drugelių;57075224058;Taip;0;1;0;1
6262;Pasaka;Drugelių;66315088164;Ne;0;1;4;5
6263;Pasaka;Drugelių;2063660647;Taip;2;0;0;2
6264;Pasaka;Drugelių;44488699090;Taip;0;1;0;1
6265;Pasaka;Drugelių;5459272292;Taip;0;1;3;4
6266;Pasaka;Drugelių;53151161817;Taip;0;1;0;1
6267;Pasaka;Drugelių;55254934245;Taip;0;1;1;2
6268;Pasaka;Drugelių;2332865106;Ne;0;1;7;8
6269;Pasaka;Drugelių;6794437566;Ne;0;0;4;4
6270;Pasaka;Drugelių;5901704055;Ne;0;0;2;2
6271;Pasaka;Nykštukų;5665758011;Taip;5;0;0;5
6272;Pasaka;Nykštukų;8166051272;Taip;0;1;0;1
6273;Pasaka;Nykštukų;91546084785;Taip;6;2;5;13
6274;Pasaka;Nykštukų;7040953491;Taip;7;0;0;7
6275;Pasaka;Nykštukų;7546205285;Ne;7;1;0;8
6276;Pasaka;Nykštukų;5687494160;Taip;0;1;0;1
6277;Pasaka;Nykštukų;3088081091;Ne;3;2;0;5
6278;Pasaka;Nykštukų;6893044575;Ne;12;2;0;14
6279;Pasaka;Nykštukų;4071643754;Ne;11;2;0;13
6280;Pasaka;Nykštukų;3151916774;Taip;0;4;1;5
6281;Pasaka;Nykštukų;4773893970;Taip;11;2;0;13
6282;Pasaka;Nykštukų;5438303030;Ne;0;1;0;1
6283;Pasaka;Nykštukų;7455544922;Ne;4;2;1;7
6284;Pasaka;Nykštukų;1630083619;Taip;7;2;0;9
6285;Pasaka;Nykštukų;7290184771;Ne;0;2;0;2
6286;Pasaka;Nykštukų;5027755073;Taip;6;4;0;10
6287;Pasaka;Nykštukų;2874308781;Ne;0;13;0;13
6288;Pasaka;Nykštukų;4082752808;Taip;20;0;0;20
6289;Pasaka;Nykštukų;9418332784;Taip;10;0;0;10
6290;Pasaka;Montesori;31880975983;Taip;0;0;1;1
6291;Pasaka;Montesori;17311912868;Taip;0;0;8;8
6292;Pasaka;Montesori;69250064506;Taip;5;0;0;5
6293;Pasaka;Montesori;81598865451;Ne;0;0;1;1
6294;Pasaka;Montesori;16974081144;Taip;11;0;0;11
6295;Pasaka;Montesori;1514381003;Taip;9;0;1;10
6296;Pasaka;Montesori;8996941733;Taip;0;7;9;16
6297;Pasaka;Montesori;4608655313;Ne;10;0;0;10
6298;Pasaka;Montesori;93994995081;Taip;5;0;4;9
6299;Pasaka;Montesori;1961712475;Taip;2;0;0;2
6300;Pasaka;Montesori;4305485747;Taip;0;0;10;10
6301;Pasaka;Montesori;79460661793;Taip;0;7;0;7
6302;Pasaka;Montesori;8635400672;Ne;0;0;4;4
6303;Pasaka;Montesori;47140322803;Taip;0;0;2;2
6304;Pasaka;Montesori;7837662446;Taip;0;0;9;9
6305;Pasaka;Montesori;3047931231;Ne;0;0;6;6
6306;Pasaka;Žirniukų;17931259433;Ne;0;0;6;6
6307;Pasaka;Žirniukų;9722435751;Taip;0;5;0;5
6308;Pasaka;Žirniukų;7648503006;Ne;2;0;11;13
6309;Pasaka;Žirniukų;73703706115;Taip;3;1;3;7
6310;Pasaka;Žirniukų;2018620389;Taip;0;0;1;1
6311;Pasaka;Žirniukų;6441884677;Taip;0;2;1;3
6312;Pasaka;Žirniukų;5651452381;Taip;0;6;0;6
6313;Pasaka;Žirniukų;1720511696;Taip;8;0;0;8
6314;Pasaka;Žirniukų;1836826810;Ne;0;0;1;1
6315;Pasaka;Žirniukų;1826743229;Ne;2;0;0;2
6316;Pasaka;Žirniukų;9560190761;Ne;2;0;0;2
6317;Pasaka;Žirniukų;7286419663;Taip;0;0;2;2
6318;Pasaka;Žirniukų;2788679885;Taip;13;0;1;14
6319;Pasaka;Žirniukų;1565873178;Ne;15;0;2;17
6320;Pasaka;Žirniukų;2400455036;Ne;0;0;1;1
6321;Pasaka;Žirniukų;79170702319;Taip;0;0;4;4
6322;Pasaka;Žirniukų;5973028582;Taip;11;0;0;11
6323;Pasaka;Žirniukų;8963465320;Ne;4;2;0;6
6324;Pasaka;"Voveriukų ";15051078156;Ne;0;2;4;6
6325;Pasaka;"Voveriukų ";50319234551;Ne;0;7;0;7
6326;Pasaka;"Voveriukų ";53523660848;Ne;0;1;0;1
6327;Pasaka;"Voveriukų ";89376142045;Ne;3;0;0;3
6328;Pasaka;"Voveriukų ";1188769609;Ne;0;0;1;1
6329;Pasaka;"Voveriukų ";52135673503;Ne;0;2;8;10
6330;Pasaka;"Voveriukų ";59491538033;Ne;0;0;1;1
6331;Pasaka;"Voveriukų ";35718732394;Ne;0;1;0;1
6332;Pasaka;"Voveriukų ";61091610394;Taip;10;0;2;12
6333;Pasaka;"Voveriukų ";8122815158;Ne;0;0;1;1
6334;Pasaka;"Voveriukų ";1719236931;Taip;0;0;1;1
6335;Pasaka;"Voveriukų ";1257775317;Ne;6;0;0;6
6336;Pasaka;"Voveriukų ";1268530885;Taip;9;0;2;11
6337;Pasaka;"VALDOFRO 12";2141354232;Taip;0;0;2;2
6338;Pasaka;"VALDOFRO 12";4271029223;Taip;4;0;3;7
6339;Pasaka;"VALDOFRO 12";49627576872;Ne;5;0;3;8
6340;Pasaka;"VALDOFRO 12";75591036061;Taip;0;0;4;4
6341;Pasaka;"VALDOFRO 12";8042135600;Ne;0;1;9;10
6342;Pasaka;"VALDOFRO 12";73057603223;Taip;0;0;2;2
6343;Pasaka;"VALDOFRO 12";3367120837;Ne;0;0;9;9
6344;Pasaka;"VALDOFRO 12";7010681103;Taip;0;5;1;6
6345;Pasaka;"VALDOFRO 12";1155273197;Taip;0;13;2;15
6346;Pasaka;"VALDOFRO 12";56766427323;Ne;14;0;0;14
6347;Pasaka;"VALDOFRO 12";4680456848;Taip;0;1;0;1
6348;Pasaka;"VALDOFRO 12";2268625523;Ne;2;0;1;3
6349;Pasaka;"VALDOFRO 12";9797361535;Ne;0;0;22;22
6350;Pasaka;"VALDOFRO 12";8976424908;Taip;4;0;4;8
6351;Pasaka;"VALDOFRO 12";8701112181;Taip;2;0;8;10
6352;Pasaka;"VALDORFO 2";27035873367;Ne;0;7;1;8
6353;Pasaka;"VALDORFO 2";95494862542;Taip;3;0;1;4
6354;Pasaka;"VALDORFO 2";25283698668;Taip;0;5;2;7
6355;Pasaka;"VALDORFO 2";2077818693;Taip;0;1;0;1
6356;Pasaka;"VALDORFO 2";71365777764;Taip;5;0;8;13
6357;Pasaka;"VALDORFO 2";1741935840;Taip;9;0;2;11
6358;Pasaka;"VALDORFO 2";4752117533;Taip;0;1;0;1
6359;Pasaka;"VALDORFO 2";7432241898;Taip;3;1;1;5
6360;Pasaka;"VALDORFO 2";10616073718;Ne;0;1;0;1
6361;Pasaka;"VALDORFO 2";7950962252;Taip;0;0;5;5
6362;Pasaka;"VALDORFO 2";1480107348;Taip;0;0;5;5
6363;Pasaka;"VALDORFO 2";8590385693;Taip;22;0;0;22
6364;Pasaka;"VALDORFO 2";4620573687;Ne;0;7;2;9
6365;Pasaka;"VALDORFO 2";4825373152;Taip;1;1;0;2
6366;Pasaka;"VALDORFO 2";9462745431;Taip;3;4;0;7
6367;Pasaka;"VALDORFO 2";5399148997;Taip;1;0;0;1
6368;Pasaka;Gudručiai;4895994309;Taip;0;0;3;3
6369;Pasaka;Gudručiai;62051806386;Taip;0;2;2;4
6370;Pasaka;Gudručiai;14080980324;Taip;0;10;0;10
6371;Pasaka;Gudručiai;80567536745;Taip;0;1;0;1
6372;Pasaka;Gudručiai;78517147252;Taip;0;1;0;1
6373;Pasaka;Gudručiai;76899232405;Taip;4;0;0;4
6374;Pasaka;Gudručiai;45850914548;Ne;0;13;0;13
6375;Pasaka;Gudručiai;97012371435;Ne;0;13;0;13
6376;Pasaka;Gudručiai;17537343699;Taip;5;0;0;5
6377;Pasaka;Gudručiai;29836649248;Taip;2;0;2;4
6378;Pasaka;Gudručiai;1979028353;Ne;0;0;2;2
6379;Pasaka;Gudručiai;1920564803;Ne;7;0;0;7
6380;Pasaka;Gudručiai;2605583220;Ne;0;0;1;1
6381;Pasaka;Bitelių;8651165520;Taip;10;0;1;11
6382;Pasaka;Bitelių;8132829016;Taip;9;0;1;10
6383;Pasaka;Bitelių;5351364328;Taip;6;0;12;18
6384;Pasaka;Bitelių;4635912654;Taip;6;0;12;18
6385;Pasaka;Bitelių;4137222204;Taip;11;0;0;11
6386;Pasaka;Bitelių;7248640367;Taip;0;4;2;6
6387;Pasaka;Bitelių;8277245475;Taip;0;0;8;8
6388;Pasaka;Bitelių;7103485358;Taip;4;0;0;4
6389;Pasaka;Bitelių;6868519179;Taip;5;4;1;10
6390;Pasaka;Bitelių;6759415053;Taip;0;4;1;5
6391;Pasaka;Bitelių;5723970763;Ne;0;1;8;9
6392;Pasaka;Bitelių;9136521759;Taip;7;7;0;14
6393;Pasaka;Bitelių;7685589423;Taip;0;0;4;4
6394;Pasaka;Bitelių;9737445077;Taip;9;10;0;19
6395;Pasaka;Bitelių;2638182985;Taip;4;0;2;6
6396;Pasaka;Bitelių;2293613528;Taip;0;14;0;14
6397;Pasaka;Bitelių;3367346582;Taip;18;0;0;18
6398;Pasaka;Bitelių;3351338617;Taip;0;1;1;2
6399;Pasaka;Bitelių;5371046207;Taip;4;6;1;11
6400;Pasaka;Bitelių;1335408890;Ne;15;0;0;15
6401;Pasaka;"Pabiručių ";2854919649;Ne;0;0;2;2
6402;Pasaka;"Pabiručių ";7176272684;Ne;9;4;0;13
6403;Pasaka;"Pabiručių ";1950145441;Ne;0;5;0;5
6404;Pasaka;"Pabiručių ";3709664132;Ne;4;0;0;4
6405;Pasaka;"Pabiručių ";1512874567;Taip;2;0;0;2
6406;Pasaka;"Pabiručių ";3606141216;Ne;3;8;0;11
6407;Pasaka;"Pabiručių ";5217688848;Taip;3;8;0;11
6408;Pasaka;"Pabiručių ";3536862796;Ne;9;0;0;9
6409;Pasaka;"Pabiručių ";8899289832;Ne;9;0;0;9
6410;Pasaka;"Pabiručių ";4171004263;Ne;4;0;0;4
6411;Pasaka;"Pabiručių ";4915357646;Ne;10;0;0;10
6412;Pasaka;"Pabiručių ";8504575043;Ne;0;0;1;1
6413;Pasaka;Šnekučių;31896116591;Ne;0;0;4;4
6414;Pasaka;Šnekučių;49626651411;Ne;0;1;8;9
6415;Pasaka;Šnekučių;9549799936;Ne;0;0;5;5
6416;Pasaka;Šnekučių;34897359060;Ne;8;0;4;12
6417;Pasaka;Šnekučių;52912333520;Ne;0;1;3;4
6418;Pasaka;Šnekučių;49520139946;Taip;3;1;0;4
6419;Pasaka;Šnekučių;1693530160;Ne;0;1;0;1
6420;Pasaka;Šnekučių;62303770229;Ne;0;1;3;4
6421;Pasaka;Šnekučių;23132755276;Ne;4;0;0;4
6422;Pasaka;Šnekučių;7082166681;Taip;1;1;0;2
6423;Pasaka;Šnekučių;8615661704;Ne;0;2;1;3
6424;Pasaka;Šnekučių;4178679491;Ne;0;2;0;2
6425;Pasaka;Šnekučių;56983167265;Taip;0;0;3;3
6426;Pasaka;Šnekučių;5021568651;Taip;5;0;0;5
6427;Pasaka;Šnekučių;50456063454;Ne;1;0;1;2
6428;Pasaka;Šnekučių;10055061537;Ne;0;1;4;5
6429;Pasaka;Šnekučių;51500606207;Ne;2;1;0;3
6430;Paslaptis;Priešmokyklinė;1259942408;Ne;0;0;4;4
6431;Paslaptis;Priešmokyklinė;36229769543;Taip;11;1;1;13
6432;Paslaptis;Priešmokyklinė;1982955007;Ne;1;1;1;3
6433;Paslaptis;Priešmokyklinė;1273662366;Taip;6;0;1;7
6434;Paslaptis;Priešmokyklinė;99228588629;Ne;10;1;0;11
6435;Paslaptis;Priešmokyklinė;57773958059;Ne;7;7;5;19
6436;Paslaptis;Priešmokyklinė;73547132372;Ne;0;1;0;1
6437;Paslaptis;Priešmokyklinė;1950287365;Taip;0;0;15;15
6438;Paslaptis;Priešmokyklinė;1094068061;Taip;4;1;0;5
6439;Paslaptis;Priešmokyklinė;1195616749;Taip;0;1;0;1
6440;Paslaptis;Priešmokyklinė;8522925854;Taip;10;4;1;15
6441;Paslaptis;Priešmokyklinė;1445974659;Taip;4;1;0;5
6442;Paslaptis;Priešmokyklinė;2578713065;Ne;6;7;1;14
6443;Paslaptis;Priešmokyklinė;1868248793;Taip;7;1;2;10
6444;Paslaptis;Priešmokyklinė;1938288335;Taip;11;0;0;11
6445;Paslaptis;Priešmokyklinė;1530380043;Taip;8;1;0;9
6446;Paslaptis;Priešmokyklinė;4674623065;Taip;5;1;0;6
6447;Paslaptis;Priešmokyklinė;4731417201;Taip;13;1;0;14
6448;Paslaptis;Priešmokyklinė;6638769261;Ne;5;1;0;6
6449;Paslaptis;Priešmokyklinė;3798754778;Ne;0;6;1;7
6450;Paslaptis;"Darželio mišraus amžiaus grupė";6375966771;Ne;5;0;0;5
6451;Paslaptis;"Darželio mišraus amžiaus grupė";2474900044;Taip;9;0;0;9
6452;Paslaptis;"Darželio mišraus amžiaus grupė";3093280943;Taip;0;1;0;1
6453;Paslaptis;"Darželio mišraus amžiaus grupė";9559318660;Taip;17;0;0;17
6454;Paslaptis;"Darželio mišraus amžiaus grupė";2705751628;Taip;0;0;4;4
6455;Paslaptis;"Darželio mišraus amžiaus grupė";8280740387;Taip;12;0;0;12
6456;Paslaptis;"Darželio mišraus amžiaus grupė";2891547963;Taip;4;1;0;5
6457;Paslaptis;"Darželio mišraus amžiaus grupė";3415869190;Taip;11;1;0;12
6458;Paslaptis;"Darželio mišraus amžiaus grupė";1983773762;Taip;0;1;0;1
6459;Paslaptis;"Darželio mišraus amžiaus grupė";1782398974;Taip;14;0;0;14
6460;Paslaptis;"Darželio mišraus amžiaus grupė";8083478190;Taip;10;4;0;14
6461;Paslaptis;"Darželio mišraus amžiaus grupė";2089780119;Taip;0;11;0;11
6462;Paslaptis;"Darželio mišraus amžiaus grupė";1029321312;Taip;4;2;0;6
6463;Paslaptis;"Darželio mišraus amžiaus grupė";9941731250;Taip;4;0;0;4
6464;Paslaptis;"Darželio mišraus amžiaus grupė";6131831325;Taip;13;1;0;14
6465;Paslaptis;"Darželio mišraus amžiaus grupė";2879752620;Taip;4;9;0;13
6466;Paslaptis;"Darželio mišraus amžiaus grupė";3243226933;Taip;7;0;3;10
6467;Paslaptis;"Darželio mišraus amžiaus grupė";5852939221;Taip;4;1;1;6
6468;Paslaptis;"Darželio mišraus amžiaus grupė";2693910134;Taip;8;1;0;9
6469;Paslaptis;"Darželio mišraus amžiaus grupė";3104525540;Taip;14;0;0;14
6470;Paslaptis;"Darželio mišraus amžiaus grupė";8895770223;Taip;11;1;0;12
6471;Paslaptis;"Darželio mišraus amžiaus grupė";5206529350;Taip;0;8;0;8
6472;Paslaptis;"Darželio mišraus amžiaus grupė";8239855620;Taip;3;0;0;3
6473;Paslaptis;"Darželio mišraus amžiaus grupė";8146824196;Taip;0;0;9;9
6474;Paslaptis;"Darželio mišraus amžiaus grupė";3398729758;Taip;9;1;0;10
6475;Paslaptis;"Darželio mišraus amžiaus grupė";1033910097;Taip;4;0;0;4
6476;Paslaptis;"NAUJA (LOPŠELIS)";3984799090;Ne;3;1;0;4
6477;Paslaptis;"NAUJA (LOPŠELIS)";5406800599;Taip;0;0;1;1
6478;Paslaptis;"NAUJA (LOPŠELIS)";4810686225;Taip;6;1;0;7
6479;Paslaptis;"NAUJA (LOPŠELIS)";1754621741;Ne;22;0;0;22
6480;Paslaptis;"NAUJA (LOPŠELIS)";6098345982;Taip;5;0;2;7
6481;Paslaptis;"NAUJA (LOPŠELIS)";6686352764;Taip;0;6;0;6
6482;Paslaptis;"NAUJA (LOPŠELIS)";1557783684;Taip;11;1;0;12
6483;Paslaptis;"NAUJA (LOPŠELIS)";5646806136;Taip;0;1;1;2
6484;Paslaptis;"NAUJA (LOPŠELIS)";9540612585;Taip;14;0;0;14
6485;Paslaptis;"NAUJA (LOPŠELIS)";7638521198;Taip;0;1;0;1
6486;Paslaptis;"NAUJA (LOPŠELIS)";9100003209;Ne;5;1;0;6
6487;Paslaptis;"NAUJA (LOPŠELIS)";5456011928;Taip;5;0;0;5
6488;Paslaptis;"NAUJA (LOPŠELIS)";5756338103;Taip;8;1;0;9
6489;Paslaptis;"NAUJA (LOPŠELIS)";5886364670;Ne;3;2;0;5
6490;Paslaptis;"NAUJA (LOPŠELIS)";2675089401;Ne;12;0;0;12
6491;Paslaptis;"NAUJA (LOPŠELIS)";4130010071;Taip;5;0;0;5
6492;Paslaptis;"NAUJA (LOPŠELIS)";4591318991;Ne;6;0;0;6
6493;Paslaptis;"NAUJA (LOPŠELIS)";8717111488;Taip;9;1;0;10
6494;Pasakaitė;Vieversėlių;7685647972;Taip;10;1;0;11
6495;Pasakaitė;Vieversėlių;6459145539;Taip;12;0;2;14
6496;Pasakaitė;Vieversėlių;2194313054;Taip;12;0;0;12
6497;Pasakaitė;Vieversėlių;9587489514;Taip;9;0;0;9
6498;Pasakaitė;Vieversėlių;3444442287;Taip;10;0;1;11
6499;Pasakaitė;Vieversėlių;5485965486;Taip;8;0;1;9
6500;Pasakaitė;Vieversėlių;2563725297;Taip;9;0;0;9
6501;Pasakaitė;Vieversėlių;2849753418;Taip;6;0;0;6
6502;Pasakaitė;Vieversėlių;8043493934;Taip;7;1;0;8
6503;Pasakaitė;Vieversėlių;7963057831;Taip;5;0;0;5
6504;Pasakaitė;Vieversėlių;9543991684;Taip;5;1;0;6
6505;Pasakaitė;Vieversėlių;7020773169;Taip;8;0;0;8
6506;Pasakaitė;Vieversėlių;3680596008;Taip;8;0;0;8
6507;Pasakaitė;Vieversėlių;4882856664;Taip;0;0;9;9
6508;Pasakaitė;Vieversėlių;5953162958;Taip;3;0;0;3
6509;Pasakaitė;Vieversėlių;5948958906;Taip;12;1;0;13
6510;Pasakaitė;Vieversėlių;1060914693;Taip;7;1;0;8
6511;Pasakaitė;Vieversėlių;7761162338;Taip;3;1;0;4
6512;Pasakaitė;Vieversėlių;8463220257;Taip;0;4;0;4
6513;Pasakaitė;Vieversėlių;9018830962;Taip;10;0;2;12
6514;Pasakaitė;Spindulėlių;8638071584;Ne;0;3;1;4
6515;Pasakaitė;Spindulėlių;75361056418;Taip;2;12;0;14
6516;Pasakaitė;Spindulėlių;4680949976;Taip;4;6;0;10
6517;Pasakaitė;Spindulėlių;3734935229;Ne;9;1;0;10
6518;Pasakaitė;Spindulėlių;4267488049;Taip;0;3;1;4
6519;Pasakaitė;Spindulėlių;1523034176;Taip;0;3;3;6
6520;Pasakaitė;Spindulėlių;7152349570;Taip;0;18;0;18
6521;Pasakaitė;Spindulėlių;1220619991;Taip;4;2;0;6
6522;Pasakaitė;Spindulėlių;7526264241;Taip;0;2;0;2
6523;Pasakaitė;Spindulėlių;3606601644;Taip;4;4;0;8
6524;Pasakaitė;Spindulėlių;3541877287;Taip;7;0;0;7
6525;Pasakaitė;Spindulėlių;3579498202;Taip;0;6;0;6
6526;Pasakaitė;Spindulėlių;3231283338;Taip;5;1;0;6
6527;Pasakaitė;Spindulėlių;7790937149;Taip;0;2;3;5
6528;Pasakaitė;Spindulėlių;5313360864;Ne;4;0;0;4
6529;Pasakaitė;Spindulėlių;3400305768;Taip;0;2;3;5
6530;Pasakaitė;Spindulėlių;6568538767;Ne;9;7;0;16
6531;Pasakaitė;Pasagėlių;3165658822;Taip;0;11;0;11
6532;Pasakaitė;Pasagėlių;61230317080;Ne;0;3;0;3
6533;Pasakaitė;Pasagėlių;1740419218;Taip;7;10;0;17
6534;Pasakaitė;Pasagėlių;5378855541;Ne;7;0;0;7
6535;Pasakaitė;Pasagėlių;4703375416;Taip;0;12;0;12
6536;Pasakaitė;Pasagėlių;8466086339;Taip;4;0;0;4
6537;Pasakaitė;Pasagėlių;1019010454;Taip;2;4;0;6
6538;Pasakaitė;Pasagėlių;4959175420;Taip;0;15;0;15
6539;Pasakaitė;Pasagėlių;83018133588;Ne;2;5;0;7
6540;Pasakaitė;Pasagėlių;5605619860;Ne;0;1;0;1
6541;Pasakaitė;Pasagėlių;1791015854;Taip;3;0;1;4
6542;Pasakaitė;Pasagėlių;39853246609;Taip;5;0;0;5
6543;Pasakaitė;Pasagėlių;4591161640;Taip;0;0;1;1
6544;Pasakaitė;Pasagėlių;1707428977;Taip;16;0;0;16
6545;Pasakaitė;Pasagėlių;5467179333;Taip;0;1;0;1
6546;Pasakaitė;Švyturėlių;24096031951;Taip;7;0;1;8
6547;Pasakaitė;Švyturėlių;11001677712;Taip;0;0;12;12
6548;Pasakaitė;Švyturėlių;9914689534;Taip;7;0;1;8
6549;Pasakaitė;Švyturėlių;75785125455;Taip;0;0;8;8
6550;Pasakaitė;Švyturėlių;88077831193;Taip;5;0;1;6
6551;Pasakaitė;Švyturėlių;8225188274;Ne;0;5;0;5
6552;Pasakaitė;Švyturėlių;73957497029;Taip;4;0;1;5
6553;Pasakaitė;Švyturėlių;1070409611;Taip;9;0;2;11
6554;Pasakaitė;Švyturėlių;7702359586;Taip;9;1;0;10
6555;Pasakaitė;Švyturėlių;2331486690;Taip;10;0;2;12
6556;Pasakaitė;Švyturėlių;8469043564;Taip;16;0;1;17
6557;Pasakaitė;Švyturėlių;5436985035;Ne;11;0;4;15
6558;Pasakaitė;Švyturėlių;4008826950;Taip;18;4;0;22
6559;Pasakaitė;Švyturėlių;2721048424;Taip;2;8;2;12
6560;Pasakaitė;Švyturėlių;1513903341;Taip;15;0;0;15
6561;Pasakaitė;Švyturėlių;8578521969;Taip;5;0;0;5
6562;Pasakaitė;Švyturėlių;8390366303;Ne;9;0;2;11
6563;Pasakaitė;Švyturėlių;1278198989;Taip;19;0;0;19
6564;Pasakaitė;Švyturėlių;1940545723;Ne;4;4;0;8
6565;Pasakaitė;Kodėlčiukų;94317654094;Taip;0;0;2;2
6566;Pasakaitė;Kodėlčiukų;72093762601;Taip;5;0;0;5
6567;Pasakaitė;Kodėlčiukų;1553678838;Taip;6;0;3;9
6568;Pasakaitė;Kodėlčiukų;92762645558;Taip;0;0;5;5
6569;Pasakaitė;Kodėlčiukų;1854100959;Taip;0;0;2;2
6570;Pasakaitė;Kodėlčiukų;93907096625;Taip;0;0;3;3
6571;Pasakaitė;Kodėlčiukų;4974486850;Ne;7;0;4;11
6572;Pasakaitė;Kodėlčiukų;9746401498;Ne;7;0;4;11
6573;Pasakaitė;Kodėlčiukų;6839399035;Ne;4;0;2;6
6574;Pasakaitė;Kodėlčiukų;99352468512;Taip;10;0;0;10
6575;Pasakaitė;Kodėlčiukų;1809383469;Taip;10;0;0;10
6576;Pasakaitė;Kodėlčiukų;2742595829;Taip;0;8;0;8
6577;Pasakaitė;Kodėlčiukų;1592521766;Taip;5;0;0;5
6578;Pasakaitė;Kodėlčiukų;6983619733;Taip;9;0;1;10
6579;Pasakaitė;Kodėlčiukų;9506178305;Taip;0;0;11;11
6580;Pasakaitė;Kodėlčiukų;4583679144;Taip;0;0;2;2
6581;Pasakaitė;Gudručių;70802215290;Taip;0;11;0;11
6582;Pasakaitė;Gudručių;48421643700;Ne;0;2;0;2
6583;Pasakaitė;Gudručių;1537944476;Taip;0;0;1;1
6584;Pasakaitė;Gudručių;1631919806;Ne;0;0;3;3
6585;Pasakaitė;Gudručių;1696228992;Ne;0;0;3;3
6586;Pasakaitė;Gudručių;41359431347;Taip;2;0;1;3
6587;Pasakaitė;Gudručių;18419655194;Taip;0;1;0;1
6588;Pasakaitė;Gudručių;91751201397;Taip;13;2;1;16
6589;Pasakaitė;Gudručių;23103636206;Taip;0;4;0;4
6590;Pasakaitė;Gudručių;35147041377;Ne;0;0;3;3
6591;Pasakaitė;Gudručių;91109909258;Taip;0;6;0;6
6592;Pasakaitė;Gudručių;39926553926;Taip;0;0;10;10
6593;Pasakaitė;Gudručių;1139554564;Taip;0;6;0;6
6594;Pasakaitė;Gudručių;1627102470;Taip;0;6;3;9
6595;Pasakaitė;Čiulbonėlių;19151459055;Taip;2;0;1;3
6596;Pasakaitė;Čiulbonėlių;30460033968;Taip;0;3;0;3
6597;Pasakaitė;Čiulbonėlių;32235101944;Taip;0;0;1;1
6598;Pasakaitė;Čiulbonėlių;1159523006;Taip;0;0;1;1
6599;Pasakaitė;Čiulbonėlių;26826144324;Taip;0;0;2;2
6600;Pasakaitė;Čiulbonėlių;74338375162;Taip;0;0;7;7
6601;Pasakaitė;Čiulbonėlių;72232008007;Taip;0;0;2;2
6602;Pasakaitė;Čiulbonėlių;21872672491;Taip;0;0;5;5
6603;Pasakaitė;Čiulbonėlių;21284070194;Taip;0;1;1;2
6604;Pasakaitė;Čiulbonėlių;13787417933;Ne;11;0;0;11
6605;Pasakaitė;Čiulbonėlių;45451715428;Taip;0;12;0;12
6606;Pasakaitė;Čiulbonėlių;1381307997;Taip;0;9;0;9
6607;Pasakaitė;"Verpstelių ";12092268542;Taip;0;4;0;4
6608;Pasakaitė;"Verpstelių ";600641021;Taip;0;7;0;7
6609;Pasakaitė;"Verpstelių ";17218793370;Taip;0;7;0;7
6610;Pasakaitė;"Verpstelių ";33418184802;Ne;0;3;2;5
6611;Pasakaitė;"Verpstelių ";46873849992;Taip;0;7;0;7
6612;Pasakaitė;"Verpstelių ";96648719544;Taip;0;9;0;9
6613;Pasakaitė;"Verpstelių ";82475369612;Taip;0;15;0;15
6614;Pasakaitė;"Verpstelių ";88885227604;Ne;0;9;0;9
6615;Pasakaitė;"Verpstelių ";2210519019;Taip;0;0;1;1
6616;Pasakaitė;"Verpstelių ";18105216772;Taip;0;2;0;2
6617;Pasakaitė;"Verpstelių ";50537059387;Taip;0;5;0;5
6618;Pasakaitė;"Verpstelių ";29699532850;Taip;4;13;0;17
6619;Pasakaitė;"Verpstelių ";46074425530;Taip;7;0;0;7
6620;Pasakaitė;"Verpstelių ";45157801238;Taip;0;0;1;1
6621;Pasakaitė;Smalsučiai;2407824666;Taip;0;7;0;7
6622;Pasakaitė;Smalsučiai;7451624229;Taip;8;0;0;8
6623;Pasakaitė;Smalsučiai;6847782430;Taip;0;19;0;19
6624;Pasakaitė;Smalsučiai;7759051761;Taip;0;7;0;7
6625;Pasakaitė;Smalsučiai;4728731352;Taip;5;0;0;5
6626;Pasakaitė;Smalsučiai;3710143250;Taip;0;4;0;4
6627;Pasakaitė;Smalsučiai;7621306769;Taip;0;10;0;10
6628;Pasakaitė;Smalsučiai;1744216870;Taip;0;13;1;14
6629;Pasakaitė;Smalsučiai;1533259056;Taip;7;1;2;10
6630;Pasakaitė;Smalsučiai;1425166722;Taip;0;0;4;4
6631;Pasakaitė;Smalsučiai;4946855684;Taip;20;0;0;20
6632;Pasakaitė;Smalsučiai;8315840473;Taip;0;6;0;6
6633;Pasakaitė;Smalsučiai;9821617981;Taip;1;0;3;4
6634;Pasakaitė;"Čiauškučiai ";6714500298;Ne;15;0;1;16
6635;Pasakaitė;"Čiauškučiai ";1962693480;Taip;0;7;0;7
6636;Pasakaitė;"Čiauškučiai ";1963102227;Taip;0;0;2;2
6637;Pasakaitė;"Čiauškučiai ";4758073190;Taip;7;0;0;7
6638;Pasakaitė;"Čiauškučiai ";7813221735;Taip;5;0;0;5
6639;Pasakaitė;"Čiauškučiai ";1619513932;Taip;0;5;0;5
6640;Pasakaitė;"Čiauškučiai ";4246461594;Taip;0;0;2;2
6641;Pasakaitė;"Čiauškučiai ";8267725352;Taip;0;8;0;8
6642;Pasakaitė;"Čiauškučiai ";1184513606;Taip;0;6;0;6
6643;Pasakaitė;"Čiauškučiai ";8223662339;Taip;7;0;0;7
6644;Pasakaitė;"Čiauškučiai ";6858356868;Taip;0;4;1;5
6645;Pasakaitė;Pabiručiai;1827070201;Taip;9;0;2;11
6646;Pasakaitė;Pabiručiai;9175612991;Taip;10;0;0;10
6647;Pasakaitė;Pabiručiai;26714845001;Taip;5;0;0;5
6648;Pasakaitė;Pabiručiai;46891856500;Taip;0;7;0;7
6649;Pasakaitė;Pabiručiai;3397132786;Ne;0;10;1;11
6650;Pasakaitė;Pabiručiai;1769070351;Taip;0;6;0;6
6651;Pasakaitė;Pabiručiai;1320898756;Taip;18;0;0;18
6652;Pasakaitė;Pabiručiai;1027136050;Taip;7;0;0;7
6653;Pasakaitė;Pabiručiai;1198248619;Taip;5;6;0;11
6654;Pasakaitė;Pabiručiai;1032113089;Taip;0;2;0;2
6655;Pasakaitė;Pabiručiai;21252086256;Taip;4;0;0;4
6656;Pasakaitė;Pabiručiai;6134483994;Taip;7;6;0;13
6657;Pasakaitė;Pabiručiai;1673576868;Taip;0;18;3;21
6658;Pasakaitė;Pabiručiai;2017275984;Taip;0;6;1;7
6659;Pasakaitė;Pabiručiai;27702516199;Taip;0;0;1;1
6660;Pasakaitė;Pabiručiai;22071058323;Taip;0;19;3;22
6661;Pasakaitė;Pabiručiai;6346678827;Ne;0;0;22;22
6662;Pelenė;Varpelis;1283843474;Taip;7;0;0;7
6663;Pelenė;Varpelis;93009343319;Taip;2;0;0;2
6664;Pelenė;Varpelis;25108428891;Taip;0;4;0;4
6665;Pelenė;Varpelis;59795549508;Taip;0;4;0;4
6666;Pelenė;Varpelis;83359560510;Taip;0;8;0;8
6667;Pelenė;Varpelis;70335326964;Taip;9;0;0;9
6668;Pelenė;Varpelis;75264382003;Taip;3;0;0;3
6669;Pelenė;Varpelis;3245982902;Taip;0;0;1;1
6670;Pelenė;Varpelis;32716320977;Taip;0;5;0;5
6671;Pelenė;Varpelis;1733433768;Ne;0;0;2;2
6672;Pelenė;Varpelis;40968963343;Taip;1;0;0;1
6673;Pelenė;Varpelis;29587640966;Taip;0;6;0;6
6674;Pelenė;Varpelis;55350714718;Taip;0;5;0;5
6675;Pelenė;Varpelis;120966603;Taip;0;5;0;5
6676;Pelenė;Varpelis;30625065081;Taip;9;1;0;10
6677;Pelenė;Varpelis;62615483649;Taip;0;5;0;5
6678;Pelenė;Varpelis;35657264407;Ne;0;2;2;4
6679;Pelenė;Varpelis;12400151337;Taip;0;0;1;1
6680;Pelenė;Saulutės;99849461351;Taip;0;3;0;3
6681;Pelenė;Saulutės;93982153559;Taip;0;5;1;6
6682;Pelenė;Saulutės;93692312117;Taip;0;4;0;4
6683;Pelenė;Saulutės;12170216844;Taip;0;0;2;2
6684;Pelenė;Saulutės;1321060587;Taip;0;0;5;5
6685;Pelenė;Saulutės;11671895181;Taip;0;0;2;2
6686;Pelenė;Saulutės;89623266364;Taip;3;0;0;3
6687;Pelenė;Saulutės;72216942887;Taip;0;1;1;2
6688;Pelenė;Saulutės;96121315210;Ne;0;0;5;5
6689;Pelenė;Saulutės;1289416312;Taip;6;0;0;6
6690;Pelenė;Saulutės;96840961754;Taip;14;0;2;16
6691;Pelenė;Saulutės;52690820;Taip;0;0;2;2
6692;Pelenė;Saulutės;78648474464;Ne;5;0;1;6
6693;Pelenė;Saulutės;4178071578;Taip;0;2;0;2
6694;Pelenė;Saulutės;8813044848;Taip;8;0;0;8
6695;Pelenė;Saulutės;1807037374;Taip;0;0;2;2
6696;Pelenė;Saulutės;6559830470;Taip;5;5;0;10
6697;Pelenė;Saulutės;6937587856;Taip;0;4;0;4
6698;Pelenė;Raktelis;9019827941;Taip;8;0;2;10
6699;Pelenė;Raktelis;3465518545;Taip;8;0;2;10
6700;Pelenė;Raktelis;4386060612;Ne;0;0;1;1
6701;Pelenė;Raktelis;1568123491;Taip;8;1;0;9
6702;Pelenė;Raktelis;14200374671;Taip;9;0;0;9
6703;Pelenė;Raktelis;1418000665;Taip;3;0;10;13
6704;Pelenė;Raktelis;3299454566;Taip;4;0;1;5
6705;Pelenė;Raktelis;1127657620;Taip;6;4;0;10
6706;Pelenė;Raktelis;17572291941;Taip;0;1;0;1
6707;Pelenė;Raktelis;1183026351;Taip;0;0;1;1
6708;Pelenė;Raktelis;2072863178;Taip;0;1;1;2
6709;Pelenė;Raktelis;1050272821;Taip;0;0;1;1
6710;Pelenė;Raktelis;51979406888;Taip;0;0;7;7
6711;Pelenė;Raktelis;89920419797;Taip;0;3;0;3
6712;Pelenė;Raktelis;45589326259;Ne;2;0;0;2
6713;Pelenė;Raktelis;26010775076;Taip;0;12;0;12
6714;Pelenė;Raktelis;1483843416;Taip;0;17;0;17
6715;Pelenė;Raktelis;2677995903;Ne;0;10;0;10
6716;Pelenė;Raktelis;6289619123;Taip;8;0;3;11
6717;Pelenė;Žvaigždutės;8404317146;Taip;0;0;2;2
6718;Pelenė;Žvaigždutės;8466974910;Taip;13;0;0;13
6719;Pelenė;Žvaigždutės;1336431888;Taip;0;1;0;1
6720;Pelenė;Žvaigždutės;1114786936;Taip;4;0;1;5
6721;Pelenė;Žvaigždutės;1140030742;Taip;0;6;0;6
6722;Pelenė;Žvaigždutės;3497915398;Taip;3;6;0;9
6723;Pelenė;Žvaigždutės;2154553741;Taip;3;6;0;9
6724;Pelenė;Žvaigždutės;8598498275;Taip;0;8;0;8
6725;Pelenė;Žvaigždutės;69721118552;Taip;3;0;0;3
6726;Pelenė;Žvaigždutės;39705461573;Ne;0;10;0;10
6727;Pelenė;Žvaigždutės;3131930907;Taip;13;0;1;14
6728;Pelenė;Žvaigždutės;5804848640;Taip;10;0;0;10
6729;Pelenė;Žvaigždutės;1710249888;Taip;4;1;0;5
6730;Pelenė;Žvaigždutės;33009702783;Taip;0;0;5;5
6731;Pelenė;Žvaigždutės;61012202440;Taip;0;5;0;5
6732;Pelenė;Žvaigždutės;34765342495;Taip;3;1;0;4
6733;Pelenė;Žvaigždutės;45410683361;Ne;0;0;10;10
6734;Pelenė;Žvaigždutės;1305335939;Taip;8;0;0;8
6735;Pelenė;Žvaigždutės;62484999314;Taip;5;0;2;7
6736;Pelenė;Žvaigždutės;5081903157;Taip;0;5;0;5
6737;Pelenė;Nykštukas;9621197758;Taip;0;16;0;16
6738;Pelenė;Nykštukas;7144616734;Ne;0;0;1;1
6739;Pelenė;Nykštukas;3296147024;Taip;0;7;0;7
6740;Pelenė;Nykštukas;3189305906;Taip;0;7;0;7
6741;Pelenė;Nykštukas;8607110629;Taip;0;9;0;9
6742;Pelenė;Nykštukas;9584503078;Taip;0;0;2;2
6743;Pelenė;Nykštukas;8770771520;Taip;4;0;0;4
6744;Pelenė;Nykštukas;10457480694;Taip;0;0;4;4
6745;Pelenė;Nykštukas;1750366978;Taip;5;0;2;7
6746;Pelenė;Nykštukas;2092775878;Taip;6;5;0;11
6747;Pelenė;Nykštukas;7254981715;Ne;0;1;0;1
6748;Pelenė;Nykštukas;7836778389;Taip;0;8;0;8
6749;Pelenė;Nykštukas;8721423900;Taip;22;0;0;22
6750;Pelenė;Nykštukas;6021833025;Taip;0;0;11;11
6751;Pelenė;Nykštukas;7205437280;Taip;4;0;0;4
6752;Pelenė;Nykštukas;3385568839;Taip;0;9;0;9
6753;Pelenė;Nykštukas;7589978427;Taip;0;1;0;1
6754;Pelenė;Žirniukai;4315677064;Taip;6;0;1;7
6755;Pelenė;Žirniukai;4624325473;Taip;0;3;0;3
6756;Pelenė;Žirniukai;1775717256;Ne;12;0;0;12
6757;Pelenė;Žirniukai;6632188229;Taip;4;12;0;16
6758;Pelenė;Žirniukai;5356756237;Ne;11;0;0;11
6759;Pelenė;Žirniukai;7587887488;Taip;5;2;0;7
6760;Pelenė;Žirniukai;8716395810;Taip;0;4;0;4
6761;Pelenė;Žirniukai;6191899254;Taip;0;5;1;6
6762;Pelenė;Žirniukai;2737277656;Taip;10;0;0;10
6763;Pelenė;Žirniukai;5389865440;Ne;0;0;1;1
6764;Pelenė;Žirniukai;1902314385;Taip;0;0;2;2
6765;Pelenė;Žirniukai;6707167720;Taip;0;0;2;2
6766;Pelenė;Žirniukai;9009271610;Taip;0;12;0;12
6767;Pelenė;Žirniukai;5325176433;Taip;3;6;0;9
6768;Pelenė;Žirniukai;9186679454;Taip;0;3;0;3
6769;Pelenė;Žirniukai;8414727016;Taip;9;0;2;11
6770;Pelenė;Žirniukai;6221703608;Taip;0;8;0;8
6771;Pelenė;Lašeliai;4591637887;Ne;6;0;3;9
6772;Pelenė;Lašeliai;1067737206;Ne;0;10;0;10
6773;Pelenė;Lašeliai;6038229659;Taip;0;8;0;8
6774;Pelenė;Lašeliai;4090532624;Ne;8;5;0;13
6775;Pelenė;Lašeliai;9075193730;Ne;11;0;0;11
6776;Pelenė;Lašeliai;6419661741;Taip;5;0;2;7
6777;Pelenė;Lašeliai;8123162647;Taip;0;6;0;6
6778;Pelenė;Lašeliai;4366940539;Taip;6;6;0;12
6779;Pelenė;Lašeliai;7114993398;Ne;6;0;7;13
6780;Pelenė;Lašeliai;7659625628;Taip;14;0;0;14
6781;Pelenė;Lašeliai;2210314952;Taip;12;8;0;20
6782;Pelenė;Lašeliai;9063588699;Taip;0;14;0;14
6783;Pelenė;Lašeliai;7088493729;Taip;18;0;0;18
6784;Pelenė;Lašeliai;3573543545;Taip;12;2;0;14
6785;Pelenė;Lašeliai;4089199552;Taip;18;0;0;18
6786;Pelenė;Lašeliai;4541391191;Taip;13;3;0;16
6787;Pelenė;Lašeliai;9195113444;Taip;8;7;0;15
6788;Pelenė;Lašeliai;7880284433;Ne;5;0;2;7
6789;Pelenė;Lašeliai;6375060159;Taip;5;12;0;17
6790;Pelenė;Lašeliai;5063098703;Taip;9;2;0;11
6791;Pelenė;Lašeliai;5780697554;Taip;0;5;0;5
6792;Pelenė;Grūdelis;34209230034;Taip;1;0;0;1
6793;Pelenė;Grūdelis;55160554683;Taip;4;0;0;4
6794;Pelenė;Grūdelis;3189769456;Taip;0;1;0;1
6795;Pelenė;Grūdelis;77504082241;Taip;0;16;0;16
6796;Pelenė;Grūdelis;1599336930;Taip;6;0;0;6
6797;Pelenė;Grūdelis;93234992958;Taip;5;4;0;9
6798;Pelenė;Grūdelis;2393068606;Taip;0;3;0;3
6799;Pelenė;Grūdelis;43686344645;Ne;0;10;0;10
6800;Pelenė;Grūdelis;1157718969;Taip;0;0;1;1
6801;Pelenė;Grūdelis;39850314417;Taip;6;0;0;6
6802;Pelenė;Grūdelis;71274664713;Taip;0;3;0;3
6803;Pelenė;Grūdelis;1542958753;Taip;1;0;0;1
6804;Pelenė;Grūdelis;1908166570;Taip;0;10;0;10
6805;Pelenė;Grūdelis;1516249890;Taip;0;3;0;3
6806;Pelenė;Grūdelis;1846536895;Taip;0;5;0;5
6807;Pelenė;Braškytė;8038559319;Taip;0;0;1;1
6808;Pelenė;Braškytė;5697826755;Taip;0;0;1;1
6809;Pelenė;Braškytė;6864263698;Taip;22;0;0;22
6810;Pelenė;Braškytė;9447223913;Taip;15;0;0;15
6811;Pelenė;Braškytė;4004975235;Taip;11;0;0;11
6812;Pelenė;Braškytė;8790613872;Taip;11;0;0;11
6813;Pelenė;Braškytė;8194354176;Taip;0;5;0;5
6814;Pelenė;Braškytė;8239650471;Taip;0;0;1;1
6815;Pelenė;Braškytė;5228983908;Taip;0;0;2;2
6816;Pelenė;Braškytė;3174009848;Taip;11;0;3;14
6817;Pelenė;Braškytė;6524101295;Taip;5;4;0;9
6818;Pelenė;Braškytė;7164790060;Taip;0;1;0;1
6819;Pelenė;Braškytė;4376033711;Taip;0;3;0;3
6820;Pelenė;Braškytė;6894978459;Taip;0;11;0;11
6821;Pelenė;Braškytė;4321705575;Taip;0;1;0;1
6822;Pelenė;Braškytė;1632490481;Taip;5;0;2;7
6823;Pelenė;Boružėlės;5031778158;Taip;0;7;0;7
6824;Pelenė;Boružėlės;9218868317;Taip;11;0;0;11
6825;Pelenė;Boružėlės;2163737781;Taip;0;4;0;4
6826;Pelenė;Boružėlės;7565331966;Taip;2;0;1;3
6827;Pelenė;Boružėlės;1048899958;Taip;7;0;0;7
6828;Pelenė;Boružėlės;4056676361;Taip;6;0;0;6
6829;Pelenė;Boružėlės;2540405047;Taip;6;0;1;7
6830;Pelenė;Boružėlės;6469409776;Taip;15;0;0;15
6831;Pelenė;Boružėlės;4870187198;Taip;9;0;0;9
6832;Pelenė;Boružėlės;1274729537;Taip;0;0;1;1
6833;Pelenė;Boružėlės;3205331614;Taip;6;0;0;6
6834;Pelenė;Boružėlės;2322908067;Ne;0;18;0;18
6835;Pelenė;Boružėlės;5084452088;Taip;0;10;0;10
6836;Pelenė;Boružėlės;5074054534;Taip;4;0;0;4
6837;Pelenė;Boružėlės;2476080951;Taip;4;6;0;10
6838;Pelenė;Saldainiukai;2040256240;Taip;5;3;0;8
6839;Pelenė;Saldainiukai;8623480143;Ne;1;0;3;4
6840;Pelenė;Saldainiukai;3662919521;Taip;22;0;0;22
6841;Pelenė;Saldainiukai;4856039707;Taip;16;0;0;16
6842;Pelenė;Saldainiukai;2765650058;Taip;2;11;0;13
6843;Pelenė;Saldainiukai;8841183816;Taip;17;0;0;17
6844;Pelenė;Saldainiukai;4695104609;Ne;0;10;0;10
6845;Pelenė;Saldainiukai;1852964349;Taip;16;0;0;16
6846;Pelenė;Saldainiukai;7578318198;Taip;0;15;0;15
6847;Pelenė;Saldainiukai;1080017906;Taip;9;0;0;9
6848;Pelenė;Saldainiukai;7714061272;Taip;5;1;0;6
6849;Pipiras;EŽIUKAI;12489971559;Taip;0;8;0;8
6850;Pipiras;EŽIUKAI;56241147614;Taip;0;2;0;2
6851;Pipiras;EŽIUKAI;1112327896;Taip;0;6;0;6
6852;Pipiras;EŽIUKAI;52968399382;Taip;0;6;0;6
6853;Pipiras;EŽIUKAI;24414917430;Taip;0;10;0;10
6854;Pipiras;EŽIUKAI;71881026465;Ne;0;1;0;1
6855;Pipiras;EŽIUKAI;32958963027;Taip;0;1;0;1
6856;Pipiras;EŽIUKAI;95904922548;Taip;0;19;0;19
6857;Pipiras;EŽIUKAI;55466909230;Taip;0;7;0;7
6858;Pipiras;EŽIUKAI;53468621826;Taip;0;7;0;7
6859;Pipiras;EŽIUKAI;1213972436;Taip;0;13;0;13
6860;Pipiras;EŽIUKAI;4564046164;Ne;4;2;0;6
6861;Pipiras;EŽIUKAI;35225328018;Ne;0;4;0;4
6862;Pipiras;EŽIUKAI;1129409620;Taip;0;8;0;8
6863;Pipiras;EŽIUKAI;1061415778;Taip;0;21;0;21
6864;Pipiras;EŽIUKAI;1095731795;Taip;0;22;0;22
6865;Pipiras;EŽIUKAI;24106575180;Ne;0;9;0;9
6866;Pipiras;EŽIUKAI;2874546969;Taip;0;14;0;14
6867;Pipiras;BITUTĖS;3554786173;Taip;7;0;0;7
6868;Pipiras;BITUTĖS;5725956659;Taip;0;5;0;5
6869;Pipiras;BITUTĖS;7934365114;Ne;11;3;0;14
6870;Pipiras;BITUTĖS;2075041950;Taip;6;0;0;6
6871;Pipiras;BITUTĖS;9840040112;Taip;12;3;0;15
6872;Pipiras;BITUTĖS;3852848863;Taip;7;0;0;7
6873;Pipiras;BITUTĖS;5235868332;Ne;3;0;0;3
6874;Pipiras;BITUTĖS;7350131214;Taip;2;0;0;2
6875;Pipiras;BITUTĖS;7161727352;Taip;8;0;0;8
6876;Pipiras;BITUTĖS;5225533488;Taip;8;1;0;9
6877;Pipiras;BITUTĖS;6792777396;Taip;10;2;0;12
6878;Pipiras;BITUTĖS;1784839485;Taip;0;11;0;11
6879;Pipiras;BITUTĖS;3775916247;Taip;0;1;3;4
6880;Pipiras;BITUTĖS;5845498558;Taip;0;9;0;9
6881;Pipiras;BITUTĖS;9157870634;Taip;0;1;0;1
6882;Pipiras;BITUTĖS;3882437376;Taip;6;8;0;14
6883;Pipiras;BITUTĖS;9770780973;Taip;9;11;0;20
6884;Pipiras;BITUTĖS;6523189501;Taip;7;4;0;11
6885;Pipiras;NYKŠTUKAI;1045583136;Taip;2;8;0;10
6886;Pipiras;NYKŠTUKAI;4811029230;Taip;10;0;0;10
6887;Pipiras;NYKŠTUKAI;8895028305;Taip;11;1;2;14
6888;Pipiras;NYKŠTUKAI;8140314304;Taip;0;3;0;3
6889;Pipiras;NYKŠTUKAI;6791495556;Taip;0;1;0;1
6890;Pipiras;NYKŠTUKAI;5422547144;Taip;5;2;0;7
6891;Pipiras;NYKŠTUKAI;6363349541;Taip;0;5;0;5
6892;Pipiras;NYKŠTUKAI;6340323302;Taip;0;3;0;3
6893;Pipiras;NYKŠTUKAI;4266424785;Taip;0;7;0;7
6894;Pipiras;NYKŠTUKAI;6748400056;Taip;0;22;0;22
6895;Pipiras;NYKŠTUKAI;1242260242;Taip;3;3;0;6
6896;Pipiras;NYKŠTUKAI;6685567970;Taip;0;1;2;3
6897;Pipiras;NYKŠTUKAI;8520454289;Taip;0;1;5;6
6898;Pipiras;NYKŠTUKAI;4426479971;Taip;4;0;0;4
6899;Pipiras;NYKŠTUKAI;2267192782;Taip;0;13;0;13
6900;Pipiras;NYKŠTUKAI;3421769229;Taip;0;0;1;1
6901;Pipiras;NYKŠTUKAI;5445858240;Taip;0;2;0;2
6902;Pipiras;NYKŠTUKAI;4725221169;Taip;5;3;0;8
6903;Pipiras;NYKŠTUKAI;5059203266;Taip;0;0;2;2
6904;Pipiras;PELĖDŽIUKAI;4428216634;Taip;0;0;3;3
6905;Pipiras;PELĖDŽIUKAI;6694920607;Taip;0;4;0;4
6906;Pipiras;PELĖDŽIUKAI;3325511140;Taip;19;0;0;19
6907;Pipiras;PELĖDŽIUKAI;3341850450;Taip;0;0;2;2
6908;Pipiras;PELĖDŽIUKAI;7870521230;Taip;0;4;8;12
6909;Pipiras;PELĖDŽIUKAI;5778300856;Taip;7;2;0;9
6910;Pipiras;PELĖDŽIUKAI;3888552150;Taip;0;1;0;1
6911;Pipiras;PELĖDŽIUKAI;7026118693;Taip;0;4;0;4
6912;Pipiras;PELĖDŽIUKAI;1391682850;Taip;0;3;0;3
6913;Pipiras;PELĖDŽIUKAI;87924002679;Taip;16;0;0;16
6914;Pipiras;PELĖDŽIUKAI;6805620664;Taip;0;3;1;4
6915;Pipiras;PELĖDŽIUKAI;5502001191;Taip;0;0;1;1
6916;Pipiras;PELĖDŽIUKAI;9275905384;Taip;8;1;0;9
6917;Pipiras;PELĖDŽIUKAI;4496076326;Taip;0;0;8;8
6918;Pipiras;PELĖDŽIUKAI;3141822820;Taip;0;15;0;15
6919;Pipiras;PELĖDŽIUKAI;4456861303;Taip;0;12;0;12
6920;Pipiras;PELĖDŽIUKAI;2044498561;Ne;9;1;0;10
6921;Pipiras;PELĖDŽIUKAI;2240865490;Taip;0;10;0;10
6922;Pipiras;PELĖDŽIUKAI;3357866319;Ne;10;1;1;12
6923;Pipiras;DRUGELIAI;41585818819;Taip;14;0;0;14
6924;Pipiras;DRUGELIAI;5577759167;Ne;0;22;0;22
6925;Pipiras;DRUGELIAI;7799786844;Ne;0;10;0;10
6926;Pipiras;DRUGELIAI;5014457985;Ne;4;7;0;11
6927;Pipiras;DRUGELIAI;4927845000;Ne;5;7;0;12
6928;Pipiras;DRUGELIAI;1904376366;Ne;0;7;0;7
6929;Pipiras;DRUGELIAI;1128674099;Taip;0;11;0;11
6930;Pipiras;DRUGELIAI;3422170541;Taip;0;3;0;3
6931;Pipiras;DRUGELIAI;1391958633;Taip;0;8;0;8
6932;Pipiras;DRUGELIAI;7784343130;Taip;0;6;0;6
6933;Pipiras;DRUGELIAI;3622164823;Taip;0;13;0;13
6934;Pipiras;DRUGELIAI;3008358842;Ne;7;2;0;9
6935;Pipiras;DRUGELIAI;2024777430;Taip;0;7;0;7
6936;Pipiras;DRUGELIAI;4959823035;Taip;0;7;0;7
6937;Pipiras;DRUGELIAI;6339186940;Taip;0;10;0;10
6938;Pipiras;DRUGELIAI;3314276870;Ne;0;10;0;10
6939;Pipiras;DRUGELIAI;5637557921;Taip;0;1;0;1
6940;Pipiras;DRUGELIAI;1050430252;Ne;0;7;0;7
6941;Pipiras;DRUGELIAI;2255644686;Taip;9;1;0;10
6942;Pipiras;DRUGELIAI;7736031786;Taip;0;4;0;4
6943;Pipiras;GĖLYTĖS;81335131932;Taip;3;0;0;3
6944;Pipiras;GĖLYTĖS;23377947863;Taip;0;15;0;15
6945;Pipiras;GĖLYTĖS;87831792882;Taip;0;3;0;3
6946;Pipiras;GĖLYTĖS;1417855241;Taip;0;2;0;2
6947;Pipiras;GĖLYTĖS;1791226869;Taip;4;9;0;13
6948;Pipiras;GĖLYTĖS;1077104941;Taip;0;1;0;1
6949;Pipiras;GĖLYTĖS;60652954862;Taip;0;8;0;8
6950;Pipiras;GĖLYTĖS;27808576289;Taip;0;18;0;18
6951;Pipiras;GĖLYTĖS;5114553619;Taip;0;1;0;1
6952;Pipiras;GĖLYTĖS;1780531222;Taip;0;1;0;1
6953;Pipiras;GĖLYTĖS;18211174874;Taip;0;6;0;6
6954;Pipiras;GĖLYTĖS;4246712256;Taip;8;3;0;11
6955;Pipiras;GĖLYTĖS;25000181631;Taip;0;8;0;8
6956;Pipiras;GĖLYTĖS;2473644942;Taip;0;6;0;6
6957;Pipiras;GĖLYTĖS;1650661825;Taip;0;1;0;1
6958;Pipiras;GĖLYTĖS;56822466210;Taip;9;1;0;10
6959;Pipiras;GĖLYTĖS;23663823688;Taip;0;22;0;22
6960;Pipiras;GĖLYTĖS;6481320053;Ne;0;2;0;2
6961;Pipiras;BORUŽĖLĖS;54633757340;Taip;0;3;0;3
6962;Pipiras;BORUŽĖLĖS;68636458010;Taip;0;4;0;4
6963;Pipiras;BORUŽĖLĖS;20456702162;Taip;5;1;0;6
6964;Pipiras;BORUŽĖLĖS;57459408180;Taip;0;14;0;14
6965;Pipiras;BORUŽĖLĖS;7354253729;Ne;0;5;0;5
6966;Pipiras;BORUŽĖLĖS;99551392640;Taip;0;6;0;6
6967;Pipiras;BORUŽĖLĖS;9423015002;Taip;0;1;0;1
6968;Pipiras;BORUŽĖLĖS;68235713574;Taip;0;4;0;4
6969;Pipiras;BORUŽĖLĖS;63605758339;Taip;0;0;1;1
6970;Pipiras;BORUŽĖLĖS;23794561369;Taip;0;12;0;12
6971;Pipiras;BORUŽĖLĖS;46165404909;Taip;0;2;0;2
6972;Pipiras;BORUŽĖLĖS;81817710888;Taip;0;5;0;5
6973;Pipiras;BORUŽĖLĖS;7448924569;Taip;0;6;0;6
6974;Pipiras;BORUŽĖLĖS;1676986127;Taip;0;5;0;5
6975;Pipiras;BORUŽĖLĖS;1334584865;Taip;5;1;2;8
6976;Pipiras;BORUŽĖLĖS;9673674008;Taip;0;7;0;7
6977;Pipiras;BORUŽĖLĖS;1657721144;Taip;0;2;0;2
6978;Pipiras;BORUŽĖLĖS;6766596656;Taip;0;1;3;4
6979;Pipiras;SKRUZDĖLIUKAI;1975780209;Taip;13;0;1;14
6980;Pipiras;SKRUZDĖLIUKAI;50739918812;Ne;6;2;0;8
6981;Pipiras;SKRUZDĖLIUKAI;75153377410;Taip;0;7;0;7
6982;Pipiras;SKRUZDĖLIUKAI;7196519583;Taip;0;8;0;8
6983;Pipiras;SKRUZDĖLIUKAI;96711811784;Taip;0;6;0;6
6984;Pipiras;SKRUZDĖLIUKAI;85339674885;Taip;6;4;0;10
6985;Pipiras;SKRUZDĖLIUKAI;61166497338;Taip;5;0;0;5
6986;Pipiras;SKRUZDĖLIUKAI;90202583208;Taip;0;2;0;2
6987;Pipiras;SKRUZDĖLIUKAI;84791674090;Taip;0;3;0;3
6988;Pipiras;SKRUZDĖLIUKAI;49361002482;Taip;0;5;0;5
6989;Pipiras;SKRUZDĖLIUKAI;53377928276;Taip;7;2;0;9
6990;Pipiras;SKRUZDĖLIUKAI;57731282074;Taip;4;0;0;4
6991;Pipiras;SKRUZDĖLIUKAI;1450882528;Taip;14;0;0;14
6992;Pipiras;SKRUZDĖLIUKAI;65132324180;Taip;0;2;0;2
6993;Pipiras;SKRUZDĖLIUKAI;71790101454;Taip;0;4;0;4
6994;Pipiras;SKRUZDĖLIUKAI;73564428514;Ne;0;17;0;17
6995;Pipiras;SKRUZDĖLIUKAI;3867978800;Ne;0;2;0;2
6996;Pipiras;ŽVIRBLIUKŲ;70940029154;Ne;14;0;0;14
6997;Pipiras;ŽVIRBLIUKŲ;1232620336;Taip;0;19;0;19
6998;Pipiras;ŽVIRBLIUKŲ;1549121029;Ne;0;2;0;2
6999;Pipiras;ŽVIRBLIUKŲ;37087220885;Taip;0;1;0;1
7000;Pipiras;ŽVIRBLIUKŲ;1700856741;Taip;9;6;0;15
7001;Pipiras;ŽVIRBLIUKŲ;1319863476;Ne;0;1;0;1
7002;Pipiras;ŽVIRBLIUKŲ;1757192919;Taip;0;12;0;12
7003;Pipiras;ŽVIRBLIUKŲ;1417086043;Taip;0;4;0;4
7004;Pipiras;ŽVIRBLIUKŲ;1441590033;Taip;0;2;0;2
7005;Pipiras;ŽVIRBLIUKŲ;1008228932;Ne;0;4;0;4
7006;Pipiras;ŽVIRBLIUKŲ;2030665851;Taip;0;1;0;1
7007;Pipiras;ŽVIRBLIUKŲ;1182415963;Taip;1;7;0;8
7008;Pipiras;ŽVIRBLIUKŲ;8657924258;Taip;0;7;0;7
7009;Pipiras;ŽVIRBLIUKŲ;10750695428;Ne;5;15;0;20
7010;Pipiras;ŽVIRBLIUKŲ;22190236403;Ne;0;2;0;2
7011;Pipiras;ŽVIRBLIUKŲ;2402351134;Taip;10;4;0;14
7012;Pipiras;ZUIKUČIŲ;2016718354;Ne;5;3;0;8
7013;Pipiras;ZUIKUČIŲ;4017042461;Taip;0;6;0;6
7014;Pipiras;ZUIKUČIŲ;5908707752;Taip;0;5;0;5
7015;Pipiras;ZUIKUČIŲ;8422419380;Taip;0;7;0;7
7016;Pipiras;ZUIKUČIŲ;9892201598;Taip;15;0;0;15
7017;Pipiras;ZUIKUČIŲ;6775489564;Taip;5;3;0;8
7018;Pipiras;ZUIKUČIŲ;9499869533;Taip;3;0;0;3
7019;Pipiras;ZUIKUČIŲ;3980950261;Taip;9;0;0;9
7020;Pipiras;ZUIKUČIŲ;6696824728;Taip;4;1;0;5
7021;Pipiras;ZUIKUČIŲ;6310054093;Taip;2;1;0;3
7022;Pipiras;ZUIKUČIŲ;8167354189;Ne;0;1;0;1
7023;Pipiras;ZUIKUČIŲ;5137132420;Ne;4;3;0;7
7024;Pipiras;ZUIKUČIŲ;6034298583;Taip;15;0;0;15
7025;Pipiras;ZUIKUČIŲ;1019753152;Ne;0;12;0;12
7026;Pipiras;VARLIUKŲ;7969837759;Taip;8;4;0;12
7027;Pipiras;VARLIUKŲ;9625933545;Taip;5;0;0;5
7028;Pipiras;VARLIUKŲ;8819018248;Taip;0;1;0;1
7029;Pipiras;VARLIUKŲ;5888429623;Taip;5;2;0;7
7030;Pipiras;VARLIUKŲ;3768825314;Taip;8;0;1;9
7031;Pipiras;VARLIUKŲ;2296702730;Taip;4;0;0;4
7032;Pipiras;VARLIUKŲ;1711168196;Ne;11;0;0;11
7033;Pipiras;VARLIUKŲ;9968182443;Taip;4;7;0;11
7034;Pipiras;VARLIUKŲ;4309096743;Taip;3;0;2;5
7035;Pipiras;VARLIUKŲ;2483867901;Taip;0;0;1;1
7036;Pipiras;VARLIUKŲ;1315372873;Taip;0;6;0;6
7037;Pipiras;VARLIUKŲ;2892176166;Taip;0;5;0;5
7038;Pipiras;ŽIOGELIŲ;2096009051;Ne;0;19;0;19
7039;Pipiras;ŽIOGELIŲ;71283505646;Ne;0;2;0;2
7040;Pipiras;ŽIOGELIŲ;1485565125;Ne;9;0;0;9
7041;Pipiras;ŽIOGELIŲ;2061168407;Taip;0;12;0;12
7042;Pipiras;ŽIOGELIŲ;2030170020;Ne;0;2;0;2
7043;Pipiras;ŽIOGELIŲ;2637950013;Taip;22;0;0;22
7044;Pipiras;ŽIOGELIŲ;3652741639;Taip;16;0;0;16
7045;Pipiras;ŽIOGELIŲ;1082396096;Taip;0;8;0;8
7046;Pipiras;ŽIOGELIŲ;1324680675;Taip;0;1;0;1
7047;Pipiras;ŽIOGELIŲ;1371141047;Taip;0;7;0;7
7048;Pipiras;ŽIOGELIŲ;1293250996;Taip;0;1;0;1
7049;Pipiras;ŽIOGELIŲ;1751427121;Taip;0;2;0;2
7050;Pipiras;ŽIOGELIŲ;1114377378;Taip;0;10;0;10
7051;Pipiras;ŽIOGELIŲ;8088285579;Ne;0;12;0;12
7052;Pipiras;ŽIOGELIŲ;1876870081;Taip;0;6;0;6
7053;Pumpurėlis;RAMUNĖLIŲ;7610949816;Taip;0;0;1;1
7054;Pumpurėlis;RAMUNĖLIŲ;6165833101;Taip;0;5;0;5
7055;Pumpurėlis;RAMUNĖLIŲ;6977710645;Ne;0;0;6;6
7056;Pumpurėlis;RAMUNĖLIŲ;9431295796;Taip;6;0;7;13
7057;Pumpurėlis;RAMUNĖLIŲ;1395380236;Taip;0;0;10;10
7058;Pumpurėlis;RAMUNĖLIŲ;9424449290;Ne;9;11;0;20
7059;Pumpurėlis;RAMUNĖLIŲ;6955168163;Taip;0;0;2;2
7060;Pumpurėlis;RAMUNĖLIŲ;9726028397;Taip;8;0;0;8
7061;Pumpurėlis;RAMUNĖLIŲ;7229289985;Taip;0;0;9;9
7062;Pumpurėlis;RAMUNĖLIŲ;2969734731;Ne;6;0;0;6
7063;Pumpurėlis;RAMUNĖLIŲ;5663147778;Ne;0;0;3;3
7064;Pumpurėlis;RAMUNĖLIŲ;7559071945;Taip;0;7;0;7
7065;Pumpurėlis;RAMUNĖLIŲ;8373105196;Taip;7;4;3;14
7066;Pumpurėlis;RAMUNĖLIŲ;6574415196;Taip;6;0;1;7
7067;Pumpurėlis;RAMUNĖLIŲ;3953103488;Taip;0;0;1;1
7068;Pumpurėlis;RAMUNĖLIŲ;6511527480;Taip;3;0;0;3
7069;Pumpurėlis;RAMUNĖLIŲ;3838705973;Taip;12;0;2;14
7070;Pumpurėlis;RAMUNĖLIŲ;7996736781;Taip;0;11;0;11
7071;Pumpurėlis;VARPELIŲ;7160091629;Taip;22;0;0;22
7072;Pumpurėlis;VARPELIŲ;3101133244;Ne;5;1;8;14
7073;Pumpurėlis;VARPELIŲ;3893768713;Ne;0;22;0;22
7074;Pumpurėlis;VARPELIŲ;5023658988;Ne;0;3;2;5
7075;Pumpurėlis;VARPELIŲ;2668855786;Taip;0;5;9;14
7076;Pumpurėlis;VARPELIŲ;8258560345;Taip;0;3;0;3
7077;Pumpurėlis;VARPELIŲ;9612924972;Taip;2;1;2;5
7078;Pumpurėlis;VARPELIŲ;9884099545;Taip;8;0;0;8
7079;Pumpurėlis;VARPELIŲ;1687770779;Ne;0;0;22;22
7080;Pumpurėlis;VARPELIŲ;3733509497;Taip;0;6;1;7
7081;Pumpurėlis;VARPELIŲ;4508966729;Taip;4;0;5;9
7082;Pumpurėlis;VARPELIŲ;9552913910;Taip;0;2;0;2
7083;Pumpurėlis;VARPELIŲ;5196733185;Taip;10;0;1;11
7084;Pumpurėlis;VARPELIŲ;4928495108;Taip;0;1;1;2
7085;Pumpurėlis;VARPELIŲ;8886730333;Taip;0;5;0;5
7086;Pumpurėlis;VARPELIŲ;2247300456;Taip;0;5;0;5
7087;Pumpurėlis;VARPELIŲ;5564680653;Taip;0;0;2;2
7088;Pumpurėlis;VARPELIŲ;1411232443;Taip;0;5;1;6
7089;Pumpurėlis;VARPELIŲ;6726772655;Taip;8;0;2;10
7090;Pumpurėlis;DRUGELIŲ;1230058211;Taip;0;11;0;11
7091;Pumpurėlis;DRUGELIŲ;1225377038;Taip;1;0;0;1
7092;Pumpurėlis;DRUGELIŲ;1053338730;Taip;22;0;0;22
7093;Pumpurėlis;DRUGELIŲ;1397924008;Taip;0;10;0;10
7094;Pumpurėlis;DRUGELIŲ;6230500803;Ne;5;0;7;12
7095;Pumpurėlis;DRUGELIŲ;2129779614;Taip;0;5;0;5
7096;Pumpurėlis;DRUGELIŲ;2102427499;Taip;0;2;0;2
7097;Pumpurėlis;DRUGELIŲ;9724549899;Taip;14;0;0;14
7098;Pumpurėlis;DRUGELIŲ;9317495169;Taip;0;5;0;5
7099;Pumpurėlis;DRUGELIŲ;8262886949;Ne;0;3;0;3
7100;Pumpurėlis;DRUGELIŲ;9078991043;Taip;0;0;2;2
7101;Pumpurėlis;DRUGELIŲ;9733380187;Taip;0;2;0;2
7102;Pumpurėlis;DRUGELIŲ;1690424790;Ne;10;2;0;12
7103;Pumpurėlis;DRUGELIŲ;4192641015;Ne;9;0;0;9
7104;Pumpurėlis;DRUGELIŲ;1248017244;Ne;0;8;1;9
7105;Pumpurėlis;DRUGELIŲ;1306102772;Ne;7;3;0;10
7106;Pumpurėlis;KODĖLČIUKŲ;18928851032;Taip;0;1;1;2
7107;Pumpurėlis;KODĖLČIUKŲ;9224879966;Taip;9;0;1;10
7108;Pumpurėlis;KODĖLČIUKŲ;2468796972;Taip;0;15;0;15
7109;Pumpurėlis;KODĖLČIUKŲ;8830261792;Taip;0;1;0;1
7110;Pumpurėlis;KODĖLČIUKŲ;9583257172;Taip;0;2;0;2
7111;Pumpurėlis;KODĖLČIUKŲ;9138883172;Taip;0;0;2;2
7112;Pumpurėlis;KODĖLČIUKŲ;7533555059;Taip;0;8;0;8
7113;Pumpurėlis;KODĖLČIUKŲ;6669327226;Taip;0;1;0;1
7114;Pumpurėlis;KODĖLČIUKŲ;13952236905;Taip;0;0;3;3
7115;Pumpurėlis;KODĖLČIUKŲ;87061817106;Taip;17;0;0;17
7116;Pumpurėlis;KODĖLČIUKŲ;1835168438;Ne;0;1;3;4
7117;Pumpurėlis;KODĖLČIUKŲ;5615260965;Taip;0;4;0;4
7118;Pumpurėlis;KODĖLČIUKŲ;4344595328;Ne;0;12;0;12
7119;Pumpurėlis;KODĖLČIUKŲ;3298821054;Ne;3;0;1;4
7120;Pumpurėlis;KODĖLČIUKŲ;8806961007;Ne;5;0;0;5
7121;Pumpurėlis;KODĖLČIUKŲ;9439363363;Taip;7;0;0;7
7122;Pumpurėlis;KODĖLČIUKŲ;5964953923;Taip;7;0;0;7
7123;Pumpurėlis;KODĖLČIUKŲ;1492810528;Taip;9;6;0;15
7124;Pumpurėlis;LINELIS;44982629856;Taip;0;2;0;2
7125;Pumpurėlis;LINELIS;5901659879;Taip;0;4;0;4
7126;Pumpurėlis;LINELIS;11052382671;Ne;0;7;0;7
7127;Pumpurėlis;LINELIS;46386981131;Ne;0;2;0;2
7128;Pumpurėlis;LINELIS;77110003421;Taip;6;1;0;7
7129;Pumpurėlis;LINELIS;56351492623;Taip;0;4;0;4
7130;Pumpurėlis;LINELIS;70522541316;Taip;0;3;0;3
7131;Pumpurėlis;LINELIS;465606233;Taip;0;1;0;1
7132;Pumpurėlis;LINELIS;40808677022;Taip;3;0;0;3
7133;Pumpurėlis;LINELIS;57426850391;Ne;5;2;0;7
7134;Pumpurėlis;LINELIS;28759758744;Taip;0;1;0;1
7135;Pumpurėlis;LINELIS;36645787745;Taip;4;0;0;4
7136;Pumpurėlis;LINELIS;15256433275;Ne;3;0;0;3
7137;Pumpurėlis;LINELIS;47596248180;Taip;5;0;3;8
7138;Pumpurėlis;LINELIS;97145389284;Ne;7;1;0;8
7139;Pumpurėlis;LINELIS;1645287832;Ne;0;3;0;3
7140;Pumpurėlis;LINELIS;6025998706;Taip;0;8;0;8
7141;Pumpurėlis;LINELIS;2149564401;Ne;0;1;0;1
7142;Pumpurėlis;SAULUTĖS;6215273976;Taip;0;4;0;4
7143;Pumpurėlis;SAULUTĖS;1366801299;Ne;0;2;2;4
7144;Pumpurėlis;SAULUTĖS;1524688901;Ne;0;2;2;4
7145;Pumpurėlis;SAULUTĖS;1021043951;Taip;2;1;0;3
7146;Pumpurėlis;SAULUTĖS;1631951556;Ne;2;3;0;5
7147;Pumpurėlis;SAULUTĖS;9041599264;Taip;0;0;1;1
7148;Pumpurėlis;SAULUTĖS;45279361421;Taip;5;0;0;5
7149;Pumpurėlis;SAULUTĖS;1085633311;Taip;4;0;2;6
7150;Pumpurėlis;SAULUTĖS;66672997420;Taip;0;0;1;1
7151;Pumpurėlis;SAULUTĖS;27361939846;Taip;0;0;2;2
7152;Pumpurėlis;SAULUTĖS;2671657094;Taip;0;0;1;1
7153;Pumpurėlis;SAULUTĖS;61297074638;Taip;0;0;2;2
7154;Pumpurėlis;SAULUTĖS;24681852477;Taip;0;0;5;5
7155;Pumpurėlis;SAULUTĖS;33847164571;Taip;0;0;4;4
7156;Pumpurėlis;SAULUTĖS;20093100251;Taip;0;1;0;1
7157;Pumpurėlis;SAULUTĖS;87813594933;Ne;0;6;0;6
7158;Pumpurėlis;SAULUTĖS;15096075268;Taip;0;4;3;7
7159;Pumpurėlis;SAULUTĖS;72455192748;Taip;5;0;0;5
7160;Pumpurėlis;SAULUTĖS;7015779224;Taip;0;3;0;3
7161;Pumpurėlis;SAULUTĖS;91612536967;Taip;0;2;0;2
7162;Pumpurėlis;BITUTĖS;2028515310;Taip;7;3;0;10
7163;Pumpurėlis;BITUTĖS;1333429949;Taip;3;0;0;3
7164;Pumpurėlis;BITUTĖS;8747439652;Taip;0;8;0;8
7165;Pumpurėlis;BITUTĖS;92238719397;Taip;5;0;0;5
7166;Pumpurėlis;BITUTĖS;1400057487;Ne;0;1;3;4
7167;Pumpurėlis;BITUTĖS;1274293175;Ne;0;4;0;4
7168;Pumpurėlis;BITUTĖS;93809482039;Taip;3;0;0;3
7169;Pumpurėlis;BITUTĖS;7786926187;Taip;0;1;0;1
7170;Pumpurėlis;BITUTĖS;74144468541;Taip;0;5;0;5
7171;Pumpurėlis;BITUTĖS;1640573725;Taip;2;0;1;3
7172;Pumpurėlis;BITUTĖS;1473237607;Taip;4;1;1;6
7173;Pumpurėlis;BITUTĖS;71979455611;Ne;0;5;0;5
7174;Pumpurėlis;BITUTĖS;1001114367;Taip;0;7;0;7
7175;Pumpurėlis;BITUTĖS;26859673794;Taip;12;1;0;13
7176;Pumpurėlis;BITUTĖS;72719147901;Taip;0;5;0;5
7177;Pumpurėlis;BITUTĖS;1527144198;Taip;7;4;0;11
7178;Pumpurėlis;BITUTĖS;57949968899;Taip;1;0;2;3
7179;Pumpurėlis;BITUTĖS;1298302188;Taip;0;3;1;4
7180;Pumpurėlis;BITUTĖS;1255753542;Ne;4;0;1;5
7181;Pumpurėlis;BITUTĖS;3231167303;Taip;0;6;0;6
7182;Pumpurėlis;DOBILIUKAI;1273831078;Taip;0;2;0;2
7183;Pumpurėlis;DOBILIUKAI;1264017142;Ne;8;2;0;10
7184;Pumpurėlis;DOBILIUKAI;98061041685;Taip;0;2;0;2
7185;Pumpurėlis;DOBILIUKAI;1287902351;Taip;0;8;0;8
7186;Pumpurėlis;DOBILIUKAI;13358453137;Taip;0;2;0;2
7187;Pumpurėlis;DOBILIUKAI;1209654095;Taip;5;1;2;8
7188;Pumpurėlis;DOBILIUKAI;40267078306;Ne;0;5;2;7
7189;Pumpurėlis;DOBILIUKAI;51793437519;Taip;0;4;0;4
7190;Pumpurėlis;DOBILIUKAI;1921332565;Taip;0;0;1;1
7191;Pumpurėlis;DOBILIUKAI;1620037477;Taip;0;1;0;1
7192;Pumpurėlis;DOBILIUKAI;1307929787;Taip;0;13;0;13
7193;Pumpurėlis;DOBILIUKAI;1511761574;Taip;0;2;0;2
7194;Pumpurėlis;DOBILIUKAI;1346602122;Taip;0;3;0;3
7195;Pumpurėlis;DOBILIUKAI;88732170322;Taip;0;6;2;8
7196;Pumpurėlis;DOBILIUKAI;94636926281;Ne;0;4;0;4
7197;Pumpurėlis;DOBILIUKAI;1027125361;Taip;0;2;0;2
7198;Pumpurėlis;PUPYČIŲ;3214652626;Ne;0;0;1;1
7199;Pumpurėlis;PUPYČIŲ;2028068230;Ne;5;0;0;5
7200;Pumpurėlis;PUPYČIŲ;5587118874;Ne;4;0;0;4
7201;Pumpurėlis;PUPYČIŲ;7825190756;Ne;0;0;6;6
7202;Pumpurėlis;PUPYČIŲ;9058493247;Ne;4;0;0;4
7203;Pumpurėlis;PUPYČIŲ;3374174445;Ne;0;5;0;5
7204;Pumpurėlis;PUPYČIŲ;6307988067;Taip;0;3;0;3
7205;Pumpurėlis;PUPYČIŲ;1961282282;Ne;3;0;1;4
7206;Pumpurėlis;PUPYČIŲ;9509051946;Taip;0;0;3;3
7207;Pumpurėlis;PUPYČIŲ;5444879430;Ne;11;2;0;13
7208;Pumpurėlis;PUPYČIŲ;7276322999;Taip;4;0;0;4
7209;Pumpurėlis;PUPYČIŲ;1438740562;Taip;4;0;0;4
7210;Pumpurėlis;PUPYČIŲ;5438584331;Taip;1;0;0;1
7211;Pumpurėlis;ŽIRNIUKŲ;1768239820;Taip;0;0;7;7
7212;Pumpurėlis;ŽIRNIUKŲ;7363814444;Taip;0;10;0;10
7213;Pumpurėlis;ŽIRNIUKŲ;4426697956;Taip;0;0;2;2
7214;Pumpurėlis;ŽIRNIUKŲ;1714440337;Taip;0;1;0;1
7215;Pumpurėlis;ŽIRNIUKŲ;8505655534;Taip;18;0;1;19
7216;Pumpurėlis;ŽIRNIUKŲ;1130280140;Ne;7;0;1;8
7217;Pumpurėlis;ŽIRNIUKŲ;3951445693;Taip;7;0;0;7
7218;Pumpurėlis;ŽIRNIUKŲ;9612924316;Taip;0;11;0;11
7219;Pumpurėlis;ŽIRNIUKŲ;8655389224;Ne;13;0;3;16
7220;Pumpurėlis;ŽIRNIUKŲ;4985045047;Taip;22;0;0;22
7221;Pumpurėlis;ŽIRNIUKŲ;3405169131;Taip;6;0;1;7
7222;Pumpurėlis;ŽIRNIUKŲ;1674341906;Taip;0;1;0;1
7223;Pumpurėlis;ŽIRNIUKŲ;2566557351;Taip;10;0;5;15
7224;Pumpurėlis;ŽIRNIUKŲ;2651037375;Taip;18;0;0;18
7225;Pumpurėlis;ŽIRNIUKŲ;5194285627;Ne;7;2;0;9
7226;Pumpurėlis;BORUŽĖLIŲ;42611228425;Ne;4;1;0;5
7227;Pumpurėlis;BORUŽĖLIŲ;1594436797;Taip;2;0;0;2
7228;Pumpurėlis;BORUŽĖLIŲ;1568701327;Ne;4;5;0;9
7229;Pumpurėlis;BORUŽĖLIŲ;1842097360;Ne;3;0;3;6
7230;Pumpurėlis;BORUŽĖLIŲ;82659096039;Taip;0;4;0;4
7231;Pumpurėlis;BORUŽĖLIŲ;1098875585;Ne;0;1;0;1
7232;Pumpurėlis;BORUŽĖLIŲ;1034745510;Taip;8;0;0;8
7233;Pumpurėlis;BORUŽĖLIŲ;5364345261;Taip;7;0;1;8
7234;Pumpurėlis;BORUŽĖLIŲ;1617303626;Taip;4;1;0;5
7235;Pumpurėlis;BORUŽĖLIŲ;1436627913;Taip;0;6;0;6
7236;Pumpurėlis;BORUŽĖLIŲ;1075914140;Ne;0;2;4;6
7237;Pumpurėlis;BORUŽĖLIŲ;2345116167;Taip;0;7;0;7
7238;Pumpurėlis;BORUŽĖLIŲ;63610860077;Taip;0;2;0;2
7239;Pumpurėlis;BORUŽĖLIŲ;1257222112;Ne;3;5;0;8
7240;Pumpurėlis;BORUŽĖLIŲ;1508245418;Ne;5;2;0;7
7241;Pumpurėlis;BORUŽĖLIŲ;81595634697;Taip;7;0;0;7
7242;Pumpurėlis;BORUŽĖLIŲ;1061975374;Taip;0;8;0;8
7243;Puriena;Ančiukų;88588968229;Taip;0;0;1;1
7244;Puriena;Ančiukų;1758690169;Taip;0;6;2;8
7245;Puriena;Ančiukų;1240190350;Taip;14;0;0;14
7246;Puriena;Ančiukų;19157486407;Taip;5;0;0;5
7247;Puriena;Ančiukų;1557814435;Taip;0;1;0;1
7248;Puriena;Ančiukų;87523460146;Taip;0;1;0;1
7249;Puriena;Ančiukų;61241768982;Taip;15;4;0;19
7250;Puriena;Ančiukų;26980342372;Taip;0;1;0;1
7251;Puriena;Ančiukų;4260334053;Taip;0;7;0;7
7252;Puriena;Ančiukų;71778035373;Taip;0;15;0;15
7253;Puriena;Ančiukų;1184946421;Taip;9;0;5;14
7254;Puriena;Ančiukų;59193676476;Taip;0;3;0;3
7255;Puriena;Ančiukų;61117212576;Taip;0;3;2;5
7256;Puriena;Ančiukų;91069175088;Taip;6;0;3;9
7257;Puriena;Ančiukų;16572830524;Taip;0;1;0;1
7258;Puriena;Ančiukų;18592085188;Taip;0;1;0;1
7259;Puriena;Ančiukų;1418776789;Ne;0;0;1;1
7260;Puriena;Ančiukų;3327714361;Taip;0;0;2;2
7261;Puriena;Ančiukų;41863686552;Taip;0;6;0;6
7262;Puriena;Drugeliai;7337038503;Taip;6;1;0;7
7263;Puriena;Drugeliai;47316276655;Ne;0;11;5;16
7264;Puriena;Drugeliai;48468411549;Taip;0;2;10;12
7265;Puriena;Drugeliai;20286870431;Ne;0;8;0;8
7266;Puriena;Drugeliai;63196502622;Taip;0;0;6;6
7267;Puriena;Drugeliai;11497629767;Taip;0;9;0;9
7268;Puriena;Drugeliai;2146036332;Taip;0;0;2;2
7269;Puriena;Drugeliai;1443945321;Taip;0;0;8;8
7270;Puriena;Drugeliai;1703078658;Taip;7;0;1;8
7271;Puriena;Drugeliai;2083071198;Taip;0;2;0;2
7272;Puriena;Drugeliai;8213725698;Ne;0;2;3;5
7273;Puriena;Drugeliai;2378865002;Taip;0;2;0;2
7274;Puriena;Drugeliai;5891404983;Ne;7;2;2;11
7275;Puriena;Drugeliai;9239618299;Taip;0;19;2;21
7276;Puriena;Drugeliai;2089174669;Taip;0;2;3;5
7277;Puriena;Drugeliai;2131343339;Taip;0;2;0;2
7278;Puriena;Drugeliai;1748337587;Taip;0;0;2;2
7279;Puriena;Drugeliai;8618298134;Taip;12;0;0;12
7280;Puriena;Drugeliai;8707076857;Taip;5;0;0;5
7281;Puriena;Drugeliai;1820719083;Taip;7;0;0;7
7282;Puriena;Pelėdžiukai;11431481909;Taip;0;3;0;3
7283;Puriena;Pelėdžiukai;53451774513;Taip;0;1;0;1
7284;Puriena;Pelėdžiukai;12499791115;Taip;0;3;0;3
7285;Puriena;Pelėdžiukai;54048579160;Taip;5;6;0;11
7286;Puriena;Pelėdžiukai;43490363874;Taip;0;13;0;13
7287;Puriena;Pelėdžiukai;21611180390;Taip;0;11;0;11
7288;Puriena;Pelėdžiukai;11677252767;Taip;10;0;0;10
7289;Puriena;Pelėdžiukai;16437608299;Taip;0;9;0;9
7290;Puriena;Pelėdžiukai;69494886505;Taip;0;7;0;7
7291;Puriena;Pelėdžiukai;95972862152;Ne;0;1;0;1
7292;Puriena;Pelėdžiukai;58791977007;Taip;0;1;0;1
7293;Puriena;Pelėdžiukai;53286108187;Ne;0;1;0;1
7294;Puriena;Pelėdžiukai;81806945761;Taip;0;4;0;4
7295;Puriena;Pelėdžiukai;43963341624;Ne;8;0;0;8
7296;Puriena;Pelėdžiukai;26040866189;Taip;0;2;1;3
7297;Puriena;Pelėdžiukai;90508354565;Ne;5;4;0;9
7298;Puriena;Pelėdžiukai;95822432988;Taip;13;1;0;14
7299;Puriena;Pelėdžiukai;2011809589;Taip;0;3;0;3
7300;Puriena;Voveriukai;23746358787;Taip;0;1;0;1
7301;Puriena;Voveriukai;5501308683;Ne;10;1;0;11
7302;Puriena;Voveriukai;92604925140;Taip;0;2;0;2
7303;Puriena;Voveriukai;1263637124;Taip;3;0;0;3
7304;Puriena;Voveriukai;1290933817;Taip;0;1;0;1
7305;Puriena;Voveriukai;7429832136;Taip;0;2;1;3
7306;Puriena;Voveriukai;2663832596;Taip;0;2;0;2
7307;Puriena;Voveriukai;2203259310;Taip;0;0;8;8
7308;Puriena;Voveriukai;40573980976;Taip;0;2;0;2
7309;Puriena;Voveriukai;6057477307;Taip;0;4;0;4
7310;Puriena;Voveriukai;1290962809;Taip;0;4;0;4
7311;Puriena;Voveriukai;11242620566;Ne;4;1;0;5
7312;Puriena;Voveriukai;9139110598;Ne;0;9;0;9
7313;Puriena;Voveriukai;8112003551;Taip;18;0;0;18
7314;Puriena;Voveriukai;9106525954;Taip;1;0;0;1
7315;Puriena;Voveriukai;9146447088;Taip;0;22;0;22
7316;Puriena;Voveriukai;8478901457;Taip;0;2;0;2
7317;Puriena;Bitučių;71773966341;Taip;0;0;9;9
7318;Puriena;Bitučių;1945542034;Taip;0;4;0;4
7319;Puriena;Bitučių;79194353091;Taip;13;0;0;13
7320;Puriena;Bitučių;1629458651;Taip;15;0;0;15
7321;Puriena;Bitučių;91735621242;Ne;7;3;3;13
7322;Puriena;Bitučių;1116529845;Taip;8;0;0;8
7323;Puriena;Bitučių;98967026878;Taip;4;0;2;6
7324;Puriena;Bitučių;5284316470;Taip;0;1;0;1
7325;Puriena;Bitučių;84527348236;Ne;4;0;0;4
7326;Puriena;Bitučių;24572685191;Taip;0;0;11;11
7327;Puriena;Bitučių;8719239663;Taip;6;0;0;6
7328;Puriena;Bitučių;63944407195;Ne;5;1;0;6
7329;Puriena;Bitučių;95153406240;Ne;5;4;2;11
7330;Puriena;Bitučių;1125102675;Ne;5;5;0;10
7331;Puriena;Bitučių;29217326976;Taip;19;0;3;22
7332;Puriena;Bitučių;9666714143;Taip;4;1;1;6
7333;Puriena;Bitučių;1376708741;Ne;4;0;6;10
7334;Puriena;Bitučių;1507059980;Ne;13;1;0;14
7335;Puriena;Bitučių;85334594528;Taip;0;0;2;2
7336;Puriena;Bitučių;1206969296;Ne;0;0;8;8
7337;Puriena;Zylutės;29931607789;Ne;5;2;1;8
7338;Puriena;Zylutės;14052847763;Taip;8;0;1;9
7339;Puriena;Zylutės;46510003255;Taip;0;4;0;4
7340;Puriena;Zylutės;1993142891;Ne;0;10;0;10
7341;Puriena;Zylutės;6539425730;Taip;0;6;0;6
7342;Puriena;Zylutės;88483773966;Taip;0;17;0;17
7343;Puriena;Zylutės;45128021817;Ne;5;10;0;15
7344;Puriena;Zylutės;7285127722;Ne;12;2;0;14
7345;Puriena;Zylutės;87711542948;Taip;0;0;6;6
7346;Puriena;Zylutės;14780389529;Taip;0;4;1;5
7347;Puriena;Zylutės;1994224209;Taip;0;2;1;3
7348;Puriena;Meškučių;9251058353;Ne;4;0;2;6
7349;Puriena;Meškučių;1030958414;Taip;9;0;0;9
7350;Puriena;Meškučių;7967288875;Ne;0;0;8;8
7351;Puriena;Meškučių;6158842119;Taip;14;2;0;16
7352;Puriena;Meškučių;4060087185;Taip;0;0;8;8
7353;Puriena;Meškučių;3033562627;Taip;9;3;2;14
7354;Puriena;Meškučių;5777076971;Taip;9;3;2;14
7355;Puriena;Meškučių;8310231540;Taip;0;1;0;1
7356;Puriena;Meškučių;4460575818;Taip;7;6;0;13
7357;Puriena;Meškučių;8120597514;Taip;0;4;0;4
7358;Puriena;Meškučių;5336923102;Taip;5;0;0;5
7359;Puriena;Meškučių;4605662701;Taip;0;8;0;8
7360;Puriena;Meškučių;1819876614;Taip;0;0;9;9
7361;Puriena;Meškučių;4776745276;Ne;5;0;6;11
7362;Puriena;Meškučių;7769252165;Taip;0;2;4;6
7363;Puriena;Meškučių;2170025682;Taip;4;0;0;4
7364;Puriena;Meškučių;3772941726;Taip;5;2;0;7
7365;Puriena;Meškučių;1428098802;Taip;5;2;0;7
7366;Puriena;Nykštukų;8237149969;Taip;8;0;1;9
7367;Puriena;Nykštukų;1295692895;Taip;4;0;0;4
7368;Puriena;Nykštukų;8416003733;Taip;0;6;0;6
7369;Puriena;Nykštukų;5224135638;Ne;14;1;0;15
7370;Puriena;Nykštukų;9543884311;Taip;0;12;10;22
7371;Puriena;Nykštukų;4017644414;Ne;0;2;2;4
7372;Puriena;Nykštukų;6780164845;Taip;14;0;1;15
7373;Puriena;Nykštukų;1398572100;Taip;6;0;2;8
7374;Puriena;Nykštukų;1339162214;Taip;13;0;0;13
7375;Puriena;Nykštukų;6656013805;Taip;0;1;0;1
7376;Puriena;Nykštukų;7573536525;Taip;6;2;0;8
7377;Puriena;Nykštukų;8022809059;Taip;14;0;0;14
7378;Puriena;Nykštukų;5395382717;Taip;0;6;0;6
7379;Puriena;Nykštukų;4444523140;Ne;0;11;6;17
7380;Puriena;Nykštukų;7622407056;Taip;0;4;0;4
7381;Puriena;Nykštukų;6813480086;Ne;0;1;0;1
7382;Puriena;Nykštukų;9854244405;Ne;0;9;0;9
7383;Puriena;Nykštukų;4498919764;Taip;0;3;6;9
7384;Puriena;Ežiukai;1900570261;Taip;0;1;2;3
7385;Puriena;Ežiukai;1704296685;Taip;0;12;0;12
7386;Puriena;Ežiukai;1174355613;Taip;0;2;1;3
7387;Puriena;Ežiukai;2255508780;Taip;0;2;0;2
7388;Puriena;Ežiukai;35226601932;Taip;0;2;0;2
7389;Puriena;Ežiukai;2072874096;Taip;3;2;1;6
7390;Puriena;Ežiukai;11011727269;Taip;0;9;0;9
7391;Puriena;Ežiukai;87416314075;Taip;0;4;0;4
7392;Puriena;Ežiukai;1175577834;Taip;0;2;6;8
7393;Puriena;Ežiukai;9471669903;Taip;6;1;0;7
7394;Puriena;Ežiukai;1707413291;Taip;0;2;0;2
7395;Puriena;Ežiukai;1773431155;Taip;0;1;0;1
7396;Puriena;Ežiukai;1379084331;Taip;0;0;2;2
7397;Puriena;Ežiukai;1710087159;Taip;0;1;0;1
7398;Puriena;Ežiukai;21180207545;Taip;0;0;7;7
7399;Puriena;Ežiukai;1762395617;Taip;0;6;0;6
7400;Puriena;Ežiukai;2560477213;Taip;0;2;0;2
7401;Puriena;Ežiukai;1786569222;Taip;0;2;5;7
7402;Puriena;Ežiukai;4792538031;Taip;0;1;0;1
7403;Puriena;"Boružiukų ";8061605125;Taip;5;0;1;6
7404;Puriena;"Boružiukų ";4858971990;Taip;0;2;1;3
7405;Puriena;"Boružiukų ";4608801156;Taip;5;0;0;5
7406;Puriena;"Boružiukų ";6463129806;Taip;9;0;2;11
7407;Puriena;"Boružiukų ";4501239330;Taip;4;0;0;4
7408;Puriena;"Boružiukų ";6197840105;Ne;17;0;0;17
7409;Puriena;"Boružiukų ";3175917649;Taip;0;0;3;3
7410;Puriena;"Boružiukų ";6786694796;Taip;4;0;0;4
7411;Puriena;"Boružiukų ";1417566073;Taip;9;0;0;9
7412;Puriena;"Boružiukų ";3671297035;Taip;0;8;0;8
7413;Puriena;"Boružiukų ";6352605894;Ne;0;0;4;4
7414;Puriena;"Boružiukų ";2579402981;Taip;0;2;1;3
7415;Puriena;"Boružiukų ";2267225709;Taip;5;0;0;5
7416;Puriena;"Boružiukų ";6413337915;Taip;0;0;3;3
7417;Puriena;"Boružiukų ";5341228269;Taip;18;0;0;18
7418;Puriena;"Zuikučių ";6883573289;Taip;0;0;9;9
7419;Puriena;"Zuikučių ";7120683581;Taip;4;2;0;6
7420;Puriena;"Zuikučių ";8144488922;Taip;0;0;1;1
7421;Puriena;"Zuikučių ";4283608124;Taip;0;8;0;8
7422;Puriena;"Zuikučių ";8130975863;Taip;0;1;0;1
7423;Puriena;"Zuikučių ";2813562677;Taip;0;3;2;5
7424;Puriena;"Zuikučių ";3542374463;Taip;0;1;0;1
7425;Puriena;"Zuikučių ";1933733714;Taip;0;5;0;5
7426;Puriena;"Zuikučių ";6150437624;Taip;0;2;1;3
7427;Puriena;"Zuikučių ";3627403517;Taip;0;0;6;6
7428;Puriena;"Zuikučių ";4070825932;Taip;0;0;10;10
7429;Puriena;"Zuikučių ";4653085762;Taip;10;6;0;16
7430;Puriena;"Zuikučių ";8952508230;Taip;11;0;3;14
7431;Puriena;"Zuikučių ";7169054113;Taip;0;6;0;6
7432;Puriena;"Zuikučių ";8476986855;Taip;15;1;0;16
7433;Puriena;"Zuikučių ";3309219271;Taip;0;6;0;6
7434;Puriena;"Zuikučių ";2624283930;Taip;8;0;0;8
7435;Pušaitė;Kodėlčiukai;62054870153;Taip;6;1;0;7
7436;Pušaitė;Kodėlčiukai;44525744411;Taip;11;0;0;11
7437;Pušaitė;Kodėlčiukai;1434600898;Ne;0;8;4;12
7438;Pušaitė;Kodėlčiukai;92087943993;Ne;5;1;0;6
7439;Pušaitė;Kodėlčiukai;10391045958;Taip;0;2;1;3
7440;Pušaitė;Kodėlčiukai;79462284429;Taip;17;0;0;17
7441;Pušaitė;Kodėlčiukai;51875651426;Taip;0;5;0;5
7442;Pušaitė;Kodėlčiukai;35587797387;Taip;0;5;3;8
7443;Pušaitė;Kodėlčiukai;12300222260;Ne;5;0;0;5
7444;Pušaitė;Kodėlčiukai;37480908997;Taip;0;1;5;6
7445;Pušaitė;Kodėlčiukai;81773729142;Taip;7;10;0;17
7446;Pušaitė;Kodėlčiukai;15593642938;Taip;0;6;3;9
7447;Pušaitė;Kodėlčiukai;10955132610;Taip;0;0;3;3
7448;Pušaitė;Kodėlčiukai;7680945149;Taip;0;1;7;8
7449;Pušaitė;Kodėlčiukai;89687717250;Taip;12;1;3;16
7450;Pušaitė;Kodėlčiukai;36677285052;Taip;6;0;0;6
7451;Pušaitė;Kodėlčiukai;3554790718;Taip;0;0;2;2
7452;Pušaitė;Kodėlčiukai;1912176781;Taip;0;4;0;4
7453;Pušaitė;Kodėlčiukai;20960105409;Taip;15;1;0;16
7454;Pušaitė;Kodėlčiukai;95522616207;Taip;0;0;3;3
7455;Pušaitė;Kodėlčiukai;66025911973;Taip;0;1;10;11
7456;Pušaitė;Saulutės;1918948738;Taip;6;0;0;6
7457;Pušaitė;Saulutės;29899199427;Taip;0;2;0;2
7458;Pušaitė;Saulutės;20174084726;Ne;2;0;0;2
7459;Pušaitė;Saulutės;36646217833;Taip;11;2;1;14
7460;Pušaitė;Saulutės;40449072854;Taip;5;1;0;6
7461;Pušaitė;Saulutės;46097491628;Taip;0;2;0;2
7462;Pušaitė;Saulutės;2066639203;Taip;6;4;0;10
7463;Pušaitė;Saulutės;99740435577;Ne;0;4;0;4
7464;Pušaitė;Saulutės;34324686486;Taip;5;2;2;9
7465;Pušaitė;Saulutės;88286687854;Taip;0;10;0;10
7466;Pušaitė;Saulutės;1302087452;Taip;0;2;3;5
7467;Pušaitė;Saulutės;61624123734;Taip;9;1;0;10
7468;Pušaitė;Saulutės;10115195053;Taip;1;0;0;1
7469;Pušaitė;Saulutės;22491605433;Taip;0;5;0;5
7470;Pušaitė;Saulutės;1389123203;Taip;10;0;4;14
7471;Pušaitė;Saulutės;2030939996;Ne;0;4;5;9
7472;Pušaitė;Saulutės;1444313482;Taip;4;0;0;4
7473;Pušaitė;Zuikučiai;2115591523;Taip;4;0;2;6
7474;Pušaitė;Zuikučiai;8738827821;Ne;4;0;7;11
7475;Pušaitė;Zuikučiai;2181510181;Taip;9;1;0;10
7476;Pušaitė;Zuikučiai;7477429922;Taip;0;3;0;3
7477;Pušaitė;Zuikučiai;6306133416;Taip;4;2;0;6
7478;Pušaitė;Zuikučiai;2099169654;Taip;0;0;3;3
7479;Pušaitė;Zuikučiai;6355379926;Ne;15;1;0;16
7480;Pušaitė;Zuikučiai;9389544351;Taip;0;22;0;22
7481;Pušaitė;Zuikučiai;80743691769;Taip;5;0;1;6
7482;Pušaitė;Zuikučiai;1296700534;Taip;9;2;1;12
7483;Pušaitė;Zuikučiai;51500717235;Taip;11;0;0;11
7484;Pušaitė;Zuikučiai;2125574493;Ne;0;0;1;1
7485;Pušaitė;Zuikučiai;5398532705;Taip;0;8;2;10
7486;Pušaitė;Zuikučiai;8309000712;Taip;16;1;0;17
7487;Pušaitė;Zuikučiai;4881689337;Taip;4;3;0;7
7488;Pušaitė;Zuikučiai;3718196299;Taip;0;0;2;2
7489;Pušaitė;Zuikučiai;1295203136;Taip;0;0;3;3
7490;Pušaitė;Zuikučiai;6259961070;Ne;0;6;1;7
7491;Pušaitė;Zuikučiai;2944418714;Ne;17;0;1;18
7492;Pušaitė;Zuikučiai;3813761666;Ne;0;0;21;21
7493;Pušaitė;Zuikučiai;4762094720;Taip;7;0;0;7
7494;Pušaitė;Zuikučiai;6600314608;Taip;0;0;1;1
7495;Pušaitė;Zuikučiai;2130767942;Taip;0;22;0;22
7496;Pušaitė;Vėžliukai;1386420328;Taip;0;0;1;1
7497;Pušaitė;Vėžliukai;1863885754;Taip;10;0;0;10
7498;Pušaitė;Vėžliukai;4050198577;Taip;5;0;2;7
7499;Pušaitė;Vėžliukai;1412632976;Taip;0;21;0;21
7500;Pušaitė;Vėžliukai;8361761447;Taip;2;0;2;4
7501;Pušaitė;Vėžliukai;4490041906;Taip;5;7;0;12
7502;Pušaitė;Vėžliukai;97738851561;Taip;0;21;0;21
7503;Pušaitė;Vėžliukai;1502634518;Taip;0;0;5;5
7504;Pušaitė;Vėžliukai;57025420993;Ne;0;22;0;22
7505;Pušaitė;Vėžliukai;73291156409;Taip;0;0;5;5
7506;Pušaitė;Vėžliukai;5262505407;Ne;4;0;3;7
7507;Pušaitė;Vėžliukai;1569413876;Taip;10;0;0;10
7508;Pušaitė;Vėžliukai;2892138891;Taip;14;0;8;22
7509;Pušaitė;Vėžliukai;3745881982;Taip;0;13;0;13
7510;Pušaitė;Vėžliukai;3577616212;Taip;8;2;1;11
7511;Pušaitė;Vėžliukai;71218084687;Taip;2;0;3;5
7512;Pušaitė;Vėžliukai;8155746120;Taip;0;0;1;1
7513;Pušaitė;Vėžliukai;8592426606;Taip;0;0;3;3
7514;Pušaitė;Vėžliukai;6752676513;Taip;0;0;2;2
7515;Pušaitė;Vėžliukai;1972872969;Taip;0;21;0;21
7516;Pušaitė;Vėžliukai;2856902024;Taip;0;21;0;21
7517;Pušaitė;Vėžliukai;1878172874;Taip;0;8;0;8
7518;Pušaitė;"Linksmieji nykštukai";7520393710;Taip;5;0;0;5
7519;Pušaitė;"Linksmieji nykštukai";4517181474;Ne;12;0;0;12
7520;Pušaitė;"Linksmieji nykštukai";9033615485;Taip;0;7;0;7
7521;Pušaitė;"Linksmieji nykštukai";3130824742;Taip;0;6;0;6
7522;Pušaitė;"Linksmieji nykštukai";4605161267;Taip;16;0;0;16
7523;Pušaitė;"Linksmieji nykštukai";6160825713;Taip;2;2;2;6
7524;Pušaitė;"Linksmieji nykštukai";1781601521;Taip;6;1;2;9
7525;Pušaitė;"Linksmieji nykštukai";1024996364;Taip;5;0;1;6
7526;Pušaitė;"Linksmieji nykštukai";4662871524;Taip;0;3;0;3
7527;Pušaitė;"Linksmieji nykštukai";8438652029;Taip;0;1;2;3
7528;Pušaitė;"Linksmieji nykštukai";6578483902;Taip;9;0;1;10
7529;Pušaitė;"Linksmieji nykštukai";9327636862;Taip;3;11;0;14
7530;Pušaitė;"Linksmieji nykštukai";4175909754;Taip;6;0;3;9
7531;Pušaitė;"Linksmieji nykštukai";3788392895;Taip;10;0;2;12
7532;Pušaitė;"Linksmieji nykštukai";3195191374;Taip;11;0;0;11
7533;Pušaitė;"Linksmieji nykštukai";9127444013;Taip;3;1;0;4
7534;Pušaitė;"Linksmieji nykštukai";5422784898;Ne;9;0;2;11
7535;Pušaitė;"Linksmieji nykštukai";5104111840;Taip;12;0;0;12
7536;Pušaitė;"Linksmieji nykštukai";9866431097;Taip;13;0;0;13
7537;Pušaitė;"Linksmieji nykštukai";4564478833;Taip;5;0;1;6
7538;Pušaitė;"Kačiukų trobelė";3695016765;Taip;15;0;0;15
7539;Pušaitė;"Kačiukų trobelė";7983115812;Taip;4;1;0;5
7540;Pušaitė;"Kačiukų trobelė";7614475216;Taip;4;0;0;4
7541;Pušaitė;"Kačiukų trobelė";1122112207;Taip;0;0;6;6
7542;Pušaitė;"Kačiukų trobelė";1635528919;Taip;6;0;0;6
7543;Pušaitė;"Kačiukų trobelė";2837439334;Taip;7;0;0;7
7544;Pušaitė;"Kačiukų trobelė";7014914682;Ne;0;19;0;19
7545;Pušaitė;"Kačiukų trobelė";1624587173;Taip;0;0;6;6
7546;Pušaitė;"Kačiukų trobelė";8793102437;Ne;0;16;0;16
7547;Pušaitė;"Kačiukų trobelė";9056933586;Taip;8;14;0;22
7548;Pušaitė;"Kačiukų trobelė";7898355721;Taip;6;0;1;7
7549;Pušaitė;"Kačiukų trobelė";4374232593;Ne;11;0;5;16
7550;Pušaitė;"Kačiukų trobelė";6323180798;Taip;10;0;0;10
7551;Pušaitė;"Kačiukų trobelė";5191894075;Taip;13;0;2;15
7552;Pušaitė;"Kačiukų trobelė";1161519408;Taip;9;0;0;9
7553;Pušaitė;"Kačiukų trobelė";8822285103;Taip;9;0;0;9
7554;Pušaitė;"Kačiukų trobelė";9313564235;Taip;13;1;0;14
7555;Pušaitė;"Kačiukų trobelė";5564338170;Taip;0;1;1;2
7556;Pušaitė;"Kačiukų trobelė";9291306449;Taip;4;0;2;6
7557;Pušaitė;"Kačiukų trobelė";2865062081;Taip;3;0;0;3
7558;Pušaitė;Ežiukai;2090143259;Taip;0;0;5;5
7559;Pušaitė;Ežiukai;9524002395;Taip;0;6;2;8
7560;Pušaitė;Ežiukai;7305350540;Ne;10;4;0;14
7561;Pušaitė;Ežiukai;5394378197;Taip;0;0;1;1
7562;Pušaitė;Ežiukai;15270671089;Taip;0;1;0;1
7563;Pušaitė;Ežiukai;69869396094;Taip;0;1;4;5
7564;Pušaitė;Ežiukai;1143122778;Ne;0;1;8;9
7565;Pušaitė;Ežiukai;9461292576;Taip;16;1;0;17
7566;Pušaitė;Ežiukai;5185787803;Taip;7;1;2;10
7567;Pušaitė;Ežiukai;4671293211;Taip;0;1;0;1
7568;Pušaitė;Ežiukai;4101326122;Taip;7;0;0;7
7569;Pušaitė;Ežiukai;8958364766;Taip;5;1;0;6
7570;Pušaitė;Ežiukai;7808186865;Taip;10;5;0;15
7571;Pušaitė;Ežiukai;4842783897;Taip;7;1;0;8
7572;Pušaitė;Ežiukai;5436168234;Taip;13;0;0;13
7573;Pušaitė;Ežiukai;6472169278;Ne;5;0;0;5
7574;Pušaitė;Ežiukai;8021494509;Taip;0;22;0;22
7575;Pušaitė;Ežiukai;2172342063;Taip;17;1;0;18
7576;Pušaitė;"Gudručių šalis";6470721291;Taip;4;1;0;5
7577;Pušaitė;"Gudručių šalis";24768657107;Taip;3;0;1;4
7578;Pušaitė;"Gudručių šalis";55304000825;Taip;0;1;2;3
7579;Pušaitė;"Gudručių šalis";15550007793;Taip;0;1;8;9
7580;Pušaitė;"Gudručių šalis";4386242143;Taip;0;1;5;6
7581;Pušaitė;"Gudručių šalis";9997642887;Taip;0;2;1;3
7582;Pušaitė;"Gudručių šalis";15546035138;Taip;0;2;1;3
7583;Pušaitė;"Gudručių šalis";79097991060;Taip;0;1;1;2
7584;Pušaitė;"Gudručių šalis";1275885492;Taip;0;2;14;16
7585;Pušaitė;"Gudručių šalis";40886746431;Taip;9;0;2;11
7586;Pušaitė;"Gudručių šalis";90178990466;Taip;0;0;2;2
7587;Pušaitė;"Gudručių šalis";89985930634;Taip;0;22;0;22
7588;Pušaitė;"Gudručių šalis";4266368627;Taip;0;5;2;7
7589;Pušaitė;"Gudručių šalis";49973513385;Taip;0;8;0;8
7590;Pušaitė;"Gudručių šalis";89212112638;Taip;0;1;5;6
7591;Pušaitė;"Gudručių šalis";11297426946;Taip;0;0;2;2
7592;Pušaitė;"Gudručių šalis";35947321028;Taip;0;22;0;22
7593;Pušaitė;"Gudručių šalis";87504481892;Ne;6;8;1;15
7594;Pušaitė;"Gudručių šalis";6915619931;Ne;0;4;0;4
7595;Pušaitė;"Gudručių šalis";41026183089;Taip;0;1;2;3
7596;Pušaitė;"Lapučių mokyklėlė";1102988768;Taip;9;0;2;11
7597;Pušaitė;"Lapučių mokyklėlė";53211427399;Taip;0;1;5;6
7598;Pušaitė;"Lapučių mokyklėlė";40417586835;Taip;0;6;0;6
7599;Pušaitė;"Lapučių mokyklėlė";91960884985;Taip;0;0;6;6
7600;Pušaitė;"Lapučių mokyklėlė";60394388920;Taip;0;1;0;1
7601;Pušaitė;"Lapučių mokyklėlė";85343380637;Ne;3;4;0;7
7602;Pušaitė;"Lapučių mokyklėlė";2044213583;Taip;0;22;0;22
7603;Pušaitė;"Lapučių mokyklėlė";7408224942;Taip;0;2;0;2
7604;Pušaitė;"Lapučių mokyklėlė";1394847204;Ne;4;0;0;4
7605;Pušaitė;"Lapučių mokyklėlė";21992678312;Taip;15;0;0;15
7606;Pušaitė;"Lapučių mokyklėlė";77082825248;Taip;2;0;0;2
7607;Pušaitė;"Lapučių mokyklėlė";53766202712;Taip;3;2;0;5
7608;Pušaitė;"Lapučių mokyklėlė";3231637165;Taip;14;2;0;16
7609;Pušaitė;"Lapučių mokyklėlė";6542917863;Taip;9;5;0;14
7610;Pušaitė;"Lapučių mokyklėlė";9179757395;Taip;18;0;0;18
7611;Pušaitė;"Lapučių mokyklėlė";8470059012;Ne;0;0;13;13
7612;Pušaitė;"Lapučių mokyklėlė";1798044901;Ne;0;22;0;22
7613;Pušaitė;"Lapučių mokyklėlė";7251064118;Taip;0;3;0;3
7614;Pušaitė;"VOVERIUKAI ";1978339054;Taip;6;0;0;6
7615;Pušaitė;"VOVERIUKAI ";1326581025;Taip;0;12;0;12
7616;Pušaitė;"VOVERIUKAI ";5161142520;Taip;10;0;0;10
7617;Pušaitė;"VOVERIUKAI ";3014867515;Taip;10;0;0;10
7618;Pušaitė;"VOVERIUKAI ";9527253696;Taip;19;0;0;19
7619;Pušaitė;"VOVERIUKAI ";3485234259;Taip;17;0;0;17
7620;Pušaitė;"VOVERIUKAI ";1996544496;Taip;9;1;0;10
7621;Pušaitė;"VOVERIUKAI ";6739253961;Taip;8;0;0;8
7622;Pušaitė;"VOVERIUKAI ";8412276797;Taip;0;0;1;1
7623;Pušaitė;"VOVERIUKAI ";9470667227;Taip;17;0;0;17
7624;Pušaitė;"VOVERIUKAI ";4326967247;Taip;0;22;0;22
7625;Pušaitė;MEŠKUČIAI;8702361596;Ne;6;1;0;7
7626;Pušaitė;MEŠKUČIAI;7890577174;Taip;12;1;0;13
7627;Pušaitė;MEŠKUČIAI;2253477550;Taip;3;6;0;9
7628;Pušaitė;MEŠKUČIAI;4103149433;Taip;0;1;0;1
7629;Pušaitė;MEŠKUČIAI;6186545163;Taip;5;4;1;10
7630;Pušaitė;MEŠKUČIAI;4198571222;Taip;5;0;0;5
7631;Pušaitė;MEŠKUČIAI;4838345510;Taip;3;2;1;6
7632;Pušaitė;MEŠKUČIAI;7068451014;Ne;3;0;0;3
7633;Pušaitė;MEŠKUČIAI;5281161835;Taip;1;0;0;1
7634;Pušaitė;MEŠKUČIAI;6275090953;Taip;0;0;1;1
7635;Pušaitė;MEŠKUČIAI;7117784038;Ne;12;1;0;13
7636;Pušaitė;MEŠKUČIAI;4747611989;Taip;7;9;0;16
7637;Pušaitė;MEŠKUČIAI;8750774616;Taip;0;6;0;6
7638;Pušaitė;MEŠKUČIAI;6576647982;Taip;1;0;0;1
7639;Pušaitė;MEŠKUČIAI;3832434608;Taip;0;3;1;4
7640;Pušaitė;PELIUKAI;3698808100;Ne;10;1;0;11
7641;Pušaitė;PELIUKAI;6833083982;Taip;0;1;3;4
7642;Pušaitė;PELIUKAI;2793941689;Taip;0;22;0;22
7643;Pušaitė;PELIUKAI;6445790780;Taip;5;0;0;5
7644;Pušaitė;PELIUKAI;2004615252;Taip;0;22;0;22
7645;Pušaitė;PELIUKAI;6794867560;Taip;5;0;0;5
7646;Pušaitė;PELIUKAI;5296435012;Taip;0;10;0;10
7647;Pušaitė;PELIUKAI;8399589954;Taip;5;2;0;7
7648;Pušaitė;PELIUKAI;4615270419;Taip;11;0;0;11
7649;Pušaitė;PELIUKAI;7652706756;Taip;4;1;0;5
7650;Pušaitė;PELIUKAI;4743105731;Taip;4;0;0;4
7651;Pušaitė;PELIUKAI;5318602924;Taip;0;0;13;13
7652;Pušaitė;PELIUKAI;7945713337;Taip;5;1;0;6
7653;Pušaitė;PELIUKAI;1935059739;Taip;0;0;22;22
7654;Pušaitė;PELIUKAI;9364887123;Taip;10;0;0;10
7655;Pušaitė;PELIUKAI;6180888008;Taip;2;1;1;4
7656;Pušaitė;PELIUKAI;9391350218;Taip;0;13;0;13
7657;Pušynėlis;PUMPURĖLIAI;7177725663;Taip;0;10;0;10
7658;Pušynėlis;PUMPURĖLIAI;1891728904;Taip;0;1;10;11
7659;Pušynėlis;PUMPURĖLIAI;3100230874;Taip;0;22;0;22
7660;Pušynėlis;PUMPURĖLIAI;4030500100;Taip;2;0;0;2
7661;Pušynėlis;PUMPURĖLIAI;8172450090;Taip;2;0;0;2
7662;Pušynėlis;PUMPURĖLIAI;9039274775;Taip;18;0;1;19
7663;Pušynėlis;PUMPURĖLIAI;6077698697;Taip;0;0;2;2
7664;Pušynėlis;PUMPURĖLIAI;7046421581;Taip;8;0;1;9
7665;Pušynėlis;PUMPURĖLIAI;7729392498;Taip;0;0;1;1
7666;Pušynėlis;PUMPURĖLIAI;4380948433;Taip;0;0;5;5
7667;Pušynėlis;PUMPURĖLIAI;4668634909;Ne;0;1;0;1
7668;Pušynėlis;PUMPURĖLIAI;2793982816;Ne;0;0;5;5
7669;Pušynėlis;PUMPURĖLIAI;4920818548;Taip;22;0;0;22
7670;Pušynėlis;PUMPURĖLIAI;2508640229;Taip;3;0;1;4
7671;Pušynėlis;PUMPURĖLIAI;5236219294;Taip;0;0;4;4
7672;Pušynėlis;PUMPURĖLIAI;4052132379;Taip;3;0;0;3
7673;Pušynėlis;PUMPURĖLIAI;2141785580;Taip;0;3;0;3
7674;Pušynėlis;PUMPURĖLIAI;6560054869;Taip;0;0;14;14
7675;Pušynėlis;SAULUTĖS;74952593070;Taip;8;0;0;8
7676;Pušynėlis;SAULUTĖS;1610449906;Taip;0;3;0;3
7677;Pušynėlis;SAULUTĖS;1811758590;Taip;0;0;1;1
7678;Pušynėlis;SAULUTĖS;8742287326;Taip;0;0;4;4
7679;Pušynėlis;SAULUTĖS;25261143142;Taip;0;9;0;9
7680;Pušynėlis;SAULUTĖS;2012089695;Taip;0;13;0;13
7681;Pušynėlis;SAULUTĖS;1284674882;Taip;0;15;0;15
7682;Pušynėlis;SAULUTĖS;35538053975;Taip;0;1;0;1
7683;Pušynėlis;SAULUTĖS;3510202379;Ne;0;7;7;14
7684;Pušynėlis;SAULUTĖS;6716726918;Ne;7;0;0;7
7685;Pušynėlis;SAULUTĖS;9665845150;Taip;0;3;0;3
7686;Pušynėlis;SAULUTĖS;2765869141;Taip;0;0;8;8
7687;Pušynėlis;PRIEŠMOKYKLINĖ;3527543120;Ne;3;0;0;3
7688;Pušynėlis;PRIEŠMOKYKLINĖ;6862900911;Taip;9;0;4;13
7689;Pušynėlis;PRIEŠMOKYKLINĖ;4291894982;Taip;8;0;0;8
7690;Pušynėlis;PRIEŠMOKYKLINĖ;16192036601;Taip;5;0;0;5
7691;Pušynėlis;PRIEŠMOKYKLINĖ;93484950406;Ne;0;0;8;8
7692;Pušynėlis;PRIEŠMOKYKLINĖ;1955967062;Taip;0;0;2;2
7693;Pušynėlis;PRIEŠMOKYKLINĖ;79386112020;Ne;0;0;1;1
7694;Pušynėlis;PRIEŠMOKYKLINĖ;2042833795;Taip;0;3;0;3
7695;Pušynėlis;PRIEŠMOKYKLINĖ;58252435610;Taip;0;6;0;6
7696;Pušynėlis;PRIEŠMOKYKLINĖ;51866074822;Taip;0;0;1;1
7697;Pušynėlis;PRIEŠMOKYKLINĖ;75716791245;Taip;0;10;0;10
7698;Pušynėlis;PRIEŠMOKYKLINĖ;39796631884;Taip;0;5;0;5
7699;Pušynėlis;PRIEŠMOKYKLINĖ;1863758087;Taip;0;1;0;1
7700;Pušynėlis;PRIEŠMOKYKLINĖ;91759717760;Taip;0;13;0;13
7701;Pušynėlis;PRIEŠMOKYKLINĖ;2431940444;Taip;0;6;0;6
7702;Pušynėlis;PRIEŠMOKYKLINĖ;40478713455;Taip;0;9;0;9
7703;Pušynėlis;PRIEŠMOKYKLINĖ;1415916851;Taip;7;0;0;7
7704;Pušynėlis;PRIEŠMOKYKLINĖ;1367922475;Taip;0;0;1;1
7705;Pušynėlis;PRIEŠMOKYKLINĖ;1585572669;Taip;3;6;0;9
7706;Pušynėlis;LOPŠELIS;2718421498;Taip;0;4;0;4
7707;Pušynėlis;LOPŠELIS;8218331977;Taip;0;10;0;10
7708;Pušynėlis;LOPŠELIS;1818077465;Taip;0;20;0;20
7709;Pušynėlis;LOPŠELIS;1251787066;Taip;0;0;12;12
7710;Pušynėlis;LOPŠELIS;4052365035;Taip;0;0;1;1
7711;Pušynėlis;LOPŠELIS;7896617995;Taip;0;0;4;4
7712;Pušynėlis;LOPŠELIS;9483417104;Taip;15;0;0;15
7713;Pušynėlis;LOPŠELIS;9081582524;Taip;2;0;0;2
7714;Pušynėlis;LOPŠELIS;3882064516;Taip;2;0;0;2
7715;Pušynėlis;LOPŠELIS;1034336110;Taip;0;0;5;5
7716;Pušynėlis;LOPŠELIS;1164201286;Taip;0;9;0;9
7717;Pušynėlis;LOPŠELIS;6709692748;Taip;0;2;0;2
7718;Pušynėlis;LOPŠELIS;8799095053;Taip;0;1;0;1
7719;Pušynėlis;LOPŠELIS;5318223378;Taip;5;0;1;6
7720;Pušynėlis;LOPŠELIS;5897839636;Taip;0;4;0;4
7721;Pušynėlis;LOPŠELIS;7401066252;Taip;0;0;3;3
7722;Pušynėlis;LOPŠELIS;7787646910;Taip;0;0;1;1
7723;Pušynėlis;LOPŠELIS;2553444832;Taip;3;0;2;5
7724;Raktelis;LAŠIUKAI;55504358470;Ne;0;6;0;6
7725;Raktelis;LAŠIUKAI;61367764807;Ne;7;1;0;8
7726;Raktelis;LAŠIUKAI;1453259901;Taip;9;0;4;13
7727;Raktelis;LAŠIUKAI;6935703343;Ne;0;1;0;1
7728;Raktelis;LAŠIUKAI;30483797110;Taip;0;0;2;2
7729;Raktelis;LAŠIUKAI;5430563880;Taip;0;3;0;3
7730;Raktelis;LAŠIUKAI;874585350;Taip;0;2;0;2
7731;Raktelis;LAŠIUKAI;25504804011;Ne;0;1;0;1
7732;Raktelis;LAŠIUKAI;79301972646;Taip;6;1;3;10
7733;Raktelis;LAŠIUKAI;54361317676;Taip;0;5;0;5
7734;Raktelis;LAŠIUKAI;61636842808;Taip;0;0;4;4
7735;Raktelis;LAŠIUKAI;69445577844;Ne;0;2;0;2
7736;Raktelis;LAŠIUKAI;83366206408;Taip;0;6;0;6
7737;Raktelis;LAŠIUKAI;38068336379;Taip;0;0;2;2
7738;Raktelis;LAŠIUKAI;68578915107;Taip;0;1;7;8
7739;Raktelis;LAŠIUKAI;49216690763;Taip;0;0;5;5
7740;Raktelis;LAŠIUKAI;1586157196;Ne;0;4;0;4
7741;Raktelis;LAŠIUKAI;78841101231;Taip;0;0;10;10
7742;Raktelis;BITUTĖS;37587869107;Taip;0;2;6;8
7743;Raktelis;BITUTĖS;1544882634;Ne;0;15;0;15
7744;Raktelis;BITUTĖS;63051817818;Taip;0;2;2;4
7745;Raktelis;BITUTĖS;5663304735;Ne;9;2;0;11
7746;Raktelis;BITUTĖS;8559758812;Ne;5;1;0;6
7747;Raktelis;BITUTĖS;7265543701;Taip;0;2;0;2
7748;Raktelis;BITUTĖS;5627179884;Taip;0;2;1;3
7749;Raktelis;BITUTĖS;5405322552;Taip;11;0;2;13
7750;Raktelis;BITUTĖS;5492437864;Taip;0;2;5;7
7751;Raktelis;BITUTĖS;3880578523;Taip;0;5;0;5
7752;Raktelis;BITUTĖS;8796557675;Taip;4;5;0;9
7753;Raktelis;BITUTĖS;24323703041;Ne;0;0;4;4
7754;Raktelis;BITUTĖS;53034039807;Taip;2;3;0;5
7755;Raktelis;BITUTĖS;5711863758;Ne;4;0;5;9
7756;Raktelis;BITUTĖS;1747834520;Taip;6;0;1;7
7757;Raktelis;BITUTĖS;5000264125;Ne;0;1;11;12
7758;Raktelis;BITUTĖS;1820583792;Taip;12;1;1;14
7759;Raktelis;BITUTĖS;5802689482;Taip;10;4;0;14
7760;Raktelis;BITUTĖS;17270742947;Taip;0;9;0;9
7761;Raktelis;BITUTĖS;5392514118;Ne;0;0;18;18
7762;Raktelis;BITUTĖS;7048022562;Taip;3;0;0;3
7763;Raktelis;BITUTĖS;9774706725;Ne;0;8;0;8
7764;Raktelis;BITUTĖS;1455550617;Taip;0;6;0;6
7765;Raktelis;BITUTĖS;5218387088;Taip;0;3;0;3
7766;Raktelis;BORUŽĖLĖS;8117871963;Taip;0;5;6;11
7767;Raktelis;BORUŽĖLĖS;95104355224;Taip;0;2;1;3
7768;Raktelis;BORUŽĖLĖS;6049420030;Ne;6;4;0;10
7769;Raktelis;BORUŽĖLĖS;9313156299;Taip;14;0;0;14
7770;Raktelis;BORUŽĖLĖS;54221331553;Taip;10;1;0;11
7771;Raktelis;BORUŽĖLĖS;2070196225;Ne;16;3;0;19
7772;Raktelis;BORUŽĖLĖS;2303286473;Taip;0;0;1;1
7773;Raktelis;BORUŽĖLĖS;1192775994;Ne;0;6;0;6
7774;Raktelis;BORUŽĖLĖS;3609939325;Taip;0;8;0;8
7775;Raktelis;BORUŽĖLĖS;8245310502;Taip;6;2;4;12
7776;Raktelis;BORUŽĖLĖS;7487507324;Ne;8;0;0;8
7777;Raktelis;BORUŽĖLĖS;93271260871;Taip;0;16;0;16
7778;Raktelis;BORUŽĖLĖS;6779413882;Taip;9;13;0;22
7779;Raktelis;BORUŽĖLĖS;9584164290;Ne;0;10;0;10
7780;Raktelis;BORUŽĖLĖS;6854111162;Ne;4;2;3;9
7781;Raktelis;BORUŽĖLĖS;3762141936;Taip;0;3;0;3
7782;Raktelis;BORUŽĖLĖS;3713386556;Taip;0;10;0;10
7783;Raktelis;BORUŽĖLĖS;9230053040;Taip;22;0;0;22
7784;Raktelis;BORUŽĖLĖS;4671391106;Taip;3;0;0;3
7785;Raktelis;KAČIUKAI;8579864696;Taip;6;0;0;6
7786;Raktelis;KAČIUKAI;1393351147;Taip;0;2;1;3
7787;Raktelis;KAČIUKAI;27084497916;Ne;5;0;0;5
7788;Raktelis;KAČIUKAI;1063413424;Ne;0;10;0;10
7789;Raktelis;KAČIUKAI;4449411816;Taip;10;0;0;10
7790;Raktelis;KAČIUKAI;89139880068;Ne;0;2;0;2
7791;Raktelis;KAČIUKAI;1623046697;Taip;3;0;1;4
7792;Raktelis;KAČIUKAI;21063882404;Taip;5;1;0;6
7793;Raktelis;KAČIUKAI;78145437124;Taip;0;1;0;1
7794;Raktelis;KAČIUKAI;2143998936;Ne;0;7;7;14
7795;Raktelis;KAČIUKAI;1957572199;Taip;7;1;0;8
7796;Raktelis;KAČIUKAI;4906678347;Ne;0;2;0;2
7797;Raktelis;KAČIUKAI;1567546511;Taip;0;12;0;12
7798;Raktelis;KAČIUKAI;86883305675;Taip;0;1;0;1
7799;Raktelis;KAČIUKAI;9380332489;Taip;0;2;6;8
7800;Raktelis;KAČIUKAI;26727657814;Taip;6;5;0;11
7801;Raktelis;KAČIUKAI;30092089456;Ne;9;5;0;14
7802;Raktelis;KAČIUKAI;50372098009;Taip;8;3;0;11
7803;Raktelis;KAČIUKAI;3180109604;Taip;10;7;0;17
7804;Raktelis;KAČIUKAI;1046075234;Taip;0;3;0;3
7805;Raktelis;KAČIUKAI;1457880868;Ne;14;0;0;14
7806;Raktelis;KAČIUKAI;4071338645;Ne;0;8;0;8
7807;Raktelis;KIŠKUČIAI;1983808547;Taip;1;0;0;1
7808;Raktelis;KIŠKUČIAI;5046450478;Taip;7;6;0;13
7809;Raktelis;KIŠKUČIAI;4317705126;Taip;8;0;0;8
7810;Raktelis;KIŠKUČIAI;1843086151;Taip;7;6;0;13
7811;Raktelis;KIŠKUČIAI;2295251060;Taip;5;0;0;5
7812;Raktelis;KIŠKUČIAI;4160091258;Taip;19;1;0;20
7813;Raktelis;KIŠKUČIAI;6974263764;Taip;0;12;0;12
7814;Raktelis;KIŠKUČIAI;5042538956;Taip;4;6;0;10
7815;Raktelis;KIŠKUČIAI;4471813998;Ne;2;2;0;4
7816;Raktelis;KIŠKUČIAI;6550851582;Taip;0;2;3;5
7817;Raktelis;KIŠKUČIAI;3775306030;Taip;7;6;0;13
7818;Raktelis;KIŠKUČIAI;7807341574;Taip;5;0;2;7
7819;Raktelis;KIŠKUČIAI;4009105487;Taip;9;0;3;12
7820;Raktelis;KIŠKUČIAI;7260767942;Ne;10;0;1;11
7821;Raktelis;KIŠKUČIAI;6265489540;Taip;7;2;0;9
7822;Raktelis;KIŠKUČIAI;4187804340;Ne;13;0;0;13
7823;Raktelis;KIŠKUČIAI;8385770827;Taip;11;4;0;15
7824;Raktelis;NYKŠTUKAI;3271931810;Taip;0;0;18;18
7825;Raktelis;NYKŠTUKAI;4933650089;Taip;0;12;0;12
7826;Raktelis;NYKŠTUKAI;5270430511;Ne;22;0;0;22
7827;Raktelis;NYKŠTUKAI;6007823584;Taip;0;2;0;2
7828;Raktelis;NYKŠTUKAI;4676213966;Taip;0;5;0;5
7829;Raktelis;NYKŠTUKAI;3733786043;Taip;4;6;0;10
7830;Raktelis;NYKŠTUKAI;4319176525;Taip;8;4;1;13
7831;Raktelis;NYKŠTUKAI;6929358401;Taip;0;3;0;3
7832;Raktelis;NYKŠTUKAI;8600632097;Taip;0;3;0;3
7833;Raktelis;NYKŠTUKAI;4444129040;Taip;0;5;0;5
7834;Raktelis;NYKŠTUKAI;7630501672;Taip;12;4;0;16
7835;Raktelis;NYKŠTUKAI;9965855682;Taip;9;2;2;13
7836;Raktelis;NYKŠTUKAI;4631375439;Taip;9;0;0;9
7837;Raktelis;PELIUKAI;2967941870;Taip;10;0;0;10
7838;Raktelis;PELIUKAI;8146076115;Taip;6;0;0;6
7839;Raktelis;PELIUKAI;2731096860;Taip;0;5;1;6
7840;Raktelis;PELIUKAI;2809458453;Taip;6;0;0;6
7841;Raktelis;PELIUKAI;6892006495;Taip;0;6;0;6
7842;Raktelis;PELIUKAI;1322912585;Taip;0;2;4;6
7843;Raktelis;PELIUKAI;4228614834;Taip;9;4;0;13
7844;Raktelis;PELIUKAI;4755892641;Taip;0;4;0;4
7845;Raktelis;PELIUKAI;8353427144;Taip;5;0;0;5
7846;Raktelis;PELIUKAI;3395720463;Taip;0;1;0;1
7847;Raktelis;PELIUKAI;9151796053;Taip;22;0;0;22
7848;Raktelis;AGUONOS;6102196040;Taip;4;2;1;7
7849;Raktelis;AGUONOS;1622504968;Taip;5;2;0;7
7850;Raktelis;AGUONOS;6199212999;Taip;0;4;0;4
7851;Raktelis;AGUONOS;7334310944;Taip;8;5;0;13
7852;Raktelis;AGUONOS;6281687751;Taip;0;2;0;2
7853;Raktelis;AGUONOS;3661917922;Taip;0;6;0;6
7854;Raktelis;AGUONOS;1975411457;Ne;14;2;0;16
7855;Raktelis;AGUONOS;6877934219;Taip;11;0;0;11
7856;Raktelis;AGUONOS;6367875352;Taip;0;9;0;9
7857;Raktelis;AGUONOS;7170546710;Taip;14;5;0;19
7858;Raktelis;AGUONOS;4905982507;Taip;3;3;1;7
7859;Raktelis;AGUONOS;6014726741;Taip;9;1;0;10
7860;Raktelis;AGUONOS;9779789133;Taip;4;2;1;7
7861;Raktelis;AGUONOS;2219712757;Ne;5;0;0;5
7862;Raktelis;AGUONOS;9593639791;Taip;0;2;4;6
7863;Raktelis;AGUONOS;6608224825;Taip;7;5;0;12
7864;Raktelis;AGUONOS;4658530212;Taip;0;8;0;8
7865;Raktelis;AGUONOS;4335378625;Taip;0;2;0;2
7866;Raktelis;AGUONOS;8873203690;Taip;17;0;1;18
7867;Raktelis;AGUONOS;9357757604;Taip;3;9;0;12
7868;Raktelis;AGUONOS;8459980712;Taip;7;2;2;11
7869;Raktelis;AGUONOS;7973137015;Taip;0;7;0;7
7870;Raktelis;AGUONOS;9591285702;Taip;12;1;0;13
7871;Raktelis;AGUONOS;9210856228;Taip;0;0;5;5
7872;Raktelis;LAPIUKŲ;7962509432;Taip;3;6;0;9
7873;Raktelis;LAPIUKŲ;9501202273;Taip;0;4;0;4
7874;Raktelis;LAPIUKŲ;54341630847;Taip;7;5;0;12
7875;Raktelis;LAPIUKŲ;4569798381;Ne;13;0;0;13
7876;Raktelis;LAPIUKŲ;67304194087;Taip;0;2;0;2
7877;Raktelis;LAPIUKŲ;15583558585;Ne;0;12;0;12
7878;Raktelis;LAPIUKŲ;2753402906;Taip;0;4;0;4
7879;Raktelis;LAPIUKŲ;4583377785;Taip;0;6;0;6
7880;Raktelis;LAPIUKŲ;5082785025;Taip;22;0;0;22
7881;Raktelis;LAPIUKŲ;9130613710;Taip;0;6;0;6
7882;Raktelis;LAPIUKŲ;1453677708;Taip;9;4;0;13
7883;Raktelis;LAPIUKŲ;2282754345;Taip;0;4;0;4
7884;Raktelis;LAPIUKŲ;1109105359;Ne;0;3;0;3
7885;Raktelis;LAPIUKŲ;5768653399;Taip;9;1;0;10
7886;Raktelis;LAPIUKŲ;6385127914;Taip;0;4;0;4
7887;Raktelis;LAPIUKŲ;8207675881;Taip;0;3;0;3
7888;Raktelis;PELĖDŽIUKAI;2985254060;Ne;12;1;0;13
7889;Raktelis;PELĖDŽIUKAI;68390568000;Taip;0;4;0;4
7890;Raktelis;PELĖDŽIUKAI;68570148753;Taip;0;16;0;16
7891;Raktelis;PELĖDŽIUKAI;27403835292;Taip;0;1;0;1
7892;Raktelis;PELĖDŽIUKAI;25141529581;Taip;0;13;0;13
7893;Raktelis;PELĖDŽIUKAI;43500434912;Taip;0;11;0;11
7894;Raktelis;PELĖDŽIUKAI;51237034253;Taip;4;2;0;6
7895;Raktelis;PELĖDŽIUKAI;77512682081;Taip;0;0;1;1
7896;Raktelis;PELĖDŽIUKAI;15159708127;Taip;0;1;0;1
7897;Raktelis;PELĖDŽIUKAI;53270411090;Ne;0;1;0;1
7898;Raktelis;PELĖDŽIUKAI;14234831040;Taip;0;2;1;3
7899;Raktelis;PELĖDŽIUKAI;92373834478;Ne;0;8;0;8
7900;Raktelis;PELĖDŽIUKAI;1819514057;Ne;2;0;0;2
7901;Raktelis;PELĖDŽIUKAI;86120193313;Taip;0;0;1;1
7902;Raktelis;PELĖDŽIUKAI;5914986262;Taip;0;0;1;1
7903;Raktelis;PELĖDŽIUKAI;67378900057;Ne;0;0;3;3
7904;Raktelis;PELĖDŽIUKAI;40006848965;Taip;0;2;0;2
7905;Raktelis;PELĖDŽIUKAI;67756822733;Taip;0;2;3;5
7906;Raktelis;PELĖDŽIUKAI;82492627;Taip;0;1;3;4
7907;Raktelis;PELĖDŽIUKAI;1197826066;Ne;19;0;0;19
7908;Rasa;Nykštukai;3664125930;Ne;3;4;0;7
7909;Rasa;Nykštukai;5176175108;Taip;14;4;0;18
7910;Rasa;Nykštukai;3979273111;Taip;5;8;0;13
7911;Rasa;Nykštukai;4847544355;Taip;3;5;1;9
7912;Rasa;Nykštukai;9723040721;Taip;10;3;0;13
7913;Rasa;Nykštukai;7004232909;Taip;0;0;2;2
7914;Rasa;Nykštukai;1223962374;Taip;0;7;0;7
7915;Rasa;Nykštukai;3200377629;Ne;1;3;0;4
7916;Rasa;Nykštukai;1336291828;Taip;0;6;0;6
7917;Rasa;Nykštukai;5861229664;Taip;0;4;2;6
7918;Rasa;Nykštukai;1386880644;Taip;9;3;2;14
7919;Rasa;Nykštukai;7228037580;Taip;0;3;0;3
7920;Rasa;Nykštukai;2093263887;Taip;0;2;0;2
7921;Rasa;Nykštukai;2540124793;Taip;5;1;2;8
7922;Rasa;Nykštukai;5363748728;Taip;0;12;0;12
7923;Rasa;Nykštukai;2977737634;Taip;7;3;0;10
7924;Rasa;Nykštukai;8310400946;Taip;5;2;0;7
7925;Rasa;Nykštukai;7520665472;Taip;0;16;0;16
7926;Rasa;Nykštukai;7534306402;Ne;5;0;0;5
7927;Rasa;Nykštukai;3508648715;Ne;0;3;14;17
7928;Rasa;Meškiukai;8052120247;Taip;5;1;0;6
7929;Rasa;Meškiukai;1013865195;Taip;0;10;0;10
7930;Rasa;Meškiukai;2110008545;Taip;0;1;0;1
7931;Rasa;Meškiukai;72772661373;Taip;8;1;0;9
7932;Rasa;Meškiukai;63673920646;Taip;3;1;1;5
7933;Rasa;Meškiukai;52913880917;Taip;0;6;0;6
7934;Rasa;Meškiukai;5932187584;Taip;3;3;0;6
7935;Rasa;Meškiukai;5145978804;Ne;22;3;0;25
7936;Rasa;Meškiukai;8438563545;Taip;0;1;3;4
7937;Rasa;Meškiukai;6356448094;Taip;15;3;0;18
7938;Rasa;Meškiukai;2683897055;Taip;0;15;0;15
7939;Rasa;Meškiukai;4790859112;Taip;0;1;6;7
7940;Rasa;Meškiukai;7534548604;Taip;4;1;2;7
7941;Rasa;Meškiukai;5606722133;Taip;0;4;0;4
7942;Rasa;Meškiukai;7565880116;Taip;0;9;1;10
7943;Rasa;Meškiukai;7544963724;Taip;9;3;0;12
7944;Rasa;Meškiukai;3567565920;Ne;0;0;4;4
7945;Rasa;Meškiukai;6734478649;Taip;0;5;0;5
7946;Rasa;Sauliukai;95625598016;Taip;0;1;0;1
7947;Rasa;Sauliukai;1067614202;Ne;1;4;0;5
7948;Rasa;Sauliukai;29141190550;Taip;3;0;0;3
7949;Rasa;Sauliukai;59695217278;Taip;2;2;0;4
7950;Rasa;Sauliukai;87310376118;Taip;3;0;0;3
7951;Rasa;Sauliukai;36336738780;Taip;0;5;0;5
7952;Rasa;Sauliukai;1549153022;Taip;0;1;0;1
7953;Rasa;Sauliukai;59127440556;Taip;0;2;0;2
7954;Rasa;Sauliukai;99521832856;Taip;5;0;0;5
7955;Rasa;Sauliukai;26384431360;Taip;0;4;0;4
7956;Rasa;Sauliukai;1004116597;Taip;2;1;0;3
7957;Rasa;Sauliukai;1560278351;Taip;5;0;0;5
7958;Rasa;Sauliukai;1916783052;Ne;8;3;0;11
7959;Rasa;Smalsučiai;3281315532;Taip;0;4;0;4
7960;Rasa;Smalsučiai;13135367451;Taip;10;0;0;10
7961;Rasa;Smalsučiai;91941960564;Taip;0;2;1;3
7962;Rasa;Smalsučiai;1883458628;Taip;0;3;3;6
7963;Rasa;Smalsučiai;4601657045;Taip;4;4;3;11
7964;Rasa;Smalsučiai;1339376048;Taip;7;3;0;10
7965;Rasa;Smalsučiai;5201341227;Taip;5;3;2;10
7966;Rasa;Smalsučiai;1267340581;Taip;0;0;4;4
7967;Rasa;Smalsučiai;88779978297;Taip;0;7;0;7
7968;Rasa;Smalsučiai;13286984288;Taip;0;4;2;6
7969;Rasa;Smalsučiai;1558712079;Taip;0;9;0;9
7970;Rasa;Smalsučiai;99911904705;Taip;6;0;1;7
7971;Rasa;Smalsučiai;79439306932;Taip;0;11;0;11
7972;Rasa;Smalsučiai;9890493148;Taip;9;6;0;15
7973;Rasa;Smalsučiai;25918582395;Ne;9;5;0;14
7974;Rasa;Smalsučiai;1311346161;Taip;0;12;0;12
7975;Rasa;Smalsučiai;77589878141;Taip;0;1;2;3
7976;Rasa;Smalsučiai;1581241275;Taip;5;0;0;5
7977;Rasa;Smalsučiai;1658948426;Taip;6;3;0;9
7978;Rasa;Smalsučiai;1803769089;Taip;0;9;0;9
7979;Rasa;"Pelėdžiukai ";1176606744;Taip;0;2;1;3
7980;Rasa;"Pelėdžiukai ";6345614521;Taip;6;2;1;9
7981;Rasa;"Pelėdžiukai ";8278928396;Taip;0;3;2;5
7982;Rasa;"Pelėdžiukai ";2121070882;Taip;0;11;0;11
7983;Rasa;"Pelėdžiukai ";1457384318;Taip;0;3;5;8
7984;Rasa;"Pelėdžiukai ";3884105235;Taip;10;4;0;14
7985;Rasa;"Pelėdžiukai ";1726266997;Ne;3;0;0;3
7986;Rasa;"Pelėdžiukai ";6704162447;Taip;0;2;0;2
7987;Rasa;"Pelėdžiukai ";7558966891;Taip;10;3;0;13
7988;Rasa;"Pelėdžiukai ";6773004268;Ne;15;3;0;18
7989;Rasa;"Pelėdžiukai ";3023088027;Taip;0;9;0;9
7990;Rasa;"Pelėdžiukai ";8953448462;Ne;4;1;1;6
7991;Rasa;"Pelėdžiukai ";5325275053;Taip;10;7;0;17
7992;Rasa;"Pelėdžiukai ";4758605343;Taip;4;3;18;25
7993;Rasa;"Pelėdžiukai ";4542122478;Taip;5;10;0;15
7994;Rasa;"Pelėdžiukai ";2962815301;Taip;0;3;5;8
7995;Rasa;"Pelėdžiukai ";3091012313;Ne;0;2;3;5
7996;Rasa;Katinėliai;5652936425;Taip;0;1;0;1
7997;Rasa;Katinėliai;5885520521;Taip;13;3;0;16
7998;Rasa;Katinėliai;4555510957;Taip;0;3;11;14
7999;Rasa;Katinėliai;7730322729;Taip;0;9;0;9
8000;Rasa;Katinėliai;2170134084;Taip;0;7;1;8
8001;Rasa;Katinėliai;6891623055;Taip;5;0;0;5
8002;Rasa;Katinėliai;9010812748;Taip;2;4;1;7
8003;Rasa;Katinėliai;7220007488;Taip;4;7;0;11
8004;Rasa;Katinėliai;8235869241;Taip;0;1;0;1
8005;Rasa;Katinėliai;3135828190;Ne;5;11;0;16
8006;Rasa;Katinėliai;2984661168;Taip;6;0;0;6
8007;Rasa;Katinėliai;4913483444;Taip;12;3;2;17
8008;Rasa;Katinėliai;7142481458;Taip;0;3;2;5
8009;Rasa;Katinėliai;7314537168;Taip;2;3;1;6
8010;Rasa;Katinėliai;4734775151;Taip;0;12;1;13
8011;Rasa;Katinėliai;4758138905;Taip;4;1;1;6
8012;Rasa;Katinėliai;9447346901;Taip;0;1;1;2
8013;Rasa;Katinėliai;3631124501;Ne;6;2;0;8
8014;Rasa;Katinėliai;1454724752;Taip;11;2;0;13
8015;Rasa;Ančiukai;7185331699;Taip;18;7;0;25
8016;Rasa;Ančiukai;1060810039;Taip;18;7;0;25
8017;Rasa;Ančiukai;9599510902;Taip;6;0;0;6
8018;Rasa;Ančiukai;7037958994;Taip;6;3;0;9
8019;Rasa;Ančiukai;9668538340;Taip;0;5;0;5
8020;Rasa;Ančiukai;4795339259;Taip;5;5;0;10
8021;Rasa;Ančiukai;4694111253;Taip;1;0;0;1
8022;Rasa;Ančiukai;7028605422;Taip;0;7;0;7
8023;Rasa;Ančiukai;2711923397;Taip;2;2;0;4
8024;Rasa;Ančiukai;2800420481;Taip;0;3;1;4
8025;Rasa;Ančiukai;5869253167;Taip;9;0;0;9
8026;Rasa;Ančiukai;3475601049;Taip;0;1;0;1
8027;Rasa;Ančiukai;6887471189;Taip;4;11;0;15
8028;Rasa;Ančiukai;6011243039;Taip;4;11;0;15
8029;Rasa;Ančiukai;8236785255;Taip;0;6;0;6
8030;Rasa;"Vyturiukai ";1210203141;Taip;0;3;11;14
8031;Rasa;"Vyturiukai ";7575833127;Taip;0;3;9;12
8032;Rasa;"Vyturiukai ";27131705540;Taip;0;4;0;4
8033;Rasa;"Vyturiukai ";1823276800;Taip;0;3;1;4
8034;Rasa;"Vyturiukai ";66103644564;Taip;0;12;0;12
8035;Rasa;"Vyturiukai ";73115061371;Ne;0;11;0;11
8036;Rasa;"Vyturiukai ";1049242346;Taip;0;0;3;3
8037;Rasa;"Vyturiukai ";1179402963;Ne;0;4;0;4
8038;Rasa;"Vyturiukai ";1210340955;Taip;6;12;0;18
8039;Rasa;"Vyturiukai ";83227920971;Ne;0;6;0;6
8040;Rasa;"Vyturiukai ";34934099958;Taip;0;9;0;9
8041;Rasa;"Vyturiukai ";84161884493;Taip;0;0;2;2
8042;Rasa;"Vyturiukai ";1214055260;Taip;0;1;2;3
8043;Rasa;"Vyturiukai ";2041098301;Taip;0;11;1;12
8044;Rasa;"Vyturiukai ";71420694152;Ne;0;2;5;7
8045;Rasa;"Vyturiukai ";1477555365;Taip;0;1;0;1
8046;Rasa;"Vyturiukai ";9438727789;Taip;0;3;10;13
8047;Rasa;Voveriukai;1728275988;Taip;8;2;0;10
8048;Rasa;Voveriukai;74744565967;Taip;7;3;0;10
8049;Rasa;Voveriukai;1093723298;Ne;0;6;0;6
8050;Rasa;Voveriukai;5589971159;Taip;0;2;2;4
8051;Rasa;Voveriukai;2980868154;Ne;0;12;0;12
8052;Rasa;Voveriukai;4065614217;Taip;3;5;0;8
8053;Rasa;Voveriukai;15257986685;Taip;9;3;0;12
8054;Rasa;Voveriukai;6198612392;Taip;0;2;0;2
8055;Rasa;Voveriukai;1900027524;Ne;7;3;0;10
8056;Rasa;Voveriukai;5108279813;Ne;0;5;0;5
8057;Rasa;Voveriukai;2349860704;Taip;0;16;0;16
8058;Rasa;Voveriukai;1704518157;Taip;3;2;0;5
8059;Rasa;Voveriukai;8983800071;Ne;0;1;1;2
8060;Rasa;Voveriukai;9086339064;Taip;6;16;0;22
8061;Rasa;"DRUGELIAI ";9140875020;Ne;10;13;0;23
8062;Rasa;"DRUGELIAI ";9229817861;Taip;8;1;3;12
8063;Rasa;"DRUGELIAI ";1206005039;Taip;6;0;0;6
8064;Rasa;"DRUGELIAI ";9788282861;Taip;0;3;1;4
8065;Rasa;"DRUGELIAI ";6311322617;Taip;18;3;0;21
8066;Rasa;"DRUGELIAI ";8595804874;Ne;3;0;0;3
8067;Rasa;"DRUGELIAI ";3073804713;Taip;9;6;0;15
8068;Rasa;"DRUGELIAI ";9677810607;Taip;17;3;5;25
8069;Rasa;"DRUGELIAI ";1466616814;Taip;0;6;10;16
8070;Rasa;"DRUGELIAI ";1796573723;Taip;0;13;0;13
8071;Rasa;"DRUGELIAI ";5719253028;Taip;0;11;2;13
8072;Rasa;"DRUGELIAI ";5710220699;Taip;5;0;0;5
8073;Rasa;Zuikučiai;4554377449;Taip;0;11;0;11
8074;Rasa;Zuikučiai;2137321989;Taip;0;16;0;16
8075;Rasa;Zuikučiai;1432856662;Taip;3;2;0;5
8076;Rasa;Zuikučiai;1993471951;Ne;3;4;0;7
8077;Rasa;Zuikučiai;1860462451;Taip;14;3;0;17
8078;Rasa;Zuikučiai;42609897431;Taip;0;10;0;10
8079;Rasa;Zuikučiai;55374082940;Taip;0;12;0;12
8080;Rasa;Zuikučiai;2114613635;Taip;11;4;1;16
8081;Rasa;Zuikučiai;7397794681;Taip;0;2;0;2
8082;Rasa;Zuikučiai;13297122928;Taip;13;4;0;17
8083;Rasa;Zuikučiai;6108187043;Ne;0;3;0;3
8084;Rasa;Zuikučiai;1690518970;Taip;0;5;1;6
8085;Rasa;Zuikučiai;1131418692;Taip;5;4;1;10
8086;Rasa;Zuikučiai;7065597550;Ne;6;1;0;7
8087;Rasa;Zuikučiai;68980971096;Ne;0;1;0;1
8088;Rasa;Zuikučiai;9432880035;Taip;0;9;0;9
8089;Rasa;Širdelė;56168039878;Taip;0;3;0;3
8090;Rasa;Širdelė;8424049317;Ne;5;11;0;16
8091;Rasa;Širdelė;5599182715;Taip;0;14;0;14
8092;Rasa;Širdelė;9648034081;Ne;10;4;0;14
8093;Rasa;Širdelė;33479419656;Taip;10;7;0;17
8094;Rasa;Širdelė;8236464670;Ne;0;15;0;15
8095;Rasa;Širdelė;1271820053;Ne;16;2;0;18
8096;Rasa;Širdelė;2626361958;Taip;13;3;1;17
8097;Rasa;Širdelė;5426981046;Taip;0;4;0;4
8098;Rasa;Širdelė;2840872613;Taip;0;13;0;13
8099;Rasa;Širdelė;23600769349;Taip;0;2;0;2
8100;Rasa;Širdelė;6976298054;Taip;2;4;0;6
8101;Rasa;Širdelė;91931863004;Taip;3;13;0;16
8102;Rasa;Širdelė;3668598028;Taip;3;13;0;16
8103;Rasa;Širdelė;58858081077;Taip;8;4;0;12
8104;Rasa;Širdelė;2132535297;Taip;10;4;0;14
8105;Rasa;Širdelė;2133989183;Taip;0;4;0;4
8106;Rasa;Širdelė;8866896989;Taip;0;20;0;20
8107;Rasa;Širdelė;9938280570;Taip;8;4;1;13
8108;Rasa;Širdelė;2333938367;Taip;0;14;0;14
8109;Riešutėlis;Viščiukų;1782544949;Taip;5;2;0;7
8110;Riešutėlis;Viščiukų;91799192513;Taip;5;0;0;5
8111;Riešutėlis;Viščiukų;50427986973;Taip;6;4;0;10
8112;Riešutėlis;Viščiukų;28855582790;Taip;0;3;0;3
8113;Riešutėlis;Viščiukų;41275727334;Taip;1;10;0;11
8114;Riešutėlis;Viščiukų;98456292572;Taip;0;3;0;3
8115;Riešutėlis;Viščiukų;63919369801;Taip;0;7;0;7
8116;Riešutėlis;Viščiukų;2146831972;Ne;0;1;0;1
8117;Riešutėlis;Viščiukų;61571638960;Taip;3;0;2;5
8118;Riešutėlis;Viščiukų;8857939937;Ne;0;3;0;3
8119;Riešutėlis;Viščiukų;1957794151;Taip;14;0;0;14
8120;Riešutėlis;Viščiukų;1743324657;Ne;10;0;0;10
8121;Riešutėlis;Viščiukų;1792212841;Taip;0;8;2;10
8122;Riešutėlis;Viščiukų;86455801201;Taip;3;0;1;4
8123;Riešutėlis;Viščiukų;93958381534;Taip;5;2;0;7
8124;Riešutėlis;Viščiukų;1532275496;Taip;0;0;1;1
8125;Riešutėlis;Viščiukų;4311016578;Taip;11;0;0;11
8126;Riešutėlis;Viščiukų;2201158918;Taip;0;4;0;4
8127;Riešutėlis;Viščiukų;8927730307;Ne;10;0;6;16
8128;Riešutėlis;Viščiukų;6855553238;Taip;0;3;8;11
8129;Riešutėlis;Viščiukų;1930481567;Taip;0;0;2;2
8130;Riešutėlis;"Riešutėliai ";8077135868;Taip;7;1;7;15
8131;Riešutėlis;"Riešutėliai ";84116863778;Taip;0;7;0;7
8132;Riešutėlis;"Riešutėliai ";1077680441;Taip;8;2;0;10
8133;Riešutėlis;"Riešutėliai ";6097581240;Taip;6;0;0;6
8134;Riešutėlis;"Riešutėliai ";55620350407;Taip;16;0;0;16
8135;Riešutėlis;"Riešutėliai ";1105598415;Taip;0;0;4;4
8136;Riešutėlis;"Riešutėliai ";11913461630;Taip;0;5;0;5
8137;Riešutėlis;"Riešutėliai ";1674871670;Taip;0;2;3;5
8138;Riešutėlis;"Riešutėliai ";1853283967;Taip;0;0;2;2
8139;Riešutėlis;"Riešutėliai ";49061075792;Taip;3;5;0;8
8140;Riešutėlis;"Riešutėliai ";3806836220;Taip;0;2;0;2
8141;Riešutėlis;"Riešutėliai ";16308059025;Taip;0;6;0;6
8142;Riešutėlis;"Riešutėliai ";9023304543;Taip;5;7;0;12
8143;Riešutėlis;"Riešutėliai ";1941869661;Taip;0;3;0;3
8144;Riešutėlis;"Riešutėliai ";4404544549;Taip;0;14;0;14
8145;Riešutėlis;"Riešutėliai ";85356230208;Taip;0;1;0;1
8146;Riešutėlis;Ežiukai;7030346495;Taip;13;9;0;22
8147;Riešutėlis;Ežiukai;9750713954;Taip;17;0;0;17
8148;Riešutėlis;Ežiukai;9476688736;Taip;20;0;0;20
8149;Riešutėlis;Ežiukai;7601776182;Taip;0;4;0;4
8150;Riešutėlis;Ežiukai;7381623086;Taip;0;6;0;6
8151;Riešutėlis;Ežiukai;9964688413;Taip;4;0;0;4
8152;Riešutėlis;Ežiukai;1548585448;Taip;13;1;0;14
8153;Riešutėlis;Ežiukai;2092933906;Taip;10;8;4;22
8154;Riešutėlis;Ežiukai;6813024366;Taip;0;1;0;1
8155;Riešutėlis;Ežiukai;7913381005;Taip;3;3;0;6
8156;Riešutėlis;Ežiukai;3460145784;Ne;0;7;0;7
8157;Riešutėlis;Ežiukai;8480059272;Ne;9;0;0;9
8158;Riešutėlis;Ežiukai;5728858361;Ne;4;2;1;7
8159;Riešutėlis;Ežiukai;8721736343;Taip;10;2;2;14
8160;Riešutėlis;Ežiukai;5327627748;Taip;7;6;1;14
8161;Riešutėlis;Ežiukai;2397854323;Taip;0;2;3;5
8162;Riešutėlis;Ežiukai;6259158270;Taip;11;0;2;13
8163;Riešutėlis;Ežiukai;6194259707;Taip;16;5;0;21
8164;Riešutėlis;Ežiukai;3575043942;Taip;0;22;0;22
8165;Riešutėlis;Pelėdžiukai;6303767779;Taip;10;0;2;12
8166;Riešutėlis;Pelėdžiukai;7198434243;Taip;0;5;4;9
8167;Riešutėlis;Pelėdžiukai;8018914251;Taip;15;0;0;15
8168;Riešutėlis;Pelėdžiukai;8012201566;Taip;14;0;0;14
8169;Riešutėlis;Pelėdžiukai;8751571852;Taip;19;0;0;19
8170;Riešutėlis;Pelėdžiukai;5479780116;Taip;0;4;0;4
8171;Riešutėlis;Pelėdžiukai;7225365172;Ne;8;0;0;8
8172;Riešutėlis;Pelėdžiukai;9839084885;Taip;0;0;2;2
8173;Riešutėlis;Pelėdžiukai;6928558714;Ne;14;0;0;14
8174;Riešutėlis;Pelėdžiukai;9040123535;Taip;0;7;0;7
8175;Riešutėlis;Pelėdžiukai;6405116059;Taip;0;0;1;1
8176;Riešutėlis;Pelėdžiukai;5995176001;Taip;0;2;0;2
8177;Riešutėlis;Pelėdžiukai;2430518637;Taip;5;2;1;8
8178;Riešutėlis;Pelėdžiukai;3970874098;Taip;2;0;2;4
8179;Riešutėlis;Pelėdžiukai;4451419273;Taip;4;7;2;13
8180;Riešutėlis;Pelėdžiukai;1638021880;Taip;0;6;0;6
8181;Riešutėlis;Pelėdžiukai;5598052531;Taip;14;0;0;14
8182;Riešutėlis;Pelėdžiukai;5282039544;Ne;0;0;1;1
8183;Riešutėlis;Meškiukai;1999979060;Ne;0;0;3;3
8184;Riešutėlis;Meškiukai;4004669930;Taip;5;1;0;6
8185;Riešutėlis;Meškiukai;6721758785;Ne;0;4;6;10
8186;Riešutėlis;Meškiukai;5753609922;Taip;11;1;0;12
8187;Riešutėlis;Meškiukai;3694146893;Taip;6;3;0;9
8188;Riešutėlis;Meškiukai;1748151109;Ne;18;2;0;20
8189;Riešutėlis;Meškiukai;8738716660;Taip;0;2;0;2
8190;Riešutėlis;Meškiukai;1528972517;Taip;13;5;0;18
8191;Riešutėlis;Meškiukai;7177632315;Taip;0;1;0;1
8192;Riešutėlis;Meškiukai;3077468722;Taip;10;0;0;10
8193;Riešutėlis;Meškiukai;4293402095;Taip;0;22;0;22
8194;Riešutėlis;Meškiukai;4828635362;Taip;0;1;0;1
8195;Riešutėlis;Meškiukai;8504832383;Ne;0;1;0;1
8196;Riešutėlis;Meškiukai;8996456595;Taip;9;0;0;9
8197;Riešutėlis;Kiškučiai;49061132665;Taip;0;2;1;3
8198;Riešutėlis;Kiškučiai;92159110899;Taip;6;8;0;14
8199;Riešutėlis;Kiškučiai;1623455993;Taip;5;4;0;9
8200;Riešutėlis;Kiškučiai;4464545735;Taip;0;4;0;4
8201;Riešutėlis;Kiškučiai;96066602684;Ne;0;1;0;1
8202;Riešutėlis;Kiškučiai;55715445788;Taip;4;1;0;5
8203;Riešutėlis;Kiškučiai;1250209796;Ne;0;2;0;2
8204;Riešutėlis;Kiškučiai;1526573984;Taip;0;2;0;2
8205;Riešutėlis;Kiškučiai;35876952602;Ne;0;5;0;5
8206;Riešutėlis;Kiškučiai;1748738558;Taip;1;0;2;3
8207;Riešutėlis;Kiškučiai;93192056557;Taip;0;0;1;1
8208;Riešutėlis;Kiškučiai;2163433983;Taip;0;1;6;7
8209;Riešutėlis;Kiškučiai;4916885450;Taip;0;0;22;22
8210;Riešutėlis;Voveriukų;6130980726;Ne;0;3;0;3
8211;Riešutėlis;Voveriukų;6500567162;Taip;0;9;0;9
8212;Riešutėlis;Voveriukų;9081486438;Taip;0;2;0;2
8213;Riešutėlis;Voveriukų;31417468379;Taip;0;2;0;2
8214;Riešutėlis;Voveriukų;1065105725;Ne;3;2;0;5
8215;Riešutėlis;Voveriukų;26053212952;Taip;0;5;0;5
8216;Riešutėlis;Voveriukų;51840071269;Taip;0;5;0;5
8217;Riešutėlis;Voveriukų;92166220283;Taip;4;0;0;4
8218;Riešutėlis;Voveriukų;43038393551;Ne;0;1;0;1
8219;Riešutėlis;Voveriukų;65629075580;Taip;3;7;0;10
8220;Riešutėlis;Voveriukų;50971787753;Taip;0;2;0;2
8221;Riešutėlis;Voveriukų;89384403521;Taip;0;13;0;13
8222;Riešutėlis;Voveriukų;6701821406;Taip;0;3;0;3
8223;Riešutėlis;Voveriukų;64736615832;Ne;3;1;0;4
8224;Riešutėlis;Voveriukų;29751938918;Taip;10;0;0;10
8225;Riešutėlis;Saulutės;9198963882;Ne;2;1;3;6
8226;Riešutėlis;Saulutės;2111280879;Taip;0;1;0;1
8227;Riešutėlis;Saulutės;1190403952;Taip;5;1;0;6
8228;Riešutėlis;Saulutės;1160573638;Taip;0;4;0;4
8229;Riešutėlis;Saulutės;1056034480;Ne;0;1;0;1
8230;Riešutėlis;Saulutės;2097580659;Taip;0;0;2;2
8231;Riešutėlis;Saulutės;2112179980;Ne;9;2;0;11
8232;Riešutėlis;Saulutės;2851186469;Taip;0;0;2;2
8233;Riešutėlis;Saulutės;7207507008;Ne;0;12;10;22
8234;Riešutėlis;Saulutės;8749505821;Taip;0;13;0;13
8235;Riešutėlis;Saulutės;1169051233;Taip;3;0;0;3
8236;Riešutėlis;Saulutės;1091941952;Taip;0;7;0;7
8237;Riešutėlis;Saulutės;24776322315;Taip;0;0;5;5
8238;Riešutėlis;Saulutės;6402032861;Taip;3;0;1;4
8239;Riešutėlis;Saulutės;5717194707;Taip;0;6;0;6
8240;Riešutėlis;Saulutės;5537309549;Ne;0;2;4;6
8241;Riešutėlis;"Boruželės ";16561622902;Taip;0;12;0;12
8242;Riešutėlis;"Boruželės ";56117509354;Taip;19;1;0;20
8243;Riešutėlis;"Boruželės ";1936519033;Taip;6;5;0;11
8244;Riešutėlis;"Boruželės ";2611705234;Taip;13;2;0;15
8245;Riešutėlis;"Boruželės ";4131218911;Taip;0;1;0;1
8246;Riešutėlis;"Boruželės ";1455509576;Taip;0;7;4;11
8247;Riešutėlis;"Boruželės ";3577669231;Taip;4;3;0;7
8248;Riešutėlis;"Boruželės ";9670912357;Taip;12;2;0;14
8249;Riešutėlis;"Boruželės ";26781529460;Taip;7;0;2;9
8250;Riešutėlis;"Boruželės ";5097410462;Taip;14;0;0;14
8251;Riešutėlis;"Boruželės ";4344185375;Taip;0;3;0;3
8252;Riešutėlis;"Boruželės ";4041498684;Taip;0;8;0;8
8253;Riešutėlis;"Boruželės ";8087180983;Taip;8;5;2;15
8254;Riešutėlis;"Boruželės ";4276034784;Taip;0;5;0;5
8255;Riešutėlis;"Boruželės ";2566084613;Taip;5;10;0;15
8256;Riešutėlis;"Boruželės ";3851000866;Taip;0;7;0;7
8257;Riešutėlis;"Boruželės ";3982030863;Taip;0;0;1;1
8258;Riešutėlis;"Boruželės ";1623681835;Ne;0;1;0;1
8259;Riešutėlis;"Boruželės ";1818130297;Taip;13;3;0;16
8260;Riešutėlis;"Bitutės ";1000408690;Taip;0;0;1;1
8261;Riešutėlis;"Bitutės ";3149710709;Taip;8;4;0;12
8262;Riešutėlis;"Bitutės ";1918857028;Taip;8;0;0;8
8263;Riešutėlis;"Bitutės ";1686215195;Taip;10;0;0;10
8264;Riešutėlis;"Bitutės ";54011982803;Taip;0;1;0;1
8265;Riešutėlis;"Bitutės ";2395648260;Taip;22;0;0;22
8266;Riešutėlis;"Bitutės ";86647499063;Ne;5;5;0;10
8267;Riešutėlis;"Bitutės ";4188823834;Taip;8;0;0;8
8268;Riešutėlis;"Bitutės ";59796628656;Taip;8;1;0;9
8269;Riešutėlis;"Bitutės ";6852846350;Ne;14;1;0;15
8270;Riešutėlis;"Bitutės ";13815744901;Taip;7;5;0;12
8271;Riešutėlis;"Bitutės ";91430094368;Taip;0;2;0;2
8272;Riešutėlis;"Bitutės ";65873300738;Taip;0;6;0;6
8273;Riešutėlis;"Bitutės ";1921241349;Taip;6;0;0;6
8274;Riešutėlis;"Bitutės ";7987368969;Taip;0;8;5;13
8275;Riešutėlis;"Bitutės ";85564700996;Taip;17;0;0;17
8276;Riešutėlis;"Bitutės ";9092861254;Taip;0;22;0;22
8277;Riešutėlis;Drugelių;8266735624;Taip;9;2;0;11
8278;Riešutėlis;Drugelių;4776231497;Taip;9;2;0;11
8279;Riešutėlis;Drugelių;8578903763;Taip;13;4;0;17
8280;Riešutėlis;Drugelių;7769079730;Taip;15;0;0;15
8281;Riešutėlis;Drugelių;5811657782;Taip;12;0;1;13
8282;Riešutėlis;Drugelių;4221375847;Taip;0;1;0;1
8283;Riešutėlis;Drugelių;1075842434;Taip;4;0;1;5
8284;Riešutėlis;Drugelių;1942944625;Taip;9;0;0;9
8285;Riešutėlis;Drugelių;8845709386;Taip;7;2;2;11
8286;Riešutėlis;Drugelių;8128352818;Taip;0;6;0;6
8287;Riešutėlis;Drugelių;8352146446;Taip;7;3;0;10
8288;Riešutėlis;Drugelių;8180618419;Ne;0;3;0;3
8289;Riešutėlis;Drugelių;5412882446;Taip;9;3;2;14
8290;Riešutėlis;Drugelių;8020533200;Taip;15;2;0;17
8291;Riešutėlis;Drugelių;1164273595;Ne;13;6;0;19
8292;Riešutėlis;Drugelių;8918753084;Taip;0;3;0;3
8293;Riešutėlis;Drugelių;3836374000;Taip;8;1;0;9
8294;Riešutėlis;Drugelių;8016820352;Taip;12;4;0;16
8295;Riešutėlis;Drugelių;3975091711;Taip;8;7;0;15
8296;Riešutėlis;Drugelių;2599147931;Taip;7;0;0;7
8297;Ramunėlė;SAULUTĖS;19664665864;Ne;0;5;0;5
8298;Ramunėlė;SAULUTĖS;44016905818;Taip;0;3;0;3
8299;Ramunėlė;SAULUTĖS;19784681244;Ne;0;8;0;8
8300;Ramunėlė;SAULUTĖS;9266024764;Taip;0;4;0;4
8301;Ramunėlė;SAULUTĖS;94707638226;Ne;0;1;0;1
8302;Ramunėlė;SAULUTĖS;69367849602;Taip;0;2;1;3
8303;Ramunėlė;SAULUTĖS;27163734018;Ne;0;2;0;2
8304;Ramunėlė;SAULUTĖS;2089805114;Taip;6;0;0;6
8305;Ramunėlė;SAULUTĖS;1079295964;Taip;5;0;0;5
8306;Ramunėlė;SAULUTĖS;26568396284;Ne;0;2;1;3
8307;Ramunėlė;SAULUTĖS;1982905923;Taip;0;2;2;4
8308;Ramunėlė;SAULUTĖS;16577268434;Taip;0;1;0;1
8309;Ramunėlė;SAULUTĖS;3599929268;Taip;0;1;0;1
8310;Ramunėlė;SAULUTĖS;43737882488;Taip;4;1;0;5
8311;Ramunėlė;SAULUTĖS;72681762872;Taip;7;1;0;8
8312;Ramunėlė;SAULUTĖS;37338389480;Taip;0;1;0;1
8313;Ramunėlė;SAULUTĖS;97944093065;Taip;4;2;0;6
8314;Ramunėlė;SAULUTĖS;85972695257;Taip;0;2;0;2
8315;Ramunėlė;SAULUTĖS;42746084302;Taip;0;3;2;5
8316;Ramunėlė;SAULUTĖS;18362159086;Taip;13;0;0;13
8317;Ramunėlė;ŽIBUTĖ;2127262855;Taip;0;2;0;2
8318;Ramunėlė;ŽIBUTĖ;71451001033;Taip;5;0;1;6
8319;Ramunėlė;ŽIBUTĖ;8943746426;Taip;0;3;0;3
8320;Ramunėlė;ŽIBUTĖ;57697488265;Taip;0;5;0;5
8321;Ramunėlė;ŽIBUTĖ;4103951942;Taip;0;6;0;6
8322;Ramunėlė;ŽIBUTĖ;37227575121;Ne;0;5;0;5
8323;Ramunėlė;ŽIBUTĖ;9615607625;Taip;0;6;0;6
8324;Ramunėlė;ŽIBUTĖ;24395304267;Ne;13;2;0;15
8325;Ramunėlė;ŽIBUTĖ;41210974793;Taip;5;0;0;5
8326;Ramunėlė;ŽIBUTĖ;78632810141;Taip;0;3;0;3
8327;Ramunėlė;ŽIBUTĖ;8826277893;Ne;0;4;0;4
8328;Ramunėlė;ŽIBUTĖ;1383896021;Taip;4;2;3;9
8329;Ramunėlė;ŽIBUTĖ;1898089064;Taip;0;16;0;16
8330;Ramunėlė;ŽIBUTĖ;6126971384;Taip;7;2;0;9
8331;Ramunėlė;ŽIBUTĖ;21178777924;Taip;0;1;0;1
8332;Ramunėlė;ŽIBUTĖ;1845973626;Taip;0;1;0;1
8333;Ramunėlė;ŽIBUTĖ;1575204445;Taip;0;1;0;1
8334;Ramunėlė;ŽIBUTĖ;2069380818;Taip;0;0;1;1
8335;Ramunėlė;ŽIBUTĖ;1511271386;Ne;0;7;0;7
8336;Ramunėlė;ŽIRNIUKAI;3973083939;Taip;0;4;0;4
8337;Ramunėlė;ŽIRNIUKAI;53748116108;Taip;0;2;0;2
8338;Ramunėlė;ŽIRNIUKAI;1085668968;Taip;0;1;0;1
8339;Ramunėlė;ŽIRNIUKAI;2075485387;Taip;0;7;0;7
8340;Ramunėlė;ŽIRNIUKAI;2036562086;Taip;0;1;0;1
8341;Ramunėlė;ŽIRNIUKAI;85179822339;Taip;4;2;0;6
8342;Ramunėlė;ŽIRNIUKAI;57963557951;Taip;0;1;0;1
8343;Ramunėlė;ŽIRNIUKAI;9924675250;Taip;0;1;0;1
8344;Ramunėlė;ŽIRNIUKAI;1386186515;Taip;0;0;1;1
8345;Ramunėlė;ŽIRNIUKAI;1364997950;Taip;0;4;0;4
8346;Ramunėlė;ŽIRNIUKAI;1171170929;Ne;0;2;5;7
8347;Ramunėlė;ŽIRNIUKAI;10677635919;Taip;0;4;0;4
8348;Ramunėlė;ŽIRNIUKAI;1157861595;Taip;2;0;0;2
8349;Ramunėlė;ŽIRNIUKAI;1397784717;Taip;4;0;1;5
8350;Ramunėlė;ŽIRNIUKAI;17292085814;Taip;0;2;0;2
8351;Ramunėlė;ŽIRNIUKAI;1500685962;Taip;0;19;0;19
8352;Ramunėlė;ŽIRNIUKAI;4814208279;Ne;1;2;0;3
8353;Ramunėlė;ŽIRNIUKAI;8254302108;Taip;0;1;0;1
8354;Ramunėlė;ŽIRNIUKAI;60610765717;Taip;3;1;0;4
8355;Ramunėlė;BITUTĖS;23095478847;Taip;0;8;0;8
8356;Ramunėlė;BITUTĖS;1866642357;Ne;9;7;0;16
8357;Ramunėlė;BITUTĖS;1343249939;Taip;2;5;4;11
8358;Ramunėlė;BITUTĖS;3541189470;Taip;0;2;1;3
8359;Ramunėlė;BITUTĖS;95100104105;Ne;6;2;2;10
8360;Ramunėlė;BITUTĖS;32249506035;Taip;0;2;1;3
8361;Ramunėlė;BITUTĖS;42582811243;Taip;0;6;0;6
8362;Ramunėlė;BITUTĖS;3683430430;Taip;0;7;0;7
8363;Ramunėlė;BITUTĖS;4101387438;Taip;5;0;0;5
8364;Ramunėlė;BITUTĖS;16357824257;Taip;0;7;0;7
8365;Ramunėlė;BITUTĖS;1012658900;Taip;0;6;0;6
8366;Ramunėlė;BITUTĖS;1485483496;Taip;6;5;0;11
8367;Ramunėlė;BITUTĖS;1090204906;Taip;0;0;2;2
8368;Ramunėlė;BITUTĖS;9961229084;Taip;0;1;0;1
8369;Ramunėlė;BITUTĖS;8098492540;Taip;0;13;0;13
8370;Ramunėlė;BITUTĖS;17201639406;Taip;4;0;4;8
8371;Ramunėlė;BITUTĖS;3065727741;Taip;0;5;0;5
8372;Ramunėlė;BITUTĖS;19420482998;Ne;5;0;0;5
8373;Ramunėlė;BITUTĖS;9130637883;Taip;7;6;0;13
8374;Ramunėlė;BITUTĖS;8016643568;Taip;4;9;0;13
8375;Ramunėlė;BITUTĖS;6217540064;Ne;0;2;7;9
8376;Ramunėlė;BITUTĖS;4990982790;Taip;5;4;0;9
8377;Ramunėlė;BITUTĖS;9171690612;Taip;0;2;5;7
8378;Ramunėlė;BITUTĖS;3271832822;Ne;10;2;1;13
8379;Ramunėlė;DRUGELIAI;15310034187;Taip;0;3;0;3
8380;Ramunėlė;DRUGELIAI;25346770513;Taip;0;7;2;9
8381;Ramunėlė;DRUGELIAI;28838673166;Ne;0;2;0;2
8382;Ramunėlė;DRUGELIAI;1253351354;Taip;6;0;0;6
8383;Ramunėlė;DRUGELIAI;84319432445;Ne;0;2;2;4
8384;Ramunėlė;DRUGELIAI;26152001976;Ne;5;4;0;9
8385;Ramunėlė;DRUGELIAI;22306706669;Taip;5;1;0;6
8386;Ramunėlė;DRUGELIAI;76947701645;Taip;3;0;0;3
8387;Ramunėlė;DRUGELIAI;1175561112;Taip;0;4;0;4
8388;Ramunėlė;DRUGELIAI;1478538572;Taip;7;1;0;8
8389;Ramunėlė;DRUGELIAI;72620475723;Ne;0;8;0;8
8390;Ramunėlė;DRUGELIAI;92929314036;Taip;4;2;0;6
8391;Ramunėlė;DRUGELIAI;67836032797;Taip;0;11;0;11
8392;Ramunėlė;DRUGELIAI;9017349382;Taip;0;1;0;1
8393;Ramunėlė;DRUGELIAI;1376538015;Ne;6;2;0;8
8394;Ramunėlė;DRUGELIAI;1783572058;Taip;0;4;0;4
8395;Ramunėlė;DRUGELIAI;30907738272;Ne;0;2;6;8
8396;Ramunėlė;DRUGELIAI;1891454355;Ne;11;3;0;14
8397;Ramunėlė;DRUGELIAI;1814199950;Taip;0;4;0;4
8398;Ramunėlė;DRUGELIAI;1199690327;Taip;7;0;0;7
8399;Ramunėlė;DRUGELIAI;1988109236;Taip;3;2;0;5
8400;Ramunėlė;DRUGELIAI;52168460247;Taip;3;0;2;5
8401;Ramunėlė;NEUŽMIRŠTUOLĖS;2383861394;Taip;13;0;0;13
8402;Ramunėlė;NEUŽMIRŠTUOLĖS;7220407572;Taip;4;6;0;10
8403;Ramunėlė;NEUŽMIRŠTUOLĖS;5847625697;Taip;15;0;1;16
8404;Ramunėlė;NEUŽMIRŠTUOLĖS;6342801407;Taip;6;0;1;7
8405;Ramunėlė;NEUŽMIRŠTUOLĖS;7307307882;Taip;9;2;0;11
8406;Ramunėlė;NEUŽMIRŠTUOLĖS;1916520056;Taip;14;0;0;14
8407;Ramunėlė;NEUŽMIRŠTUOLĖS;7692958269;Taip;0;8;3;11
8408;Ramunėlė;NEUŽMIRŠTUOLĖS;5865482869;Taip;0;9;0;9
8409;Ramunėlė;NEUŽMIRŠTUOLĖS;6843262303;Taip;0;0;1;1
8410;Ramunėlė;NEUŽMIRŠTUOLĖS;8942483792;Taip;0;0;15;15
8411;Ramunėlė;NEUŽMIRŠTUOLĖS;6870110390;Taip;10;0;0;10
8412;Ramunėlė;NEUŽMIRŠTUOLĖS;2245564567;Taip;10;0;0;10
8413;Ramunėlė;NEUŽMIRŠTUOLĖS;8940763540;Taip;9;7;0;16
8414;Ramunėlė;NEUŽMIRŠTUOLĖS;2225787182;Taip;0;3;0;3
8415;Ramunėlė;NEUŽMIRŠTUOLĖS;6329943991;Taip;10;0;3;13
8416;Ramunėlė;NEUŽMIRŠTUOLĖS;8086994543;Taip;0;4;0;4
8417;Ramunėlė;NEUŽMIRŠTUOLĖS;6166192468;Taip;2;0;0;2
8418;Ramunėlė;NEUŽMIRŠTUOLĖS;6165754839;Taip;0;1;0;1
8419;Ramunėlė;OBUOLIUKAI;2555810841;Taip;0;0;6;6
8420;Ramunėlė;OBUOLIUKAI;7228065409;Taip;0;15;0;15
8421;Ramunėlė;OBUOLIUKAI;8402889872;Taip;20;0;0;20
8422;Ramunėlė;OBUOLIUKAI;1745170057;Taip;0;2;2;4
8423;Ramunėlė;OBUOLIUKAI;5170325023;Taip;13;0;0;13
8424;Ramunėlė;OBUOLIUKAI;8768539595;Taip;0;14;0;14
8425;Ramunėlė;OBUOLIUKAI;2055332353;Taip;6;4;0;10
8426;Ramunėlė;OBUOLIUKAI;2567264851;Taip;8;0;0;8
8427;Ramunėlė;OBUOLIUKAI;9584620339;Taip;10;0;0;10
8428;Ramunėlė;OBUOLIUKAI;6930505887;Taip;11;1;0;12
8429;Ramunėlė;OBUOLIUKAI;1199673371;Taip;0;0;2;2
8430;Ramunėlė;OBUOLIUKAI;3617897977;Taip;0;5;2;7
8431;Ramunėlė;OBUOLIUKAI;7955507702;Taip;0;0;4;4
8432;Ramunėlė;OBUOLIUKAI;58573425792;Taip;7;2;5;14
8433;Ramunėlė;OBUOLIUKAI;1078618047;Taip;18;3;0;21
8434;Ramunėlė;OBUOLIUKAI;6348171102;Taip;9;0;0;9
8435;Ramunėlė;OBUOLIUKAI;4392309015;Taip;8;0;1;9
8436;Ramunėlė;OBUOLIUKAI;5049415445;Taip;15;0;4;19
8437;Ramunėlė;OBUOLIUKAI;1800967823;Taip;4;0;0;4
8438;Ramunėlė;OBUOLIUKAI;8656417794;Taip;5;2;4;11
8439;Ramunėlė;OBUOLIUKAI;8205893352;Taip;6;2;0;8
8440;Ramunėlė;SAULĖGRĄŽA;5465647281;Taip;0;14;0;14
8441;Ramunėlė;SAULĖGRĄŽA;9927068798;Taip;0;1;0;1
8442;Ramunėlė;SAULĖGRĄŽA;3852734401;Taip;4;1;0;5
8443;Ramunėlė;SAULĖGRĄŽA;1483391590;Taip;0;1;0;1
8444;Ramunėlė;SAULĖGRĄŽA;8929122197;Ne;0;1;0;1
8445;Ramunėlė;SAULĖGRĄŽA;7219400182;Taip;0;1;0;1
8446;Ramunėlė;SAULĖGRĄŽA;4575123456;Taip;7;0;0;7
8447;Ramunėlė;SAULĖGRĄŽA;1192743154;Taip;0;5;0;5
8448;Ramunėlė;SAULĖGRĄŽA;5562960498;Taip;0;12;0;12
8449;Ramunėlė;SAULĖGRĄŽA;8726443989;Taip;12;4;0;16
8450;Ramunėlė;SAULĖGRĄŽA;1599595174;Taip;0;1;0;1
8451;Ramunėlė;SAULĖGRĄŽA;3779769727;Taip;0;2;2;4
8452;Ramunėlė;SAULĖGRĄŽA;8323020864;Taip;10;0;0;10
8453;Ramunėlė;SAULĖGRĄŽA;5420360864;Taip;0;7;0;7
8454;Ramunėlė;SAULĖGRĄŽA;4209191105;Taip;0;1;0;1
8455;Ramunėlė;SAULĖGRĄŽA;5714771643;Taip;2;1;0;3
8456;Ramunėlė;BORUŽĖLĖS;82024687579;Taip;10;4;0;14
8457;Ramunėlė;BORUŽĖLĖS;1946639898;Taip;0;6;0;6
8458;Ramunėlė;BORUŽĖLĖS;1827657363;Taip;0;2;0;2
8459;Ramunėlė;BORUŽĖLĖS;1341351994;Taip;0;13;0;13
8460;Ramunėlė;BORUŽĖLĖS;2859202237;Taip;4;2;0;6
8461;Ramunėlė;BORUŽĖLĖS;1709795078;Taip;0;3;4;7
8462;Ramunėlė;BORUŽĖLĖS;1077068878;Taip;0;4;0;4
8463;Ramunėlė;BORUŽĖLĖS;1207455851;Taip;0;0;5;5
8464;Ramunėlė;BORUŽĖLĖS;1405532116;Taip;0;2;0;2
8465;Ramunėlė;BORUŽĖLĖS;76195144469;Taip;0;2;15;17
8466;Ramunėlė;BORUŽĖLĖS;1690224857;Taip;0;0;2;2
8467;Ramunėlė;BORUŽĖLĖS;1058243928;Taip;0;6;0;6
8468;Ramunėlė;BORUŽĖLĖS;93125217886;Taip;2;0;0;2
8469;Ramunėlė;BORUŽĖLĖS;1033548164;Taip;0;1;0;1
8470;Ramunėlė;BORUŽĖLĖS;1439962940;Taip;0;1;0;1
8471;Ramunėlė;NYKŠTUKAS;7250951221;Taip;3;0;0;3
8472;Ramunėlė;NYKŠTUKAS;2427399083;Taip;10;0;0;10
8473;Ramunėlė;NYKŠTUKAS;5316468106;Taip;10;0;0;10
8474;Ramunėlė;NYKŠTUKAS;4233978236;Taip;8;0;0;8
8475;Ramunėlė;NYKŠTUKAS;7622952406;Taip;7;0;5;12
8476;Ramunėlė;NYKŠTUKAS;2983986428;Taip;13;7;0;20
8477;Ramunėlė;NYKŠTUKAS;6156792400;Taip;17;3;0;20
8478;Ramunėlė;NYKŠTUKAS;5117135860;Taip;0;1;0;1
8479;Ramunėlė;NYKŠTUKAS;5548358138;Taip;0;8;0;8
8480;Ramunėlė;NYKŠTUKAS;3683181174;Taip;10;0;0;10
8481;Ramunėlė;NYKŠTUKAS;2422656007;Taip;8;0;3;11
8482;Ramunėlė;NYKŠTUKAS;6809164145;Taip;5;2;2;9
8483;Ramunėlė;NYKŠTUKAS;9984243153;Taip;11;0;0;11
8484;Ramunėlė;NYKŠTUKAS;6184872126;Taip;8;0;2;10
8485;Ramunėlė;NYKŠTUKAS;7829765488;Ne;4;0;1;5
8486;Ramunėlė;NYKŠTUKAS;7364976547;Taip;5;0;2;7
8487;Ramunėlė;NYKŠTUKAS;9217815657;Taip;9;11;0;20
8488;Ramunėlė;UOGELĖ;3996453947;Taip;4;1;0;5
8489;Ramunėlė;UOGELĖ;2591052434;Ne;14;0;0;14
8490;Ramunėlė;UOGELĖ;5304803880;Taip;0;7;0;7
8491;Ramunėlė;UOGELĖ;6389008823;Taip;0;3;0;3
8492;Ramunėlė;UOGELĖ;1671759939;Taip;16;2;0;18
8493;Ramunėlė;UOGELĖ;6347164708;Taip;0;1;0;1
8494;Ramunėlė;UOGELĖ;5315953299;Taip;0;1;0;1
8495;Ramunėlė;UOGELĖ;9136437288;Taip;6;7;0;13
8496;Ramunėlė;UOGELĖ;2446375037;Taip;6;2;0;8
8497;Ramunėlė;UOGELĖ;5801760033;Taip;3;2;1;6
8498;Ramunėlė;UOGELĖ;6627399830;Taip;0;1;6;7
8499;Ramunėlė;UOGELĖ;3525444906;Taip;3;2;0;5
8500;Ramunėlė;UOGELĖ;8055844166;Taip;17;0;0;17
8501;Ramunėlė;UOGELĖ;4715809064;Taip;0;8;0;8
8502;Ramunėlė;VARPELIAI;1534723406;Taip;22;0;0;22
8503;Ramunėlė;VARPELIAI;6837072361;Taip;0;4;0;4
8504;Ramunėlė;VARPELIAI;3685786758;Taip;0;3;0;3
8505;Ramunėlė;VARPELIAI;6310921755;Taip;0;1;0;1
8506;Ramunėlė;VARPELIAI;4349250416;Taip;0;1;0;1
8507;Ramunėlė;VARPELIAI;9448369796;Taip;0;0;1;1
8508;Ramunėlė;VARPELIAI;7750405604;Taip;10;0;0;10
8509;Ramunėlė;VARPELIAI;6695672297;Taip;4;1;0;5
8510;Ramunėlė;VARPELIAI;7825538259;Taip;0;7;0;7
8511;Ramunėlė;VARPELIAI;58028743912;Taip;22;0;0;22
8512;Ramunėlė;VARPELIAI;6612728883;Taip;0;3;0;3
8513;Ramunėlė;VARPELIAI;1567537525;Taip;0;1;0;1
8514;Ramunėlė;VARPELIAI;1216101539;Taip;10;8;0;18
8515;Ramunėlė;VARPELIAI;7638038269;Taip;0;5;0;5
8516;Ramunėlė;VARPELIAI;3554787356;Taip;8;0;0;8
8517;Ramunėlė;VARPELIAI;8496322672;Taip;2;0;0;2
8518;Rūta;SMALSUČIAI;18117978189;Taip;0;1;0;1
8519;Rūta;SMALSUČIAI;78953568121;Taip;0;1;0;1
8520;Rūta;SMALSUČIAI;26152518052;Taip;8;0;0;8
8521;Rūta;SMALSUČIAI;68107516536;Taip;0;1;0;1
8522;Rūta;SMALSUČIAI;87692898919;Taip;0;0;1;1
8523;Rūta;SMALSUČIAI;1323253379;Taip;0;0;1;1
8524;Rūta;SMALSUČIAI;8604212304;Taip;0;6;0;6
8525;Rūta;SMALSUČIAI;50814418724;Ne;0;5;0;5
8526;Rūta;SMALSUČIAI;1364470800;Taip;0;0;3;3
8527;Rūta;SMALSUČIAI;1996690514;Taip;8;2;0;10
8528;Rūta;SMALSUČIAI;59694891781;Taip;0;11;0;11
8529;Rūta;SMALSUČIAI;2986201324;Taip;3;0;2;5
8530;Rūta;KŪLVERSTUKAI;1080628212;Taip;9;0;0;9
8531;Rūta;KŪLVERSTUKAI;80410156050;Taip;0;4;0;4
8532;Rūta;KŪLVERSTUKAI;1150292834;Taip;4;1;0;5
8533;Rūta;KŪLVERSTUKAI;56171468735;Taip;0;5;0;5
8534;Rūta;KŪLVERSTUKAI;88159609117;Taip;0;1;0;1
8535;Rūta;KŪLVERSTUKAI;2084379688;Taip;4;0;0;4
8536;Rūta;KŪLVERSTUKAI;1807332522;Taip;0;8;0;8
8537;Rūta;KŪLVERSTUKAI;1674584707;Taip;0;8;0;8
8538;Rūta;KŪLVERSTUKAI;2079429418;Taip;0;3;0;3
8539;Rūta;KŪLVERSTUKAI;1972150300;Taip;0;3;0;3
8540;Rūta;KŪLVERSTUKAI;99777522247;Taip;7;0;0;7
8541;Rūta;KŪLVERSTUKAI;1971925569;Taip;0;6;0;6
8542;Rūta;KŪLVERSTUKAI;56470874552;Taip;9;0;0;9
8543;Rūta;KŪLVERSTUKAI;17349566042;Ne;0;5;0;5
8544;Rūta;KŪLVERSTUKAI;1043614414;Taip;0;11;0;11
8545;Rūta;KŪLVERSTUKAI;1703148668;Taip;22;0;0;22
8546;Rūta;KŪLVERSTUKAI;1177226887;Ne;7;1;0;8
8547;Rūta;KODĖLČIUKAI;2546023973;Taip;6;0;2;8
8548;Rūta;KODĖLČIUKAI;6814051598;Taip;10;0;0;10
8549;Rūta;KODĖLČIUKAI;1775029025;Taip;5;0;0;5
8550;Rūta;KODĖLČIUKAI;8958880558;Taip;15;3;4;22
8551;Rūta;KODĖLČIUKAI;2263820829;Taip;12;0;0;12
8552;Rūta;KODĖLČIUKAI;5109138407;Taip;7;0;0;7
8553;Rūta;KODĖLČIUKAI;8599313527;Taip;0;10;0;10
8554;Rūta;KODĖLČIUKAI;6186413364;Taip;0;15;0;15
8555;Rūta;KODĖLČIUKAI;6458458913;Taip;5;1;0;6
8556;Rūta;KODĖLČIUKAI;6585842434;Taip;21;0;0;21
8557;Rūta;KODĖLČIUKAI;4473591998;Taip;5;4;0;9
8558;Rūta;KODĖLČIUKAI;9589117921;Taip;11;0;0;11
8559;Rūta;KODĖLČIUKAI;5902965224;Taip;3;4;0;7
8560;Rūta;BORUŽĖLĖS;1623968580;Taip;0;3;5;8
8561;Rūta;BORUŽĖLĖS;8273644943;Taip;6;0;2;8
8562;Rūta;BORUŽĖLĖS;4293920701;Taip;0;0;3;3
8563;Rūta;BORUŽĖLĖS;9419809946;Taip;0;2;0;2
8564;Rūta;BORUŽĖLĖS;3454881685;Taip;5;8;0;13
8565;Rūta;BORUŽĖLĖS;1811055786;Taip;0;0;7;7
8566;Rūta;BORUŽĖLĖS;1510268514;Taip;3;0;0;3
8567;Rūta;BORUŽĖLĖS;2702537976;Taip;0;1;0;1
8568;Rūta;BORUŽĖLĖS;4044349935;Taip;4;3;0;7
8569;Rūta;BORUŽĖLĖS;7936198171;Taip;19;0;0;19
8570;Rūta;BORUŽĖLĖS;9243332756;Taip;10;0;0;10
8571;Rūta;BORUŽĖLĖS;8963959004;Taip;0;0;7;7
8572;Rūta;BORUŽĖLĖS;2772130413;Taip;0;5;0;5
8573;Rūta;VYTURĖLIAI;69788516459;Taip;0;13;0;13
8574;Rūta;VYTURĖLIAI;78925728976;Ne;0;1;1;2
8575;Rūta;VYTURĖLIAI;44365150696;Taip;0;4;0;4
8576;Rūta;VYTURĖLIAI;10957816153;Ne;0;2;0;2
8577;Rūta;VYTURĖLIAI;35843737071;Taip;0;1;1;2
8578;Rūta;VYTURĖLIAI;4409524323;Taip;0;1;1;2
8579;Rūta;VYTURĖLIAI;2033577529;Taip;0;6;0;6
8580;Rūta;VYTURĖLIAI;28332403249;Taip;0;1;2;3
8581;Rūta;VYTURĖLIAI;76831234529;Taip;2;0;2;4
8582;Rūta;VYTURĖLIAI;24211514845;Taip;0;2;0;2
8583;Rūta;VYTURĖLIAI;48213220767;Ne;0;9;0;9
8584;Rūta;VYTURĖLIAI;50266063379;Ne;10;4;1;15
8585;Rūta;VYTURĖLIAI;28676981495;Ne;0;11;0;11
8586;Rūta;VYTURĖLIAI;91072621203;Taip;0;6;0;6
8587;Rūta;VYTURĖLIAI;81049938466;Taip;9;0;0;9
8588;Rūta;VYTURĖLIAI;34935546673;Taip;13;0;0;13
8589;Rūta;VYTURĖLIAI;47869128534;Taip;9;0;0;9
8590;Rūta;VYTURĖLIAI;67740925555;Taip;8;0;4;12
8591;Rūta;"PABIRUČIAI (LOGOPEDINĖ)";1489564914;Taip;0;15;0;15
8592;Rūta;"PABIRUČIAI (LOGOPEDINĖ)";5009619812;Ne;7;0;0;7
8593;Rūta;"PABIRUČIAI (LOGOPEDINĖ)";3055294324;Ne;0;0;1;1
8594;Rūta;"PABIRUČIAI (LOGOPEDINĖ)";3247709788;Taip;15;0;1;16
8595;Rūta;GUDRUČIAI;3873876608;Taip;0;2;0;2
8596;Rūta;GUDRUČIAI;8851591109;Taip;0;0;5;5
8597;Rūta;GUDRUČIAI;3478456813;Taip;0;4;2;6
8598;Rūta;GUDRUČIAI;8889388348;Taip;0;0;1;1
8599;Rūta;GUDRUČIAI;1346367896;Taip;0;1;0;1
8600;Rūta;GUDRUČIAI;2116581815;Taip;8;0;2;10
8601;Rūta;GUDRUČIAI;4363571135;Taip;0;4;0;4
8602;Rūta;GUDRUČIAI;6006094035;Taip;5;0;1;6
8603;Rūta;GUDRUČIAI;1521231573;Ne;6;0;1;7
8604;Rūta;GUDRUČIAI;7552644990;Taip;4;10;0;14
8605;Rūta;GUDRUČIAI;8673942478;Taip;0;1;6;7
8606;Rūta;GUDRUČIAI;4078957924;Taip;0;0;1;1
8607;Rūta;GUDRUČIAI;4754142240;Taip;0;1;0;1
8608;Rūta;GUDRUČIAI;1565896222;Ne;0;0;8;8
8609;Rūta;GUDRUČIAI;8704594038;Taip;0;0;1;1
8610;Rūta;GUDRUČIAI;7631229177;Taip;5;0;2;7
8611;Rūta;GUDRUČIAI;8026402652;Ne;13;0;0;13
8612;Rūta;SEKLYTĖLĖ;1800198849;Taip;0;4;0;4
8613;Rūta;SEKLYTĖLĖ;54140704807;Taip;0;0;7;7
8614;Rūta;SEKLYTĖLĖ;76518034714;Taip;0;1;0;1
8615;Rūta;SEKLYTĖLĖ;79192262053;Taip;0;2;3;5
8616;Rūta;SEKLYTĖLĖ;42791864630;Taip;0;6;3;9
8617;Rūta;SEKLYTĖLĖ;20967345257;Taip;0;0;2;2
8618;Rūta;SEKLYTĖLĖ;50734030014;Taip;5;5;0;10
8619;Rūta;SEKLYTĖLĖ;29240858006;Taip;0;0;9;9
8620;Rūta;SEKLYTĖLĖ;75730421646;Ne;0;8;0;8
8621;Rūta;SEKLYTĖLĖ;2711671531;Ne;0;0;6;6
8622;Rūta;SEKLYTĖLĖ;9994442882;Taip;0;3;0;3
8623;Rūta;SEKLYTĖLĖ;29483136582;Taip;0;9;2;11
8624;Rūta;SEKLYTĖLĖ;1545183162;Ne;1;0;0;1
8625;Rūta;SEKLYTĖLĖ;5733023163;Taip;18;0;0;18
8626;Rūta;SEKLYTĖLĖ;63972399637;Taip;7;0;0;7
8627;Rūta;"VARPELIAI (LOGOPEDINĖ)";1863889584;Taip;0;0;5;5
8628;Rūta;"VARPELIAI (LOGOPEDINĖ)";70608720189;Taip;4;2;5;11
8629;Rūta;"VARPELIAI (LOGOPEDINĖ)";97812491022;Taip;0;4;0;4
8630;Rūta;"VARPELIAI (LOGOPEDINĖ)";57805651069;Taip;0;2;0;2
8631;Rūta;"VARPELIAI (LOGOPEDINĖ)";1831410058;Taip;0;0;3;3
8632;Rūta;KIŠKUČIŲ;4297300799;Ne;0;9;0;9
8633;Rūta;KIŠKUČIŲ;6207902435;Taip;0;5;0;5
8634;Rūta;KIŠKUČIŲ;9791861646;Taip;0;0;14;14
8635;Rūta;KIŠKUČIŲ;7434152435;Taip;0;0;8;8
8636;Rūta;KIŠKUČIŲ;8182243701;Taip;3;1;4;8
8637;Rūta;KIŠKUČIŲ;4728904136;Taip;0;6;0;6
8638;Rūta;KIŠKUČIŲ;6316768460;Taip;0;22;0;22
8639;Rūta;KIŠKUČIŲ;2928803089;Taip;13;5;0;18
8640;Rūta;KIŠKUČIŲ;3875136625;Taip;0;3;0;3
8641;Rūta;KIŠKUČIŲ;5899860543;Taip;0;15;0;15
8642;Rūta;KIŠKUČIŲ;8378318357;Ne;9;6;0;15
8643;Rūta;KIŠKUČIŲ;4962272621;Taip;4;5;0;9
8644;Rūta;KIŠKUČIŲ;9603105651;Taip;10;0;6;16
8645;Rūta;KIŠKUČIŲ;1951202550;Taip;3;0;3;6
8646;Rūta;KIŠKUČIŲ;9911151238;Taip;8;0;5;13
8647;Rūta;KIŠKUČIŲ;1346124133;Taip;0;7;0;7
8648;Rūta;KIŠKUČIŲ;1543099858;Taip;9;8;5;22
8649;Rūta;KIŠKUČIŲ;3843325181;Taip;0;0;2;2
8650;Rūta;KIŠKUČIŲ;7649756034;Taip;10;0;0;10
8651;Rūta;ŽVIRBLIUKAI;3499727608;Taip;16;0;0;16
8652;Rūta;ŽVIRBLIUKAI;9765301038;Taip;16;0;0;16
8653;Rūta;ŽVIRBLIUKAI;8277677952;Taip;6;3;2;11
8654;Rūta;ŽVIRBLIUKAI;9638495757;Taip;10;0;0;10
8655;Rūta;ŽVIRBLIUKAI;3956912957;Ne;0;1;2;3
8656;Rūta;ŽVIRBLIUKAI;3055345528;Taip;0;4;0;4
8657;Rūta;ŽVIRBLIUKAI;4423305209;Taip;0;1;0;1
8658;Rūta;ŽVIRBLIUKAI;2890569107;Ne;0;0;8;8
8659;Rūta;ŽVIRBLIUKAI;3964922552;Taip;11;0;0;11
8660;Rūta;ŽVIRBLIUKAI;1216786487;Ne;0;5;0;5
8661;Rūta;ŽVIRBLIUKAI;9736567509;Taip;0;0;6;6
8662;Rūta;ŽVIRBLIUKAI;2474991135;Taip;6;0;0;6
8663;Rūta;ŽVIRBLIUKAI;7519931138;Taip;0;0;6;6
8664;Rūta;ŽVIRBLIUKAI;9400586178;Taip;0;8;0;8
8665;Rūta;ŽVIRBLIUKAI;8395765508;Taip;0;0;1;1
8666;Rūta;ŽVIRBLIUKAI;7222494215;Taip;7;1;0;8
8667;Rūta;ŽVIRBLIUKAI;1962172243;Taip;8;0;0;8
8668;Rūta;ŽVIRBLIUKAI;7553844890;Taip;0;4;5;9
8669;Rūta;ŽVIRBLIUKAI;8605070655;Taip;5;0;1;6
8670;Rūta;ŽVIRBLIUKAI;4880804625;Ne;0;0;8;8
8671;Rūta;SAULUTĖS;1671913833;Taip;0;5;4;9
8672;Rūta;SAULUTĖS;1186493111;Taip;0;5;0;5
8673;Rūta;SAULUTĖS;9675482322;Ne;4;9;0;13
8674;Rūta;SAULUTĖS;1415664888;Taip;0;6;3;9
8675;Rūta;SAULUTĖS;6982618655;Ne;0;4;0;4
8676;Rūta;SAULUTĖS;4282074540;Taip;0;1;0;1
8677;Rūta;SAULUTĖS;8607455403;Taip;0;3;0;3
8678;Rūta;SAULUTĖS;9569447586;Taip;0;5;0;5
8679;Rūta;SAULUTĖS;2677062861;Taip;6;0;0;6
8680;Rūta;SAULUTĖS;1390207547;Taip;0;1;0;1
8681;Rūta;SAULUTĖS;32004750783;Taip;0;0;4;4
8682;Rūta;SAULUTĖS;3567273206;Ne;0;0;2;2
8683;Rūta;SAULUTĖS;1368317570;Taip;4;0;0;4
8684;Sadutė;Kiškučiai;42447771280;Taip;0;1;0;1
8685;Sadutė;Kiškučiai;62408324442;Taip;0;10;0;10
8686;Sadutė;Kiškučiai;3253659165;Taip;0;1;1;2
8687;Sadutė;Kiškučiai;67439547513;Taip;0;1;0;1
8688;Sadutė;Kiškučiai;98527988102;Taip;0;3;0;3
8689;Sadutė;Kiškučiai;62077575922;Ne;0;1;5;6
8690;Sadutė;Kiškučiai;48298497;Taip;0;0;2;2
8691;Sadutė;Kiškučiai;69988140413;Taip;0;4;0;4
8692;Sadutė;Kiškučiai;61357382189;Taip;0;0;1;1
8693;Sadutė;Kiškučiai;1433422421;Taip;4;1;4;9
8694;Sadutė;Kiškučiai;73649870571;Taip;1;0;14;15
8695;Sadutė;Kiškučiai;1092421263;Taip;0;11;2;13
8696;Sadutė;Kiškučiai;1291782232;Taip;0;3;0;3
8697;Sadutė;Kiškučiai;5586949339;Ne;0;0;2;2
8698;Sadutė;Kiškučiai;9883685724;Taip;0;1;14;15
8699;Sadutė;Kiškučiai;4525909977;Taip;10;0;0;10
8700;Sadutė;Kiškučiai;1533081218;Taip;0;11;2;13
8701;Sadutė;Kiškučiai;3400524440;Ne;0;0;4;4
8702;Sadutė;Kiškučiai;1084400276;Taip;2;2;2;6
8703;Sadutė;Boružėlės;99171108375;Taip;0;0;3;3
8704;Sadutė;Boružėlės;30046732620;Taip;0;10;0;10
8705;Sadutė;Boružėlės;91943880567;Taip;0;0;6;6
8706;Sadutė;Boružėlės;70505797915;Ne;0;0;4;4
8707;Sadutė;Boružėlės;48817619537;Taip;3;0;2;5
8708;Sadutė;Boružėlės;76464399248;Taip;0;0;2;2
8709;Sadutė;Boružėlės;47883796567;Taip;0;0;5;5
8710;Sadutė;Boružėlės;93561298785;Ne;0;0;2;2
8711;Sadutė;Boružėlės;48327367042;Taip;0;0;11;11
8712;Sadutė;Boružėlės;4064111008;Ne;0;0;3;3
8713;Sadutė;Boružėlės;35237170892;Taip;0;0;1;1
8714;Sadutė;Boružėlės;84758378727;Taip;0;0;3;3
8715;Sadutė;Boružėlės;38373089101;Taip;0;8;2;10
8716;Sadutė;Boružėlės;13779484979;Taip;0;0;4;4
8717;Sadutė;Boružėlės;2414632774;Taip;2;0;2;4
8718;Sadutė;Boružėlės;16493384211;Taip;0;0;7;7
8719;Sadutė;Boružėlės;71576294118;Ne;5;0;4;9
8720;Sadutė;Boružėlės;21011440269;Ne;0;0;6;6
8721;Sadutė;Boružėlės;39222963335;Ne;0;0;10;10
8722;Sadutė;Boružėlės;4695479762;Taip;0;0;6;6
8723;Sadutė;Boružėlės;1920496059;Taip;0;2;0;2
8724;Sadutė;Bitutės;1759479328;Taip;0;1;0;1
8725;Sadutė;Bitutės;4245873513;Ne;6;1;1;8
8726;Sadutė;Bitutės;1873928395;Ne;3;3;2;8
8727;Sadutė;Bitutės;5866461096;Taip;0;0;3;3
8728;Sadutė;Bitutės;4883934480;Ne;14;2;1;17
8729;Sadutė;Bitutės;9107727583;Taip;2;0;0;2
8730;Sadutė;Bitutės;7097653016;Taip;5;0;0;5
8731;Sadutė;Bitutės;4479315578;Taip;7;0;0;7
8732;Sadutė;Bitutės;2020766695;Taip;0;22;0;22
8733;Sadutė;Bitutės;5011320850;Taip;0;5;3;8
8734;Sadutė;Bitutės;4161502667;Taip;4;0;2;6
8735;Sadutė;Bitutės;5973513916;Ne;0;15;0;15
8736;Sadutė;Bitutės;5169694660;Taip;0;1;0;1
8737;Sadutė;Bitutės;3361904803;Taip;10;0;8;18
8738;Sadutė;Bitutės;1231048342;Taip;4;1;0;5
8739;Sadutė;Drugeliai;1552350084;Taip;0;9;0;9
8740;Sadutė;Drugeliai;7910380894;Taip;5;0;0;5
8741;Sadutė;Drugeliai;2467800545;Taip;4;0;0;4
8742;Sadutė;Drugeliai;4402558234;Taip;0;1;0;1
8743;Sadutė;Drugeliai;8713575864;Taip;3;3;0;6
8744;Sadutė;Drugeliai;1782594187;Ne;3;0;1;4
8745;Sadutė;Drugeliai;5816844295;Taip;3;2;0;5
8746;Sadutė;Drugeliai;2095914442;Taip;3;0;0;3
8747;Sadutė;Drugeliai;8803249656;Ne;4;2;2;8
8748;Sadutė;Drugeliai;4901634532;Taip;0;5;0;5
8749;Sadutė;Drugeliai;6196282159;Taip;9;0;1;10
8750;Sadutė;Drugeliai;8953107298;Taip;22;0;0;22
8751;Sadutė;Drugeliai;1735450955;Taip;2;1;0;3
8752;Sadutė;Drugeliai;2064784580;Taip;2;1;0;3
8753;Sadutė;Drugeliai;2883991326;Taip;2;0;0;2
8754;Sadutė;Drugeliai;7731164484;Taip;0;1;0;1
8755;Sadutė;Drugeliai;2014660237;Taip;11;0;2;13
8756;Sadutė;Drugeliai;8322941607;Ne;9;13;0;22
8757;Sadutė;Pėledžiukai;50662732693;Taip;0;0;3;3
8758;Sadutė;Pėledžiukai;26761581977;Ne;0;6;0;6
8759;Sadutė;Pėledžiukai;1885941594;Taip;0;7;0;7
8760;Sadutė;Pėledžiukai;4933574100;Taip;0;6;0;6
8761;Sadutė;Pėledžiukai;6105924871;Taip;0;5;0;5
8762;Sadutė;Pėledžiukai;8870465478;Taip;15;3;0;18
8763;Sadutė;Pėledžiukai;64835095908;Taip;8;5;0;13
8764;Sadutė;Pėledžiukai;3619323573;Ne;3;1;15;19
8765;Sadutė;Pėledžiukai;14962142857;Taip;0;4;0;4
8766;Sadutė;Pėledžiukai;92111253012;Taip;0;0;1;1
8767;Sadutė;Pėledžiukai;1594844154;Ne;17;0;0;17
8768;Sadutė;Pėledžiukai;1005751811;Taip;11;9;0;20
8769;Sadutė;Pėledžiukai;45981672295;Taip;0;5;3;8
8770;Sadutė;Pėledžiukai;5864572784;Taip;0;8;0;8
8771;Sadutė;Pėledžiukai;8667620186;Taip;0;1;0;1
8772;Sadutė;Pėledžiukai;9946417453;Ne;0;3;0;3
8773;Sadutė;Pėledžiukai;48818906299;Ne;0;0;5;5
8774;Sadutė;Pėledžiukai;1003580436;Taip;3;0;2;5
8775;Sadutė;Pėledžiukai;1190667513;Taip;0;2;0;2
8776;Sadutė;Pėledžiukai;1985946393;Taip;0;4;0;4
8777;Sadutė;Kačiukų;1507052440;Taip;5;0;4;9
8778;Sadutė;Kačiukų;1903961488;Ne;5;0;5;10
8779;Sadutė;Kačiukų;2890916313;Taip;0;9;5;14
8780;Sadutė;Kačiukų;2733633163;Taip;3;0;1;4
8781;Sadutė;Kačiukų;3993181500;Taip;0;10;2;12
8782;Sadutė;Kačiukų;1871236869;Taip;0;8;2;10
8783;Sadutė;Kačiukų;8835627470;Taip;9;0;0;9
8784;Sadutė;Kačiukų;2466024649;Taip;0;11;2;13
8785;Sadutė;Kačiukų;2426974464;Taip;2;0;1;3
8786;Sadutė;Kačiukų;5438448926;Taip;0;5;0;5
8787;Sadutė;Kačiukų;8974374101;Taip;9;0;1;10
8788;Sadutė;Kačiukų;8714168144;Taip;5;0;0;5
8789;Sadutė;Kačiukų;3927044011;Taip;10;0;3;13
8790;Sadutė;Kačiukų;8974225608;Ne;0;0;4;4
8791;Sadutė;Kačiukų;8770727233;Taip;9;0;0;9
8792;Sakalėlis;GIRINUKŲ;9566176151;Taip;18;0;0;18
8793;Sakalėlis;GIRINUKŲ;8606714134;Ne;5;8;0;13
8794;Sakalėlis;GIRINUKŲ;2895663259;Taip;8;3;0;11
8795;Sakalėlis;GIRINUKŲ;5405669698;Ne;2;0;1;3
8796;Sakalėlis;GIRINUKŲ;2474164013;Ne;13;0;0;13
8797;Sakalėlis;GIRINUKŲ;9493905856;Taip;10;0;4;14
8798;Sakalėlis;GIRINUKŲ;5496044442;Taip;4;0;1;5
8799;Sakalėlis;GIRINUKŲ;3165387995;Taip;0;0;4;4
8800;Sakalėlis;GIRINUKŲ;6603105354;Ne;7;0;2;9
8801;Sakalėlis;GIRINUKŲ;3418702674;Taip;0;0;1;1
8802;Sakalėlis;GIRINUKŲ;6700169944;Ne;6;0;0;6
8803;Sakalėlis;GIRINUKŲ;3333037807;Taip;4;1;0;5
8804;Sakalėlis;GIRINUKŲ;8667155756;Ne;4;0;1;5
8805;Sakalėlis;GIRINUKŲ;4596727938;Taip;0;0;1;1
8806;Sakalėlis;GIRINUKŲ;6706466627;Taip;11;4;0;15
8807;Sakalėlis;GIRINUKŲ;4458071075;Taip;0;0;5;5
8808;Sakalėlis;GIRINUKŲ;4209146744;Taip;7;0;0;7
8809;Sakalėlis;GIRINUKŲ;2780141413;Ne;0;8;0;8
8810;Sakalėlis;GIRINUKŲ;1347171934;Taip;4;0;0;4
8811;Sakalėlis;GIRINUKŲ;9823633774;Taip;0;0;1;1
8812;Sakalėlis;VYTURIUKŲ;21726291811;Taip;8;0;0;8
8813;Sakalėlis;VYTURIUKŲ;7852180045;Taip;0;0;1;1
8814;Sakalėlis;VYTURIUKŲ;27291131963;Taip;0;1;2;3
8815;Sakalėlis;VYTURIUKŲ;1822130260;Ne;4;6;0;10
8816;Sakalėlis;VYTURIUKŲ;25558438129;Taip;0;0;6;6
8817;Sakalėlis;VYTURIUKŲ;33360718659;Taip;3;0;4;7
8818;Sakalėlis;VYTURIUKŲ;99937511623;Taip;0;0;6;6
8819;Sakalėlis;VYTURIUKŲ;32956243898;Taip;0;3;1;4
8820;Sakalėlis;VYTURIUKŲ;87806505145;Taip;0;0;1;1
8821;Sakalėlis;VYTURIUKŲ;59067963901;Taip;19;0;0;19
8822;Sakalėlis;VYTURIUKŲ;1371469574;Ne;0;5;0;5
8823;Sakalėlis;VYTURIUKŲ;52975188309;Taip;0;0;2;2
8824;Sakalėlis;VYTURIUKŲ;74622921410;Taip;0;0;3;3
8825;Sakalėlis;VYTURIUKŲ;13953070987;Taip;6;0;8;14
8826;Sakalėlis;VYTURIUKŲ;80747256105;Taip;8;0;0;8
8827;Sakalėlis;VYTURIUKŲ;77801416034;Taip;13;0;0;13
8828;Sakalėlis;VYTURIUKŲ;12601081196;Taip;0;0;6;6
8829;Sakalėlis;VYTURIUKŲ;60747121226;Taip;0;8;0;8
8830;Sakalėlis;DRUGELIŲ;97259304899;Taip;2;0;2;4
8831;Sakalėlis;DRUGELIŲ;1605682818;Taip;0;5;0;5
8832;Sakalėlis;DRUGELIŲ;68379930730;Taip;0;0;1;1
8833;Sakalėlis;DRUGELIŲ;19456041826;Taip;0;0;4;4
8834;Sakalėlis;DRUGELIŲ;28930740067;Taip;0;0;1;1
8835;Sakalėlis;DRUGELIŲ;15950016412;Ne;0;0;2;2
8836;Sakalėlis;DRUGELIŲ;87950904971;Taip;0;0;1;1
8837;Sakalėlis;DRUGELIŲ;44702801581;Taip;4;0;0;4
8838;Sakalėlis;DRUGELIŲ;1075787529;Taip;0;0;5;5
8839;Sakalėlis;DRUGELIŲ;1421038685;Taip;0;3;0;3
8840;Sakalėlis;DRUGELIŲ;2124748537;Taip;0;5;0;5
8841;Sakalėlis;DRUGELIŲ;1538847469;Taip;0;0;5;5
8842;Sakalėlis;DRUGELIŲ;9634589602;Taip;1;0;1;2
8843;Sakalėlis;DRUGELIŲ;4583569438;Taip;0;0;6;6
8844;Sakalėlis;DRUGELIŲ;23064985127;Taip;5;0;3;8
8845;Sakalėlis;GENIUKŲ;4763858893;Taip;0;0;16;16
8846;Sakalėlis;GENIUKŲ;3337299648;Taip;9;0;3;12
8847;Sakalėlis;GENIUKŲ;43677485606;Taip;0;10;0;10
8848;Sakalėlis;GENIUKŲ;8649226611;Taip;0;0;3;3
8849;Sakalėlis;GENIUKŲ;5717022080;Taip;8;0;0;8
8850;Sakalėlis;GENIUKŲ;1027765680;Taip;0;2;0;2
8851;Sakalėlis;GENIUKŲ;96053733139;Taip;0;1;0;1
8852;Sakalėlis;GENIUKŲ;4612388683;Taip;0;12;0;12
8853;Sakalėlis;GENIUKŲ;7159705304;Taip;4;0;0;4
8854;Sakalėlis;GENIUKŲ;4775685174;Taip;7;0;0;7
8855;Sakalėlis;GENIUKŲ;69916351348;Taip;8;0;0;8
8856;Sakalėlis;GENIUKŲ;6727251397;Taip;6;10;0;16
8857;Sakalėlis;GENIUKŲ;1552929452;Taip;9;0;0;9
8858;Sakalėlis;GENIUKŲ;8936933971;Ne;0;1;13;14
8859;Sakalėlis;GENIUKŲ;3371763993;Taip;0;0;1;1
8860;Sakalėlis;GENIUKŲ;7085108710;Taip;11;0;0;11
8861;Sakalėlis;VOVERIUKŲ;4430763418;Taip;0;5;0;5
8862;Sakalėlis;VOVERIUKŲ;6190741162;Ne;0;0;1;1
8863;Sakalėlis;VOVERIUKŲ;1702964714;Ne;6;0;4;10
8864;Sakalėlis;VOVERIUKŲ;1839096675;Ne;0;0;6;6
8865;Sakalėlis;VOVERIUKŲ;1946531018;Taip;3;0;1;4
8866;Sakalėlis;VOVERIUKŲ;2796230671;Taip;0;0;3;3
8867;Sakalėlis;VOVERIUKŲ;1210451022;Taip;0;0;5;5
8868;Sakalėlis;VOVERIUKŲ;8662137531;Taip;0;7;0;7
8869;Sakalėlis;VOVERIUKŲ;1104881142;Taip;0;1;0;1
8870;Sakalėlis;VOVERIUKŲ;46629941288;Taip;3;0;0;3
8871;Sakalėlis;VOVERIUKŲ;3678172501;Taip;0;7;0;7
8872;Sakalėlis;VOVERIUKŲ;1133377117;Taip;0;0;2;2
8873;Sakalėlis;VOVERIUKŲ;34464485043;Ne;6;0;1;7
8874;Sakalėlis;VOVERIUKŲ;30987215315;Taip;0;0;1;1
8875;Sakalėlis;VOVERIUKŲ;7567476424;Taip;0;0;1;1
8876;Sakalėlis;VOVERIUKŲ;6180987643;Taip;9;0;2;11
8877;Sakalėlis;VOVERIUKŲ;9693949103;Taip;0;0;1;1
8878;Sakalėlis;VOVERIUKŲ;8852001037;Taip;0;0;5;5
8879;Sakalėlis;PĖLEDŽIUKŲ;1974955778;Taip;0;0;3;3
8880;Sakalėlis;PĖLEDŽIUKŲ;69254656227;Ne;5;0;0;5
8881;Sakalėlis;PĖLEDŽIUKŲ;4573623341;Taip;0;0;11;11
8882;Sakalėlis;PĖLEDŽIUKŲ;1359444361;Taip;0;0;2;2
8883;Sakalėlis;PĖLEDŽIUKŲ;3781188811;Taip;0;0;2;2
8884;Sakalėlis;PĖLEDŽIUKŲ;58113060986;Taip;7;0;0;7
8885;Sakalėlis;PĖLEDŽIUKŲ;89579043958;Taip;13;1;0;14
8886;Sakalėlis;PĖLEDŽIUKŲ;54902207576;Taip;2;0;2;4
8887;Sakalėlis;PĖLEDŽIUKŲ;81593611262;Taip;5;0;3;8
8888;Sakalėlis;PĖLEDŽIUKŲ;33825546706;Taip;1;2;0;3
8889;Sakalėlis;PĖLEDŽIUKŲ;1790571847;Taip;4;0;1;5
8890;Sakalėlis;PĖLEDŽIUKŲ;81361557297;Taip;13;0;7;20
8891;Sakalėlis;PĖLEDŽIUKŲ;39504139934;Taip;0;0;5;5
8892;Sakalėlis;PĖLEDŽIUKŲ;2134118895;Taip;0;0;5;5
8893;Sakalėlis;PĖLEDŽIUKŲ;67193921335;Taip;6;0;0;6
8894;Sakalėlis;PĖLEDŽIUKŲ;6301366135;Taip;0;0;1;1
8895;Sakalėlis;PĖLEDŽIUKŲ;37201848270;Taip;0;0;1;1
8896;Sakalėlis;PĖLEDŽIUKŲ;36670171187;Taip;9;0;0;9
8897;Sakalėlis;PĖLEDŽIUKŲ;4364341933;Taip;0;0;7;7
8898;Sakalėlis;PĖLEDŽIUKŲ;79413947806;Taip;5;1;3;9
8899;Sakalėlis;"BITUČIŲ (LOGOPEDINĖ)";4649447372;Taip;15;0;0;15
8900;Sakalėlis;"BITUČIŲ (LOGOPEDINĖ)";1219441890;Taip;3;0;1;4
8901;Sakalėlis;"BITUČIŲ (LOGOPEDINĖ)";16884257622;Taip;0;0;3;3
8902;Sakalėlis;"BITUČIŲ (LOGOPEDINĖ)";4716949191;Taip;2;0;0;2
8903;Sakalėlis;"BITUČIŲ (LOGOPEDINĖ)";7241416465;Ne;0;0;3;3
8904;Sakalėlis;"BITUČIŲ (LOGOPEDINĖ)";4857211754;Taip;5;0;2;7
8905;Sakalėlis;"BITUČIŲ (LOGOPEDINĖ)";8610668395;Taip;7;0;3;10
8906;Sakalėlis;"BITUČIŲ (LOGOPEDINĖ)";5377250664;Ne;5;0;2;7
8907;Sakalėlis;"BITUČIŲ (LOGOPEDINĖ)";1384225025;Ne;4;0;6;10
8908;Sakalėlis;"BITUČIŲ (LOGOPEDINĖ)";46481555688;Taip;0;0;8;8
8909;Sakalėlis;"BITUČIŲ (LOGOPEDINĖ)";5018151097;Taip;4;0;6;10
8910;Sakalėlis;"BORUŽIUKŲ (LOGOPEDINĖ)";68146506860;Taip;7;0;0;7
8911;Sakalėlis;"BORUŽIUKŲ (LOGOPEDINĖ)";92557587855;Taip;4;0;4;8
8912;Sakalėlis;"BORUŽIUKŲ (LOGOPEDINĖ)";1765370689;Ne;0;0;1;1
8913;Sakalėlis;"BORUŽIUKŲ (LOGOPEDINĖ)";70791762492;Taip;0;0;3;3
8914;Sakalėlis;"BORUŽIUKŲ (LOGOPEDINĖ)";9452901338;Taip;0;2;0;2
8915;Sakalėlis;"BORUŽIUKŲ (LOGOPEDINĖ)";1288160341;Ne;10;0;0;10
8916;Sakalėlis;"BORUŽIUKŲ (LOGOPEDINĖ)";4514546151;Ne;7;2;2;11
8917;Sakalėlis;"BORUŽIUKŲ (LOGOPEDINĖ)";50037388220;Taip;0;2;0;2
8918;Sakalėlis;"BORUŽIUKŲ (LOGOPEDINĖ)";9740003273;Taip;0;0;2;2
8919;Sakalėlis;"BORUŽIUKŲ (LOGOPEDINĖ)";2074868084;Taip;10;0;0;10
8920;Sakalėlis;MEŠKUČIŲ;8422299669;Taip;11;0;1;12
8921;Sakalėlis;MEŠKUČIŲ;4136266629;Taip;2;0;0;2
8922;Sakalėlis;MEŠKUČIŲ;6840368824;Taip;0;0;4;4
8923;Sakalėlis;MEŠKUČIŲ;6250400609;Taip;5;0;3;8
8924;Sakalėlis;MEŠKUČIŲ;3927487265;Taip;0;0;2;2
8925;Sakalėlis;MEŠKUČIŲ;5233697077;Taip;7;0;1;8
8926;Sakalėlis;MEŠKUČIŲ;3680732318;Ne;0;7;0;7
8927;Sakalėlis;MEŠKUČIŲ;4862004373;Ne;16;0;0;16
8928;Sakalėlis;MEŠKUČIŲ;6579827280;Taip;6;5;0;11
8929;Sakalėlis;MEŠKUČIŲ;6806170544;Taip;0;7;1;8
8930;Sakalėlis;MEŠKUČIŲ;8381310908;Taip;0;10;5;15
8931;Sakalėlis;MEŠKUČIŲ;7285833058;Taip;6;0;2;8
8932;Sakalėlis;MEŠKUČIŲ;2985239904;Taip;0;0;8;8
8933;Sakalėlis;MEŠKUČIŲ;3351218789;Ne;2;0;2;4
8934;Sakalėlis;MEŠKUČIŲ;4986131090;Taip;0;5;2;7
8935;Sakalėlis;MEŠKUČIŲ;3927363997;Taip;8;3;0;11
8936;Sakalėlis;MEŠKUČIŲ;9120873899;Ne;13;0;3;16
8937;Sakalėlis;KIŠKUČIŲ;1806698668;Ne;0;0;3;3
8938;Sakalėlis;KIŠKUČIŲ;2898006208;Taip;0;0;1;1
8939;Sakalėlis;KIŠKUČIŲ;1201086815;Ne;0;0;5;5
8940;Sakalėlis;KIŠKUČIŲ;9416737436;Taip;4;0;0;4
8941;Sakalėlis;KIŠKUČIŲ;4918228191;Taip;0;0;4;4
8942;Sakalėlis;KIŠKUČIŲ;9272347788;Taip;2;0;0;2
8943;Sakalėlis;KIŠKUČIŲ;1117800518;Taip;17;0;0;17
8944;Sakalėlis;KIŠKUČIŲ;6515519140;Taip;0;1;0;1
8945;Sakalėlis;KIŠKUČIŲ;6586215199;Taip;0;6;0;6
8946;Sakalėlis;KIŠKUČIŲ;8095359035;Taip;6;1;0;7
8947;Sakalėlis;KIŠKUČIŲ;5911341542;Taip;0;4;1;5
8948;Sakalėlis;KIŠKUČIŲ;8331612396;Taip;4;0;4;8
8949;Sakalėlis;KIŠKUČIŲ;7542322748;Taip;3;0;0;3
8950;Sakalėlis;KIŠKUČIŲ;3934295338;Taip;4;0;4;8
8951;Sakalėlis;SVIRPLIUKŲ;3574956316;Taip;0;4;2;6
8952;Sakalėlis;SVIRPLIUKŲ;7602249339;Taip;16;0;0;16
8953;Sakalėlis;SVIRPLIUKŲ;1403384561;Taip;5;0;2;7
8954;Sakalėlis;SVIRPLIUKŲ;1953356983;Taip;14;0;0;14
8955;Sakalėlis;SVIRPLIUKŲ;4358313171;Taip;8;0;0;8
8956;Sakalėlis;SVIRPLIUKŲ;6414564366;Taip;13;0;0;13
8957;Sakalėlis;SVIRPLIUKŲ;1833573491;Taip;4;0;2;6
8958;Sakalėlis;SVIRPLIUKŲ;7165739418;Ne;0;0;5;5
8959;Sakalėlis;SVIRPLIUKŲ;1736303381;Ne;0;0;1;1
8960;Sakalėlis;SVIRPLIUKŲ;2531146677;Ne;13;0;0;13
8961;Sakalėlis;SVIRPLIUKŲ;8133985842;Taip;8;0;1;9
8962;Sakalėlis;SVIRPLIUKŲ;7280513854;Taip;10;0;0;10
8963;Sakalėlis;SVIRPLIUKŲ;6778987483;Taip;0;1;7;8
8964;Sakalėlis;SVIRPLIUKŲ;2699844937;Taip;0;2;0;2
8965;Salininkų;BORUŽIUKAI;2467926286;Ne;2;0;1;3
8966;Salininkų;BORUŽIUKAI;8774984357;Taip;3;0;0;3
8967;Salininkų;BORUŽIUKAI;6577237672;Taip;3;0;0;3
8968;Salininkų;BORUŽIUKAI;6125152143;Ne;0;0;1;1
8969;Salininkų;BORUŽIUKAI;6551489987;Taip;4;2;0;6
8970;Salininkų;BORUŽIUKAI;6979816464;Ne;0;0;1;1
8971;Salininkų;BORUŽIUKAI;5582091833;Taip;0;4;0;4
8972;Salininkų;BORUŽIUKAI;9996809930;Taip;2;0;6;8
8973;Salininkų;BORUŽIUKAI;4480303856;Taip;6;0;0;6
8974;Salininkų;BORUŽIUKAI;3915336062;Ne;22;0;0;22
8975;Salininkų;BORUŽIUKAI;2073939432;Ne;0;0;1;1
8976;Salininkų;BORUŽIUKAI;3252151974;Taip;7;0;4;11
8977;Salininkų;BORUŽIUKAI;7639362434;Taip;2;0;2;4
8978;Salininkų;GĖLYTĖS;3015863723;Taip;22;0;0;22
8979;Salininkų;GĖLYTĖS;3323233525;Taip;22;0;0;22
8980;Salininkų;GĖLYTĖS;1832393272;Taip;0;2;0;2
8981;Salininkų;GĖLYTĖS;7665409499;Taip;0;0;2;2
8982;Salininkų;GĖLYTĖS;9890660815;Ne;0;0;5;5
8983;Salininkų;GĖLYTĖS;6850925495;Taip;0;5;0;5
8984;Salininkų;GĖLYTĖS;3585435095;Taip;10;0;0;10
8985;Salininkų;GĖLYTĖS;2760231414;Taip;4;12;0;16
8986;Salininkų;GĖLYTĖS;1658695150;Taip;5;0;4;9
8987;Salininkų;GĖLYTĖS;7383557807;Taip;5;4;0;9
8988;Salininkų;GĖLYTĖS;9344614003;Ne;5;4;0;9
8989;Salininkų;GĖLYTĖS;2808778763;Ne;3;7;0;10
8990;Salininkų;GĖLYTĖS;6656578271;Ne;8;3;0;11
8991;Salininkų;GĖLYTĖS;8995565864;Taip;18;2;0;20
8992;Salininkų;GĖLYTĖS;8394582546;Taip;0;6;0;6
8993;Salininkų;GĖLYTĖS;6327046935;Ne;3;2;0;5
8994;Salininkų;GĖLYTĖS;4323257798;Taip;0;2;0;2
8995;Salininkų;GĖLYTĖS;5427013789;Taip;0;2;0;2
8996;Salininkų;GĖLYTĖS;3100499807;Taip;0;2;0;2
8997;Salininkų;GĖLYTĖS;7782972361;Taip;5;5;0;10
8998;Salininkų;GĖLYTĖS;5867676844;Taip;0;0;10;10
8999;Salininkų;GĖLYTĖS;7737045952;Taip;6;0;0;6
9000;Salininkų;DRUGELIAI;1910467994;Ne;0;2;0;2
9001;Salininkų;DRUGELIAI;14626363996;Ne;4;0;0;4
9002;Salininkų;DRUGELIAI;1948988168;Ne;5;0;1;6
9003;Salininkų;DRUGELIAI;5434294777;Taip;0;0;2;2
9004;Salininkų;DRUGELIAI;8157811781;Taip;12;2;0;14
9005;Salininkų;DRUGELIAI;1963139815;Taip;9;0;0;9
9006;Salininkų;DRUGELIAI;45194646218;Taip;0;8;0;8
9007;Salininkų;DRUGELIAI;6301139299;Ne;0;4;0;4
9008;Salininkų;DRUGELIAI;6125334614;Ne;0;2;0;2
9009;Salininkų;DRUGELIAI;1568780329;Ne;10;3;0;13
9010;Salininkų;DRUGELIAI;30123603107;Ne;0;0;2;2
9011;Salininkų;DRUGELIAI;8410624264;Taip;4;6;0;10
9012;Salininkų;ŽIRNIUKAI;5063792784;Taip;0;0;2;2
9013;Salininkų;ŽIRNIUKAI;22167560908;Taip;0;7;0;7
9014;Salininkų;ŽIRNIUKAI;2292919406;Taip;6;4;0;10
9015;Salininkų;ŽIRNIUKAI;10335028421;Taip;4;12;0;16
9016;Salininkų;ŽIRNIUKAI;8488127476;Ne;0;0;1;1
9017;Salininkų;ŽIRNIUKAI;1723241116;Taip;8;0;1;9
9018;Salininkų;ŽIRNIUKAI;46867660097;Taip;7;4;0;11
9019;Salininkų;ŽIRNIUKAI;4269202761;Taip;8;0;1;9
9020;Salininkų;ŽIRNIUKAI;3692008687;Taip;9;4;0;13
9021;Salininkų;ŽIRNIUKAI;1065549119;Taip;0;0;4;4
9022;Salininkų;ŽIRNIUKAI;1460694577;Taip;4;0;0;4
9023;Salininkų;PAUKŠČIUKAI;1202154135;Ne;0;0;1;1
9024;Salininkų;PAUKŠČIUKAI;23990693770;Ne;0;0;3;3
9025;Salininkų;PAUKŠČIUKAI;67593920224;Ne;0;5;0;5
9026;Salininkų;PAUKŠČIUKAI;1470744233;Ne;0;7;0;7
9027;Salininkų;PAUKŠČIUKAI;52499970010;Ne;7;0;4;11
9028;Salininkų;PAUKŠČIUKAI;18178857793;Taip;0;8;0;8
9029;Salininkų;PAUKŠČIUKAI;1439852031;Ne;0;7;0;7
9030;Salininkų;PAUKŠČIUKAI;20609963605;Ne;2;0;4;6
9031;Salininkų;PAUKŠČIUKAI;29341671329;Ne;0;6;0;6
9032;Salininkų;PAUKŠČIUKAI;16967442608;Taip;0;2;0;2
9033;Salininkų;PAUKŠČIUKAI;7918995181;Taip;9;6;1;16
9034;Salininkų;PAUKŠČIUKAI;1544346282;Ne;0;2;0;2
9035;Salvija;Daigelis(šatil);3424917706;Ne;6;2;0;8
9036;Salvija;Daigelis(šatil);4152602039;Taip;0;0;4;4
9037;Salvija;Daigelis(šatil);3856351749;Taip;13;0;1;14
9038;Salvija;Daigelis(šatil);1791922219;Taip;5;0;0;5
9039;Salvija;Daigelis(šatil);1653831148;Taip;6;0;0;6
9040;Salvija;Daigelis(šatil);8013023311;Taip;0;1;0;1
9041;Salvija;Daigelis(šatil);8023422294;Taip;5;0;17;22
9042;Salvija;Daigelis(šatil);8981331532;Taip;4;0;8;12
9043;Salvija;Daigelis(šatil);8306404275;Taip;0;0;20;20
9044;Salvija;Daigelis(šatil);8158680641;Taip;4;3;0;7
9045;Salvija;Daigelis(šatil);3487446998;Taip;12;0;0;12
9046;Salvija;Daigelis(šatil);1062662192;Taip;12;0;0;12
9047;Salvija;Daigelis(šatil);6706565915;Taip;16;0;0;16
9048;Salvija;Daigelis(šatil);5723168506;Ne;11;1;0;12
9049;Salvija;Daigelis(šatil);4373711097;Taip;0;0;5;5
9050;Salvija;Daigelis(šatil);7477171133;Taip;0;0;8;8
9051;Salvija;Daigelis(šatil);8853389268;Ne;5;6;0;11
9052;Salvija;Daigelis(šatil);7862619996;Taip;0;0;3;3
9053;Salvija;"Pienė (savjon)";22615390885;Taip;0;0;1;1
9054;Salvija;"Pienė (savjon)";9168718017;Taip;9;0;5;14
9055;Salvija;"Pienė (savjon)";1641242817;Taip;0;6;0;6
9056;Salvija;"Pienė (savjon)";58888784609;Taip;5;7;0;12
9057;Salvija;"Pienė (savjon)";3331501534;Taip;0;3;0;3
9058;Salvija;"Pienė (savjon)";5494438837;Taip;0;0;2;2
9059;Salvija;"Pienė (savjon)";8798739147;Taip;10;4;0;14
9060;Salvija;"Pienė (savjon)";1103379012;Taip;6;0;0;6
9061;Salvija;"Pienė (savjon)";62121799666;Taip;4;1;0;5
9062;Salvija;"Pienė (savjon)";95774147903;Taip;0;0;1;1
9063;Salvija;"Pienė (savjon)";7361435128;Taip;5;0;1;6
9064;Salvija;"Pienė (savjon)";1777783229;Taip;4;5;0;9
9065;Salvija;"Pienė (savjon)";1478775998;Taip;8;0;1;9
9066;Salvija;"Pienė (savjon)";8802891478;Ne;0;0;4;4
9067;Salvija;"Pienė (savjon)";24038366791;Taip;2;0;0;2
9068;Salvija;"Pienė (savjon)";5784594015;Taip;0;0;1;1
9069;Salvija;"Pienė (savjon)";1517130961;Ne;0;0;2;2
9070;Salvija;"Pienė (savjon)";8725965215;Taip;0;0;1;1
9071;Salvija;"Pienė (savjon)";9908473681;Taip;0;0;2;2
9072;Saulėtekis;BERŽELIS;37001834066;Taip;5;0;0;5
9073;Saulėtekis;BERŽELIS;29935189464;Ne;0;8;0;8
9074;Saulėtekis;BERŽELIS;49102885577;Taip;0;7;0;7
9075;Saulėtekis;BERŽELIS;18801492293;Taip;0;0;7;7
9076;Saulėtekis;BERŽELIS;43809213927;Taip;1;0;0;1
9077;Saulėtekis;BERŽELIS;17046444483;Taip;0;0;2;2
9078;Saulėtekis;BERŽELIS;14357681543;Taip;0;0;5;5
9079;Saulėtekis;BERŽELIS;27109020149;Taip;0;1;0;1
9080;Saulėtekis;BERŽELIS;42952333477;Taip;6;4;0;10
9081;Saulėtekis;BERŽELIS;88165168902;Taip;0;4;0;4
9082;Saulėtekis;BERŽELIS;19786161536;Taip;6;1;0;7
9083;Saulėtekis;BERŽELIS;49746307178;Taip;0;0;2;2
9084;Saulėtekis;BERŽELIS;9632257866;Taip;0;0;2;2
9085;Saulėtekis;BERŽELIS;24403133622;Taip;0;4;0;4
9086;Saulėtekis;BERŽELIS;7440287746;Taip;7;0;0;7
9087;Saulėtekis;BERŽELIS;1502304241;Ne;0;6;0;6
9088;Saulėtekis;BERŽELIS;19209281962;Taip;0;0;5;5
9089;Saulėtekis;BERŽELIS;2096996257;Ne;8;0;1;9
9090;Saulėtekis;ŠYPSENA;1720125332;Taip;7;0;0;7
9091;Saulėtekis;ŠYPSENA;9972687066;Ne;17;0;0;17
9092;Saulėtekis;ŠYPSENA;7346852524;Taip;7;0;0;7
9093;Saulėtekis;ŠYPSENA;1902333363;Taip;8;0;0;8
9094;Saulėtekis;ŠYPSENA;6072030240;Taip;0;0;1;1
9095;Saulėtekis;ŠYPSENA;7893982893;Taip;8;0;0;8
9096;Saulėtekis;ŠYPSENA;7505040675;Taip;6;0;3;9
9097;Saulėtekis;ŠYPSENA;6501250875;Taip;0;0;3;3
9098;Saulėtekis;ŠYPSENA;9791926936;Taip;4;0;12;16
9099;Saulėtekis;ŠYPSENA;8620689981;Taip;5;0;1;6
9100;Saulėtekis;ŠYPSENA;8143793642;Taip;1;2;0;3
9101;Saulėtekis;ŠYPSENA;4909850069;Taip;11;0;0;11
9102;Saulėtekis;ŠYPSENA;7673965242;Taip;18;0;0;18
9103;Saulėtekis;ŠYPSENA;3166959569;Taip;5;0;4;9
9104;Saulėtekis;ŠYPSENA;9661075465;Taip;0;1;0;1
9105;Saulėtekis;ŠYPSENA;2154590089;Ne;0;5;0;5
9106;Saulėtekis;ŠYPSENA;9383567339;Taip;0;8;3;11
9107;Saulėtekis;ŠYPSENA;4610536784;Taip;1;1;0;2
9108;Saulėtekis;NYKŠTUKAI;81074197598;Taip;0;6;0;6
9109;Saulėtekis;NYKŠTUKAI;87539304992;Taip;0;2;0;2
9110;Saulėtekis;NYKŠTUKAI;75818502835;Taip;10;0;0;10
9111;Saulėtekis;NYKŠTUKAI;1623791240;Taip;0;9;0;9
9112;Saulėtekis;NYKŠTUKAI;46936348504;Taip;0;5;0;5
9113;Saulėtekis;NYKŠTUKAI;47570401883;Taip;10;0;0;10
9114;Saulėtekis;NYKŠTUKAI;40443812162;Taip;5;2;0;7
9115;Saulėtekis;NYKŠTUKAI;1288313734;Taip;1;0;0;1
9116;Saulėtekis;NYKŠTUKAI;9333073549;Taip;0;9;0;9
9117;Saulėtekis;NYKŠTUKAI;75785868657;Ne;0;11;0;11
9118;Saulėtekis;NYKŠTUKAI;1445753431;Ne;0;8;0;8
9119;Saulėtekis;NYKŠTUKAI;1064355395;Taip;0;5;0;5
9120;Saulėtekis;NYKŠTUKAI;1691667254;Taip;0;13;0;13
9121;Saulėtekis;NYKŠTUKAI;1466627555;Ne;0;11;0;11
9122;Saulėtekis;NYKŠTUKAI;29552225924;Taip;0;9;0;9
9123;Saulėtekis;NYKŠTUKAI;1111323783;Taip;0;12;0;12
9124;Saulėtekis;NYKŠTUKAI;21569877958;Taip;0;11;0;11
9125;Saulėtekis;NYKŠTUKAI;1673236492;Taip;5;4;0;9
9126;Saulėtekis;NYKŠTUKAI;5104259667;Taip;0;10;0;10
9127;Saulėtekis;PAGRANDUKAS;8102360466;Taip;11;0;0;11
9128;Saulėtekis;PAGRANDUKAS;2371396923;Taip;5;0;0;5
9129;Saulėtekis;PAGRANDUKAS;4152255439;Taip;6;7;1;14
9130;Saulėtekis;PAGRANDUKAS;2209156661;Taip;0;0;3;3
9131;Saulėtekis;PAGRANDUKAS;3220993253;Taip;10;5;0;15
9132;Saulėtekis;PAGRANDUKAS;5552614092;Taip;0;7;0;7
9133;Saulėtekis;PAGRANDUKAS;9497129509;Ne;18;0;0;18
9134;Saulėtekis;PAGRANDUKAS;9918219913;Taip;15;0;0;15
9135;Saulėtekis;PAGRANDUKAS;8517049464;Taip;10;0;1;11
9136;Saulėtekis;PAGRANDUKAS;7186085219;Taip;11;0;0;11
9137;Saulėtekis;PAGRANDUKAS;1020209414;Taip;11;0;0;11
9138;Saulėtekis;PAGRANDUKAS;2728836108;Taip;0;4;0;4
9139;Saulėtekis;PAGRANDUKAS;8390615573;Ne;8;0;3;11
9140;Saulėtekis;PAGRANDUKAS;2698535938;Taip;6;0;1;7
9141;Saulėtekis;PAGRANDUKAS;2656659133;Ne;9;9;0;18
9142;Saulėtekis;PAGRANDUKAS;7164579375;Ne;0;4;0;4
9143;Saulėtekis;PAGRANDUKAS;5678858566;Taip;8;0;2;10
9144;Saulėtekis;PAGRANDUKAS;4101644021;Taip;0;9;0;9
9145;Saulėtekis;PAGRANDUKAS;3366064429;Taip;11;0;0;11
9146;Saulėtekis;PAGRANDUKAS;8574702901;Ne;13;0;1;14
9147;Saulėtekis;RAMUNĖLIŲ;70948000188;Taip;2;0;0;2
9148;Saulėtekis;RAMUNĖLIŲ;23797246535;Taip;2;9;0;11
9149;Saulėtekis;RAMUNĖLIŲ;16450627896;Taip;7;0;0;7
9150;Saulėtekis;RAMUNĖLIŲ;60662699125;Taip;10;0;0;10
9151;Saulėtekis;RAMUNĖLIŲ;31291807930;Ne;10;1;0;11
9152;Saulėtekis;RAMUNĖLIŲ;86593254070;Taip;0;1;1;2
9153;Saulėtekis;RAMUNĖLIŲ;10524532865;Taip;3;5;0;8
9154;Saulėtekis;RAMUNĖLIŲ;80037388013;Taip;0;1;0;1
9155;Saulėtekis;RAMUNĖLIŲ;1219435678;Taip;6;3;0;9
9156;Saulėtekis;RAMUNĖLIŲ;29662148323;Taip;7;0;0;7
9157;Saulėtekis;RAMUNĖLIŲ;3394231244;Taip;15;0;1;16
9158;Saulėtekis;RAMUNĖLIŲ;7544912614;Taip;0;2;0;2
9159;Saulėtekis;RAMUNĖLIŲ;1349303787;Ne;12;1;2;15
9160;Saulėtekis;RAMUNĖLIŲ;1103824875;Taip;2;0;0;2
9161;Saulėtekis;PASAKAITĖ;8033763960;Taip;7;0;0;7
9162;Saulėtekis;PASAKAITĖ;5086871001;Taip;16;0;0;16
9163;Saulėtekis;PASAKAITĖ;4681031693;Taip;6;0;0;6
9164;Saulėtekis;PASAKAITĖ;2446282019;Taip;12;0;2;14
9165;Saulėtekis;PASAKAITĖ;8572701238;Taip;9;0;5;14
9166;Saulėtekis;PASAKAITĖ;6979741482;Taip;13;0;0;13
9167;Saulėtekis;PASAKAITĖ;6063956790;Taip;5;0;5;10
9168;Saulėtekis;PASAKAITĖ;4437540996;Taip;18;0;0;18
9169;Saulėtekis;PASAKAITĖ;7407451018;Taip;12;0;0;12
9170;Saulėtekis;PASAKAITĖ;9226317303;Taip;7;0;3;10
9171;Saulėtekis;PASAKAITĖ;9267790598;Ne;0;0;4;4
9172;Saulėtekis;PASAKAITĖ;6670590135;Ne;14;0;0;14
9173;Saulėtekis;PASAKAITĖ;6720758829;Taip;10;0;0;10
9174;Saulėtekis;PASAKAITĖ;7966714585;Taip;7;0;0;7
9175;Saulėtekis;PASAKAITĖ;6784471792;Taip;2;6;0;8
9176;Saulėtekis;PASAKAITĖ;4427383755;Taip;10;0;0;10
9177;Saulėtekis;PASAKAITĖ;1547117566;Taip;10;0;0;10
9178;Saulėtekis;VARPELIAI;94326821425;Taip;17;0;0;17
9179;Saulėtekis;VARPELIAI;6984530386;Taip;4;0;1;5
9180;Saulėtekis;VARPELIAI;1339984127;Taip;0;0;2;2
9181;Saulėtekis;VARPELIAI;68563453302;Taip;4;0;0;4
9182;Saulėtekis;VARPELIAI;77901730057;Taip;0;3;0;3
9183;Saulėtekis;VARPELIAI;74713390994;Taip;2;9;1;12
9184;Saulėtekis;VARPELIAI;43127755042;Taip;0;10;2;12
9185;Saulėtekis;VARPELIAI;1154284625;Taip;10;0;0;10
9186;Saulėtekis;VARPELIAI;1335149249;Taip;9;0;0;9
9187;Saulėtekis;VARPELIAI;1108321396;Taip;0;0;2;2
9188;Saulėtekis;VARPELIAI;891603633;Taip;0;0;3;3
9189;Saulėtekis;VARPELIAI;36605502570;Taip;0;0;2;2
9190;Saulėtekis;VARPELIAI;2075281680;Taip;3;3;7;13
9191;Saulėtekis;VARPELIAI;1213567219;Ne;9;0;0;9
9192;Saulėtekis;VARPELIAI;61118132521;Ne;0;0;1;1
9193;Saulėtekis;VARPELIAI;6671771491;Taip;7;0;0;7
9194;Saulėtekis;VARPELIAI;8752857993;Ne;10;0;0;10
9195;Saulėtekis;VARPELIAI;2641849320;Ne;11;0;0;11
9196;Saulėtekis;GRŪDELIS;20794781914;Ne;13;0;0;13
9197;Saulėtekis;GRŪDELIS;9132383069;Taip;10;0;1;11
9198;Saulėtekis;GRŪDELIS;67951758325;Ne;14;0;0;14
9199;Saulėtekis;GRŪDELIS;70230805151;Taip;5;0;4;9
9200;Saulėtekis;GRŪDELIS;41775536104;Taip;8;4;0;12
9201;Saulėtekis;GRŪDELIS;12954283491;Taip;8;0;1;9
9202;Saulėtekis;GRŪDELIS;21376960952;Ne;6;0;2;8
9203;Saulėtekis;GRŪDELIS;4027823257;Ne;11;0;0;11
9204;Saulėtekis;GRŪDELIS;86804497954;Taip;1;0;3;4
9205;Saulėtekis;GRŪDELIS;1180197203;Ne;15;0;1;16
9206;Saulėtekis;GRŪDELIS;1066191639;Taip;6;0;1;7
9207;Saulėtekis;GRŪDELIS;22570044589;Taip;0;0;11;11
9208;Saulėtekis;GRŪDELIS;1865278537;Taip;0;2;0;2
9209;Saulėtekis;GRŪDELIS;20534872540;Taip;5;0;0;5
9210;Saulėtekis;GRŪDELIS;53906058088;Taip;3;0;0;3
9211;Saulėtekis;GRŪDELIS;1456140823;Ne;5;0;1;6
9212;Saulėtekis;GRŪDELIS;49053923177;Taip;0;8;2;10
9213;Saulėtekis;JONVABALIS;5003645081;Taip;14;0;1;15
9214;Saulėtekis;JONVABALIS;1715634399;Ne;9;1;0;10
9215;Saulėtekis;JONVABALIS;1897872021;Taip;13;0;0;13
9216;Saulėtekis;JONVABALIS;1010906684;Taip;12;0;0;12
9217;Saulėtekis;JONVABALIS;97037457833;Taip;9;1;0;10
9218;Saulėtekis;JONVABALIS;7227802003;Taip;1;0;0;1
9219;Saulėtekis;JONVABALIS;84492261206;Taip;12;2;0;14
9220;Saulėtekis;JONVABALIS;72559769416;Taip;7;1;0;8
9221;Saulėtekis;JONVABALIS;1611009868;Ne;17;0;0;17
9222;Saulėtekis;JONVABALIS;4613040294;Taip;16;0;0;16
9223;Saulėtekis;JONVABALIS;1655720839;Taip;10;0;0;10
9224;Saulėtekis;JONVABALIS;5249014111;Taip;19;0;0;19
9225;Saulėtekis;JONVABALIS;2101902207;Taip;0;5;0;5
9226;Saulėtekis;JONVABALIS;3166181835;Taip;10;1;0;11
9227;Saulėtekis;JONVABALIS;6599452886;Taip;8;0;12;20
9228;Saulėtekis;JONVABALIS;8896065807;Taip;18;0;0;18
9229;Saulėtekis;JONVABALIS;1702638461;Taip;18;2;0;20
9230;Saulėtekis;JONVABALIS;3207128776;Ne;5;0;0;5
9231;Saulėtekis;JONVABALIS;2311184444;Taip;3;4;0;7
9232;Saulėtekis;JONVABALIS;1267706132;Ne;14;0;0;14
9233;Saulėtekis;SMALSUČIAI;40877542045;Taip;0;0;6;6
9234;Saulėtekis;SMALSUČIAI;9095968376;Taip;0;0;19;19
9235;Saulėtekis;SMALSUČIAI;86524549051;Taip;0;0;5;5
9236;Saulėtekis;SMALSUČIAI;7030227903;Taip;0;0;1;1
9237;Saulėtekis;SMALSUČIAI;81118611780;Taip;7;0;1;8
9238;Saulėtekis;SMALSUČIAI;32771808648;Taip;0;0;1;1
9239;Saulėtekis;SMALSUČIAI;38762730531;Ne;3;3;0;6
9240;Saulėtekis;SMALSUČIAI;1808644850;Taip;17;2;0;19
9241;Saulėtekis;SMALSUČIAI;1642031589;Taip;3;5;6;14
9242;Saulėtekis;SMALSUČIAI;1568300232;Ne;0;0;3;3
9243;Saulėtekis;SMALSUČIAI;97771948184;Taip;14;0;1;15
9244;Saulėtekis;SMALSUČIAI;7621094096;Taip;14;0;4;18
9245;Saulėtekis;SMALSUČIAI;13451381485;Taip;0;9;0;9
9246;Saulėtekis;SMALSUČIAI;1619134034;Taip;5;3;1;9
9247;Saulėtekis;SMALSUČIAI;32658647272;Taip;13;0;1;14
9248;Saulėtekis;SMALSUČIAI;92060861583;Taip;5;0;3;8
9249;Saulėtekis;SMALSUČIAI;4180984076;Taip;8;0;0;8
9250;Saulėtekis;BITUTĖS;7766084857;Taip;3;0;0;3
9251;Saulėtekis;BITUTĖS;4537254306;Taip;11;0;0;11
9252;Saulėtekis;BITUTĖS;60462712074;Taip;18;0;0;18
9253;Saulėtekis;BITUTĖS;1699576940;Taip;8;0;0;8
9254;Saulėtekis;BITUTĖS;9945647968;Taip;16;0;0;16
9255;Saulėtekis;BITUTĖS;1962914764;Taip;12;0;1;13
9256;Saulėtekis;BITUTĖS;1481503733;Taip;6;0;1;7
9257;Saulėtekis;BITUTĖS;8302260087;Taip;8;0;1;9
9258;Saulėtekis;BITUTĖS;2593106154;Taip;0;0;2;2
9259;Saulėtekis;BITUTĖS;2813949848;Taip;15;0;0;15
9260;Saulėtekis;BITUTĖS;6643388548;Taip;4;1;0;5
9261;Saulėtekis;BITUTĖS;3058991890;Taip;5;0;0;5
9262;Saulėtekis;BITUTĖS;9983577817;Taip;6;0;1;7
9263;Saulėtekis;BITUTĖS;7986712728;Taip;10;2;0;12
9264;Saulėtekis;BITUTĖS;6087170055;Taip;5;0;0;5
9265;Saulėtekis;BITUTĖS;7027103276;Taip;10;7;0;17
9266;Saulėtekis;BITUTĖS;7758268674;Taip;9;0;0;9
9267;Saulėtekis;BITUTĖS;2077976415;Ne;3;0;3;6
9268;Saulėtekis;BITUTĖS;9605052795;Taip;13;0;0;13
9269;Saulėtekis;BITUTĖS;7075757274;Taip;12;5;0;17
9270;Saulėtekis;BITUTĖS;2639872637;Taip;0;0;1;1
9271;Saulėtekis;RIEŠUTĖLIAI;3337160930;Taip;4;5;2;11
9272;Saulėtekis;RIEŠUTĖLIAI;2021901593;Taip;7;0;0;7
9273;Saulėtekis;RIEŠUTĖLIAI;7842280836;Taip;8;0;0;8
9274;Saulėtekis;RIEŠUTĖLIAI;2407911405;Taip;0;0;1;1
9275;Saulėtekis;RIEŠUTĖLIAI;6102064617;Taip;3;0;1;4
9276;Saulėtekis;RIEŠUTĖLIAI;2238947856;Taip;6;0;2;8
9277;Saulėtekis;RIEŠUTĖLIAI;84982517658;Taip;5;0;0;5
9278;Saulėtekis;RIEŠUTĖLIAI;3541535891;Taip;7;0;2;9
9279;Saulėtekis;RIEŠUTĖLIAI;8231869593;Taip;5;0;0;5
9280;Saulėtekis;RIEŠUTĖLIAI;36003078842;Taip;0;5;0;5
9281;Saulėtekis;RIEŠUTĖLIAI;4663268649;Taip;8;1;0;9
9282;Saulėtekis;RIEŠUTĖLIAI;25199011812;Taip;8;0;0;8
9283;Saulėtekis;RIEŠUTĖLIAI;81153273188;Taip;4;6;0;10
9284;Saulėtekis;RIEŠUTĖLIAI;7051608858;Taip;12;0;0;12
9285;Saulėtekis;RIEŠUTĖLIAI;9634949452;Taip;3;0;0;3
9286;Saulėtekis;RIEŠUTĖLIAI;4338502152;Taip;0;3;0;3
9287;Saulėtekis;RIEŠUTĖLIAI;8002806189;Taip;5;6;0;11
9288;Saulėtekis;RIEŠUTĖLIAI;9657195627;Taip;14;0;0;14
9289;Saulėtekis;RIEŠUTĖLIAI;1209960122;Taip;3;0;0;3
9290;Skroblinukas;SVIRPLIUKŲ;56496090956;Ne;0;0;9;9
9291;Skroblinukas;SVIRPLIUKŲ;27948464942;Taip;5;0;1;6
9292;Skroblinukas;SVIRPLIUKŲ;92096423589;Taip;0;6;0;6
9293;Skroblinukas;SVIRPLIUKŲ;5992090518;Taip;5;0;0;5
9294;Skroblinukas;SVIRPLIUKŲ;69303322030;Taip;3;0;0;3
9295;Skroblinukas;SVIRPLIUKŲ;2034869306;Taip;6;0;1;7
9296;Skroblinukas;SVIRPLIUKŲ;2020866728;Ne;5;2;3;10
9297;Skroblinukas;SVIRPLIUKŲ;1059137398;Taip;10;0;2;12
9298;Skroblinukas;SVIRPLIUKŲ;91070212533;Taip;0;4;0;4
9299;Skroblinukas;SVIRPLIUKŲ;60291417607;Taip;0;13;0;13
9300;Skroblinukas;SVIRPLIUKŲ;31484348317;Taip;3;6;0;9
9301;Skroblinukas;SVIRPLIUKŲ;88601994922;Taip;0;11;0;11
9302;Skroblinukas;SVIRPLIUKŲ;72829437831;Taip;7;1;0;8
9303;Skroblinukas;SVIRPLIUKŲ;1364608720;Taip;0;5;0;5
9304;Skroblinukas;SVIRPLIUKŲ;31670763980;Taip;0;0;1;1
9305;Skroblinukas;SVIRPLIUKŲ;89356084678;Ne;0;7;0;7
9306;Skroblinukas;SVIRPLIUKŲ;30925721180;Taip;5;2;0;7
9307;Skroblinukas;SVIRPLIUKŲ;87902801288;Taip;2;1;1;4
9308;Skroblinukas;SVIRPLIUKŲ;1462404838;Ne;0;5;0;5
9309;Skroblinukas;SVIRPLIUKŲ;23551272822;Ne;1;1;0;2
9310;Skroblinukas;SVIRPLIUKŲ;2105394649;Taip;5;1;2;8
9311;Skroblinukas;GANDRIUKŲ;2197158518;Taip;2;0;0;2
9312;Skroblinukas;GANDRIUKŲ;2097758483;Taip;0;11;0;11
9313;Skroblinukas;GANDRIUKŲ;7921251819;Taip;0;13;3;16
9314;Skroblinukas;GANDRIUKŲ;9045708140;Taip;4;5;0;9
9315;Skroblinukas;GANDRIUKŲ;2406619611;Taip;4;0;0;4
9316;Skroblinukas;GANDRIUKŲ;9572912046;Taip;0;16;2;18
9317;Skroblinukas;GANDRIUKŲ;5646847921;Taip;2;0;0;2
9318;Skroblinukas;GANDRIUKŲ;9377215921;Taip;9;4;0;13
9319;Skroblinukas;GANDRIUKŲ;6266609965;Taip;7;3;0;10
9320;Skroblinukas;GANDRIUKŲ;6235844690;Taip;0;10;0;10
9321;Skroblinukas;GANDRIUKŲ;6489976163;Taip;8;1;0;9
9322;Skroblinukas;GANDRIUKŲ;1159546580;Taip;0;7;1;8
9323;Skroblinukas;GANDRIUKŲ;4571530482;Taip;4;0;1;5
9324;Skroblinukas;GANDRIUKŲ;2310750833;Taip;0;2;1;3
9325;Skroblinukas;GANDRIUKŲ;9888115079;Taip;0;15;1;16
9326;Skroblinukas;GANDRIUKŲ;9475514959;Ne;0;7;0;7
9327;Skroblinukas;GANDRIUKŲ;9031598603;Taip;0;0;2;2
9328;Skroblinukas;VYTURIUKŲ;40320573258;Ne;0;0;2;2
9329;Skroblinukas;VYTURIUKŲ;94897926442;Ne;0;0;4;4
9330;Skroblinukas;VYTURIUKŲ;7416993749;Ne;0;0;4;4
9331;Skroblinukas;VYTURIUKŲ;30982591733;Taip;3;0;0;3
9332;Skroblinukas;VYTURIUKŲ;1935381164;Taip;4;0;0;4
9333;Skroblinukas;VYTURIUKŲ;58000101216;Taip;0;6;11;17
9334;Skroblinukas;VYTURIUKŲ;72528180087;Taip;0;0;5;5
9335;Skroblinukas;VYTURIUKŲ;40602768192;Taip;0;4;1;5
9336;Skroblinukas;VYTURIUKŲ;3226377926;Ne;11;0;2;13
9337;Skroblinukas;VYTURIUKŲ;1175660577;Taip;17;0;1;18
9338;Skroblinukas;VYTURIUKŲ;1446835893;Taip;0;11;3;14
9339;Skroblinukas;VYTURIUKŲ;1710559060;Taip;12;0;0;12
9340;Skroblinukas;VYTURIUKŲ;21862553841;Ne;8;3;0;11
9341;Skroblinukas;VYTURIUKŲ;1611685585;Ne;7;3;0;10
9342;Skroblinukas;VYTURIUKŲ;1631945330;Ne;0;0;7;7
9343;Skroblinukas;VYTURIUKŲ;42252673755;Taip;0;14;0;14
9344;Skroblinukas;VYTURIUKŲ;7896922448;Taip;0;6;0;6
9345;Skroblinukas;VYTURIUKŲ;91409992058;Taip;0;0;3;3
9346;Skroblinukas;GENIUKŲ;48655837755;Taip;0;1;0;1
9347;Skroblinukas;GENIUKŲ;4393041946;Taip;0;22;0;22
9348;Skroblinukas;GENIUKŲ;2323980730;Taip;10;0;0;10
9349;Skroblinukas;GENIUKŲ;1325903217;Taip;4;5;0;9
9350;Skroblinukas;GENIUKŲ;8380073853;Taip;14;0;3;17
9351;Skroblinukas;GENIUKŲ;4436698905;Taip;0;7;0;7
9352;Skroblinukas;GENIUKŲ;1905085978;Taip;0;0;1;1
9353;Skroblinukas;GENIUKŲ;1557733803;Taip;0;14;0;14
9354;Skroblinukas;GENIUKŲ;9433465007;Taip;12;0;0;12
9355;Skroblinukas;GENIUKŲ;1395950886;Ne;6;0;0;6
9356;Skroblinukas;GENIUKŲ;9777300890;Taip;9;0;1;10
9357;Skroblinukas;GENIUKŲ;1696303051;Taip;5;0;0;5
9358;Skroblinukas;GENIUKŲ;9846569195;Taip;10;0;0;10
9359;Skroblinukas;GENIUKŲ;3746278003;Taip;17;0;0;17
9360;Skroblinukas;GENIUKŲ;4773576465;Ne;7;0;3;10
9361;Skroblinukas;GENIUKŲ;2704157855;Taip;11;0;1;12
9362;Skroblinukas;GENIUKŲ;9564385215;Taip;0;0;5;5
9363;Skroblinukas;GENIUKŲ;6129591146;Taip;0;2;0;2
9364;Skroblinukas;GENIUKŲ;3128337104;Taip;4;0;0;4
9365;Skroblinukas;GENIUKŲ;4272941994;Taip;0;0;1;1
9366;Skroblinukas;BITUČIŲ;1255323441;Taip;0;1;3;4
9367;Skroblinukas;BITUČIŲ;1934804499;Taip;5;3;0;8
9368;Skroblinukas;BITUČIŲ;2134821488;Taip;5;2;0;7
9369;Skroblinukas;BITUČIŲ;2071447940;Taip;22;0;0;22
9370;Skroblinukas;BITUČIŲ;6604496585;Ne;0;7;0;7
9371;Skroblinukas;BITUČIŲ;3736883850;Taip;4;0;0;4
9372;Skroblinukas;BITUČIŲ;7191689856;Taip;0;6;0;6
9373;Skroblinukas;BITUČIŲ;2032621707;Taip;4;0;0;4
9374;Skroblinukas;BITUČIŲ;8618587013;Taip;0;1;5;6
9375;Skroblinukas;BITUČIŲ;9594078223;Ne;0;1;0;1
9376;Skroblinukas;BITUČIŲ;9075266818;Ne;12;1;0;13
9377;Skroblinukas;BITUČIŲ;1432694920;Taip;0;9;0;9
9378;Skroblinukas;BITUČIŲ;1967305501;Taip;0;5;5;10
9379;Skroblinukas;BITUČIŲ;1688990637;Taip;9;0;0;9
9380;Skroblinukas;BITUČIŲ;1957488412;Taip;0;1;3;4
9381;Skroblinukas;BITUČIŲ;1000804920;Taip;8;1;0;9
9382;Skroblinukas;BITUČIŲ;1711568129;Taip;0;7;1;8
9383;Skroblinukas;BORUŽĖLIŲ;5665463557;Taip;16;0;0;16
9384;Skroblinukas;BORUŽĖLIŲ;3292517112;Taip;5;0;0;5
9385;Skroblinukas;BORUŽĖLIŲ;2481980627;Taip;0;4;1;5
9386;Skroblinukas;BORUŽĖLIŲ;3512297435;Taip;0;1;2;3
9387;Skroblinukas;BORUŽĖLIŲ;3594000419;Taip;0;1;2;3
9388;Skroblinukas;BORUŽĖLIŲ;2978284436;Taip;0;0;1;1
9389;Skroblinukas;BORUŽĖLIŲ;6293879765;Taip;0;0;3;3
9390;Skroblinukas;BORUŽĖLIŲ;9725125130;Taip;4;0;1;5
9391;Skroblinukas;BORUŽĖLIŲ;8946940285;Taip;4;1;0;5
9392;Skroblinukas;BORUŽĖLIŲ;3461165182;Taip;0;0;7;7
9393;Skroblinukas;BORUŽĖLIŲ;6433636135;Taip;9;6;3;18
9394;Skroblinukas;BORUŽĖLIŲ;7068452970;Taip;7;0;1;8
9395;Skroblinukas;BORUŽĖLIŲ;9985033530;Taip;6;0;7;13
9396;Skroblinukas;SKRUZDĖLIUKŲ;9634311146;Taip;0;2;0;2
9397;Skroblinukas;SKRUZDĖLIUKŲ;5688453546;Taip;0;2;1;3
9398;Skroblinukas;SKRUZDĖLIUKŲ;6890306112;Taip;0;5;0;5
9399;Skroblinukas;SKRUZDĖLIUKŲ;6445065388;Ne;5;6;0;11
9400;Skroblinukas;SKRUZDĖLIUKŲ;3006521657;Taip;0;3;0;3
9401;Skroblinukas;SKRUZDĖLIUKŲ;9448253468;Taip;7;0;1;8
9402;Skroblinukas;SKRUZDĖLIUKŲ;3771045336;Ne;0;9;0;9
9403;Skroblinukas;SKRUZDĖLIUKŲ;4424763028;Taip;5;4;0;9
9404;Skroblinukas;SKRUZDĖLIUKŲ;9353353289;Taip;6;2;0;8
9405;Skroblinukas;SKRUZDĖLIUKŲ;2883593274;Ne;0;1;0;1
9406;Skroblinukas;SKRUZDĖLIUKŲ;5157913924;Taip;0;7;0;7
9407;Skroblinukas;SKRUZDĖLIUKŲ;9958188318;Taip;2;4;0;6
9408;Skroblinukas;SKRUZDĖLIUKŲ;8576448571;Taip;4;9;0;13
9409;Skroblinukas;SKRUZDĖLIUKŲ;1002570367;Taip;0;2;1;3
9410;Skroblinukas;SKRUZDĖLIUKŲ;9813249677;Taip;12;4;0;16
9411;Skroblinukas;SKRUZDĖLIUKŲ;2706526326;Taip;5;0;0;5
9412;Skroblinukas;SKRUZDĖLIUKŲ;5915278745;Taip;0;2;0;2
9413;Skroblinukas;SKRUZDĖLIUKŲ;6640062847;Taip;0;4;0;4
9414;Skroblinukas;ŽVIRBLIUKŲ;4989544273;Ne;12;0;5;17
9415;Skroblinukas;ŽVIRBLIUKŲ;3271736540;Taip;0;11;1;12
9416;Skroblinukas;ŽVIRBLIUKŲ;3065235192;Taip;8;7;0;15
9417;Skroblinukas;ŽVIRBLIUKŲ;5902713448;Ne;8;1;0;9
9418;Skroblinukas;ŽVIRBLIUKŲ;7480611069;Taip;0;0;6;6
9419;Skroblinukas;ŽVIRBLIUKŲ;2071093890;Taip;0;1;3;4
9420;Skroblinukas;ŽVIRBLIUKŲ;6879979868;Taip;0;2;1;3
9421;Skroblinukas;ŽVIRBLIUKŲ;3954228349;Taip;13;0;1;14
9422;Skroblinukas;ŽVIRBLIUKŲ;4560580022;Taip;0;5;2;7
9423;Skroblinukas;ŽVIRBLIUKŲ;8206063106;Taip;7;0;5;12
9424;Skroblinukas;ŽVIRBLIUKŲ;3532258904;Taip;11;0;2;13
9425;Skroblinukas;ŽVIRBLIUKŲ;9553242594;Taip;0;5;0;5
9426;Skroblinukas;ŽVIRBLIUKŲ;2948231687;Taip;0;0;11;11
9427;Skroblinukas;ŽIOGELIŲ;9629502585;Taip;2;3;0;5
9428;Skroblinukas;ŽIOGELIŲ;8283516422;Taip;10;0;0;10
9429;Skroblinukas;ŽIOGELIŲ;1449037968;Taip;0;7;0;7
9430;Skroblinukas;ŽIOGELIŲ;9828486832;Taip;0;0;2;2
9431;Skroblinukas;ŽIOGELIŲ;1924714755;Taip;14;0;0;14
9432;Skroblinukas;ŽIOGELIŲ;8064713969;Taip;6;0;1;7
9433;Skroblinukas;ŽIOGELIŲ;8622930871;Taip;0;8;0;8
9434;Skroblinukas;ŽIOGELIŲ;4266945644;Taip;9;0;1;10
9435;Skroblinukas;ŽIOGELIŲ;7675772872;Taip;0;0;3;3
9436;Skroblinukas;ŽIOGELIŲ;7761972818;Taip;8;0;0;8
9437;Skroblinukas;ŽIOGELIŲ;8286842648;Taip;18;0;0;18
9438;Skroblinukas;ŽIOGELIŲ;6461678336;Taip;7;0;0;7
9439;Skroblinukas;ŽIOGELIŲ;7216760382;Taip;17;0;0;17
9440;Skroblinukas;ŽIOGELIŲ;5154111867;Taip;0;2;0;2
9441;Skroblinukas;ŽIOGELIŲ;4861971439;Taip;11;0;2;13
9442;Skroblinukas;ŽIOGELIŲ;9003855190;Taip;9;6;0;15
9443;Skroblinukas;STRAZDELIŲ;5433647187;Taip;0;0;4;4
9444;Skroblinukas;STRAZDELIŲ;9915130747;Taip;5;4;0;9
9445;Skroblinukas;STRAZDELIŲ;1669610397;Taip;6;0;1;7
9446;Skroblinukas;STRAZDELIŲ;5566457656;Ne;3;7;0;10
9447;Skroblinukas;STRAZDELIŲ;8312341293;Taip;1;5;1;7
9448;Skroblinukas;STRAZDELIŲ;6254811026;Taip;14;0;2;16
9449;Skroblinukas;STRAZDELIŲ;2195112297;Taip;0;0;3;3
9450;Skroblinukas;STRAZDELIŲ;8958893525;Taip;3;4;0;7
9451;Skroblinukas;STRAZDELIŲ;7750501815;Taip;22;0;0;22
9452;Skroblinukas;STRAZDELIŲ;6574558658;Taip;5;10;0;15
9453;Skroblinukas;STRAZDELIŲ;4198512202;Taip;17;0;0;17
9454;Skroblinukas;STRAZDELIŲ;1544598440;Taip;9;5;0;14
9455;Skroblinukas;STRAZDELIŲ;4168542339;Taip;4;0;2;6
9456;Skroblinukas;DRUGELIŲ;1792672886;Taip;0;0;10;10
9457;Skroblinukas;DRUGELIŲ;1979723351;Ne;0;6;0;6
9458;Skroblinukas;DRUGELIŲ;1964529755;Taip;0;17;2;19
9459;Skroblinukas;DRUGELIŲ;86231564690;Taip;0;1;2;3
9460;Skroblinukas;DRUGELIŲ;23687553212;Taip;14;4;0;18
9461;Skroblinukas;DRUGELIŲ;4532268875;Taip;0;1;2;3
9462;Skroblinukas;DRUGELIŲ;86542450905;Ne;13;0;5;18
9463;Skroblinukas;DRUGELIŲ;54750454175;Taip;0;0;1;1
9464;Skroblinukas;DRUGELIŲ;3636028890;Taip;13;0;2;15
9465;Skroblinukas;DRUGELIŲ;2079452635;Taip;10;0;0;10
9466;Skroblinukas;DRUGELIŲ;1510927547;Taip;5;0;2;7
9467;Skroblinukas;DRUGELIŲ;2325940694;Taip;0;12;0;12
9468;Skroblinukas;DRUGELIŲ;5068339590;Taip;13;1;0;14
9469;Skroblinukas;DRUGELIŲ;3580045988;Taip;4;4;0;8
9470;Skroblinukas;DRUGELIŲ;1005726705;Taip;6;0;0;6
9471;Skroblinukas;DRUGELIŲ;1388763405;Taip;0;8;0;8
9472;Skroblinukas;DRUGELIŲ;1791669956;Taip;0;1;0;1
9473;Skroblinukas;DRUGELIŲ;7184817010;Taip;0;0;7;7
9474;Skroblinukas;DRUGELIŲ;1109895463;Ne;0;6;0;6
9475;Skroblinukas;DRUGELIŲ;60061213883;Taip;10;1;2;13
9476;Skroblinukas;DRUGELIŲ;2116630768;Taip;0;10;1;11
9477;Skroblinukas;DRUGELIŲ;18955401411;Taip;0;0;8;8
9478;Skroblinukas;PELĖDŽIUKŲ;5975039463;Taip;3;0;0;3
9479;Skroblinukas;PELĖDŽIUKŲ;63514584063;Taip;7;9;0;16
9480;Skroblinukas;PELĖDŽIUKŲ;1000422430;Ne;5;9;0;14
9481;Skroblinukas;PELĖDŽIUKŲ;1556675902;Taip;5;0;2;7
9482;Skroblinukas;PELĖDŽIUKŲ;7666122737;Taip;13;0;0;13
9483;Skroblinukas;PELĖDŽIUKŲ;3864043251;Taip;4;0;7;11
9484;Skroblinukas;PELĖDŽIUKŲ;1759830058;Taip;0;7;0;7
9485;Skroblinukas;PELĖDŽIUKŲ;1471842192;Taip;0;7;0;7
9486;Skroblinukas;PELĖDŽIUKŲ;1382981497;Taip;0;5;0;5
9487;Skroblinukas;PELĖDŽIUKŲ;29908502973;Taip;0;5;0;5
9488;Skroblinukas;PELĖDŽIUKŲ;1220311458;Taip;10;0;0;10
9489;Skroblinukas;PELĖDŽIUKŲ;95946607624;Ne;0;2;0;2
9490;Skroblinukas;PELĖDŽIUKŲ;8150037173;Taip;0;2;0;2
9491;Skroblinukas;PELĖDŽIUKŲ;1898486832;Taip;7;4;0;11
9492;Skroblinukas;PELĖDŽIUKŲ;4221501092;Taip;0;0;1;1
9493;Skroblinukas;PELĖDŽIUKŲ;1515227489;Ne;0;5;0;5
9494;Skroblinukas;PELĖDŽIUKŲ;76523308405;Ne;17;0;0;17
9495;Skroblinukas;PELĖDŽIUKŲ;1602978649;Taip;0;2;0;2
9496;Skroblinukas;PELĖDŽIUKŲ;1258044022;Taip;0;0;2;2
9497;Skroblinukas;PELĖDŽIUKŲ;4914479407;Taip;6;0;1;7
9498;Skroblinukas;PELĖDŽIUKŲ;1847074960;Taip;16;0;0;16
9499;Skroblinukas;PELĖDŽIUKŲ;87741312158;Taip;8;2;0;10
9500;Skroblinukas;PELĖDŽIUKŲ;3858891097;Taip;15;0;0;15
9501;Smalsučiai;Žibuoklės;27034024515;Ne;8;0;0;8
9502;Smalsučiai;Žibuoklės;68726523946;Ne;4;5;0;9
9503;Smalsučiai;Žibuoklės;85358131888;Taip;4;0;1;5
9504;Smalsučiai;Žibuoklės;4258713607;Taip;0;12;0;12
9505;Smalsučiai;Žibuoklės;40922293471;Taip;0;1;0;1
9506;Smalsučiai;Žibuoklės;83056178108;Taip;0;3;0;3
9507;Smalsučiai;Žibuoklės;1023262986;Ne;0;3;0;3
9508;Smalsučiai;Žibuoklės;83033796468;Taip;0;10;0;10
9509;Smalsučiai;Žibuoklės;62767756842;Taip;4;4;0;8
9510;Smalsučiai;Žibuoklės;2099765750;Taip;8;0;0;8
9511;Smalsučiai;Žibuoklės;9512217842;Taip;0;2;0;2
9512;Smalsučiai;Žibuoklės;56779125767;Taip;0;4;0;4
9513;Smalsučiai;Žibuoklės;97809921080;Taip;0;1;0;1
9514;Smalsučiai;Aitvarų;2638709634;Taip;0;1;0;1
9515;Smalsučiai;Aitvarų;8306946163;Taip;0;10;0;10
9516;Smalsučiai;Aitvarų;6469044880;Taip;8;2;0;10
9517;Smalsučiai;Aitvarų;8193410963;Ne;3;0;0;3
9518;Smalsučiai;Aitvarų;99467576480;Ne;3;0;0;3
9519;Smalsučiai;Aitvarų;2136420967;Taip;0;0;1;1
9520;Smalsučiai;Aitvarų;2059832436;Taip;0;3;0;3
9521;Smalsučiai;Aitvarų;4795138729;Taip;8;0;0;8
9522;Smalsučiai;Aitvarų;1997966082;Taip;0;1;0;1
9523;Smalsučiai;Aitvarų;1372591510;Taip;0;1;0;1
9524;Smalsučiai;Aitvarų;8810690546;Taip;5;6;0;11
9525;Smalsučiai;Aitvarų;1775539505;Taip;0;2;0;2
9526;Smalsučiai;Aitvarų;5761169841;Taip;0;0;4;4
9527;Smalsučiai;Aitvarų;4909226602;Taip;0;5;7;12
9528;Smalsučiai;Aitvarų;6536165801;Ne;15;0;0;15
9529;Smalsučiai;Aitvarų;3644256220;Taip;0;1;2;3
9530;Smalsučiai;Sraigiukų;48426272721;Taip;0;0;3;3
9531;Smalsučiai;Sraigiukų;26007606072;Taip;0;10;0;10
9532;Smalsučiai;Sraigiukų;31748074403;Taip;0;4;1;5
9533;Smalsučiai;Sraigiukų;55212746834;Taip;7;0;0;7
9534;Smalsučiai;Sraigiukų;67243805772;Ne;0;0;5;5
9535;Smalsučiai;Sraigiukų;1417945043;Ne;12;2;0;14
9536;Smalsučiai;Sraigiukų;70181610962;Ne;0;5;0;5
9537;Smalsučiai;Sraigiukų;71839472863;Taip;10;0;0;10
9538;Smalsučiai;Sraigiukų;95501158334;Taip;7;0;0;7
9539;Smalsučiai;Sraigiukų;1095159887;Taip;5;3;0;8
9540;Smalsučiai;Sraigiukų;1424532027;Ne;7;0;4;11
9541;Smalsučiai;Saulučių;4655599359;Taip;0;5;2;7
9542;Smalsučiai;Saulučių;2112871055;Taip;0;0;1;1
9543;Smalsučiai;Saulučių;50085798686;Ne;10;3;2;15
9544;Smalsučiai;Saulučių;4903800388;Taip;0;0;17;17
9545;Smalsučiai;Saulučių;52829213579;Taip;0;11;0;11
9546;Smalsučiai;Saulučių;1594035039;Taip;0;8;0;8
9547;Smalsučiai;Saulučių;8542926346;Taip;7;0;5;12
9548;Smalsučiai;Saulučių;4042979105;Taip;0;0;6;6
9549;Smalsučiai;Saulučių;1760728524;Taip;0;5;0;5
9550;Smalsučiai;Saulučių;28055409190;Taip;0;4;0;4
9551;Smalsučiai;Saulučių;1567576834;Ne;10;1;0;11
9552;Smalsučiai;Saulučių;1965194010;Taip;6;0;5;11
9553;Smalsučiai;Saulučių;1673246147;Taip;0;7;0;7
9554;Smalsučiai;Saulučių;62387945180;Taip;0;5;4;9
9555;Smalsučiai;Viščiukų;2802867649;Taip;0;1;0;1
9556;Smalsučiai;Viščiukų;66281706978;Taip;0;7;0;7
9557;Smalsučiai;Viščiukų;30592434971;Taip;5;0;3;8
9558;Smalsučiai;Viščiukų;18717627431;Taip;5;0;0;5
9559;Smalsučiai;Viščiukų;26787916874;Taip;0;0;1;1
9560;Smalsučiai;Viščiukų;63575906792;Taip;5;4;0;9
9561;Smalsučiai;Viščiukų;27727844778;Taip;1;2;2;5
9562;Smalsučiai;Viščiukų;1514166474;Taip;0;4;0;4
9563;Smalsučiai;Viščiukų;37702522563;Taip;0;4;0;4
9564;Smalsučiai;Viščiukų;95945382872;Taip;0;3;0;3
9565;Smalsučiai;Viščiukų;96002139110;Taip;0;4;0;4
9566;Smalsučiai;Viščiukų;55385713527;Taip;0;1;0;1
9567;Smalsučiai;Viščiukų;78496301809;Taip;0;1;0;1
9568;Smalsučiai;Viščiukų;92961881271;Taip;0;5;1;6
9569;Smalsučiai;Viščiukų;6264082741;Ne;0;7;0;7
9570;Smalsučiai;Boružėlių;1703679877;Taip;0;4;0;4
9571;Smalsučiai;Boružėlių;2208462326;Taip;0;10;0;10
9572;Smalsučiai;Boružėlių;6643253926;Taip;7;4;0;11
9573;Smalsučiai;Boružėlių;7226242747;Taip;3;0;1;4
9574;Smalsučiai;Boružėlių;6085020049;Ne;0;6;0;6
9575;Smalsučiai;Boružėlių;8340768848;Ne;0;0;2;2
9576;Smalsučiai;Boružėlių;69450514879;Ne;12;6;1;19
9577;Smalsučiai;Boružėlių;4740303929;Taip;0;4;0;4
9578;Smalsučiai;Boružėlių;3063127699;Taip;0;1;0;1
9579;Smalsučiai;Boružėlių;2737886714;Taip;0;2;0;2
9580;Smalsučiai;Boružėlių;4858914868;Taip;0;2;4;6
9581;Smalsučiai;Boružėlių;8523742213;Taip;22;0;0;22
9582;Smalsučiai;Zuikių;3792738445;Taip;10;0;1;11
9583;Smalsučiai;Zuikių;92129554371;Taip;0;4;0;4
9584;Smalsučiai;Zuikių;1830368274;Taip;0;0;9;9
9585;Smalsučiai;Zuikių;87920436781;Taip;0;1;0;1
9586;Smalsučiai;Zuikių;18980466605;Taip;0;2;0;2
9587;Smalsučiai;Zuikių;2057177596;Taip;0;0;6;6
9588;Smalsučiai;Nykštukų;2327930850;Taip;10;6;0;16
9589;Smalsučiai;Nykštukų;3787937467;Taip;0;14;0;14
9590;Smalsučiai;Nykštukų;4134975456;Taip;4;0;1;5
9591;Smalsučiai;Nykštukų;9155011285;Taip;0;13;0;13
9592;Smalsučiai;Nykštukų;4566816316;Taip;0;2;1;3
9593;Smalsučiai;Nykštukų;1471941426;Taip;3;2;0;5
9594;Smalsučiai;Nykštukų;1458544456;Taip;0;2;0;2
9595;Smalsučiai;Nykštukų;6469604093;Taip;10;0;0;10
9596;Smalsučiai;Nykštukų;6358800570;Taip;12;1;0;13
9597;Smalsučiai;Nykštukų;5184903287;Taip;4;0;0;4
9598;Smalsučiai;Nykštukų;7933302912;Taip;0;14;0;14
9599;Smalsučiai;Nykštukų;3757955200;Taip;9;0;0;9
9600;Smalsučiai;Nykštukų;5406430393;Taip;0;8;0;8
9601;Smalsučiai;Nykštukų;6899040199;Taip;10;5;0;15
9602;Smalsučiai;Nykštukų;4824786207;Taip;3;0;0;3
9603;Smalsučiai;Nykštukų;4629526320;Taip;9;0;0;9
9604;Smalsučiai;Nykštukų;9604182559;Taip;0;6;0;6
9605;Smalsučiai;Nykštukų;7396172351;Taip;0;1;0;1
9606;Smalsučiai;Katinėlių;2034528872;Ne;11;0;0;11
9607;Smalsučiai;Katinėlių;8259056296;Taip;0;0;10;10
9608;Smalsučiai;Katinėlių;9864518144;Taip;0;1;0;1
9609;Smalsučiai;Katinėlių;2958335372;Taip;0;2;0;2
9610;Smalsučiai;Katinėlių;7137550663;Taip;3;0;0;3
9611;Smalsučiai;Katinėlių;6090391818;Taip;14;1;0;15
9612;Smalsučiai;Katinėlių;6478152041;Ne;0;2;0;2
9613;Smalsučiai;Katinėlių;6006832443;Ne;4;8;0;12
9614;Smalsučiai;Katinėlių;8128348060;Taip;0;20;0;20
9615;Smalsučiai;Katinėlių;9637877396;Taip;19;0;0;19
9616;Smalsučiai;Katinėlių;8763382361;Taip;12;0;2;14
9617;Smalsučiai;Katinėlių;4425714802;Taip;0;2;8;10
9618;Smalsučiai;Katinėlių;9732075162;Taip;0;0;1;1
9619;Smalsučiai;Katinėlių;7023531176;Taip;0;0;1;1
9620;Smalsučiai;Katinėlių;4565479092;Taip;0;7;1;8
9621;Smalsučiai;Katinėlių;7256557310;Taip;7;7;0;14
9622;Smalsučiai;Katinėlių;3925021238;Ne;13;0;0;13
9623;Smalsučiai;PELĖDŽIUKAI;94734585174;Taip;0;2;0;2
9624;Smalsučiai;PELĖDŽIUKAI;25838645404;Taip;0;1;0;1
9625;Smalsučiai;PELĖDŽIUKAI;66154228179;Taip;0;0;2;2
9626;Smalsučiai;PELĖDŽIUKAI;99471280741;Taip;0;3;0;3
9627;Smalsučiai;PELĖDŽIUKAI;1276659532;Taip;0;8;0;8
9628;Smalsučiai;PELĖDŽIUKAI;513516143;Taip;0;2;4;6
9629;Smalsučiai;PELĖDŽIUKAI;47452987441;Taip;0;3;1;4
9630;Smalsučiai;PELĖDŽIUKAI;57622458673;Ne;0;1;0;1
9631;Smalsučiai;PELĖDŽIUKAI;73899364649;Taip;0;0;11;11
9632;Smalsučiai;PELĖDŽIUKAI;1575017231;Taip;0;2;0;2
9633;Smalsučiai;PELĖDŽIUKAI;6857124432;Taip;0;3;0;3
9634;Smalsučiai;PELĖDŽIUKAI;1653798728;Taip;0;1;0;1
9635;Smalsučiai;PELĖDŽIUKAI;59594678142;Taip;0;2;1;3
9636;Smalsučiai;Pingvinukai;4288788194;Taip;0;0;1;1
9637;Smalsučiai;Pingvinukai;6535494814;Taip;2;0;3;5
9638;Smalsučiai;Pingvinukai;3309134310;Taip;4;4;0;8
9639;Smalsučiai;Pingvinukai;5402027714;Taip;6;9;1;16
9640;Smalsučiai;Pingvinukai;2326167599;Taip;0;9;0;9
9641;Smalsučiai;Pingvinukai;4094037708;Taip;0;0;6;6
9642;Smalsučiai;Pingvinukai;5893045664;Taip;3;0;0;3
9643;Smalsučiai;Pingvinukai;5482692473;Taip;0;8;1;9
9644;Smalsučiai;Pingvinukai;4379372200;Taip;0;8;0;8
9645;Smalsučiai;Pingvinukai;7070240693;Ne;10;2;0;12
9646;Smalsučiai;Pingvinukai;7726086066;Taip;1;0;1;2
9647;Smalsučiai;Pingvinukai;1380214235;Taip;9;0;0;9
9648;Smalsučiai;Pingvinukai;8644849194;Ne;0;0;13;13
9649;Smalsučiai;Pingvinukai;3071594259;Taip;4;0;0;4
9650;Smalsučiai;Pingvinukai;7107126092;Taip;4;0;0;4
9651;Smalsučiai;Pingvinukai;3877274360;Taip;4;3;0;7
9652;Smalsučiai;Voverikų;7713078413;Taip;0;3;0;3
9653;Smalsučiai;Voverikų;3607226859;Taip;0;3;0;3
9654;Smalsučiai;Voverikų;22791221635;Taip;0;2;0;2
9655;Smalsučiai;Voverikų;7794541741;Taip;0;0;1;1
9656;Smalsučiai;Voverikų;1467603676;Ne;0;8;0;8
9657;Smalsučiai;Voverikų;1982046497;Taip;3;1;0;4
9658;Smalsučiai;Voverikų;1181574676;Taip;0;14;0;14
9659;Smalsučiai;Voverikų;1599488035;Taip;0;9;0;9
9660;Smalsučiai;Voverikų;6207026048;Taip;0;5;1;6
9661;Smalsučiai;Voverikų;19592364606;Taip;0;1;0;1
9662;Smalsučiai;Voverikų;5611487967;Taip;5;2;0;7
9663;Smalsučiai;Voverikų;8520753848;Ne;0;6;0;6
9664;Smalsučiai;Voverikų;4145769042;Ne;1;5;0;6
9665;Smalsučiai;Voverikų;4727475042;Taip;22;0;0;22
9666;Smalsučiai;Voverikų;6529889121;Taip;4;3;0;7
9667;Smalsučiai;Voverikų;3627324317;Taip;0;8;0;8
9668;Spindulėlis;SAULUTĖS;1394918021;Taip;6;0;0;6
9669;Spindulėlis;SAULUTĖS;6449284856;Taip;8;0;14;22
9670;Spindulėlis;SAULUTĖS;1180176295;Taip;0;1;2;3
9671;Spindulėlis;SAULUTĖS;1730248631;Ne;0;0;6;6
9672;Spindulėlis;SAULUTĖS;2234877411;Taip;8;0;0;8
9673;Spindulėlis;SAULUTĖS;4353031174;Ne;12;0;5;17
9674;Spindulėlis;SAULUTĖS;1424288192;Ne;3;0;0;3
9675;Spindulėlis;SAULUTĖS;1346035733;Taip;5;0;0;5
9676;Spindulėlis;SAULUTĖS;9903990297;Taip;0;0;1;1
9677;Spindulėlis;SAULUTĖS;4077985773;Taip;13;0;4;17
9678;Spindulėlis;SAULUTĖS;6592057292;Taip;13;0;3;16
9679;Spindulėlis;SAULUTĖS;2890377876;Taip;19;0;3;22
9680;Spindulėlis;SAULUTĖS;9511051386;Taip;17;0;0;17
9681;Spindulėlis;SAULUTĖS;5578151523;Taip;3;0;5;8
9682;Spindulėlis;SAULUTĖS;8141324449;Taip;19;0;0;19
9683;Spindulėlis;SAULUTĖS;9244494109;Taip;4;0;3;7
9684;Spindulėlis;SAULUTĖS;8923393066;Taip;14;0;3;17
9685;Spindulėlis;SAULUTĖS;5288557629;Taip;0;10;0;10
9686;Spindulėlis;SAULUTĖS;7099787230;Taip;9;5;0;14
9687;Spindulėlis;SAULUTĖS;4929866385;Taip;16;0;2;18
9688;Spindulėlis;SAULUTĖS;5233044803;Ne;6;10;0;16
9689;Spindulėlis;SAULUTĖS;3088386659;Taip;0;5;0;5
9690;Spindulėlis;DRUGELIAI;1528496272;Taip;5;0;0;5
9691;Spindulėlis;DRUGELIAI;2988630379;Taip;0;1;2;3
9692;Spindulėlis;DRUGELIAI;55250330957;Taip;0;0;2;2
9693;Spindulėlis;DRUGELIAI;80331157814;Ne;4;7;0;11
9694;Spindulėlis;DRUGELIAI;60956380679;Taip;9;0;0;9
9695;Spindulėlis;DRUGELIAI;2131409282;Taip;7;0;0;7
9696;Spindulėlis;DRUGELIAI;9348576749;Taip;0;0;5;5
9697;Spindulėlis;DRUGELIAI;63344816879;Taip;8;0;10;18
9698;Spindulėlis;DRUGELIAI;9145337789;Taip;7;0;4;11
9699;Spindulėlis;DRUGELIAI;96365393879;Taip;0;8;0;8
9700;Spindulėlis;DRUGELIAI;7757264510;Taip;0;0;2;2
9701;Spindulėlis;DRUGELIAI;5050019035;Taip;0;2;1;3
9702;Spindulėlis;DRUGELIAI;1821231102;Taip;10;0;0;10
9703;Spindulėlis;DRUGELIAI;1514479696;Taip;9;5;0;14
9704;Spindulėlis;DRUGELIAI;27408123487;Taip;0;18;0;18
9705;Spindulėlis;DRUGELIAI;1694423628;Taip;0;4;0;4
9706;Spindulėlis;DRUGELIAI;1679106754;Taip;4;6;0;10
9707;Spindulėlis;DRUGELIAI;72997461686;Taip;5;0;2;7
9708;Spindulėlis;DRUGELIAI;92417802345;Taip;0;5;0;5
9709;Spindulėlis;DRUGELIAI;4194714698;Taip;0;0;2;2
9710;Spindulėlis;DRUGELIAI;9977569249;Taip;11;0;1;12
9711;Spindulėlis;BITUTĖS;83785970474;Taip;6;0;0;6
9712;Spindulėlis;BITUTĖS;92803008887;Taip;0;4;0;4
9713;Spindulėlis;BITUTĖS;4539792030;Ne;7;0;0;7
9714;Spindulėlis;BITUTĖS;16045001090;Taip;5;4;0;9
9715;Spindulėlis;BITUTĖS;1399847362;Ne;13;0;0;13
9716;Spindulėlis;BITUTĖS;3986191435;Taip;0;0;4;4
9717;Spindulėlis;BITUTĖS;97661389553;Taip;0;1;1;2
9718;Spindulėlis;BITUTĖS;64339072411;Taip;8;0;0;8
9719;Spindulėlis;BITUTĖS;2137229669;Taip;0;0;3;3
9720;Spindulėlis;BITUTĖS;19541905006;Taip;4;0;0;4
9721;Spindulėlis;BITUTĖS;503164673;Taip;1;1;0;2
9722;Spindulėlis;BITUTĖS;27928352319;Taip;0;1;0;1
9723;Spindulėlis;BITUTĖS;18443825776;Taip;0;0;2;2
9724;Spindulėlis;BITUTĖS;1763306358;Taip;9;0;4;13
9725;Spindulėlis;BITUTĖS;27520164282;Taip;8;0;0;8
9726;Spindulėlis;BITUTĖS;29747353664;Taip;0;0;1;1
9727;Spindulėlis;BITUTĖS;1939526832;Taip;0;0;3;3
9728;Spindulėlis;VARPELIAI;7107337857;Taip;13;0;5;18
9729;Spindulėlis;VARPELIAI;8432194383;Taip;9;0;0;9
9730;Spindulėlis;VARPELIAI;7184471307;Taip;3;0;5;8
9731;Spindulėlis;VARPELIAI;4116151797;Taip;13;0;4;17
9732;Spindulėlis;VARPELIAI;3276656641;Taip;11;0;0;11
9733;Spindulėlis;VARPELIAI;8039086094;Taip;11;0;0;11
9734;Spindulėlis;VARPELIAI;3329587401;Ne;0;1;2;3
9735;Spindulėlis;VARPELIAI;6633031473;Taip;0;0;3;3
9736;Spindulėlis;VARPELIAI;6880075874;Taip;7;0;0;7
9737;Spindulėlis;VARPELIAI;4152722583;Taip;7;0;4;11
9738;Spindulėlis;VARPELIAI;8793327541;Taip;8;1;0;9
9739;Spindulėlis;VARPELIAI;6949857110;Taip;11;0;3;14
9740;Spindulėlis;VARPELIAI;2511267939;Ne;0;11;0;11
9741;Spindulėlis;VARPELIAI;4171789569;Taip;2;4;2;8
9742;Spindulėlis;VARPELIAI;1454039572;Taip;11;0;0;11
9743;Spindulėlis;VARPELIAI;9740815635;Ne;5;0;0;5
9744;Spindulėlis;VARPELIAI;4308169582;Taip;18;0;2;20
9745;Spragtukas;NYKŠTUKAI;4809829190;Taip;0;3;0;3
9746;Spragtukas;NYKŠTUKAI;4527798635;Taip;3;0;0;3
9747;Spragtukas;NYKŠTUKAI;8551195766;Taip;4;6;0;10
9748;Spragtukas;NYKŠTUKAI;8623311748;Taip;0;22;0;22
9749;Spragtukas;NYKŠTUKAI;9805841777;Taip;5;3;0;8
9750;Spragtukas;NYKŠTUKAI;2943832694;Taip;0;2;0;2
9751;Spragtukas;NYKŠTUKAI;8460527225;Taip;13;0;0;13
9752;Spragtukas;NYKŠTUKAI;8297700739;Taip;7;0;0;7
9753;Spragtukas;NYKŠTUKAI;9595221494;Ne;5;8;0;13
9754;Spragtukas;NYKŠTUKAI;6185016824;Taip;6;0;0;6
9755;Spragtukas;NYKŠTUKAI;8715073512;Taip;10;0;0;10
9756;Spragtukas;NYKŠTUKAI;6162830167;Taip;6;5;0;11
9757;Spragtukas;NYKŠTUKAI;1710184531;Taip;0;3;0;3
9758;Spragtukas;NYKŠTUKAI;2076126173;Taip;5;5;0;10
9759;Spragtukas;NYKŠTUKAI;3012345413;Taip;19;0;0;19
9760;Spragtukas;NYKŠTUKAI;8698492694;Taip;2;0;0;2
9761;Spragtukas;NYKŠTUKAI;1150002524;Taip;0;0;1;1
9762;Spragtukas;NYKŠTUKAI;8288793522;Taip;9;3;0;12
9763;Spragtukas;SAULUTĖ;89749837388;Ne;0;5;2;7
9764;Spragtukas;SAULUTĖ;3392224465;Taip;6;0;0;6
9765;Spragtukas;SAULUTĖ;1174566363;Ne;4;0;0;4
9766;Spragtukas;SAULUTĖ;10998123453;Taip;0;2;0;2
9767;Spragtukas;SAULUTĖ;48934106998;Ne;5;0;0;5
9768;Spragtukas;SAULUTĖ;34989165939;Ne;0;4;0;4
9769;Spragtukas;SAULUTĖ;1889153590;Taip;2;0;0;2
9770;Spragtukas;SAULUTĖ;50653432030;Taip;0;1;0;1
9771;Spragtukas;SAULUTĖ;63252513820;Taip;0;5;0;5
9772;Spragtukas;SAULUTĖ;4321780080;Taip;0;1;0;1
9773;Spragtukas;SAULUTĖ;51889437335;Taip;0;1;0;1
9774;Spragtukas;SAULUTĖ;7234682005;Taip;0;3;0;3
9775;Spragtukas;SAULUTĖ;80790750169;Taip;5;5;0;10
9776;Spragtukas;SAULUTĖ;96435499947;Taip;0;7;0;7
9777;Spragtukas;SAULUTĖ;91767288727;Taip;5;2;0;7
9778;Spragtukas;SAULUTĖ;94418271961;Taip;0;8;0;8
9779;Spragtukas;SAULUTĖ;5377198769;Taip;10;1;0;11
9780;Spragtukas;SAULUTĖ;14001343134;Taip;0;2;1;3
9781;Spragtukas;SPINDULĖLIAI;94650801877;Taip;1;0;1;2
9782;Spragtukas;SPINDULĖLIAI;4675031453;Taip;0;1;2;3
9783;Spragtukas;SPINDULĖLIAI;4004275398;Taip;0;3;0;3
9784;Spragtukas;SPINDULĖLIAI;9781727236;Taip;7;0;0;7
9785;Spragtukas;SPINDULĖLIAI;1029392579;Taip;0;8;1;9
9786;Spragtukas;SPINDULĖLIAI;1336973131;Taip;10;4;0;14
9787;Spragtukas;SPINDULĖLIAI;70413855110;Taip;15;3;0;18
9788;Spragtukas;SPINDULĖLIAI;47393966396;Taip;3;0;0;3
9789;Spragtukas;SPINDULĖLIAI;65692358082;Taip;5;0;0;5
9790;Spragtukas;SPINDULĖLIAI;1945068716;Taip;4;0;1;5
9791;Spragtukas;SPINDULĖLIAI;6052538605;Taip;0;8;0;8
9792;Spragtukas;SPINDULĖLIAI;2138152514;Taip;0;1;0;1
9793;Spragtukas;SPINDULĖLIAI;1305123801;Taip;0;1;0;1
9794;Spragtukas;SPINDULĖLIAI;4485715299;Taip;0;5;0;5
9795;Spragtukas;SPINDULĖLIAI;4224693184;Taip;0;0;4;4
9796;Spragtukas;SPINDULĖLIAI;81928765016;Taip;0;0;3;3
9797;Spragtukas;GINTARĖLIAI;1437794402;Taip;0;2;0;2
9798;Spragtukas;GINTARĖLIAI;37209001618;Taip;0;1;0;1
9799;Spragtukas;GINTARĖLIAI;15208696709;Taip;9;3;0;12
9800;Spragtukas;GINTARĖLIAI;82498261158;Taip;0;1;0;1
9801;Spragtukas;GINTARĖLIAI;32290835176;Taip;0;12;0;12
9802;Spragtukas;GINTARĖLIAI;68059396649;Ne;0;6;0;6
9803;Spragtukas;GINTARĖLIAI;1035579583;Taip;0;1;0;1
9804;Spragtukas;GINTARĖLIAI;8554047390;Taip;0;7;0;7
9805;Spragtukas;GINTARĖLIAI;69086864157;Ne;0;10;0;10
9806;Spragtukas;ČIPOLINO;2371848091;Taip;0;1;0;1
9807;Spragtukas;ČIPOLINO;6582680700;Taip;22;0;0;22
9808;Spragtukas;ČIPOLINO;1547670082;Ne;2;6;0;8
9809;Spragtukas;ČIPOLINO;1597988501;Taip;11;0;0;11
9810;Spragtukas;ČIPOLINO;6526633051;Taip;5;0;0;5
9811;Spragtukas;ČIPOLINO;1058970799;Taip;0;6;0;6
9812;Spragtukas;ČIPOLINO;45661532130;Taip;0;5;0;5
9813;Spragtukas;ČIPOLINO;7640805299;Taip;0;19;0;19
9814;Spragtukas;ČIPOLINO;2493749424;Taip;0;2;0;2
9815;Spragtukas;ČIPOLINO;1365907314;Taip;1;3;0;4
9816;Spragtukas;ČIPOLINO;4941531443;Taip;6;0;0;6
9817;Spragtukas;ČIPOLINO;3566797064;Taip;4;3;0;7
9818;Spragtukas;ČIPOLINO;2902550587;Taip;0;2;0;2
9819;Spragtukas;ČIPOLINO;1827458781;Taip;5;5;0;10
9820;Spragtukas;ČIPOLINO;3798118695;Taip;0;11;0;11
9821;Spragtukas;ČIPOLINO;69114720307;Taip;4;2;0;6
9822;Spragtukas;ČIPOLINO;9789977863;Taip;0;4;0;4
9823;Spragtukas;ČIPOLINO;1044112039;Ne;13;3;0;16
9824;Spragtukas;ČIPOLINO;5707084920;Taip;12;6;0;18
9825;Spragtukas;BORUŽĖLĖS;2356476212;Taip;5;5;0;10
9826;Spragtukas;BORUŽĖLĖS;8429135626;Taip;0;12;0;12
9827;Spragtukas;BORUŽĖLĖS;8287102733;Taip;0;16;0;16
9828;Spragtukas;BORUŽĖLĖS;5844437769;Ne;4;6;0;10
9829;Spragtukas;BORUŽĖLĖS;6584145176;Taip;0;3;0;3
9830;Spragtukas;BORUŽĖLĖS;8226921630;Taip;9;2;0;11
9831;Spragtukas;BORUŽĖLĖS;2946297529;Ne;0;13;0;13
9832;Spragtukas;BORUŽĖLĖS;9860876807;Taip;0;4;0;4
9833;Spragtukas;BORUŽĖLĖS;5633883897;Taip;7;2;0;9
9834;Spragtukas;BORUŽĖLĖS;1570206034;Taip;0;20;0;20
9835;Spragtukas;BORUŽĖLĖS;9965087132;Taip;7;3;0;10
9836;Spragtukas;BORUŽĖLĖS;7806145224;Taip;4;3;0;7
9837;Spragtukas;BORUŽĖLĖS;2909322678;Taip;0;4;0;4
9838;Spragtukas;BORUŽĖLĖS;5236797574;Taip;0;14;0;14
9839;Spragtukas;BORUŽĖLĖS;1306663967;Taip;5;11;0;16
9840;Spragtukas;BORUŽĖLĖS;4069044269;Taip;0;2;0;2
9841;Spragtukas;BORUŽĖLĖS;5150028968;Taip;8;2;0;10
9842;Spragtukas;BORUŽĖLĖS;9754594384;Ne;0;16;0;16
9843;Spragtukas;BORUŽĖLĖS;1756340613;Taip;12;1;0;13
9844;Spragtukas;DRUGELIAI;41147623084;Taip;8;4;0;12
9845;Spragtukas;DRUGELIAI;1138975383;Taip;0;2;0;2
9846;Spragtukas;DRUGELIAI;2118272247;Taip;0;16;0;16
9847;Spragtukas;DRUGELIAI;46794033116;Taip;7;0;1;8
9848;Spragtukas;DRUGELIAI;1418494757;Taip;0;0;2;2
9849;Spragtukas;DRUGELIAI;60980580078;Taip;10;3;0;13
9850;Spragtukas;DRUGELIAI;82801263312;Taip;2;0;0;2
9851;Spragtukas;DRUGELIAI;56384144331;Taip;0;1;1;2
9852;Spragtukas;DRUGELIAI;2032107153;Ne;7;0;1;8
9853;Spragtukas;DRUGELIAI;19580966465;Taip;0;1;2;3
9854;Spragtukas;DRUGELIAI;67679737675;Taip;4;0;0;4
9855;Spragtukas;DRUGELIAI;1953368351;Taip;3;0;0;3
9856;Spragtukas;DRUGELIAI;271958429;Taip;4;0;0;4
9857;Spragtukas;DRUGELIAI;1030688447;Taip;0;0;1;1
9858;Spragtukas;DRUGELIAI;99915428485;Taip;0;0;1;1
9859;Spragtukas;DRUGELIAI;22025568463;Ne;0;1;0;1
9860;Spragtukas;DRUGELIAI;1491147348;Taip;3;1;0;4
9861;Spragtukas;DRUGELIAI;20279570129;Ne;10;1;0;11
9862;Spragtukas;GAIDELIAI;7569802487;Taip;0;0;1;1
9863;Spragtukas;GAIDELIAI;71081903240;Taip;0;1;0;1
9864;Spragtukas;GAIDELIAI;79237309377;Taip;0;8;0;8
9865;Spragtukas;GAIDELIAI;54099559107;Taip;0;7;0;7
9866;Spragtukas;GAIDELIAI;19453957982;Taip;2;0;1;3
9867;Spragtukas;GAIDELIAI;1203266608;Taip;10;0;0;10
9868;Spragtukas;GAIDELIAI;11849369985;Taip;0;5;0;5
9869;Spragtukas;GAIDELIAI;2042294168;Taip;0;11;0;11
9870;Spragtukas;GAIDELIAI;1030566027;Taip;3;11;0;14
9871;Spragtukas;GAIDELIAI;8150653485;Taip;0;3;0;3
9872;Spragtukas;GAIDELIAI;1247838976;Taip;0;1;0;1
9873;Spragtukas;GAIDELIAI;2061441977;Taip;0;1;0;1
9874;Spragtukas;GAIDELIAI;9644808747;Taip;4;6;0;10
9875;Spragtukas;GAIDELIAI;78296815539;Taip;8;0;0;8
9876;Spragtukas;GAIDELIAI;4209118353;Taip;6;6;0;12
9877;Spragtukas;GAIDELIAI;6501930436;Taip;14;8;0;22
9878;Spragtukas;GAIDELIAI;1210698072;Taip;3;3;0;6
9879;Spragtukas;GAIDELIAI;1070119148;Taip;18;1;0;19
9880;Spragtukas;GAIDELIAI;9235972927;Taip;0;0;1;1
9881;Spragtukas;GAIDELIAI;2277960395;Taip;3;0;1;4
9882;Spragtukas;ŽUVELĖS;9078163633;Ne;18;0;0;18
9883;Spragtukas;ŽUVELĖS;8762832644;Ne;5;0;0;5
9884;Spragtukas;ŽUVELĖS;8652973900;Taip;4;5;0;9
9885;Spragtukas;ŽUVELĖS;3261213140;Taip;0;1;0;1
9886;Spragtukas;ŽUVELĖS;5689392663;Taip;0;1;2;3
9887;Spragtukas;ŽUVELĖS;9592271053;Taip;4;0;0;4
9888;Spragtukas;ŽUVELĖS;6465991136;Taip;0;1;0;1
9889;Spragtukas;ŽUVELĖS;9282940430;Taip;3;7;0;10
9890;Spragtukas;ŽUVELĖS;6503842956;Taip;0;1;0;1
9891;Spragtukas;ŽUVELĖS;6757604305;Taip;14;0;0;14
9892;Spragtukas;ŽUVELĖS;3139748724;Taip;11;0;0;11
9893;Spragtukas;ŽUVELĖS;8640877497;Taip;13;0;0;13
9894;Spragtukas;ŽUVELĖS;2025314314;Taip;0;0;1;1
9895;Spragtukas;ŽUVELĖS;4848647219;Taip;13;1;1;15
9896;Spragtukas;ŽUVELĖS;3491418162;Taip;7;1;0;8
9897;Spragtukas;ŽUVELĖS;5836788916;Taip;7;0;0;7
9898;Spragtukas;ŽUVELĖS;5704941595;Taip;9;6;0;15
9899;Spragtukas;ŽUVELĖS;3286456855;Taip;0;1;0;1
9900;Spragtukas;ŽUVELĖS;9662188102;Taip;9;1;0;10
9901;Spragtukas;ŽUVELĖS;2539660577;Ne;0;13;0;13
9902;Spragtukas;RIEŠUTĖLIAI;8444759709;Taip;0;15;0;15
9903;Spragtukas;RIEŠUTĖLIAI;8463747761;Taip;0;1;0;1
9904;Spragtukas;RIEŠUTĖLIAI;6800727630;Taip;0;1;0;1
9905;Spragtukas;RIEŠUTĖLIAI;1690400583;Taip;4;8;0;12
9906;Spragtukas;RIEŠUTĖLIAI;6419503965;Taip;0;16;0;16
9907;Spragtukas;RIEŠUTĖLIAI;8246512283;Ne;0;7;0;7
9908;Spragtukas;RIEŠUTĖLIAI;1627243902;Taip;12;2;0;14
9909;Spragtukas;RIEŠUTĖLIAI;1326603216;Taip;22;0;0;22
9910;Spragtukas;RIEŠUTĖLIAI;72636559695;Taip;8;1;0;9
9911;Spragtukas;RIEŠUTĖLIAI;6573750143;Taip;0;2;0;2
9912;Spragtukas;RIEŠUTĖLIAI;5306883933;Ne;0;1;0;1
9913;Spragtukas;RIEŠUTĖLIAI;3654640843;Taip;0;1;0;1
9914;Spragtukas;RIEŠUTĖLIAI;1849644444;Taip;4;11;0;15
9915;Spragtukas;RIEŠUTĖLIAI;9045185920;Taip;0;3;0;3
9916;Spragtukas;RIEŠUTĖLIAI;1800927281;Taip;0;2;1;3
9917;Spragtukas;RIEŠUTĖLIAI;1514277186;Taip;0;2;0;2
9918;Spragtukas;RIEŠUTĖLIAI;4427123314;Taip;0;7;0;7
9919;Spragtukas;RIEŠUTĖLIAI;6322121173;Taip;0;10;0;10
9920;Spragtukas;RIEŠUTĖLIAI;9314811354;Taip;0;2;0;2
9921;Spragtukas;VIŠČIUKAI;6493380877;Taip;0;1;0;1
9922;Spragtukas;VIŠČIUKAI;5556920140;Taip;12;4;0;16
9923;Spragtukas;VIŠČIUKAI;2255007161;Taip;0;5;0;5
9924;Spragtukas;VIŠČIUKAI;3471355267;Taip;0;19;0;19
9925;Spragtukas;VIŠČIUKAI;5427116799;Taip;0;5;0;5
9926;Spragtukas;VIŠČIUKAI;6121388208;Taip;0;18;0;18
9927;Spragtukas;VIŠČIUKAI;1747417905;Taip;8;0;6;14
9928;Spragtukas;VIŠČIUKAI;8339926929;Taip;9;1;0;10
9929;Spragtukas;VIŠČIUKAI;5724874569;Taip;3;0;0;3
9930;Spragtukas;VIŠČIUKAI;8698469979;Taip;0;10;0;10
9931;Spragtukas;VIŠČIUKAI;8625143071;Taip;9;1;1;11
9932;Spragtukas;VIŠČIUKAI;9664130733;Taip;0;5;1;6
9933;Spragtukas;VIŠČIUKAI;1430632638;Taip;10;0;0;10
9934;Spragtukas;VIŠČIUKAI;5697451914;Taip;9;1;0;10
9935;Spragtukas;MEŠKIUKAI;6192381779;Taip;0;13;0;13
9936;Spragtukas;MEŠKIUKAI;4586034709;Taip;8;0;0;8
9937;Spragtukas;MEŠKIUKAI;5687853390;Taip;6;0;0;6
9938;Spragtukas;MEŠKIUKAI;8235791891;Taip;4;7;0;11
9939;Spragtukas;MEŠKIUKAI;3948232692;Taip;0;1;0;1
9940;Spragtukas;MEŠKIUKAI;2879077913;Ne;2;2;0;4
9941;Spragtukas;MEŠKIUKAI;4669257062;Taip;5;0;0;5
9942;Spragtukas;MEŠKIUKAI;3968434618;Taip;3;0;0;3
9943;Spragtukas;MEŠKIUKAI;1150727381;Taip;0;10;0;10
9944;Spragtukas;MEŠKIUKAI;9191831532;Taip;4;10;0;14
9945;Spragtukas;MEŠKIUKAI;3189741449;Ne;0;6;0;6
9946;Spragtukas;MEŠKIUKAI;4344537391;Taip;10;1;0;11
9947;Spragtukas;MEŠKIUKAI;7859959104;Taip;0;0;1;1
9948;Spragtukas;MEŠKIUKAI;3692960591;Taip;0;1;0;1
9949;Spragtukas;MEŠKIUKAI;3337355440;Taip;5;1;0;6
9950;Spragtukas;MEŠKIUKAI;2987638580;Taip;0;17;0;17
9951;Spragtukas;MEŠKIUKAI;2305568596;Taip;0;1;0;1
9952;Spragtukas;MEŠKIUKAI;7511680722;Taip;7;1;0;8
9953;Spragtukas;MEŠKIUKAI;9149954373;Taip;2;10;0;12
9954;Spragtukas;MEŠKIUKAI;6679886985;Taip;14;0;0;14
9955;Strazdelis;Žiogelių;59969322783;Taip;9;3;0;12
9956;Strazdelis;Žiogelių;48052363003;Taip;0;5;0;5
9957;Strazdelis;Žiogelių;12739940649;Ne;0;2;0;2
9958;Strazdelis;Žiogelių;79443961061;Taip;0;6;0;6
9959;Strazdelis;Žiogelių;84548133061;Taip;0;10;0;10
9960;Strazdelis;Žiogelių;4013389618;Ne;0;4;0;4
9961;Strazdelis;Žiogelių;57514782479;Taip;10;12;0;22
9962;Strazdelis;Žiogelių;50984917126;Taip;11;3;0;14
9963;Strazdelis;Žiogelių;2110092578;Taip;0;3;0;3
9964;Strazdelis;Žiogelių;1858519255;Ne;11;1;0;12
9965;Strazdelis;Žiogelių;20845810823;Taip;0;2;0;2
9966;Strazdelis;Žiogelių;2086723106;Taip;0;1;0;1
9967;Strazdelis;Žiogelių;20510560289;Taip;0;2;1;3
9968;Strazdelis;Žiogelių;64076729200;Taip;0;3;0;3
9969;Strazdelis;Žiogelių;98433672584;Taip;0;2;0;2
9970;Strazdelis;Žiogelių;43128715501;Taip;6;0;0;6
9971;Strazdelis;Šeimynėlės;3662217925;Taip;0;11;0;11
9972;Strazdelis;Šeimynėlės;8274897977;Taip;20;0;0;20
9973;Strazdelis;Šeimynėlės;29586826889;Taip;0;2;0;2
9974;Strazdelis;Šeimynėlės;43314069648;Taip;0;3;0;3
9975;Strazdelis;Šeimynėlės;4697537943;Taip;0;6;0;6
9976;Strazdelis;Šeimynėlės;3943578036;Ne;14;1;0;15
9977;Strazdelis;Šeimynėlės;2802486859;Ne;4;4;0;8
9978;Strazdelis;Šeimynėlės;4791752179;Ne;8;0;0;8
9979;Strazdelis;Šeimynėlės;7215063033;Taip;0;2;0;2
9980;Strazdelis;Šeimynėlės;1665134387;Taip;0;2;0;2
9981;Strazdelis;Šeimynėlės;1481671624;Taip;4;3;0;7
9982;Strazdelis;Šeimynėlės;6014213362;Taip;0;4;0;4
9983;Strazdelis;Šeimynėlės;45083023033;Taip;21;0;0;21
9984;Strazdelis;Šeimynėlės;4454199703;Ne;22;0;0;22
9985;Strazdelis;Šeimynėlės;4698566091;Ne;6;1;0;7
9986;Strazdelis;Šeimynėlės;5698472204;Taip;0;0;10;10
9987;Strazdelis;Šeimynėlės;6528024720;Taip;3;3;0;6
9988;Strazdelis;Šeimynėlės;9835716116;Ne;0;2;0;2
9989;Strazdelis;Šeimynėlės;7149827850;Taip;6;4;0;10
9990;Strazdelis;Šeimynėlės;4633366779;Taip;0;1;0;1
9991;Strazdelis;Šeimynėlės;5749300013;Taip;0;8;0;8
9992;Strazdelis;Šeimynėlės;4929828091;Taip;0;1;0;1
9993;Strazdelis;Genelio;8038163444;Ne;0;1;0;1
9994;Strazdelis;Genelio;8754275576;Taip;0;9;0;9
9995;Strazdelis;Genelio;7216768880;Taip;0;1;0;1
9996;Strazdelis;Genelio;1540973269;Taip;0;2;0;2
9997;Strazdelis;Genelio;7120717682;Taip;0;3;0;3
9998;Strazdelis;Genelio;50350281905;Taip;0;5;0;5
9999;Strazdelis;Genelio;1187534672;Taip;0;1;0;1
10000;Strazdelis;Genelio;9198429790;Ne;0;6;0;6
10001;Strazdelis;Genelio;2871673641;Taip;9;7;0;16
10002;Strazdelis;Genelio;6147183190;Taip;4;0;0;4
10003;Strazdelis;Genelio;2078150337;Taip;0;11;0;11
10004;Strazdelis;Genelio;18461074207;Taip;0;1;0;1
10005;Strazdelis;Genelio;8801420992;Taip;0;0;1;1
10006;Strazdelis;Genelio;8634815556;Taip;0;0;1;1
10007;Strazdelis;Genelio;9904719582;Ne;0;2;0;2
10008;Strazdelis;Genelio;7308925265;Taip;0;2;0;2
10009;Strazdelis;Genelio;4655931716;Taip;0;2;0;2
10010;Strazdelis;Genelio;8182994112;Ne;2;3;0;5
10011;Strazdelis;Genelio;1362428967;Taip;0;1;0;1
10012;Strazdelis;Genelio;5981747175;Taip;1;0;0;1
10013;Strazdelis;Genelio;1847733888;Taip;13;0;1;14
10014;Strazdelis;Vikruolių;86783302100;Taip;0;1;0;1
10015;Strazdelis;Vikruolių;13220421668;Taip;0;6;0;6
10016;Strazdelis;Vikruolių;54050062292;Taip;0;5;0;5
10017;Strazdelis;Vikruolių;16453584376;Taip;0;2;0;2
10018;Strazdelis;Vikruolių;77589342371;Taip;3;2;0;5
10019;Strazdelis;Vikruolių;56012252629;Taip;0;1;0;1
10020;Strazdelis;Vikruolių;87689168341;Taip;0;7;0;7
10021;Strazdelis;Vikruolių;9065275674;Taip;0;4;0;4
10022;Strazdelis;Vikruolių;66254701944;Taip;0;13;0;13
10023;Strazdelis;Vikruolių;6523307315;Taip;0;2;0;2
10024;Strazdelis;Vikruolių;15920566059;Taip;5;2;0;7
10025;Strazdelis;Vikruolių;33123804487;Ne;4;0;0;4
10026;Strazdelis;Vyturėlių;13625184061;Taip;0;1;0;1
10027;Strazdelis;Vyturėlių;72069723016;Taip;0;1;0;1
10028;Strazdelis;Vyturėlių;18595696353;Taip;0;13;0;13
10029;Strazdelis;Vyturėlių;1426195737;Taip;0;2;0;2
10030;Strazdelis;Vyturėlių;2502465398;Taip;0;1;0;1
10031;Strazdelis;Vyturėlių;86957187003;Ne;6;1;0;7
10032;Strazdelis;Vyturėlių;1707225898;Taip;0;4;0;4
10033;Strazdelis;Vyturėlių;39502125227;Taip;0;7;0;7
10034;Strazdelis;Vyturėlių;98553857685;Taip;0;3;0;3
10035;Strazdelis;Vyturėlių;43722400626;Taip;0;6;0;6
10036;Strazdelis;Vyturėlių;47899514138;Taip;5;6;0;11
10037;Strazdelis;Vyturėlių;95260832237;Taip;0;2;0;2
10038;Strazdelis;Vyturėlių;17045991832;Taip;0;1;0;1
10039;Strazdelis;Vyturėlių;49277241025;Taip;0;2;0;2
10040;Strazdelis;Vyturėlių;58143176237;Taip;0;2;0;2
10041;Strazdelis;Vyturėlių;58440671129;Taip;0;6;0;6
10042;Strazdelis;Vyturėlių;62063592887;Taip;0;2;0;2
10043;Strazdelis;Vyturėlių;96062922228;Taip;0;6;0;6
10044;Strazdelis;Varpelio;8415383526;Taip;0;2;0;2
10045;Strazdelis;Varpelio;2580733127;Taip;0;2;0;2
10046;Strazdelis;Varpelio;2662549392;Taip;4;0;0;4
10047;Strazdelis;Varpelio;9502341478;Taip;0;6;0;6
10048;Strazdelis;Varpelio;2251157025;Taip;18;0;0;18
10049;Strazdelis;Varpelio;6931726275;Taip;0;2;0;2
10050;Strazdelis;Varpelio;9401101407;Ne;0;4;0;4
10051;Strazdelis;Varpelio;4873707286;Ne;9;2;0;11
10052;Strazdelis;Varpelio;6527855940;Taip;0;5;2;7
10053;Strazdelis;Varpelio;4076266466;Taip;20;0;0;20
10054;Strazdelis;Varpelio;2824416350;Taip;0;13;0;13
10055;Strazdelis;Varpelio;3610250359;Taip;19;0;0;19
10056;Strazdelis;Varpelio;2329522074;Taip;9;8;0;17
10057;Strazdelis;Varpelio;1173067724;Taip;13;0;0;13
10058;Strazdelis;Varpelio;7393083827;Taip;0;1;0;1
10059;Strazdelis;Varpelio;6555803164;Taip;0;2;0;2
10060;Strazdelis;Varpelio;1021364759;Taip;7;3;0;10
10061;Strazdelis;Varpelio;1706026100;Ne;0;1;0;1
10062;Strazdelis;Pelėdžiukų;5892430004;Taip;15;0;0;15
10063;Strazdelis;Pelėdžiukų;1901641517;Taip;4;9;0;13
10064;Strazdelis;Pelėdžiukų;1704292727;Taip;4;1;0;5
10065;Strazdelis;Pelėdžiukų;4617237063;Taip;0;7;0;7
10066;Strazdelis;Pelėdžiukų;3036380561;Taip;0;7;0;7
10067;Strazdelis;Pelėdžiukų;8371999002;Taip;0;3;0;3
10068;Strazdelis;Pelėdžiukų;6046139859;Taip;0;3;0;3
10069;Strazdelis;Pelėdžiukų;5580738386;Taip;4;3;0;7
10070;Strazdelis;Pelėdžiukų;4448556404;Ne;0;2;0;2
10071;Strazdelis;Pelėdžiukų;2238875354;Ne;13;3;0;16
10072;Strazdelis;Pelėdžiukų;4004930488;Taip;2;6;0;8
10073;Strazdelis;Pelėdžiukų;5768674837;Taip;14;0;0;14
10074;Strazdelis;Pelėdžiukų;7349106795;Taip;0;1;0;1
10075;Strazdelis;Pelėdžiukų;9761595867;Taip;9;1;0;10
10076;Strazdelis;Pelėdžiukų;8089585177;Ne;4;7;0;11
10077;Strazdelis;Pelėdžiukų;7876385010;Taip;0;3;0;3
10078;Strazdelis;Pelėdžiukų;2848984531;Taip;6;3;0;9
10079;Strazdelis;Pelėdžiukų;7471890377;Taip;5;0;0;5
10080;Strazdelis;Saulutės;1474503932;Taip;0;2;0;2
10081;Strazdelis;Saulutės;27177757900;Taip;0;2;1;3
10082;Strazdelis;Saulutės;40932140069;Taip;0;11;0;11
10083;Strazdelis;Saulutės;1523471662;Taip;0;7;0;7
10084;Strazdelis;Saulutės;2854642875;Taip;10;0;2;12
10085;Strazdelis;Saulutės;7578229276;Taip;0;1;0;1
10086;Strazdelis;Saulutės;8710848483;Taip;0;1;0;1
10087;Strazdelis;Saulutės;4129957131;Taip;0;1;0;1
10088;Strazdelis;Saulutės;3425430317;Taip;7;1;0;8
10089;Strazdelis;Saulutės;7081517417;Taip;5;2;0;7
10090;Strazdelis;Saulutės;67641340859;Taip;0;11;0;11
10091;Strazdelis;Saulutės;15298412755;Ne;6;2;0;8
10092;Strazdelis;Saulutės;1391009140;Taip;0;7;0;7
10093;Strazdelis;Saulutės;12713270671;Taip;3;0;0;3
10094;Strazdelis;Saulutės;1886601605;Taip;0;12;0;12
10095;Strazdelis;Saulutės;6113491562;Taip;0;0;9;9
10096;Strazdelis;Saulutės;8808299050;Taip;0;1;0;1
10097;Strazdelis;Saulutės;1693309238;Taip;0;11;0;11
10098;Strazdelis;Bitutės;99973904527;Ne;0;1;0;1
10099;Strazdelis;Bitutės;1111310766;Taip;0;2;0;2
10100;Strazdelis;Bitutės;24669852216;Taip;0;1;0;1
10101;Strazdelis;Bitutės;51702469375;Taip;0;2;0;2
10102;Strazdelis;Bitutės;59837435595;Ne;7;9;0;16
10103;Strazdelis;Bitutės;90089166514;Taip;0;9;0;9
10104;Strazdelis;Bitutės;96077591556;Taip;0;9;0;9
10105;Strazdelis;Bitutės;14459771394;Taip;0;9;0;9
10106;Strazdelis;Bitutės;34644143572;Taip;0;2;0;2
10107;Strazdelis;Bitutės;1847755442;Taip;0;1;0;1
10108;Strazdelis;Bitutės;1073814440;Taip;0;5;0;5
10109;Strazdelis;Bitutės;7812253305;Taip;0;1;0;1
10110;Strazdelis;Bitutės;1140100663;Taip;0;1;0;1
10111;Strazdelis;Bitutės;60128913543;Taip;0;4;0;4
10112;Strazdelis;Bitutės;2090154632;Taip;8;2;0;10
10113;Strazdelis;Bitutės;76361365558;Ne;0;2;1;3
10114;Strazdelis;Bitutės;1735868807;Taip;0;3;0;3
10115;Strazdelis;Bitutės;2350690409;Taip;0;1;0;1
10116;Strazdelis;Bitutės;68605763183;Taip;20;0;0;20
10117;Strazdelis;Bitutės;1785962711;Taip;11;4;0;15
10118;Strazdelis;Mažylių;8753316532;Taip;22;0;0;22
10119;Strazdelis;Mažylių;2081538505;Taip;8;7;0;15
10120;Strazdelis;Mažylių;2589303722;Taip;0;5;0;5
10121;Strazdelis;Mažylių;3043580835;Taip;7;0;0;7
10122;Strazdelis;Mažylių;4369569609;Taip;0;0;4;4
10123;Strazdelis;Mažylių;1005082012;Ne;0;2;3;5
10124;Strazdelis;Mažylių;5232064496;Taip;8;2;0;10
10125;Strazdelis;Mažylių;4784401449;Ne;5;1;0;6
10126;Strazdelis;Mažylių;4020547762;Taip;0;2;3;5
10127;Strazdelis;Mažylių;3149930355;Taip;2;0;0;2
10128;Strazdelis;Mažylių;9435593972;Ne;0;1;0;1
10129;Strazdelis;Mažylių;8485509145;Taip;0;6;0;6
10130;Strazdelis;Mažylių;1539984888;Taip;0;11;0;11
10131;Strazdelis;Mažylių;9555240419;Taip;3;2;2;7
10132;Strazdelis;Mažylių;6508933324;Taip;4;0;0;4
10133;Strazdelis;Pabiručių;7913526787;Taip;22;0;0;22
10134;Strazdelis;Pabiručių;8277333786;Taip;5;0;0;5
10135;Strazdelis;Pabiručių;8686828982;Taip;9;1;0;10
10136;Strazdelis;Pabiručių;8581533423;Ne;13;0;0;13
10137;Strazdelis;Pabiručių;7425818775;Taip;2;0;1;3
10138;Strazdelis;Pabiručių;8111541739;Taip;0;4;0;4
10139;Strazdelis;Pabiručių;1194918926;Taip;0;3;0;3
10140;Strazdelis;Pabiručių;9933042249;Taip;0;7;0;7
10141;Strazdelis;Pabiručių;1141752802;Taip;0;0;7;7
10142;Strazdelis;Pabiručių;2753635198;Taip;0;0;1;1
10143;Strazdelis;Pabiručių;9567476872;Ne;0;1;0;1
10144;Strazdelis;Pabiručių;1683900907;Taip;0;1;0;1
10145;Strazdelis;Pabiručių;5346485534;Taip;0;1;0;1
10146;Strazdelis;Pabiručių;1228651165;Taip;0;3;1;4
10147;Strazdelis;Pabiručių;8209625399;Taip;7;1;0;8
10148;Strazdelis;Pabiručių;6651360492;Taip;0;6;0;6
10149;Šermukšnėlė;MOLINUKAI;61809452162;Taip;3;1;1;5
10150;Šermukšnėlė;MOLINUKAI;60863269031;Taip;0;4;0;4
10151;Šermukšnėlė;MOLINUKAI;39534021804;Taip;0;1;0;1
10152;Šermukšnėlė;MOLINUKAI;54312555311;Taip;8;0;1;9
10153;Šermukšnėlė;MOLINUKAI;3873114056;Taip;0;0;1;1
10154;Šermukšnėlė;MOLINUKAI;1561527473;Taip;0;0;1;1
10155;Šermukšnėlė;MOLINUKAI;1054907277;Ne;0;0;2;2
10156;Šermukšnėlė;MOLINUKAI;83487643143;Taip;3;0;0;3
10157;Šermukšnėlė;MOLINUKAI;1411650732;Ne;6;0;1;7
10158;Šermukšnėlė;MOLINUKAI;7830792252;Ne;0;0;3;3
10159;Šermukšnėlė;MOLINUKAI;1756161106;Taip;0;6;1;7
10160;Šermukšnėlė;MOLINUKAI;1543336828;Ne;22;0;0;22
10161;Šermukšnėlė;MOLINUKAI;2050855662;Ne;0;0;2;2
10162;Šermukšnėlė;MOLINUKAI;2561033248;Taip;0;10;0;10
10163;Šermukšnėlė;ŠIAUDINUKAI;85959255744;Taip;0;0;1;1
10164;Šermukšnėlė;ŠIAUDINUKAI;95999386401;Taip;0;0;1;1
10165;Šermukšnėlė;ŠIAUDINUKAI;2734502079;Taip;0;0;3;3
10166;Šermukšnėlė;ŠIAUDINUKAI;16859553972;Taip;0;11;0;11
10167;Šermukšnėlė;ŠIAUDINUKAI;32403224788;Taip;3;4;0;7
10168;Šermukšnėlė;ŠIAUDINUKAI;99444734331;Taip;0;0;1;1
10169;Šermukšnėlė;ŠIAUDINUKAI;3851927973;Taip;0;0;4;4
10170;Šermukšnėlė;ŠIAUDINUKAI;87587621833;Taip;0;0;3;3
10171;Šermukšnėlė;ŠIAUDINUKAI;1738008915;Taip;0;6;0;6
10172;Šermukšnėlė;ŠIAUDINUKAI;28087351377;Taip;0;4;0;4
10173;Šermukšnėlė;ŠIAUDINUKAI;28007013244;Taip;0;4;0;4
10174;Šermukšnėlė;ŠIAUDINUKAI;82928987881;Taip;0;0;1;1
10175;Šermukšnėlė;ŠIAUDINUKAI;1189930137;Taip;0;0;3;3
10176;Šermukšnėlė;ŠIAUDINUKAI;1367964100;Taip;0;10;0;10
10177;Šermukšnėlė;ŠIAUDINUKAI;2100740973;Taip;4;0;2;6
10178;Šermukšnėlė;ŠIAUDINUKAI;63858537394;Taip;0;4;0;4
10179;Šermukšnėlė;TOŠINUKAI;1290319484;Taip;0;9;0;9
10180;Šermukšnėlė;TOŠINUKAI;1636627303;Ne;0;1;3;4
10181;Šermukšnėlė;TOŠINUKAI;1846720859;Taip;0;4;0;4
10182;Šermukšnėlė;TOŠINUKAI;51058072005;Taip;12;2;0;14
10183;Šermukšnėlė;TOŠINUKAI;1559325175;Taip;0;14;0;14
10184;Šermukšnėlė;TOŠINUKAI;2137141949;Taip;4;0;1;5
10185;Šermukšnėlė;TOŠINUKAI;1858862320;Taip;4;14;0;18
10186;Šermukšnėlė;TOŠINUKAI;1016403317;Taip;0;0;5;5
10187;Šermukšnėlė;TOŠINUKAI;2477657052;Taip;5;0;0;5
10188;Šermukšnėlė;TOŠINUKAI;85018940292;Ne;0;2;3;5
10189;Šermukšnėlė;TOŠINUKAI;92414041480;Taip;0;0;1;1
10190;Šermukšnėlė;TOŠINUKAI;288807384;Ne;0;0;2;2
10191;Šermukšnėlė;TOŠINUKAI;1138272220;Ne;3;0;1;4
10192;Šermukšnėlė;TOŠINUKAI;1112022308;Taip;0;0;5;5
10193;Šermukšnėlė;TOŠINUKAI;83448986084;Taip;0;1;0;1
10194;Šermukšnėlė;TOŠINUKAI;1828510990;Taip;0;0;6;6
10195;Šermukšnėlė;ODINUKAI;5545018656;Taip;0;4;0;4
10196;Šermukšnėlė;ODINUKAI;2176788727;Taip;10;0;0;10
10197;Šermukšnėlė;ODINUKAI;3148857617;Taip;0;15;0;15
10198;Šermukšnėlė;ODINUKAI;5575518612;Ne;5;0;4;9
10199;Šermukšnėlė;ODINUKAI;3322053946;Taip;0;9;0;9
10200;Šermukšnėlė;ODINUKAI;7262199284;Taip;0;0;1;1
10201;Šermukšnėlė;ODINUKAI;5159461963;Taip;1;2;0;3
10202;Šermukšnėlė;ODINUKAI;5354978646;Taip;11;0;3;14
10203;Šermukšnėlė;ODINUKAI;1882432812;Taip;9;0;4;13
10204;Šermukšnėlė;ODINUKAI;5242187638;Ne;0;10;1;11
10205;Šermukšnėlė;ODINUKAI;1148559284;Taip;15;0;0;15
10206;Šermukšnėlė;ODINUKAI;3949629658;Ne;2;0;6;8
10207;Šermukšnėlė;ODINUKAI;6105915822;Taip;4;4;0;8
10208;Šermukšnėlė;ODINUKAI;7667114310;Taip;6;0;1;7
10209;Šermukšnėlė;ODINUKAI;7245206247;Taip;5;0;4;9
10210;Šermukšnėlė;ODINUKAI;5397385093;Taip;0;0;6;6
10211;Šermukšnėlė;ODINUKAI;4331948700;Taip;0;0;2;2
10212;Šermukšnėlė;KRIAUKLELĖS;8123096990;Taip;4;0;0;4
10213;Šermukšnėlė;KRIAUKLELĖS;1492328724;Taip;3;0;0;3
10214;Šermukšnėlė;KRIAUKLELĖS;3639954786;Taip;0;0;5;5
10215;Šermukšnėlė;KRIAUKLELĖS;1902848560;Taip;9;0;0;9
10216;Šermukšnėlė;KRIAUKLELĖS;5678559268;Taip;8;0;0;8
10217;Šermukšnėlė;KRIAUKLELĖS;8407947566;Ne;11;0;1;12
10218;Šermukšnėlė;KRIAUKLELĖS;7843128263;Ne;19;0;0;19
10219;Šermukšnėlė;KRIAUKLELĖS;3513568460;Taip;10;0;0;10
10220;Šermukšnėlė;KRIAUKLELĖS;6067298318;Taip;4;0;0;4
10221;Šermukšnėlė;KRIAUKLELĖS;5159105661;Taip;0;0;8;8
10222;Šermukšnėlė;KRIAUKLELĖS;5660238634;Taip;7;0;0;7
10223;Šermukšnėlė;KRIAUKLELĖS;4569484117;Taip;0;9;1;10
10224;Šermukšnėlė;KRIAUKLELĖS;8064473083;Taip;0;5;0;5
10225;Šermukšnėlė;KRIAUKLELĖS;2837099502;Taip;10;0;3;13
10226;Šermukšnėlė;KRIAUKLELĖS;7548637091;Ne;14;0;2;16
10227;Šermukšnėlė;VYTINUKAI;97906920174;Ne;8;1;2;11
10228;Šermukšnėlė;VYTINUKAI;1523361932;Taip;5;0;0;5
10229;Šermukšnėlė;VYTINUKAI;8531953934;Ne;0;1;2;3
10230;Šermukšnėlė;VYTINUKAI;25189813939;Taip;6;2;0;8
10231;Šermukšnėlė;VYTINUKAI;83123267733;Taip;0;1;0;1
10232;Šermukšnėlė;VYTINUKAI;20028832329;Taip;0;4;0;4
10233;Šermukšnėlė;VYTINUKAI;3959795064;Taip;6;4;0;10
10234;Šermukšnėlė;VYTINUKAI;8498288021;Taip;0;0;1;1
10235;Šermukšnėlė;VYTINUKAI;3751769136;Taip;9;2;1;12
10236;Šermukšnėlė;VYTINUKAI;6291531570;Taip;8;0;0;8
10237;Šermukšnėlė;VYTINUKAI;1244964311;Ne;4;0;0;4
10238;Šermukšnėlė;VYTINUKAI;83882579952;Taip;0;2;0;2
10239;Šermukšnėlė;VYTINUKAI;60840526220;Taip;3;4;0;7
10240;Šermukšnėlė;VYTINUKAI;1519623099;Taip;0;0;3;3
10241;Šermukšnėlė;VYTINUKAI;7106405983;Ne;5;0;3;8
10242;Šermukšnėlė;VYTINUKAI;9654198217;Ne;5;0;1;6
10243;Šermukšnėlė;VYTINUKAI;1670047548;Taip;0;2;2;4
10244;Šermukšnėlė;GINTARĖLIAI;3147809450;Taip;0;0;1;1
10245;Šermukšnėlė;GINTARĖLIAI;1167696952;Ne;4;1;1;6
10246;Šermukšnėlė;GINTARĖLIAI;85062380771;Taip;16;0;1;17
10247;Šermukšnėlė;GINTARĖLIAI;35389950541;Taip;0;1;10;11
10248;Šermukšnėlė;GINTARĖLIAI;82240400954;Taip;3;0;0;3
10249;Šermukšnėlė;GINTARĖLIAI;1944687724;Taip;2;0;0;2
10250;Šermukšnėlė;GINTARĖLIAI;1013698297;Taip;4;0;0;4
10251;Šermukšnėlė;GINTARĖLIAI;2094932013;Ne;0;0;1;1
10252;Šermukšnėlė;GINTARĖLIAI;1851549466;Taip;0;0;3;3
10253;Šermukšnėlė;GINTARĖLIAI;1521544270;Taip;0;1;1;2
10254;Šermukšnėlė;GINTARĖLIAI;3697936074;Taip;12;0;0;12
10255;Šermukšnėlė;GINTARĖLIAI;2686950289;Taip;4;1;0;5
10256;Šermukšnėlė;GINTARĖLIAI;27183547828;Ne;0;0;2;2
10257;Šermukšnėlė;GINTARĖLIAI;10728235594;Ne;0;0;6;6
10258;Šermukšnėlė;GINTARĖLIAI;42477406335;Ne;7;0;2;9
10259;Šermukšnėlė;GINTARĖLIAI;61300763004;Taip;1;7;0;8
10260;Šermukšnėlė;GINTARĖLIAI;1425285365;Taip;0;3;4;7
10261;Šermukšnėlė;GINTARĖLIAI;6279210465;Taip;6;0;2;8
10262;Šermukšnėlė;GINTARĖLIAI;4601810772;Taip;0;5;0;5
10263;Šermukšnėlė;GINTARĖLIAI;1562494176;Taip;0;10;0;10
10264;Šermukšnėlė;AKMENUKAI;95089450234;Ne;0;0;4;4
10265;Šermukšnėlė;AKMENUKAI;80199267729;Taip;4;0;0;4
10266;Šermukšnėlė;AKMENUKAI;27139089487;Taip;0;3;0;3
10267;Šermukšnėlė;AKMENUKAI;42520543068;Ne;0;0;2;2
10268;Šermukšnėlė;AKMENUKAI;76682206033;Taip;0;0;7;7
10269;Šermukšnėlė;AKMENUKAI;42192131599;Ne;2;0;0;2
10270;Šermukšnėlė;AKMENUKAI;1316118025;Taip;0;0;4;4
10271;Šermukšnėlė;AKMENUKAI;3628734426;Taip;4;3;0;7
10272;Šermukšnėlė;AKMENUKAI;9658469152;Taip;7;0;1;8
10273;Šermukšnėlė;AKMENUKAI;98850511500;Taip;13;0;0;13
10274;Šermukšnėlė;AKMENUKAI;48653098796;Taip;0;7;0;7
10275;Šermukšnėlė;AKMENUKAI;26775257484;Taip;0;10;0;10
10276;Šermukšnėlė;AKMENUKAI;82028252228;Taip;6;0;1;7
10277;Šermukšnėlė;AKMENUKAI;23434568160;Taip;1;5;0;6
10278;Šermukšnėlė;AKMENUKAI;3543061360;Taip;0;4;0;4
10279;Šermukšnėlė;AKMENUKAI;80349025945;Taip;0;0;7;7
10280;Šermukšnėlė;AKMENUKAI;6255671190;Taip;0;0;3;3
10281;Šermukšnėlė;AKMENUKAI;7564745299;Taip;0;7;0;7
10282;Šermukšnėlė;AKMENUKAI;9617044855;Ne;0;7;0;7
10283;Šermukšnėlė;AKMENUKAI;1856012121;Taip;6;1;0;7
10284;Šermukšnėlė;SIŪLINUKAI;32417473492;Taip;10;2;0;12
10285;Šermukšnėlė;SIŪLINUKAI;35508499818;Taip;8;2;1;11
10286;Šermukšnėlė;SIŪLINUKAI;30853722796;Taip;0;5;3;8
10287;Šermukšnėlė;SIŪLINUKAI;62420710883;Taip;0;0;1;1
10288;Šermukšnėlė;SIŪLINUKAI;25663713043;Taip;0;1;0;1
10289;Šermukšnėlė;SIŪLINUKAI;88123535614;Taip;0;0;1;1
10290;Šermukšnėlė;SIŪLINUKAI;61911120798;Taip;0;0;4;4
10291;Šermukšnėlė;SIŪLINUKAI;3089008915;Taip;4;0;0;4
10292;Šermukšnėlė;SIŪLINUKAI;20160146304;Taip;0;0;1;1
10293;Šermukšnėlė;SIŪLINUKAI;1330471614;Taip;1;0;0;1
10294;Šermukšnėlė;SIŪLINUKAI;1127786451;Taip;0;1;0;1
10295;Šermukšnėlė;SIŪLINUKAI;18799838453;Taip;2;5;2;9
10296;Šermukšnėlė;SIŪLINUKAI;78916223877;Taip;0;11;1;12
10297;Šermukšnėlė;SIŪLINUKAI;45632551657;Taip;16;0;0;16
10298;Šermukšnėlė;SIŪLINUKAI;7766292005;Taip;0;2;0;2
10299;Šermukšnėlė;MEDINUKAi;2380988728;Ne;5;3;0;8
10300;Šermukšnėlė;MEDINUKAi;2529526401;Taip;6;0;3;9
10301;Šermukšnėlė;MEDINUKAi;8956573129;Taip;0;0;1;1
10302;Šermukšnėlė;MEDINUKAi;3222466449;Taip;1;1;1;3
10303;Šermukšnėlė;MEDINUKAi;5096946133;Taip;5;6;0;11
10304;Šermukšnėlė;MEDINUKAi;8279692394;Taip;0;0;1;1
10305;Šermukšnėlė;MEDINUKAi;78341448188;Taip;3;0;1;4
10306;Šermukšnėlė;MEDINUKAi;1661977128;Ne;0;0;3;3
10307;Šermukšnėlė;MEDINUKAi;6430627501;Taip;2;0;0;2
10308;Šermukšnėlė;MEDINUKAi;5832072195;Taip;4;16;0;20
10309;Šermukšnėlė;MEDINUKAi;9035625467;Taip;0;7;1;8
10310;Šermukšnėlė;MEDINUKAi;7038705221;Taip;0;10;1;11
10311;Šermukšnėlė;MEDINUKAi;3081548524;Ne;0;0;1;1
10312;Šermukšnėlė;MEDINUKAi;3994316729;Taip;0;0;3;3
10313;Šermukšnėlė;MEDINUKAi;6413821285;Taip;7;0;0;7
10314;Šermukšnėlė;MEDINUKAi;4981204674;Taip;5;4;0;9
10315;Šermukšnėlė;MEDINUKAi;7229632099;Ne;7;0;1;8
10316;Šermukšnėlė;SKUDURINUKAI;6351841889;Ne;13;0;0;13
10317;Šermukšnėlė;SKUDURINUKAI;2989011150;Taip;3;9;0;12
10318;Šermukšnėlė;SKUDURINUKAI;1636944853;Taip;6;0;0;6
10319;Šermukšnėlė;SKUDURINUKAI;3747531232;Taip;5;3;0;8
10320;Šermukšnėlė;SKUDURINUKAI;1994737857;Taip;11;2;0;13
10321;Šermukšnėlė;SKUDURINUKAI;4619811264;Taip;15;0;0;15
10322;Šermukšnėlė;SKUDURINUKAI;4805637096;Taip;8;0;1;9
10323;Šermukšnėlė;SKUDURINUKAI;6249700552;Taip;8;0;1;9
10324;Šermukšnėlė;SKUDURINUKAI;4783726095;Taip;0;4;0;4
10325;Šermukšnėlė;SKUDURINUKAI;7053319091;Taip;3;0;3;6
10326;Šermukšnėlė;SKUDURINUKAI;9714566919;Taip;0;0;1;1
10327;Šermukšnėlė;SKUDURINUKAI;6194188831;Taip;0;0;6;6
10328;Šermukšnėlė;SKUDURINUKAI;1437314920;Taip;0;1;0;1
10329;Šermukšnėlė;SKUDURINUKAI;7305013368;Taip;5;0;0;5
10330;Šermukšnėlė;SKUDURINUKAI;7661182825;Taip;0;3;0;3
10331;Šermukšnėlė;PAGRANDUKAI;2447547509;Taip;0;0;4;4
10332;Šermukšnėlė;PAGRANDUKAI;9876533442;Taip;0;0;1;1
10333;Šermukšnėlė;PAGRANDUKAI;3613456202;Taip;0;0;5;5
10334;Šermukšnėlė;PAGRANDUKAI;3002999054;Taip;3;0;0;3
10335;Šermukšnėlė;PAGRANDUKAI;8709426669;Taip;0;7;0;7
10336;Šermukšnėlė;PAGRANDUKAI;3170388518;Ne;8;0;5;13
10337;Šermukšnėlė;PAGRANDUKAI;5905330617;Taip;0;7;0;7
10338;Šermukšnėlė;PAGRANDUKAI;6585484701;Ne;11;0;0;11
10339;Šermukšnėlė;PAGRANDUKAI;3653792683;Taip;5;0;6;11
10340;Šermukšnėlė;PAGRANDUKAI;9783673534;Taip;0;0;1;1
10341;Šermukšnėlė;PAGRANDUKAI;6599779539;Taip;5;8;0;13
10342;Šermukšnėlė;PAGRANDUKAI;8541743148;Ne;4;0;0;4
10343;Šermukšnėlė;PAGRANDUKAI;8201447350;Taip;14;0;0;14
10344;Šermukšnėlė;PAGRANDUKAI;4256630681;Taip;5;0;0;5
10345;Šermukšnėlė;PAGRANDUKAI;2784732759;Taip;5;0;0;5
10346;Šypsena;NYKŠTUKAI;1114341518;Taip;3;0;0;3
10347;Šypsena;NYKŠTUKAI;1558614852;Taip;3;2;0;5
10348;Šypsena;NYKŠTUKAI;1897176871;Ne;0;6;0;6
10349;Šypsena;NYKŠTUKAI;8715718525;Ne;3;0;0;3
10350;Šypsena;NYKŠTUKAI;2312828770;Ne;9;0;0;9
10351;Šypsena;NYKŠTUKAI;1181590127;Taip;0;10;4;14
10352;Šypsena;NYKŠTUKAI;4808041625;Taip;0;0;4;4
10353;Šypsena;NYKŠTUKAI;1422418997;Taip;0;1;0;1
10354;Šypsena;NYKŠTUKAI;5834057370;Ne;0;2;0;2
10355;Šypsena;NYKŠTUKAI;1515803985;Ne;5;3;0;8
10356;Šypsena;NYKŠTUKAI;5928432220;Taip;0;1;0;1
10357;Šypsena;NYKŠTUKAI;5504570516;Taip;0;2;0;2
10358;Šypsena;NYKŠTUKAI;1063834589;Taip;0;3;0;3
10359;Šypsena;NYKŠTUKAI;2798819321;Taip;0;1;0;1
10360;Šypsena;NYKŠTUKAI;4038279267;Taip;9;3;1;13
10361;Šypsena;NYKŠTUKAI;8950694484;Ne;0;9;3;12
10362;Šypsena;NYKŠTUKAI;4344780723;Taip;0;0;16;16
10363;Šypsena;NYKŠTUKAI;1893123775;Taip;4;2;0;6
10364;Šypsena;NYKŠTUKAI;6237208661;Taip;0;5;0;5
10365;Šypsena;NYKŠTUKAI;3506046076;Ne;0;6;0;6
10366;Šypsena;NYKŠTUKAI;7519967594;Taip;0;0;1;1
10367;Šypsena;SPINDULIUKAI;5568502083;Taip;0;9;0;9
10368;Šypsena;SPINDULIUKAI;1795366502;Taip;0;8;0;8
10369;Šypsena;SPINDULIUKAI;2706678026;Ne;5;0;0;5
10370;Šypsena;SPINDULIUKAI;3063226692;Ne;3;0;1;4
10371;Šypsena;SPINDULIUKAI;4766170132;Ne;0;0;1;1
10372;Šypsena;SPINDULIUKAI;4936775366;Taip;0;1;15;16
10373;Šypsena;SPINDULIUKAI;7569495879;Taip;0;12;0;12
10374;Šypsena;SPINDULIUKAI;6832433711;Ne;0;16;0;16
10375;Šypsena;SPINDULIUKAI;2248628927;Taip;3;1;0;4
10376;Šypsena;SPINDULIUKAI;2995753269;Taip;0;0;1;1
10377;Šypsena;SPINDULIUKAI;4635232236;Taip;0;0;1;1
10378;Šypsena;SPINDULIUKAI;1796837022;Taip;0;5;0;5
10379;Šypsena;SPINDULIUKAI;4677405885;Taip;0;3;0;3
10380;Šypsena;SPINDULIUKAI;5985974927;Taip;4;4;0;8
10381;Šypsena;SPINDULIUKAI;1669768648;Ne;9;0;2;11
10382;Šypsena;SPINDULIUKAI;1575413188;Taip;0;3;0;3
10383;Šypsena;SPINDULIUKAI;2005543016;Ne;5;0;2;7
10384;Šypsena;SKRUZDELIUKAI;5642959574;Ne;6;5;0;11
10385;Šypsena;SKRUZDELIUKAI;3025437080;Ne;0;5;0;5
10386;Šypsena;SKRUZDELIUKAI;7538681006;Taip;0;0;1;1
10387;Šypsena;SKRUZDELIUKAI;1272973534;Ne;7;0;1;8
10388;Šypsena;SKRUZDELIUKAI;1917246860;Ne;8;4;0;12
10389;Šypsena;SKRUZDELIUKAI;46569341613;Taip;16;0;0;16
10390;Šypsena;SKRUZDELIUKAI;42130115068;Taip;9;6;0;15
10391;Šypsena;SKRUZDELIUKAI;6444616846;Taip;0;2;0;2
10392;Šypsena;SKRUZDELIUKAI;1996746426;Taip;0;5;0;5
10393;Šypsena;SKRUZDELIUKAI;4017777389;Taip;0;0;1;1
10394;Šypsena;SKRUZDELIUKAI;70188972463;Taip;6;0;2;8
10395;Šypsena;SKRUZDELIUKAI;1906529989;Taip;5;11;0;16
10396;Šypsena;SKRUZDELIUKAI;2099216049;Taip;4;1;0;5
10397;Šypsena;SKRUZDELIUKAI;89503728819;Ne;4;1;0;5
10398;Šypsena;SKRUZDELIUKAI;1133113196;Ne;1;1;0;2
10399;Šypsena;SKRUZDELIUKAI;1387130727;Taip;2;0;2;4
10400;Šypsena;Bitutės;1702152247;Ne;0;11;0;11
10401;Šypsena;Bitutės;5971488796;Taip;0;4;0;4
10402;Šypsena;Bitutės;5680397153;Taip;6;0;2;8
10403;Šypsena;Bitutės;25175991441;Taip;0;1;2;3
10404;Šypsena;Bitutės;2117865969;Taip;0;1;0;1
10405;Šypsena;Bitutės;1329170686;Taip;0;1;0;1
10406;Šypsena;Bitutės;1369664461;Ne;4;0;0;4
10407;Šypsena;Bitutės;2368339278;Taip;0;1;2;3
10408;Šypsena;Bitutės;91846404526;Ne;0;4;0;4
10409;Šypsena;Bitutės;84526597847;Taip;0;3;0;3
10410;Šypsena;Bitutės;39296351965;Taip;0;4;0;4
10411;Šypsena;Bitutės;17041968817;Taip;4;1;0;5
10412;Šypsena;Bitutės;1972212253;Ne;5;1;0;6
10413;Šypsena;Bitutės;39495782526;Taip;0;4;0;4
10414;Šypsena;MEŠKIUKAI;1656674673;Taip;0;0;1;1
10415;Šypsena;MEŠKIUKAI;1369906621;Taip;4;0;0;4
10416;Šypsena;MEŠKIUKAI;7877396588;Taip;7;5;0;12
10417;Šypsena;MEŠKIUKAI;1287205292;Taip;6;0;0;6
10418;Šypsena;MEŠKIUKAI;1324902555;Taip;7;0;0;7
10419;Šypsena;MEŠKIUKAI;5611440056;Ne;0;0;1;1
10420;Šypsena;MEŠKIUKAI;7160466766;Taip;8;0;4;12
10421;Šypsena;MEŠKIUKAI;3823623458;Ne;4;0;0;4
10422;Šypsena;MEŠKIUKAI;4695547847;Ne;3;0;0;3
10423;Šypsena;MEŠKIUKAI;6713182218;Taip;0;4;0;4
10424;Šypsena;MEŠKIUKAI;7537442618;Taip;4;1;0;5
10425;Šypsena;MEŠKIUKAI;3968514430;Taip;3;1;0;4
10426;Šypsena;MEŠKIUKAI;8566236342;Taip;22;0;0;22
10427;Šypsena;MEŠKIUKAI;6716558946;Taip;6;0;0;6
10428;Šypsena;BORUŽĖLĖS;6377979434;Taip;0;0;2;2
10429;Šypsena;BORUŽĖLĖS;2179657619;Ne;5;5;0;10
10430;Šypsena;BORUŽĖLĖS;8215278033;Taip;0;4;0;4
10431;Šypsena;BORUŽĖLĖS;3733757483;Ne;0;10;0;10
10432;Šypsena;BORUŽĖLĖS;2372820133;Taip;10;0;0;10
10433;Šypsena;BORUŽĖLĖS;5879506651;Taip;0;2;0;2
10434;Šypsena;BORUŽĖLĖS;8164410749;Ne;0;10;0;10
10435;Šypsena;BORUŽĖLĖS;7898387398;Ne;12;0;1;13
10436;Šypsena;BORUŽĖLĖS;2584574423;Taip;8;0;1;9
10437;Šypsena;BORUŽĖLĖS;6951845385;Taip;7;10;0;17
10438;Šypsena;BORUŽĖLĖS;5906001927;Taip;13;0;1;14
10439;Šypsena;BORUŽĖLĖS;7120597034;Taip;10;8;0;18
10440;Šypsena;BORUŽĖLĖS;3003901966;Taip;16;0;0;16
10441;Šypsena;BORUŽĖLĖS;4520148322;Taip;5;4;0;9
10442;Šnekutis;DRUGELIŲ;1430790285;Taip;0;0;2;2
10443;Šnekutis;DRUGELIŲ;70663269171;Taip;2;0;0;2
10444;Šnekutis;DRUGELIŲ;65711574140;Taip;0;0;1;1
10445;Šnekutis;DRUGELIŲ;1723901018;Taip;0;1;7;8
10446;Šnekutis;DRUGELIŲ;2000728679;Taip;0;22;0;22
10447;Šnekutis;DRUGELIŲ;1956224017;Ne;8;0;3;11
10448;Šnekutis;DRUGELIŲ;1159232792;Taip;13;0;4;17
10449;Šnekutis;DRUGELIŲ;2092637040;Taip;5;0;5;10
10450;Šnekutis;DRUGELIŲ;94289379983;Taip;0;8;0;8
10451;Šnekutis;DRUGELIŲ;1836892386;Taip;0;0;1;1
10452;Šnekutis;DRUGELIŲ;5962885680;Taip;0;1;0;1
10453;Šnekutis;DRUGELIŲ;4743885834;Taip;10;0;5;15
10454;Šnekutis;DRUGELIŲ;18354631454;Taip;0;0;3;3
10455;Šnekutis;DRUGELIŲ;5029631107;Taip;0;5;0;5
10456;Šnekutis;DRUGELIŲ;4405486406;Taip;9;5;0;14
10457;Šnekutis;Kačiukų;3281475303;Taip;0;3;0;3
10458;Šnekutis;Kačiukų;5052137859;Taip;9;0;0;9
10459;Šnekutis;Kačiukų;8531521901;Taip;5;1;1;7
10460;Šnekutis;Kačiukų;9670205249;Ne;0;0;2;2
10461;Šnekutis;Kačiukų;7615716438;Taip;4;7;0;11
10462;Šnekutis;Kačiukų;9780684867;Ne;0;0;1;1
10463;Šnekutis;Kačiukų;3271262071;Taip;4;0;10;14
10464;Šnekutis;Kačiukų;4405567649;Taip;5;3;0;8
10465;Šnekutis;Kačiukų;3166309530;Taip;0;1;2;3
10466;Šnekutis;Kačiukų;5049964996;Taip;4;0;0;4
10467;Šnekutis;Kačiukų;4143844589;Taip;0;10;0;10
10468;Šnekutis;Kačiukų;9312935803;Taip;0;0;14;14
10469;Šnekutis;Kačiukų;7236658561;Taip;0;0;1;1
10470;Šnekutis;Kačiukų;4992188525;Ne;18;0;0;18
10471;Šnekutis;Kačiukų;9896249776;Taip;7;0;6;13
10472;Šnekutis;Kačiukų;9157136735;Taip;0;5;0;5
10473;Šnekutis;Kačiukų;9790803767;Taip;12;0;0;12
10474;Šnekutis;Kačiukų;4920263429;Taip;0;4;0;4
10475;Šnekutis;Kačiukų;5909584565;Taip;0;0;3;3
10476;Šnekutis;Kačiukų;6234943180;Taip;0;0;3;3
10477;Šnekutis;Pėlėdžiukų;5188035949;Taip;0;2;0;2
10478;Šnekutis;Pėlėdžiukų;4334155280;Ne;0;0;2;2
10479;Šnekutis;Pėlėdžiukų;77534335117;Ne;7;0;8;15
10480;Šnekutis;Pėlėdžiukų;3312928478;Taip;2;15;0;17
10481;Šnekutis;Pėlėdžiukų;42697936562;Ne;0;0;4;4
10482;Šnekutis;Pėlėdžiukų;7507857415;Taip;0;0;1;1
10483;Šnekutis;Pėlėdžiukų;8866360301;Taip;0;0;2;2
10484;Šnekutis;Pėlėdžiukų;8745465796;Ne;5;0;14;19
10485;Šnekutis;Pėlėdžiukų;3170928052;Taip;8;0;0;8
10486;Šnekutis;Pėlėdžiukų;5321817615;Taip;4;0;0;4
10487;Šnekutis;Pėlėdžiukų;3578045341;Taip;10;0;0;10
10488;Šnekutis;Pėlėdžiukų;5117544317;Taip;0;0;5;5
10489;Šnekutis;Pėlėdžiukų;1507200600;Taip;0;0;8;8
10490;Šnekutis;Pėlėdžiukų;5615869149;Ne;3;1;0;4
10491;Šnekutis;Pėlėdžiukų;1329958641;Taip;0;0;2;2
10492;Šnekutis;Pėlėdžiukų;9511116249;Taip;9;0;0;9
10493;Šnekutis;Boružėlių;1818789769;Taip;6;1;0;7
10494;Šnekutis;Boružėlių;4557629310;Ne;0;19;0;19
10495;Šnekutis;Boružėlių;79174984189;Taip;16;0;0;16
10496;Šnekutis;Boružėlių;1249451765;Taip;0;9;0;9
10497;Šnekutis;Boružėlių;1936021189;Taip;0;1;2;3
10498;Šnekutis;Boružėlių;1031911012;Taip;4;0;0;4
10499;Šnekutis;Boružėlių;1985052072;Taip;0;6;2;8
10500;Šnekutis;Boružėlių;1738802158;Taip;0;9;0;9
10501;Šnekutis;Boružėlių;1744313172;Taip;0;0;1;1
10502;Šnekutis;Boružėlių;1620268693;Taip;8;0;0;8
10503;Šnekutis;Boružėlių;54532738133;Taip;14;0;0;14
10504;Šnekutis;Boružėlių;1370696345;Taip;10;0;1;11
10505;Šnekutis;Boružėlių;7514753023;Taip;15;0;0;15
10506;Šnekutis;Boružėlių;1881531513;Taip;0;3;0;3
10507;Šnekutis;Boružėlių;6828079735;Taip;3;1;1;5
10508;Šnekutis;Boružėlių;13826429088;Taip;0;0;2;2
10509;Šnekutis;Boružėlių;9166145365;Ne;4;0;2;6
10510;Šnekutis;Boružėlių;8458769051;Ne;4;0;2;6
10511;Šnekutis;Meškučių;4835202527;Ne;0;6;0;6
10512;Šnekutis;Meškučių;5597629090;Taip;0;0;4;4
10513;Šnekutis;Meškučių;8440160819;Taip;0;0;3;3
10514;Šnekutis;Meškučių;9862362744;Taip;0;0;2;2
10515;Šnekutis;Meškučių;8486136697;Taip;0;22;0;22
10516;Šnekutis;Meškučių;5970951526;Taip;0;7;0;7
10517;Šnekutis;Meškučių;9326455786;Taip;7;0;5;12
10518;Šnekutis;Meškučių;3136349573;Taip;5;0;1;6
10519;Šnekutis;Meškučių;7680962037;Taip;5;0;2;7
10520;Šnekutis;Meškučių;6081100604;Taip;0;1;0;1
10521;Šnekutis;Meškučių;3937465849;Taip;4;0;0;4
10522;Šnekutis;Meškučių;3344425033;Taip;0;8;0;8
10523;Šnekutis;Meškučių;9054899440;Taip;8;0;0;8
10524;Šnekutis;Meškučių;3096125224;Taip;0;14;0;14
10525;Šnekutis;Viščiukų;8219465079;Taip;12;1;0;13
10526;Šnekutis;Viščiukų;5906320006;Taip;6;1;0;7
10527;Šnekutis;Viščiukų;9956077693;Ne;0;0;1;1
10528;Šnekutis;Viščiukų;5519015388;Taip;0;1;21;22
10529;Šnekutis;Viščiukų;3628210526;Taip;0;0;1;1
10530;Šnekutis;Viščiukų;3889176018;Taip;0;0;2;2
10531;Šnekutis;Viščiukų;2843483435;Taip;1;0;2;3
10532;Šnekutis;Viščiukų;7344776758;Taip;4;0;1;5
10533;Šnekutis;Viščiukų;1504945841;Taip;5;3;0;8
10534;Šnekutis;Viščiukų;6405894763;Taip;7;3;0;10
10535;Šnekutis;Viščiukų;7089000987;Taip;0;0;1;1
10536;Šnekutis;Viščiukų;3644413861;Taip;0;1;0;1
10537;Šnekutis;Viščiukų;6749848086;Taip;0;22;0;22
10538;Šnekutis;Viščiukų;6146988521;Ne;0;15;0;15
10539;Vaidilutė;Rūtelė;2131127298;Taip;0;0;1;1
10540;Vaidilutė;Rūtelė;7319037375;Taip;0;0;4;4
10541;Vaidilutė;Rūtelė;6630603158;Taip;2;0;0;2
10542;Vaidilutė;Rūtelė;4838951446;Ne;4;0;3;7
10543;Vaidilutė;Rūtelė;7494818866;Taip;0;0;2;2
10544;Vaidilutė;Rūtelė;5500950179;Taip;12;7;0;19
10545;Vaidilutė;Rūtelė;1516903980;Taip;22;0;0;22
10546;Vaidilutė;Rūtelė;1140011879;Taip;0;3;0;3
10547;Vaidilutė;Rūtelė;9563257771;Taip;3;0;0;3
10548;Vaidilutė;Rūtelė;9652684068;Taip;19;0;0;19
10549;Vaidilutė;Rūtelė;2024078532;Taip;11;0;4;15
10550;Vaidilutė;Rūtelė;5482030284;Taip;0;0;2;2
10551;Vaidilutė;Rūtelė;8505156287;Taip;8;4;0;12
10552;Vaidilutė;Rūtelė;9568450630;Taip;12;0;0;12
10553;Vaidilutė;Rūtelė;7306768961;Taip;5;6;1;12
10554;Vaidilutė;Rūtelė;7532115462;Taip;7;11;0;18
10555;Vaidilutė;Rūtelė;6896047075;Taip;6;0;0;6
10556;Vaidilutė;Rūtelė;3059654988;Ne;10;0;0;10
10557;Vaidilutė;Rūtelė;1341696594;Ne;4;0;0;4
10558;Vaidilutė;Voveraitė;1993403692;Taip;0;0;7;7
10559;Vaidilutė;Voveraitė;42503303158;Taip;4;0;2;6
10560;Vaidilutė;Voveraitė;9948685221;Taip;0;0;6;6
10561;Vaidilutė;Voveraitė;9869134464;Taip;18;0;0;18
10562;Vaidilutė;Voveraitė;29153363263;Taip;11;0;0;11
10563;Vaidilutė;Voveraitė;3069613102;Ne;0;0;1;1
10564;Vaidilutė;Voveraitė;5177060346;Ne;9;0;1;10
10565;Vaidilutė;Voveraitė;19402768340;Taip;0;6;0;6
10566;Vaidilutė;Voveraitė;4671287016;Ne;6;1;0;7
10567;Vaidilutė;Voveraitė;3600181974;Taip;0;0;4;4
10568;Vaidilutė;Voveraitė;7419525100;Taip;1;0;1;2
10569;Vaidilutė;Voveraitė;1363913645;Ne;4;3;0;7
10570;Vaidilutė;Voveraitė;5252637701;Taip;0;0;1;1
10571;Vaidilutė;Voveraitė;1320999237;Taip;8;0;0;8
10572;Vaidilutė;Voveraitė;1691407801;Taip;0;0;4;4
10573;Vaidilutė;Voveraitė;1704155743;Taip;6;4;0;10
10574;Vaidilutė;Voveraitė;1139332221;Taip;6;0;0;6
10575;Vaidilutė;Voveraitė;1297817018;Taip;0;0;22;22
10576;Vaidilutė;Voveraitė;9124975928;Taip;0;4;0;4
10577;Vaidilutė;Voveraitė;3202508790;Taip;0;0;11;11
10578;Vaidilutė;Saulutė;8492055287;Taip;12;0;0;12
10579;Vaidilutė;Saulutė;6844372910;Taip;22;0;0;22
10580;Vaidilutė;Saulutė;4972645715;Taip;13;0;2;15
10581;Vaidilutė;Saulutė;1355005114;Taip;22;0;0;22
10582;Vaidilutė;Saulutė;4680645841;Taip;4;0;0;4
10583;Vaidilutė;Saulutė;2662468804;Taip;8;1;1;10
10584;Vaidilutė;Saulutė;5217609332;Taip;0;1;4;5
10585;Vaidilutė;Saulutė;2864731541;Ne;1;1;5;7
10586;Vaidilutė;Saulutė;1998872078;Taip;2;5;1;8
10587;Vaidilutė;Saulutė;2468220275;Taip;9;1;2;12
10588;Vaidilutė;Saulutė;1610262589;Taip;10;0;0;10
10589;Vaidilutė;Saulutė;2356037175;Ne;15;0;0;15
10590;Vaidilutė;Saulutė;5054640268;Taip;6;1;0;7
10591;Vaidilutė;Saulutė;6885473308;Taip;5;6;0;11
10592;Vaidilutė;Saulutė;7826111890;Ne;5;0;2;7
10593;Vaidilutė;Saulutė;1667275889;Taip;0;1;4;5
10594;Vaidilutė;Saulutė;9870763434;Taip;22;0;0;22
10595;Vaidilutė;Saulutė;5945744595;Taip;5;3;5;13
10596;Vaidilutė;Saulutė;6674238265;Taip;0;0;5;5
10597;Vaidilutė;"Ąžuoliukas ";95291858283;Taip;1;0;0;1
10598;Vaidilutė;"Ąžuoliukas ";38331934468;Taip;6;7;0;13
10599;Vaidilutė;"Ąžuoliukas ";92269487538;Taip;5;0;5;10
10600;Vaidilutė;"Ąžuoliukas ";83614804593;Taip;0;0;1;1
10601;Vaidilutė;"Ąžuoliukas ";2176694565;Taip;0;0;1;1
10602;Vaidilutė;"Ąžuoliukas ";15308595647;Taip;0;2;0;2
10603;Vaidilutė;"Ąžuoliukas ";57981568010;Taip;0;0;1;1
10604;Vaidilutė;"Ąžuoliukas ";29245907351;Taip;0;0;1;1
10605;Vaidilutė;"Ąžuoliukas ";13343473227;Taip;0;0;1;1
10606;Vaidilutė;"Ąžuoliukas ";5737042516;Taip;0;0;2;2
10607;Vaidilutė;"Ąžuoliukas ";5785964650;Taip;3;0;2;5
10608;Vaidilutė;"Ąžuoliukas ";7036490032;Taip;7;0;0;7
10609;Vaidilutė;"Vyturėlis ";5821467408;Taip;6;0;0;6
10610;Vaidilutė;"Vyturėlis ";24445906930;Taip;6;0;0;6
10611;Vaidilutė;"Vyturėlis ";83944413409;Taip;0;1;0;1
10612;Vaidilutė;"Vyturėlis ";25654419755;Taip;0;0;8;8
10613;Vaidilutė;"Vyturėlis ";2099647381;Taip;9;0;1;10
10614;Vaidilutė;"Vyturėlis ";72248829784;Taip;0;0;1;1
10615;Vaidilutė;"Vyturėlis ";34492341585;Taip;4;1;0;5
10616;Vaidilutė;"Vyturėlis ";79964507480;Taip;0;0;2;2
10617;Vaidilutė;"Vyturėlis ";10737417556;Taip;6;0;3;9
10618;Vaidilutė;"Vyturėlis ";1416870651;Taip;0;0;1;1
10619;Vaidilutė;"Vyturėlis ";77020716708;Taip;5;0;0;5
10620;Vaidilutė;"Vyturėlis ";87401758633;Taip;0;5;0;5
10621;Vaidilutė;"Vyturėlis ";2067604305;Taip;0;0;6;6
10622;Vaidilutė;"Vyturėlis ";94210720777;Taip;0;9;0;9
10623;Vaidilutė;"Vyturėlis ";1315347184;Taip;0;3;0;3
10624;Vaidilutė;"Varpelis ";4159072583;Taip;0;0;8;8
10625;Vaidilutė;"Varpelis ";5276088687;Taip;9;0;0;9
10626;Vaidilutė;"Varpelis ";2763266518;Taip;3;0;0;3
10627;Vaidilutė;"Varpelis ";6037349527;Ne;0;0;8;8
10628;Vaidilutė;"Varpelis ";5867501558;Taip;0;1;5;6
10629;Vaidilutė;"Varpelis ";3832349858;Taip;8;0;0;8
10630;Vaidilutė;"Varpelis ";9317774960;Taip;3;0;0;3
10631;Vaidilutė;"Varpelis ";5448014291;Taip;0;0;1;1
10632;Vaidilutė;"Varpelis ";3497795848;Taip;0;0;1;1
10633;Vaidilutė;"Varpelis ";1385914020;Taip;19;0;0;19
10634;Vaidilutė;"Varpelis ";6107554047;Taip;5;0;2;7
10635;Vaidilutė;"Varpelis ";3453045619;Taip;7;1;0;8
10636;Vaidilutė;"Varpelis ";6022130248;Taip;0;0;5;5
10637;Vaidilutė;"Varpelis ";5101104226;Ne;6;0;0;6
10638;Vaidilutė;"Varpelis ";5594121340;Taip;5;0;1;6
10639;Vaidilutė;"Varpelis ";1882829340;Taip;0;0;6;6
10640;Vaidilutė;"Boružėlių ";3381544575;Taip;11;0;0;11
10641;Vaidilutė;"Boružėlių ";1305478052;Taip;6;0;0;6
10642;Vaidilutė;"Boružėlių ";6586072228;Taip;7;0;0;7
10643;Vaidilutė;"Boružėlių ";9811981645;Taip;12;0;0;12
10644;Vaidilutė;"Boružėlių ";4761992071;Taip;2;0;0;2
10645;Vaidilutė;"Boružėlių ";5307486959;Taip;0;4;0;4
10646;Vaidilutė;"Boružėlių ";1653497170;Taip;0;4;0;4
10647;Vaidilutė;"Boružėlių ";5556351358;Taip;0;2;0;2
10648;Vaidilutė;"Boružėlių ";4954285515;Taip;0;1;0;1
10649;Vaidilutė;"Boružėlių ";5439973183;Taip;16;0;0;16
10650;Vaidilutė;"Boružėlių ";1440819171;Ne;8;8;0;16
10651;Vaidilutė;"Boružėlių ";3730573432;Taip;7;0;0;7
10652;Vaidilutė;"Malūnelis ";9558983004;Taip;7;0;0;7
10653;Vaidilutė;"Malūnelis ";9689388330;Taip;16;1;0;17
10654;Vaidilutė;"Malūnelis ";2081959307;Taip;0;0;4;4
10655;Vaidilutė;"Malūnelis ";2058071219;Taip;5;0;3;8
10656;Vaidilutė;"Malūnelis ";9577869269;Taip;5;3;0;8
10657;Vaidilutė;"Malūnelis ";1417828163;Taip;0;3;0;3
10658;Vaidilutė;"Malūnelis ";5326935037;Taip;3;0;0;3
10659;Vaidilutė;"Malūnelis ";2189753894;Taip;0;4;0;4
10660;Vaidilutė;"Malūnelis ";4230076320;Taip;11;0;4;15
10661;Vaidilutė;"Malūnelis ";4388069915;Taip;3;1;1;5
10662;Vaidilutė;"Malūnelis ";9584702487;Taip;1;1;0;2
10663;Vaidilutė;"Malūnelis ";8882402632;Taip;4;1;0;5
10664;Vaidilutė;"Riešutėlis ";1986162951;Taip;0;10;1;11
10665;Vaidilutė;"Riešutėlis ";1941081703;Taip;0;0;7;7
10666;Vaidilutė;"Riešutėlis ";87621682081;Taip;0;5;0;5
10667;Vaidilutė;"Riešutėlis ";76613866916;Taip;2;0;0;2
10668;Vaidilutė;"Riešutėlis ";1942402815;Ne;1;1;1;3
10669;Vaidilutė;"Riešutėlis ";13133501690;Taip;2;0;0;2
10670;Vaidilutė;"Riešutėlis ";8543285470;Taip;0;0;5;5
10671;Vaidilutė;"Riešutėlis ";3962268551;Ne;0;22;0;22
10672;Vaidilutė;"Riešutėlis ";19413698194;Taip;0;0;2;2
10673;Vaidilutė;"Riešutėlis ";83887347923;Taip;4;0;3;7
10674;Vaidilutė;"Riešutėlis ";69452750985;Taip;0;0;4;4
10675;Vaidilutė;"Riešutėlis ";44867291232;Taip;4;5;1;10
10676;Vaidilutė;"Riešutėlis ";38698526742;Ne;0;3;0;3
10677;Vaidilutė;"Riešutėlis ";1664595920;Taip;0;0;2;2
10678;Vaidilutė;"Riešutėlis ";1608286003;Taip;0;3;1;4
10679;Vaidilutė;"Riešutėlis ";1083096707;Ne;1;4;0;5
10680;Vaidilutė;"Riešutėlis ";1405802722;Taip;5;1;0;6
10681;Vaidilutė;"Riešutėlis ";67830476121;Taip;13;0;2;15
10682;Vaidilutė;"Riešutėlis ";3243266869;Taip;4;0;1;5
10683;Vandenis;ŽUVĖDRŲ;52063106839;Taip;0;1;0;1
10684;Vandenis;ŽUVĖDRŲ;83799061370;Taip;14;0;0;14
10685;Vandenis;ŽUVĖDRŲ;96459201904;Taip;11;0;0;11
10686;Vandenis;ŽUVĖDRŲ;49204161380;Taip;0;7;0;7
10687;Vandenis;ŽUVĖDRŲ;67472126318;Taip;0;1;0;1
10688;Vandenis;ŽUVĖDRŲ;32749176064;Taip;0;1;0;1
10689;Vandenis;ŽUVĖDRŲ;80186166441;Taip;2;0;0;2
10690;Vandenis;ŽUVĖDRŲ;4045401354;Ne;4;2;0;6
10691;Vandenis;ŽUVĖDRŲ;41376432095;Taip;0;4;0;4
10692;Vandenis;ŽUVĖDRŲ;62877843868;Ne;0;5;0;5
10693;Vandenis;ŽUVĖDRŲ;85287618619;Taip;0;21;0;21
10694;Vandenis;ŽUVĖDRŲ;3639803910;Taip;0;2;0;2
10695;Vandenis;ŽUVĖDRŲ;35581230147;Ne;0;12;0;12
10696;Vandenis;ŽUVĖDRŲ;22764351701;Taip;0;7;0;7
10697;Vandenis;ŽUVĖDRŲ;92857304500;Taip;4;0;0;4
10698;Vandenis;ŽUVĖDRŲ;55952119623;Ne;0;3;0;3
10699;Vandenis;ŽUVĖDRŲ;58324898715;Taip;0;1;0;1
10700;Vandenis;ŽUVĖDRŲ;56648967396;Taip;0;3;0;3
10701;Vandenis;ŽUVĖDRŲ;87398241763;Taip;5;0;0;5
10702;Vandenis;ŽUVĖDRŲ;48908599635;Taip;0;5;0;5
10703;Vandenis;RUONIUKŲ;2422642232;Taip;0;0;8;8
10704;Vandenis;RUONIUKŲ;1051281257;Taip;0;0;8;8
10705;Vandenis;RUONIUKŲ;7565308536;Taip;0;4;0;4
10706;Vandenis;RUONIUKŲ;9518434896;Taip;0;2;0;2
10707;Vandenis;RUONIUKŲ;1120907086;Taip;7;0;0;7
10708;Vandenis;RUONIUKŲ;7702272913;Taip;6;4;0;10
10709;Vandenis;RUONIUKŲ;6476051751;Taip;0;8;0;8
10710;Vandenis;RUONIUKŲ;9162936403;Ne;4;1;0;5
10711;Vandenis;RUONIUKŲ;4713395766;Taip;0;1;0;1
10712;Vandenis;RUONIUKŲ;6986724058;Taip;0;1;0;1
10713;Vandenis;RUONIUKŲ;7754158588;Taip;0;0;3;3
10714;Vandenis;RUONIUKŲ;9527253920;Taip;4;2;5;11
10715;Vandenis;RUONIUKŲ;8971291182;Taip;9;0;1;10
10716;Vandenis;RUONIUKŲ;6330187732;Ne;11;2;0;13
10717;Vandenis;RUONIUKŲ;9688954631;Ne;0;12;0;12
10718;Vandenis;RUONIUKŲ;8729351613;Taip;13;1;0;14
10719;Vandenis;RUONIUKŲ;4971165639;Ne;0;2;0;2
10720;Vandenis;ŽUVYČIŲ;28286348996;Taip;0;4;0;4
10721;Vandenis;ŽUVYČIŲ;2494327284;Taip;0;0;3;3
10722;Vandenis;ŽUVYČIŲ;47333381244;Taip;10;1;0;11
10723;Vandenis;ŽUVYČIŲ;20458211098;Taip;0;9;0;9
10724;Vandenis;ŽUVYČIŲ;95498596116;Ne;0;3;0;3
10725;Vandenis;ŽUVYČIŲ;39662768043;Taip;0;0;6;6
10726;Vandenis;ŽUVYČIŲ;391453841;Ne;10;3;0;13
10727;Vandenis;ŽUVYČIŲ;32087433270;Taip;13;1;0;14
10728;Vandenis;ŽUVYČIŲ;50009330411;Taip;0;1;0;1
10729;Vandenis;ŽUVYČIŲ;18310147466;Taip;0;6;0;6
10730;Vandenis;ŽUVYČIŲ;318399174;Taip;6;1;0;7
10731;Vandenis;ŽUVYČIŲ;57251416305;Taip;0;22;0;22
10732;Vandenis;ŽUVYČIŲ;54659569326;Taip;4;0;0;4
10733;Vandenis;ŽUVYČIŲ;69485657846;Taip;4;2;0;6
10734;Vandenis;ŽUVYČIŲ;54762939917;Taip;2;0;0;2
10735;Vandenis;ŽUVYČIŲ;45362889638;Taip;0;4;0;4
10736;Vandenis;ŽUVYČIŲ;33177236893;Taip;11;0;0;11
10737;Vandenis;ŽUVYČIŲ;23752943243;Ne;5;2;0;7
10738;Vandenis;ŽUVYČIŲ;35977990277;Ne;9;2;0;11
10739;Vandenis;ŽUVYČIŲ;59487083886;Taip;3;2;1;6
10740;Vandenis;ŽUVYČIŲ;51472939588;Taip;0;4;1;5
10741;Vandenis;ŽUVYČIŲ;1493719754;Taip;10;2;0;12
10742;Vandenis;PERLIUKŲ;8678508812;Taip;0;3;0;3
10743;Vandenis;PERLIUKŲ;2645775090;Taip;0;9;0;9
10744;Vandenis;PERLIUKŲ;5844576485;Taip;5;0;2;7
10745;Vandenis;PERLIUKŲ;6295009202;Taip;0;3;0;3
10746;Vandenis;PERLIUKŲ;7598257845;Taip;2;0;0;2
10747;Vandenis;PERLIUKŲ;7473692892;Ne;15;1;0;16
10748;Vandenis;PERLIUKŲ;5323428164;Ne;0;2;0;2
10749;Vandenis;PERLIUKŲ;1511740350;Taip;2;0;0;2
10750;Vandenis;PERLIUKŲ;2576575249;Taip;0;6;0;6
10751;Vandenis;PERLIUKŲ;9798192239;Taip;0;1;0;1
10752;Vandenis;PERLIUKŲ;1975385430;Taip;0;8;0;8
10753;Vandenis;PERLIUKŲ;3061606138;Ne;0;2;0;2
10754;Vandenis;PERLIUKŲ;8117385209;Taip;2;0;0;2
10755;Vandenis;PERLIUKŲ;5613067534;Taip;2;2;1;5
10756;Vandenis;PERLIUKŲ;2321919298;Taip;22;0;0;22
10757;Vandenis;PERLIUKŲ;5963181638;Ne;0;5;0;5
10758;Vandenis;PERLIUKŲ;5609737826;Taip;0;5;2;7
10759;Vandenis;ANČIUKŲ;8233407105;Taip;0;2;2;4
10760;Vandenis;ANČIUKŲ;1282499654;Taip;11;0;0;11
10761;Vandenis;ANČIUKŲ;3578947540;Ne;0;5;0;5
10762;Vandenis;ANČIUKŲ;5395847317;Taip;0;1;0;1
10763;Vandenis;ANČIUKŲ;3938359901;Taip;5;0;0;5
10764;Vandenis;ANČIUKŲ;1314724267;Taip;8;2;0;10
10765;Vandenis;ANČIUKŲ;8251169901;Ne;0;4;0;4
10766;Vandenis;ANČIUKŲ;4750141780;Taip;4;0;0;4
10767;Vandenis;ANČIUKŲ;6181866272;Taip;4;5;0;9
10768;Vandenis;ANČIUKŲ;7522472652;Taip;10;0;0;10
10769;Vandenis;ANČIUKŲ;7630017843;Taip;0;3;0;3
10770;Vandenis;ANČIUKŲ;1222539247;Taip;0;1;0;1
10771;Vandenis;ANČIUKŲ;3067868099;Taip;0;4;0;4
10772;Vandenis;ANČIUKŲ;8511948282;Ne;4;2;0;6
10773;Vandenis;ANČIUKŲ;33317650043;Ne;6;1;0;7
10774;Vandenis;ANČIUKŲ;1739780612;Ne;13;2;0;15
10775;Vandenis;ANČIUKŲ;2489776665;Taip;0;5;3;8
10776;Vandenis;ANČIUKŲ;71786730314;Taip;11;0;0;11
10777;Vandenis;ANČIUKŲ;1621481561;Ne;0;9;0;9
10778;Vandenis;ANČIUKŲ;33782837791;Taip;0;2;0;2
10779;Vandenis;VĖŽLIUKŲ;2309166304;Taip;0;4;0;4
10780;Vandenis;VĖŽLIUKŲ;5454049563;Taip;10;1;0;11
10781;Vandenis;VĖŽLIUKŲ;9805578141;Taip;10;1;0;11
10782;Vandenis;VĖŽLIUKŲ;8921666108;Taip;13;0;0;13
10783;Vandenis;VĖŽLIUKŲ;8116532445;Taip;0;4;0;4
10784;Vandenis;VĖŽLIUKŲ;7069369080;Taip;0;5;0;5
10785;Vandenis;VĖŽLIUKŲ;7924399684;Taip;0;3;0;3
10786;Vandenis;VĖŽLIUKŲ;1187395353;Taip;0;10;0;10
10787;Vandenis;VĖŽLIUKŲ;7091356848;Taip;0;7;0;7
10788;Vandenis;VĖŽLIUKŲ;1081385111;Taip;3;0;0;3
10789;Vandenis;VĖŽLIUKŲ;5126732658;Taip;8;0;0;8
10790;Vandenis;VĖŽLIUKŲ;7059385610;Taip;4;4;0;8
10791;Vandenis;VĖŽLIUKŲ;9158541919;Taip;4;2;0;6
10792;Vandenis;VĖŽLIUKŲ;5959181898;Taip;4;2;0;6
10793;Vandenis;VĖŽLIUKŲ;1707354287;Taip;0;5;0;5
10794;Vandenis;VĖŽLIUKŲ;4413648496;Taip;22;0;0;22
10795;Vandenis;VĖŽLIUKŲ;9704394568;Ne;13;1;0;14
10796;Vandenis;VĖŽLIUKŲ;4177166475;Taip;0;2;0;2
10797;Vandenis;VĖŽLIUKŲ;5218101579;Taip;1;4;0;5
10798;Vandenis;VĖŽLIUKŲ;8416839037;Taip;6;2;0;8
10799;Vandenis;VĖŽLIUKŲ;2936885357;Taip;15;0;0;15
10800;Vandenis;AŠTUNKOJŲ;39832993343;Taip;0;1;0;1
10801;Vandenis;AŠTUNKOJŲ;70732367996;Ne;0;2;0;2
10802;Vandenis;AŠTUNKOJŲ;2056980868;Ne;3;2;1;6
10803;Vandenis;AŠTUNKOJŲ;17644420312;Taip;0;1;0;1
10804;Vandenis;AŠTUNKOJŲ;26057060619;Taip;0;2;0;2
10805;Vandenis;AŠTUNKOJŲ;55331810310;Taip;4;12;0;16
10806;Vandenis;AŠTUNKOJŲ;48194812760;Taip;3;0;0;3
10807;Vandenis;AŠTUNKOJŲ;84025519453;Taip;0;2;0;2
10808;Vandenis;AŠTUNKOJŲ;5363853315;Taip;0;2;1;3
10809;Vandenis;AŠTUNKOJŲ;85054617489;Taip;0;4;0;4
10810;Vandenis;AŠTUNKOJŲ;61521559336;Taip;0;6;0;6
10811;Vandenis;AŠTUNKOJŲ;87310831307;Taip;0;4;0;4
10812;Vandenis;AŠTUNKOJŲ;63629799884;Taip;0;1;0;1
10813;Vandenis;AŠTUNKOJŲ;92286914041;Taip;0;2;1;3
10814;Vandenis;AŠTUNKOJŲ;2120420294;Taip;0;4;0;4
10815;Vandenis;AŠTUNKOJŲ;1646554203;Taip;0;5;0;5
10816;Vandenis;GANDRIUKŲ;8367599264;Taip;0;1;0;1
10817;Vandenis;GANDRIUKŲ;94471245079;Taip;0;1;0;1
10818;Vandenis;GANDRIUKŲ;53737587501;Taip;0;5;0;5
10819;Vandenis;GANDRIUKŲ;67409458110;Ne;0;0;1;1
10820;Vandenis;GANDRIUKŲ;1945164524;Taip;0;2;0;2
10821;Vandenis;GANDRIUKŲ;38894447952;Ne;0;1;0;1
10822;Vandenis;GANDRIUKŲ;2117594123;Ne;0;5;0;5
10823;Vandenis;GANDRIUKŲ;1924693472;Taip;0;1;0;1
10824;Vandenis;GANDRIUKŲ;61110317694;Taip;7;1;0;8
10825;Vandenis;GANDRIUKŲ;5716325525;Taip;0;5;0;5
10826;Vandenis;GANDRIUKŲ;1650529956;Taip;6;1;0;7
10827;Vandenis;GANDRIUKŲ;2447879418;Taip;0;2;0;2
10828;Vandenis;GANDRIUKŲ;7591129504;Taip;3;0;0;3
10829;Vandenis;GANDRIUKŲ;44800276421;Taip;0;1;0;1
10830;Vandenis;GANDRIUKŲ;91774614891;Taip;8;0;0;8
10831;Vandenis;GANDRIUKŲ;1944730492;Taip;0;1;0;1
10832;Vandenis;GANDRIUKŲ;26193472997;Taip;0;12;0;12
10833;Vandenis;GANDRIUKŲ;75077443996;Ne;0;1;0;1
10834;Vandenis;ŽĄSIUKAI;80643665990;Taip;0;2;0;2
10835;Vandenis;ŽĄSIUKAI;74138671368;Taip;0;3;3;6
10836;Vandenis;ŽĄSIUKAI;25459674313;Taip;5;3;0;8
10837;Vandenis;ŽĄSIUKAI;2812520834;Taip;0;3;0;3
10838;Vandenis;ŽĄSIUKAI;1286716632;Taip;0;2;0;2
10839;Vandenis;ŽĄSIUKAI;11527007102;Taip;5;0;0;5
10840;Vandenis;ŽĄSIUKAI;1373653402;Taip;5;2;0;7
10841;Vandenis;ŽĄSIUKAI;65840410497;Taip;0;4;0;4
10842;Vandenis;ŽĄSIUKAI;53658866238;Taip;5;9;0;14
10843;Vandenis;ŽĄSIUKAI;1217508516;Taip;0;4;0;4
10844;Vandenis;ŽĄSIUKAI;55238344586;Taip;5;2;0;7
10845;Vandenis;ŽĄSIUKAI;25934798454;Taip;4;0;0;4
10846;Vandenis;ŽĄSIUKAI;2029167786;Taip;0;1;0;1
10847;Vandenis;ŽĄSIUKAI;23439586487;Taip;6;0;0;6
10848;Vandenis;ŽĄSIUKAI;78917527699;Taip;5;6;0;11
10849;Vandenis;ŽĄSIUKAI;1397125827;Taip;0;2;0;2
10850;Vandenis;ŽĄSIUKAI;46916815441;Taip;0;2;2;4
10851;Vandenis;ŽĄSIUKAI;1155423158;Taip;0;9;0;9
10852;Vandenis;ŽĄSIUKAI;7333587583;Taip;10;2;0;12
10853;Vandenis;ŽĄSIUKAI;18417531508;Taip;0;9;0;9
10854;Vandenis;ŽĄSIUKAI;5797629313;Taip;0;1;0;1
10855;Vandenis;PURIENŲ;2114436962;Ne;0;2;0;2
10856;Vandenis;PURIENŲ;3823382249;Taip;5;1;0;6
10857;Vandenis;PURIENŲ;43295720034;Ne;0;3;0;3
10858;Vandenis;PURIENŲ;84636435681;Taip;14;8;0;22
10859;Vandenis;PURIENŲ;1958929302;Taip;0;4;0;4
10860;Vandenis;PURIENŲ;39973189502;Taip;4;0;2;6
10861;Vandenis;PURIENŲ;2096950367;Taip;0;8;0;8
10862;Vandenis;PURIENŲ;1633589144;Ne;0;1;0;1
10863;Vandenis;PURIENŲ;1854498462;Taip;0;9;0;9
10864;Vandenis;PURIENŲ;7467699979;Taip;0;1;0;1
10865;Vandenis;PURIENŲ;6673346389;Ne;0;2;0;2
10866;Vandenis;PURIENŲ;58997790744;Taip;1;0;0;1
10867;Vandenis;PURIENŲ;61120985165;Taip;0;1;0;1
10868;Vandenis;PURIENŲ;81817138188;Taip;4;3;0;7
10869;Vandenis;PURIENŲ;1395272045;Taip;8;1;0;9
10870;Vandenis;VARLIUKAI;2960005490;Taip;4;2;2;8
10871;Vandenis;VARLIUKAI;1180322026;Taip;4;2;2;8
10872;Vandenis;VARLIUKAI;2719678617;Taip;0;1;0;1
10873;Vandenis;VARLIUKAI;7171302906;Taip;14;3;0;17
10874;Vandenis;VARLIUKAI;8085633453;Taip;14;3;0;17
10875;Vandenis;VARLIUKAI;5764809162;Taip;3;2;2;7
10876;Vandenis;VARLIUKAI;2315167746;Ne;0;1;0;1
10877;Vandenis;VARLIUKAI;6332179750;Taip;0;1;0;1
10878;Vandenis;VARLIUKAI;6027680514;Taip;8;0;0;8
10879;Vandenis;PINGVINAI;9994373029;Taip;4;1;0;5
10880;Vandenis;PINGVINAI;3544717790;Taip;0;2;0;2
10881;Vandenis;PINGVINAI;4085256182;Taip;0;1;0;1
10882;Vandenis;PINGVINAI;18336904438;Taip;0;3;0;3
10883;Vandenis;PINGVINAI;8689134931;Taip;0;2;0;2
10884;Vandenis;PINGVINAI;64711327503;Taip;0;14;0;14
10885;Vandenis;PINGVINAI;7381695975;Taip;4;1;0;5
10886;Vandenis;PINGVINAI;43933878402;Taip;6;0;0;6
10887;Vandenis;PINGVINAI;55421695186;Taip;3;2;0;5
10888;Vandenis;PINGVINAI;24217366528;Taip;4;1;0;5
10889;Vandenis;PINGVINAI;5549292096;Taip;6;2;0;8
10890;Vandenis;PINGVINAI;4643267945;Taip;0;14;0;14
10891;Vandenis;PINGVINAI;8430706407;Ne;0;1;0;1
10892;Vandenis;PINGVINAI;1535450614;Taip;0;8;0;8
10893;Vandenis;PINGVINAI;35673258175;Taip;0;6;5;11
10894;Vandenis;PINGVINAI;27409922803;Taip;4;1;0;5
10895;Vandenis;PINGVINAI;1598122777;Ne;2;0;0;2
10896;Vandenis;PINGVINAI;1815765498;Taip;4;0;0;4
10897;Vėjelis;Pumpurėliai;89672883586;Taip;3;0;2;5
10898;Vėjelis;Pumpurėliai;2647629246;Taip;9;0;3;12
10899;Vėjelis;Pumpurėliai;31795519758;Taip;0;0;3;3
10900;Vėjelis;Pumpurėliai;1712263816;Taip;0;0;5;5
10901;Vėjelis;Pumpurėliai;49983865253;Taip;5;0;9;14
10902;Vėjelis;Pumpurėliai;90185075321;Taip;4;1;0;5
10903;Vėjelis;Pumpurėliai;1640356242;Taip;0;6;0;6
10904;Vėjelis;Pumpurėliai;86128256406;Taip;3;3;1;7
10905;Vėjelis;Pumpurėliai;77205958956;Taip;3;2;1;6
10906;Vėjelis;Pumpurėliai;2718251356;Taip;0;1;2;3
10907;Vėjelis;Pumpurėliai;1988459596;Taip;0;0;2;2
10908;Vėjelis;Pumpurėliai;64339770365;Taip;0;22;0;22
10909;Vėjelis;Pumpurėliai;75596757609;Taip;1;0;1;2
10910;Vėjelis;Pumpurėliai;1934426525;Taip;8;1;0;9
10911;Vėjelis;Pumpurėliai;44153389025;Taip;9;0;0;9
10912;Vėjelis;Pumpurėliai;1921039937;Taip;0;0;1;1
10913;Vėjelis;Pumpurėliai;57285479257;Taip;0;0;3;3
10914;Vėjelis;Pumpurėliai;93219773975;Taip;0;0;5;5
10915;Vėjelis;Pumpurėliai;8198463045;Taip;4;0;1;5
10916;Vėjelis;Pumpurėliai;2721810040;Taip;0;0;4;4
10917;Vėjelis;Drugeliai;4746932126;Taip;5;2;0;7
10918;Vėjelis;Drugeliai;8353084814;Taip;0;0;7;7
10919;Vėjelis;Drugeliai;1115802837;Ne;22;0;0;22
10920;Vėjelis;Drugeliai;4741154518;Taip;10;0;0;10
10921;Vėjelis;Drugeliai;1494531065;Taip;3;6;1;10
10922;Vėjelis;Drugeliai;9298789434;Taip;4;4;0;8
10923;Vėjelis;Drugeliai;2734024890;Taip;15;4;0;19
10924;Vėjelis;Drugeliai;7981032872;Taip;8;0;11;19
10925;Vėjelis;Drugeliai;7752923796;Taip;4;0;1;5
10926;Vėjelis;Drugeliai;7594586198;Taip;0;0;5;5
10927;Vėjelis;Drugeliai;7697394469;Taip;0;0;6;6
10928;Vėjelis;Drugeliai;4066956765;Ne;10;0;0;10
10929;Vėjelis;Drugeliai;1571064934;Taip;0;0;3;3
10930;Vėjelis;Drugeliai;2788205363;Taip;11;0;1;12
10931;Vėjelis;Drugeliai;1331334220;Taip;2;8;5;15
10932;Vėjelis;Drugeliai;2151737048;Taip;0;16;0;16
10933;Vėjelis;Drugeliai;3276062426;Taip;8;0;7;15
10934;Vėjelis;Malūnėlis;20148908290;Taip;0;6;0;6
10935;Vėjelis;Malūnėlis;90926729186;Taip;4;1;0;5
10936;Vėjelis;Malūnėlis;39671245978;Taip;4;3;0;7
10937;Vėjelis;Malūnėlis;68958036563;Taip;4;12;0;16
10938;Vėjelis;Malūnėlis;20593684676;Taip;3;1;0;4
10939;Vėjelis;Malūnėlis;14502736200;Taip;0;0;8;8
10940;Vėjelis;Malūnėlis;98024305748;Taip;0;2;0;2
10941;Vėjelis;Malūnėlis;5468993286;Taip;0;1;0;1
10942;Vėjelis;Malūnėlis;46167493039;Taip;0;2;0;2
10943;Vėjelis;Malūnėlis;1267672356;Taip;0;1;0;1
10944;Vėjelis;Malūnėlis;2021887954;Taip;0;2;1;3
10945;Vėjelis;Malūnėlis;1284286578;Ne;2;0;3;5
10946;Vėjelis;Malūnėlis;1789982154;Taip;0;8;0;8
10947;Vėjelis;Malūnėlis;54924516732;Taip;1;7;0;8
10948;Vėjelis;Malūnėlis;1242928700;Taip;0;6;0;6
10949;Vėjelis;Malūnėlis;9826410933;Taip;3;0;0;3
10950;Vėjelis;Malūnėlis;4110537888;Taip;7;0;0;7
10951;Vėjelis;Malūnėlis;44482585723;Taip;0;1;0;1
10952;Vėjelis;Žvaigždutės;98588113289;Taip;0;3;0;3
10953;Vėjelis;Žvaigždutės;1612878387;Taip;0;1;2;3
10954;Vėjelis;Žvaigždutės;3485366651;Taip;0;12;0;12
10955;Vėjelis;Žvaigždutės;5139323880;Ne;0;0;1;1
10956;Vėjelis;Žvaigždutės;2363974247;Taip;8;0;1;9
10957;Vėjelis;Žvaigždutės;8379298947;Taip;8;0;1;9
10958;Vėjelis;Žvaigždutės;8973530484;Taip;7;0;8;15
10959;Vėjelis;Žvaigždutės;69341469387;Ne;9;5;0;14
10960;Vėjelis;Žvaigždutės;9190085358;Taip;10;5;0;15
10961;Vėjelis;Žvaigždutės;8949760376;Taip;8;0;3;11
10962;Vėjelis;Žvaigždutės;6002719498;Taip;0;15;0;15
10963;Vėjelis;Žvaigždutės;9000966115;Ne;0;2;0;2
10964;Vėjelis;Žvaigždutės;4230144743;Taip;0;10;0;10
10965;Vėjelis;Žvaigždutės;78490601352;Taip;7;0;0;7
10966;Vėjelis;Žvaigždutės;3255066035;Taip;22;0;0;22
10967;Vėjelis;Žvaigždutės;76305473353;Taip;9;0;5;14
10968;Vėjelis;Žvaigždutės;73287916371;Taip;0;12;0;12
10969;Vėjelis;Žvaigždutės;41673970488;Taip;5;5;0;10
10970;Vėjelis;Žvaigždutės;5396347620;Taip;0;1;0;1
10971;Vėjelis;Žvaigždutės;50124109589;Ne;0;17;0;17
10972;Vėjelis;Varpeliai;28696711850;Taip;1;6;0;7
10973;Vėjelis;Varpeliai;8787363287;Taip;7;0;1;8
10974;Vėjelis;Varpeliai;71456994638;Taip;0;1;0;1
10975;Vėjelis;Varpeliai;86680640521;Taip;1;8;0;9
10976;Vėjelis;Varpeliai;1944266562;Taip;9;0;0;9
10977;Vėjelis;Varpeliai;80942260332;Taip;0;6;0;6
10978;Vėjelis;Varpeliai;8389094301;Taip;0;2;3;5
10979;Vėjelis;Varpeliai;6745229012;Ne;0;0;2;2
10980;Vėjelis;Varpeliai;90647333398;Taip;0;0;2;2
10981;Vėjelis;Varpeliai;40744700561;Taip;0;6;0;6
10982;Vėjelis;Varpeliai;47143492836;Taip;0;0;1;1
10983;Vėjelis;Varpeliai;1295818672;Ne;14;0;0;14
10984;Vėjelis;Varpeliai;1930159743;Taip;0;2;0;2
10985;Vėjelis;Varpeliai;1540879634;Ne;0;0;1;1
10986;Vėjelis;Varpeliai;56520156825;Taip;0;6;0;6
10987;Vėjelis;Varpeliai;3256138691;Ne;4;0;0;4
10988;Vėjelis;Pelėdžiukų;1238171728;Taip;3;0;0;3
10989;Vėjelis;Pelėdžiukų;4024898537;Taip;0;1;0;1
10990;Vėjelis;Pelėdžiukų;24011371444;Taip;5;0;0;5
10991;Vėjelis;Pelėdžiukų;2819491961;Taip;0;0;8;8
10992;Vėjelis;Pelėdžiukų;1783878104;Taip;9;0;0;9
10993;Vėjelis;Pelėdžiukų;55075988807;Taip;1;0;0;1
10994;Vėjelis;Pelėdžiukų;1510415602;Taip;3;0;7;10
10995;Vėjelis;Pelėdžiukų;2042863944;Taip;0;11;0;11
10996;Vėjelis;Pelėdžiukų;5992665537;Taip;0;10;0;10
10997;Vėjelis;Pelėdžiukų;1347855869;Taip;0;1;0;1
10998;Vėjelis;Pelėdžiukų;1990674632;Taip;0;10;0;10
10999;Vėjelis;Pelėdžiukų;6618114389;Taip;0;0;10;10
11000;Vėjelis;Pelėdžiukų;1518855620;Taip;0;9;0;9
11001;Vėjelis;Pelėdžiukų;4930807661;Ne;4;0;2;6
11002;Vėjelis;Pelėdžiukų;2128818222;Ne;6;0;4;10
11003;Vėjelis;Pelėdžiukų;1603377234;Taip;0;2;6;8
11004;Vėjelis;Pelėdžiukų;5001661462;Taip;2;0;0;2
11005;Vėjelis;Pelėdžiukų;8304310182;Ne;9;1;0;10
11006;Vėjelis;Pelėdžiukų;6856583336;Ne;11;1;0;12
11007;Vėjelis;Skruzdeliukų;3910688753;Ne;0;0;4;4
11008;Vėjelis;Skruzdeliukų;2167025998;Taip;0;4;1;5
11009;Vėjelis;Skruzdeliukų;2467377103;Taip;0;0;2;2
11010;Vėjelis;Skruzdeliukų;7400967836;Taip;4;0;0;4
11011;Vėjelis;Skruzdeliukų;8470977526;Taip;0;3;0;3
11012;Vėjelis;Skruzdeliukų;1952141664;Taip;14;0;6;20
11013;Vėjelis;Skruzdeliukų;12087873516;Taip;0;13;0;13
11014;Vėjelis;Skruzdeliukų;7610485310;Taip;0;7;0;7
11015;Vėjelis;Skruzdeliukų;2282796452;Taip;0;7;0;7
11016;Vėjelis;Skruzdeliukų;1551143643;Taip;9;0;4;13
11017;Vėjelis;Skruzdeliukų;7771422316;Taip;0;1;0;1
11018;Vėjelis;Skruzdeliukų;8941647789;Taip;0;0;1;1
11019;Vėjelis;Skruzdeliukų;41268510292;Taip;4;4;0;8
11020;Vėjelis;Skruzdeliukų;1534169381;Taip;9;4;0;13
11021;Vėjelis;Skruzdeliukų;4508775250;Taip;9;6;0;15
11022;Vėjelis;Skruzdeliukų;4992783345;Taip;0;8;0;8
11023;Vėjelis;Skruzdeliukų;1555270425;Taip;0;11;0;11
11024;Vėjelis;Skruzdeliukų;2957105835;Taip;0;1;0;1
11025;Vėjelis;Pieštukų;4868574574;Taip;1;0;0;1
11026;Vėjelis;Pieštukų;60890519853;Taip;0;1;0;1
11027;Vėjelis;Pieštukų;8386409466;Taip;22;0;0;22
11028;Vėjelis;Pieštukų;9492690970;Ne;6;0;0;6
11029;Vėjelis;Pieštukų;6386092350;Taip;0;15;0;15
11030;Vėjelis;Pieštukų;8684461171;Taip;0;11;0;11
11031;Vėjelis;Pieštukų;9395929106;Ne;0;18;0;18
11032;Vėjelis;Pieštukų;1205392813;Ne;0;6;0;6
11033;Vėjelis;Pieštukų;5031781196;Taip;2;0;0;2
11034;Vėjelis;Pieštukų;7133454882;Taip;0;7;0;7
11035;Vėjelis;Pieštukų;8866974952;Taip;0;1;0;1
11036;Vėjelis;Pieštukų;2117924725;Taip;13;0;0;13
11037;Vėjelis;Pieštukų;1436893015;Ne;18;0;0;18
11038;Vėjelis;Pieštukų;1549518622;Taip;7;0;13;20
11039;Vėjelis;Pieštukų;6844704326;Taip;3;0;1;4
11040;Vėjelis;Pieštukų;8300497094;Taip;6;0;1;7
11041;Vėjelis;Pieštukų;4219672982;Taip;7;0;0;7
11042;Vėjelis;Pieštukų;2132551615;Ne;0;11;11;22
11043;Vėjelis;Ramunėlių;5987294293;Taip;0;13;0;13
11044;Vėjelis;Ramunėlių;8047799576;Taip;19;3;0;22
11045;Vėjelis;Ramunėlių;4745262277;Ne;9;0;0;9
11046;Vėjelis;Ramunėlių;4353239658;Ne;1;1;0;2
11047;Vėjelis;Ramunėlių;7178844364;Ne;19;0;0;19
11048;Vėjelis;Ramunėlių;2386927970;Taip;8;2;0;10
11049;Vėjelis;Ramunėlių;2124857941;Ne;15;0;0;15
11050;Vėjelis;Ramunėlių;6455798848;Taip;0;1;0;1
11051;Vėjelis;Ramunėlių;6996900411;Taip;11;2;0;13
11052;Vėjelis;Ramunėlių;2289954824;Taip;6;3;0;9
11053;Vėjelis;Ramunėlių;6777528441;Taip;0;6;0;6
11054;Vėjelis;Ramunėlių;6891260701;Taip;0;7;0;7
11055;Vėjelis;Ramunėlių;4733227215;Taip;14;0;0;14
11056;Vėjelis;Ramunėlių;5909697341;Taip;0;9;0;9
11057;Vėjelis;Ramunėlių;6451722893;Taip;13;1;0;14
11058;Vėjelis;Ramunėlių;1381191703;Ne;5;3;0;8
11059;Vėjelis;Ramunėlių;9042329808;Taip;4;1;0;5
11060;Vėjelis;Nykštukai;1022888418;Taip;5;1;1;7
11061;Vėjelis;Nykštukai;6660799519;Taip;9;0;0;9
11062;Vėjelis;Nykštukai;2522750651;Taip;0;22;0;22
11063;Vėjelis;Nykštukai;4433799070;Taip;7;0;0;7
11064;Vėjelis;Nykštukai;1235788079;Ne;13;1;0;14
11065;Vėjelis;Nykštukai;2371667380;Taip;12;2;0;14
11066;Vėjelis;Nykštukai;4988352741;Taip;0;3;0;3
11067;Vėjelis;Nykštukai;9625857378;Taip;16;0;0;16
11068;Vėjelis;Nykštukai;8054114720;Taip;0;5;0;5
11069;Vėjelis;Nykštukai;2866394056;Taip;13;1;0;14
11070;Vėjelis;Nykštukai;1862173525;Taip;0;3;0;3
11071;Vėjelis;Nykštukai;3524350131;Taip;4;1;0;5
11072;Vėjelis;Nykštukai;5516672613;Taip;7;0;0;7
11073;Vėjelis;Nykštukai;6061966626;Taip;7;0;0;7
11074;Vėjelis;Nykštukai;7790713917;Taip;16;0;0;16
11075;Vėjelis;Nykštukai;6772736175;Taip;0;0;19;19
11076;Vėjelis;Nykštukai;2917197418;Taip;0;22;0;22
11077;Vėjelis;Nykštukai;4506243333;Taip;10;1;0;11
11078;Vėjelis;BITUTĖS;5902455219;Taip;0;1;0;1
11079;Vėjelis;BITUTĖS;48694326383;Taip;0;1;0;1
11080;Vėjelis;BITUTĖS;4831426440;Taip;0;1;3;4
11081;Vėjelis;BITUTĖS;74475070018;Taip;0;7;0;7
11082;Vėjelis;BITUTĖS;6724813553;Ne;4;2;0;6
11083;Vėjelis;BITUTĖS;5508269515;Taip;12;5;0;17
11084;Vėjelis;BITUTĖS;8998452731;Ne;0;6;0;6
11085;Vėjelis;BITUTĖS;9672929606;Ne;5;1;2;8
11086;Vėjelis;BITUTĖS;9754373141;Taip;8;0;2;10
11087;Vėjelis;BITUTĖS;4906958328;Ne;0;1;4;5
11088;Vėjelis;BITUTĖS;43342043904;Ne;0;3;0;3
11089;Vėjelis;BITUTĖS;89943712210;Ne;0;1;0;1
11090;Vėjelis;BITUTĖS;64628040227;Ne;6;6;0;12
11091;Vėjelis;BITUTĖS;22865699640;Ne;0;1;0;1
11092;Vėjelis;BITUTĖS;1008705526;Taip;1;1;0;2
11093;Vėjelis;BITUTĖS;1251348150;Ne;0;12;0;12
11094;Vėjelis;BITUTĖS;5207473829;Ne;0;2;0;2
11095;Vėjelis;BITUTĖS;8226906949;Taip;9;1;0;10
11096;Vėjelis;BITUTĖS;4938939921;Taip;0;9;0;9
11097;Vėjelis;BITUTĖS;20492762368;Ne;6;0;0;6
11098;Vėjelis;Boruželės;5325081841;Taip;0;14;0;14
11099;Vėjelis;Boruželės;5381588565;Taip;9;2;0;11
11100;Vėjelis;Boruželės;1863210064;Taip;0;1;0;1
11101;Vėjelis;Boruželės;9037622738;Taip;3;0;0;3
11102;Vėjelis;Boruželės;8553966497;Taip;0;9;0;9
11103;Vėjelis;Boruželės;1588345134;Taip;0;1;0;1
11104;Vėjelis;Boruželės;1751533938;Ne;10;2;0;12
11105;Vėjelis;Boruželės;1429496839;Taip;0;8;0;8
11106;Vėjelis;Boruželės;1931659200;Taip;21;0;0;21
11107;Vėjelis;Boruželės;4747466651;Taip;9;0;0;9
11108;Vėjelis;Boruželės;3473416323;Taip;3;0;0;3
11109;Vėjelis;Boruželės;8141198449;Taip;15;1;0;16
11110;Vėjelis;Boruželės;8121537795;Ne;22;0;0;22
11111;Vėjelis;Boruželės;5517128872;Taip;0;1;0;1
11112;Vėjelis;Boruželės;8938491367;Taip;9;4;0;13
11113;Vėtrungė;Debesėlių;1280823326;Taip;11;0;0;11
11114;Vėtrungė;Debesėlių;3655025938;Taip;16;0;0;16
11115;Vėtrungė;Debesėlių;2825732654;Taip;0;5;0;5
11116;Vėtrungė;Debesėlių;5251308945;Taip;9;0;0;9
11117;Vėtrungė;Debesėlių;5446546214;Taip;5;0;0;5
11118;Vėtrungė;Debesėlių;8956375453;Taip;5;1;3;9
11119;Vėtrungė;Debesėlių;4339450816;Taip;10;0;0;10
11120;Vėtrungė;Debesėlių;7863176604;Taip;2;2;0;4
11121;Vėtrungė;Debesėlių;3179715496;Taip;0;2;2;4
11122;Vėtrungė;Debesėlių;6439014588;Taip;8;2;1;11
11123;Vėtrungė;Debesėlių;9423361592;Taip;2;6;0;8
11124;Vėtrungė;Debesėlių;4269488000;Taip;0;0;1;1
11125;Vėtrungė;Debesėlių;1191007983;Taip;0;4;0;4
11126;Vėtrungė;Debesėlių;3745680607;Taip;19;3;0;22
11127;Vėtrungė;Debesėlių;9359012317;Taip;20;2;0;22
11128;Vėtrungė;Zuikių;7585075881;Taip;17;1;0;18
11129;Vėtrungė;Zuikių;9332362038;Taip;7;1;0;8
11130;Vėtrungė;Zuikių;9407558097;Taip;5;7;0;12
11131;Vėtrungė;Zuikių;2985829593;Taip;0;2;0;2
11132;Vėtrungė;Zuikių;4121886031;Ne;10;2;0;12
11133;Vėtrungė;Zuikių;7573021445;Taip;0;3;0;3
11134;Vėtrungė;Zuikių;3335047815;Taip;3;3;0;6
11135;Vėtrungė;Zuikių;9742099165;Taip;7;1;0;8
11136;Vėtrungė;Zuikių;1215953192;Taip;0;6;5;11
11137;Vėtrungė;Zuikių;3908259010;Ne;0;9;1;10
11138;Vėtrungė;Zuikių;8421138967;Taip;9;0;8;17
11139;Vėtrungė;Zuikių;1729819557;Taip;22;3;0;25
11140;Vėtrungė;Drugelių;5366256528;Ne;13;2;4;19
11141;Vėtrungė;Drugelių;5622109033;Ne;8;0;0;8
11142;Vėtrungė;Drugelių;5539872851;Taip;5;0;0;5
11143;Vėtrungė;Drugelių;6457369177;Taip;2;0;0;2
11144;Vėtrungė;Drugelių;8744050633;Taip;2;0;0;2
11145;Vėtrungė;Drugelių;9444188699;Ne;6;4;3;13
11146;Vėtrungė;Drugelių;7943682529;Taip;20;1;0;21
11147;Vėtrungė;Drugelių;7476984763;Taip;14;3;0;17
11148;Vėtrungė;Drugelių;9090873546;Taip;0;6;0;6
11149;Vėtrungė;Drugelių;8441629302;Taip;9;0;0;9
11150;Vėtrungė;Do-re-mi;6449124019;Taip;4;1;0;5
11151;Vėtrungė;Do-re-mi;3278452234;Ne;0;5;12;17
11152;Vėtrungė;Do-re-mi;2928868412;Taip;0;3;6;9
11153;Vėtrungė;Do-re-mi;2883254822;Taip;0;9;0;9
11154;Vėtrungė;Do-re-mi;9518734260;Taip;5;3;0;8
11155;Vėtrungė;Do-re-mi;7496582551;Taip;9;1;0;10
11156;Vėtrungė;Do-re-mi;5430818470;Taip;9;2;4;15
11157;Vėtrungė;Do-re-mi;7895027909;Taip;0;6;0;6
11158;Vėtrungė;Do-re-mi;8538678373;Ne;0;7;0;7
11159;Vėtrungė;Do-re-mi;7749675589;Taip;8;1;0;9
11160;Vėtrungė;Do-re-mi;7483624989;Taip;7;5;0;12
11161;Vėtrungė;Do-re-mi;7807708310;Taip;6;11;1;18
11162;Vėtrungė;Do-re-mi;3200251047;Taip;1;6;0;7
11163;Vėtrungė;Do-re-mi;3369970611;Taip;0;8;0;8
11164;Vėtrungė;Do-re-mi;1808699695;Taip;10;2;0;12
11165;Vėtrungė;Do-re-mi;5217297849;Ne;0;14;1;15
11166;Vėtrungė;Smalsučių;5338119067;Taip;0;1;0;1
11167;Vėtrungė;Smalsučių;18747550179;Taip;0;1;1;2
11168;Vėtrungė;Smalsučių;31644585040;Ne;0;5;0;5
11169;Vėtrungė;Smalsučių;65861118217;Taip;0;11;1;12
11170;Vėtrungė;Smalsučių;30792456956;Ne;0;3;1;4
11171;Vėtrungė;Smalsučių;684188851;Taip;9;2;0;11
11172;Vėtrungė;Smalsučių;11835082526;Taip;0;8;0;8
11173;Vėtrungė;Smalsučių;1833285759;Taip;0;1;1;2
11174;Vėtrungė;Smalsučių;92977432447;Ne;0;7;0;7
11175;Vėtrungė;Smalsučių;4547247726;Taip;0;3;9;12
11176;Vėtrungė;Smalsučių;63472451321;Taip;0;2;5;7
11177;Vėtrungė;Smalsučių;92266460791;Taip;0;3;4;7
11178;Vėtrungė;Smalsučių;68262180072;Taip;0;1;1;2
11179;Vėtrungė;Smalsučių;1452467682;Taip;0;3;2;5
11180;Vėtrungė;Gudručių;1128961321;Taip;4;0;0;4
11181;Vėtrungė;Gudručių;45715910769;Taip;3;0;0;3
11182;Vėtrungė;Gudručių;98795465390;Taip;0;0;1;1
11183;Vėtrungė;Gudručių;40200404538;Ne;0;2;0;2
11184;Vėtrungė;Gudručių;42353807206;Taip;0;3;0;3
11185;Vėtrungė;Gudručių;76967115688;Ne;0;7;0;7
11186;Vėtrungė;Gudručių;1533796435;Taip;4;0;0;4
11187;Vėtrungė;Gudručių;1752676956;Ne;0;2;0;2
11188;Vėtrungė;Gudručių;72462689908;Taip;0;5;0;5
11189;Vėtrungė;Gudručių;26126038013;Taip;0;2;0;2
11190;Vėtrungė;Gudručių;58224525427;Taip;0;4;0;4
11191;Vėtrungė;Gudručių;68938242748;Taip;7;2;1;10
11192;Vėtrungė;Gudručių;76708504248;Taip;4;0;1;5
11193;Vėtrungė;Gudručių;6520234687;Ne;0;5;0;5
11194;Vėtrungė;Kodėlčių;1366458234;Taip;0;1;5;6
11195;Vėtrungė;Kodėlčių;1021458176;Taip;10;9;0;19
11196;Vėtrungė;Kodėlčių;1267104594;Taip;0;2;0;2
11197;Vėtrungė;Kodėlčių;1283685496;Taip;0;11;0;11
11198;Vėtrungė;Kodėlčių;20608668180;Taip;0;4;0;4
11199;Vėtrungė;Kodėlčių;3980104822;Taip;0;3;0;3
11200;Vėtrungė;Kodėlčių;49220186521;Taip;0;8;0;8
11201;Vėtrungė;Kodėlčių;41508942219;Taip;0;11;0;11
11202;Vėtrungė;Kodėlčių;1662123237;Taip;0;2;0;2
11203;Vėtrungė;Kodėlčių;1456877681;Taip;22;1;0;23
11204;Vėtrungė;Kodėlčių;1487142899;Taip;2;1;1;4
11205;Vėtrungė;Kodėlčių;19486911273;Taip;0;3;0;3
11206;Vėtrungė;Kodėlčių;56266349747;Taip;0;1;1;2
11207;Vėtrungė;Kodėlčių;9395706055;Taip;10;2;0;12
11208;Vėtrungė;Kodėlčių;4291687553;Taip;4;1;0;5
11209;Vėtrungė;Kodėlčių;18426639118;Taip;0;6;0;6
11210;Vėtrungė;Kodėlčių;1383686133;Taip;0;5;0;5
11211;Vėtrungė;Kodėlčių;6563805572;Taip;0;5;0;5
11212;Vėtrungė;Kodėlčių;1395153496;Taip;0;12;0;12
11213;Vėtrungė;Kodėlčių;8857763201;Taip;0;5;0;5
11214;Vėtrungė;Kodėlčių;8080668755;Taip;20;3;0;23
11215;Vėtrungė;Paukštelių;63512524250;Ne;5;0;4;9
11216;Vėtrungė;Paukštelių;1322617786;Taip;14;1;0;15
11217;Vėtrungė;Paukštelių;7921863675;Taip;0;7;0;7
11218;Vėtrungė;Paukštelių;4091719904;Taip;0;2;0;2
11219;Vėtrungė;Paukštelių;4347810256;Taip;5;2;2;9
11220;Vėtrungė;Paukštelių;8915159672;Taip;0;7;0;7
11221;Vėtrungė;Paukštelių;2482436192;Ne;3;0;0;3
11222;Vėtrungė;Paukštelių;6732632515;Taip;4;0;0;4
11223;Vėtrungė;Paukštelių;8897558066;Ne;7;1;2;10
11224;Vėtrungė;Paukštelių;3404120492;Taip;0;1;0;1
11225;Vėtrungė;Paukštelių;8154023892;Ne;13;0;0;13
11226;Vėtrungė;Paukštelių;3721504364;Taip;9;0;0;9
11227;Vėtrungė;Paukštelių;4115995882;Taip;0;9;0;9
11228;Vėtrungė;Paukštelių;1357603285;Taip;0;0;1;1
11229;Vėtrungė;Paukštelių;5994465833;Taip;8;0;0;8
11230;Vėtrungė;Paukštelių;8721035192;Taip;5;6;0;11
11231;Vėtrungė;Paukštelių;6964225210;Taip;6;0;1;7
11232;Vėtrungė;Paukštelių;1970034012;Ne;21;0;0;21
11233;Vėtrungė;Paukštelių;40392900667;Ne;10;0;0;10
11234;Vėtrungė;Viščiukų;3922749661;Taip;5;9;0;14
11235;Vėtrungė;Viščiukų;3744377479;Taip;0;0;2;2
11236;Vėtrungė;Viščiukų;4916692634;Taip;0;6;0;6
11237;Vėtrungė;Viščiukų;3887230224;Taip;5;1;2;8
11238;Vėtrungė;Viščiukų;2447851565;Taip;17;2;0;19
11239;Vėtrungė;Viščiukų;2136966687;Taip;14;3;5;22
11240;Vėtrungė;Viščiukų;4197321604;Taip;4;0;0;4
11241;Vėtrungė;Viščiukų;6416245099;Ne;5;4;0;9
11242;Vėtrungė;Viščiukų;8742161467;Taip;0;0;1;1
11243;Vėtrungė;Viščiukų;7558548846;Taip;12;1;0;13
11244;Vėtrungė;Viščiukų;1007578933;Taip;12;1;0;13
11245;Vėtrungė;Viščiukų;9893842192;Taip;13;1;0;14
11246;Vėtrungė;Viščiukų;3433811829;Taip;0;6;0;6
11247;Vėtrungė;Viščiukų;3634995652;Taip;12;0;0;12
11248;Vėtrungė;Viščiukų;5508759323;Taip;8;4;0;12
11249;Vėtrungė;Viščiukų;1255147376;Ne;0;6;0;6
11250;Vėtrungė;Viščiukų;5950287989;Taip;6;1;1;8
11251;Vėtrungė;Nykštukų;29699317546;Taip;0;2;12;14
11252;Vėtrungė;Nykštukų;1474010989;Ne;0;16;0;16
11253;Vėtrungė;Nykštukų;1754493671;Ne;0;4;0;4
11254;Vėtrungė;Nykštukų;1843306606;Taip;11;0;0;11
11255;Vėtrungė;Nykštukų;5198153485;Ne;0;4;0;4
11256;Vėtrungė;Nykštukų;1630866223;Taip;8;2;3;13
11257;Vėtrungė;Nykštukų;1529226569;Taip;0;1;0;1
11258;Vėtrungė;Nykštukų;1279678980;Taip;0;1;0;1
11259;Vėtrungė;Nykštukų;78016704795;Taip;0;8;0;8
11260;Vėtrungė;Nykštukų;87686013986;Taip;0;1;0;1
11261;Vėtrungė;Nykštukų;70610257897;Taip;2;0;0;2
11262;Vėtrungė;Nykštukų;2715736596;Taip;0;9;0;9
11263;Vėtrungė;Nykštukų;1744400765;Ne;10;2;7;19
11264;Vėtrungė;Nykštukų;1360031121;Taip;0;6;0;6
11265;Vėtrungė;Nykštukų;2145081325;Taip;10;1;2;13
11266;Vėtrungė;Nykštukų;2529102855;Taip;0;1;1;2
11267;Vėtrungė;Nykštukų;1611274573;Taip;0;12;0;12
11268;Vėtrungė;Nykštukų;7792694801;Ne;9;0;0;9
11269;Vėtrungė;Nykštukų;9606769599;Ne;0;15;0;15
11270;Vėtrungė;Meškiukų;2510763357;Taip;0;1;0;1
11271;Vėtrungė;Meškiukų;4713420194;Taip;0;1;0;1
11272;Vėtrungė;Meškiukų;9207846866;Taip;0;0;3;3
11273;Vėtrungė;Meškiukų;9065848425;Taip;0;6;0;6
11274;Vėtrungė;Meškiukų;3328447991;Taip;0;1;0;1
11275;Vėtrungė;Meškiukų;9685389270;Ne;0;16;0;16
11276;Vėtrungė;Meškiukų;9313438768;Taip;6;4;0;10
11277;Vėtrungė;Meškiukų;9070732925;Taip;1;2;0;3
11278;Vėtrungė;Meškiukų;3122948974;Taip;0;1;3;4
11279;Vėtrungė;Meškiukų;2880342138;Taip;0;1;0;1
11280;Vėtrungė;Meškiukų;2520926439;Taip;2;0;0;2
11281;Vėtrungė;Meškiukų;7704497739;Taip;0;5;0;5
11282;Vėtrungė;Meškiukų;7143997258;Taip;14;1;0;15
11283;Vėtrungė;Meškiukų;5123894802;Taip;0;5;0;5
11284;Vėtrungė;Meškiukų;8961791293;Taip;0;4;0;4
11285;Vėtrungė;Meškiukų;2809555356;Taip;0;0;2;2
11286;Vėtrungė;Meškiukų;4624264759;Ne;0;4;2;6
11287;Vėtrungė;Ąžuoliukų;2471926240;Taip;0;10;0;10
11288;Vėtrungė;Ąžuoliukų;3249689008;Taip;7;5;0;12
11289;Vėtrungė;Ąžuoliukų;7295216791;Taip;0;12;0;12
11290;Vėtrungė;Ąžuoliukų;2440001662;Taip;0;11;0;11
11291;Vėtrungė;Ąžuoliukų;7803736567;Taip;0;11;0;11
11292;Vėtrungė;Ąžuoliukų;1042333710;Ne;0;10;0;10
11293;Vėtrungė;Ąžuoliukų;16216365941;Taip;0;12;0;12
11294;Vėtrungė;Ąžuoliukų;6356914122;Ne;0;18;0;18
11295;Vėtrungė;Ąžuoliukų;1934540281;Ne;14;1;0;15
11296;Vėtrungė;Ąžuoliukų;6479094819;Taip;9;0;0;9
11297;Vėtrungė;Ąžuoliukų;5367369908;Ne;8;0;0;8
11298;Vėtrungė;Ąžuoliukų;4000379945;Taip;0;9;0;9
11299;Vėtrungė;Ąžuoliukų;1789419548;Ne;0;7;0;7
11300;Vėtrungė;Ąžuoliukų;7363490503;Taip;0;1;0;1
11301;Vėtrungė;Ąžuoliukų;1082104060;Ne;0;13;0;13
11302;Vilnelė;Lakštutė;9657350714;Taip;0;8;0;8
11303;Vilnelė;Lakštutė;1720695615;Taip;7;0;0;7
11304;Vilnelė;Lakštutė;1065422209;Taip;0;11;0;11
11305;Vilnelė;Lakštutė;1607330769;Taip;0;4;0;4
11306;Vilnelė;Lakštutė;66992481918;Taip;0;1;0;1
11307;Vilnelė;Lakštutė;3316451889;Taip;0;3;0;3
11308;Vilnelė;Lakštutė;8820091584;Taip;6;5;0;11
11309;Vilnelė;Lakštutė;8270866998;Taip;0;15;0;15
11310;Vilnelė;Lakštutė;2990112955;Taip;11;5;0;16
11311;Vilnelė;Lakštutė;8593060923;Taip;7;0;6;13
11312;Vilnelė;Lakštutė;9618342480;Taip;6;2;0;8
11313;Vilnelė;Lakštutė;9369955153;Taip;8;0;0;8
11314;Vilnelė;Lakštutė;6155522893;Taip;4;0;0;4
11315;Vilnelė;Lakštutė;6318246517;Taip;6;0;1;7
11316;Vilnelė;Lakštutė;7387394504;Taip;11;2;0;13
11317;Vilnelė;Lakštutė;1882520335;Ne;0;3;0;3
11318;Vilnelė;Vyturėlis;5091272908;Taip;4;2;0;6
11319;Vilnelė;Vyturėlis;1133945467;Taip;0;5;3;8
11320;Vilnelė;Vyturėlis;6132739519;Ne;2;2;0;4
11321;Vilnelė;Vyturėlis;3009064105;Taip;5;2;0;7
11322;Vilnelė;Vyturėlis;1674551092;Taip;0;2;0;2
11323;Vilnelė;Vyturėlis;2131599015;Taip;7;7;0;14
11324;Vilnelė;Vyturėlis;9460789751;Ne;7;0;0;7
11325;Vilnelė;Vyturėlis;18740103706;Taip;10;6;0;16
11326;Vilnelė;Vyturėlis;7057183482;Taip;22;0;0;22
11327;Vilnelė;Vyturėlis;8725191514;Taip;4;2;0;6
11328;Vilnelė;Vyturėlis;6308015852;Taip;13;2;0;15
11329;Vilnelė;Vyturėlis;7963783957;Taip;11;0;0;11
11330;Vilnelė;Vyturėlis;5540359276;Taip;10;2;1;13
11331;Vilnelė;Vyturėlis;1966090625;Taip;0;5;0;5
11332;Vilnelė;Vyturėlis;8740717061;Taip;5;2;0;7
11333;Vilnelė;Vyturėlis;3772263873;Taip;0;2;1;3
11334;Vilnelė;Vyturėlis;9183391434;Taip;5;2;0;7
11335;Vilnelė;Vyturėlis;2159103903;Taip;0;2;0;2
11336;Vilnelė;Pagrandukas;6707161045;Taip;0;6;0;6
11337;Vilnelė;Pagrandukas;59579013512;Ne;0;7;0;7
11338;Vilnelė;Pagrandukas;5480363267;Taip;0;1;0;1
11339;Vilnelė;Pagrandukas;2812680090;Taip;0;2;0;2
11340;Vilnelė;Pagrandukas;95852926101;Taip;0;3;0;3
11341;Vilnelė;Pagrandukas;1594154669;Taip;7;3;0;10
11342;Vilnelė;Pagrandukas;32662933313;Ne;0;1;3;4
11343;Vilnelė;Pagrandukas;1410511913;Taip;0;4;0;4
11344;Vilnelė;Pagrandukas;48926369907;Taip;0;3;0;3
11345;Vilnelė;Pagrandukas;13646307629;Taip;0;5;0;5
11346;Vilnelė;Pagrandukas;1680411448;Ne;0;10;0;10
11347;Vilnelė;Pagrandukas;1294194561;Taip;0;4;0;4
11348;Vilnelė;Pagrandukas;1230072125;Taip;0;0;4;4
11349;Vilnelė;Pagrandukas;1733279710;Taip;5;0;0;5
11350;Vilnelė;Pagrandukas;91933747502;Taip;0;4;0;4
11351;Vilnelė;Pagrandukas;1932829642;Ne;11;0;0;11
11352;Vilnelė;Bitutė;41258849574;Ne;0;0;2;2
11353;Vilnelė;Bitutė;9643543101;Taip;0;12;0;12
11354;Vilnelė;Bitutė;78753442031;Taip;0;3;0;3
11355;Vilnelė;Bitutė;31701260922;Taip;0;4;0;4
11356;Vilnelė;Bitutė;95736417954;Taip;0;2;0;2
11357;Vilnelė;Bitutė;10333554439;Taip;0;5;0;5
11358;Vilnelė;Bitutė;2864763106;Taip;0;0;1;1
11359;Vilnelė;Bitutė;60707257606;Taip;0;4;0;4
11360;Vilnelė;Bitutė;96611892032;Taip;0;1;0;1
11361;Vilnelė;Bitutė;79700582010;Taip;0;6;0;6
11362;Vilnelė;Bitutė;985960052;Taip;0;3;0;3
11363;Vilnelė;Bitutė;624138880;Taip;5;1;0;6
11364;Vilnelė;Bitutė;87237045379;Taip;0;1;0;1
11365;Vilnelė;Bitutė;1051858780;Taip;13;0;1;14
11366;Vilnelė;Bitutė;2138907190;Taip;0;10;0;10
11367;Vilnelė;Bitutė;5936699300;Taip;4;8;0;12
11368;Vilnelė;Bitutė;77572611171;Taip;0;2;0;2
11369;Vilnelė;Bitutė;7442249956;Ne;0;2;0;2
11370;Vilnelė;Bitutė;1061139491;Taip;0;3;0;3
11371;Vilnelė;Šaltinėlis;1783854203;Ne;15;3;0;18
11372;Vilnelė;Šaltinėlis;5013418313;Taip;10;3;0;13
11373;Vilnelė;Šaltinėlis;42835212158;Taip;0;7;0;7
11374;Vilnelė;Šaltinėlis;98028664140;Taip;0;7;0;7
11375;Vilnelė;Šaltinėlis;11430703629;Taip;4;0;0;4
11376;Vilnelė;Šaltinėlis;7292043157;Taip;0;6;0;6
11377;Vilnelė;Šaltinėlis;6327531229;Taip;0;1;0;1
11378;Vilnelė;Šaltinėlis;1572818047;Taip;2;1;0;3
11379;Vilnelė;Šaltinėlis;2130482375;Taip;2;2;0;4
11380;Vilnelė;Šaltinėlis;4480175299;Taip;0;0;1;1
11381;Vilnelė;Šaltinėlis;9058632601;Taip;0;6;0;6
11382;Vilnelė;Šaltinėlis;1507865281;Taip;0;5;0;5
11383;Vilnelė;Šaltinėlis;39494954188;Taip;0;11;0;11
11384;Vilnelė;Šaltinėlis;8615257084;Taip;0;1;0;1
11385;Vilnelė;Šaltinėlis;6146514112;Taip;0;5;0;5
11386;Vilnelė;Šaltinėlis;9016832316;Taip;0;9;0;9
11387;Vilnelė;Šaltinėlis;1281521052;Taip;0;12;0;12
11388;Vilnelė;Šaltinėlis;5790420711;Taip;0;1;0;1
11389;Vilnelė;Riešutėllis;55974182996;Taip;3;0;0;3
11390;Vilnelė;Riešutėllis;67561845041;Taip;0;2;0;2
11391;Vilnelė;Riešutėllis;85568332595;Taip;8;0;0;8
11392;Vilnelė;Riešutėllis;22516605873;Taip;0;2;0;2
11393;Vilnelė;Riešutėllis;64066480740;Taip;0;2;0;2
11394;Vilnelė;Riešutėllis;16272480270;Taip;7;1;0;8
11395;Vilnelė;Riešutėllis;1859757115;Taip;0;5;0;5
11396;Vilnelė;Riešutėllis;1450994872;Taip;9;1;0;10
11397;Vilnelė;Riešutėllis;9331404812;Taip;0;15;0;15
11398;Vilnelė;Riešutėllis;11702051319;Taip;0;9;0;9
11399;Vilnelė;Riešutėllis;41536662155;Ne;0;1;4;5
11400;Vilnelė;Riešutėllis;69413564937;Taip;0;5;0;5
11401;Vilnelė;Riešutėllis;71906228270;Taip;0;0;3;3
11402;Vilnelė;Riešutėllis;7916632244;Taip;0;2;0;2
11403;Vilnelė;Riešutėllis;20639648308;Ne;0;2;2;4
11404;Vilnelė;Riešutėllis;73658263243;Ne;0;2;0;2
11405;Vilnelė;Riešutėllis;8889469645;Taip;9;3;0;12
11406;Vilnelė;Riešutėllis;1321202650;Ne;14;0;0;14
11407;Vilnelė;Riešutėllis;2696565855;Taip;0;2;1;3
11408;Vilnelė;Nykštukas;1336497125;Taip;2;0;0;2
11409;Vilnelė;Nykštukas;34859308729;Taip;1;0;0;1
11410;Vilnelė;Nykštukas;32988468324;Taip;0;12;0;12
11411;Vilnelė;Nykštukas;13583637193;Taip;0;10;0;10
11412;Vilnelė;Nykštukas;23442711820;Taip;10;0;0;10
11413;Vilnelė;Nykštukas;47863474499;Taip;2;1;0;3
11414;Vilnelė;Nykštukas;13231410969;Taip;0;2;0;2
11415;Vilnelė;Nykštukas;62208863766;Taip;3;0;0;3
11416;Vilnelė;Nykštukas;36905818484;Taip;3;0;0;3
11417;Vilnelė;Nykštukas;1845336128;Taip;0;7;0;7
11418;Vilnelė;Nykštukas;87094375121;Taip;0;8;0;8
11419;Vilnelė;Nykštukas;42526993637;Taip;0;1;0;1
11420;Vilnelė;Nykštukas;15265621906;Taip;0;7;0;7
11421;Vilnelė;Nykštukas;5198859945;Taip;0;8;0;8
11422;Vilnelė;Nykštukas;2131603460;Taip;0;4;0;4
11423;Vilnelė;Nykštukas;2097945353;Ne;0;2;0;2
11424;Vilnelė;Nykštukas;1957418704;Taip;5;1;0;6
11425;Vilnelė;Pieštukas;9879688569;Taip;0;3;0;3
11426;Vilnelė;Pieštukas;5473379559;Taip;0;1;0;1
11427;Vilnelė;Pieštukas;1462397783;Taip;0;6;0;6
11428;Vilnelė;Pieštukas;1792586468;Ne;5;3;0;8
11429;Vilnelė;Pieštukas;3781595939;Taip;0;12;0;12
11430;Vilnelė;Pieštukas;9884955712;Taip;7;2;0;9
11431;Vilnelė;Pieštukas;2479090686;Taip;12;6;0;18
11432;Vilnelė;Pieštukas;3945921490;Taip;0;15;0;15
11433;Vilnelė;Pieštukas;6798728562;Taip;0;5;0;5
11434;Vilnelė;Pieštukas;2859160609;Taip;3;0;0;3
11435;Vilnelė;Pieštukas;6355912551;Taip;1;5;0;6
11436;Vilnelė;Pieštukas;7976798775;Taip;0;4;0;4
11437;Vilnelė;Pieštukas;3811289758;Taip;13;4;0;17
11438;Vilnelė;Pieštukas;5261402753;Taip;12;9;0;21
11439;Vilnelė;Pieštukas;3529718234;Ne;8;7;0;15
11440;Vilnelė;Voverytė;7536603663;Taip;13;2;0;15
11441;Vilnelė;Voverytė;3503461211;Ne;0;9;0;9
11442;Vilnelė;Voverytė;3993826389;Taip;0;2;0;2
11443;Vilnelė;Voverytė;7388336851;Taip;6;3;0;9
11444;Vilnelė;Voverytė;8667403338;Taip;6;2;0;8
11445;Vilnelė;Voverytė;7883724600;Taip;0;3;0;3
11446;Vilnelė;Voverytė;4166351390;Taip;0;2;0;2
11447;Vilnelė;Voverytė;1351798589;Taip;0;9;0;9
11448;Vilnelė;Voverytė;9162681538;Taip;4;0;0;4
11449;Vilnelė;Voverytė;3075681823;Taip;3;0;0;3
11450;Vilnelė;Voverytė;6342242777;Taip;0;3;0;3
11451;Vilnelė;Voverytė;3843064564;Taip;0;2;0;2
11452;Vilnelė;Voverytė;3558073399;Taip;8;0;1;9
11453;Vilnelė;Voverytė;2841315531;Taip;0;0;5;5
11454;Vilnelė;Voverytė;9804772168;Taip;0;0;9;9
11455;Vilnelė;Voverytė;1596625263;Taip;0;11;0;11
11456;Vilnelė;Voverytė;7338573817;Taip;3;0;1;4
11457;Vilnelė;Voverytė;8121075430;Ne;0;2;0;2
11458;Vilnelė;Kodėlčiukas;53049214510;Taip;3;1;0;4
11459;Vilnelė;Kodėlčiukas;6289991945;Taip;0;6;0;6
11460;Vilnelė;Kodėlčiukas;81657018187;Taip;0;4;0;4
11461;Vilnelė;Kodėlčiukas;69532393507;Taip;0;6;0;6
11462;Vilnelė;Kodėlčiukas;1160794222;Taip;0;5;0;5
11463;Vilnelė;Kodėlčiukas;64950604083;Taip;0;4;0;4
11464;Vilnelė;Kodėlčiukas;99580393765;Taip;0;13;0;13
11465;Vilnelė;Kodėlčiukas;36561742487;Taip;0;2;0;2
11466;Vilnelė;Kodėlčiukas;96900970284;Taip;15;1;0;16
11467;Vilnelė;Kodėlčiukas;85391221236;Taip;0;1;0;1
11468;Vilnelė;Kodėlčiukas;39412868538;Taip;0;6;0;6
11469;Vilnelė;Kodėlčiukas;67110179640;Ne;0;1;0;1
11470;Vilnelė;Kodėlčiukas;35546482171;Taip;0;2;0;2
11471;Vilnelė;Kodėlčiukas;90980722090;Taip;0;4;0;4
11472;Vilnelė;Kodėlčiukas;32819254615;Ne;12;2;0;14
11473;Vilnelė;Kodėlčiukas;91413844614;Taip;0;2;0;2
11474;Vilnelė;Žirniukas;6026600803;Taip;5;4;0;9
11475;Vilnelė;Žirniukas;1580287517;Ne;0;7;0;7
11476;Vilnelė;Žirniukas;4328263940;Taip;0;2;1;3
11477;Vilnelė;Žirniukas;8620789304;Taip;19;0;0;19
11478;Vilnelė;Žirniukas;6448119003;Taip;0;4;0;4
11479;Vilnelė;Žirniukas;1027463000;Ne;8;2;0;10
11480;Vilnelė;Žirniukas;5953205533;Taip;0;6;0;6
11481;Vilnelė;Žirniukas;4448413194;Ne;0;2;6;8
11482;Vilnelė;Žirniukas;6830433856;Ne;9;8;0;17
11483;Vilnelė;Žirniukas;7020707723;Taip;0;17;0;17
11484;Vilnelė;Žirniukas;5558378376;Taip;0;13;0;13
11485;Vilnelė;Žirniukas;4664946923;Taip;2;0;0;2
11486;Vilnelė;Žirniukas;3312254613;Ne;0;12;0;12
11487;Vilnelė;Pipiras;6659537454;Taip;16;0;0;16
11488;Vilnelė;Pipiras;9640330864;Ne;5;2;1;8
11489;Vilnelė;Pipiras;5961910077;Taip;5;2;0;7
11490;Vilnelė;Pipiras;4295816753;Taip;0;8;0;8
11491;Vilnelė;Pipiras;3848720970;Taip;0;2;0;2
11492;Vilnelė;Pipiras;6686896190;Taip;5;2;5;12
11493;Vilnelė;Pipiras;9537740492;Taip;5;0;0;5
11494;Vilnelė;Pipiras;3670613082;Taip;16;0;0;16
11495;Vilnelė;Pipiras;3211657057;Taip;1;1;0;2
11496;Vilnelė;Pipiras;6417545510;Taip;0;2;0;2
11497;Vilnelė;Pipiras;7833531435;Taip;0;2;0;2
11498;Vilnelė;Pipiras;5756690199;Taip;0;2;2;4
11499;Vilnelė;Pipiras;3056845279;Taip;0;19;0;19
11500;Vilnelė;Pipiras;7085972543;Taip;6;0;0;6
11501;Vilnelė;Pipiras;2144925171;Ne;6;1;0;7
11502;Vilnelė;Pipiras;3844066232;Taip;0;11;0;11
11503;Vėrinėlis;GAIDELIAI;2529641529;Ne;0;14;0;14
11504;Vėrinėlis;GAIDELIAI;3729926575;Taip;0;25;0;25
11505;Vėrinėlis;GAIDELIAI;4390098560;Ne;3;1;0;4
11506;Vėrinėlis;GAIDELIAI;4666918175;Ne;0;0;3;3
11507;Vėrinėlis;GAIDELIAI;2774618380;Ne;0;2;0;2
11508;Vėrinėlis;GAIDELIAI;5429955166;Taip;0;19;0;19
11509;Vėrinėlis;GAIDELIAI;5209398043;Ne;0;8;0;8
11510;Vėrinėlis;GAIDELIAI;1060619471;Ne;9;3;4;16
11511;Vėrinėlis;GAIDELIAI;8885866108;Taip;0;1;3;4
11512;Vėrinėlis;GAIDELIAI;8213498951;Ne;7;2;0;9
11513;Vėrinėlis;GAIDELIAI;6136232912;Ne;0;5;0;5
11514;Vėrinėlis;GAIDELIAI;6058712578;Taip;11;0;0;11
11515;Vėrinėlis;GAIDELIAI;6496291933;Taip;0;8;0;8
11516;Vėrinėlis;GAIDELIAI;1164396960;Ne;10;0;0;10
11517;Vėrinėlis;GAIDELIAI;8091400240;Ne;6;3;0;9
11518;Vėrinėlis;GAIDELIAI;8728166391;Ne;0;7;4;11
11519;Vėrinėlis;GAIDELIAI;8100283579;Taip;3;9;0;12
11520;Vėrinėlis;SAULUTĖ;8755941866;Ne;6;2;1;9
11521;Vėrinėlis;SAULUTĖ;5434506594;Ne;1;0;0;1
11522;Vėrinėlis;SAULUTĖ;9751494612;Taip;1;1;0;2
11523;Vėrinėlis;SAULUTĖ;1897451825;Ne;0;7;0;7
11524;Vėrinėlis;SAULUTĖ;4727265555;Ne;12;6;0;18
11525;Vėrinėlis;SAULUTĖ;1047139776;Taip;0;0;3;3
11526;Vėrinėlis;SAULUTĖ;1493604303;Taip;22;0;0;22
11527;Vėrinėlis;SAULUTĖ;9500715949;Taip;0;7;0;7
11528;Vėrinėlis;SAULUTĖ;8922728881;Ne;0;1;0;1
11529;Vėrinėlis;SAULUTĖ;84391578139;Taip;0;0;4;4
11530;Vėrinėlis;SAULUTĖ;9391697537;Taip;0;0;2;2
11531;Vėrinėlis;SAULUTĖ;7071043164;Ne;0;8;0;8
11532;Vėrinėlis;SAULUTĖ;8620836106;Taip;22;0;0;22
11533;Vėrinėlis;SAULUTĖ;5003344894;Taip;0;0;2;2
11534;Vėrinėlis;SAULUTĖ;6866592245;Ne;0;2;1;3
11535;Vėrinėlis;SAULUTĖ;4183077476;Taip;0;16;0;16
11536;Vėrinėlis;SAULUTĖ;6906865967;Taip;0;16;0;16
11537;Vėrinėlis;SAULUTĖ;4925983616;Taip;0;0;2;2
11538;Vėrinėlis;SAULUTĖ;2732572235;Ne;0;0;3;3
11539;Vėrinėlis;SAULUTĖ;2633143128;Taip;2;4;0;6
11540;Vėrinėlis;NYKŠTUKAI;1518907235;Taip;0;6;2;8
11541;Vėrinėlis;NYKŠTUKAI;1865151493;Taip;6;0;0;6
11542;Vėrinėlis;NYKŠTUKAI;6065348004;Ne;0;2;0;2
11543;Vėrinėlis;NYKŠTUKAI;3563944204;Ne;6;0;0;6
11544;Vėrinėlis;NYKŠTUKAI;7436873997;Taip;12;4;0;16
11545;Vėrinėlis;NYKŠTUKAI;63333257753;Taip;19;0;0;19
11546;Vėrinėlis;NYKŠTUKAI;1592544116;Taip;0;0;3;3
11547;Vėrinėlis;NYKŠTUKAI;1261337457;Ne;5;3;2;10
11548;Vėrinėlis;NYKŠTUKAI;11459693163;Ne;0;1;3;4
11549;Vėrinėlis;NYKŠTUKAI;38428514086;Ne;0;6;0;6
11550;Vėrinėlis;NYKŠTUKAI;41029899086;Ne;0;2;2;4
11551;Vėrinėlis;NYKŠTUKAI;1251822610;Taip;15;0;1;16
11552;Vėrinėlis;NYKŠTUKAI;8755231814;Ne;5;0;0;5
11553;Vėrinėlis;NYKŠTUKAI;9419245081;Taip;0;1;0;1
11554;Vėrinėlis;NYKŠTUKAI;9604483237;Taip;10;0;0;10
11555;Vėrinėlis;BURATINAS;65408541019;Ne;0;14;0;14
11556;Vėrinėlis;BURATINAS;3703886468;Ne;9;0;1;10
11557;Vėrinėlis;BURATINAS;54666417396;Taip;0;9;0;9
11558;Vėrinėlis;BURATINAS;4067153819;Taip;0;10;0;10
11559;Vėrinėlis;BURATINAS;1103951120;Ne;5;0;0;5
11560;Vėrinėlis;BURATINAS;90979069296;Taip;0;0;1;1
11561;Vėrinėlis;BURATINAS;1028568095;Taip;0;3;0;3
11562;Vėrinėlis;BURATINAS;7431541945;Taip;5;1;0;6
11563;Vėrinėlis;BURATINAS;67987598880;Taip;0;1;0;1
11564;Vėrinėlis;BURATINAS;9266953028;Ne;0;1;0;1
11565;Vėrinėlis;BURATINAS;4789626884;Taip;0;0;2;2
11566;Vėrinėlis;GINTARĖLIAI;79005449877;Taip;0;2;0;2
11567;Vėrinėlis;GINTARĖLIAI;2023475725;Taip;3;0;0;3
11568;Vėrinėlis;GINTARĖLIAI;1028694005;Ne;0;4;0;4
11569;Vėrinėlis;GINTARĖLIAI;1465052758;Ne;22;0;0;22
11570;Vėrinėlis;GINTARĖLIAI;97559214584;Taip;0;1;0;1
11571;Vėrinėlis;GINTARĖLIAI;7819933209;Ne;0;1;0;1
11572;Vėrinėlis;GINTARĖLIAI;762270610;Taip;6;1;0;7
11573;Vėrinėlis;GINTARĖLIAI;78121632796;Ne;0;1;0;1
11574;Vėrinėlis;GINTARĖLIAI;99325931907;Taip;0;4;0;4
11575;Vėrinėlis;GINTARĖLIAI;668239862;Taip;0;1;0;1
11576;Vėrinėlis;GINTARĖLIAI;8197177876;Ne;5;1;0;6
11577;Vėrinėlis;GINTARĖLIAI;1804757495;Taip;4;0;0;4
11578;Vėrinėlis;GINTARĖLIAI;1029210296;Taip;0;4;0;4
11579;Vėrinėlis;GINTARĖLIAI;1791124205;Ne;4;2;0;6
11580;Vėrinėlis;GINTARĖLIAI;92480758419;Ne;0;9;0;9
11581;Vėrinėlis;GINTARĖLIAI;7168682238;Ne;0;2;0;2
11582;Vėrinėlis;GINTARĖLIAI;8955109359;Ne;0;1;0;1
11583;Vėrinėlis;RAMUNĖLĖS;6738189242;Taip;0;0;3;3
11584;Vėrinėlis;RAMUNĖLĖS;1292880457;Ne;0;0;3;3
11585;Vėrinėlis;RAMUNĖLĖS;1398564881;Taip;0;2;0;2
11586;Vėrinėlis;RAMUNĖLĖS;68073702260;Taip;3;0;0;3
11587;Vėrinėlis;RAMUNĖLĖS;1133491927;Ne;7;0;0;7
11588;Vėrinėlis;RAMUNĖLĖS;1268710930;Taip;0;6;0;6
11589;Vėrinėlis;RAMUNĖLĖS;1477336890;Taip;0;7;0;7
11590;Vėrinėlis;RAMUNĖLĖS;25415760747;Ne;0;1;5;6
11591;Vėrinėlis;RAMUNĖLĖS;6004379115;Ne;0;1;0;1
11592;Vėrinėlis;RAMUNĖLĖS;1803838403;Taip;10;0;0;10
11593;Vėrinėlis;RAMUNĖLĖS;71830611159;Ne;0;0;1;1
11594;Vėrinėlis;RAMUNĖLĖS;39153716711;Ne;0;4;0;4
11595;Vėrinėlis;RAMUNĖLĖS;11343969028;Ne;0;16;0;16
11596;Vėrinėlis;RAMUNĖLĖS;1086306523;Ne;5;0;1;6
11597;Vėrinėlis;RAMUNĖLĖS;1408704528;Ne;15;1;0;16
11598;Vėrinėlis;RAMUNĖLĖS;1239744245;Ne;15;1;0;16
11599;Vėrinėlis;RAMUNĖLĖS;6148700823;Ne;0;13;0;13
11600;Vėrinėlis;RAMUNĖLĖS;4680688747;Ne;20;0;0;20
11601;Vėrinėlis;RAMUNĖLĖS;4415030161;Taip;0;9;0;9
11602;Vėrinėlis;KODELČIUKŲ;95040879760;Ne;4;0;0;4
11603;Vėrinėlis;KODELČIUKŲ;1410929889;Taip;0;8;0;8
11604;Vėrinėlis;KODELČIUKŲ;1001125426;Ne;14;0;4;18
11605;Vėrinėlis;KODELČIUKŲ;42875958735;Ne;0;1;0;1
11606;Vėrinėlis;KODELČIUKŲ;25734061057;Ne;8;0;0;8
11607;Vėrinėlis;KODELČIUKŲ;68027880109;Ne;9;0;1;10
11608;Vėrinėlis;KODELČIUKŲ;2676104110;Taip;0;0;1;1
11609;Vėrinėlis;KODELČIUKŲ;1876456237;Ne;4;0;1;5
11610;Vėrinėlis;KODELČIUKŲ;12363691267;Taip;0;0;1;1
11611;Vėrinėlis;KODELČIUKŲ;24888549934;Taip;0;7;0;7
11612;Vėrinėlis;KODELČIUKŲ;38831165210;Taip;0;8;0;8
11613;Vėrinėlis;KODELČIUKŲ;37600982027;Ne;0;1;0;1
11614;Vėrinėlis;KODELČIUKŲ;79317384797;Ne;0;11;0;11
11615;Vėrinėlis;KODELČIUKŲ;58909000723;Taip;0;1;0;1
11616;Vėrinėlis;KODELČIUKŲ;8978798314;Ne;0;0;2;2
11617;Vėrinėlis;KODELČIUKŲ;7493919076;Ne;17;0;1;18
11618;Vėrinėlis;ŽIRNIUKAI;3074835599;Ne;4;0;6;10
11619;Vėrinėlis;ŽIRNIUKAI;1769852084;Ne;22;0;0;22
11620;Vėrinėlis;ŽIRNIUKAI;4718732261;Taip;10;0;1;11
11621;Vėrinėlis;ŽIRNIUKAI;9798993200;Taip;8;2;1;11
11622;Vėrinėlis;ŽIRNIUKAI;7845985650;Ne;6;0;2;8
11623;Vėrinėlis;ŽIRNIUKAI;2815770695;Taip;9;0;2;11
11624;Vėrinėlis;ŽIRNIUKAI;8329989952;Ne;12;0;1;13
11625;Vėrinėlis;ŽIRNIUKAI;3202518504;Taip;16;0;0;16
11626;Vėrinėlis;ŽIRNIUKAI;8824435889;Ne;9;1;0;10
11627;Vėrinėlis;ŽIRNIUKAI;4752902173;Ne;10;0;3;13
11628;Vėrinėlis;ŽIRNIUKAI;7237945125;Ne;0;4;5;9
11629;Vėrinėlis;ŽIRNIUKAI;5600815908;Ne;14;0;1;15
11630;Vėrinėlis;ŽIRNIUKAI;6779005350;Ne;5;0;3;8
11631;Vėrinėlis;ŽIRNIUKAI;7367485961;Ne;4;0;0;4
11632;Vėrinėlis;ŽIRNIUKAI;6576726481;Taip;22;0;0;22
11633;Vėrinėlis;ŽIRNIUKAI;8397025332;Taip;22;0;0;22
11634;Vėrinėlis;ŽIRNIUKAI;9340167973;Taip;15;0;0;15
11635;Vėrinėlis;ŽIRNIUKAI;1736733257;Ne;0;0;1;1
11636;Vėrinėlis;ŽIRNIUKAI;2687583764;Taip;13;0;2;15
11637;Vėrinėlis;VARPELIAI;3316897176;Ne;0;0;4;4
11638;Vėrinėlis;VARPELIAI;9009344779;Ne;0;1;0;1
11639;Vėrinėlis;VARPELIAI;7471147288;Ne;16;0;0;16
11640;Vėrinėlis;VARPELIAI;3810261864;Taip;4;0;2;6
11641;Vėrinėlis;VARPELIAI;9289003583;Ne;0;8;0;8
11642;Vėrinėlis;VARPELIAI;1684203955;Taip;0;8;0;8
11643;Vėrinėlis;VARPELIAI;3882915774;Taip;7;3;0;10
11644;Vėrinėlis;VARPELIAI;7273090217;Ne;5;1;0;6
11645;Vėrinėlis;VARPELIAI;7233139048;Ne;0;1;3;4
11646;Vėrinėlis;VARPELIAI;3130841241;Ne;0;0;5;5
11647;Vėrinėlis;VARPELIAI;2337883071;Taip;10;0;1;11
11648;Vėrinėlis;VARPELIAI;6913001318;Ne;0;6;0;6
11649;Vėrinėlis;VARPELIAI;7224418233;Ne;0;19;0;19
11650;Vėrinėlis;VARPELIAI;1894717954;Taip;17;0;0;17
11651;Vėrinėlis;VARPELIAI;3667953591;Taip;11;0;0;11
11652;Vėrinėlis;VARPELIAI;4191386053;Ne;3;8;0;11
11653;Vėrinėlis;VARPELIAI;2090334618;Taip;8;6;0;14
11654;Vėrinėlis;VARPELIAI;3291922401;Ne;0;0;1;1
11655;Vėrinėlis;BORUŽĖLĖS;8759487574;Ne;5;4;0;9
11656;Vėrinėlis;BORUŽĖLĖS;4819016753;Ne;12;0;0;12
11657;Vėrinėlis;BORUŽĖLĖS;1910385020;Taip;7;7;0;14
11658;Vėrinėlis;BORUŽĖLĖS;2078857084;Ne;8;0;1;9
11659;Vėrinėlis;BORUŽĖLĖS;3934652683;Ne;13;0;1;14
11660;Vėrinėlis;BORUŽĖLĖS;6904733283;Ne;9;0;3;12
11661;Vėrinėlis;BORUŽĖLĖS;4446546335;Taip;0;5;2;7
11662;Vėrinėlis;BORUŽĖLĖS;3718510933;Taip;9;0;0;9
11663;Vėrinėlis;BORUŽĖLĖS;2501287529;Ne;1;1;0;2
11664;Vėrinėlis;BORUŽĖLĖS;8904833339;Ne;11;3;0;14
11665;Vėrinėlis;BORUŽĖLĖS;3312501759;Taip;11;1;0;12
11666;Vėrinėlis;BORUŽĖLĖS;9217188911;Taip;0;18;0;18
11667;Vėrinėlis;BORUŽĖLĖS;7414937335;Taip;17;2;0;19
11668;Vėrinėlis;BORUŽĖLĖS;2574507205;Ne;14;1;0;15
11669;Vėrinėlis;BORUŽĖLĖS;6671382987;Ne;13;0;1;14
11670;Vėrinėlis;BORUŽĖLĖS;6859410675;Taip;13;0;1;14
11671;Vėrinėlis;SVEIKUOLIAI;87606501349;Ne;0;0;3;3
11672;Vėrinėlis;SVEIKUOLIAI;19865450007;Taip;7;0;0;7
11673;Vėrinėlis;SVEIKUOLIAI;1395590011;Ne;14;0;0;14
11674;Vėrinėlis;SVEIKUOLIAI;3975934329;Ne;0;0;4;4
11675;Vėrinėlis;SVEIKUOLIAI;9751037428;Ne;0;2;0;2
11676;Vėrinėlis;SVEIKUOLIAI;3562371502;Taip;14;0;1;15
11677;Vėrinėlis;SVEIKUOLIAI;5960946826;Taip;5;0;10;15
11678;Vėrinėlis;SVEIKUOLIAI;5496928903;Ne;4;0;2;6
11679;Vėrinėlis;SVEIKUOLIAI;7981261038;Taip;0;1;0;1
11680;Vėrinėlis;SVEIKUOLIAI;6278738058;Taip;0;0;3;3
11681;Vėrinėlis;SVEIKUOLIAI;6644892686;Ne;4;0;0;4
11682;Vėrinėlis;SVEIKUOLIAI;4958359640;Taip;9;0;0;9
11683;Vėrinėlis;SVEIKUOLIAI;1338287524;Taip;0;3;0;3
11684;Vėrinėlis;SVEIKUOLIAI;8579819581;Ne;7;6;0;13
11685;Vėrinėlis;SVEIKUOLIAI;6220653152;Taip;0;13;0;13
11686;Vėrinėlis;ŠIRDELĖS;2944010445;Taip;0;12;6;18
11687;Vėrinėlis;ŠIRDELĖS;8195455092;Taip;9;0;0;9
11688;Vėrinėlis;ŠIRDELĖS;96779456411;Taip;0;2;0;2
11689;Vėrinėlis;ŠIRDELĖS;7167034587;Taip;2;0;2;4
11690;Vėrinėlis;ŠIRDELĖS;3049346950;Taip;0;0;20;20
11691;Vėrinėlis;ŠIRDELĖS;7070058961;Taip;5;0;0;5
11692;Vėrinėlis;ŠIRDELĖS;7130691686;Ne;4;0;3;7
11693;Vėrinėlis;ŠIRDELĖS;8709714647;Taip;0;0;3;3
11694;Vėrinėlis;ŠIRDELĖS;85262495209;Ne;0;7;0;7
11695;Vėrinėlis;ŠIRDELĖS;9119967823;Taip;0;0;3;3
11696;Vėrinėlis;ŠIRDELĖS;7634939364;Taip;0;2;0;2
11697;Vėrinėlis;ŠIRDELĖS;42298331453;Taip;0;2;0;2
11698;Vėrinėlis;ŠIRDELĖS;1535567719;Ne;8;5;0;13
11699;Vėrinėlis;ŠIRDELĖS;8652292752;Taip;0;7;0;7
11700;Vėrinėlis;ŠIRDELĖS;2231062782;Ne;9;0;0;9
11701;Viltenė;Drugeliai;1936464823;Taip;0;0;4;4
11702;Viltenė;Drugeliai;50489733849;Ne;8;1;0;9
11703;Viltenė;Drugeliai;69838945768;Ne;0;6;0;6
11704;Viltenė;Drugeliai;54422258148;Taip;0;10;0;10
11705;Viltenė;Drugeliai;4322306031;Taip;14;0;0;14
11706;Viltenė;Drugeliai;82849073169;Taip;0;1;0;1
11707;Viltenė;Drugeliai;39676814294;Ne;0;4;0;4
11708;Viltenė;Drugeliai;47885567334;Taip;0;1;0;1
11709;Viltenė;Drugeliai;68110722913;Taip;0;3;0;3
11710;Viltenė;Drugeliai;21489308130;Taip;5;1;0;6
11711;Viltenė;Drugeliai;16461652415;Taip;0;10;0;10
11712;Viltenė;Drugeliai;91847807834;Taip;0;1;0;1
11713;Viltenė;Drugeliai;34691221253;Ne;3;0;0;3
11714;Viltenė;Drugeliai;33159619580;Taip;0;1;0;1
11715;Viltenė;Drugeliai;4586042895;Taip;0;7;0;7
11716;Viltenė;Drugeliai;1739353382;Taip;0;15;0;15
11717;Viltenė;Bitučių;21665885641;Taip;0;2;0;2
11718;Viltenė;Bitučių;1747442313;Ne;0;8;0;8
11719;Viltenė;Bitučių;13157765051;Taip;0;6;0;6
11720;Viltenė;Bitučių;2046122804;Taip;0;2;0;2
11721;Viltenė;Bitučių;74464437862;Taip;0;8;0;8
11722;Viltenė;Bitučių;86055366818;Taip;0;1;0;1
11723;Viltenė;Bitučių;65252989761;Taip;0;6;0;6
11724;Viltenė;Bitučių;84451732377;Taip;0;1;0;1
11725;Viltenė;Bitučių;1702925444;Taip;0;2;0;2
11726;Viltenė;Bitučių;6006470515;Taip;0;6;0;6
11727;Viltenė;Bitučių;1656026241;Taip;0;1;0;1
11728;Viltenė;Bitučių;4554162475;Taip;0;8;0;8
11729;Viltenė;Bitučių;1291605426;Taip;0;1;0;1
11730;Viltenė;Bitučių;6322746293;Taip;0;10;0;10
11731;Viltenė;Bitučių;4334881910;Taip;9;9;0;18
11732;Viltenė;Bitučių;9068349987;Ne;0;2;0;2
11733;Viltenė;Boružėlių;6642790962;Taip;19;0;0;19
11734;Viltenė;Boružėlių;9572407405;Taip;0;2;0;2
11735;Viltenė;Boružėlių;3738838707;Taip;2;0;0;2
11736;Viltenė;Boružėlių;8473588098;Taip;8;12;0;20
11737;Viltenė;Boružėlių;3995418079;Taip;16;0;0;16
11738;Viltenė;Boružėlių;1399653129;Taip;0;4;0;4
11739;Viltenė;Boružėlių;7526555727;Taip;15;0;0;15
11740;Viltenė;Boružėlių;3164402142;Taip;0;2;0;2
11741;Viltenė;Boružėlių;5379804362;Taip;0;1;0;1
11742;Viltenė;Boružėlių;7912396297;Taip;5;3;0;8
11743;Viltenė;Boružėlių;4604298036;Taip;3;4;0;7
11744;Viltenė;Boružėlių;6621273812;Taip;18;0;0;18
11745;Viltenė;Boružėlių;2383607612;Taip;10;0;0;10
11746;Viltenė;Boružėlių;1496943250;Ne;0;1;0;1
11747;Viltenė;Gandriukų;6481491422;Taip;6;0;3;9
11748;Viltenė;Gandriukų;2452782594;Taip;9;0;0;9
11749;Viltenė;Gandriukų;9217178863;Taip;10;3;0;13
11750;Viltenė;Gandriukų;1126409020;Taip;0;6;0;6
11751;Viltenė;Gandriukų;6060648988;Taip;11;0;0;11
11752;Viltenė;Gandriukų;1840626621;Taip;0;19;0;19
11753;Viltenė;Gandriukų;8549631247;Taip;0;6;0;6
11754;Viltenė;Gandriukų;7796422726;Taip;6;0;0;6
11755;Viltenė;Gandriukų;2815105107;Taip;0;1;0;1
11756;Viltenė;Gandriukų;6511850468;Taip;18;1;0;19
11757;Viltenė;Gandriukų;4945108189;Taip;5;8;0;13
11758;Viltenė;Gandriukų;5850652322;Taip;11;0;0;11
11759;Viltenė;Gandriukų;8110413064;Taip;5;1;0;6
11760;Viltenė;Gandriukų;4388770140;Taip;3;4;0;7
11761;Viltenė;Gandriukų;3073228245;Taip;17;0;0;17
11762;Viltenė;Gandriukų;4468743044;Ne;0;12;0;12
11763;Viltenė;Gandriukų;6355857716;Ne;4;4;2;10
11764;Viltenė;Gandriukų;7274368180;Taip;0;4;2;6
11765;Viltenė;Aitvariukai;51598096361;Taip;0;10;0;10
11766;Viltenė;Aitvariukai;15218988953;Taip;0;16;0;16
11767;Viltenė;Aitvariukai;9155192250;Taip;0;13;2;15
11768;Viltenė;Aitvariukai;9611851889;Taip;3;0;0;3
11769;Viltenė;Aitvariukai;5304966336;Taip;0;5;0;5
11770;Viltenė;Aitvariukai;3057761137;Ne;13;1;0;14
11771;Viltenė;Aitvariukai;6160715081;Taip;0;10;0;10
11772;Viltenė;Aitvariukai;5919786939;Taip;0;12;0;12
11773;Viltenė;Aitvariukai;17844870669;Taip;0;11;0;11
11774;Viltenė;Aitvariukai;56293220882;Taip;0;1;0;1
11775;Viltenė;Aitvariukai;8259812812;Taip;0;6;0;6
11776;Viltenė;Aitvariukai;23233966729;Ne;0;0;1;1
11777;Viltenė;Aitvariukai;44367763042;Taip;6;0;2;8
11778;Viltenė;Aitvariukai;99398043638;Taip;4;0;0;4
11779;Viltenė;Aitvariukai;1712349973;Taip;0;3;0;3
11780;Viltenė;Aitvariukai;55514676697;Taip;2;1;3;6
11781;Viltenė;Aitvariukai;14831307307;Taip;0;3;0;3
11782;Viltenė;Aitvariukai;70963916697;Taip;6;0;1;7
11783;Viltenė;Aitvariukai;5297513672;Taip;0;0;3;3
11784;Viltenė;Geniukų;5604263567;Taip;14;0;0;14
11785;Viltenė;Geniukų;1822220265;Ne;6;2;0;8
11786;Viltenė;Geniukų;9613791189;Taip;0;2;0;2
11787;Viltenė;Geniukų;1423254631;Ne;0;1;0;1
11788;Viltenė;Geniukų;3002690526;Ne;0;8;0;8
11789;Viltenė;Geniukų;6276349499;Ne;6;3;0;9
11790;Viltenė;Geniukų;3711956659;Taip;0;5;0;5
11791;Viltenė;Geniukų;1054469254;Taip;9;0;0;9
11792;Viltenė;Geniukų;4295285885;Taip;0;8;0;8
11793;Viltenė;Geniukų;6063181025;Taip;0;3;0;3
11794;Viltenė;Geniukų;1672091332;Taip;9;0;0;9
11795;Viltenė;Geniukų;3018271511;Taip;5;4;0;9
11796;Viltenė;Geniukų;49998813869;Taip;0;2;0;2
11797;Viltenė;Geniukų;3389110405;Taip;0;5;0;5
11798;Viltenė;Geniukų;4319685140;Ne;14;2;0;16
11799;Viltenė;Geniukų;8329611036;Ne;0;6;0;6
11800;Viltenė;Geniukų;8125023386;Taip;16;1;0;17
11801;Viltenė;Geniukų;9035687504;Ne;1;1;0;2
11802;Viltenė;Geniukų;1629377078;Taip;0;1;0;1
11803;Viltenė;Saulutės;2044754943;Taip;0;2;0;2
11804;Viltenė;Saulutės;1615415742;Taip;0;2;0;2
11805;Viltenė;Saulutės;7994367286;Ne;10;1;0;11
11806;Viltenė;Saulutės;6664059418;Taip;0;1;0;1
11807;Viltenė;Saulutės;2141002432;Taip;0;8;0;8
11808;Viltenė;Saulutės;1362308882;Ne;0;3;0;3
11809;Viltenė;Saulutės;8920533673;Taip;0;11;0;11
11810;Viltenė;Saulutės;5024192785;Taip;2;3;0;5
11811;Viltenė;Saulutės;92968672028;Ne;0;8;0;8
11812;Viltenė;Saulutės;1918867591;Ne;5;5;0;10
11813;Viltenė;Saulutės;7559243300;Taip;0;22;0;22
11814;Viltenė;Saulutės;3560474943;Taip;0;6;0;6
11815;Viltenė;Saulutės;2840208662;Taip;7;0;0;7
11816;Viltenė;Saulutės;1252657362;Taip;0;3;0;3
11817;Viltenė;Saulutės;2546789906;Taip;0;0;3;3
11818;Viltenė;Saulutės;7726650894;Taip;7;1;0;8
11819;Viltenė;Saulutės;3709362712;Ne;0;2;0;2
11820;Viltenė;Saulutės;3008272979;Taip;0;5;0;5
11821;Viltenė;Lapiukų;2016636764;Taip;0;1;0;1
11822;Viltenė;Lapiukų;1650304982;Taip;0;5;0;5
11823;Viltenė;Lapiukų;89844531860;Taip;0;5;0;5
11824;Viltenė;Lapiukų;60092202534;Taip;0;10;2;12
11825;Viltenė;Lapiukų;22318027000;Taip;0;3;0;3
11826;Viltenė;Lapiukų;1559623914;Taip;0;0;1;1
11827;Viltenė;Lapiukų;1042196397;Taip;0;5;0;5
11828;Viltenė;Lapiukų;1210824560;Taip;0;5;0;5
11829;Viltenė;Lapiukų;2065651722;Ne;3;2;1;6
11830;Viltenė;Lapiukų;3526237179;Taip;5;0;3;8
11831;Viltenė;Lapiukų;1662950901;Taip;0;0;1;1
11832;Viltenė;Lapiukų;1350487577;Ne;0;1;1;2
11833;Viltenė;Lapiukų;1592077335;Taip;0;4;0;4
11834;Viltenė;Lapiukų;1281808784;Ne;9;0;5;14
11835;Viltenė;Lapiukų;1726174128;Taip;0;9;5;14
11836;Viltenė;Lapiukų;4470172666;Taip;4;10;0;14
11837;Viltenė;Lapiukų;2527648089;Taip;0;0;2;2
11838;Viltenė;Lapiukų;93894985640;Ne;0;18;0;18
11839;Viltenė;Lapiukų;3259114583;Taip;0;14;0;14
11840;Viltenė;Voveriukai;8732323660;Taip;0;6;0;6
11841;Viltenė;Voveriukai;13795858727;Ne;0;6;0;6
11842;Viltenė;Voveriukai;69110885244;Taip;0;9;0;9
11843;Viltenė;Voveriukai;46757944454;Ne;10;3;0;13
11844;Viltenė;Voveriukai;69918162258;Taip;0;3;0;3
11845;Viltenė;Voveriukai;76569470768;Taip;0;2;0;2
11846;Viltenė;Voveriukai;1262222404;Ne;0;1;0;1
11847;Viltenė;Voveriukai;7245395388;Ne;0;6;0;6
11848;Viltenė;Voveriukai;77847693433;Taip;4;0;0;4
11849;Viltenė;Voveriukai;46252876577;Taip;3;0;0;3
11850;Viltenė;Voveriukai;92175043385;Taip;0;5;0;5
11851;Viltenė;Voveriukai;35466181637;Ne;4;1;0;5
11852;Viltenė;Voveriukai;54346881662;Taip;0;4;0;4
11853;Viltenė;Voveriukai;68243828276;Taip;6;1;0;7
11854;Viltenė;Voveriukai;1615151982;Taip;0;1;0;1
11855;Viltenė;Voveriukai;87296434240;Taip;0;1;0;1
11856;Viltenė;Voveriukai;51997485918;Ne;0;9;0;9
11857;Viltenė;Voveriukai;1872042290;Taip;0;11;0;11
11858;Viltenė;Voveriukai;2008408325;Ne;0;10;0;10
11859;Viltenė;Voveriukai;4441280059;Taip;5;1;0;6
11860;Viltenė;Kiškučiai;6040634853;Taip;19;0;0;19
11861;Viltenė;Kiškučiai;9101795131;Taip;0;1;0;1
11862;Viltenė;Kiškučiai;6296509460;Taip;0;2;0;2
11863;Viltenė;Kiškučiai;2702489251;Taip;12;3;0;15
11864;Viltenė;Kiškučiai;6810811656;Taip;4;1;0;5
11865;Viltenė;Kiškučiai;2013415571;Taip;5;4;0;9
11866;Viltenė;Kiškučiai;8679787688;Taip;10;0;0;10
11867;Viltenė;Kiškučiai;3908574248;Taip;10;0;0;10
11868;Viltenė;Kiškučiai;9228677568;Taip;0;4;0;4
11869;Viltenė;Kiškučiai;8477241365;Taip;20;0;0;20
11870;Viltenė;Kiškučiai;8840885039;Taip;4;1;0;5
11871;Viltenė;Kiškučiai;4616047113;Taip;0;1;0;1
11872;Viltenė;Kiškučiai;2642080849;Taip;6;0;0;6
11873;Viltenė;Kiškučiai;6171399579;Taip;0;21;0;21
11874;Viltenė;Kiškučiai;7045940267;Ne;5;0;0;5
11875;Viltenė;Kiškučiai;2894570917;Ne;0;1;0;1
11876;Viltenė;Nykštukų;2036902795;Taip;0;0;4;4
11877;Viltenė;Nykštukų;9476132305;Taip;22;0;0;22
11878;Viltenė;Nykštukų;5194925689;Ne;1;0;0;1
11879;Viltenė;Nykštukų;3679704404;Taip;0;10;0;10
11880;Viltenė;Nykštukų;1507287948;Taip;0;1;0;1
11881;Viltenė;Nykštukų;4121448859;Taip;10;0;0;10
11882;Viltenė;Nykštukų;5599943846;Taip;0;0;4;4
11883;Viltenė;Nykštukų;5552217000;Taip;2;5;0;7
11884;Viltenė;Nykštukų;3905014810;Ne;0;4;0;4
11885;Viltenė;Nykštukų;9157616307;Taip;5;2;0;7
11886;Viltenė;Nykštukų;3052677157;Taip;0;6;0;6
11887;Viltenė;Nykštukų;9063994291;Taip;0;0;1;1
11888;Viltenė;Nykštukų;3291926243;Taip;22;0;0;22
11889;Viltenė;Triušiukai;9756519374;Ne;0;7;0;7
11890;Viltenė;Triušiukai;5522245968;Taip;0;18;0;18
11891;Viltenė;Triušiukai;8696698257;Taip;2;1;0;3
11892;Viltenė;Triušiukai;8439859449;Taip;22;0;0;22
11893;Viltenė;Triušiukai;9820462941;Taip;0;1;0;1
11894;Viltenė;Triušiukai;2976705872;Taip;13;1;1;15
11895;Viltenė;Triušiukai;7928894276;Taip;10;2;0;12
11896;Viltenė;Triušiukai;8527270437;Taip;0;3;0;3
11897;Viltenė;Triušiukai;2660622296;Taip;3;7;0;10
11898;Viltenė;Triušiukai;4550915388;Taip;0;15;0;15
11899;Viltenė;Triušiukai;8122878153;Taip;9;1;3;13
11900;Viltenė;Triušiukai;2026654467;Taip;0;4;0;4
11901;Viltenė;Triušiukai;4641365031;Ne;4;3;0;7
11902;Viltenė;Triušiukai;7277455268;Taip;0;11;0;11
11903;Viltenė;Triušiukai;2410868015;Taip;0;1;0;1
11904;Viltenė;Triušiukai;3245284852;Taip;7;0;0;7
11905;Viltenė;Triušiukai;7401460248;Taip;0;3;0;3
11906;Viltenė;Triušiukai;4195708756;Taip;14;0;0;14
11907;Viltenė;Triušiukai;2786572522;Taip;13;0;0;13
11908;Voveraitė;ŽVIRBLIUKŲ;1522307865;Taip;0;3;0;3
11909;Voveraitė;ŽVIRBLIUKŲ;3258155215;Taip;2;1;0;3
11910;Voveraitė;VOVERIUKŲ;9195700962;Taip;4;13;0;17
11911;Voveraitė;VOVERIUKŲ;5138855000;Taip;2;0;0;2
11912;Voveraitė;VOVERIUKŲ;1340379090;Taip;0;4;0;4
11913;Voveraitė;VOVERIUKŲ;9912862474;Taip;8;6;0;14
11914;Voveraitė;VOVERIUKŲ;1960385335;Taip;4;0;0;4
11915;Voveraitė;VOVERIUKŲ;2594535017;Taip;4;1;0;5
11916;Voveraitė;VOVERIUKŲ;7746424196;Taip;1;6;0;7
11917;Voveraitė;VOVERIUKŲ;4563198733;Taip;0;1;0;1
11918;Voveraitė;VOVERIUKŲ;8373093305;Ne;6;2;0;8
11919;Voveraitė;VOVERIUKŲ;2662384275;Taip;0;1;0;1
11920;Voveraitė;VOVERIUKŲ;9514425475;Taip;7;0;0;7
11921;Voveraitė;VOVERIUKŲ;6017698476;Taip;0;5;0;5
11922;Voveraitė;VOVERIUKŲ;8580034134;Taip;2;6;0;8
11923;Voveraitė;VOVERIUKŲ;6891841301;Taip;1;7;0;8
11924;Voveraitė;VOVERIUKŲ;2627555750;Taip;18;3;0;21
11925;Voveraitė;VOVERIUKŲ;6113913885;Ne;0;7;0;7
11926;Voveraitė;VOVERIUKŲ;6007396459;Taip;1;4;0;5
11927;Voveraitė;KIŠKUČIŲ;3615729576;Ne;11;2;0;13
11928;Voveraitė;KIŠKUČIŲ;4338861332;Taip;0;3;0;3
11929;Voveraitė;KIŠKUČIŲ;9933037872;Taip;7;1;0;8
11930;Voveraitė;KIŠKUČIŲ;3113780055;Taip;0;1;0;1
11931;Voveraitė;KIŠKUČIŲ;65926130735;Taip;4;1;0;5
11932;Voveraitė;KIŠKUČIŲ;7069780513;Taip;9;0;0;9
11933;Voveraitė;KIŠKUČIŲ;9703726869;Taip;0;6;0;6
11934;Voveraitė;KIŠKUČIŲ;7314148938;Taip;4;1;0;5
11935;Voveraitė;KIŠKUČIŲ;4511771924;Taip;4;1;0;5
11936;Voveraitė;KIŠKUČIŲ;9007031372;Taip;19;1;0;20
11937;Voveraitė;KIŠKUČIŲ;6369860178;Taip;0;14;0;14
11938;Voveraitė;KIŠKUČIŲ;6649068571;Taip;0;2;0;2
11939;Voveraitė;KIŠKUČIŲ;1775800865;Taip;0;2;0;2
11940;Voveraitė;KIŠKUČIŲ;6433760749;Ne;4;6;0;10
11941;Voveraitė;KIŠKUČIŲ;54408671673;Taip;12;0;0;12
11942;Voveraitė;KIŠKUČIŲ;72154318379;Taip;12;0;0;12
11943;Voveraitė;KIŠKUČIŲ;1959958256;Ne;0;6;1;7
11944;Voveraitė;KIŠKUČIŲ;2693544600;Taip;0;2;0;2
11945;Voveraitė;KIŠKUČIŲ;6460834118;Taip;6;4;0;10
11946;Voveraitė;KODĖLČIUKŲ;3469734853;Taip;0;4;0;4
11947;Voveraitė;KODĖLČIUKŲ;9117809080;Taip;5;0;1;6
11948;Voveraitė;KODĖLČIUKŲ;5467979968;Taip;8;0;0;8
11949;Voveraitė;KODĖLČIUKŲ;46205148458;Taip;5;0;0;5
11950;Voveraitė;KODĖLČIUKŲ;1772758517;Ne;8;4;0;12
11951;Voveraitė;KODĖLČIUKŲ;51213803814;Taip;0;2;2;4
11952;Voveraitė;KODĖLČIUKŲ;36749754999;Taip;0;1;0;1
11953;Voveraitė;KODĖLČIUKŲ;6653141009;Taip;8;2;1;11
11954;Voveraitė;KODĖLČIUKŲ;4045121781;Taip;6;3;0;9
11955;Voveraitė;KODĖLČIUKŲ;2304004487;Taip;5;0;0;5
11956;Voveraitė;KODĖLČIUKŲ;2208396431;Ne;4;2;0;6
11957;Voveraitė;KODĖLČIUKŲ;5296850349;Taip;0;9;0;9
11958;Voveraitė;KODĖLČIUKŲ;4468214107;Taip;13;1;0;14
11959;Voveraitė;KODĖLČIUKŲ;9921313716;Taip;0;2;5;7
11960;Voveraitė;KODĖLČIUKŲ;5449490074;Ne;8;2;2;12
11961;Voveraitė;KODĖLČIUKŲ;7786378018;Ne;2;1;0;3
11962;Voveraitė;KODĖLČIUKŲ;6690309946;Taip;0;1;0;1
11963;Voveraitė;MEŠKIUKŲ;4079618555;Taip;0;6;0;6
11964;Voveraitė;MEŠKIUKŲ;3381417855;Taip;0;2;1;3
11965;Voveraitė;MEŠKIUKŲ;3703062195;Taip;6;1;0;7
11966;Voveraitė;MEŠKIUKŲ;8438876806;Taip;0;7;0;7
11967;Voveraitė;MEŠKIUKŲ;1058273156;Taip;0;2;0;2
11968;Voveraitė;MEŠKIUKŲ;9149748841;Taip;6;5;0;11
11969;Voveraitė;MEŠKIUKŲ;5576058454;Taip;10;0;0;10
11970;Voveraitė;MEŠKIUKŲ;1629942114;Ne;0;4;0;4
11971;Voveraitė;MEŠKIUKŲ;6359983706;Taip;3;3;0;6
11972;Voveraitė;MEŠKIUKŲ;17534618616;Ne;1;2;2;5
11973;Voveraitė;MEŠKIUKŲ;1592633500;Taip;0;10;0;10
11974;Voveraitė;MEŠKIUKŲ;5437283673;Taip;8;1;0;9
11975;Voveraitė;MEŠKIUKŲ;7797966139;Taip;0;7;0;7
11976;Voveraitė;MEŠKIUKŲ;3029983180;Taip;0;7;0;7
11977;Voveraitė;MEŠKIUKŲ;4680264973;Ne;0;1;0;1
11978;Voveraitė;MEŠKIUKŲ;5095849577;Taip;12;1;0;13
11979;Voveraitė;MEŠKIUKŲ;6886337758;Taip;0;16;0;16
11980;Voveraitė;MEŠKIUKŲ;6994680282;Taip;9;2;1;12
11981;Voveraitė;MEŠKIUKŲ;7861722125;Taip;5;4;0;9
11982;Voveraitė;BORUŽĖLIŲ;49205285378;Ne;0;3;0;3
11983;Voveraitė;BORUŽĖLIŲ;1587569563;Taip;0;6;0;6
11984;Voveraitė;BORUŽĖLIŲ;89216481616;Taip;0;3;0;3
11985;Voveraitė;BORUŽĖLIŲ;46318035221;Taip;5;0;1;6
11986;Voveraitė;BORUŽĖLIŲ;26080915874;Taip;0;6;0;6
11987;Voveraitė;BORUŽĖLIŲ;3818120898;Taip;0;3;0;3
11988;Voveraitė;BORUŽĖLIŲ;64724933885;Taip;3;2;0;5
11989;Voveraitė;BORUŽĖLIŲ;69797506996;Ne;0;4;0;4
11990;Voveraitė;BORUŽĖLIŲ;26264960973;Taip;0;0;1;1
11991;Voveraitė;BORUŽĖLIŲ;89873985894;Taip;0;1;0;1
11992;Voveraitė;BORUŽĖLIŲ;76074825733;Taip;0;3;1;4
11993;Voveraitė;BORUŽĖLIŲ;61376515242;Taip;0;3;0;3
11994;Voveraitė;BORUŽĖLIŲ;47111956594;Taip;0;7;1;8
11995;Voveraitė;BORUŽĖLIŲ;53801893219;Ne;0;2;2;4
11996;Voveraitė;BORUŽĖLIŲ;59442802443;Taip;5;1;0;6
11997;Voveraitė;BORUŽĖLIŲ;1398043988;Taip;0;0;4;4
11998;Voveraitė;BORUŽĖLIŲ;22913200509;Taip;0;1;3;4
11999;Voveraitė;PELĖDŽIUKŲ;1689261748;Taip;0;2;0;2
12000;Voveraitė;PELĖDŽIUKŲ;7671966977;Taip;0;0;1;1
12001;Voveraitė;PELĖDŽIUKŲ;30591405375;Taip;10;1;0;11
12002;Voveraitė;PELĖDŽIUKŲ;42683378356;Taip;0;1;0;1
12003;Voveraitė;PELĖDŽIUKŲ;46665609670;Taip;0;1;4;5
12004;Voveraitė;PELĖDŽIUKŲ;68005956631;Taip;0;4;0;4
12005;Voveraitė;PELĖDŽIUKŲ;32030461873;Taip;0;2;0;2
12006;Voveraitė;PELĖDŽIUKŲ;5354784149;Taip;0;0;7;7
12007;Voveraitė;PELĖDŽIUKŲ;3292830298;Taip;0;0;6;6
12008;Voveraitė;PELĖDŽIUKŲ;86045196465;Taip;0;0;1;1
12009;Voveraitė;PELĖDŽIUKŲ;3756080192;Taip;0;0;15;15
12010;Voveraitė;PELĖDŽIUKŲ;1018558040;Taip;0;2;0;2
12011;Voveraitė;PELĖDŽIUKŲ;5804909515;Taip;0;3;2;5
12012;Voveraitė;PELĖDŽIUKŲ;41221846403;Taip;0;4;0;4
12013;Voveraitė;DRUGELIŲ;9623406874;Taip;6;1;0;7
12014;Voveraitė;DRUGELIŲ;1668695462;Taip;0;0;2;2
12015;Voveraitė;DRUGELIŲ;1753442884;Taip;0;1;0;1
12016;Voveraitė;DRUGELIŲ;63032690186;Ne;0;1;0;1
12017;Voveraitė;DRUGELIŲ;7974406524;Taip;0;11;1;12
12018;Voveraitė;DRUGELIŲ;8538259157;Taip;3;1;0;4
12019;Voveraitė;DRUGELIŲ;81628846458;Taip;0;1;0;1
12020;Voveraitė;DRUGELIŲ;2044914624;Ne;1;9;0;10
12021;Voveraitė;DRUGELIŲ;5037713667;Taip;3;0;0;3
12022;Voveraitė;DRUGELIŲ;80330740714;Taip;0;6;0;6
12023;Voveraitė;DRUGELIŲ;6729475469;Taip;0;5;0;5
12024;Voveraitė;DRUGELIŲ;1397274691;Ne;0;10;0;10
12025;Voveraitė;DRUGELIŲ;1612322367;Taip;0;5;0;5
12026;Voveraitė;DRUGELIŲ;6847620019;Ne;0;9;0;9
12027;Voveraitė;DRUGELIŲ;53507758884;Taip;0;3;0;3
12028;Voveraitė;DRUGELIŲ;1780573926;Taip;0;4;0;4
12029;Voveraitė;DRUGELIŲ;8443005812;Taip;9;0;0;9
12030;Voveraitė;DRUGELIŲ;1449122395;Ne;0;7;0;7
12031;Voveraitė;NYKŠTUKŲ;59346262217;Ne;0;7;3;10
12032;Voveraitė;NYKŠTUKŲ;44115826781;Taip;0;1;0;1
12033;Voveraitė;NYKŠTUKŲ;67851579200;Taip;0;10;0;10
12034;Voveraitė;NYKŠTUKŲ;2902148527;Taip;0;4;0;4
12035;Voveraitė;NYKŠTUKŲ;28656009009;Taip;4;2;0;6
12036;Voveraitė;NYKŠTUKŲ;1704834744;Taip;0;2;0;2
12037;Voveraitė;NYKŠTUKŲ;35549553867;Taip;7;3;1;11
12038;Voveraitė;NYKŠTUKŲ;49924157014;Taip;0;2;4;6
12039;Voveraitė;NYKŠTUKŲ;41182124889;Taip;5;0;0;5
12040;Voveraitė;NYKŠTUKŲ;13173711840;Taip;0;22;0;22
12041;Voveraitė;NYKŠTUKŲ;602726070;Taip;4;0;0;4
12042;Voveraitė;NYKŠTUKŲ;27132982320;Taip;0;5;0;5
12043;Voveraitė;NYKŠTUKŲ;107968318;Taip;8;2;0;10
12044;Voveraitė;NYKŠTUKŲ;2762066479;Taip;0;2;0;2
12045;Voveraitė;NYKŠTUKŲ;66612277823;Taip;7;1;0;8
12046;Voveraitė;NYKŠTUKŲ;82642244788;Taip;1;1;0;2
12047;Voveraitė;NYKŠTUKŲ;2051732666;Ne;0;10;0;10
12048;Voveraitė;NYKŠTUKŲ;4163635632;Taip;5;3;0;8
12049;Voveraitė;NYKŠTUKŲ;1513069857;Ne;3;7;5;15
12050;Voveraitė;GENIUKŲ;63276868064;Taip;0;2;4;6
12051;Voveraitė;GENIUKŲ;3137529068;Taip;0;2;0;2
12052;Voveraitė;GENIUKŲ;34170702690;Taip;0;3;0;3
12053;Voveraitė;GENIUKŲ;12366200545;Taip;0;2;3;5
12054;Voveraitė;GENIUKŲ;90970378921;Taip;4;0;0;4
12055;Voveraitė;GENIUKŲ;15716865051;Ne;0;1;0;1
12056;Voveraitė;GENIUKŲ;30515775412;Taip;0;0;3;3
12057;Voveraitė;GENIUKŲ;14865004407;Taip;0;1;0;1
12058;Voveraitė;GENIUKŲ;35850480678;Taip;0;0;1;1
12059;Voveraitė;GENIUKŲ;39956224681;Taip;0;2;11;13
12060;Voveraitė;GENIUKŲ;1055423524;Ne;0;4;3;7
12061;Voveraitė;GENIUKŲ;1261834247;Taip;0;2;0;2
12062;Voveraitė;GENIUKŲ;6898251154;Taip;0;2;5;7
12063;Voveraitė;LAPIUKŲ;1141304286;Taip;4;5;0;9
12064;Voveraitė;LAPIUKŲ;1510853268;Taip;0;2;1;3
12065;Voveraitė;LAPIUKŲ;3388547792;Taip;3;7;0;10
12066;Voveraitė;LAPIUKŲ;8344323109;Taip;0;6;0;6
12067;Voveraitė;LAPIUKŲ;2716400502;Taip;0;2;6;8
12068;Voveraitė;LAPIUKŲ;7008576999;Taip;0;2;4;6
12069;Voveraitė;LAPIUKŲ;4300235743;Taip;3;10;6;19
12070;Voveraitė;LAPIUKŲ;7531020548;Ne;0;5;3;8
12071;Voveraitė;LAPIUKŲ;7990479988;Taip;0;1;0;1
12072;Voveraitė;LAPIUKŲ;8421104790;Taip;19;0;1;20
12073;Voveraitė;LAPIUKŲ;7640409923;Taip;9;10;0;19
12074;Voveraitė;LAPIUKŲ;4350450125;Taip;0;8;3;11
12075;Voveraitė;EŽIUKŲ;6572172779;Taip;0;0;6;6
12076;Voveraitė;EŽIUKŲ;8084986328;Taip;4;0;2;6
12077;Voveraitė;EŽIUKŲ;8746008166;Taip;17;0;0;17
12078;Voveraitė;EŽIUKŲ;8507818993;Taip;0;6;0;6
12079;Voveraitė;EŽIUKŲ;3736638759;Taip;5;2;0;7
12080;Voveraitė;EŽIUKŲ;6261152304;Taip;0;3;11;14
12081;Voveraitė;EŽIUKŲ;9537862791;Taip;4;0;4;8
12082;Voveraitė;EŽIUKŲ;4478984171;Taip;4;2;0;6
12083;Voveraitė;EŽIUKŲ;3058377539;Taip;0;2;0;2
12084;Voveraitė;EŽIUKŲ;5114768009;Taip;4;1;0;5
12085;Voveraitė;EŽIUKŲ;4626178764;Taip;0;14;8;22
12086;Voveraitė;EŽIUKŲ;1550830434;Taip;0;6;0;6
12087;Voveraitė;EŽIUKŲ;8220437514;Taip;0;0;1;1
12088;"Trakų Vokė";Voveriukų;2906508821;Ne;22;0;0;22
12089;"Trakų Vokė";Voveriukų;2389794233;Taip;22;0;0;22
12090;"Trakų Vokė";Voveriukų;9233090228;Taip;0;0;2;2
12091;"Trakų Vokė";Voveriukų;2880299812;Taip;4;0;0;4
12092;"Trakų Vokė";Voveriukų;4854440884;Taip;22;0;0;22
12093;"Trakų Vokė";Voveriukų;2761614687;Taip;22;0;0;22
12094;"Trakų Vokė";Voveriukų;1360046096;Taip;13;0;3;16
12095;"Trakų Vokė";Voveriukų;3328527700;Taip;4;1;0;5
12096;"Trakų Vokė";Voveriukų;3278842582;Taip;2;0;1;3
12097;"Trakų Vokė";Voveriukų;2869217654;Taip;0;0;3;3
12098;"Trakų Vokė";Voveriukų;6277305384;Taip;0;0;5;5
12099;"Trakų Vokė";Voveriukų;6369848950;Taip;5;0;0;5
12100;"Trakų Vokė";Voveriukų;6326568445;Taip;0;1;1;2
12101;"Trakų Vokė";Voveriukų;4040038648;Taip;3;0;0;3
12102;"Trakų Vokė";Voveriukų;7727246187;Taip;0;1;3;4
12103;"Trakų Vokė";Voveriukų;5206616285;Taip;8;0;2;10
12104;"Trakų Vokė";Voveriukų;4535167417;Taip;0;1;0;1
12105;"Trakų Vokė";Boružėlių;3209594216;Taip;0;0;4;4
12106;"Trakų Vokė";Boružėlių;6732422645;Ne;0;12;1;13
12107;"Trakų Vokė";Boružėlių;5338798362;Ne;14;0;1;15
12108;"Trakų Vokė";Boružėlių;3319243283;Taip;0;0;2;2
12109;"Trakų Vokė";Boružėlių;1039690987;Taip;6;0;1;7
12110;"Trakų Vokė";Boružėlių;2516219363;Taip;0;0;3;3
12111;"Trakų Vokė";Boružėlių;7858812338;Ne;0;0;8;8
12112;"Trakų Vokė";Boružėlių;3913623741;Taip;0;0;1;1
12113;"Trakų Vokė";Boružėlių;2730385281;Taip;5;0;0;5
12114;"Trakų Vokė";Boružėlių;1088928094;Taip;9;0;1;10
12115;"Trakų Vokė";Boružėlių;7318458282;Taip;9;1;0;10
12116;"Trakų Vokė";Boružėlių;6908913934;Ne;7;0;1;8
12117;"Trakų Vokė";Boružėlių;7909596435;Taip;7;0;0;7
12118;"Trakų Vokė";Boružėlių;5251929660;Taip;0;2;0;2
12119;"Trakų Vokė";Boružėlių;7752786907;Taip;16;0;0;16
12120;"Trakų Vokė";Boružėlių;2475068032;Taip;0;0;11;11
12121;"Trakų Vokė";Boružėlių;4601374629;Ne;4;0;3;7
12122;"Trakų Vokė";Boružėlių;4014027030;Taip;0;5;0;5
12123;"Trakų Vokė";Boružėlių;7660240598;Taip;0;10;0;10
12124;"Trakų Vokė";Boružėlių;4438127190;Ne;15;0;1;16
12125;"Trakų Vokė";Boružėlių;2388817616;Taip;4;0;0;4
12126;"Trakų Vokė";Boružėlių;9453317084;Ne;11;0;0;11
12127;"Trakų Vokė";Boružėlių;1080300137;Taip;0;3;0;3
12128;"Trakų Vokė";Boružėlių;2469340933;Taip;0;10;7;17
12129;"Trakų Vokė";KIŠKUČIŲ;88989814775;Ne;4;0;0;4
12130;"Trakų Vokė";KIŠKUČIŲ;6675993703;Taip;3;0;4;7
12131;"Trakų Vokė";KIŠKUČIŲ;87781186373;Ne;0;0;1;1
12132;"Trakų Vokė";KIŠKUČIŲ;69866048102;Taip;13;4;0;17
12133;"Trakų Vokė";KIŠKUČIŲ;64083541565;Ne;4;0;1;5
12134;"Trakų Vokė";KIŠKUČIŲ;67434532111;Taip;0;13;0;13
12135;"Trakų Vokė";KIŠKUČIŲ;26598573711;Ne;0;0;2;2
12136;"Trakų Vokė";KIŠKUČIŲ;69311478204;Taip;5;0;2;7
12137;"Trakų Vokė";KIŠKUČIŲ;71417288063;Taip;0;0;1;1
12138;"Trakų Vokė";KIŠKUČIŲ;44023296535;Ne;0;4;0;4
12139;"Trakų Vokė";KIŠKUČIŲ;6418198934;Taip;10;0;1;11
12140;"Trakų Vokė";KIŠKUČIŲ;50697040061;Taip;0;0;12;12
12141;"Trakų Vokė";KIŠKUČIŲ;64019248229;Taip;0;5;0;5
12142;"Trakų Vokė";KIŠKUČIŲ;18796898215;Taip;3;0;1;4
12143;"Trakų Vokė";KIŠKUČIŲ;21329819892;Taip;3;0;1;4
12144;"Trakų Vokė";KIŠKUČIŲ;9705561511;Taip;0;0;1;1
12145;"Trakų Vokė";KIŠKUČIŲ;5109850366;Ne;0;3;0;3
12146;"Trakų Vokė";KIŠKUČIŲ;85293469079;Taip;3;0;2;5
12147;"Trakų Vokė";BITUČIŲ;3406479364;Taip;0;3;0;3
12148;"Trakų Vokė";BITUČIŲ;1461337199;Taip;1;0;1;2
12149;"Trakų Vokė";BITUČIŲ;3373764541;Taip;0;4;0;4
12150;"Trakų Vokė";BITUČIŲ;4849992906;Taip;0;5;0;5
12151;"Trakų Vokė";BITUČIŲ;3098390989;Ne;5;0;0;5
12152;"Trakų Vokė";BITUČIŲ;50553766116;Taip;3;0;0;3
12153;"Trakų Vokė";BITUČIŲ;4903261568;Taip;3;0;1;4
12154;"Trakų Vokė";BITUČIŲ;1590598232;Taip;5;0;5;10
12155;"Trakų Vokė";BITUČIŲ;8857529726;Taip;0;0;3;3
12156;"Trakų Vokė";BITUČIŲ;4846130117;Taip;0;1;0;1
12157;"Trakų Vokė";BITUČIŲ;1433982328;Taip;0;6;0;6
12158;"Trakų Vokė";BITUČIŲ;7566567901;Taip;0;2;3;5
12159;"Trakų Vokė";BITUČIŲ;1623166260;Taip;5;0;2;7
12160;Zylutė;Katerok;8749296671;Taip;5;1;0;6
12161;Zylutė;Katerok;1621772702;Taip;0;1;1;2
12162;Zylutė;Katerok;4592825972;Taip;0;10;0;10
12163;Zylutė;Katerok;8747721198;Taip;0;7;0;7
12164;Zylutė;Katerok;8212030518;Taip;0;9;0;9
12165;Zylutė;Katerok;7706833089;Taip;0;6;0;6
12166;Zylutė;Katerok;8618778936;Taip;0;1;0;1
12167;Zylutė;Katerok;1897871944;Taip;0;6;0;6
12168;Zylutė;Katerok;5687201052;Taip;0;1;1;2
12169;Zylutė;Katerok;1797701777;Taip;7;0;0;7
12170;Zylutė;Katerok;5264930854;Taip;0;6;0;6
12171;Zylutė;Katerok;1452384017;Taip;0;0;10;10
12172;Zylutė;Katerok;2945894661;Taip;5;1;1;7
12173;Zylutė;Katerok;9986289837;Taip;7;0;0;7
12174;Zylutė;"Vesole misiaki";86301183281;Taip;0;6;0;6
12175;Zylutė;"Vesole misiaki";9262869284;Taip;12;3;0;15
12176;Zylutė;"Vesole misiaki";1256879956;Ne;7;6;0;13
12177;Zylutė;"Vesole misiaki";3126726854;Taip;0;3;0;3
12178;Zylutė;"Vesole misiaki";9484752315;Taip;0;5;0;5
12179;Zylutė;"Vesole misiaki";7140223126;Taip;0;1;0;1
12180;Zylutė;"Vesole misiaki";81796510706;Ne;0;20;0;20
12181;Zylutė;"Vesole misiaki";7606434084;Taip;6;1;0;7
12182;Zylutė;"Vesole misiaki";9953834483;Taip;0;1;0;1
12183;Zylutė;"Vesole misiaki";9664467134;Ne;3;0;0;3
12184;Zylutė;"Vesole misiaki";8336138549;Taip;21;0;0;21
12185;Zylutė;"Vesole misiaki";2445444641;Taip;0;5;0;5
12186;Zylutė;"Vesole misiaki";9908198854;Taip;6;2;0;8
12187;Zylutė;"Vesole misiaki";3332865242;Taip;12;0;0;12
12188;Zylutė;NYKŠTUKAI;19429820228;Taip;0;8;0;8
12189;Zylutė;NYKŠTUKAI;40369749025;Taip;0;2;0;2
12190;Zylutė;NYKŠTUKAI;1187261223;Ne;0;4;3;7
12191;Zylutė;NYKŠTUKAI;2276463136;Taip;11;0;0;11
12192;Zylutė;NYKŠTUKAI;7042731356;Taip;3;9;0;12
12193;Zylutė;NYKŠTUKAI;27488840113;Taip;5;1;0;6
12194;Zylutė;NYKŠTUKAI;35300054087;Taip;0;2;0;2
12195;Zylutė;NYKŠTUKAI;3246229837;Taip;9;0;4;13
12196;Zylutė;NYKŠTUKAI;4394023057;Taip;0;14;0;14
12197;Zylutė;NYKŠTUKAI;2153133102;Taip;5;9;0;14
12198;Zylutė;NYKŠTUKAI;2910542367;Taip;0;1;0;1
12199;Zylutė;NYKŠTUKAI;8141884164;Ne;14;3;0;17
12200;Zylutė;Ručijok;6112586092;Taip;0;4;0;4
12201;Zylutė;Ručijok;5045652581;Taip;9;8;0;17
12202;Zylutė;Ručijok;3547185618;Ne;0;2;0;2
12203;Zylutė;Ručijok;9913001904;Ne;6;9;0;15
12204;Zylutė;Ručijok;9381656201;Taip;13;5;0;18
12205;Zylutė;Ručijok;2654373943;Taip;9;1;0;10
12206;Zylutė;Ručijok;4497904128;Taip;11;3;0;14
12207;Zylutė;Ručijok;9586800176;Taip;0;6;0;6
12208;Zylutė;Ručijok;3355159275;Taip;0;7;0;7
12209;Zylutė;Ručijok;9995791665;Taip;9;7;0;16
12210;Zylutė;Ručijok;4916625058;Taip;8;0;0;8
12211;Zylutė;Ručijok;8178488164;Taip;12;0;1;13
12212;Zylutė;Ručijok;6848387941;Taip;14;1;2;17
12213;Zylutė;Ručijok;6962852787;Taip;0;6;0;6
12214;Zylutė;Ručijok;4548205666;Taip;0;6;0;6
12215;Zylutė;Ručijok;9220918504;Taip;0;6;0;6
12216;Zylutė;Raduga;9325387975;Taip;0;13;0;13
12217;Zylutė;Raduga;3363212754;Taip;5;0;3;8
12218;Zylutė;Raduga;6569135467;Taip;8;0;0;8
12219;Zylutė;Raduga;3117948118;Taip;0;0;6;6
12220;Zylutė;Raduga;2654794460;Taip;8;0;0;8
12221;Zylutė;Raduga;1423890598;Taip;0;6;15;21
12222;Zylutė;Raduga;3826815202;Taip;5;0;1;6
12223;Zylutė;Raduga;3943002728;Taip;8;0;0;8
12224;Zylutė;Raduga;4043810535;Taip;7;0;0;7
12225;Zylutė;Raduga;2107123106;Ne;12;0;1;13
12226;Zylutė;Raduga;7482740111;Taip;0;0;12;12
12227;Zylutė;Raduga;6995285377;Ne;11;5;0;16
12228;Zylutė;Raduga;2559643556;Taip;5;0;17;22
12229;Zylutė;Raduga;7824348276;Ne;10;2;0;12
12230;Zylutė;Raduga;4811667497;Ne;17;0;1;18
12231;Zylutė;Raduga;5683151005;Taip;1;2;0;3
12232;Zylutė;Raduga;2681013154;Ne;0;22;0;22
12233;Zylutė;Raduga;6391999153;Taip;4;0;0;4
12234;Zylutė;Raduga;6833030749;Taip;9;5;0;14
12235;Zylutė;Raduga;4493469560;Taip;13;0;2;15
12236;Zylutė;Raduga;4416434150;Taip;0;6;0;6
12237;Zylutė;Raduga;3608920051;Ne;0;3;0;3
12238;Zylutė;"Miki Maus";5027134228;Taip;0;11;0;11
12239;Zylutė;"Miki Maus";4543822765;Taip;0;15;0;15
12240;Zylutė;"Miki Maus";9457457032;Taip;13;0;1;14
12241;Zylutė;"Miki Maus";1290248125;Ne;5;0;0;5
12242;Zylutė;"Miki Maus";1580781723;Taip;3;4;0;7
12243;Zylutė;"Miki Maus";3633983359;Taip;22;0;0;22
12244;Zylutė;"Miki Maus";6833822248;Taip;8;0;0;8
12245;Zylutė;"Miki Maus";5589330186;Taip;7;0;0;7
12246;Zylutė;"Miki Maus";9737308076;Taip;0;8;0;8
12247;Zylutė;"Miki Maus";9162232979;Taip;7;0;1;8
12248;Zylutė;"Miki Maus";3848401615;Taip;7;0;1;8
12249;Zylutė;"Miki Maus";2999425729;Ne;11;0;0;11
12250;Zylutė;"Miki Maus";9250902486;Taip;10;1;0;11
12251;Zylutė;Solnyško;52293061924;Taip;0;4;0;4
12252;Zylutė;Solnyško;50784859977;Taip;0;1;0;1
12253;Zylutė;Solnyško;2020113161;Taip;5;0;0;5
12254;Zylutė;Solnyško;16723015849;Ne;4;1;0;5
12255;Zylutė;Solnyško;53283282669;Taip;3;0;0;3
12256;Zylutė;Solnyško;63287117036;Ne;0;5;0;5
12257;Zylutė;Solnyško;1979823314;Taip;0;10;0;10
12258;Zylutė;Solnyško;36486637873;Ne;0;3;0;3
12259;Zylutė;Solnyško;91938227358;Ne;0;12;0;12
12260;Zylutė;Solnyško;55672880453;Ne;0;9;0;9
12261;Zylutė;Solnyško;63798640792;Ne;0;9;0;9
12262;Zylutė;Solnyško;1059365398;Taip;2;0;0;2
12263;Zylutė;Solnyško;91534371407;Taip;0;0;14;14
12264;Zylutė;Motyliok;45252076215;Ne;0;0;22;22
12265;Zylutė;Motyliok;45779928616;Taip;0;3;0;3
12266;Zylutė;Motyliok;31724596372;Taip;0;6;0;6
12267;Zylutė;Motyliok;1001570452;Taip;0;7;0;7
12268;Zylutė;Motyliok;1598044320;Taip;0;2;0;2
12269;Zylutė;Motyliok;1756267879;Taip;9;0;0;9
12270;Zylutė;Motyliok;1801436436;Taip;0;18;0;18
12271;Zylutė;Motyliok;1445891751;Taip;0;7;0;7
12272;Zylutė;Motyliok;1873200936;Taip;0;1;0;1
12273;Zylutė;Motyliok;86763862813;Ne;2;0;0;2
12274;Zylutė;Motyliok;8546942240;Taip;0;0;4;4
12275;Zylutė;Motyliok;7712651566;Ne;0;9;0;9
12276;Zylutė;Motyliok;42101273435;Taip;0;2;0;2
12277;Zylutė;Motyliok;35364823312;Taip;3;7;0;10
12278;Zylutė;ŽVIRBLIUKAI;20569748356;Ne;0;1;3;4
12279;Zylutė;ŽVIRBLIUKAI;8783866036;Taip;8;8;0;16
12280;Zylutė;ŽVIRBLIUKAI;2274290871;Taip;8;10;0;18
12281;Zylutė;ŽVIRBLIUKAI;9902286013;Taip;4;0;1;5
12282;Zylutė;ŽVIRBLIUKAI;4154010905;Taip;4;0;0;4
12283;Zylutė;ŽVIRBLIUKAI;3919565034;Taip;0;0;4;4
12284;Zylutė;ŽVIRBLIUKAI;6865973084;Taip;0;7;3;10
12285;Zylutė;ŽVIRBLIUKAI;8627523283;Taip;0;13;0;13
12286;Zylutė;ŽVIRBLIUKAI;3606566852;Taip;11;1;0;12
12287;Zylutė;ŽVIRBLIUKAI;8874692591;Taip;0;4;0;4
12288;Zylutė;ŽVIRBLIUKAI;5431521522;Taip;8;1;0;9
12289;Zylutė;ŽVIRBLIUKAI;6548786007;Ne;0;3;0;3
12290;Zylutė;ŽVIRBLIUKAI;3074954453;Taip;3;0;0;3
12291;Zylutė;ŽVIRBLIUKAI;6221528830;Taip;10;3;0;13
12292;Zylutė;ŽVIRBLIUKAI;1048279422;Ne;10;0;4;14
12293;Zylutė;"DRUŽNYJE REBIATA";1428614163;Taip;0;9;0;9
12294;Zylutė;"DRUŽNYJE REBIATA";1674095701;Taip;4;3;0;7
12295;Zylutė;"DRUŽNYJE REBIATA";3379725202;Ne;0;8;0;8
12296;Zylutė;"DRUŽNYJE REBIATA";67435726524;Taip;0;5;0;5
12297;Zylutė;"DRUŽNYJE REBIATA";3843999609;Taip;0;8;10;18
12298;Zylutė;"DRUŽNYJE REBIATA";3036582121;Ne;6;1;0;7
12299;Zylutė;"DRUŽNYJE REBIATA";9163527400;Ne;0;1;0;1
12300;Zylutė;"DRUŽNYJE REBIATA";2157398751;Ne;0;6;0;6
12301;Zylutė;"DRUŽNYJE REBIATA";4302751308;Taip;0;18;0;18
12302;Zylutė;"DRUŽNYJE REBIATA";8293541980;Taip;5;0;6;11
12303;Zylutė;"DRUŽNYJE REBIATA";5452659798;Ne;0;5;0;5
12304;Zylutė;"DRUŽNYJE REBIATA";9589810356;Taip;4;8;0;12
12305;Zylutė;"DRUŽNYJE REBIATA";5224781417;Ne;0;2;0;2
12306;Zylutė;"DRUŽNYJE REBIATA";5162635301;Ne;0;4;0;4
12307;Zylutė;"DRUŽNYJE REBIATA";7023565057;Taip;15;0;0;15
12308;Zylutė;"DRUŽNYJE REBIATA";3254847545;Ne;0;1;0;1
12309;Zylutė;"DRUŽNYJE REBIATA";5803032683;Taip;0;7;0;7
12310;Zylutė;"DRUŽNYJE REBIATA";3089235413;Taip;0;6;3;9
12311;Zylutė;"DRUŽNYJE REBIATA";8180889070;Taip;4;0;0;4
12312;Zylutė;VIEVERSĖLIAI;4505081448;Taip;2;11;0;13
12313;Zylutė;VIEVERSĖLIAI;5172154642;Taip;0;8;0;8
12314;Zylutė;VIEVERSĖLIAI;6907378757;Taip;0;1;0;1
12315;Zylutė;VIEVERSĖLIAI;6723650872;Taip;0;1;0;1
12316;Zylutė;VIEVERSĖLIAI;3810636967;Taip;0;3;1;4
12317;Zylutė;VIEVERSĖLIAI;6154352500;Taip;0;2;0;2
12318;Zylutė;VIEVERSĖLIAI;4016518230;Taip;0;1;0;1
12319;Zylutė;VIEVERSĖLIAI;9660898505;Taip;0;8;0;8
12320;Zylutė;VIEVERSĖLIAI;57138305703;Ne;0;20;0;20
12321;Zylutė;VIEVERSĖLIAI;5544338521;Taip;0;1;0;1
12322;Zylutė;VIEVERSĖLIAI;4764295850;Taip;0;15;0;15
12323;Zylutė;VIEVERSĖLIAI;4966816780;Taip;0;1;0;1
12324;Zylutė;VIEVERSĖLIAI;4104979263;Ne;4;0;1;5
12325;Želmenėliai;Bitučių;4681686872;Ne;0;1;0;1
12326;Želmenėliai;Bitučių;3268310531;Taip;5;6;0;11
12327;Želmenėliai;Bitučių;5211426226;Taip;8;6;0;14
12328;Želmenėliai;Bitučių;2122665619;Taip;3;0;0;3
12329;Želmenėliai;Bitučių;2563117992;Taip;2;0;0;2
12330;Želmenėliai;Bitučių;6799702725;Ne;2;2;0;4
12331;Želmenėliai;Bitučių;8358780570;Taip;0;2;0;2
12332;Želmenėliai;Bitučių;9006406225;Taip;5;2;0;7
12333;Želmenėliai;Bitučių;7423900312;Taip;5;2;3;10
12334;Želmenėliai;Bitučių;2102401372;Taip;3;2;0;5
12335;Želmenėliai;Bitučių;4931835807;Taip;1;1;0;2
12336;Želmenėliai;Bitučių;6481952132;Taip;1;1;0;2
12337;Želmenėliai;Bitučių;9611741258;Taip;0;9;0;9
12338;Želmenėliai;Bitučių;1619143702;Taip;0;9;0;9
12339;Želmenėliai;Bitučių;2794274146;Taip;5;12;0;17
12340;Želmenėliai;Bitučių;9825545754;Ne;0;1;0;1
12341;Želmenėliai;Bitučių;5314438217;Taip;4;1;0;5
12342;Želmenėliai;Bitučių;4927030144;Taip;1;11;0;12
12343;Želmenėliai;Bitučių;1751328192;Taip;2;6;0;8
12344;Želmenėliai;Kačiukų;53611793303;Taip;0;1;0;1
12345;Želmenėliai;Kačiukų;25991128602;Ne;14;0;0;14
12346;Želmenėliai;Kačiukų;50204719384;Taip;0;5;0;5
12347;Želmenėliai;Kačiukų;75215159489;Taip;0;6;0;6
12348;Želmenėliai;Kačiukų;68168210430;Ne;0;1;0;1
12349;Želmenėliai;Kačiukų;52474082386;Taip;0;5;0;5
12350;Želmenėliai;Kačiukų;32945118976;Taip;0;7;3;10
12351;Želmenėliai;Kačiukų;72091418618;Ne;0;3;0;3
12352;Želmenėliai;Kačiukų;80129197524;Ne;0;1;0;1
12353;Želmenėliai;Kačiukų;93374623931;Ne;0;0;2;2
12354;Želmenėliai;Kačiukų;41941728755;Taip;0;0;5;5
12355;Želmenėliai;Kačiukų;98487229210;Taip;0;1;0;1
12356;Želmenėliai;Kačiukų;11316462529;Taip;0;0;9;9
12357;Želmenėliai;Kačiukų;1064518850;Taip;0;3;0;3
12358;Želmenėliai;Kačiukų;1868937175;Taip;0;13;0;13
12359;Želmenėliai;Voveriukų;38426234048;Taip;6;1;0;7
12360;Želmenėliai;Voveriukų;1799477959;Taip;0;7;0;7
12361;Želmenėliai;Voveriukų;3258904017;Taip;0;1;0;1
12362;Želmenėliai;Voveriukų;6783113916;Taip;0;2;0;2
12363;Želmenėliai;Voveriukų;2044063398;Taip;22;0;0;22
12364;Želmenėliai;Voveriukų;2005437403;Taip;0;10;0;10
12365;Želmenėliai;Voveriukų;27187464726;Taip;4;1;0;5
12366;Želmenėliai;Voveriukų;1952686295;Ne;15;0;0;15
12367;Želmenėliai;Voveriukų;1342094235;Ne;0;0;22;22
12368;Želmenėliai;Voveriukų;5214021520;Ne;0;0;22;22
12369;Želmenėliai;Voveriukų;3490705425;Ne;3;3;0;6
12370;Želmenėliai;Voveriukų;6478525575;Taip;14;3;0;17
12371;Želmenėliai;Voveriukų;2231634495;Taip;14;3;0;17
12372;Želmenėliai;Voveriukų;1582618217;Taip;0;13;0;13
12373;Želmenėliai;Voveriukų;7054808979;Ne;15;0;0;15
12374;Želmenėliai;Ežiukų;34055134038;Ne;0;2;5;7
12375;Želmenėliai;Ežiukų;63879513374;Ne;0;6;0;6
12376;Želmenėliai;Ežiukų;12336777368;Ne;4;3;0;7
12377;Želmenėliai;Ežiukų;65633625929;Ne;0;2;0;2
12378;Želmenėliai;Ežiukų;5345737656;Ne;0;2;0;2
12379;Želmenėliai;Ežiukų;34529381726;Taip;0;2;0;2
12380;Želmenėliai;Ežiukų;16400566719;Taip;0;7;0;7
12381;Želmenėliai;Ežiukų;22209426414;Ne;0;1;0;1
12382;Želmenėliai;Ežiukų;21636460884;Taip;0;4;0;4
12383;Želmenėliai;Ežiukų;90992236935;Ne;2;1;0;3
12384;Želmenėliai;Ežiukų;8394779853;Ne;0;2;0;2
12385;Želmenėliai;Ežiukų;1425695010;Taip;0;4;0;4
12386;Želmenėliai;Ežiukų;9234190447;Ne;0;2;0;2
12387;Želmenėliai;Ežiukų;10686783804;Ne;0;2;2;4
12388;Želmenėliai;Ežiukų;77946540922;Ne;7;3;0;10
12389;Želmenėliai;Ežiukų;8218755050;Ne;0;2;1;3
12390;Želmenėliai;Ežiukų;68226657214;Ne;0;2;0;2
12391;Želmenėliai;Ežiukų;10990624964;Ne;0;12;0;12
12392;Želmenėliai;Peledžiukų;4206128805;Taip;0;7;0;7
12393;Želmenėliai;Peledžiukų;6816346946;Taip;4;1;0;5
12394;Želmenėliai;Peledžiukų;9359070885;Ne;3;1;0;4
12395;Želmenėliai;Peledžiukų;5787772212;Taip;6;1;0;7
12396;Želmenėliai;Peledžiukų;29112205705;Taip;0;2;0;2
12397;Želmenėliai;Peledžiukų;1248541555;Taip;0;5;0;5
12398;Želmenėliai;Peledžiukų;8995804360;Taip;0;3;0;3
12399;Želmenėliai;Peledžiukų;1522141057;Taip;9;11;0;20
12400;Želmenėliai;Peledžiukų;5616709457;Ne;4;1;0;5
12401;Želmenėliai;Peledžiukų;8300887366;Taip;0;1;0;1
12402;Želmenėliai;Peledžiukų;96660519820;Ne;10;0;0;10
12403;Želmenėliai;Peledžiukų;5842563754;Taip;0;1;0;1
12404;Želmenėliai;Peledžiukų;9375550172;Ne;0;2;0;2
12405;Želmenėliai;Peledžiukų;8478564831;Taip;14;8;0;22
12406;Želmenėliai;Peledžiukų;8590746750;Taip;9;2;0;11
12407;Želmenėliai;Drugelių;7664430346;Ne;0;0;8;8
12408;Želmenėliai;Drugelių;3417538909;Taip;6;0;1;7
12409;Želmenėliai;Drugelių;3295852546;Ne;0;10;0;10
12410;Želmenėliai;Drugelių;4739083871;Taip;0;0;3;3
12411;Želmenėliai;Drugelių;3379266015;Taip;8;1;0;9
12412;Želmenėliai;Drugelių;3737786832;Taip;5;0;6;11
12413;Želmenėliai;Drugelių;5633127620;Taip;14;1;0;15
12414;Želmenėliai;Drugelių;1984105453;Taip;17;2;0;19
12415;Želmenėliai;Drugelių;1920917916;Taip;9;1;0;10
12416;Želmenėliai;Drugelių;4652412483;Taip;0;11;0;11
12417;Želmenėliai;Drugelių;1652949383;Taip;0;7;0;7
12418;Želmenėliai;Drugelių;9237611484;Taip;0;0;6;6
12419;Želmenėliai;Drugelių;13558387807;Taip;0;7;0;7
12420;Želmenėliai;Drugelių;5143554665;Taip;0;7;0;7
12421;Želmenėliai;Drugelių;7585159351;Ne;0;10;0;10
12422;Želmenėliai;Drugelių;4916436238;Taip;0;7;0;7
12423;Želmenėliai;Drugelių;5558795651;Taip;4;4;0;8
12424;Želmenėliai;Voriukų;4264751761;Taip;0;5;0;5
12425;Želmenėliai;Voriukų;3184074698;Taip;0;1;0;1
12426;Želmenėliai;Voriukų;1614791794;Taip;0;1;0;1
12427;Želmenėliai;Voriukų;1203343580;Taip;0;7;0;7
12428;Želmenėliai;Voriukų;9351650342;Ne;0;3;0;3
12429;Želmenėliai;Voriukų;3014568232;Ne;0;4;0;4
12430;Želmenėliai;Voriukų;6916426436;Taip;2;0;0;2
12431;Želmenėliai;Voriukų;7563461821;Ne;0;18;0;18
12432;Želmenėliai;Voriukų;4075533071;Taip;0;4;0;4
12433;Želmenėliai;Voriukų;4545012342;Taip;0;1;0;1
12434;Želmenėliai;Voriukų;8504963337;Taip;0;4;0;4
12435;Želmenėliai;Voriukų;7505996978;Taip;0;13;0;13
12436;Želmenėliai;Voriukų;2846903449;Ne;5;0;0;5
12437;Želmenėliai;Voriukų;4473677352;Taip;0;1;0;1
12438;Želmenėliai;Voriukų;8973215240;Taip;0;12;0;12
12439;Želmenėliai;Voriukų;2722619508;Ne;0;11;0;11
12440;Želmenėliai;Voriukų;5025345647;Ne;0;11;0;11
12441;Želmenėliai;Voriukų;3043560150;Taip;0;0;12;12
12442;Želmenėliai;Voriukų;8892137326;Taip;0;4;0;4
12443;Želmenėliai;Boružėlių;51756630728;Taip;0;11;0;11
12444;Želmenėliai;Boružėlių;22539846993;Taip;0;6;0;6
12445;Želmenėliai;Boružėlių;5223588064;Ne;0;3;0;3
12446;Želmenėliai;Boružėlių;2898358705;Ne;0;9;0;9
12447;Želmenėliai;Boružėlių;63043069680;Taip;0;2;0;2
12448;Želmenėliai;Boružėlių;10462964817;Taip;1;0;0;1
12449;Želmenėliai;Boružėlių;2103938312;Taip;0;3;0;3
12450;Želmenėliai;Boružėlių;35901929384;Taip;0;3;0;3
12451;Želmenėliai;Boružėlių;39675390598;Taip;0;1;0;1
12452;Želmenėliai;Boružėlių;1290780920;Taip;3;3;0;6
12453;Želmenėliai;Boružėlių;1699958696;Ne;0;13;0;13
12454;Želmenėliai;Boružėlių;98852944217;Taip;0;4;0;4
12455;Želmenėliai;Boružėlių;7502363323;Ne;18;0;0;18
12456;Želmenėliai;Boružėlių;1009164107;Taip;0;22;0;22
12457;Želmenėliai;Boružėlių;92486344928;Taip;0;6;0;6
12458;Želmenėliai;Boružėlių;1802714172;Taip;5;0;0;5
12459;Želmenėliai;Boružėlių;1933769076;Taip;0;0;22;22
12460;Želmenėliai;Boružėlių;1134743316;Ne;0;4;0;4
12461;Želmenėliai;Boružėlių;9414488405;Taip;1;1;0;2
12462;Želmenėliai;Pūkuotukų;73813829491;Taip;0;6;0;6
12463;Želmenėliai;Pūkuotukų;79879695958;Taip;0;0;5;5
12464;Želmenėliai;Pūkuotukų;54536849345;Taip;0;1;0;1
12465;Želmenėliai;Pūkuotukų;8936734213;Taip;0;1;0;1
12466;Želmenėliai;Pūkuotukų;1803684569;Ne;0;1;0;1
12467;Želmenėliai;Pūkuotukų;1716801722;Taip;0;14;0;14
12468;Želmenėliai;Pūkuotukų;45440599686;Taip;0;11;0;11
12469;Želmenėliai;Pūkuotukų;50805473649;Taip;0;4;0;4
12470;Želmenėliai;Pūkuotukų;85619767784;Ne;0;13;0;13
12471;Želmenėliai;Pūkuotukų;1800724034;Taip;0;0;6;6
12472;Želmenėliai;Pūkuotukų;74037118861;Taip;0;4;0;4
12473;Želmenėliai;Pūkuotukų;8706951420;Taip;0;7;0;7
12474;Želmenėliai;Pūkuotukų;1426827854;Taip;0;1;0;1
12475;Želmenėliai;Pūkuotukų;75198661944;Taip;0;1;0;1
12476;Želmenėliai;Pūkuotukų;2036184590;Taip;0;3;0;3
12477;Želmenėliai;Pūkuotukų;72855365141;Taip;3;0;0;3
12478;Želmenėliai;Pūkuotukų;22138795060;Taip;0;2;0;2
12479;Želmenėliai;Pūkuotukų;37152467004;Ne;0;2;0;2
12480;Želmenėliai;Ančiukų;9493581034;Taip;4;1;0;5
12481;Želmenėliai;Ančiukų;6509783586;Taip;0;8;0;8
12482;Želmenėliai;Ančiukų;8987377791;Taip;0;3;0;3
12483;Želmenėliai;Ančiukų;4126499046;Taip;3;0;0;3
12484;Želmenėliai;Ančiukų;4758240577;Taip;2;1;0;3
12485;Želmenėliai;Ančiukų;7197717698;Taip;11;1;0;12
12486;Želmenėliai;Ančiukų;2570248893;Taip;3;12;0;15
12487;Želmenėliai;Ančiukų;2111008869;Taip;0;5;2;7
12488;Želmenėliai;Ančiukų;4198085732;Taip;3;0;0;3
12489;Želmenėliai;Ančiukų;5929410363;Taip;6;0;0;6
12490;Želmenėliai;Ančiukų;7849682820;Taip;19;1;0;20
12491;Želmenėliai;Ančiukų;7751609462;Taip;22;2;0;24
12492;Želmenėliai;Ančiukų;4589396143;Taip;3;2;0;5
12493;Želmenėliai;Ančiukų;7094853897;Taip;17;2;0;19
12494;Želmenėliai;Nykštukų;8491797555;Taip;11;7;0;18
12495;Želmenėliai;Nykštukų;3572462731;Taip;8;2;0;10
12496;Želmenėliai;Nykštukų;1652131150;Ne;22;0;0;22
12497;Želmenėliai;Nykštukų;2350936740;Taip;12;5;0;17
12498;Želmenėliai;Nykštukų;4931664953;Taip;13;8;0;21
12499;Želmenėliai;Nykštukų;3063417708;Taip;0;6;0;6
12500;Želmenėliai;Nykštukų;6635909614;Taip;6;2;0;8
12501;Želmenėliai;Nykštukų;3353793939;Taip;0;1;0;1
12502;Želmenėliai;Nykštukų;8519608506;Taip;9;8;0;17
12503;Želmenėliai;Nykštukų;1877749103;Taip;6;6;0;12
12504;Želmenėliai;Lašelių;8154713582;Taip;0;2;0;2
12505;Želmenėliai;Lašelių;6876147546;Taip;0;8;0;8
12506;Želmenėliai;Lašelių;9126715074;Taip;0;6;0;6
12507;Želmenėliai;Lašelių;6180553648;Taip;0;8;0;8
12508;Želmenėliai;Lašelių;1260607572;Taip;0;1;0;1
12509;Želmenėliai;Lašelių;4120125150;Ne;9;1;0;10
12510;Želmenėliai;Lašelių;3972980949;Taip;0;4;0;4
12511;Želmenėliai;Lašelių;2296870749;Taip;0;2;0;2
12512;Želmenėliai;Lašelių;2262009049;Taip;7;1;0;8
12513;Želmenėliai;Lašelių;5638248652;Taip;8;0;0;8
12514;Želmenėliai;Lašelių;7294722095;Taip;14;3;0;17
12515;Želmenėliai;Lašelių;6819466901;Taip;0;2;1;3
12516;Želmenėliai;Lašelių;6779746783;Taip;10;3;0;13
12517;Želmenėliai;Lašelių;5161934903;Taip;0;9;0;9
12518;Žemyna;Čiauškučiai;2003368811;Taip;0;6;0;6
12519;Žemyna;Čiauškučiai;58578414067;Taip;4;0;3;7
12520;Žemyna;Čiauškučiai;1694969407;Ne;0;0;1;1
12521;Žemyna;Čiauškučiai;35462796459;Taip;0;2;0;2
12522;Žemyna;Čiauškučiai;50543973728;Taip;1;0;0;1
12523;Žemyna;Čiauškučiai;1595030102;Ne;5;0;2;7
12524;Žemyna;Čiauškučiai;6448628301;Taip;14;0;0;14
12525;Žemyna;Čiauškučiai;1421842247;Taip;5;0;3;8
12526;Žemyna;Čiauškučiai;47562685723;Taip;0;0;3;3
12527;Žemyna;Čiauškučiai;32755929074;Taip;3;11;0;14
12528;Žemyna;Čiauškučiai;54253890981;Taip;3;0;1;4
12529;Žemyna;Čiauškučiai;54823974018;Taip;4;0;1;5
12530;Žemyna;Čiauškučiai;1049546597;Taip;0;0;1;1
12531;Žemyna;Čiauškučiai;8096035110;Taip;3;0;0;3
12532;Žemyna;Čiauškučiai;38604851102;Taip;0;0;18;18
12533;Žemyna;Čiauškučiai;1305667359;Taip;4;0;2;6
12534;Žemyna;Čiauškučiai;7343337032;Taip;0;0;7;7
12535;Žemyna;Nykštukai;5114094924;Taip;5;1;0;6
12536;Žemyna;Nykštukai;3874855308;Taip;4;0;1;5
12537;Žemyna;Nykštukai;2461700030;Taip;0;3;0;3
12538;Žemyna;Nykštukai;1725771976;Taip;0;0;10;10
12539;Žemyna;Nykštukai;8622780639;Taip;3;0;0;3
12540;Žemyna;Nykštukai;3643594001;Ne;4;0;0;4
12541;Žemyna;Nykštukai;9182709647;Taip;0;3;0;3
12542;Žemyna;Nykštukai;7121742098;Taip;10;4;0;14
12543;Žemyna;Nykštukai;1468040559;Taip;4;0;0;4
12544;Žemyna;Nykštukai;4322192775;Taip;8;1;0;9
12545;Žemyna;Nykštukai;4444870782;Taip;2;2;0;4
12546;Žemyna;Nykštukai;7781924111;Taip;5;0;0;5
12547;Žemyna;Nykštukai;4257096808;Ne;0;1;1;2
12548;Žemyna;Nykštukai;1575505075;Taip;4;2;1;7
12549;Žemyna;Nykštukai;2860210906;Taip;0;10;5;15
12550;Žemyna;Nykštukai;7832066079;Taip;2;0;1;3
12551;Žemyna;Nykštukai;4759403487;Taip;0;3;0;3
12552;Žemyna;Nykštukai;9653530823;Taip;0;9;0;9
12553;Žemyna;Nykštukai;7508491119;Taip;8;1;0;9
12554;Žemyna;Nykštukai;2928125522;Ne;1;2;0;3
12555;Žemyna;Voveriukai;3135562485;Taip;10;0;1;11
12556;Žemyna;Voveriukai;5940619734;Taip;0;3;0;3
12557;Žemyna;Voveriukai;6812823390;Taip;0;0;1;1
12558;Žemyna;Voveriukai;8500642069;Taip;0;1;0;1
12559;Žemyna;Voveriukai;6430348135;Taip;0;4;0;4
12560;Žemyna;Voveriukai;2412956023;Taip;5;10;0;15
12561;Žemyna;Voveriukai;3938938667;Taip;0;11;0;11
12562;Žemyna;Voveriukai;9958040413;Ne;11;0;0;11
12563;Žemyna;Voveriukai;1531980297;Taip;0;5;3;8
12564;Žemyna;Voveriukai;1114714466;Taip;3;0;6;9
12565;Žemyna;Voveriukai;1807466584;Taip;22;0;0;22
12566;Žemyna;Voveriukai;1543415914;Taip;11;0;0;11
12567;Žemyna;Voveriukai;7125026803;Taip;0;7;0;7
12568;Žemyna;Voveriukai;9148594407;Taip;4;3;0;7
12569;Žemyna;Voveriukai;6701717634;Taip;6;0;0;6
12570;Žemyna;Voveriukai;9866110744;Taip;0;0;3;3
12571;Žemyna;Voveriukai;7693278353;Taip;0;7;0;7
12572;Žemyna;Voveriukai;1118997229;Ne;5;1;0;6
12573;Žemyna;Voveriukai;3357339710;Taip;0;0;12;12
12574;Žemyna;Kiškučiai;1566781183;Ne;11;0;0;11
12575;Žemyna;Kiškučiai;26124703883;Taip;2;0;1;3
12576;Žemyna;Kiškučiai;1688122673;Taip;5;2;0;7
12577;Žemyna;Kiškučiai;5635456615;Taip;3;0;3;6
12578;Žemyna;Kiškučiai;1947185865;Taip;0;0;10;10
12579;Žemyna;Kiškučiai;6647400698;Ne;4;1;0;5
12580;Žemyna;Kiškučiai;23371576969;Taip;0;0;1;1
12581;Žemyna;Kiškučiai;5830320758;Taip;0;7;0;7
12582;Žemyna;Kiškučiai;6148416514;Taip;0;22;0;22
12583;Žemyna;Kiškučiai;1380225362;Taip;5;0;3;8
12584;Žemyna;Kiškučiai;88687293547;Taip;4;4;0;8
12585;Žemyna;Kiškučiai;1265326169;Ne;0;0;2;2
12586;Žemyna;Kiškučiai;2032992299;Taip;0;1;0;1
12587;Žemyna;Kiškučiai;1210307182;Taip;0;0;2;2
12588;Žemyna;Kiškučiai;4570281722;Ne;8;0;3;11
12589;Žemyna;Kiškučiai;2073608501;Taip;0;1;0;1
12590;Žemyna;Kiškučiai;92534877861;Taip;0;0;5;5
12591;Žemyna;Kiškučiai;1716821186;Ne;0;0;3;3
12592;Žemyna;Kiškučiai;75681135185;Taip;0;0;5;5
12593;Žemyna;Kiškučiai;15573695823;Taip;0;6;0;6
12594;Žemyna;Kiškučiai;8292265369;Taip;0;0;5;5
12595;Žemyna;Vyturiukai;9232638767;Taip;0;1;0;1
12596;Žemyna;Vyturiukai;47470155594;Taip;6;0;1;7
12597;Žemyna;Vyturiukai;17098859260;Taip;0;3;0;3
12598;Žemyna;Vyturiukai;1687206394;Taip;0;2;0;2
12599;Žemyna;Vyturiukai;59506345859;Taip;6;0;1;7
12600;Žemyna;Vyturiukai;89787441782;Taip;0;2;0;2
12601;Žemyna;Vyturiukai;5506889213;Ne;0;1;0;1
12602;Žemyna;Vyturiukai;5306392307;Taip;4;1;0;5
12603;Žemyna;Vyturiukai;37570629861;Ne;16;3;0;19
12604;Žemyna;Vyturiukai;13242930752;Taip;2;2;0;4
12605;Žemyna;Vyturiukai;94548785045;Taip;5;0;0;5
12606;Žemyna;Vyturiukai;93423088394;Taip;0;5;0;5
12607;Žemyna;Vyturiukai;8040359407;Taip;4;0;7;11
12608;Žemyna;Vyturiukai;55161890341;Ne;12;0;0;12
12609;Žemyna;Vyturiukai;4524929331;Taip;0;1;0;1
12610;Žemyna;Vyturiukai;3622634119;Ne;7;0;3;10
12611;Žemyna;Vyturiukai;4235160760;Taip;5;0;0;5
12612;Žemyna;Pelėdžiukai;68982161758;Taip;0;0;4;4
12613;Žemyna;Pelėdžiukai;69634515292;Ne;0;3;0;3
12614;Žemyna;Pelėdžiukai;65677663175;Taip;9;0;1;10
12615;Žemyna;Pelėdžiukai;74969696164;Taip;9;4;1;14
12616;Žemyna;Pelėdžiukai;47974278492;Taip;9;0;0;9
12617;Žemyna;Pelėdžiukai;92159859248;Taip;0;0;2;2
12618;Žemyna;Pelėdžiukai;10344263960;Taip;0;0;3;3
12619;Žemyna;Pelėdžiukai;54029612806;Taip;0;1;0;1
12620;Žemyna;Pelėdžiukai;93378737171;Taip;0;2;0;2
12621;Žemyna;Pelėdžiukai;6546437872;Taip;6;0;4;10
12622;Žemyna;Pelėdžiukai;5204796908;Taip;9;0;0;9
12623;Žemyna;Pelėdžiukai;9556275322;Taip;0;0;2;2
12624;Žemyna;Pelėdžiukai;78280621543;Taip;4;5;0;9
12625;Žemyna;Pelėdžiukai;81683768388;Taip;6;6;0;12
12626;Žemyna;Pelėdžiukai;65117735882;Taip;0;0;7;7
12627;Žemyna;Pelėdžiukai;59441904717;Taip;0;0;1;1
12628;Žemyna;Pelėdžiukai;97712802830;Taip;0;3;0;3
12629;Žemyna;Pelėdžiukai;70694756261;Taip;0;0;3;3
12630;Žemyna;Pelėdžiukai;45269313606;Ne;0;1;2;3
12631;Žemyna;Pelėdžiukai;30518889603;Taip;0;0;2;2
12632;Žemyna;Pelėdžiukai;1674165765;Taip;9;1;0;10
12633;Žemyna;Pelėdžiukai;2033947862;Taip;0;0;2;2
12634;Žemyna;Vijurkai;96099047169;Taip;2;0;0;2
12635;Žemyna;Vijurkai;85617781303;Taip;0;0;1;1
12636;Žemyna;Vijurkai;62565967575;Taip;0;1;0;1
12637;Žemyna;Vijurkai;1535497308;Taip;9;1;1;11
12638;Žemyna;Vijurkai;25099273803;Taip;0;0;2;2
12639;Žemyna;Vijurkai;10288969939;Taip;2;0;0;2
12640;Žemyna;Vijurkai;40843229500;Ne;0;0;1;1
12641;Žemyna;Vijurkai;69690099920;Taip;0;0;1;1
12642;Žemyna;Vijurkai;98477626952;Taip;0;0;3;3
12643;Žemyna;Vijurkai;71013970407;Taip;0;0;3;3
12644;Žemyna;Vijurkai;87939385151;Taip;1;0;1;2
12645;Žemyna;Vijurkai;56418377668;Taip;0;2;0;2
12646;Žemyna;Vijurkai;98919412716;Taip;0;0;6;6
12647;Žemyna;Vijurkai;1609941314;Ne;0;1;0;1
12648;Žemyna;Vijurkai;1790109762;Taip;0;0;2;2
12649;Žemyna;Vijurkai;89754744294;Taip;6;0;0;6
12650;Žemyna;Vijurkai;9409512255;Taip;0;15;0;15
12651;Žemyna;Šnekučiai;6735720135;Taip;12;0;0;12
12652;Žemyna;Šnekučiai;9912869400;Taip;1;0;1;2
12653;Žemyna;Šnekučiai;2006173745;Taip;0;3;0;3
12654;Žemyna;Šnekučiai;5727308039;Taip;0;4;0;4
12655;Žemyna;Šnekučiai;7280740926;Taip;0;0;2;2
12656;Žemyna;Šnekučiai;6419974691;Taip;0;3;0;3
12657;Žemyna;Šnekučiai;9219519029;Ne;0;9;0;9
12658;Žemyna;Šnekučiai;6293560729;Taip;0;0;2;2
12659;Žemyna;Šnekučiai;7764615445;Taip;0;0;1;1
12660;Žemyna;Šnekučiai;5868208651;Ne;0;0;8;8
12661;Žemyna;Šnekučiai;3992383447;Taip;9;1;0;10
12662;Žemyna;Šnekučiai;9668975591;Taip;0;1;1;2
12663;Žemyna;Šnekučiai;6856737270;Ne;0;2;0;2
12664;Žemyna;Šnekučiai;5188496664;Taip;3;0;0;3
12665;Žemyna;Šnekučiai;6878669773;Taip;0;0;4;4
12666;Žemyna;Šnekučiai;4502958166;Ne;5;1;0;6
12667;Žemyna;Šnekučiai;5688714928;Taip;0;0;1;1
12668;Žemyna;Pabiručiai;3596822649;Taip;2;0;0;2
12669;Žemyna;Pabiručiai;6775880309;Taip;0;6;1;7
12670;Žemyna;Pabiručiai;82507236376;Taip;0;1;0;1
12671;Žemyna;Pabiručiai;84955588471;Taip;0;11;0;11
12672;Žemyna;Pabiručiai;80737839511;Taip;0;6;0;6
12673;Žemyna;Pabiručiai;14902924855;Taip;0;1;3;4
12674;Žemyna;Pabiručiai;1847882950;Taip;3;0;0;3
12675;Žemyna;Pabiručiai;50687988382;Ne;0;10;0;10
12676;Žemyna;Pabiručiai;1278096396;Taip;11;0;5;16
12677;Žemyna;Pabiručiai;8726346349;Taip;13;0;0;13
12678;Žemyna;Pabiručiai;2841526614;Taip;5;1;1;7
12679;Žemyna;Pabiručiai;8496195396;Taip;0;3;9;12
12680;Žemyna;Pabiručiai;4796265997;Taip;0;0;5;5
12681;Žemyna;Pabiručiai;8139714064;Taip;0;3;0;3
12682;Žemyna;Pabiručiai;3895238312;Taip;13;0;2;15
12683;Žemyna;Pabiručiai;1058705875;Taip;0;11;0;11
12684;Žemyna;Pabiručiai;7785889259;Taip;3;0;0;3
12685;Žemyna;Pabiručiai;7676796264;Taip;4;2;0;6
12686;Žemyna;Pabiručiai;2090395417;Taip;17;0;0;17
12687;Žemyna;Pabiručiai;15110117571;Taip;12;2;0;14
12688;Žemyna;Drugeliai;72801825176;Taip;0;9;0;9
12689;Žemyna;Drugeliai;32383247850;Taip;3;0;0;3
12690;Žemyna;Drugeliai;2100326039;Taip;0;3;0;3
12691;Žemyna;Drugeliai;84680481889;Taip;0;0;1;1
12692;Žemyna;Drugeliai;1471204471;Taip;0;3;0;3
12693;Žemyna;Drugeliai;1882507954;Taip;6;1;0;7
12694;Žemyna;Drugeliai;1623854426;Taip;3;0;0;3
12695;Žemyna;Drugeliai;50369667193;Taip;4;3;0;7
12696;Žemyna;Drugeliai;1705971732;Taip;0;3;1;4
12697;Žemyna;Drugeliai;17784132877;Taip;0;0;1;1
12698;Žemyna;Drugeliai;97625732866;Taip;0;22;0;22
12699;Žemyna;Drugeliai;45222048620;Taip;1;6;0;7
12700;Žemyna;Drugeliai;1968337404;Taip;0;6;3;9
12701;Žemyna;Drugeliai;51870099224;Taip;0;0;8;8
12702;Žemyna;Drugeliai;1941650167;Taip;0;8;1;9
12703;Žemyna;Drugeliai;1867198805;Ne;3;0;0;3
12704;Žemyna;Drugeliai;1299164876;Taip;0;10;1;11
12705;Žemyna;Drugeliai;4519502372;Taip;0;0;1;1
12706;Žemyna;Drugeliai;8018865138;Ne;0;2;0;2
12707;Žemyna;Drugeliai;5233574060;Ne;5;0;0;5
12708;Žemyna;"ŽIRNIUKAI ";7620179886;Taip;12;0;0;12
12709;Žemyna;"ŽIRNIUKAI ";5069437469;Taip;0;0;2;2
12710;Žemyna;"ŽIRNIUKAI ";7277970673;Taip;0;4;1;5
12711;Žemyna;"ŽIRNIUKAI ";3074391266;Taip;1;7;0;8
12712;Žemyna;"ŽIRNIUKAI ";2547436771;Taip;10;0;2;12
12713;Žemyna;"ŽIRNIUKAI ";6346173832;Taip;6;0;0;6
12714;Žemyna;"ŽIRNIUKAI ";1365045512;Ne;6;0;0;6
12715;Žemyna;"ŽIRNIUKAI ";5416338054;Taip;0;0;2;2
12716;Žemyna;"ŽIRNIUKAI ";5133115712;Taip;0;0;1;1
12717;Žemyna;"ŽIRNIUKAI ";4693414703;Ne;4;0;1;5
12718;Žemyna;"ŽIRNIUKAI ";6051208732;Taip;0;0;3;3
12719;Žemyna;"ŽIRNIUKAI ";7427119736;Ne;6;0;1;7
12720;Žemyna;"ŽIRNIUKAI ";2354265632;Taip;1;0;2;3
12721;Žemyna;"ŽIOGELIAI ";9094718595;Taip;9;0;0;9
12722;Žemyna;"ŽIOGELIAI ";6208953341;Taip;6;5;0;11
12723;Žemyna;"ŽIOGELIAI ";9827401825;Taip;0;5;0;5
12724;Žemyna;"ŽIOGELIAI ";4176386795;Taip;17;0;0;17
12725;Žemyna;"ŽIOGELIAI ";6958537154;Taip;6;0;0;6
12726;Žemyna;"ŽIOGELIAI ";2034162734;Taip;3;0;0;3
12727;Žemyna;"ŽIOGELIAI ";7122276019;Taip;5;3;1;9
12728;Žemyna;"ŽIOGELIAI ";7005045961;Taip;5;3;1;9
12729;Žemyna;"ŽIOGELIAI ";1745197274;Taip;16;2;0;18
12730;Žemyna;"ŽIOGELIAI ";6041223291;Taip;10;0;0;10
12731;Žemyna;"ŽIOGELIAI ";8248443265;Taip;8;0;0;8
12732;Žemyna;"ŽIOGELIAI ";1850100203;Taip;6;1;0;7
12733;Žemyna;"ŽIOGELIAI ";9628651723;Taip;0;22;0;22
12734;Žemyna;"ŽIOGELIAI ";5743535463;Taip;19;0;0;19
12735;Žemyna;"ŽIOGELIAI ";4613946229;Taip;6;1;0;7
12736;Žemyna;"ŽIOGELIAI ";1656335765;Taip;0;2;0;2
12737;Žemyna;"ŽIOGELIAI ";5127174926;Taip;11;0;1;12
12738;Žemyna;"ŽIOGELIAI ";2102920661;Ne;13;0;1;14
12739;Žemuogėlė;Boružiukai;54663750186;Taip;9;1;0;10
12740;Žemuogėlė;Boružiukai;4231767115;Taip;3;0;0;3
12741;Žemuogėlė;Boružiukai;3977351017;Taip;3;0;0;3
12742;Žemuogėlė;Boružiukai;5147617128;Taip;10;7;0;17
12743;Žemuogėlė;Boružiukai;5625943720;Taip;5;2;1;8
12744;Žemuogėlė;Boružiukai;1058207935;Taip;5;1;2;8
12745;Žemuogėlė;Boružiukai;1628749648;Taip;11;0;0;11
12746;Žemuogėlė;Boružiukai;711908013;Taip;0;4;0;4
12747;Žemuogėlė;Boružiukai;6962103028;Taip;5;2;0;7
12748;Žemuogėlė;Boružiukai;7714826773;Taip;18;0;0;18
12749;Žemuogėlė;Boružiukai;3134493860;Taip;4;2;0;6
12750;Žemuogėlė;Boružiukai;1907004376;Taip;6;0;0;6
12751;Žemuogėlė;Boružiukai;38870047353;Taip;7;0;0;7
12752;Žemuogėlė;Boružiukai;7403172794;Taip;0;2;0;2
12753;Žemuogėlė;Boružiukai;9315711142;Taip;5;2;0;7
12754;Žemuogėlė;Boružiukai;2102057496;Taip;8;0;0;8
12755;Žemuogėlė;Boružiukai;94792383091;Taip;9;2;1;12
12756;Žemuogėlė;Boružiukai;4421397490;Taip;15;0;0;15
12757;Žemuogėlė;Šviesuliukai;1049009199;Taip;0;5;0;5
12758;Žemuogėlė;Šviesuliukai;4810459063;Taip;0;1;0;1
12759;Žemuogėlė;Šviesuliukai;1745679183;Taip;1;0;0;1
12760;Žemuogėlė;Šviesuliukai;9255723192;Taip;0;11;0;11
12761;Žemuogėlė;Šviesuliukai;2740942924;Taip;0;9;0;9
12762;Žemuogėlė;Šviesuliukai;5972567526;Taip;0;2;1;3
12763;Žemuogėlė;Šviesuliukai;1910570858;Taip;10;3;0;13
12764;Žemuogėlė;Šviesuliukai;6726124641;Taip;5;0;0;5
12765;Žemuogėlė;Šviesuliukai;5127370193;Taip;3;0;0;3
12766;Žemuogėlė;Šviesuliukai;5126348190;Taip;0;2;0;2
12767;Žemuogėlė;Šviesuliukai;9534937419;Taip;5;0;0;5
12768;Žemuogėlė;Šviesuliukai;2481547868;Taip;5;0;0;5
12769;Žemuogėlė;Šviesuliukai;3612833383;Taip;4;0;0;4
12770;Žemuogėlė;Šviesuliukai;3000676765;Taip;11;0;0;11
12771;Žemuogėlė;Šviesuliukai;9689082202;Ne;0;8;0;8
12772;Žemuogėlė;Šviesuliukai;3411390558;Taip;2;4;0;6
12773;Žemuogėlė;Šviesuliukai;1275552038;Taip;0;7;0;7
12774;Žemuogėlė;Šviesuliukai;1377813636;Taip;0;0;5;5
12775;Žemuogėlė;Šviesuliukai;2731544174;Taip;22;0;0;22
12776;Žemuogėlė;Šviesuliukai;4660479216;Taip;15;0;0;15
12777;Žemuogėlė;Lašiukai;2320908623;Taip;0;10;0;10
12778;Žemuogėlė;Lašiukai;60841198741;Taip;4;3;0;7
12779;Žemuogėlė;Lašiukai;97014601220;Ne;2;4;0;6
12780;Žemuogėlė;Lašiukai;31450036105;Ne;4;0;0;4
12781;Žemuogėlė;Lašiukai;93523683833;Taip;0;1;0;1
12782;Žemuogėlė;Lašiukai;1223819270;Ne;0;1;0;1
12783;Žemuogėlė;Lašiukai;1608506638;Taip;0;4;0;4
12784;Žemuogėlė;Lašiukai;1448477562;Taip;0;4;0;4
12785;Žemuogėlė;Lašiukai;4900328025;Taip;5;2;0;7
12786;Žemuogėlė;Lašiukai;8295541141;Ne;0;6;0;6
12787;Žemuogėlė;Lašiukai;1223648771;Taip;0;2;0;2
12788;Žemuogėlė;Skambaliukai;34462365948;Taip;0;1;0;1
12789;Žemuogėlė;Skambaliukai;13768771915;Taip;0;1;0;1
12790;Žemuogėlė;Skambaliukai;1844596636;Taip;0;0;3;3
12791;Žemuogėlė;Skambaliukai;10356039859;Taip;0;3;0;3
12792;Žemuogėlė;Skambaliukai;8952696734;Taip;0;5;0;5
12793;Žemuogėlė;Skambaliukai;29973978107;Taip;2;2;0;4
12794;Žemuogėlė;Skambaliukai;1366286798;Taip;0;6;0;6
12795;Žemuogėlė;Skambaliukai;58604834495;Taip;5;3;0;8
12796;Žemuogėlė;Skambaliukai;87719167969;Taip;0;3;0;3
12797;Žemuogėlė;Skambaliukai;97664138036;Ne;0;2;5;7
12798;Žemuogėlė;Skambaliukai;66464155865;Taip;1;2;2;5
12799;Žemuogėlė;Skambaliukai;3354347837;Taip;11;1;0;12
12800;Žemuogėlė;Skambaliukai;98006600854;Taip;0;2;1;3
12801;Žemuogėlė;Skambaliukai;92317183904;Ne;9;0;0;9
12802;Žemuogėlė;Skambaliukai;28795421460;Taip;3;0;0;3
12803;Žemuogėlė;Skambaliukai;33112231008;Taip;0;6;0;6
12804;Žemuogėlė;Skambaliukai;24111477729;Taip;0;1;0;1
12805;Žemuogėlė;Spinduliukai;22761916112;Ne;0;7;0;7
12806;Žemuogėlė;Spinduliukai;5888483930;Ne;0;8;0;8
12807;Žemuogėlė;Spinduliukai;97511628790;Taip;0;4;0;4
12808;Žemuogėlė;Spinduliukai;89316574266;Taip;0;1;0;1
12809;Žemuogėlė;Spinduliukai;64042870424;Taip;0;12;0;12
12810;Žemuogėlė;Spinduliukai;1296464444;Taip;0;3;0;3
12811;Žemuogėlė;Spinduliukai;29436958034;Taip;0;8;0;8
12812;Žemuogėlė;Spinduliukai;9864664937;Taip;5;2;0;7
12813;Žemuogėlė;Spinduliukai;9042246873;Taip;4;5;0;9
12814;Žemuogėlė;Spinduliukai;57783467185;Taip;0;1;0;1
12815;Žemuogėlė;Spinduliukai;1859848343;Taip;0;11;0;11
12816;Žemuogėlė;Spinduliukai;96167322031;Taip;13;0;0;13
12817;Žemuogėlė;Spinduliukai;1608544032;Taip;2;8;0;10
12818;Žemuogėlė;Spinduliukai;3868254757;Taip;8;2;0;10
12819;Žemuogėlė;Spinduliukai;8187939143;Taip;0;4;0;4
12820;Žemuogėlė;Spinduliukai;3062268362;Taip;0;4;0;4
12821;Žemuogėlė;Spinduliukai;5395954931;Taip;4;4;0;8
12822;Žemuogėlė;Perliukai;64182347253;Taip;0;2;0;2
12823;Žemuogėlė;Perliukai;23841110826;Taip;0;1;0;1
12824;Žemuogėlė;Perliukai;89682626079;Taip;9;2;1;12
12825;Žemuogėlė;Perliukai;21886029194;Taip;0;6;0;6
12826;Žemuogėlė;Perliukai;95392130582;Taip;0;1;0;1
12827;Žemuogėlė;Perliukai;1099252682;Taip;0;1;0;1
12828;Žemuogėlė;Perliukai;1550066922;Taip;0;1;0;1
12829;Žemuogėlė;Perliukai;1354590098;Taip;0;2;2;4
12830;Žemuogėlė;Perliukai;1543283524;Taip;3;0;0;3
12831;Žemuogėlė;Perliukai;1085793430;Taip;0;2;0;2
12832;Žemuogėlė;Perliukai;1970687025;Taip;0;1;0;1
12833;Žemuogėlė;Perliukai;52842591023;Taip;14;0;1;15
12834;Žemuogėlė;Perliukai;5911529759;Taip;0;4;0;4
12835;Žemuogėlė;Perliukai;1093128368;Taip;0;6;0;6
12836;Žemuogėlė;Perliukai;70054283264;Taip;9;2;0;11
12837;Žemuogėlė;Perliukai;40590616715;Taip;0;1;0;1
12838;Žemuogėlė;Drugeliai;9592456683;Taip;10;0;0;10
12839;Žemuogėlė;Drugeliai;3765022476;Taip;4;2;1;7
12840;Žemuogėlė;Drugeliai;5266493632;Taip;9;1;0;10
12841;Žemuogėlė;Drugeliai;3237083654;Taip;19;0;0;19
12842;Žemuogėlė;Drugeliai;2259779058;Taip;6;1;0;7
12843;Žemuogėlė;Drugeliai;9693894254;Taip;8;1;0;9
12844;Žemuogėlė;Drugeliai;5418395023;Taip;3;1;0;4
12845;Žemuogėlė;Drugeliai;6581889641;Ne;9;0;0;9
12846;Žemuogėlė;Drugeliai;2555902309;Ne;6;2;0;8
12847;Žemuogėlė;Drugeliai;4536398519;Taip;11;1;0;12
12848;Žemuogėlė;Drugeliai;3458374439;Taip;5;1;0;6
12849;Žemuogėlė;Drugeliai;8757701456;Taip;13;3;0;16
12850;Žemuogėlė;Drugeliai;2132549536;Taip;4;6;0;10
12851;Žemuogėlė;Drugeliai;8496353410;Taip;0;7;0;7
12852;Žemuogėlė;Drugeliai;1733808230;Taip;4;4;0;8
12853;Žemuogėlė;Drugeliai;7804015060;Taip;11;0;0;11
12854;Žemuogėlė;Drugeliai;3714945248;Taip;22;0;0;22
12855;Žemuogėlė;Drugeliai;2001471529;Taip;0;2;0;2
12856;Žemuogėlė;Drugeliai;6913038845;Taip;9;1;0;10
12857;Žemuogėlė;Drugeliai;5532053268;Taip;12;0;0;12
12858;Žemuogėlė;"VIEVERSIUKAI ";4629107942;Taip;16;1;0;17
12859;Žemuogėlė;"VIEVERSIUKAI ";1658954821;Taip;5;0;0;5
12860;Žemuogėlė;"VIEVERSIUKAI ";7592566602;Taip;8;0;0;8
12861;Žemuogėlė;"VIEVERSIUKAI ";2664267604;Taip;7;0;0;7
12862;Žemuogėlė;"VIEVERSIUKAI ";9693814425;Taip;3;2;0;5
12863;Žemuogėlė;"VIEVERSIUKAI ";3288369628;Taip;2;1;0;3
12864;Žemuogėlė;"VIEVERSIUKAI ";3825509486;Taip;11;0;0;11
12865;Žemuogėlė;"VIEVERSIUKAI ";1060986850;Taip;4;2;0;6
12866;Žemuogėlė;"VIEVERSIUKAI ";1306065826;Taip;22;0;0;22
12867;Žemuogėlė;"VIEVERSIUKAI ";5992802843;Taip;2;0;0;2
12868;Žemuogėlė;"VIEVERSIUKAI ";5505719625;Taip;8;2;0;10
12869;Žemuogėlė;"VIEVERSIUKAI ";1555899448;Taip;22;0;0;22
12870;Žemuogėlė;"VIEVERSIUKAI ";7137182934;Taip;2;0;0;2
12871;Žemuogėlė;"VIEVERSIUKAI ";1796489729;Taip;9;1;1;11
12872;Žemuogėlė;"VIEVERSIUKAI ";3059525247;Taip;3;5;0;8
12873;Žemuogėlė;"NYKŠTUKAI ";3546429231;Taip;4;12;0;16
12874;Žemuogėlė;"NYKŠTUKAI ";2115883173;Taip;13;0;0;13
12875;Žemuogėlė;"NYKŠTUKAI ";1251497003;Taip;5;0;0;5
12876;Žemuogėlė;"NYKŠTUKAI ";3706531223;Taip;10;0;0;10
12877;Žemuogėlė;"NYKŠTUKAI ";2841634296;Taip;13;0;0;13
12878;Žemuogėlė;"NYKŠTUKAI ";4565097904;Ne;0;1;0;1
12879;Žemuogėlė;"NYKŠTUKAI ";9579921777;Taip;10;0;0;10
12880;Žemuogėlė;"NYKŠTUKAI ";6169845677;Taip;8;0;0;8
12881;Žemuogėlė;"NYKŠTUKAI ";1356340471;Taip;14;3;0;17
12882;Žemuogėlė;"NYKŠTUKAI ";6747566307;Taip;2;1;0;3
12883;Žemuogėlė;"NYKŠTUKAI ";3753156044;Ne;7;0;0;7
12884;Žemuogėlė;"NYKŠTUKAI ";3073956225;Taip;4;0;0;4
12885;Žemuogėlė;"NYKŠTUKAI ";1469759840;Taip;0;1;0;1
12886;Žemuogėlė;"NYKŠTUKAI ";4933948491;Ne;1;3;8;12
12887;Žemuogėlė;KIŠKUČIAI;3041461125;Taip;0;3;0;3
12888;Žemuogėlė;KIŠKUČIAI;1953538445;Taip;22;0;0;22
12889;Žemuogėlė;KIŠKUČIAI;6707522989;Taip;9;1;0;10
12890;Žemuogėlė;KIŠKUČIAI;9981446556;Taip;12;0;1;13
12891;Žemuogėlė;KIŠKUČIAI;3837424301;Taip;10;0;0;10
12892;Žemuogėlė;KIŠKUČIAI;7669457695;Taip;3;1;0;4
12893;Žemuogėlė;KIŠKUČIAI;8675089149;Taip;0;0;1;1
12894;Žemuogėlė;KIŠKUČIAI;4165354124;Taip;3;6;0;9
12895;Žemuogėlė;KIŠKUČIAI;6059069293;Taip;0;4;0;4
12896;Žemuogėlė;KIŠKUČIAI;5971652934;Taip;0;2;0;2
12897;Žemuogėlė;KIŠKUČIAI;5770044886;Taip;14;0;0;14
12898;Žemuogėlė;KIŠKUČIAI;4578291476;Taip;0;0;2;2
12899;Žemuogėlė;KIŠKUČIAI;5499401648;Taip;4;0;0;4
12900;Žibutė;PELĖDŽIUKAI;3496675605;Taip;6;3;0;9
12901;Žibutė;PELĖDŽIUKAI;5811023607;Taip;0;1;0;1
12902;Žibutė;PELĖDŽIUKAI;54535455969;Taip;10;4;5;19
12903;Žibutė;PELĖDŽIUKAI;62146271609;Taip;0;10;0;10
12904;Žibutė;PELĖDŽIUKAI;85042822872;Taip;0;0;2;2
12905;Žibutė;PELĖDŽIUKAI;59824395612;Taip;14;0;0;14
12906;Žibutė;PELĖDŽIUKAI;2361682400;Taip;0;1;2;3
12907;Žibutė;PELĖDŽIUKAI;1826763192;Taip;0;1;0;1
12908;Žibutė;PELĖDŽIUKAI;3826875107;Taip;0;8;0;8
12909;Žibutė;PELĖDŽIUKAI;3186792146;Taip;0;0;2;2
12910;Žibutė;PELĖDŽIUKAI;7344095020;Taip;0;10;1;11
12911;Žibutė;PELĖDŽIUKAI;1078105287;Taip;0;4;0;4
12912;Žibutė;PELĖDŽIUKAI;2152452830;Ne;0;8;0;8
12913;Žibutė;PELĖDŽIUKAI;1394895695;Ne;0;4;0;4
12914;Žibutė;PELĖDŽIUKAI;2236930916;Taip;4;0;1;5
12915;Žibutė;PELĖDŽIUKAI;7095870173;Taip;0;7;0;7
12916;Žibutė;PELĖDŽIUKAI;2840754631;Taip;6;0;0;6
12917;Žibutė;PELĖDŽIUKAI;6089325755;Ne;2;0;2;4
12918;Žibutė;PELĖDŽIUKAI;1274409680;Taip;0;16;3;19
12919;Žibutė;KREGŽDUTĖS;8587562864;Ne;4;4;11;19
12920;Žibutė;KREGŽDUTĖS;1132220505;Taip;0;0;5;5
12921;Žibutė;KREGŽDUTĖS;3035056391;Taip;0;5;0;5
12922;Žibutė;KREGŽDUTĖS;4480906648;Ne;9;0;0;9
12923;Žibutė;KREGŽDUTĖS;90082848356;Taip;0;2;0;2
12924;Žibutė;KREGŽDUTĖS;81886125258;Ne;0;3;0;3
12925;Žibutė;KREGŽDUTĖS;1478348672;Taip;3;0;0;3
12926;Žibutė;KREGŽDUTĖS;37321817270;Taip;6;0;1;7
12927;Žibutė;KREGŽDUTĖS;8973875215;Taip;0;3;0;3
12928;Žibutė;KREGŽDUTĖS;2776197727;Ne;0;1;0;1
12929;Žibutė;KREGŽDUTĖS;6471216018;Ne;11;3;0;14
12930;Žibutė;KREGŽDUTĖS;8830047872;Taip;6;0;2;8
12931;Žibutė;BORUŽĖLĖS;8792292819;Taip;7;8;0;15
12932;Žibutė;BORUŽĖLĖS;2438980348;Taip;13;0;0;13
12933;Žibutė;BORUŽĖLĖS;7668484415;Taip;0;10;0;10
12934;Žibutė;BORUŽĖLĖS;5126232169;Taip;6;0;3;9
12935;Žibutė;BORUŽĖLĖS;9700866512;Taip;1;0;1;2
12936;Žibutė;BORUŽĖLĖS;3268141759;Ne;0;10;2;12
12937;Žibutė;BORUŽĖLĖS;7774532200;Taip;0;6;0;6
12938;Žibutė;BORUŽĖLĖS;1366469428;Ne;14;0;0;14
12939;Žibutė;BORUŽĖLĖS;4825064521;Taip;0;14;8;22
12940;Žibutė;BORUŽĖLĖS;5826523148;Taip;0;0;1;1
12941;Žibutė;BORUŽĖLĖS;3957898269;Taip;0;7;0;7
12942;Žibutė;BORUŽĖLĖS;4382812297;Taip;4;0;3;7
12943;Žibutė;BORUŽĖLĖS;1004098038;Ne;8;13;1;22
12944;Žibutė;BORUŽĖLĖS;2880593326;Taip;0;1;0;1
12945;Žibutė;BORUŽĖLĖS;7479437931;Ne;5;0;0;5
12946;Žibutė;BITUTĖS;3194445795;Taip;0;3;0;3
12947;Žibutė;BITUTĖS;14091973543;Taip;1;4;0;5
12948;Žibutė;BITUTĖS;27182644850;Taip;0;7;0;7
12949;Žibutė;BITUTĖS;9591439732;Taip;0;3;1;4
12950;Žibutė;BITUTĖS;90040902859;Taip;0;2;0;2
12951;Žibutė;BITUTĖS;39367516353;Taip;0;4;0;4
12952;Žibutė;BITUTĖS;72357016152;Taip;0;10;0;10
12953;Žibutė;BITUTĖS;1054908586;Taip;0;8;0;8
12954;Žibutė;BITUTĖS;2603387036;Taip;0;3;0;3
12955;Žibutė;BITUTĖS;1215072172;Taip;0;4;0;4
12956;Žibutė;BITUTĖS;1317512329;Taip;4;1;0;5
12957;Žibutė;BITUTĖS;2144866874;Ne;4;1;0;5
12958;Žibutė;BITUTĖS;1010766308;Taip;2;3;0;5
12959;Žibutė;BITUTĖS;1749323904;Taip;0;25;0;25
12960;Žibutė;BITUTĖS;19558564943;Taip;6;9;0;15
12961;Žibutė;BITUTĖS;6958822972;Ne;0;1;0;1
12962;Žibutė;BITUTĖS;62187632470;Taip;0;6;0;6
12963;Žibutė;KAČIUKAI;25658034484;Taip;0;10;2;12
12964;Žibutė;KAČIUKAI;9982611436;Ne;3;1;0;4
12965;Žibutė;KAČIUKAI;2089960385;Taip;11;0;1;12
12966;Žibutė;KAČIUKAI;35959201106;Taip;0;0;3;3
12967;Žibutė;KAČIUKAI;67702702073;Taip;5;1;0;6
12968;Žibutė;KAČIUKAI;60756444655;Ne;4;8;0;12
12969;Žibutė;KAČIUKAI;33367530216;Taip;3;0;0;3
12970;Žibutė;KAČIUKAI;97730387781;Taip;0;2;0;2
12971;Žibutė;KAČIUKAI;51435935201;Taip;0;0;3;3
12972;Žibutė;KAČIUKAI;14243834326;Taip;0;1;3;4
12973;Žibutė;KAČIUKAI;19029125959;Taip;0;1;0;1
12974;Žibutė;KAČIUKAI;1683770314;Taip;0;2;0;2
12975;Žibutė;KAČIUKAI;76137370554;Ne;0;1;14;15
12976;Žibutė;KAČIUKAI;4475507372;Taip;8;1;0;9
12977;Žibutė;KAČIUKAI;2120935059;Taip;0;1;0;1
12978;Žibutė;KAČIUKAI;9655499291;Ne;0;1;2;3
12979;Žibutė;ZUIKIAI;5187777741;Taip;1;0;3;4
12980;Žibutė;ZUIKIAI;6013340521;Taip;4;0;1;5
12981;Žibutė;ZUIKIAI;7036454359;Ne;17;0;0;17
12982;Žibutė;ZUIKIAI;5412917352;Taip;0;0;4;4
12983;Žibutė;ZUIKIAI;8715912139;Taip;2;0;1;3
12984;Žibutė;ZUIKIAI;5416015554;Taip;1;0;4;5
12985;Žibutė;ZUIKIAI;3555071718;Taip;13;0;0;13
12986;Žibutė;ZUIKIAI;7531027545;Taip;0;0;5;5
12987;Žibutė;ZUIKIAI;3645481894;Taip;0;1;0;1
12988;Žibutė;ZUIKIAI;6074488747;Ne;6;0;0;6
12989;Žibutė;ZUIKIAI;2957525481;Taip;3;1;0;4
12990;Žibutė;ZUIKIAI;5009495840;Ne;12;0;0;12
12991;Žibutė;ZUIKIAI;7136145033;Taip;0;1;0;1
12992;Žibutė;ZUIKIAI;5190377896;Taip;13;0;0;13
12993;Žibutė;ZUIKIAI;3191351976;Taip;0;0;1;1
12994;Žibutė;ZUIKIAI;9498011134;Taip;0;5;0;5
12995;Žiedas;Bitutės;7123756950;Ne;0;4;1;5
12996;Žiedas;Bitutės;1818701657;Ne;2;0;0;2
12997;Žiedas;Bitutės;2063680054;Taip;6;0;0;6
12998;Žiedas;Bitutės;1817676038;Ne;0;2;2;4
12999;Žiedas;Bitutės;38427730823;Ne;0;1;0;1
13000;Žiedas;Bitutės;1631546874;Ne;9;9;0;18
13001;Žiedas;Bitutės;33966765931;Taip;4;2;0;6
13002;Žiedas;Bitutės;42777955874;Ne;0;1;0;1
13003;Žiedas;Bitutės;83630991208;Ne;0;1;0;1
13004;Žiedas;Bitutės;20740539606;Taip;0;1;0;1
13005;Žiedas;Bitutės;80003937908;Taip;0;1;0;1
13006;Žiedas;Bitutės;81304970766;Taip;0;2;4;6
13007;Žiedas;Bitutės;1288374706;Taip;0;5;0;5
13008;Žiedas;Bitutės;34178608904;Ne;8;8;0;16
13009;Žiedas;Bitutės;58252361010;Taip;5;10;0;15
13010;Žiedas;Varpeliai;32671505578;Taip;0;1;0;1
13011;Žiedas;Varpeliai;1733596148;Taip;10;1;0;11
13012;Žiedas;Varpeliai;55459877940;Taip;0;12;0;12
13013;Žiedas;Varpeliai;50069962197;Taip;0;2;0;2
13014;Žiedas;Varpeliai;59092030605;Ne;2;2;0;4
13015;Žiedas;Varpeliai;17275054601;Taip;8;2;0;10
13016;Žiedas;Varpeliai;1897597456;Taip;0;1;0;1
13017;Žiedas;Varpeliai;1443451076;Ne;11;0;0;11
13018;Žiedas;Varpeliai;1491929025;Taip;5;1;0;6
13019;Žiedas;Varpeliai;2075892389;Taip;4;0;0;4
13020;Žiedas;Varpeliai;9044903345;Taip;11;0;0;11
13021;Žiedas;Varpeliai;85152640431;Ne;0;1;0;1
13022;Žiedas;Varpeliai;2147350804;Taip;13;3;0;16
13023;Žiedas;Varpeliai;1366570116;Taip;2;1;0;3
13024;Žiedas;Varpeliai;37314210812;Taip;5;0;0;5
13025;Žiedas;Varpeliai;52683198809;Taip;5;8;0;13
13026;Žiedas;Varpeliai;99985645406;Taip;4;0;0;4
13027;Žiedas;Varpeliai;39022317368;Ne;0;1;0;1
13028;Žiedas;Varpeliai;1618815502;Taip;8;0;0;8
13029;Žiedas;Varpeliai;1332249885;Ne;3;0;0;3
13030;Žiedas;Varpeliai;12622490543;Ne;18;0;0;18
13031;Žiedas;Varpeliai;1120478375;Taip;10;1;0;11
13032;Žiedas;Varpeliai;2081656643;Taip;0;7;0;7
13033;Žiedas;Ramunėlės;9648580306;Taip;4;2;0;6
13034;Žiedas;Ramunėlės;9736967156;Taip;4;4;0;8
13035;Žiedas;Ramunėlės;4922560649;Taip;0;2;3;5
13036;Žiedas;Ramunėlės;2511423525;Taip;0;0;4;4
13037;Žiedas;Ramunėlės;7814504623;Taip;12;0;0;12
13038;Žiedas;Ramunėlės;2095655987;Ne;5;2;0;7
13039;Žiedas;Ramunėlės;7954517383;Taip;11;2;0;13
13040;Žiedas;Ramunėlės;9247088735;Taip;15;0;0;15
13041;Žiedas;Ramunėlės;9699668892;Taip;0;1;0;1
13042;Žiedas;Ramunėlės;6432090199;Taip;22;0;0;22
13043;Žiedas;Ramunėlės;1139186052;Taip;0;2;5;7
13044;Žiedas;Ramunėlės;5653785844;Ne;6;1;0;7
13045;Žiedas;Ramunėlės;5588136738;Taip;6;1;0;7
13046;Žiedas;Ramunėlės;5626494892;Taip;15;2;1;18
13047;Žiedas;Ramunėlės;7708360056;Taip;7;1;0;8
13048;Žiedas;Ramunėlės;7396006218;Taip;12;0;0;12
13049;Žiedas;Ramunėlės;3586376571;Taip;1;4;12;17
13050;Žiedas;Ramunėlės;6786526552;Ne;15;2;3;20
13051;Žiedas;Ramunėlės;2849254119;Taip;0;12;0;12
13052;Žiedas;Pakalnutės;1063755068;Taip;0;0;1;1
13053;Žiedas;Pakalnutės;42049755986;Taip;0;8;0;8
13054;Žiedas;Pakalnutės;52721173922;Taip;0;13;0;13
13055;Žiedas;Pakalnutės;2060067625;Taip;0;13;0;13
13056;Žiedas;Pakalnutės;2434909184;Taip;0;1;0;1
13057;Žiedas;Pakalnutės;3616767119;Taip;0;2;0;2
13058;Žiedas;Pakalnutės;1600420971;Taip;4;6;0;10
13059;Žiedas;Pakalnutės;3930283171;Taip;5;5;0;10
13060;Žiedas;Pakalnutės;1708363648;Taip;0;18;0;18
13061;Žiedas;Pakalnutės;1779122644;Taip;0;9;0;9
13062;Žiedas;Pakalnutės;9940683245;Taip;0;2;0;2
13063;Žiedas;Pakalnutės;1013773415;Taip;0;1;0;1
13064;Žiedas;Pakalnutės;27339844730;Taip;4;7;0;11
13065;Žiedas;Pakalnutės;5812737969;Ne;0;5;0;5
13066;Žiedas;Pakalnutės;1127645903;Ne;6;4;0;10
13067;Žiedas;Pakalnutės;1219022794;Taip;11;4;0;15
13068;Žiedas;Pakalnutės;7647496475;Taip;0;7;0;7
13069;Žiedas;Pakalnutės;1785446716;Taip;0;6;0;6
13070;Žiedas;Pakalnutės;2094277643;Ne;0;1;0;1
13071;Žiedas;Pakalnutės;12960180114;Taip;0;2;0;2
13072;Žiedas;Pakalnutės;3346603228;Ne;11;2;0;13
13073;Žiedas;Rožytės;2718046390;Taip;0;0;3;3
13074;Žiedas;Rožytės;1136010138;Taip;0;9;0;9
13075;Žiedas;Rožytės;1618505155;Ne;0;22;0;22
13076;Žiedas;Rožytės;47457128214;Ne;2;2;1;5
13077;Žiedas;Rožytės;40744263923;Taip;0;3;0;3
13078;Žiedas;Rožytės;33135652351;Taip;9;0;1;10
13079;Žiedas;Rožytės;1893226570;Ne;0;12;0;12
13080;Žiedas;Rožytės;2157262849;Taip;0;10;0;10
13081;Žiedas;Rožytės;9757771445;Ne;0;12;0;12
13082;Žiedas;Rožytės;73923918829;Taip;0;1;0;1
13083;Žiedas;Rožytės;4749655084;Taip;0;5;0;5
13084;Žiedas;Rožytės;1772492727;Taip;4;0;2;6
13085;Žiedas;Rožytės;8372385066;Taip;7;0;1;8
13086;Žiedas;Rožytės;3613860509;Taip;0;12;0;12
13087;Žiedas;Rožytės;5537717174;Taip;0;15;0;15
13088;Žiedas;Rožytės;6925923143;Taip;12;8;0;20
13089;Žiedas;Rožytės;1453937876;Taip;4;0;0;4
13090;Žiedas;Rožytės;1781950568;Ne;0;8;0;8
13091;Žiedas;Rožytės;9573180529;Taip;0;22;0;22
13092;Žiedas;Rožytės;2026462074;Taip;1;0;1;2
13093;Žiedas;Pumpurėliai;3178778438;Taip;8;5;1;14
13094;Žiedas;Pumpurėliai;5578227349;Taip;8;0;0;8
13095;Žiedas;Pumpurėliai;8812316692;Taip;9;0;0;9
13096;Žiedas;Pumpurėliai;3387263016;Ne;5;2;1;8
13097;Žiedas;Pumpurėliai;3230107921;Taip;8;0;0;8
13098;Žiedas;Pumpurėliai;9602083568;Taip;14;1;0;15
13099;Žiedas;Pumpurėliai;5628720422;Ne;18;1;0;19
13100;Žiedas;Pumpurėliai;1582961378;Ne;5;2;1;8
13101;Žiedas;Pumpurėliai;9020540780;Ne;9;0;1;10
13102;Žiedas;Pumpurėliai;3704491209;Taip;7;0;1;8
13103;Žiedas;Pumpurėliai;6882614465;Taip;4;0;0;4
13104;Žiedas;Pumpurėliai;6914059680;Ne;4;2;0;6
13105;Žiedas;Pumpurėliai;6515510381;Ne;18;0;0;18
13106;Žiedas;Pumpurėliai;3842589827;Taip;14;0;0;14
13107;Žiedas;Pumpurėliai;5835309107;Taip;4;0;0;4
13108;Žiedas;Pumpurėliai;3178580610;Ne;13;1;1;15
13109;Žiedas;Pumpurėliai;1878050384;Ne;12;0;0;12
13110;Žiedas;"Dobiliukai ";1484464986;Taip;0;13;0;13
13111;Žiedas;"Dobiliukai ";34193530;Taip;5;0;0;5
13112;Žiedas;"Dobiliukai ";1529988412;Taip;5;10;0;15
13113;Žiedas;"Dobiliukai ";78720591915;Taip;4;2;0;6
13114;Žiedas;"Dobiliukai ";86877563124;Taip;4;0;0;4
13115;Žiedas;"Dobiliukai ";1458152054;Ne;0;3;0;3
13116;Žiedas;"Dobiliukai ";69485023219;Taip;0;3;0;3
13117;Žiedas;"Dobiliukai ";1007894628;Ne;12;1;0;13
13118;Žiedas;"Dobiliukai ";1625009666;Taip;0;3;0;3
13119;Žiedas;"Dobiliukai ";1868951268;Ne;3;3;0;6
13120;Žiedas;"Dobiliukai ";1824692620;Taip;10;0;0;10
13121;Žiedas;"Dobiliukai ";9058688663;Ne;0;8;0;8
13122;Žiedas;"Dobiliukai ";2026728639;Taip;0;3;0;3
13123;Žiedas;"Dobiliukai ";7150433256;Taip;0;10;0;10
13124;Žiedas;"Dobiliukai ";1030089009;Ne;0;1;0;1
13125;Žiedas;"Dobiliukai ";4807479784;Taip;2;2;1;5
13126;Žiedas;"Dobiliukai ";2507543124;Taip;18;0;0;18
13127;Žiedas;"Dobiliukai ";6945326867;Taip;0;1;0;1
13128;Žiedas;"Dobiliukai ";9337128671;Taip;0;1;0;1
13129;Žiedas;RŪTELĖS;5885209631;Taip;0;2;5;7
13130;Žiedas;RŪTELĖS;2134466899;Taip;0;2;3;5
13131;Žiedas;RŪTELĖS;5420327672;Taip;4;1;0;5
13132;Žiedas;RŪTELĖS;5108263139;Taip;15;0;0;15
13133;Žiedas;RŪTELĖS;6822887260;Taip;0;1;0;1
13134;Žiedas;RŪTELĖS;9352485926;Taip;0;7;3;10
13135;Žiedas;RŪTELĖS;5914428064;Taip;15;0;0;15
13136;Žiedas;RŪTELĖS;3857121753;Taip;9;2;0;11
13137;Žiedas;RŪTELĖS;6443633568;Taip;0;0;20;20
13138;Žiedas;RŪTELĖS;5959899914;Taip;4;11;0;15
13139;Žiedas;RŪTELĖS;1737296046;Taip;0;1;0;1
13140;Žiedas;RŪTELĖS;7333813704;Ne;3;10;0;13
13141;Žiedas;RŪTELĖS;1048272199;Taip;8;0;0;8
13142;Žiedas;RŪTELĖS;1645402434;Taip;6;2;0;8
13143;Žiedas;RŪTELĖS;3715928992;Taip;0;0;1;1
13144;Žiedas;RŪTELĖS;1253833615;Taip;0;1;0;1
13145;Žiedas;RŪTELĖS;7578964555;Ne;0;7;0;7
13146;Žiedas;RŪTELĖS;5126173608;Taip;6;2;0;8
13147;Žiedas;RŪTELĖS;5647232875;Taip;7;1;0;8
13148;Žiedas;RŪTELĖS;7172793351;Ne;10;0;0;10
13149;Žiedas;RŪTELĖS;4497634040;Taip;2;0;1;3
13150;Žiedas;RŪTELĖS;7057747531;Taip;11;1;0;12
13151;Žiedas;RŪTELĖS;1738121071;Taip;0;8;0;8
13152;Žiedas;SAULĖGRĄŽOS;36350993825;Taip;8;1;0;9
13153;Žiedas;SAULĖGRĄŽOS;69245659818;Taip;4;2;0;6
13154;Žiedas;SAULĖGRĄŽOS;2391924358;Taip;0;1;0;1
13155;Žiedas;SAULĖGRĄŽOS;8172222365;Taip;0;5;0;5
13156;Žiedas;SAULĖGRĄŽOS;8753972322;Ne;6;6;0;12
13157;Žiedas;SAULĖGRĄŽOS;3900091129;Taip;2;0;0;2
13158;Žiedas;SAULĖGRĄŽOS;9363714015;Taip;7;3;0;10
13159;Žiedas;SAULĖGRĄŽOS;3067962647;Ne;0;17;0;17
13160;Žiedas;SAULĖGRĄŽOS;2037477873;Ne;0;1;1;2
13161;Žiedas;SAULĖGRĄŽOS;2843328732;Taip;0;3;0;3
13162;Žiedas;SAULĖGRĄŽOS;2515028280;Taip;0;4;0;4
13163;Žiedas;SAULĖGRĄŽOS;5282211767;Taip;0;7;0;7
13164;Žiedas;SAULĖGRĄŽOS;1583038469;Taip;12;1;0;13
13165;Žiedas;SAULĖGRĄŽOS;8208331527;Taip;7;6;0;13
13166;Žiedas;SAULĖGRĄŽOS;8517250094;Taip;0;9;0;9
13167;Žiedas;SAULĖGRĄŽOS;1318132922;Taip;0;1;0;1
13168;Žiedas;SAULĖGRĄŽOS;6815408748;Ne;0;1;0;1
13169;Žiedas;SAULĖGRĄŽOS;5079107907;Taip;0;1;0;1
13170;Žiedas;SAULĖGRĄŽOS;7136135394;Taip;0;4;0;4
13171;Žiedas;SAULĖGRĄŽOS;1450251779;Taip;0;3;0;3
13172;Žiedas;SAULĖGRĄŽOS;9037835899;Taip;12;5;0;17
13173;Žiedas;RUGIAGĖLĖS;8148831014;Ne;0;2;0;2
13174;Žiedas;RUGIAGĖLĖS;8645771800;Taip;14;0;0;14
13175;Žiedas;RUGIAGĖLĖS;9702211410;Taip;0;1;0;1
13176;Žiedas;RUGIAGĖLĖS;5570910138;Taip;0;8;0;8
13177;Žiedas;RUGIAGĖLĖS;7187176169;Taip;11;5;0;16
13178;Žiedas;RUGIAGĖLĖS;8163645535;Taip;13;0;0;13
13179;Žiedas;RUGIAGĖLĖS;9750690920;Taip;7;3;0;10
13180;Žiedas;RUGIAGĖLĖS;4222689492;Taip;3;1;0;4
13181;Žiedas;RUGIAGĖLĖS;2763996098;Ne;22;0;0;22
13182;Žiedas;RUGIAGĖLĖS;9894489800;Ne;13;0;0;13
13183;Žiedas;RUGIAGĖLĖS;4983852075;Taip;7;0;0;7
13184;Žiedas;RUGIAGĖLĖS;4521161684;Taip;0;1;0;1
13185;Žiedas;RUGIAGĖLĖS;3641595127;Taip;4;3;0;7
13186;Žiedas;RUGIAGĖLĖS;1333233100;Ne;5;0;0;5
13187;Žiedas;RUGIAGĖLĖS;9129315784;Taip;10;5;0;15
13188;Žiedas;RUGIAGĖLĖS;4284627073;Taip;6;0;0;6
13189;Žiedas;RUGIAGĖLĖS;3370495317;Taip;8;4;0;12
13190;Žiedas;RUGIAGĖLĖS;7952899220;Ne;10;0;0;10
13191;Žiedas;RUGIAGĖLĖS;6261847845;Ne;0;0;1;1
13192;Žiedas;RUGIAGĖLĖS;3984607857;Taip;2;0;0;2
13193;Žiedas;RUGIAGĖLĖS;5020148822;Taip;17;0;0;17
13194;Žiedas;RUGIAGĖLĖS;9415269410;Taip;8;0;0;8
13195;Žiedas;RUGIAGĖLĖS;7672879525;Taip;0;1;0;1
13196;Žiedas;Boružėlės;1079445123;Ne;0;1;0;1
13197;Žiedas;Boružėlės;50534384762;Taip;0;7;0;7
13198;Žiedas;Boružėlės;1985949180;Taip;2;5;1;8
13199;Žiedas;Boružėlės;1782429057;Taip;0;3;0;3
13200;Žiedas;Boružėlės;75047415039;Ne;0;2;0;2
13201;Žiedas;Boružėlės;85519253910;Taip;0;2;1;3
13202;Žiedas;Boružėlės;43123840066;Ne;0;1;0;1
13203;Žiedas;Boružėlės;50295529511;Taip;0;3;0;3
13204;Žiedas;Boružėlės;66729734455;Ne;0;0;1;1
13205;Žiedas;Boružėlės;226707253;Ne;0;2;5;7
13206;Žiedas;Boružėlės;4665596321;Taip;0;0;2;2
13207;Žiedas;Boružėlės;22305887643;Ne;0;0;3;3
13208;Žiedas;Boružėlės;39792014616;Taip;0;7;0;7
13209;Žiedas;Boružėlės;65264733887;Ne;5;1;0;6
13210;Žiedas;Boružėlės;56303923223;Ne;0;0;1;1
13211;Žiedas;Boružėlės;29411390190;Ne;0;4;0;4
13212;Žiedas;Boružėlės;55136247841;Ne;0;1;0;1
13213;Žiedas;AGUONĖLĖS;3055218791;Taip;0;2;3;5
13214;Žiedas;AGUONĖLĖS;9218388800;Taip;0;6;0;6
13215;Žiedas;AGUONĖLĖS;1243169901;Taip;7;4;0;11
13216;Žiedas;AGUONĖLĖS;1333555044;Taip;17;2;0;19
13217;Žiedas;AGUONĖLĖS;2682112101;Taip;3;1;0;4
13218;Žiedas;AGUONĖLĖS;4917324037;Taip;0;5;0;5
13219;Žiedas;AGUONĖLĖS;5789261620;Taip;12;0;0;12
13220;Žiedas;AGUONĖLĖS;5920211041;Taip;0;1;0;1
13221;Žiedas;AGUONĖLĖS;3168061557;Taip;11;0;0;11
13222;Žiedas;AGUONĖLĖS;4044156905;Taip;0;0;4;4
13223;Žiedas;AGUONĖLĖS;4844442247;Taip;5;6;0;11
13224;Žiedas;AGUONĖLĖS;6884933845;Taip;9;1;0;10
13225;Žiedas;AGUONĖLĖS;4348246825;Taip;4;0;0;4
13226;Žiedas;AGUONĖLĖS;7294671324;Taip;0;0;4;4
13227;Žiedas;AGUONĖLĖS;3821849812;Taip;17;0;0;17
13228;Žiedas;AGUONĖLĖS;2938302462;Taip;0;13;0;13
13229;Žiedas;AGUONĖLĖS;2092319455;Taip;7;0;0;7
13230;Žiedas;AGUONĖLĖS;6053010050;Taip;3;0;0;3
13231;Žiedas;ŽIBUTĖS;8857150598;Taip;13;0;0;13
13232;Žiedas;ŽIBUTĖS;7942276632;Taip;8;0;0;8
13233;Žiedas;ŽIBUTĖS;6041919197;Taip;13;0;0;13
13234;Žiedas;ŽIBUTĖS;7799489700;Taip;5;13;0;18
13235;Žiedas;ŽIBUTĖS;2932857132;Taip;6;0;0;6
13236;Žiedas;ŽIBUTĖS;2642760082;Taip;0;3;0;3
13237;Žiedas;ŽIBUTĖS;8927034492;Taip;0;22;0;22
13238;Žiedas;ŽIBUTĖS;2182381160;Taip;13;0;0;13
13239;Žiedas;ŽIBUTĖS;9057761408;Taip;0;2;1;3
13240;Žiedas;ŽIBUTĖS;9562512849;Taip;0;22;0;22
13241;Žiedas;ŽIBUTĖS;6175213274;Ne;5;2;0;7
13242;Žiedas;ŽIBUTĖS;8822472312;Taip;0;7;0;7
13243;Žiedas;ŽIBUTĖS;9021286246;Taip;2;2;0;4
13244;Žiedas;ŽIBUTĖS;1777501190;Taip;0;3;0;3
13245;Žiedas;ŽIBUTĖS;1043230748;Taip;0;9;0;9
13246;Žiedas;ŽIBUTĖS;1844621525;Ne;0;14;0;14
13247;Žiedas;ŽIBUTĖS;1975718197;Ne;0;0;1;1
13248;Žiogelis;SKRUZDELYTĖS;8819549855;Ne;0;1;0;1
13249;Žiogelis;SKRUZDELYTĖS;4508141956;Taip;0;6;7;13
13250;Žiogelis;SKRUZDELYTĖS;4343510173;Taip;0;11;0;11
13251;Žiogelis;SKRUZDELYTĖS;18018505301;Taip;4;1;0;5
13252;Žiogelis;SKRUZDELYTĖS;3503872654;Taip;0;1;0;1
13253;Žiogelis;SKRUZDELYTĖS;6067622823;Taip;4;1;0;5
13254;Žiogelis;SKRUZDELYTĖS;8702710674;Taip;0;5;0;5
13255;Žiogelis;SKRUZDELYTĖS;4671356872;Taip;6;0;0;6
13256;Žiogelis;SKRUZDELYTĖS;7881358741;Taip;0;2;0;2
13257;Žiogelis;SKRUZDELYTĖS;3609961581;Taip;9;1;0;10
13258;Žiogelis;SKRUZDELYTĖS;64865699245;Taip;0;1;0;1
13259;Žiogelis;SKRUZDELYTĖS;60959051938;Taip;5;0;0;5
13260;Žiogelis;SKRUZDELYTĖS;95713316600;Taip;0;6;0;6
13261;Žiogelis;SKRUZDELYTĖS;4445888917;Taip;4;0;0;4
13262;Žiogelis;SKRUZDELYTĖS;6659086172;Taip;8;1;1;10
13263;Žiogelis;SKRUZDELYTĖS;2883732914;Taip;0;3;0;3
13264;Žiogelis;SKRUZDELYTĖS;3189872952;Taip;0;3;0;3
13265;Žiogelis;SKRUZDELYTĖS;9295720241;Taip;14;3;0;17
13266;Žiogelis;SKRUZDELYTĖS;1568915914;Taip;0;1;0;1
13267;Žiogelis;SKRUZDELYTĖS;3203359908;Taip;3;0;0;3
13268;Žiogelis;SKRUZDELYTĖS;3320077143;Ne;8;1;0;9
13269;Žiogelis;ŽIRNIUKAI;7704256764;Taip;0;0;8;8
13270;Žiogelis;ŽIRNIUKAI;6701809272;Taip;0;1;0;1
13271;Žiogelis;ŽIRNIUKAI;2233244282;Taip;0;0;3;3
13272;Žiogelis;ŽIRNIUKAI;8675451323;Taip;0;1;4;5
13273;Žiogelis;ŽIRNIUKAI;85437321236;Taip;0;0;1;1
13274;Žiogelis;ŽIRNIUKAI;1660784232;Taip;0;0;5;5
13275;Žiogelis;ŽIRNIUKAI;1320651707;Taip;0;0;7;7
13276;Žiogelis;ŽIRNIUKAI;3310492752;Taip;0;3;2;5
13277;Žiogelis;ŽIRNIUKAI;2366095661;Taip;0;0;5;5
13278;Žiogelis;ŽIRNIUKAI;1320126836;Taip;0;0;2;2
13279;Žiogelis;ŽIRNIUKAI;1442866468;Taip;17;0;2;19
13280;Žiogelis;ŽIRNIUKAI;6697117406;Taip;15;0;0;15
13281;Žiogelis;ŽIRNIUKAI;9862582346;Ne;0;0;5;5
13282;Žiogelis;ŽIRNIUKAI;7087781379;Ne;0;0;4;4
13283;Žiogelis;ŽIRNIUKAI;4015109974;Ne;0;0;4;4
13284;Žiogelis;ŽIRNIUKAI;9406830518;Ne;0;0;6;6
13285;Žiogelis;ŽIRNIUKAI;4713696984;Ne;0;0;6;6
13286;Žiogelis;ŽIRNIUKAI;2028383677;Taip;0;1;2;3
13287;Žiogelis;ŽIRNIUKAI;2704243085;Taip;2;0;1;3
13288;Žiogelis;DOBILĖLIAI;8683148826;Taip;0;1;0;1
13289;Žiogelis;DOBILĖLIAI;3502278745;Taip;7;0;0;7
13290;Žiogelis;DOBILĖLIAI;3308563362;Taip;0;0;1;1
13291;Žiogelis;DOBILĖLIAI;3928697936;Taip;0;11;0;11
13292;Žiogelis;DOBILĖLIAI;5364996984;Taip;0;0;1;1
13293;Žiogelis;DOBILĖLIAI;9568208184;Taip;0;0;1;1
13294;Žiogelis;DOBILĖLIAI;6340620973;Taip;0;6;0;6
13295;Žiogelis;DOBILĖLIAI;5961630249;Taip;0;10;0;10
13296;Žiogelis;DOBILĖLIAI;7630342576;Taip;0;0;4;4
13297;Žiogelis;DOBILĖLIAI;6532218580;Taip;0;0;2;2
13298;Žiogelis;DOBILĖLIAI;1763070523;Ne;9;5;0;14
13299;Žiogelis;DOBILĖLIAI;5911231906;Taip;0;1;0;1
13300;Žiogelis;DOBILĖLIAI;1609336147;Taip;0;5;0;5
13301;Žiogelis;DOBILĖLIAI;6115834138;Ne;0;0;4;4
13302;Žiogelis;DOBILĖLIAI;3887222613;Ne;16;1;0;17
13303;Žiogelis;DOBILĖLIAI;7065052244;Taip;0;0;6;6
13304;Žiogelis;BORUŽĖLĖS;54446173105;Taip;0;0;2;2
13305;Žiogelis;BORUŽĖLĖS;4776403513;Taip;5;0;0;5
13306;Žiogelis;BORUŽĖLĖS;1617516552;Taip;3;0;0;3
13307;Žiogelis;BORUŽĖLĖS;4465151986;Taip;0;0;8;8
13308;Žiogelis;BORUŽĖLĖS;6963163354;Taip;6;3;0;9
13309;Žiogelis;BORUŽĖLĖS;98660118094;Taip;22;0;0;22
13310;Žiogelis;BORUŽĖLĖS;67475530006;Ne;0;3;0;3
13311;Žiogelis;BORUŽĖLĖS;8169022043;Taip;0;1;0;1
13312;Žiogelis;BORUŽĖLĖS;5639046412;Ne;0;9;0;9
13313;Žiogelis;BORUŽĖLĖS;65387706999;Ne;0;2;0;2
13314;Žiogelis;BORUŽĖLĖS;45051106222;Taip;2;8;0;10
13315;Žiogelis;BORUŽĖLĖS;39293593638;Taip;0;3;0;3
13316;Žiogelis;BORUŽĖLĖS;49836275638;Taip;0;0;4;4
13317;Žiogelis;BORUŽĖLĖS;14932261911;Taip;0;11;2;13
13318;Žiogelis;BORUŽĖLĖS;48896172781;Taip;0;1;0;1
13319;Žiogelis;BORUŽĖLĖS;63956907259;Taip;0;2;0;2
13320;Žiogelis;BORUŽĖLĖS;30488905109;Ne;0;3;0;3
13321;Žiogelis;BORUŽĖLĖS;84919810287;Taip;0;7;0;7
13322;Žiogelis;BORUŽĖLĖS;87755643169;Taip;0;1;0;1
13323;Žiogelis;BORUŽĖLĖS;89934673064;Ne;0;0;5;5
13324;Žiogelis;BORUŽĖLĖS;5072204356;Taip;0;0;9;9
13325;Žiogelis;DRUGELIAI;37505015919;Taip;0;3;0;3
13326;Žiogelis;DRUGELIAI;25631779076;Taip;0;4;0;4
13327;Žiogelis;DRUGELIAI;52847485981;Taip;11;2;0;13
13328;Žiogelis;DRUGELIAI;96369154198;Ne;0;0;1;1
13329;Žiogelis;DRUGELIAI;56579227266;Ne;18;0;0;18
13330;Žiogelis;DRUGELIAI;66037746045;Taip;0;4;0;4
13331;Žiogelis;DRUGELIAI;68621438109;Taip;0;4;0;4
13332;Žiogelis;DRUGELIAI;18225364866;Taip;0;1;0;1
13333;Žiogelis;DRUGELIAI;35609682774;Taip;4;0;2;6
13334;Žiogelis;DRUGELIAI;1096666450;Taip;0;1;0;1
13335;Žiogelis;DRUGELIAI;1237788562;Taip;0;5;0;5
13336;Žiogelis;DRUGELIAI;1082983134;Taip;0;0;7;7
13337;Žiogelis;DRUGELIAI;97696839366;Taip;0;0;1;1
13338;Žiogelis;DRUGELIAI;9326053563;Taip;0;0;7;7
13339;Žiogelis;DRUGELIAI;2853980993;Taip;0;0;1;1
13340;Žiogelis;DRUGELIAI;6980862023;Taip;0;0;5;5
13341;Žiogelis;DRUGELIAI;5975060180;Taip;0;0;9;9
13342;Žiogelis;PELĖDŽIUKAI;25765405268;Taip;0;4;0;4
13343;Žiogelis;PELĖDŽIUKAI;58435832422;Taip;0;10;0;10
13344;Žiogelis;PELĖDŽIUKAI;65431295185;Taip;0;1;2;3
13345;Žiogelis;PELĖDŽIUKAI;90856268042;Taip;0;0;1;1
13346;Žiogelis;PELĖDŽIUKAI;4546122149;Taip;5;1;0;6
13347;Žiogelis;PELĖDŽIUKAI;677032532;Taip;0;1;0;1
13348;Žiogelis;PELĖDŽIUKAI;75990939732;Taip;0;1;1;2
13349;Žiogelis;PELĖDŽIUKAI;99706324340;Taip;0;4;0;4
13350;Žiogelis;PELĖDŽIUKAI;46206606894;Ne;0;1;0;1
13351;Žiogelis;PELĖDŽIUKAI;87136010729;Taip;0;3;0;3
13352;Žiogelis;PELĖDŽIUKAI;83065651470;Ne;0;1;0;1
13353;Žiogelis;PELĖDŽIUKAI;88467192459;Taip;8;8;0;16
13354;Žiogelis;PELĖDŽIUKAI;23052639699;Taip;0;0;2;2
13355;Žiogelis;PELĖDŽIUKAI;30153333482;Ne;4;0;0;4
13356;Žiogelis;PELĖDŽIUKAI;9520854450;Taip;2;2;0;4
13357;Žiogelis;PELĖDŽIUKAI;46938187629;Taip;0;0;1;1
13358;Žiogelis;PELĖDŽIUKAI;1303123383;Taip;0;1;0;1
13359;Žiogelis;PELĖDŽIUKAI;62633906174;Taip;0;3;0;3
13360;Žiogelis;PELĖDŽIUKAI;2100993889;Ne;0;2;0;2
13361;Žiogelis;PELĖDŽIUKAI;80050087040;Taip;15;5;0;20
13362;Žiogelis;VARPELIAI;63443494015;Taip;0;4;0;4
13363;Žiogelis;VARPELIAI;1069475442;Ne;3;3;0;6
13364;Žiogelis;VARPELIAI;72043183625;Taip;0;2;0;2
13365;Žiogelis;VARPELIAI;1198917418;Taip;0;11;0;11
13366;Žiogelis;VARPELIAI;44118139818;Taip;0;3;0;3
13367;Žiogelis;VARPELIAI;7708273984;Taip;4;4;0;8
13368;Žiogelis;VARPELIAI;1060830668;Taip;0;22;0;22
13369;Žiogelis;VARPELIAI;9871477318;Taip;8;0;0;8
13370;Žiogelis;VARPELIAI;6225523016;Taip;0;10;0;10
13371;Žiogelis;VARPELIAI;2575280329;Taip;7;0;0;7
13372;Žiogelis;VARPELIAI;4402777236;Taip;10;0;0;10
13373;Žiogelis;VARPELIAI;1370071592;Taip;0;7;0;7
13374;Žiogelis;VARPELIAI;9416538794;Taip;4;4;0;8
13375;Žiogelis;VARPELIAI;7888873296;Taip;3;6;0;9
13376;Žiogelis;VARPELIAI;9032003195;Ne;0;7;0;7
13377;Žiogelis;VARPELIAI;8262619320;Taip;4;1;0;5
13378;Žiogelis;VARPELIAI;1837140329;Ne;0;2;0;2
13379;Žiogelis;VARPELIAI;8058231095;Taip;0;2;0;2
13380;Žiogelis;VARPELIAI;8983731310;Taip;5;1;0;6
13381;Žiogelis;KREGŽDUTĖS;1195431423;Taip;0;1;0;1
13382;Žiogelis;KREGŽDUTĖS;20399291813;Taip;17;1;0;18
13383;Žiogelis;KREGŽDUTĖS;1521276302;Taip;7;0;0;7
13384;Žiogelis;KREGŽDUTĖS;52932005977;Taip;0;4;0;4
13385;Žiogelis;KREGŽDUTĖS;28585504631;Taip;18;0;0;18
13386;Žiogelis;KREGŽDUTĖS;71387182665;Taip;0;1;0;1
13387;Žiogelis;KREGŽDUTĖS;94690046398;Taip;0;1;0;1
13388;Žiogelis;KREGŽDUTĖS;88933947850;Ne;8;8;0;16
13389;Žiogelis;KREGŽDUTĖS;22969768169;Taip;0;1;0;1
13390;Žiogelis;KREGŽDUTĖS;18304908981;Taip;0;1;0;1
13391;Žiogelis;KREGŽDUTĖS;1042591705;Taip;0;4;0;4
13392;Žiogelis;KREGŽDUTĖS;1160064257;Taip;0;2;1;3
13393;Žiogelis;KREGŽDUTĖS;2072071751;Ne;0;2;0;2
13394;Žiogelis;KREGŽDUTĖS;1200247527;Taip;10;0;0;10
13395;Žiogelis;KREGŽDUTĖS;41448152472;Taip;4;2;0;6
13396;Žiogelis;KREGŽDUTĖS;44023584723;Taip;0;2;2;4
13397;Žiogelis;KREGŽDUTĖS;1821759690;Ne;5;1;0;6
13398;Žiogelis;KREGŽDUTĖS;24010106626;Taip;5;7;0;12
13399;Žiogelis;KREGŽDUTĖS;2062794337;Ne;0;1;0;1
13400;Žiogelis;KREGŽDUTĖS;3802615302;Taip;4;0;0;4
13401;Žiogelis;KREGŽDUTĖS;84803452318;Taip;13;5;0;18
13402;Žiogelis;KREGŽDUTĖS;10001742134;Ne;0;1;4;5
13403;Žiogelis;KREGŽDUTĖS;4675275745;Taip;13;0;0;13
13404;Žiogelis;ŽVIRBLIUKAI;4156736676;Ne;6;0;0;6
13405;Žiogelis;ŽVIRBLIUKAI;4565342104;Taip;0;2;2;4
13406;Žiogelis;ŽVIRBLIUKAI;8894068297;Taip;0;4;0;4
13407;Žiogelis;ŽVIRBLIUKAI;4609861306;Taip;6;0;0;6
13408;Žiogelis;ŽVIRBLIUKAI;9387048672;Taip;0;14;0;14
13409;Žiogelis;ŽVIRBLIUKAI;7502572217;Taip;8;0;0;8
13410;Žiogelis;ŽVIRBLIUKAI;7936785905;Taip;0;5;0;5
13411;Žiogelis;ŽVIRBLIUKAI;4378941619;Taip;0;5;0;5
13412;Žiogelis;ŽVIRBLIUKAI;1939672072;Taip;5;0;1;6
13413;Žiogelis;ŽVIRBLIUKAI;2759766559;Taip;22;0;0;22
13414;Žiogelis;ŽVIRBLIUKAI;1134384178;Taip;4;1;0;5
13415;Žiogelis;ŽVIRBLIUKAI;8689074067;Ne;0;8;0;8
13416;Žiogelis;ŽVIRBLIUKAI;7128248940;Ne;0;0;5;5
13417;Žiogelis;ŽVIRBLIUKAI;3963308094;Taip;0;8;0;8
13418;Žiogelis;ŽVIRBLIUKAI;9250789113;Taip;0;8;0;8
13419;Žiogelis;ŽVIRBLIUKAI;8217782981;Taip;0;1;0;1
13420;Žiogelis;ŽVIRBLIUKAI;7098548563;Taip;0;2;6;8
13421;Žiogelis;ŽVIRBLIUKAI;3937261260;Taip;0;2;2;4
13422;Žiogelis;BITUTĖS;3752355139;Taip;14;0;0;14
13423;Žiogelis;BITUTĖS;2173494736;Taip;0;0;3;3
13424;Žiogelis;BITUTĖS;5042341085;Taip;0;9;0;9
13425;Žiogelis;BITUTĖS;6347738933;Taip;15;0;0;15
13426;Žiogelis;BITUTĖS;9627583831;Taip;8;5;0;13
13427;Žiogelis;BITUTĖS;3296450902;Taip;0;1;0;1
13428;Žiogelis;BITUTĖS;2455244286;Taip;6;2;0;8
13429;Žiogelis;BITUTĖS;3792114246;Taip;6;1;0;7
13430;Žiogelis;BITUTĖS;9981130790;Ne;12;2;0;14
13431;Žiogelis;BITUTĖS;8293687695;Taip;0;5;0;5
13432;Žiogelis;BITUTĖS;1996517542;Ne;9;4;0;13
13433;Žiogelis;BITUTĖS;9790463889;Taip;14;8;0;22
13434;Žiogelis;BITUTĖS;6024752960;Taip;3;0;0;3
13435;Žiogelis;BITUTĖS;8853905367;Taip;3;0;0;3
13436;Žiogelis;BITUTĖS;1397686161;Taip;0;6;0;6
13437;Žiogelis;BITUTĖS;2171351454;Taip;0;0;1;1
13438;Žiogelis;BITUTĖS;6760074113;Taip;0;0;3;3
13439;Žiogelis;RIEŠUTĖLIAI;6378295945;Taip;5;0;3;8
13440;Žiogelis;RIEŠUTĖLIAI;6308141378;Taip;2;0;0;2
13441;Žiogelis;RIEŠUTĖLIAI;4115425880;Taip;4;1;0;5
13442;Žiogelis;RIEŠUTĖLIAI;4150956779;Taip;0;4;1;5
13443;Žiogelis;RIEŠUTĖLIAI;1268908081;Taip;10;0;0;10
13444;Žiogelis;RIEŠUTĖLIAI;1828843135;Taip;3;0;1;4
13445;Žiogelis;RIEŠUTĖLIAI;5487213418;Taip;0;1;0;1
13446;Žiogelis;RIEŠUTĖLIAI;3856321373;Taip;16;2;0;18
13447;Žiogelis;RIEŠUTĖLIAI;7340918175;Taip;0;8;0;8
13448;Žiogelis;RIEŠUTĖLIAI;2811730515;Taip;22;0;0;22
13449;Žiogelis;RIEŠUTĖLIAI;7310459638;Taip;2;3;0;5
13450;Žiogelis;RIEŠUTĖLIAI;4513613915;Taip;7;3;0;10
13451;Žiogelis;RIEŠUTĖLIAI;8712788346;Taip;9;5;0;14
13452;Žiogelis;RIEŠUTĖLIAI;5054228916;Taip;0;0;2;2
13453;Žiogelis;RIEŠUTĖLIAI;6866685213;Taip;4;9;0;13
13454;Žiogelis;RIEŠUTĖLIAI;9813150014;Taip;0;4;0;4
13455;Žiogelis;RIEŠUTĖLIAI;7535167450;Taip;13;0;0;13
13456;Žiogelis;RIEŠUTĖLIAI;9874412804;Taip;19;0;0;19
13457;Žiogelis;RIEŠUTĖLIAI;1763603533;Taip;19;0;0;19
13458;Žolynėlis;"RŪTELĖ (spec)";48837362422;Taip;0;5;0;5
13459;Žolynėlis;"RŪTELĖ (spec)";88879292846;Ne;0;8;0;8
13460;Žolynėlis;"RŪTELĖ (spec)";1954888655;Taip;0;7;0;7
13461;Žolynėlis;"RŪTELĖ (spec)";4000928238;Taip;0;22;0;22
13462;Žolynėlis;"RŪTELĖ (spec)";1568023021;Taip;8;7;2;17
13463;Žolynėlis;"SAULUTĖ (spec)";89488434450;Taip;15;0;0;15
13464;Žolynėlis;"SAULUTĖ (spec)";9675783636;Taip;0;5;0;5
13465;Žolynėlis;"SAULUTĖ (spec)";1196172221;Ne;5;2;0;7
13466;Žolynėlis;"SAULUTĖ (spec)";7962304738;Ne;0;2;1;3
13467;Žolynėlis;"SAULUTĖ (spec)";6678697536;Taip;2;5;0;7
13468;Žolynėlis;"LINELIS (spec)";93519259505;Taip;3;5;0;8
13469;Žolynėlis;"LINELIS (spec)";7717415005;Taip;3;1;0;4
13470;Žolynėlis;"LINELIS (spec)";2665355759;Taip;3;1;0;4
13471;Žolynėlis;"LINELIS (spec)";6080154964;Taip;0;10;0;10
13472;Žolynėlis;"RASAKILA (spec)";4971887781;Taip;22;0;0;22
13473;Žolynėlis;"RASAKILA (spec)";3337602618;Ne;1;0;0;1
13474;Žolynėlis;"RASAKILA (spec)";6510930436;Taip;8;0;0;8
13475;Žolynėlis;"RASAKILA (spec)";6619551947;Taip;16;2;0;18
13476;Žolynėlis;"RAMUNĖLĖS (spec)";4438939800;Taip;0;1;3;4
13477;Žolynėlis;"RAMUNĖLĖS (spec)";2511678193;Taip;4;2;3;9
13478;Žolynėlis;"RAMUNĖLĖS (spec)";9926551617;Taip;9;1;0;10
13479;Žolynėlis;Dobiliukai;1655571687;Taip;0;2;6;8
13480;Žolynėlis;Dobiliukai;1331253673;Taip;0;2;0;2
13481;Žolynėlis;Dobiliukai;89750778560;Taip;4;2;2;8
13482;Žolynėlis;Dobiliukai;76688557717;Taip;5;3;0;8
13483;Žolynėlis;Dobiliukai;47442048515;Taip;0;2;3;5
13484;Žolynėlis;Dobiliukai;75335374706;Taip;0;1;0;1
13485;Žolynėlis;Dobiliukai;71887799705;Taip;0;1;0;1
13486;Žolynėlis;Dobiliukai;1122183123;Taip;4;0;0;4
13487;Žolynėlis;Dobiliukai;1933377698;Taip;0;2;0;2
13488;Žolynėlis;Dobiliukai;3198470147;Taip;0;1;0;1
13489;Žolynėlis;Dobiliukai;1901979061;Ne;0;2;1;3
13490;Žolynėlis;Dobiliukai;9128728457;Taip;0;8;0;8
13491;Žolynėlis;Dobiliukai;5717038791;Taip;0;16;0;16
13492;Žolynėlis;Dobiliukai;44063150309;Taip;0;1;0;1
13493;Žolynėlis;Dobiliukai;92615552899;Taip;0;2;0;2
13494;Žolynėlis;Aguonėlė;1620578562;Taip;0;7;0;7
13495;Žolynėlis;Aguonėlė;95007685205;Taip;0;5;0;5
13496;Žolynėlis;Aguonėlė;61475380296;Taip;2;2;0;4
13497;Žolynėlis;Aguonėlė;8027151284;Taip;13;1;0;14
13498;Žolynėlis;Aguonėlė;28730145668;Taip;0;3;9;12
13499;Žolynėlis;Aguonėlė;84849092452;Ne;3;7;0;10
13500;Žolynėlis;Aguonėlė;3263848791;Taip;9;0;2;11
13501;Žolynėlis;Aguonėlė;1473516753;Taip;0;3;0;3
13502;Žolynėlis;Aguonėlė;7256502393;Taip;0;1;0;1
13503;Žolynėlis;Aguonėlė;79704789499;Taip;0;1;0;1
13504;Žolynėlis;Aguonėlė;2881461471;Taip;0;2;0;2
13505;Žolynėlis;Aguonėlė;8547773739;Taip;0;4;0;4
13506;Žolynėlis;Aguonėlė;2565770471;Taip;18;2;0;20
13507;Žolynėlis;Aguonėlė;8700231970;Taip;0;13;0;13
13508;Žolynėlis;Pienė;3520272555;Taip;0;14;0;14
13509;Žolynėlis;Pienė;2108221942;Taip;4;6;0;10
13510;Žolynėlis;Pienė;7980206574;Taip;4;0;0;4
13511;Žolynėlis;Pienė;2460982987;Taip;0;10;0;10
13512;Žolynėlis;Pienė;7339110559;Taip;12;3;0;15
13513;Žolynėlis;Pienė;6763515483;Taip;3;0;1;4
13514;Žolynėlis;Pienė;8215427354;Ne;7;10;0;17
13515;Žolynėlis;Pienė;1485195267;Taip;0;2;1;3
13516;Žolynėlis;Pienė;1163753820;Ne;7;0;0;7
13517;Žolynėlis;Pienė;9106152447;Taip;0;3;0;3
13518;Žolynėlis;Pienė;1879046798;Taip;8;0;0;8
13519;Žolynėlis;Pienė;5173171444;Taip;0;1;0;1
13520;Žolynėlis;Pienė;9238832484;Taip;0;1;0;1
13521;Žolynėlis;Pienė;3877168024;Taip;0;4;7;11
13522;Žolynėlis;Pienė;6416217971;Taip;0;6;0;6
13523;Žolynėlis;Pienė;1337138547;Taip;5;2;0;7
13524;Žolynėlis;Pienė;4618251201;Ne;0;2;1;3
13525;Žolynėlis;Pienė;5432464074;Taip;5;3;0;8
13526;Žolynėlis;Čiobreliai;4379062413;Taip;0;12;0;12
13527;Žolynėlis;Čiobreliai;96960531652;Taip;0;1;0;1
13528;Žolynėlis;Čiobreliai;67610580721;Taip;0;13;0;13
13529;Žolynėlis;Čiobreliai;91866724044;Taip;0;6;0;6
13530;Žolynėlis;Čiobreliai;58271736414;Taip;0;2;0;2
13531;Žolynėlis;Čiobreliai;1123243743;Taip;0;3;1;4
13532;Žolynėlis;Čiobreliai;79759781705;Taip;3;1;0;4
13533;Žolynėlis;Čiobreliai;1833898567;Taip;0;1;0;1
13534;Žolynėlis;Čiobreliai;1080834237;Taip;0;8;0;8
13535;Žolynėlis;Čiobreliai;1619061427;Ne;0;4;0;4
13536;Žolynėlis;Čiobreliai;8104525380;Taip;0;3;0;3
13537;Žolynėlis;Čiobreliai;24353356454;Taip;0;6;0;6
13538;Žolynėlis;Čiobreliai;82641799101;Taip;0;9;0;9
13539;Žolynėlis;Čiobreliai;95943166746;Taip;4;0;5;9
13540;Žolynėlis;Čiobreliai;4109395683;Taip;0;16;0;16
13541;Žolynėlis;Čiobreliai;2984354887;Taip;5;3;0;8
13542;Žolynėlis;Čiobreliai;66167062016;Taip;0;3;0;3
13543;Žolynėlis;Čiobreliai;2051626484;Taip;0;16;0;16
13544;Žolynėlis;Čiobreliai;5668288544;Taip;0;1;0;1
13545;Žuvėdra;"JŪROS ŽVAIGŽDUTĖS";3516571980;Taip;2;1;5;8
13546;Žuvėdra;"JŪROS ŽVAIGŽDUTĖS";8096854841;Taip;11;0;2;13
13547;Žuvėdra;"JŪROS ŽVAIGŽDUTĖS";3148638780;Taip;0;10;0;10
13548;Žuvėdra;"JŪROS ŽVAIGŽDUTĖS";7673681906;Taip;7;0;0;7
13549;Žuvėdra;"JŪROS ŽVAIGŽDUTĖS";6148764075;Taip;0;4;0;4
13550;Žuvėdra;"JŪROS ŽVAIGŽDUTĖS";8349985186;Taip;4;3;0;7
13551;Žuvėdra;"JŪROS ŽVAIGŽDUTĖS";29500668582;Taip;0;22;0;22
13552;Žuvėdra;"JŪROS ŽVAIGŽDUTĖS";4828788876;Taip;0;4;0;4
13553;Žuvėdra;"JŪROS ŽVAIGŽDUTĖS";6068515077;Taip;0;12;0;12
13554;Žuvėdra;"JŪROS ŽVAIGŽDUTĖS";8104921853;Taip;0;2;1;3
13555;Žuvėdra;"JŪROS ŽVAIGŽDUTĖS";87882215162;Taip;0;11;0;11
13556;Žuvėdra;"JŪROS ŽVAIGŽDUTĖS";11300891895;Ne;0;8;0;8
13557;Žuvėdra;"JŪROS ŽVAIGŽDUTĖS";23851864127;Taip;0;3;0;3
13558;Žuvėdra;"JŪROS ŽVAIGŽDUTĖS";8843700949;Ne;0;4;0;4
13559;Žuvėdra;"JŪROS ŽVAIGŽDUTĖS";5472830961;Ne;0;4;0;4
13560;Žuvėdra;"JŪROS ŽVAIGŽDUTĖS";8589283055;Taip;9;0;4;13
13561;Žuvėdra;"JŪROS ŽVAIGŽDUTĖS";1030020199;Taip;7;1;0;8
13562;Žuvėdra;"JŪROS ŽVAIGŽDUTĖS";8008000299;Taip;11;0;0;11
13563;Žuvėdra;DELFINUKAI;2334342995;Ne;0;2;0;2
13564;Žuvėdra;DELFINUKAI;5558584030;Ne;0;2;0;2
13565;Žuvėdra;DELFINUKAI;5049101816;Ne;0;13;0;13
13566;Žuvėdra;DELFINUKAI;9230342970;Taip;4;3;0;7
13567;Žuvėdra;DELFINUKAI;3620753237;Taip;12;6;0;18
13568;Žuvėdra;DELFINUKAI;2462839180;Ne;0;1;0;1
13569;Žuvėdra;DELFINUKAI;2660909247;Taip;6;0;0;6
13570;Žuvėdra;DELFINUKAI;8822952385;Ne;15;3;0;18
13571;Žuvėdra;DELFINUKAI;2092890028;Taip;8;3;0;11
13572;Žuvėdra;DELFINUKAI;1311162040;Taip;0;5;0;5
13573;Žuvėdra;DELFINUKAI;9870595577;Taip;0;4;0;4
13574;Žuvėdra;DELFINUKAI;6294045755;Taip;0;8;0;8
13575;Žuvėdra;DELFINUKAI;3068069755;Taip;14;2;0;16
13576;Žuvėdra;DELFINUKAI;1200084485;Taip;0;6;0;6
13577;Žuvėdra;DELFINUKAI;2694424532;Ne;13;0;0;13
13578;Žuvėdra;DELFINUKAI;4177319374;Taip;0;3;0;3
13579;Žuvėdra;DELFINUKAI;8100988548;Taip;0;9;0;9
13580;Žuvėdra;DELFINUKAI;9733979816;Ne;16;0;0;16
13581;Žuvėdra;OSMINOŽKI;1762760384;Ne;0;1;2;3
13582;Žuvėdra;OSMINOŽKI;1963584073;Taip;0;5;0;5
13583;Žuvėdra;OSMINOŽKI;2136463079;Taip;0;2;0;2
13584;Žuvėdra;OSMINOŽKI;74446494235;Taip;0;13;0;13
13585;Žuvėdra;OSMINOŽKI;41564122720;Taip;0;1;0;1
13586;Žuvėdra;OSMINOŽKI;1639340750;Taip;0;5;0;5
13587;Žuvėdra;OSMINOŽKI;3487938908;Ne;4;5;0;9
13588;Žuvėdra;OSMINOŽKI;66236924555;Taip;0;1;0;1
13589;Žuvėdra;OSMINOŽKI;66973380124;Taip;0;10;5;15
13590;Žuvėdra;OSMINOŽKI;8134671188;Taip;2;8;0;10
13591;Žuvėdra;OSMINOŽKI;4588593273;Taip;5;0;1;6
13592;Žuvėdra;OSMINOŽKI;55687216943;Taip;0;5;0;5
13593;Žuvėdra;OSMINOŽKI;1236696072;Taip;0;2;0;2
13594;Žuvėdra;OSMINOŽKI;1203660127;Taip;0;8;0;8
13595;Žuvėdra;OSMINOŽKI;9911525172;Taip;0;4;0;4
13596;Žuvėdra;OSMINOŽKI;24915726868;Taip;0;2;0;2
13597;Žuvėdra;OSMINOŽKI;1116645502;Taip;0;19;0;19
13598;Žuvėdra;OSMINOŽKI;1195732987;Ne;0;5;0;5
13599;Žuvėdra;OSMINOŽKI;1312918359;Taip;0;3;0;3
13600;Žuvėdra;OSMINOŽKI;1923452638;Taip;0;0;3;3
13601;Žuvėdra;OSMINOŽKI;6468506668;Ne;10;2;2;14
13602;Žuvėdra;OSMINOŽKI;83890207087;Taip;12;4;0;16
13603;Žuvėdra;OSMINOŽKI;1127602652;Taip;0;2;0;2
13604;Žuvėdra;RUSALAČKA;8408371550;Taip;11;0;0;11
13605;Žuvėdra;RUSALAČKA;2731016281;Taip;0;18;0;18
13606;Žuvėdra;RUSALAČKA;1164464390;Taip;11;2;0;13
13607;Žuvėdra;RUSALAČKA;1340241206;Taip;3;0;0;3
13608;Žuvėdra;RUSALAČKA;5021263583;Taip;0;2;0;2
13609;Žuvėdra;RUSALAČKA;5489757084;Taip;4;2;0;6
13610;Žuvėdra;RUSALAČKA;14760907606;Taip;14;0;0;14
13611;Žuvėdra;RUSALAČKA;1632308084;Taip;2;4;0;6
13612;Žuvėdra;RUSALAČKA;4011849839;Taip;3;7;0;10
13613;Žuvėdra;RUSALAČKA;75901332720;Taip;0;4;0;4
13614;Žuvėdra;RUSALAČKA;5684848140;Taip;8;6;0;14
13615;Žuvėdra;RUSALAČKA;5496071972;Taip;14;2;0;16
13616;Žuvėdra;RUSALAČKA;6612880861;Taip;8;2;0;10
13617;Žuvėdra;RUSALAČKA;1941428466;Ne;6;1;0;7
13618;Žuvėdra;RUSALAČKA;6007871092;Taip;0;1;0;1
13619;Žuvėdra;RUSALAČKA;3853045274;Taip;5;4;0;9
13620;Žuvėdra;RUSALAČKA;6537464526;Taip;7;4;0;11
13621;Žuvėdra;RUSALAČKA;5674529681;Taip;6;7;0;13
13622;Žuvėdra;RUSALAČKA;7630057671;Taip;0;3;0;3
13623;Žuvėdra;RUSALAČKA;7368183516;Taip;0;10;0;10
13624;Žuvėdra;RUSALAČKA;3185158741;Taip;1;0;0;1
13625;Žuvėdra;RUSALAČKA;5198825127;Taip;22;0;0;22
13626;Žuvėdra;RUSALAČKA;5561903903;Taip;17;0;0;17
13627;Žuvėdra;JANTARIKI;1960306957;Taip;0;8;0;8
13628;Žuvėdra;JANTARIKI;7467154866;Taip;6;1;0;7
13629;Žuvėdra;JANTARIKI;4715123063;Taip;0;5;0;5
13630;Žuvėdra;JANTARIKI;8308610070;Taip;0;2;2;4
13631;Žuvėdra;JANTARIKI;2582404760;Taip;0;6;0;6
13632;Žuvėdra;JANTARIKI;3613045982;Taip;4;6;0;10
13633;Žuvėdra;JANTARIKI;1509519996;Taip;0;11;0;11
13634;Žuvėdra;JANTARIKI;7710853637;Taip;0;6;0;6
13635;Žuvėdra;JANTARIKI;5151984122;Taip;0;1;0;1
13636;Žuvėdra;JANTARIKI;8942228415;Taip;0;0;2;2
13637;Žuvėdra;JANTARIKI;4373886054;Taip;4;10;0;14
13638;Žuvėdra;JANTARIKI;2987217910;Taip;14;0;0;14
13639;Žuvėdra;JANTARIKI;6672289932;Taip;5;0;0;5
13640;Žuvėdra;JANTARIKI;3349158713;Taip;5;0;1;6
13641;Žuvėdra;JANTARIKI;4702627979;Taip;0;1;0;1
13642;Žuvėdra;JANTARIKI;5398303580;Taip;14;0;0;14
13643;Žuvėdra;JANTARIKI;4907571967;Taip;4;0;0;4
13644;Žuvėdra;"AUKSINĖ ŽUVELĖ";1343293430;Ne;3;7;0;10
13645;Žuvėdra;"AUKSINĖ ŽUVELĖ";6324315523;Ne;15;2;0;17
13646;Žuvėdra;"AUKSINĖ ŽUVELĖ";7121154799;Taip;10;10;0;20
13647;Žuvėdra;"AUKSINĖ ŽUVELĖ";5744370516;Ne;11;0;0;11
13648;Žuvėdra;"AUKSINĖ ŽUVELĖ";5571732399;Taip;0;0;1;1
13649;Žuvėdra;"AUKSINĖ ŽUVELĖ";8472945857;Taip;5;0;0;5
13650;Žuvėdra;"AUKSINĖ ŽUVELĖ";7958768355;Ne;7;0;0;7
13651;Žuvėdra;"AUKSINĖ ŽUVELĖ";8185190219;Ne;4;0;0;4
13652;Žuvėdra;"AUKSINĖ ŽUVELĖ";8700802853;Taip;0;15;0;15
13653;Žuvėdra;"AUKSINĖ ŽUVELĖ";9485995178;Taip;0;13;0;13
13654;Žuvėdra;"AUKSINĖ ŽUVELĖ";5436158437;Taip;6;0;0;6
13655;Žuvėdra;"AUKSINĖ ŽUVELĖ";8599646291;Ne;5;1;0;6
13656;Žuvėdra;"AUKSINĖ ŽUVELĖ";9521104462;Taip;6;2;0;8
13657;Žuvėdra;"AUKSINĖ ŽUVELĖ";2849503557;Taip;11;0;0;11
13658;Žuvėdra;"AUKSINĖ ŽUVELĖ";8162649794;Ne;8;8;0;16
13659;Žuvėdra;"AUKSINĖ ŽUVELĖ";6952843736;Taip;6;2;0;8
13660;Žvangutis;PELIUKŲ;6701947168;Taip;0;2;0;2
13661;Žvangutis;PELIUKŲ;1165172787;Taip;15;0;0;15
13662;Žvangutis;PELIUKŲ;1339151674;Ne;0;1;0;1
13663;Žvangutis;PELIUKŲ;1310113034;Ne;0;5;0;5
13664;Žvangutis;PELIUKŲ;7202747419;Taip;0;1;1;2
13665;Žvangutis;PELIUKŲ;7320625500;Taip;0;10;0;10
13666;Žvangutis;PELIUKŲ;3513746926;Taip;16;0;0;16
13667;Žvangutis;PELIUKŲ;4053450010;Taip;0;1;0;1
13668;Žvangutis;PELIUKŲ;6110958520;Ne;10;0;2;12
13669;Žvangutis;PELIUKŲ;8288997508;Ne;0;1;0;1
13670;Žvangutis;PELIUKŲ;6844824726;Ne;22;0;0;22
13671;Žvangutis;PELIUKŲ;3315858185;Ne;22;0;0;22
13672;Žvangutis;PELIUKŲ;92356998180;Ne;0;1;2;3
13673;Žvangutis;PELIUKŲ;6815104137;Ne;0;0;3;3
13674;Žvangutis;PELIUKŲ;5683601025;Taip;0;10;0;10
13675;Žvangutis;PELIUKŲ;8617941954;Taip;0;9;0;9
13676;Žvangutis;PELIUKŲ;3775960571;Taip;3;9;0;12
13677;Žvangutis;PELIUKŲ;9134683276;Taip;0;4;0;4
13678;Žvangutis;PELIUKŲ;8511103595;Taip;0;1;3;4
13679;Žvangutis;PELIUKŲ;7267340112;Taip;0;8;0;8
13680;Žvangutis;PELIUKŲ;9145365865;Taip;14;0;0;14
13681;Žvangutis;PELIUKŲ;6989839997;Taip;5;2;0;7
13682;Žvangutis;ANČIUKŲ;46159057420;Taip;0;1;3;4
13683;Žvangutis;ANČIUKŲ;1353686877;Taip;0;0;4;4
13684;Žvangutis;ANČIUKŲ;18751626988;Taip;0;9;0;9
13685;Žvangutis;ANČIUKŲ;98607926663;Taip;0;0;5;5
13686;Žvangutis;ANČIUKŲ;12457255518;Taip;0;1;0;1
13687;Žvangutis;ANČIUKŲ;9618217868;Taip;0;1;0;1
13688;Žvangutis;ANČIUKŲ;30697407645;Ne;0;12;0;12
13689;Žvangutis;ANČIUKŲ;86145834840;Taip;0;5;0;5
13690;Žvangutis;ANČIUKŲ;93894162596;Taip;0;1;0;1
13691;Žvangutis;ANČIUKŲ;38451136109;Taip;0;8;0;8
13692;Žvangutis;ANČIUKŲ;39364323060;Taip;0;22;0;22
13693;Žvangutis;ANČIUKŲ;57033172828;Taip;20;1;0;21
13694;Žvangutis;ANČIUKŲ;11053503331;Taip;4;0;3;7
13695;Žvangutis;ANČIUKŲ;41703990445;Ne;0;2;0;2
13696;Žvangutis;ANČIUKŲ;5929099485;Ne;0;4;0;4
13697;Žvangutis;ANČIUKŲ;95130491335;Taip;5;0;0;5
13698;Žvangutis;ANČIUKŲ;77044982999;Taip;0;1;0;1
13699;Žvangutis;ANČIUKŲ;5616640228;Taip;0;1;1;2
13700;Žvangutis;ANČIUKŲ;1898484868;Taip;0;0;8;8
13701;Žvangutis;PELĖDŽIUKŲ;2755838558;Taip;0;10;0;10
13702;Žvangutis;PELĖDŽIUKŲ;1322688456;Ne;3;0;0;3
13703;Žvangutis;PELĖDŽIUKŲ;9036869235;Taip;0;4;0;4
13704;Žvangutis;PELĖDŽIUKŲ;2600596320;Taip;0;2;0;2
13705;Žvangutis;PELĖDŽIUKŲ;2623107843;Taip;0;2;0;2
13706;Žvangutis;PELĖDŽIUKŲ;1185135525;Taip;0;5;0;5
13707;Žvangutis;PELĖDŽIUKŲ;2411307963;Ne;6;0;0;6
13708;Žvangutis;PELĖDŽIUKŲ;9468660351;Taip;0;2;0;2
13709;Žvangutis;PELĖDŽIUKŲ;2922083476;Taip;0;2;0;2
13710;Žvangutis;PELĖDŽIUKŲ;1282567366;Taip;9;0;0;9
13711;Žvangutis;PELĖDŽIUKŲ;6068428687;Taip;0;2;0;2
13712;Žvangutis;PELĖDŽIUKŲ;9149037184;Taip;7;9;0;16
13713;Žvangutis;PELĖDŽIUKŲ;5012996199;Taip;5;0;0;5
13714;Žvangutis;PELĖDŽIUKŲ;8295525284;Taip;6;1;0;7
13715;Žvangutis;PELĖDŽIUKŲ;3276065009;Taip;9;0;0;9
13716;Žvangutis;PELĖDŽIUKŲ;6040986672;Ne;0;14;0;14
13717;Žvangutis;PELĖDŽIUKŲ;2716216474;Taip;0;3;0;3
13718;Žvangutis;KAČIUKŲ;2291142377;Taip;0;1;0;1
13719;Žvangutis;KAČIUKŲ;1882797491;Taip;0;8;0;8
13720;Žvangutis;KAČIUKŲ;65598561926;Taip;3;7;0;10
13721;Žvangutis;KAČIUKŲ;52676408047;Taip;0;5;0;5
13722;Žvangutis;KAČIUKŲ;52544167449;Taip;0;2;0;2
13723;Žvangutis;KAČIUKŲ;8697156717;Taip;0;3;0;3
13724;Žvangutis;KAČIUKŲ;23369081648;Taip;0;8;0;8
13725;Žvangutis;KAČIUKŲ;1065463278;Ne;0;10;0;10
13726;Žvangutis;KAČIUKŲ;1369424754;Taip;0;9;0;9
13727;Žvangutis;KAČIUKŲ;1823402065;Taip;0;1;0;1
13728;Žvangutis;KAČIUKŲ;6343552093;Taip;0;22;0;22
13729;Žvangutis;KAČIUKŲ;2145325174;Taip;0;2;0;2
13730;Žvangutis;KAČIUKŲ;2251482949;Taip;0;3;0;3
13731;Žvangutis;KAČIUKŲ;45857502483;Taip;0;2;0;2
13732;Žvangutis;KAČIUKŲ;4699447138;Taip;0;2;0;2
13733;Žvangutis;KAČIUKŲ;1862121693;Taip;0;2;0;2
13734;Žvangutis;KAČIUKŲ;619059820;Taip;0;3;1;4
13735;Žvangutis;KAČIUKŲ;1541156624;Taip;0;2;0;2
13736;Žvangutis;KAČIUKŲ;1096499939;Ne;0;3;0;3
13737;Žvangutis;KAČIUKŲ;1847928083;Taip;0;4;0;4
13738;Žvangutis;KAČIUKŲ;1665136168;Taip;0;22;0;22
13739;Žvangutis;MEŠKUČIŲ;2296360416;Taip;0;8;0;8
13740;Žvangutis;MEŠKUČIŲ;3957064486;Taip;0;3;0;3
13741;Žvangutis;MEŠKUČIŲ;9958554027;Taip;0;11;0;11
13742;Žvangutis;MEŠKUČIŲ;9239279639;Taip;0;2;0;2
13743;Žvangutis;MEŠKUČIŲ;1142315595;Taip;21;0;0;21
13744;Žvangutis;MEŠKUČIŲ;2351386211;Taip;0;1;0;1
13745;Žvangutis;MEŠKUČIŲ;6041698323;Taip;12;0;0;12
13746;Žvangutis;MEŠKUČIŲ;8492637734;Taip;22;0;0;22
13747;Žvangutis;MEŠKUČIŲ;7581320158;Taip;5;0;0;5
13748;Žvangutis;MEŠKUČIŲ;7721746116;Taip;5;0;1;6
13749;Žvangutis;MEŠKUČIŲ;2598842770;Taip;6;0;0;6
13750;Žvangutis;MEŠKUČIŲ;6723079944;Ne;0;2;1;3
13751;Žvangutis;MEŠKUČIŲ;4696437804;Taip;18;0;0;18
13752;Žvangutis;MEŠKUČIŲ;2042324002;Taip;0;4;0;4
13753;Žvangutis;MEŠKUČIŲ;7213349517;Taip;4;0;0;4
13754;Žvangutis;KIŠKUČIŲ;1687362077;Taip;0;4;0;4
13755;Žvangutis;KIŠKUČIŲ;1886637245;Taip;7;0;0;7
13756;Žvangutis;KIŠKUČIŲ;96443240617;Taip;0;0;1;1
13757;Žvangutis;KIŠKUČIŲ;4249416168;Taip;0;1;4;5
13758;Žvangutis;KIŠKUČIŲ;6661791076;Taip;8;0;4;12
13759;Žvangutis;KIŠKUČIŲ;1615111824;Taip;5;0;0;5
13760;Žvangutis;KIŠKUČIŲ;1481786579;Ne;7;3;0;10
13761;Žvangutis;KIŠKUČIŲ;1334567751;Taip;0;5;0;5
13762;Žvangutis;KIŠKUČIŲ;1693249341;Taip;0;8;0;8
13763;Žvangutis;KIŠKUČIŲ;4798540560;Taip;0;7;0;7
13764;Žvangutis;KIŠKUČIŲ;5563516622;Taip;8;6;0;14
13765;Žvangutis;KIŠKUČIŲ;74528704135;Taip;4;6;0;10
13766;Žvangutis;KIŠKUČIŲ;57385778197;Taip;9;0;0;9
13767;Žvangutis;KIŠKUČIŲ;79808715852;Taip;0;10;0;10
13768;Žvangutis;KIŠKUČIŲ;5643005222;Taip;0;7;0;7
13769;Žvangutis;KIŠKUČIŲ;1702224809;Ne;0;1;2;3
13770;Žvangutis;KIŠKUČIŲ;2111430405;Ne;10;0;0;10
13771;Žvangutis;KIŠKUČIŲ;46410307693;Taip;0;0;2;2
13772;Žvangutis;KIŠKUČIŲ;3049348955;Taip;0;4;0;4
13773;Žirniukas;Boružiukų;5311746004;Taip;0;11;0;11
13774;Žirniukas;Boružiukų;6466220057;Ne;6;2;2;10
13775;Žirniukas;Boružiukų;3107511189;Ne;10;0;7;17
13776;Žirniukas;Boružiukų;2476906136;Taip;1;14;0;15
13777;Žirniukas;Boružiukų;2785102131;Taip;4;0;0;4
13778;Žirniukas;Boružiukų;6624263476;Taip;4;0;0;4
13779;Žirniukas;Boružiukų;8213507698;Taip;0;1;7;8
13780;Žirniukas;Boružiukų;2528905738;Ne;8;3;1;12
13781;Žirniukas;Boružiukų;6268788036;Taip;5;1;1;7
13782;Žirniukas;Boružiukų;6363169823;Taip;5;0;5;10
13783;Žirniukas;Boružiukų;2636634198;Taip;0;6;8;14
13784;Žirniukas;Boružiukų;1867254291;Taip;5;3;3;11
13785;Žirniukas;Boružiukų;5058103759;Taip;12;0;0;12
13786;Žirniukas;Boružiukų;6531175340;Taip;13;0;0;13
13787;Žirniukas;Boružiukų;9647374339;Taip;0;7;0;7
13788;Žirniukas;Boružiukų;6641200341;Taip;0;9;0;9
13789;Žirniukas;Boružiukų;3022672028;Taip;8;2;0;10
13790;Žirniukas;Boružiukų;4229687519;Taip;7;0;0;7
13791;Žirniukas;Boružiukų;4433579937;Taip;4;6;0;10
13792;Žirniukas;Smalsučiai;1701389895;Taip;0;2;0;2
13793;Žirniukas;Smalsučiai;65471257240;Ne;0;8;0;8
13794;Žirniukas;Smalsučiai;99019576563;Taip;0;2;2;4
13795;Žirniukas;Smalsučiai;56948775759;Taip;0;1;0;1
13796;Žirniukas;Smalsučiai;83035751096;Taip;3;1;0;4
13797;Žirniukas;Smalsučiai;29792078209;Taip;0;2;1;3
13798;Žirniukas;Smalsučiai;23221186484;Taip;0;2;0;2
13799;Žirniukas;Smalsučiai;43241022100;Taip;0;0;7;7
13800;Žirniukas;Smalsučiai;54285529186;Taip;3;0;0;3
13801;Žirniukas;Smalsučiai;1382313386;Taip;0;1;0;1
13802;Žirniukas;Smalsučiai;49058747304;Taip;0;0;1;1
13803;Žirniukas;Smalsučiai;6718181545;Taip;9;0;2;11
13804;Žirniukas;Smalsučiai;54685058502;Taip;2;0;0;2
13805;Žirniukas;Smalsučiai;59972903968;Taip;0;2;0;2
13806;Žirniukas;Smalsučiai;4377015113;Taip;0;0;5;5
13807;Žirniukas;Smalsučiai;37416946100;Taip;0;3;0;3
13808;Žirniukas;Smalsučiai;3723155762;Ne;5;1;0;6
13809;Žirniukas;Smalsučiai;3239212369;Taip;0;2;0;2
13810;Žirniukas;Smalsučiai;15527206706;Taip;0;6;0;6
13811;Žirniukas;Smalsučiai;83997736517;Taip;0;1;0;1
13812;Žirniukas;Smalsučiai;7739943293;Taip;0;4;2;6
13813;Žirniukas;Smalsučiai;89146903524;Taip;2;2;4;8
13814;Žirniukas;Smalsučiai;1150580143;Taip;3;0;2;5
13815;Žirniukas;Gėlyčių;74425301830;Ne;9;6;0;15
13816;Žirniukas;Gėlyčių;3763537106;Taip;0;0;4;4
13817;Žirniukas;Gėlyčių;6649555415;Taip;0;0;7;7
13818;Žirniukas;Gėlyčių;32583177093;Taip;6;1;0;7
13819;Žirniukas;Gėlyčių;1804181833;Taip;0;6;0;6
13820;Žirniukas;Gėlyčių;47573534391;Taip;0;5;0;5
13821;Žirniukas;Gėlyčių;1878369945;Taip;7;1;2;10
13822;Žirniukas;Gėlyčių;2072018782;Taip;5;0;0;5
13823;Žirniukas;Gėlyčių;1378845384;Taip;0;8;0;8
13824;Žirniukas;Gėlyčių;6455741324;Taip;3;0;0;3
13825;Žirniukas;Gėlyčių;8190751348;Taip;5;4;0;9
13826;Žirniukas;Gėlyčių;7872611724;Taip;5;4;0;9
13827;Žirniukas;Gėlyčių;4992122911;Taip;0;0;1;1
13828;Žirniukas;Gėlyčių;8180092480;Ne;10;0;1;11
13829;Žirniukas;Gėlyčių;7397202752;Taip;0;0;7;7
13830;Žirniukas;Gėlyčių;3306670221;Taip;10;0;0;10
13831;Žirniukas;Nykštukų;2309995947;Taip;0;0;3;3
13832;Žirniukas;Nykštukų;1944169398;Taip;0;2;0;2
13833;Žirniukas;Nykštukų;1514504241;Taip;0;1;0;1
13834;Žirniukas;Nykštukų;1064894307;Taip;4;2;3;9
13835;Žirniukas;Nykštukų;1162904969;Taip;6;5;0;11
13836;Žirniukas;Nykštukų;2049123663;Taip;3;0;4;7
13837;Žirniukas;Nykštukų;1017483419;Taip;0;2;1;3
13838;Žirniukas;Nykštukų;6957047759;Taip;0;2;1;3
13839;Žirniukas;Nykštukų;2151329751;Ne;2;2;0;4
13840;Žirniukas;Nykštukų;5939918015;Taip;0;2;6;8
13841;Žirniukas;Nykštukų;3010062747;Ne;0;1;0;1
13842;Žirniukas;Nykštukų;2162238771;Taip;0;2;1;3
13843;Žirniukas;Nykštukų;2029018108;Taip;11;2;1;14
13844;Žirniukas;Nykštukų;5987510202;Taip;0;2;0;2
13845;Žirniukas;Nykštukų;5104110821;Taip;0;1;0;1
13846;Žirniukas;Nykštukų;7644911127;Ne;0;0;2;2
13847;Žirniukas;Nykštukų;6180439078;Taip;0;0;3;3
13848;Žirniukas;Nykštukų;3808838764;Ne;0;5;0;5
13849;Žirniukas;Nykštukų;7975957714;Ne;0;1;0;1
13850;Žirniukas;Saulytės;37852143615;Taip;5;1;4;10
13851;Žirniukas;Saulytės;1409567693;Taip;0;5;0;5
13852;Žirniukas;Saulytės;2022475049;Taip;7;0;1;8
13853;Žirniukas;Saulytės;32419042337;Taip;0;1;0;1
13854;Žirniukas;Saulytės;51172128673;Taip;2;3;1;6
13855;Žirniukas;Saulytės;29420916883;Taip;0;14;0;14
13856;Žirniukas;Saulytės;5189034384;Ne;19;0;0;19
13857;Žirniukas;Saulytės;2294854901;Taip;9;0;0;9
13858;Žirniukas;Saulytės;5188013194;Taip;14;0;8;22
13859;Žirniukas;Saulytės;66153778144;Ne;0;0;20;20
13860;Žirniukas;Saulytės;47491327916;Taip;0;2;6;8
13861;Žirniukas;Saulytės;98028824068;Taip;0;0;3;3
13862;Žirniukas;Saulytės;28992463324;Taip;0;0;3;3
13863;Žirniukas;Saulytės;71922426195;Taip;0;0;11;11
13864;Žirniukas;Saulytės;46265018782;Taip;0;9;1;10
13865;Žirniukas;Saulytės;1095501791;Taip;4;0;1;5
13866;Žirniukas;Drugelių;2141162140;Taip;0;8;0;8
13867;Žirniukas;Drugelių;1294183547;Taip;0;9;0;9
13868;Žirniukas;Drugelių;9192660067;Taip;2;10;0;12
13869;Žirniukas;Drugelių;2557138057;Taip;0;1;2;3
13870;Žirniukas;Drugelių;3068684150;Taip;8;0;2;10
13871;Žirniukas;Drugelių;8644938346;Ne;0;11;1;12
13872;Žirniukas;Drugelių;1991599271;Ne;17;0;0;17
13873;Žirniukas;Drugelių;1961708150;Taip;0;2;0;2
13874;Žirniukas;Drugelių;1393738771;Taip;0;0;2;2
13875;Žirniukas;Drugelių;9896415564;Taip;0;1;0;1
13876;Žirniukas;Drugelių;98962928727;Taip;0;10;0;10
13877;Žirniukas;Drugelių;6409900451;Taip;0;0;1;1
13878;Žirniukas;Drugelių;7190628011;Taip;5;9;0;14
13879;Žirniukas;Drugelių;3248779733;Taip;0;0;4;4
13880;Žirniukas;Drugelių;9374080010;Taip;10;0;0;10
13881;Žirniukas;Drugelių;1678041002;Taip;0;1;2;3
13882;Žirniukas;Drugelių;9649896460;Taip;0;1;2;3
13883;Žirniukas;Drugelių;3909152902;Ne;3;3;0;6
13884;Žirniukas;Pelėdžiukai;1163690644;Taip;3;0;0;3
13885;Žirniukas;Pelėdžiukai;1685677297;Taip;0;2;0;2
13886;Žirniukas;Pelėdžiukai;9424009308;Taip;2;2;0;4
13887;Žirniukas;Pelėdžiukai;1542257475;Taip;11;1;2;14
13888;Žirniukas;Pelėdžiukai;98781117814;Taip;3;0;4;7
13889;Žirniukas;Pelėdžiukai;1158530590;Taip;0;0;1;1
13890;Žirniukas;Pelėdžiukai;1352159915;Taip;0;8;1;9
13891;Žirniukas;Pelėdžiukai;1096649614;Ne;3;2;0;5
13892;Žirniukas;Pelėdžiukai;1699821845;Taip;0;0;3;3
13893;Žirniukas;Pelėdžiukai;1506642709;Taip;0;2;0;2
13894;Žirniukas;Pelėdžiukai;1788183728;Taip;4;0;0;4
13895;Žirniukas;Pelėdžiukai;1907669506;Taip;0;5;0;5
13896;Žirniukas;Pelėdžiukai;1607867151;Ne;2;0;0;2
13897;Žirniukas;Pelėdžiukai;1586083174;Taip;0;10;0;10
13898;Žirniukas;Pelėdžiukai;52181077421;Taip;0;7;6;13
13899;Žirniukas;Pelėdžiukai;5479153220;Taip;11;1;0;12
13900;Žirniukas;Pelėdžiukai;3236175335;Taip;4;0;10;14
13901;Žirniukas;ZUIKUČIAI;2733313392;Taip;7;1;0;8
13902;Žirniukas;ZUIKUČIAI;9961947583;Taip;4;1;0;5
13903;Žirniukas;ZUIKUČIAI;6834792589;Taip;0;1;4;5
13904;Žirniukas;ZUIKUČIAI;3610402086;Taip;8;0;0;8
13905;Žirniukas;ZUIKUČIAI;5819443551;Ne;8;0;0;8
13906;Žirniukas;ZUIKUČIAI;4045432303;Taip;5;7;0;12
13907;Žirniukas;ZUIKUČIAI;2325139043;Taip;3;0;0;3
13908;Žirniukas;ZUIKUČIAI;7926160083;Taip;7;0;0;7
13909;Žirniukas;ZUIKUČIAI;9656768968;Taip;9;1;0;10
13910;Žirniukas;ZUIKUČIAI;2982628594;Taip;8;1;0;9
13911;Žirniukas;ZUIKUČIAI;6362626389;Taip;0;0;4;4
13912;Žirniukas;ZUIKUČIAI;4527367786;Taip;3;1;0;4
13913;Žirniukas;ZUIKUČIAI;9425682286;Taip;11;0;0;11
13914;Aušra;Kodėlčiukai;4702400490;Taip;2;0;0;2
13915;Aušra;Kodėlčiukai;2611563172;Ne;10;0;0;10
13916;Aušra;Kodėlčiukai;3420851059;Ne;2;1;0;3
13917;Aušra;Kodėlčiukai;2199083085;Taip;0;1;0;1
13918;Aušra;Kodėlčiukai;6139706771;Taip;0;12;0;12
13919;Aušra;Kodėlčiukai;7314273812;Ne;0;19;0;19
13920;Aušra;Kodėlčiukai;4540040693;Taip;10;0;0;10
13921;Aušra;Kodėlčiukai;1423840991;Taip;22;0;0;22
13922;Aušra;Kodėlčiukai;5013135853;Taip;12;0;0;12
13923;Aušra;Kodėlčiukai;9728140172;Taip;0;2;0;2
13924;Aušra;Kodėlčiukai;7765504789;Taip;0;1;0;1
13925;Aušra;Kodėlčiukai;8108663467;Taip;5;1;0;6
13926;Aušra;Kodėlčiukai;4824773027;Ne;7;1;0;8
13927;Aušra;Kodėlčiukai;1897365632;Taip;0;10;0;10
13928;Aušra;Kodėlčiukai;7469266085;Taip;0;20;0;20
13929;Aušra;Kodėlčiukai;1010721404;Taip;0;9;0;9
13930;Aušra;Kodėlčiukai;1883185016;Taip;0;6;0;6
13931;Aušra;Pelėdžiukai;8686777160;Ne;0;4;0;4
13932;Aušra;Pelėdžiukai;15657824495;Taip;0;12;0;12
13933;Aušra;Pelėdžiukai;35429495907;Taip;0;2;0;2
13934;Aušra;Pelėdžiukai;79051821501;Taip;3;11;0;14
13935;Aušra;Pelėdžiukai;5815377310;Ne;0;1;0;1
13936;Aušra;Pelėdžiukai;23609052737;Taip;6;4;0;10
13937;Aušra;Pelėdžiukai;3823619675;Taip;7;3;0;10
13938;Aušra;Pelėdžiukai;41017803426;Taip;0;0;2;2
13939;Aušra;Pelėdžiukai;58254707316;Ne;0;2;0;2
13940;Aušra;Pelėdžiukai;18943927144;Ne;0;5;0;5
13941;Aušra;Pelėdžiukai;1623803107;Taip;0;2;1;3
13942;Aušra;Pelėdžiukai;2121418946;Ne;11;2;1;14
13943;Aušra;Pelėdžiukai;5409157554;Taip;0;1;0;1
13944;Aušra;Pelėdžiukai;2227238810;Ne;0;5;0;5
13945;Aušra;Pelėdžiukai;2000206874;Ne;0;16;2;18
13946;Aušra;Pelėdžiukai;4325224130;Taip;0;4;0;4
13947;Aušra;Pelėdžiukai;5988529284;Taip;7;11;0;18
13948;Aušra;Smalsučiai;1049364899;Taip;0;2;0;2
13949;Aušra;Smalsučiai;95327350432;Taip;0;1;0;1
13950;Aušra;Smalsučiai;1154675251;Taip;0;2;1;3
13951;Aušra;Smalsučiai;1473962346;Taip;0;2;0;2
13952;Aušra;Smalsučiai;1427235223;Ne;3;0;0;3
13953;Aušra;Smalsučiai;81510885976;Ne;0;1;0;1
13954;Aušra;Smalsučiai;1767520195;Taip;0;2;0;2
13955;Aušra;Smalsučiai;76979979920;Taip;0;2;3;5
13956;Aušra;Smalsučiai;97571593143;Taip;0;4;0;4
13957;Aušra;Smalsučiai;59235411329;Taip;5;0;3;8
13958;Aušra;Smalsučiai;42344686036;Ne;0;3;0;3
13959;Aušra;Smalsučiai;62209740677;Taip;0;6;0;6
13960;Aušra;Smalsučiai;2019580127;Ne;0;17;0;17
13961;Aušra;Smalsučiai;95586246863;Taip;0;4;0;4
13962;Aušra;Smalsučiai;66203768924;Taip;0;1;0;1
13963;Aušra;Smalsučiai;7962184651;Taip;0;1;0;1
13964;Aušra;Smalsučiai;12689030409;Taip;0;15;0;15
13965;Aušra;Smalsučiai;98150444770;Taip;0;2;0;2
13966;Aušra;Smalsučiai;1167565535;Taip;0;11;0;11
13967;Aušra;Smalsučiai;52044254281;Taip;3;0;3;6
13968;Aušra;Smalsučiai;1831747749;Taip;0;5;0;5
13969;Aušra;Smalsučiai;7222605763;Taip;0;5;0;5
13970;Aušra;Smalsučiai;4645855409;Taip;9;1;0;10
13971;Aušra;Smalsučiai;14343589644;Taip;0;1;0;1
13972;Aušra;Pagrandukai;7043021721;Taip;18;0;0;18
13973;Aušra;Pagrandukai;2023718424;Taip;0;0;2;2
13974;Aušra;Pagrandukai;8709340592;Taip;11;0;0;11
13975;Aušra;Pagrandukai;5524681006;Taip;0;0;20;20
13976;Aušra;Pagrandukai;4404047456;Taip;0;0;7;7
13977;Aušra;Pagrandukai;3680329197;Taip;6;0;2;8
13978;Aušra;Pagrandukai;2288159223;Taip;19;0;0;19
13979;Aušra;Pagrandukai;4805298824;Taip;0;0;2;2
13980;Aušra;Pagrandukai;29499576216;Taip;0;1;3;4
13981;Aušra;Pagrandukai;1940882109;Taip;0;2;0;2
13982;Aušra;Pagrandukai;7814902928;Taip;2;5;1;8
13983;Aušra;Pagrandukai;9702136789;Taip;0;0;5;5
13984;Aušra;Pagrandukai;6384243597;Taip;5;0;0;5
13985;Aušra;Pagrandukai;1612662076;Taip;21;0;0;21
13986;Aušra;Pagrandukai;3898178166;Ne;3;0;0;3
13987;Aušra;Pagrandukai;1575761029;Taip;0;5;0;5
13988;Aušra;Pagrandukai;5673568541;Taip;0;0;1;1
13989;Aušra;Pagrandukai;97102749430;Taip;0;0;3;3
13990;Aušra;Pagrandukai;5777939563;Taip;10;0;4;14
13991;Aušra;Pagrandukai;1956830515;Taip;3;0;0;3
13992;Aušra;Pagrandukai;8740755922;Taip;4;0;3;7
13993;Aušra;Pagrandukai;9831054554;Taip;0;0;1;1
13994;Aušra;"1A klasė";8510995681;Taip;4;1;0;5
13995;Aušra;"1A klasė";9605206310;Taip;3;1;0;4
13996;Aušra;"1A klasė";3284383302;Taip;1;1;0;2
13997;Aušra;"1A klasė";13157844661;Taip;3;1;0;4
13998;Aušra;"1A klasė";68160889669;Taip;1;1;0;2
13999;Aušra;"1A klasė";88655846176;Taip;4;1;0;5
14000;Aušra;"1A klasė";73509864636;Ne;1;1;0;2
14001;Aušra;"1A klasė";40499781883;Taip;3;1;0;4
14002;Aušra;"1A klasė";70233681803;Taip;1;1;0;2
14003;Aušra;"1A klasė";40714551025;Taip;12;1;0;13
14004;Aušra;"1A klasė";97781409787;Ne;3;1;0;4
14005;Aušra;"1A klasė";1396233353;Taip;5;1;0;6
14006;Aušra;"1A klasė";1437126272;Ne;1;1;0;2
14007;Aušra;"1A klasė";39537089288;Taip;3;1;0;4
14008;Aušra;"1A klasė";3965445196;Taip;1;1;0;2
14009;Aušra;"1A klasė";85578471272;Taip;20;1;0;21
14010;Aušra;"1A klasė";27958163601;Taip;9;1;0;10
14011;Aušra;"1A klasė";68031503463;Taip;5;1;0;6
14012;Aušra;"1A klasė";81633973264;Taip;1;1;0;2
14013;Aušra;"1A klasė";52985512945;Taip;2;1;0;3
14014;Aušra;"1A klasė";51185323645;Ne;6;1;0;7
14015;Aušra;"1A klasė";1437385365;Taip;3;1;0;4
14016;Aušra;"1A klasė";80929303402;Taip;9;1;0;10
14017;Aušra;"1A klasė";15330844181;Taip;2;1;0;3
14018;Aušra;"1A klasė";92468615840;Taip;1;1;0;2
14019;Aušra;"1A klasė";2062775070;Taip;4;1;0;5
14020;Aušra;"1A klasė";14157070764;Taip;4;1;0;5
14021;Aušra;"2A klasė";94704151051;Taip;2;1;0;3
14022;Aušra;"2A klasė";99886964420;Taip;0;22;0;22
14023;Aušra;"2A klasė";19920237804;Taip;5;1;0;6
14024;Aušra;"2A klasė";13361663464;Taip;3;1;0;4
14025;Aušra;"2A klasė";95948867937;Taip;0;22;0;22
14026;Aušra;"2A klasė";78030425432;Taip;1;1;0;2
14027;Aušra;"2A klasė";34795588283;Ne;0;22;0;22
14028;Aušra;"2A klasė";29636399665;Taip;2;1;0;3
14029;Aušra;"2A klasė";81428848455;Taip;1;1;0;2
14030;Aušra;"2A klasė";47725613978;Taip;0;22;0;22
14031;Aušra;"2A klasė";93365393803;Ne;10;1;0;11
14032;Aušra;"2A klasė";70687041413;Taip;1;1;0;2
14033;Aušra;"2A klasė";52864653926;Taip;0;22;0;22
14034;Aušra;"2A klasė";10272136932;Taip;1;1;0;2
14035;Aušra;"2A klasė";77425098448;Taip;2;1;0;3
14036;Aušra;"2A klasė";20550256232;Ne;3;1;0;4
14037;Aušra;"2A klasė";42015974556;Taip;1;1;0;2
14038;Aušra;"2A klasė";2113586354;Taip;8;1;0;9
14039;Aušra;"2A klasė";19718806057;Taip;2;1;0;3
14040;Aušra;"2A klasė";21856009403;Taip;2;1;0;3
14041;Aušra;"2A klasė";5166358753;Taip;2;1;0;3
14042;Aušra;"2A klasė";44870195034;Taip;0;22;0;22
14043;Aušra;"2A klasė";68481706412;Taip;0;22;0;22
14044;Aušra;"3A klasė";2908360090;Ne;1;1;0;2
14045;Aušra;"3A klasė";1585279799;Ne;1;1;0;2
14046;Aušra;"3A klasė";8497743711;Ne;12;1;0;13
14047;Aušra;"3A klasė";7439801986;Ne;1;1;0;2
14048;Aušra;"3A klasė";4952796453;Ne;3;1;0;4
14049;Aušra;"3A klasė";1404310604;Ne;1;1;0;2
14050;Aušra;"3A klasė";5770340819;Ne;15;1;0;16
14051;Aušra;"3A klasė";9510786725;Ne;1;1;0;2
14052;Aušra;"3A klasė";2280410145;Ne;0;22;0;22
14053;Aušra;"3A klasė";29945175192;Taip;0;22;0;22
14054;Aušra;"3A klasė";8367064629;Ne;21;1;0;22
14055;Aušra;"3A klasė";7931858964;Ne;1;1;0;2
14056;Aušra;"3A klasė";5792862565;Ne;2;1;0;3
14057;Aušra;"3A klasė";6942076490;Ne;4;1;0;5
14058;Aušra;"3A klasė";4399210916;Ne;1;1;0;2
14059;Aušra;"3A klasė";8892613555;Ne;2;1;0;3
14060;Aušra;"3A klasė";6534693192;Ne;2;1;0;3
14061;Aušra;"3A klasė";2797588970;Ne;4;1;0;5
14062;Aušra;"3A klasė";5657162092;Ne;0;22;0;22
14063;Aušra;"3A klasė";3435983733;Ne;3;1;0;4
14064;Aušra;"3A klasė";5825720308;Ne;0;22;0;22
14065;Aušra;"3A klasė";7313001921;Ne;3;1;0;4
14066;Aušra;"3A klasė";2796012982;Ne;1;1;0;2
14067;Aušra;"3A klasė";8632721907;Ne;1;1;0;2
14068;Aušra;"3A klasė";7113793626;Ne;5;1;0;6
14069;Aušra;"3A klasė";75839555732;Taip;3;1;0;4
14070;Aušra;"3A klasė";96979357769;Taip;0;22;0;22
14071;Aušra;"3A klasė";9584232864;Ne;5;1;0;6
14072;Aušra;"4A klasė";4190936993;Ne;0;22;0;22
14073;Aušra;"4A klasė";1685764132;Ne;0;22;0;22
14074;Aušra;"4A klasė";5340257141;Ne;2;1;0;3
14075;Aušra;"4A klasė";8328298376;Ne;0;22;0;22
14076;Aušra;"4A klasė";8543429220;Ne;5;1;0;6
14077;Aušra;"4A klasė";4341245904;Ne;4;1;0;5
14078;Aušra;"4A klasė";7499852390;Ne;0;22;0;22
14079;Aušra;"4A klasė";3749854924;Ne;2;1;0;3
14080;Aušra;"4A klasė";2072790876;Ne;2;0;0;2
14081;Aušra;"4A klasė";2863356239;Ne;1;1;0;2
14082;Aušra;"4A klasė";1448718807;Ne;0;22;0;22
14083;Aušra;"4A klasė";8550981774;Ne;0;22;0;22
14084;Aušra;"4A klasė";2951199272;Ne;1;1;0;2
14085;Aušra;"4A klasė";9332506542;Ne;8;1;0;9
14086;Aušra;"4A klasė";3115696927;Ne;6;1;0;7
14087;Aušra;"4A klasė";62035537641;Taip;0;22;0;22
14088;Aušra;"4A klasė";4073898542;Ne;0;22;0;22
14089;Aušra;"4A klasė";1414034080;Ne;11;1;0;12
14090;Aušra;"4A klasė";7435902333;Ne;2;1;0;3
14091;Aušra;"4A klasė";6232778631;Ne;5;1;0;6
14092;Aušra;"4A klasė";54244461148;Ne;2;1;0;3
14093;Aušra;"4A klasė";6540515450;Ne;0;22;0;22
14094;Aušra;"4A klasė";4257487788;Ne;2;1;0;3
14095;Aušra;"4A klasė";2942755846;Ne;2;1;0;3
14096;Aušra;"2B klasė";92119607174;Taip;3;1;0;4
14097;Aušra;"2B klasė";22923377435;Ne;9;1;0;10
14098;Aušra;"2B klasė";41852924528;Taip;3;1;0;4
14099;Aušra;"2B klasė";58526614808;Taip;3;1;0;4
14100;Aušra;"2B klasė";41039525379;Ne;4;1;0;5
14101;Aušra;"2B klasė";37339481276;Taip;3;1;0;4
14102;Aušra;"2B klasė";45165946624;Taip;3;1;0;4
14103;Aušra;"2B klasė";59107169775;Ne;1;1;0;2
14104;Aušra;"2B klasė";48349819906;Ne;1;1;0;2
14105;Aušra;"2B klasė";71596384638;Taip;2;1;0;3
14106;Aušra;"2B klasė";52332096506;Taip;3;1;0;4
14107;Aušra;"2B klasė";35703433862;Taip;5;1;0;6
14108;Aušra;"2B klasė";6201728036;Taip;0;22;0;22
14109;Aušra;"2B klasė";36889923728;Taip;1;1;0;2
14110;Aušra;"2B klasė";39957179831;Ne;0;22;0;22
14111;Aušra;"2B klasė";52909474598;Ne;1;1;0;2
14112;Aušra;"2B klasė";8901585006;Taip;4;1;0;5
14113;Aušra;"2B klasė";64562667133;Taip;1;1;0;2
14114;Aušra;"2B klasė";95076478544;Ne;1;1;0;2
14115;Aušra;"2B klasė";36899257479;Ne;4;1;0;5
14116;Aušra;"2B klasė";57520886724;Taip;0;22;0;22
14117;Aušra;"2B klasė";1815771421;Ne;1;1;0;2
14118;Aušra;"2B klasė";75433637766;Taip;13;1;0;14
14119;Aušra;"2B klasė";83119050626;Taip;3;1;0;4
14120;Aušra;"3B klasė";5687605664;Ne;0;22;0;22
14121;Aušra;"3B klasė";7713995959;Ne;3;1;0;4
14122;Aušra;"3B klasė";2610054474;Ne;0;22;0;22
14123;Aušra;"3B klasė";95798840861;Taip;0;22;0;22
14124;Aušra;"3B klasė";7553225340;Ne;3;1;0;4
14125;Aušra;"3B klasė";9736905104;Ne;2;1;0;3
14126;Aušra;"3B klasė";70054065156;Taip;4;1;0;5
14127;Aušra;"3B klasė";9695887585;Ne;1;1;0;2
14128;Aušra;"3B klasė";3225989797;Ne;4;1;0;5
14129;Aušra;"3B klasė";7405776766;Ne;0;22;0;22
14130;Aušra;"3B klasė";5005513948;Ne;2;1;0;3
14131;Aušra;"3B klasė";7697924792;Ne;0;22;0;22
14132;Aušra;"3B klasė";2412235474;Ne;3;1;0;4
14133;Aušra;"3B klasė";2075587354;Ne;5;1;0;6
14134;Aušra;"3B klasė";65535488153;Taip;3;1;0;4
14135;Aušra;"3B klasė";9600565378;Ne;0;22;0;22
14136;Aušra;"3B klasė";3114317363;Ne;1;1;0;2
14137;Aušra;"3B klasė";7075053685;Ne;0;22;0;22
14138;Aušra;"3B klasė";98154599269;Taip;1;1;0;2
14139;Aušra;"3B klasė";7321317333;Ne;1;1;0;2
14140;Aušra;"3B klasė";2893668707;Ne;7;1;0;8
14141;Aušra;"3B klasė";7886658451;Ne;0;22;0;22
14142;Berželis;PČIOLKI;1612263252;Taip;0;0;3;3
14143;Berželis;PČIOLKI;56738219250;Taip;0;3;0;3
14144;Berželis;PČIOLKI;88322206113;Taip;0;0;4;4
14145;Berželis;PČIOLKI;75750848557;Ne;0;0;4;4
14146;Berželis;PČIOLKI;77431203813;Taip;5;0;0;5
14147;Berželis;PČIOLKI;69799827219;Taip;0;0;2;2
14148;Berželis;PČIOLKI;19460486970;Taip;0;0;1;1
14149;Berželis;PČIOLKI;79818178445;Taip;0;0;1;1
14150;Berželis;PČIOLKI;59374659821;Taip;0;0;1;1
14151;Berželis;PČIOLKI;56482980062;Ne;5;0;4;9
14152;Berželis;PČIOLKI;1740077377;Taip;0;8;0;8
14153;Berželis;PČIOLKI;91676607875;Taip;0;0;1;1
14154;Berželis;PČIOLKI;1729593575;Ne;0;0;12;12
14155;Berželis;PČIOLKI;33843845240;Taip;0;0;1;1
14156;Berželis;PČIOLKI;4605587503;Taip;0;0;3;3
14157;Berželis;PČIOLKI;5747645162;Ne;14;0;0;14
14158;Berželis;PČIOLKI;3923999931;Ne;8;0;0;8
14159;Berželis;PČIOLKI;68853290649;Ne;5;5;0;10
14160;Berželis;PČIOLKI;1929783185;Taip;0;5;0;5
14161;Berželis;PČIOLKI;50400542457;Taip;4;0;1;5
14162;Berželis;PČIOLKI;68192824475;Taip;0;0;3;3
14163;Berželis;"BOŽJI KOROVKI";9132058594;Taip;5;4;0;9
14164;Berželis;"BOŽJI KOROVKI";7421059780;Taip;5;0;0;5
14165;Berželis;"BOŽJI KOROVKI";4100740863;Taip;4;14;0;18
14166;Berželis;"BOŽJI KOROVKI";5953387226;Taip;0;18;0;18
14167;Berželis;"BOŽJI KOROVKI";9466461910;Taip;12;2;0;14
14168;Berželis;"BOŽJI KOROVKI";5692603837;Taip;5;0;0;5
14169;Berželis;"BOŽJI KOROVKI";5194480946;Taip;0;0;5;5
14170;Berželis;"BOŽJI KOROVKI";9848723402;Taip;5;0;3;8
14171;Berželis;"BOŽJI KOROVKI";5551459997;Taip;1;0;0;1
14172;Berželis;"BOŽJI KOROVKI";6651007152;Ne;8;0;0;8
14173;Berželis;"BOŽJI KOROVKI";8451877584;Taip;4;0;0;4
14174;Berželis;SOLNYŠKO;8871199713;Taip;18;2;0;20
14175;Berželis;SOLNYŠKO;2182268389;Taip;16;0;1;17
14176;Berželis;SOLNYŠKO;1498165322;Taip;4;1;0;5
14177;Berželis;SOLNYŠKO;4163605313;Taip;13;1;0;14
14178;Berželis;SOLNYŠKO;2882693941;Taip;4;0;0;4
14179;Berželis;SOLNYŠKO;9438498834;Taip;10;2;0;12
14180;Berželis;SOLNYŠKO;7852089381;Ne;9;0;0;9
14181;Berželis;SOLNYŠKO;6189116357;Taip;0;0;11;11
14182;Berželis;SOLNYŠKO;8737788279;Taip;0;0;1;1
14183;Berželis;SOLNYŠKO;8875116641;Taip;10;0;2;12
14184;Berželis;SOLNYŠKO;8771171576;Taip;9;1;0;10
14185;Berželis;SOLNYŠKO;2901168499;Taip;9;0;2;11
14186;Berželis;SOLNYŠKO;8297975308;Taip;0;1;0;1
14187;Berželis;SOLNYŠKO;2693961315;Taip;15;0;0;15
14188;Berželis;SOLNYŠKO;7411282628;Taip;16;0;0;16
14189;Berželis;SOLNYŠKO;7080168105;Ne;14;0;0;14
14190;Berželis;SOLNYŠKO;1316018865;Taip;9;0;4;13
14191;Berželis;BABOČKI;4923631429;Ne;18;0;0;18
14192;Berželis;BABOČKI;5371508044;Taip;6;0;1;7
14193;Berželis;BABOČKI;1076719080;Taip;13;0;0;13
14194;Berželis;BABOČKI;2030770943;Taip;0;11;1;12
14195;Berželis;BABOČKI;9839929976;Taip;0;14;1;15
14196;Berželis;BABOČKI;2667957070;Taip;0;0;2;2
14197;Berželis;BABOČKI;7781031211;Taip;1;2;0;3
14198;Berželis;BABOČKI;2493612905;Taip;0;0;1;1
14199;Berželis;BABOČKI;5688897783;Taip;0;9;2;11
14200;Berželis;BABOČKI;6942559693;Taip;3;0;1;4
14201;Berželis;BABOČKI;6352635742;Ne;6;3;0;9
14202;Berželis;BABOČKI;3097809074;Taip;0;8;0;8
14203;Berželis;BABOČKI;3613459846;Taip;9;0;0;9
14204;Berželis;BABOČKI;8448872491;Taip;10;0;0;10
14205;Berželis;BABOČKI;5069322062;Taip;4;0;1;5
14206;Berželis;BABOČKI;2954451168;Taip;5;0;0;5
14207;Berželis;BABOČKI;4312062240;Taip;0;2;0;2
14208;Berželis;BABOČKI;9585609150;Taip;22;0;0;22
14209;Berželis;SOVUŠKI;8939353460;Taip;0;6;0;6
14210;Berželis;SOVUŠKI;5879965735;Taip;18;0;2;20
14211;Berželis;SOVUŠKI;1183377037;Ne;0;0;1;1
14212;Berželis;SOVUŠKI;61614684164;Taip;0;0;1;1
14213;Berželis;SOVUŠKI;1573177287;Taip;0;13;0;13
14214;Berželis;SOVUŠKI;48932211843;Ne;0;0;10;10
14215;Berželis;SOVUŠKI;11671380984;Taip;0;11;0;11
14216;Berželis;SOVUŠKI;1927042277;Taip;11;3;0;14
14217;Berželis;SOVUŠKI;1865658456;Taip;16;0;0;16
14218;Berželis;SOVUŠKI;1061894314;Taip;0;0;7;7
14219;Berželis;SOVUŠKI;5739686368;Taip;0;0;1;1
14220;Berželis;SOVUŠKI;25985469678;Taip;7;0;0;7
14221;Berželis;SOVUŠKI;2028316867;Ne;0;12;0;12
14222;Berželis;SOVUŠKI;83253240251;Taip;8;0;0;8
14223;Berželis;SOVUŠKI;9134420285;Ne;0;7;0;7
14224;Berželis;SOVUŠKI;5337604370;Taip;0;0;5;5
14225;Berželis;SOVUŠKI;1492203156;Taip;0;0;15;15
14226;Berželis;SOVUŠKI;1511044883;Taip;4;0;0;4
14227;Berželis;SOVUŠKI;7713921014;Taip;9;0;7;16
14228;Berželis;PODSOLNUŠKI;4521372127;Taip;0;2;0;2
14229;Berželis;PODSOLNUŠKI;2214171136;Taip;11;0;0;11
14230;Berželis;PODSOLNUŠKI;97218091736;Taip;14;0;4;18
14231;Berželis;PODSOLNUŠKI;1521982237;Taip;12;0;1;13
14232;Berželis;PODSOLNUŠKI;4013215941;Taip;0;5;0;5
14233;Berželis;PODSOLNUŠKI;7526006253;Taip;4;0;0;4
14234;Berželis;PODSOLNUŠKI;9024992452;Taip;14;0;0;14
14235;Berželis;PODSOLNUŠKI;9644196870;Ne;0;0;1;1
14236;Berželis;PODSOLNUŠKI;5084171353;Taip;12;0;0;12
14237;Berželis;PODSOLNUŠKI;1225018351;Taip;3;6;0;9
14238;Berželis;PODSOLNUŠKI;6473498471;Taip;13;2;0;15
14239;Berželis;PODSOLNUŠKI;1067618571;Taip;10;0;0;10
14240;Berželis;PODSOLNUŠKI;3772780161;Taip;17;0;0;17
14241;Berželis;PODSOLNUŠKI;4563582416;Taip;13;1;0;14
14242;Berželis;PODSOLNUŠKI;7227603702;Taip;9;0;0;9
14243;Berželis;PODSOLNUŠKI;6113571093;Ne;19;0;0;19
14244;Berželis;PODSOLNUŠKI;1036370516;Taip;10;4;0;14
14245;Berželis;PODSOLNUŠKI;4284157599;Taip;10;1;0;11
14246;Berželis;PODSOLNUŠKI;2615440913;Taip;9;0;0;9
14247;Berželis;PODSOLNUŠKI;9894751274;Taip;7;0;2;9
14248;Berželis;PODSOLNUŠKI;3298044639;Taip;3;0;0;3
14249;Berželis;PODSOLNUŠKI;3437712794;Taip;4;8;0;12
14250;Berželis;"1 klasė";7375940325;Taip;6;1;0;7
14251;Berželis;"1 klasė";39511689145;Taip;0;22;0;22
14252;Berželis;"1 klasė";62426432001;Taip;2;1;0;3
14253;Berželis;"1 klasė";29561378525;Taip;0;22;0;22
14254;Berželis;"1 klasė";51807139150;Taip;13;1;0;14
14255;Berželis;"1 klasė";95780247776;Taip;2;1;0;3
14256;Berželis;"1 klasė";84379482983;Taip;1;1;0;2
14257;Berželis;"1 klasė";17710158252;Taip;1;1;0;2
14258;Berželis;"1 klasė";86666390300;Taip;2;1;0;3
14259;Berželis;"1 klasė";37637382978;Taip;1;1;0;2
14260;Berželis;"1 klasė";44215014337;Taip;2;1;0;3
14261;Berželis;"1 klasė";2066819593;Taip;1;1;0;2
14262;Berželis;"1 klasė";36959641642;Taip;1;1;0;2
14263;Berželis;"2 klasė";64472469959;Taip;0;1;0;1
14264;Berželis;"2 klasė";3554738276;Taip;9;1;0;10
14265;Berželis;"2 klasė";68739754511;Taip;2;1;0;3
14266;Berželis;"2 klasė";9168601277;Taip;5;1;0;6
14267;Berželis;"2 klasė";93543942806;Taip;0;1;0;1
14268;Berželis;"2 klasė";5442568208;Taip;6;1;0;7
14269;Berželis;"2 klasė";84043380820;Taip;0;1;0;1
14270;Berželis;"2 klasė";945754955;Taip;0;1;0;1
14271;Berželis;"2 klasė";12564193771;Taip;0;1;0;1
14272;Berželis;"2 klasė";2412399682;Taip;0;1;0;1
14273;Berželis;"2 klasė";40956353978;Taip;0;1;0;1
14274;Berželis;"2 klasė";34721593327;Taip;5;1;0;6
14275;Berželis;"2 klasė";2511800624;Ne;0;1;0;1
14276;Berželis;"3 klasė";66532479024;Ne;8;1;0;9
14277;Berželis;"3 klasė";4381565277;Ne;4;1;0;5
14278;Berželis;"3 klasė";47358747103;Taip;3;1;0;4
14279;Berželis;"3 klasė";4263364972;Taip;2;1;0;3
14280;Berželis;"3 klasė";4750570367;Ne;0;22;0;22
14281;Berželis;"3 klasė";67358830655;Taip;2;1;0;3
14282;Berželis;"3 klasė";12252622276;Taip;6;1;0;7
14283;Berželis;"3 klasė";68547063004;Taip;3;1;0;4
14284;Berželis;"3 klasė";12819628369;Taip;3;1;0;4
14285;Berželis;"3 klasė";13521812215;Taip;0;22;0;22
14286;Berželis;"3 klasė";32336500026;Taip;13;1;0;14
14287;Berželis;"3 klasė";17898339325;Taip;15;1;0;16
14288;Berželis;"3 klasė";9395016208;Taip;2;1;0;3
14289;Berželis;"3 klasė";55709962549;Taip;1;1;0;2
14290;Berželis;"3 klasė";62300805754;Taip;1;1;0;2
14291;Berželis;"3 klasė";1162529591;Taip;8;1;0;9
14292;Berželis;"4 klasė";2691853015;Ne;1;1;0;2
14293;Berželis;"4 klasė";5856177876;Ne;5;1;0;6
14294;Berželis;"4 klasė";8143634742;Ne;1;1;0;2
14295;Berželis;"4 klasė";5616257764;Taip;1;1;0;2
14296;Berželis;"4 klasė";9486991928;Ne;2;1;0;3
14297;Berželis;"4 klasė";62987603892;Taip;1;1;0;2
14298;Berželis;"4 klasė";9998560354;Ne;12;1;0;13
14299;Berželis;"4 klasė";6702857359;Ne;3;1;0;4
14300;Berželis;"4 klasė";2955045450;Ne;1;1;0;2
14301;Berželis;"4 klasė";3149377224;Ne;2;1;0;3
14302;Berželis;"4 klasė";50930845005;Taip;6;1;0;7
14303;Berželis;"4 klasė";1161378829;Ne;1;1;0;2
14304;Berželis;"4 klasė";8322372921;Ne;11;1;0;12
14305;Berželis;"4 klasė";2501433917;Ne;0;22;0;22
14306;Berželis;"4 klasė";7728620622;Ne;1;1;0;2
14307;Berželis;"4 klasė";8921842915;Ne;2;1;0;3
14308;Berželis;"4 klasė";3064700283;Ne;1;1;0;2
14309;Saulutė;Drugeliai;66108847230;Taip;11;6;0;17
14310;Saulutė;Drugeliai;1556270046;Taip;0;1;0;1
14311;Saulutė;Drugeliai;3064199909;Taip;0;2;0;2
14312;Saulutė;Drugeliai;2097055107;Taip;0;6;0;6
14313;Saulutė;Drugeliai;1717909005;Taip;0;3;0;3
14314;Saulutė;Drugeliai;1283800571;Taip;0;10;0;10
14315;Saulutė;Drugeliai;8599199376;Taip;20;0;0;20
14316;Saulutė;Drugeliai;1750571258;Taip;0;7;0;7
14317;Saulutė;Drugeliai;87814849917;Taip;0;3;0;3
14318;Saulutė;Drugeliai;1609952589;Taip;0;2;0;2
14319;Saulutė;Drugeliai;1386800520;Taip;0;7;0;7
14320;Saulutė;Drugeliai;1261384337;Taip;4;1;0;5
14321;Saulutė;Drugeliai;1320018338;Ne;8;1;0;9
14322;Saulutė;Drugeliai;1291318940;Taip;0;3;0;3
14323;Saulutė;Drugeliai;1391904744;Taip;0;5;0;5
14324;Saulutė;Drugeliai;8944601874;Taip;0;17;0;17
14325;Saulutė;Drugeliai;4272320685;Taip;0;11;0;11
14326;Saulutė;Drugeliai;2622662153;Ne;0;3;0;3
14327;Saulutė;Drugeliai;1020606591;Taip;0;4;0;4
14328;Saulutė;Drugeliai;7539721995;Taip;0;6;0;6
14329;Saulutė;"Saulės zuikučiai";8946107286;Taip;0;3;0;3
14330;Saulutė;"Saulės zuikučiai";2397257894;Taip;0;3;0;3
14331;Saulutė;"Saulės zuikučiai";2010774109;Taip;8;7;0;15
14332;Saulutė;"Saulės zuikučiai";3089541630;Ne;0;1;0;1
14333;Saulutė;"Saulės zuikučiai";5148542811;Taip;0;22;0;22
14334;Saulutė;"Saulės zuikučiai";1562393383;Taip;7;0;0;7
14335;Saulutė;"Saulės zuikučiai";2259917151;Taip;0;14;0;14
14336;Saulutė;"Saulės zuikučiai";3749374270;Taip;0;1;0;1
14337;Saulutė;"Saulės zuikučiai";9146298505;Taip;0;1;0;1
14338;Saulutė;"Saulės zuikučiai";8242602551;Ne;2;8;0;10
14339;Saulutė;"Saulės zuikučiai";1324799653;Taip;0;11;0;11
14340;Saulutė;"Saulės zuikučiai";5247769309;Taip;0;18;0;18
14341;Saulutė;"Saulės zuikučiai";2816806902;Taip;0;4;0;4
14342;Saulutė;"Saulės zuikučiai";7844396402;Taip;0;2;0;2
14343;Saulutė;"Saulės zuikučiai";2781003892;Taip;8;0;0;8
14344;Saulutė;"Saulės zuikučiai";9892855816;Taip;5;2;0;7
14345;Saulutė;"Saulės zuikučiai";5326279083;Taip;5;0;0;5
14346;Saulutė;"Saulės zuikučiai";3675783868;Taip;0;6;0;6
14347;Saulutė;"Saulės zuikučiai";7351477901;Taip;0;6;0;6
14348;Saulutė;"Saulės zuikučiai";5839981073;Ne;0;13;0;13
14349;Saulutė;"Saulės zuikučiai";7888435573;Taip;0;6;0;6
14350;Saulutė;Boružėlės;3272296969;Taip;4;4;0;8
14351;Saulutė;Boružėlės;3295289082;Taip;0;1;0;1
14352;Saulutė;Boružėlės;1587328722;Taip;7;1;0;8
14353;Saulutė;Boružėlės;8390767549;Taip;11;0;0;11
14354;Saulutė;Boružėlės;7576532632;Ne;12;5;0;17
14355;Saulutė;Boružėlės;2725491887;Taip;0;22;0;22
14356;Saulutė;Boružėlės;9314889468;Taip;18;1;0;19
14357;Saulutė;Boružėlės;7764493159;Ne;8;0;0;8
14358;Saulutė;Boružėlės;5565832676;Ne;8;0;0;8
14359;Saulutė;Boružėlės;9173336078;Ne;6;1;0;7
14360;Saulutė;Boružėlės;3408369823;Taip;0;3;0;3
14361;Saulutė;Boružėlės;5329894543;Taip;11;2;0;13
14362;Saulutė;Boružėlės;8643975544;Taip;6;0;0;6
14363;Saulutė;Boružėlės;1265174091;Taip;7;0;0;7
14364;Saulutė;Boružėlės;4818911910;Ne;8;1;0;9
14365;Saulutė;Boružėlės;7081700501;Taip;22;0;0;22
14366;Saulutė;Boružėlės;9098663596;Taip;4;1;0;5
14367;Saulutė;Boružėlės;1803710557;Taip;10;0;0;10
14368;Saulutė;Boružėlės;7425789805;Taip;4;5;0;9
14369;Saulutė;Boružėlės;7474989619;Ne;5;1;0;6
14370;Saulutė;Boružėlės;8619163154;Ne;0;13;0;13
14371;Saulutė;Boružėlės;7574225926;Taip;7;0;0;7
14372;Saulutė;Nykštukai;6099238784;Taip;0;0;2;2
14373;Saulutė;Nykštukai;7318452189;Taip;0;12;0;12
14374;Saulutė;Nykštukai;78558743548;Ne;0;5;0;5
14375;Saulutė;Nykštukai;4771504414;Taip;0;4;0;4
14376;Saulutė;Nykštukai;55160240384;Taip;0;1;0;1
14377;Saulutė;Nykštukai;1745560688;Taip;0;0;2;2
14378;Saulutė;Nykštukai;63481737955;Taip;0;0;1;1
14379;Saulutė;Nykštukai;12674831673;Taip;4;0;0;4
14380;Saulutė;Nykštukai;32539394191;Ne;0;0;1;1
14381;Saulutė;Nykštukai;1913500127;Ne;0;5;0;5
14382;Saulutė;Nykštukai;54373231773;Taip;0;5;0;5
14383;Saulutė;Nykštukai;88168936754;Taip;14;0;0;14
14384;Saulutė;Nykštukai;98979263108;Ne;0;7;0;7
14385;Saulutė;Nykštukai;1217446865;Taip;9;0;0;9
14386;Saulutė;Nykštukai;8399364592;Taip;0;4;0;4
14387;Saulutė;Nykštukai;1077526046;Ne;0;0;2;2
14388;Saulutė;Meškiukai;1776164273;Taip;8;0;3;11
14389;Saulutė;Meškiukai;5264813819;Taip;8;0;0;8
14390;Saulutė;Meškiukai;5850783789;Taip;10;0;1;11
14391;Saulutė;Meškiukai;7243072252;Taip;0;0;4;4
14392;Saulutė;Meškiukai;5607937410;Taip;3;5;0;8
14393;Saulutė;Meškiukai;3571751974;Taip;0;0;4;4
14394;Saulutė;Meškiukai;2527027536;Taip;0;2;0;2
14395;Saulutė;Meškiukai;7620841597;Taip;22;0;0;22
14396;Saulutė;Meškiukai;7640441297;Taip;0;0;3;3
14397;Saulutė;Meškiukai;6046611248;Taip;0;3;0;3
14398;Saulutė;Meškiukai;4301516165;Taip;9;0;0;9
14399;Saulutė;Meškiukai;3221612665;Taip;6;5;4;15
14400;Saulutė;Meškiukai;9903380188;Taip;1;0;1;2
14401;Saulutė;Meškiukai;6608003946;Taip;0;17;0;17
14402;Saulutė;Ežiukai;1686338325;Taip;0;0;3;3
14403;Saulutė;Ežiukai;1888990522;Taip;5;0;8;13
14404;Saulutė;Ežiukai;2140277182;Taip;6;0;2;8
14405;Saulutė;Ežiukai;1546200973;Ne;0;0;1;1
14406;Saulutė;Ežiukai;1917058710;Ne;0;10;0;10
14407;Saulutė;Ežiukai;2813274509;Taip;8;0;7;15
14408;Saulutė;Ežiukai;4510990261;Taip;4;0;1;5
14409;Saulutė;Ežiukai;3410606033;Taip;10;0;0;10
14410;Saulutė;Ežiukai;7413098580;Taip;4;0;1;5
14411;Saulutė;Ežiukai;9269501176;Taip;0;0;2;2
14412;Saulutė;Ežiukai;2059342403;Ne;11;0;1;12
14413;Saulutė;Ežiukai;8257363228;Taip;0;0;1;1
14414;Saulutė;Ežiukai;7297886198;Taip;0;0;2;2
14415;Saulutė;Ežiukai;6982979199;Taip;0;0;2;2
14416;Saulutė;Ežiukai;4800144085;Taip;0;0;2;2
14417;Saulutė;Bitutės;1268204445;Ne;0;0;22;22
14418;Saulutė;Bitutės;7652740249;Ne;0;0;7;7
14419;Saulutė;Bitutės;2373409300;Taip;0;0;22;22
14420;Saulutė;Bitutės;2545930114;Taip;0;0;2;2
14421;Saulutė;Bitutės;1056158093;Taip;6;0;1;7
14422;Saulutė;Bitutės;8512137633;Taip;10;0;0;10
14423;Saulutė;Bitutės;4123500930;Ne;4;0;0;4
14424;Saulutė;Bitutės;9497439410;Taip;0;17;0;17
14425;Saulutė;Bitutės;8405262902;Taip;0;0;3;3
14426;Saulutė;Bitutės;4363210987;Ne;8;0;1;9
14427;Saulutė;Bitutės;6842585310;Taip;0;0;19;19
14428;Saulutė;Bitutės;2601822200;Taip;0;0;6;6
14429;Saulutė;Bitutės;4211866191;Taip;14;0;0;14
14430;Saulutė;Bitutės;8371366346;Taip;0;0;3;3
14431;Saulutė;Bitutės;7139492238;Taip;8;0;0;8
14432;Saulutė;Bitutės;1323161584;Taip;0;0;9;9
14433;Saulutė;Bitutės;9664809396;Taip;6;0;0;6
14434;Saulutė;Bitutės;3244850673;Taip;0;0;1;1
14435;Saulutė;Pelėdžiukai;3445723020;Ne;0;8;0;8
14436;Saulutė;Pelėdžiukai;27386434894;Ne;4;1;0;5
14437;Saulutė;Pelėdžiukai;65492344097;Ne;0;1;0;1
14438;Saulutė;Pelėdžiukai;1935503629;Taip;0;1;0;1
14439;Saulutė;Pelėdžiukai;31705050946;Taip;0;4;0;4
14440;Saulutė;Pelėdžiukai;45306237230;Taip;8;3;0;11
14441;Saulutė;Pelėdžiukai;14195215027;Taip;5;2;0;7
14442;Saulutė;Pelėdžiukai;1510434265;Taip;0;3;0;3
14443;Saulutė;Pelėdžiukai;5574049005;Taip;12;3;0;15
14444;Saulutė;Pelėdžiukai;4312318284;Taip;0;8;0;8
14445;Saulutė;Pelėdžiukai;27752316336;Taip;1;1;0;2
14446;Saulutė;Pelėdžiukai;77170708225;Taip;13;0;0;13
14447;Saulutė;Pelėdžiukai;9612975694;Taip;0;7;0;7
14448;Saulutė;Pelėdžiukai;4287223197;Taip;0;11;0;11
14449;Saulutė;Pelėdžiukai;5511093996;Taip;0;12;0;12
14450;Saulutė;Zylutės;1277263391;Taip;0;4;0;4
14451;Saulutė;Zylutės;46280382280;Ne;0;2;0;2
14452;Saulutė;Zylutės;75405796772;Ne;0;3;0;3
14453;Saulutė;Zylutės;35570367633;Taip;0;3;0;3
14454;Saulutė;Zylutės;1786491396;Taip;0;4;0;4
14455;Saulutė;Zylutės;10893091651;Taip;0;0;2;2
14456;Saulutė;Zylutės;16622528829;Taip;14;0;0;14
14457;Saulutė;Zylutės;1911318708;Taip;0;6;0;6
14458;Saulutė;Zylutės;9565528566;Taip;0;14;0;14
14459;Saulutė;Zylutės;1332002470;Ne;0;2;0;2
14460;Saulutė;Zylutės;9081236999;Ne;3;1;0;4
14461;Saulutė;Zylutės;67332285574;Ne;0;8;0;8
14462;Saulutė;Zylutės;1513449225;Taip;0;2;0;2
14463;Saulutė;Zylutės;28772515317;Ne;0;11;0;11
14464;Saulutė;Zylutės;97145959022;Taip;22;0;0;22
14465;Saulutė;Zylutės;8372468555;Taip;12;2;0;14
14466;Saulutė;Zylutės;5928628498;Taip;5;9;0;14
14467;Saulutė;Zylutės;8040751073;Taip;8;7;0;15
14468;Saulutė;Zylutės;2074473832;Taip;9;0;0;9
14469;Saulutė;"1 klasė";3183309722;Ne;4;5;0;9
14470;Saulutė;"1 klasė";1475031090;Taip;2;5;0;7
14471;Saulutė;"1 klasė";3246485288;Taip;0;5;0;5
14472;Saulutė;"1 klasė";78967475616;Ne;7;5;0;12
14473;Saulutė;"1 klasė";3450668814;Taip;0;5;0;5
14474;Saulutė;"1 klasė";57283533169;Taip;0;5;0;5
14475;Saulutė;"1 klasė";21703177024;Ne;0;5;0;5
14476;Saulutė;"1 klasė";13147367113;Taip;0;5;0;5
14477;Saulutė;"1 klasė";6557918941;Taip;5;5;0;10
14478;Saulutė;"1 klasė";1005459768;Taip;0;5;0;5
14479;Saulutė;"1 klasė";1804521229;Taip;1;5;0;6
14480;Saulutė;"1 klasė";44452051978;Ne;1;5;0;6
14481;Saulutė;"1 klasė";89710141573;Taip;0;5;0;5
14482;Saulutė;"1 klasė";25124975646;Taip;0;5;0;5
14483;Saulutė;"1 klasė";8168961080;Ne;1;5;0;6
14484;Saulutė;"1 klasė";76744652185;Taip;0;5;0;5
14485;Saulutė;"1 klasė";97296161595;Taip;1;5;0;6
14486;Saulutė;"1 klasė";87409240076;Taip;0;5;0;5
14487;Saulutė;"1 klasė";1205642335;Taip;5;5;0;10
14488;Saulutė;"1 klasė";36414547943;Taip;0;5;0;5
14489;Saulutė;"1 klasė";1337654926;Taip;1;5;0;6
14490;Saulutė;"1 klasė";54950572289;Taip;0;5;0;5
14491;Saulutė;"1 klasė";1644704074;Taip;0;5;0;5
14492;Saulutė;"1 klasė";2426509692;Ne;0;5;0;5
14493;Saulutė;"1 klasė";96497471950;Taip;8;5;0;13
14494;Saulutė;"1 klasė";76108591835;Taip;1;5;0;6
14495;Saulutė;"1 klasė";5741276602;Taip;0;5;0;5
14496;Saulutė;"1 klasė";99841176399;Taip;0;5;0;5
14497;Saulutė;"1 klasė";2216383015;Taip;0;5;0;5
14498;Saulutė;"1 klasė";3156830821;Taip;6;5;0;11
14499;Saulutė;"2 klasė";58163470119;Ne;12;5;0;17
14500;Saulutė;"2 klasė";5822529731;Taip;6;5;0;11
14501;Saulutė;"2 klasė";67739063665;Taip;4;5;0;9
14502;Saulutė;"2 klasė";13916981850;Ne;8;5;0;13
14503;Saulutė;"2 klasė";39606108938;Ne;1;5;0;6
14504;Saulutė;"2 klasė";81191097069;Ne;0;5;0;5
14505;Saulutė;"2 klasė";92198716772;Taip;8;5;0;13
14506;Saulutė;"2 klasė";16523279366;Taip;0;5;0;5
14507;Saulutė;"2 klasė";2095347468;Taip;1;5;0;6
14508;Saulutė;"2 klasė";37839378248;Ne;0;5;0;5
14509;Saulutė;"2 klasė";5997216605;Taip;22;4;0;26
14510;Saulutė;"2 klasė";8308288099;Ne;7;5;0;12
14511;Saulutė;"2 klasė";30863736694;Taip;1;5;0;6
14512;Saulutė;"2 klasė";12964000357;Taip;3;5;0;8
14513;Saulutė;"2 klasė";54726632101;Taip;0;5;0;5
14514;Saulutė;"2 klasė";25720655179;Ne;12;5;0;17
14515;Saulutė;"2 klasė";6469772450;Taip;22;4;0;26
14516;Saulutė;"2 klasė";4302511346;Ne;22;4;0;26
14517;Saulutė;"2 klasė";8632066475;Ne;22;4;0;26
14518;Saulutė;"2 klasė";45877127245;Taip;5;5;0;10
14519;Saulutė;"2 klasė";82106514982;Taip;0;5;0;5
14520;Saulutė;"2 klasė";61113930769;Taip;0;5;0;5
14521;Saulutė;"2 klasė";8962761979;Taip;22;4;0;26
14522;Saulutė;"2 klasė";7785909571;Ne;7;5;0;12
14523;Saulutė;"2 klasė";90078805222;Taip;9;5;0;14
14524;Saulutė;"2 klasė";50110262859;Ne;1;5;0;6
14525;Saulutė;"2 klasė";42204884890;Ne;4;5;0;9
14526;Saulutė;"3 klasė";8531372660;Taip;0;5;0;5
14527;Saulutė;"3 klasė";3614749034;Taip;7;5;0;12
14528;Saulutė;"3 klasė";1153099638;Taip;2;5;0;7
14529;Saulutė;"3 klasė";5786453424;Taip;2;5;0;7
14530;Saulutė;"3 klasė";4342595483;Taip;1;5;0;6
14531;Saulutė;"3 klasė";1081812391;Taip;0;5;0;5
14532;Saulutė;"3 klasė";1436690766;Taip;0;5;0;5
14533;Saulutė;"3 klasė";4252242862;Taip;5;5;0;10
14534;Saulutė;"3 klasė";2517511237;Ne;1;5;0;6
14535;Saulutė;"3 klasė";8953313952;Ne;0;5;0;5
14536;Saulutė;"3 klasė";2957436888;Taip;1;5;0;6
14537;Saulutė;"3 klasė";7696948081;Taip;4;5;0;9
14538;Saulutė;"3 klasė";8192525690;Taip;0;5;0;5
14539;Saulutė;"3 klasė";3937034221;Ne;6;5;0;11
14540;Saulutė;"3 klasė";1312993030;Taip;1;5;0;6
14541;Saulutė;"3 klasė";3450860412;Ne;2;5;0;7
14542;Saulutė;"3 klasė";7543978588;Taip;1;5;0;6
14543;Saulutė;"3 klasė";6924270821;Ne;3;5;0;8
14544;Saulutė;"3 klasė";1701868565;Taip;9;5;0;14
14545;Saulutė;"3 klasė";3755300838;Taip;1;5;0;6
14546;Saulutė;"3 klasė";1117229507;Taip;0;5;0;5
14547;Saulutė;"3 klasė";6025668467;Ne;0;5;0;5
14548;Saulutė;"4 klasė";9113434597;Ne;0;5;0;5
14549;Saulutė;"4 klasė";9833653313;Ne;0;5;0;5
14550;Saulutė;"4 klasė";1659579883;Ne;0;5;0;5
14551;Saulutė;"4 klasė";39035147720;Ne;1;5;0;6
14552;Saulutė;"4 klasė";9155511473;Ne;0;5;0;5
14553;Saulutė;"4 klasė";6957680310;Ne;2;5;0;7
14554;Saulutė;"4 klasė";7700196440;Ne;1;5;0;6
14555;Saulutė;"4 klasė";8601544457;Taip;0;5;0;5
14556;Saulutė;"4 klasė";8506064421;Ne;0;5;0;5
14557;Saulutė;"4 klasė";3302267009;Ne;2;5;0;7
14558;Saulutė;"4 klasė";7343265118;Ne;22;4;0;26
14559;Saulutė;"4 klasė";5193599921;Ne;1;5;0;6
14560;Saulutė;"4 klasė";2638495931;Ne;22;4;0;26
14561;Saulutė;"4 klasė";4189732482;Ne;22;4;0;26
14562;Saulutė;"4 klasė";2374587130;Ne;0;5;0;5
14563;Saulutė;"4 klasė";6797161399;Ne;4;5;0;9
14564;Saulutė;"4 klasė";6128992723;Ne;3;5;0;8
14565;Saulutė;"4 klasė";9621988308;Ne;22;4;0;26
14566;Saulutė;"4 klasė";1787634725;Ne;7;5;0;12
14567;Saulutė;"4 klasė";1604607524;Ne;22;4;0;26
14568;Saulutė;"4 klasė";9885756874;Ne;2;5;0;7
14569;Saulutė;"4 klasė";3495588866;Taip;6;5;0;11
14570;Saulutė;"4 klasė";5232445259;Taip;6;5;0;11
14571;Svaja;"STEBUKLINGAS ŽIBINTAS";9628146488;Taip;0;0;2;2
14572;Svaja;"STEBUKLINGAS ŽIBINTAS";69028070656;Taip;0;0;4;4
14573;Svaja;"STEBUKLINGAS ŽIBINTAS";1017471747;Taip;0;0;2;2
14574;Svaja;"STEBUKLINGAS ŽIBINTAS";30360097999;Taip;0;11;0;11
14575;Svaja;"STEBUKLINGAS ŽIBINTAS";1967394949;Taip;6;1;1;8
14576;Svaja;"STEBUKLINGAS ŽIBINTAS";7719185632;Taip;0;3;1;4
14577;Svaja;"STEBUKLINGAS ŽIBINTAS";30027404222;Ne;0;0;3;3
14578;Svaja;"STEBUKLINGAS ŽIBINTAS";1943166503;Ne;6;0;1;7
14579;Svaja;"STEBUKLINGAS ŽIBINTAS";43223177664;Taip;0;0;6;6
14580;Svaja;"STEBUKLINGAS ŽIBINTAS";97298858365;Taip;0;0;2;2
14581;Svaja;"STEBUKLINGAS ŽIBINTAS";1562041360;Taip;22;0;0;22
14582;Svaja;"AUKSINĖ ŽUVELĖ";43307670660;Taip;3;5;0;8
14583;Svaja;"AUKSINĖ ŽUVELĖ";25194696146;Taip;10;0;0;10
14584;Svaja;"AUKSINĖ ŽUVELĖ";55925058866;Taip;0;0;1;1
14585;Svaja;"AUKSINĖ ŽUVELĖ";1704075006;Ne;0;8;0;8
14586;Svaja;"AUKSINĖ ŽUVELĖ";70641067006;Taip;5;0;0;5
14587;Svaja;"AUKSINĖ ŽUVELĖ";8875237023;Taip;2;0;3;5
14588;Svaja;"AUKSINĖ ŽUVELĖ";1437557657;Taip;10;0;1;11
14589;Svaja;"AUKSINĖ ŽUVELĖ";87432529423;Taip;0;0;2;2
14590;Svaja;"AUKSINĖ ŽUVELĖ";36505115395;Taip;0;0;2;2
14591;Svaja;"AUKSINĖ ŽUVELĖ";58102699652;Ne;0;1;0;1
14592;Svaja;"AUKSINĖ ŽUVELĖ";6593047776;Taip;0;0;3;3
14593;Svaja;"AUKSINĖ ŽUVELĖ";5335776957;Ne;0;0;2;2
14594;Svaja;"AUKSINĖ ŽUVELĖ";7911488445;Ne;9;3;0;12
14595;Svaja;"AUKSINĖ ŽUVELĖ";1295012978;Ne;7;0;1;8
14596;Svaja;"AUKSINĖ ŽUVELĖ";64196174690;Taip;14;0;0;14
14597;Svaja;"AUKSINĖ ŽUVELĖ";22702341083;Ne;14;0;5;19
14598;Svaja;"AUKSINĖ ŽUVELĖ";2076060840;Taip;0;0;1;1
14599;Svaja;"AUKSINĖ ŽUVELĖ";27445299450;Taip;0;0;1;1
14600;Svaja;"AUKSINĖ ŽUVELĖ";1576498450;Taip;6;0;2;8
14601;Svaja;"1 B klasė";6905550313;Taip;0;2;0;2
14602;Svaja;"1 B klasė";1367687415;Taip;0;2;0;2
14603;Svaja;"1 B klasė";1847775266;Taip;0;9;0;9
14604;Svaja;"1 B klasė";44418402260;Taip;0;2;0;2
14605;Svaja;"1 B klasė";54328462992;Taip;0;2;0;2
14606;Svaja;"1 B klasė";92044111261;Ne;0;3;0;3
14607;Svaja;"1 B klasė";6020060540;Taip;0;7;0;7
14608;Svaja;"1 B klasė";71708072632;Taip;0;5;0;5
14609;Svaja;"1 B klasė";56506642672;Taip;0;4;0;4
14610;Svaja;"1 B klasė";34141773112;Ne;0;3;0;3
14611;Svaja;"1 B klasė";4416877973;Taip;0;4;0;4
14612;Svaja;"1 B klasė";73391331150;Ne;0;4;0;4
14613;Svaja;"1 B klasė";70507326327;Taip;0;2;0;2
14614;Svaja;"1 B klasė";1470843400;Taip;0;2;0;2
14615;Svaja;"1 B klasė";8011137572;Taip;0;2;0;2
14616;Svaja;"1 B klasė";70506691027;Taip;0;2;0;2
14617;Svaja;"1 B klasė";62971657427;Ne;0;2;0;2
14618;Svaja;"1 B klasė";17947580061;Taip;0;4;0;4
14619;Svaja;"1 B klasė";50649509868;Taip;0;2;0;2
14620;Svaja;"1 B klasė";80772711351;Taip;0;3;0;3
14621;Svaja;"1 B klasė";11937575740;Taip;0;3;0;3
14622;Svaja;"1 B klasė";3526873547;Ne;0;7;0;7
14623;Svaja;"1 B klasė";6969692916;Ne;0;6;0;6
14624;Svaja;"1 A klasė";34216516886;Taip;0;2;0;2
14625;Svaja;"1 A klasė";3474439050;Ne;0;7;0;7
14626;Svaja;"1 A klasė";8828911320;Ne;0;3;0;3
14627;Svaja;"1 A klasė";75104768118;Ne;0;4;0;4
14628;Svaja;"1 A klasė";4617061890;Ne;0;4;0;4
14629;Svaja;"1 A klasė";3604946305;Taip;0;7;0;7
14630;Svaja;"1 A klasė";1649920341;Taip;0;2;0;2
14631;Svaja;"1 A klasė";64487515384;Taip;0;2;0;2
14632;Svaja;"1 A klasė";63346231562;Taip;0;10;0;10
14633;Svaja;"1 A klasė";6057524892;Taip;0;3;0;3
14634;Svaja;"1 A klasė";1181877436;Taip;0;6;0;6
14635;Svaja;"1 A klasė";25578518444;Taip;0;2;0;2
14636;Svaja;"1 A klasė";7348182434;Taip;0;7;0;7
14637;Svaja;"1 A klasė";89695643588;Taip;0;4;0;4
14638;Svaja;"1 A klasė";15252353189;Taip;0;2;0;2
14639;Svaja;"1 A klasė";72752022712;Taip;0;5;0;5
14640;Svaja;"1 A klasė";36386223863;Taip;0;8;0;8
14641;Svaja;"1 A klasė";30754812113;Taip;0;2;0;2
14642;Svaja;"1 A klasė";75296600945;Ne;0;7;0;7
14643;Svaja;"1 A klasė";2321739150;Ne;0;2;0;2
14644;Svaja;"1 A klasė";1168637823;Taip;0;13;0;13
14645;Svaja;"1 A klasė";4906784415;Taip;0;4;0;4
14646;Svaja;"1 A klasė";6810463192;Taip;0;3;0;3
14647;Svaja;"1 C klasė";25934507261;Taip;0;1;0;1
14648;Svaja;"1 C klasė";89047123808;Taip;0;1;0;1
14649;Svaja;"1 C klasė";50510924690;Taip;0;1;0;1
14650;Svaja;"1 C klasė";41183537732;Taip;0;9;0;9
14651;Svaja;"1 C klasė";57216299421;Ne;0;22;0;22
14652;Svaja;"1 C klasė";1795682827;Taip;0;1;0;1
14653;Svaja;"1 C klasė";93651139102;Taip;0;1;0;1
14654;Svaja;"1 C klasė";54462393937;Taip;0;1;0;1
14655;Svaja;"1 C klasė";74904581010;Taip;0;6;0;6
14656;Svaja;"1 C klasė";2165716699;Taip;0;3;0;3
14657;Svaja;"1 C klasė";36001411632;Taip;0;10;0;10
14658;Svaja;"1 C klasė";94449039022;Taip;0;5;0;5
14659;Svaja;"1 C klasė";85150525696;Ne;0;8;0;8
14660;Svaja;"1 C klasė";1848422504;Taip;0;2;0;2
14661;Svaja;"1 C klasė";3743948734;Taip;0;2;0;2
14662;Svaja;"1 C klasė";70714898590;Taip;0;4;0;4
14663;Svaja;"1 C klasė";54852358913;Taip;0;3;0;3
14664;Svaja;"1 C klasė";57253216255;Taip;0;4;0;4
14665;Svaja;"1 C klasė";34995551069;Taip;0;3;0;3
14666;Svaja;"1 C klasė";1742951527;Taip;0;2;0;2
14667;Svaja;"1 C klasė";91855230473;Taip;0;3;0;3
14668;Svaja;"1 C klasė";1855559693;Taip;0;3;0;3
14669;Svaja;"1 C klasė";31216445971;Ne;0;2;0;2
14670;Svaja;"1 C klasė";20342193231;Taip;0;1;0;1
14671;Svaja;"1 C klasė";91088224294;Taip;0;22;0;22
14672;Svaja;"2 A klasė";8876971658;Taip;0;22;0;22
14673;Svaja;"2 A klasė";96680395594;Taip;0;8;0;8
14674;Svaja;"2 A klasė";31604152893;Ne;0;2;0;2
14675;Svaja;"2 A klasė";70513111186;Ne;0;2;0;2
14676;Svaja;"2 A klasė";72655912805;Taip;0;2;0;2
14677;Svaja;"2 A klasė";20363553383;Taip;0;2;0;2
14678;Svaja;"2 A klasė";69928474471;Taip;0;22;0;22
14679;Svaja;"2 A klasė";49184638535;Taip;0;22;0;22
14680;Svaja;"2 A klasė";58497063533;Taip;0;4;0;4
14681;Svaja;"2 A klasė";89075087937;Ne;0;22;0;22
14682;Svaja;"2 A klasė";99157757025;Ne;0;2;0;2
14683;Svaja;"2 A klasė";16955510836;Taip;0;9;0;9
14684;Svaja;"2 A klasė";24812635291;Taip;0;6;0;6
14685;Svaja;"2 A klasė";21534170175;Ne;0;3;0;3
14686;Svaja;"2 A klasė";28311552445;Taip;0;2;0;2
14687;Svaja;"2 A klasė";38781141060;Taip;0;2;0;2
14688;Svaja;"2 A klasė";88447528808;Taip;0;4;0;4
14689;Svaja;"2 A klasė";66507774550;Taip;0;2;0;2
14690;Svaja;"2 A klasė";48859926231;Taip;0;2;0;2
14691;Svaja;"2 A klasė";76101749947;Taip;0;22;0;22
14692;Svaja;"2 A klasė";3775578708;Ne;0;7;0;7
14693;Svaja;"2 B klasė";61996055386;Taip;0;2;0;2
14694;Svaja;"2 B klasė";57983452414;Taip;0;22;0;22
14695;Svaja;"2 B klasė";30200636424;Ne;0;4;0;4
14696;Svaja;"2 B klasė";8802243719;Taip;0;3;0;3
14697;Svaja;"2 B klasė";7747921362;Ne;0;3;0;3
14698;Svaja;"2 B klasė";38464012322;Taip;0;2;0;2
14699;Svaja;"2 B klasė";5712106350;Ne;0;9;0;9
14700;Svaja;"2 B klasė";9401605132;Taip;0;22;0;22
14701;Svaja;"2 B klasė";27313057222;Taip;0;22;0;22
14702;Svaja;"2 B klasė";68894832324;Taip;0;4;0;4
14703;Svaja;"2 B klasė";29972474690;Taip;0;2;0;2
14704;Svaja;"2 B klasė";47441661801;Ne;0;2;0;2
14705;Svaja;"2 B klasė";62579722313;Ne;0;6;0;6
14706;Svaja;"2 B klasė";21035820496;Ne;0;2;0;2
14707;Svaja;"2 B klasė";71840791098;Taip;0;3;0;3
14708;Svaja;"2 B klasė";59707838958;Taip;0;2;0;2
14709;Svaja;"2 B klasė";71086654007;Taip;0;2;0;2
14710;Svaja;"2 B klasė";15871540340;Taip;0;4;0;4
14711;Svaja;"2 B klasė";97651620085;Taip;0;2;0;2
14712;Svaja;"2 B klasė";77796846388;Taip;0;2;0;2
14713;Svaja;"3 A klasė";6331528628;Taip;0;2;0;2
14714;Svaja;"3 A klasė";3545160978;Ne;0;8;0;8
14715;Svaja;"3 A klasė";3812365439;Taip;0;3;0;3
14716;Svaja;"3 A klasė";4732976577;Taip;0;4;0;4
14717;Svaja;"3 A klasė";4819506647;Taip;0;2;0;2
14718;Svaja;"3 A klasė";7374204735;Taip;0;4;0;4
14719;Svaja;"3 A klasė";4147975771;Taip;0;3;0;3
14720;Svaja;"3 A klasė";5355661673;Taip;0;22;0;22
14721;Svaja;"3 A klasė";8907191675;Taip;0;4;0;4
14722;Svaja;"3 A klasė";6301200166;Ne;0;2;0;2
14723;Svaja;"3 A klasė";7406969545;Ne;0;2;0;2
14724;Svaja;"3 A klasė";6182584108;Taip;0;9;0;9
14725;Svaja;"3 A klasė";6561055995;Taip;0;2;0;2
14726;Svaja;"3 A klasė";7745440861;Taip;0;3;0;3
14727;Svaja;"3 A klasė";3100769948;Ne;0;4;0;4
14728;Svaja;"3 A klasė";1932041952;Taip;0;2;0;2
14729;Svaja;"3 A klasė";2963665708;Taip;0;2;0;2
14730;Svaja;"3 A klasė";6166818062;Taip;0;2;0;2
14731;Svaja;"3 A klasė";4677183471;Taip;0;2;0;2
14732;Svaja;"3 A klasė";3876795349;Taip;0;3;0;3
14733;Svaja;"3 A klasė";4570702330;Taip;0;3;0;3
14734;Svaja;"3 A klasė";4559408388;Ne;0;2;0;2
14735;Svaja;"3 A klasė";1851430613;Taip;0;10;0;10
14736;Svaja;"3 B klasė";6685023540;Ne;0;2;0;2
14737;Svaja;"3 B klasė";3917545035;Taip;0;22;0;22
14738;Svaja;"3 B klasė";3154268090;Ne;0;2;0;2
14739;Svaja;"3 B klasė";7137011094;Taip;0;7;0;7
14740;Svaja;"3 B klasė";8497722175;Taip;0;2;0;2
14741;Svaja;"3 B klasė";1949789571;Taip;0;2;0;2
14742;Svaja;"3 B klasė";986820082;Taip;0;3;0;3
14743;Svaja;"3 B klasė";5316972581;Taip;0;22;0;22
14744;Svaja;"3 B klasė";5304302886;Taip;0;3;0;3
14745;Svaja;"3 B klasė";9390649669;Ne;0;22;0;22
14746;Svaja;"3 B klasė";2543801351;Taip;0;2;0;2
14747;Svaja;"3 B klasė";2768998567;Ne;0;4;0;4
14748;Svaja;"3 B klasė";5417233257;Taip;0;8;0;8
14749;Svaja;"3 B klasė";8934053695;Ne;0;13;0;13
14750;Svaja;"3 B klasė";6888324693;Taip;0;2;0;2
14751;Svaja;"3 B klasė";9741563523;Taip;0;22;0;22
14752;Svaja;"3 B klasė";9474581791;Taip;0;3;0;3
14753;Svaja;"3 B klasė";7185891478;Ne;0;22;0;22
14754;Svaja;"3 B klasė";6949932613;Taip;0;3;0;3
14755;Svaja;"3 B klasė";9227257148;Taip;0;8;0;8
14756;Svaja;"3 B klasė";7403841330;Taip;0;6;0;6
14757;Svaja;"3 B klasė";6387070757;Taip;0;22;0;22
14758;Svaja;"3 B klasė";4859522896;Taip;0;5;0;5
14759;Svaja;"3 B klasė";7165840275;Taip;0;2;0;2
14760;Svaja;"3 B klasė";4858401763;Taip;0;4;0;4
14761;Svaja;SAULĖGRĄŽA;1579441289;Taip;0;0;1;1
14762;Svaja;SAULĖGRĄŽA;9811110367;Taip;0;0;1;1
14763;Svaja;SAULĖGRĄŽA;7023534254;Taip;0;0;3;3
14764;Svaja;SAULĖGRĄŽA;3792660330;Taip;22;0;0;22
14765;Svaja;SAULĖGRĄŽA;9240037050;Taip;22;0;0;22
14766;Svaja;SAULĖGRĄŽA;7575922215;Taip;4;2;0;6
14767;Svaja;SAULĖGRĄŽA;4510147045;Taip;11;2;0;13
14768;Svaja;SAULĖGRĄŽA;9680766688;Taip;10;0;1;11
14769;Svaja;SAULĖGRĄŽA;3912426942;Taip;0;0;2;2
14770;Svaja;SAULĖGRĄŽA;3809817617;Taip;2;0;3;5
14771;Svaja;SAULĖGRĄŽA;3501620040;Taip;7;2;0;9
14772;Svaja;SAULĖGRĄŽA;4333001830;Taip;7;5;0;12
14773;Svaja;SAULĖGRĄŽA;6928763381;Taip;20;0;0;20
14774;Svaja;SAULĖGRĄŽA;7408966637;Taip;8;0;0;8
14775;Svaja;SAULĖGRĄŽA;2209697834;Taip;13;5;0;18
14776;Svaja;SAULĖGRĄŽA;7089640807;Taip;10;0;0;10
14777;Svaja;SAULĖGRĄŽA;4253831334;Taip;22;0;0;22
14778;Svaja;SAULĖGRĄŽA;9311520300;Taip;0;0;1;1
14779;Svaja;SAULĖGRĄŽA;6963684639;Taip;0;1;0;1
14780;Svaja;"4 A klasė";6890796785;Taip;0;4;0;4
14781;Svaja;"4 A klasė";3060720122;Taip;0;4;0;4
14782;Svaja;"4 A klasė";4191652201;Taip;0;22;0;22
14783;Svaja;"4 A klasė";2408787820;Ne;0;4;0;4
14784;Svaja;"4 A klasė";2143707618;Taip;0;2;0;2
14785;Svaja;"4 A klasė";9922327181;Taip;0;2;0;2
14786;Svaja;"4 A klasė";7360643147;Taip;0;2;0;2
14787;Svaja;"4 A klasė";9431617139;Taip;0;22;0;22
14788;Svaja;"4 A klasė";5072924063;Taip;0;7;0;7
14789;Svaja;"4 A klasė";1224863574;Ne;0;4;0;4
14790;Svaja;"4 A klasė";5866029763;Ne;0;22;0;22
14791;Svaja;"4 A klasė";5224191012;Taip;0;2;0;2
14792;Svaja;"4 A klasė";2396489897;Taip;0;2;0;2
14793;Svaja;"4 A klasė";3362976996;Taip;0;2;0;2
14794;Svaja;"4 A klasė";6379522088;Taip;0;6;0;6
14795;Svaja;"4 A klasė";6859893256;Taip;0;22;0;22
14796;Svaja;"4 A klasė";7222472406;Taip;0;3;0;3
14797;Svaja;"4 A klasė";8566329547;Ne;0;22;0;22
14798;Svaja;"4 A klasė";8014577929;Taip;0;4;0;4
14799;Svaja;"4 A klasė";5916292577;Taip;0;22;0;22
14800;Svaja;"4 B klasė";5552969529;Taip;0;18;0;18
14801;Svaja;"4 B klasė";4730576902;Taip;0;5;0;5
14802;Svaja;"4 B klasė";1717017574;Taip;0;22;0;22
14803;Svaja;"4 B klasė";6738703814;Taip;0;6;0;6
14804;Svaja;"4 B klasė";9134285226;Taip;0;7;0;7
14805;Svaja;"4 B klasė";5936330139;Taip;0;4;0;4
14806;Svaja;"4 B klasė";2601042375;Taip;0;3;0;3
14807;Svaja;"4 B klasė";5872552939;Taip;0;22;0;22
14808;Svaja;"4 B klasė";9268837216;Taip;0;22;0;22
14809;Svaja;"4 B klasė";3914701993;Taip;0;3;0;3
14810;Svaja;"4 B klasė";6125002433;Taip;0;22;0;22
14811;Svaja;"4 B klasė";7318107259;Taip;0;22;0;22
14812;Svaja;"4 B klasė";3710090923;Taip;0;7;0;7
14813;Svaja;"4 B klasė";4798681160;Taip;0;22;0;22
14814;Svaja;"4 B klasė";8694436642;Taip;0;2;0;2
14815;Svaja;"4 B klasė";9634453365;Taip;0;22;0;22
14816;Svaja;"4 B klasė";5247586745;Taip;0;22;0;22
14817;Svaja;"4 B klasė";3794316760;Taip;0;3;0;3
14818;Svaja;"4 B klasė";2827984254;Taip;0;6;0;6
14819;Svaja;"4 B klasė";2414969796;Taip;0;2;0;2
14820;Svaja;"4 B klasė";6780795284;Taip;0;6;0;6
14821;Svaja;"4 B klasė";7211076381;Taip;0;3;0;3
14822;Svaja;"4 B klasė";7731424463;Taip;0;22;0;22
14823;Svaja;"4 B klasė";6933648513;Taip;0;7;0;7
14824;Svaja;"2 C klasė";77712240909;Taip;0;2;0;2
14825;Svaja;"2 C klasė";79260508923;Taip;0;3;0;3
14826;Svaja;"2 C klasė";94437606762;Taip;0;22;0;22
14827;Svaja;"2 C klasė";73440582394;Taip;0;4;0;4
14828;Svaja;"2 C klasė";60982723867;Ne;0;22;0;22
14829;Svaja;"2 C klasė";70157518595;Taip;0;4;0;4
14830;Svaja;"2 C klasė";50116820543;Taip;0;2;0;2
14831;Svaja;"2 C klasė";5975083034;Ne;0;22;0;22
14832;Svaja;"2 C klasė";5288858941;Ne;0;2;0;2
14833;Svaja;"2 C klasė";76871144487;Taip;0;22;0;22
14834;Svaja;"2 C klasė";6613028133;Taip;0;6;0;6
14835;Svaja;"2 C klasė";48888360976;Taip;0;2;0;2
14836;Svaja;"2 C klasė";12226488343;Taip;0;8;0;8
14837;Svaja;"2 C klasė";3909240894;Taip;0;2;0;2
14838;Svaja;"2 C klasė";53352329988;Taip;0;4;0;4
14839;Svaja;"2 C klasė";59917024948;Taip;0;22;0;22
14840;Svaja;"2 C klasė";73691352138;Taip;0;2;0;2
14841;Svaja;"2 C klasė";66967032561;Taip;0;8;0;8
14842;Svaja;"2 C klasė";82358174131;Ne;0;2;0;2
14843;Svaja;"2 C klasė";2018073862;Taip;0;11;0;11
14844;Svaja;"2 C klasė";25585032766;Taip;0;22;0;22
14845;Svaja;"2 C klasė";79572045341;Ne;0;22;0;22
14846;Svaja;"3 C klasė";4022762780;Taip;0;22;0;22
14847;Svaja;"3 C klasė";4196053724;Taip;0;3;0;3
14848;Svaja;"3 C klasė";6750156163;Taip;0;4;0;4
14849;Svaja;"3 C klasė";5749575112;Taip;0;22;0;22
14850;Svaja;"3 C klasė";8150945946;Taip;0;22;0;22
14851;Svaja;"3 C klasė";1915009909;Taip;0;3;0;3
14852;Svaja;"3 C klasė";4310597965;Taip;0;9;0;9
14853;Svaja;"3 C klasė";8274918664;Taip;0;4;0;4
14854;Svaja;"3 C klasė";4333896021;Taip;0;3;0;3
14855;Svaja;"3 C klasė";5467666579;Taip;0;3;0;3
14856;Svaja;"3 C klasė";5453168902;Ne;0;7;0;7
14857;Svaja;"3 C klasė";1750972673;Taip;0;7;0;7
14858;Svaja;"3 C klasė";5633989310;Taip;0;3;0;3
14859;Svaja;"3 C klasė";4807854408;Taip;0;22;0;22
14860;Svaja;"3 C klasė";9653780566;Taip;0;3;0;3
14861;Svaja;"3 C klasė";8556383911;Ne;0;5;0;5
14862;Svaja;"3 C klasė";5736016717;Taip;0;22;0;22
14863;Svaja;"3 C klasė";6956015602;Ne;0;22;0;22
14864;Svaja;"3 C klasė";6155277279;Ne;0;22;0;22
14865;Svaja;"3 C klasė";3466700144;Ne;0;3;0;3
14866;Svaja;"3 C klasė";9961965117;Taip;0;22;0;22
14867;Svaja;"3 C klasė";4809644609;Taip;0;3;0;3
14868;Svaja;"3 C klasė";1910435736;Taip;0;9;0;9
14869;Svaja;"3 C klasė";5205253544;Taip;0;10;0;10
14870;Svaja;"3 C klasė";6958729265;Ne;0;5;0;5
14871;Šilelis;PAUKŠTELIAI;1048576329;Taip;0;0;4;4
14872;Šilelis;PAUKŠTELIAI;15636728118;Taip;1;0;8;9
14873;Šilelis;PAUKŠTELIAI;2478018487;Taip;0;0;2;2
14874;Šilelis;PAUKŠTELIAI;43394471973;Ne;0;12;0;12
14875;Šilelis;PAUKŠTELIAI;78892676375;Ne;0;3;1;4
14876;Šilelis;PAUKŠTELIAI;2033871385;Taip;0;5;0;5
14877;Šilelis;PAUKŠTELIAI;5025537628;Taip;0;7;1;8
14878;Šilelis;PAUKŠTELIAI;1150836049;Taip;0;0;2;2
14879;Šilelis;PAUKŠTELIAI;33018110830;Taip;0;0;3;3
14880;Šilelis;PAUKŠTELIAI;8337759186;Taip;0;0;5;5
14881;Šilelis;PAUKŠTELIAI;79806281817;Taip;0;0;5;5
14882;Šilelis;PAUKŠTELIAI;89770278636;Taip;3;0;2;5
14883;Šilelis;PAUKŠTELIAI;1483339314;Taip;0;4;0;4
14884;Šilelis;SKRUZDELIUKAI;7502057552;Taip;8;0;0;8
14885;Šilelis;SKRUZDELIUKAI;6510813364;Taip;13;0;0;13
14886;Šilelis;SKRUZDELIUKAI;6099940488;Taip;10;0;1;11
14887;Šilelis;SKRUZDELIUKAI;6139976105;Taip;0;7;0;7
14888;Šilelis;SKRUZDELIUKAI;3823958567;Taip;13;3;0;16
14889;Šilelis;SKRUZDELIUKAI;2289616655;Taip;10;4;0;14
14890;Šilelis;SKRUZDELIUKAI;1887013803;Taip;0;3;0;3
14891;Šilelis;SKRUZDELIUKAI;6359318134;Taip;11;0;1;12
14892;Šilelis;SKRUZDELIUKAI;5598152793;Taip;6;4;0;10
14893;Šilelis;SKRUZDELIUKAI;8090773379;Taip;13;4;0;17
14894;Šilelis;SKRUZDELIUKAI;4196893379;Taip;0;2;0;2
14895;Šilelis;SKRUZDELIUKAI;3373275644;Taip;0;2;0;2
14896;Šilelis;SKRUZDELIUKAI;8578620603;Taip;0;0;1;1
14897;Šilelis;SKRUZDELIUKAI;9589138527;Taip;15;5;0;20
14898;Šilelis;SMERFY;1246899777;Taip;0;2;2;4
14899;Šilelis;SMERFY;93686653078;Taip;0;1;0;1
14900;Šilelis;SMERFY;8980788109;Taip;0;5;0;5
14901;Šilelis;SMERFY;7936978436;Taip;0;6;0;6
14902;Šilelis;SMERFY;8100789958;Taip;0;2;0;2
14903;Šilelis;SMERFY;6572969153;Taip;0;7;0;7
14904;Šilelis;SMERFY;3015424614;Taip;7;3;5;15
14905;Šilelis;SMERFY;3247333567;Taip;0;8;0;8
14906;Šilelis;SMERFY;6999088222;Ne;8;0;0;8
14907;Šilelis;SMERFY;74190923349;Taip;0;3;0;3
14908;Šilelis;SMERFY;5665331529;Taip;0;4;0;4
14909;Šilelis;SMERFY;3089270468;Taip;0;7;0;7
14910;Šilelis;SMERFY;7824279279;Ne;0;6;0;6
14911;Šilelis;SMERFY;5496605727;Taip;0;2;0;2
14912;Šilelis;SMERFY;4504627601;Taip;14;0;0;14
14913;Šilelis;SMERFY;7534468539;Taip;0;1;2;3
14914;Šilelis;EŽIUKAI;6336168033;Taip;0;8;0;8
14915;Šilelis;EŽIUKAI;9266061396;Ne;13;0;0;13
14916;Šilelis;EŽIUKAI;4494932923;Taip;0;9;0;9
14917;Šilelis;EŽIUKAI;7074963804;Taip;0;7;1;8
14918;Šilelis;EŽIUKAI;1165219272;Taip;10;1;0;11
14919;Šilelis;EŽIUKAI;3234612149;Taip;22;0;0;22
14920;Šilelis;EŽIUKAI;4702068672;Taip;8;1;0;9
14921;Šilelis;EŽIUKAI;1724976098;Taip;8;9;0;17
14922;Šilelis;EŽIUKAI;5020209473;Taip;0;4;4;8
14923;Šilelis;EŽIUKAI;2397366916;Taip;8;3;0;11
14924;Šilelis;EŽIUKAI;2151250706;Taip;10;0;0;10
14925;Šilelis;EŽIUKAI;2295849333;Taip;8;0;0;8
14926;Šilelis;EŽIUKAI;5131051261;Taip;8;0;0;8
14927;Šilelis;EŽIUKAI;8339335908;Ne;6;0;1;7
14928;Šilelis;EŽIUKAI;4678970810;Taip;9;0;0;9
14929;Šilelis;EŽIUKAI;1883483049;Taip;0;0;2;2
14930;Šilelis;EŽIUKAI;6386996498;Taip;11;0;0;11
14931;Šilelis;EŽIUKAI;5210301367;Taip;6;3;0;9
14932;Šilelis;EŽIUKAI;9354491312;Taip;17;0;0;17
14933;Šilelis;EŽIUKAI;4822495270;Taip;0;0;4;4
14934;Šilelis;NYKŠTUKAI;85457589779;Ne;0;0;2;2
14935;Šilelis;NYKŠTUKAI;53418739087;Taip;0;0;8;8
14936;Šilelis;NYKŠTUKAI;47822247496;Ne;6;0;1;7
14937;Šilelis;NYKŠTUKAI;51144587636;Taip;4;0;4;8
14938;Šilelis;NYKŠTUKAI;54390109952;Ne;0;10;0;10
14939;Šilelis;NYKŠTUKAI;27632618220;Taip;4;1;1;6
14940;Šilelis;NYKŠTUKAI;70854637761;Taip;0;0;4;4
14941;Šilelis;NYKŠTUKAI;46963038100;Taip;0;8;0;8
14942;Šilelis;NYKŠTUKAI;36489228256;Ne;0;6;0;6
14943;Šilelis;NYKŠTUKAI;88867863035;Taip;0;0;1;1
14944;Šilelis;NYKŠTUKAI;11569489731;Taip;0;3;0;3
14945;Šilelis;NYKŠTUKAI;1062766090;Taip;0;5;0;5
14946;Šilelis;NYKŠTUKAI;1740251009;Taip;0;0;6;6
14947;Šilelis;NYKŠTUKAI;1525689616;Taip;0;8;0;8
14948;Šilelis;NYKŠTUKAI;90624206653;Taip;0;5;0;5
14949;Šilelis;NYKŠTUKAI;96137271177;Taip;0;5;0;5
14950;Šilelis;NYKŠTUKAI;38324408521;Taip;0;5;3;8
14951;Šilelis;ANČIUKAI;6560491835;Taip;3;0;4;7
14952;Šilelis;ANČIUKAI;8969858170;Taip;5;0;3;8
14953;Šilelis;ANČIUKAI;2078673522;Taip;0;0;1;1
14954;Šilelis;ANČIUKAI;58760882565;Ne;4;0;0;4
14955;Šilelis;ANČIUKAI;3489973354;Taip;0;8;0;8
14956;Šilelis;ANČIUKAI;56024407115;Taip;3;0;3;6
14957;Šilelis;ANČIUKAI;5489571459;Taip;22;0;0;22
14958;Šilelis;ANČIUKAI;34382940842;Taip;11;0;0;11
14959;Šilelis;ANČIUKAI;1490838609;Taip;4;0;0;4
14960;Šilelis;ANČIUKAI;1621768113;Taip;4;6;0;10
14961;Šilelis;ANČIUKAI;3892886609;Taip;0;1;0;1
14962;Šilelis;ANČIUKAI;1633933962;Ne;0;0;7;7
14963;Šilelis;ANČIUKAI;8127562502;Taip;4;4;0;8
14964;Šilelis;ANČIUKAI;7201199871;Taip;4;0;0;4
14965;Šilelis;ANČIUKAI;1766981537;Taip;0;3;0;3
14966;Šilelis;ANČIUKAI;4187993554;Taip;0;4;0;4
14967;Šilelis;ANČIUKAI;2018007566;Ne;0;0;11;11
14968;Šilelis;KAČIUKAI;7666298411;Taip;13;0;0;13
14969;Šilelis;KAČIUKAI;9899047136;Taip;6;0;0;6
14970;Šilelis;KAČIUKAI;3216168797;Taip;13;0;0;13
14971;Šilelis;KAČIUKAI;9848760151;Ne;8;3;0;11
14972;Šilelis;KAČIUKAI;4743459915;Ne;12;0;0;12
14973;Šilelis;KAČIUKAI;2420308954;Taip;8;0;0;8
14974;Šilelis;KAČIUKAI;8387022157;Taip;17;5;0;22
14975;Šilelis;KAČIUKAI;3393466953;Taip;9;0;0;9
14976;Šilelis;KAČIUKAI;2111979474;Ne;16;0;0;16
14977;Šilelis;KAČIUKAI;8064905796;Taip;0;4;0;4
14978;Šilelis;KAČIUKAI;5176259940;Taip;6;0;4;10
14979;Šilelis;KAČIUKAI;5589764935;Taip;16;0;2;18
14980;Šilelis;KAČIUKAI;7123048946;Taip;8;1;0;9
14981;Šilelis;KAČIUKAI;6479728064;Taip;0;8;0;8
14982;Šilelis;KAČIUKAI;1821827154;Taip;12;5;0;17
14983;Šilelis;KAČIUKAI;3686287802;Taip;0;1;0;1
14984;Šilelis;KAČIUKAI;2906501601;Taip;0;9;0;9
14985;Šilelis;KIŠKUČIAI;62991250307;Taip;0;13;0;13
14986;Šilelis;KIŠKUČIAI;193181908;Taip;3;0;2;5
14987;Šilelis;KIŠKUČIAI;1747920772;Taip;0;0;3;3
14988;Šilelis;KIŠKUČIAI;1640789816;Taip;0;0;2;2
14989;Šilelis;KIŠKUČIAI;6061033736;Taip;0;5;0;5
14990;Šilelis;KIŠKUČIAI;1976745574;Taip;0;0;2;2
14991;Šilelis;KIŠKUČIAI;88436890881;Taip;0;8;0;8
14992;Šilelis;KIŠKUČIAI;29368876227;Taip;2;0;0;2
14993;Šilelis;KIŠKUČIAI;20920553773;Ne;0;3;0;3
14994;Šilelis;KIŠKUČIAI;5478094866;Taip;6;0;3;9
14995;Šilelis;KIŠKUČIAI;6096639483;Taip;4;0;1;5
14996;Šilelis;KIŠKUČIAI;4332682721;Ne;18;0;0;18
14997;Šilelis;KIŠKUČIAI;2256130191;Ne;0;0;8;8
14998;Šilelis;KIŠKUČIAI;1610171462;Ne;0;0;8;8
14999;Šilelis;KIŠKUČIAI;8491275729;Taip;6;0;1;7
15000;Šilelis;KIŠKUČIAI;5766702969;Ne;0;9;1;10
15001;Šilelis;KREGŽDUTĖS;1344825612;Taip;0;8;0;8
15002;Šilelis;KREGŽDUTĖS;3655800765;Taip;0;4;0;4
15003;Šilelis;KREGŽDUTĖS;50209412455;Taip;3;0;0;3
15004;Šilelis;KREGŽDUTĖS;1719681061;Ne;0;7;0;7
15005;Šilelis;KREGŽDUTĖS;2049105004;Taip;0;1;0;1
15006;Šilelis;KREGŽDUTĖS;36811772392;Taip;0;3;0;3
15007;Šilelis;KREGŽDUTĖS;1497479780;Taip;2;0;0;2
15008;Šilelis;KREGŽDUTĖS;1958785859;Taip;5;3;0;8
15009;Šilelis;KREGŽDUTĖS;89194687299;Taip;0;12;0;12
15010;Šilelis;KREGŽDUTĖS;1571063782;Taip;3;1;0;4
15011;Šilelis;KREGŽDUTĖS;1930906118;Taip;0;5;0;5
15012;Šilelis;KREGŽDUTĖS;82928837930;Taip;0;7;0;7
15013;Šilelis;KREGŽDUTĖS;1984731000;Ne;0;7;0;7
15014;Šilelis;KREGŽDUTĖS;75274553746;Taip;0;0;15;15
15015;Šilelis;KREGŽDUTĖS;20994727549;Taip;18;0;0;18
15016;Šilelis;KREGŽDUTĖS;8915228012;Taip;0;18;4;22
15017;Šilelis;PAGRANDUKAI;43259107285;Taip;5;1;0;6
15018;Šilelis;PAGRANDUKAI;3660152224;Taip;7;0;0;7
15019;Šilelis;PAGRANDUKAI;4814863979;Ne;13;4;0;17
15020;Šilelis;PAGRANDUKAI;9670243727;Taip;0;5;0;5
15021;Šilelis;PAGRANDUKAI;8357287467;Ne;10;1;0;11
15022;Šilelis;PAGRANDUKAI;20525573092;Taip;10;1;0;11
15023;Šilelis;PAGRANDUKAI;2897196188;Taip;10;0;0;10
15024;Šilelis;PAGRANDUKAI;1288690113;Ne;8;7;0;15
15025;Šilelis;PAGRANDUKAI;3583955729;Ne;0;5;0;5
15026;Šilelis;PAGRANDUKAI;8199573104;Taip;20;0;0;20
15027;Šilelis;PAGRANDUKAI;9113098594;Taip;1;0;0;1
15028;Šilelis;PAGRANDUKAI;56885383122;Taip;3;0;0;3
15029;Šilelis;PAGRANDUKAI;8265212749;Taip;9;2;0;11
15030;Šilelis;PAGRANDUKAI;9081488972;Taip;21;0;0;21
15031;Šilelis;PAGRANDUKAI;55396452032;Taip;8;2;0;10
15032;Šilelis;PAGRANDUKAI;7623203279;Taip;19;0;0;19
15033;Šilelis;PAGRANDUKAI;2397630691;Ne;14;1;0;15
15034;Šilelis;PAGRANDUKAI;4340856490;Taip;8;0;0;8
15035;Šilelis;PAGRANDUKAI;3807787648;Taip;11;2;0;13
15036;Šilelis;PAGRANDUKAI;2354942164;Taip;12;0;0;12
15037;Šilelis;PAGRANDUKAI;8687864179;Taip;5;0;0;5
15038;Šilelis;PAGRANDUKAI;6276408187;Taip;7;0;1;8
15039;Šilelis;PAGRANDUKAI;8416126751;Taip;15;0;0;15
15040;Šilelis;BITUTĖS;2948291866;Taip;0;2;0;2
15041;Šilelis;BITUTĖS;4682742121;Taip;0;8;0;8
15042;Šilelis;BITUTĖS;5835209357;Taip;1;0;0;1
15043;Šilelis;BITUTĖS;7512731255;Ne;10;3;1;14
15044;Šilelis;BITUTĖS;1268335563;Taip;5;8;0;13
15045;Šilelis;BITUTĖS;4781652156;Taip;6;4;0;10
15046;Šilelis;BITUTĖS;6104538160;Taip;5;0;0;5
15047;Šilelis;BITUTĖS;8271830626;Ne;7;0;0;7
15048;Šilelis;BITUTĖS;7814807923;Taip;15;0;0;15
15049;Šilelis;BITUTĖS;5305660046;Taip;0;0;1;1
15050;Šilelis;BITUTĖS;9071963194;Ne;9;0;2;11
15051;Šilelis;BITUTĖS;1306672095;Taip;3;0;2;5
15052;Šilelis;BITUTĖS;6297546907;Taip;17;0;0;17
15053;Šilelis;BITUTĖS;5843337891;Taip;5;0;0;5
15054;Šilelis;BITUTĖS;1960952604;Taip;22;0;0;22
15055;Šilelis;BITUTĖS;3954379433;Taip;0;4;0;4
15056;Šilelis;BITUTĖS;7350013139;Taip;0;12;0;12
15057;Šilelis;BITUTĖS;3062557053;Taip;0;0;1;1
15058;Šilelis;BITUTĖS;1390916076;Taip;0;6;0;6
15059;Šilelis;BITUTĖS;6143099736;Ne;0;7;0;7
15060;Šilelis;DRUGELIAI;1877467761;Taip;22;0;0;22
15061;Šilelis;DRUGELIAI;2079073174;Taip;8;0;0;8
15062;Šilelis;DRUGELIAI;3598370884;Ne;17;0;0;17
15063;Šilelis;DRUGELIAI;1618432877;Taip;7;0;0;7
15064;Šilelis;DRUGELIAI;1347150938;Taip;2;0;0;2
15065;Šilelis;DRUGELIAI;7636725161;Taip;0;2;0;2
15066;Šilelis;DRUGELIAI;9256656029;Taip;5;2;0;7
15067;Šilelis;DRUGELIAI;1891388542;Taip;9;0;1;10
15068;Šilelis;DRUGELIAI;5759824196;Ne;11;0;0;11
15069;Šilelis;DRUGELIAI;31906089315;Taip;0;6;0;6
15070;Šilelis;DRUGELIAI;4115738520;Taip;5;2;0;7
15071;Šilelis;DRUGELIAI;3824174896;Taip;5;2;0;7
15072;Šilelis;DRUGELIAI;8090765017;Taip;6;2;0;8
15073;Šilelis;DRUGELIAI;54633547799;Taip;8;0;0;8
15074;Šilelis;DRUGELIAI;9100047520;Taip;10;0;0;10
15075;Šilelis;DRUGELIAI;1019874215;Taip;8;0;0;8
15076;Šilelis;DRUGELIAI;5863425750;Taip;7;3;0;10
15077;Šilelis;DRUGELIAI;1448291886;Taip;0;10;0;10
15078;Šilelis;DRUGELIAI;1638362625;Taip;3;6;0;9
15079;Šilelis;DRUGELIAI;9482667810;Taip;16;0;0;16
15080;Šilelis;DRUGELIAI;5379171382;Ne;3;0;0;3
15081;Šilelis;DRUGELIAI;6230566495;Taip;3;1;0;4
15082;Šilelis;DRUGELIAI;6523676718;Ne;5;0;0;5
15083;Vaduvos;PAGRANDUKAI;1048630061;Taip;22;0;0;22
15084;Vaduvos;PAGRANDUKAI;8408017356;Taip;5;4;0;9
15085;Vaduvos;PAGRANDUKAI;72724196791;Taip;18;3;0;21
15086;Vaduvos;PAGRANDUKAI;9371067563;Taip;0;5;0;5
15087;Vaduvos;PAGRANDUKAI;9987311980;Taip;0;3;0;3
15088;Vaduvos;PAGRANDUKAI;6425640531;Taip;0;0;1;1
15089;Vaduvos;PAGRANDUKAI;73800920781;Taip;0;2;0;2
15090;Vaduvos;PAGRANDUKAI;18035723255;Ne;6;0;7;13
15091;Vaduvos;PAGRANDUKAI;5954492368;Taip;0;6;0;6
15092;Vaduvos;PAGRANDUKAI;7397068779;Ne;0;4;0;4
15093;Vaduvos;PAGRANDUKAI;8875709110;Taip;0;4;0;4
15094;Vaduvos;PAGRANDUKAI;4789480822;Taip;9;9;0;18
15095;Vaduvos;PAGRANDUKAI;7305111076;Taip;10;1;0;11
15096;Vaduvos;PAGRANDUKAI;2897226343;Taip;0;1;0;1
15097;Vaduvos;PAGRANDUKAI;68848152670;Taip;13;1;0;14
15098;Vaduvos;PAGRANDUKAI;4105978403;Taip;0;9;0;9
15099;Vaduvos;PAGRANDUKAI;5428067167;Taip;0;4;0;4
15100;Vaduvos;PAGRANDUKAI;3699578284;Taip;15;0;2;17
15101;Vaduvos;KODĖLČIUKAI;3010510262;Ne;0;4;0;4
15102;Vaduvos;KODĖLČIUKAI;9429028460;Taip;0;2;0;2
15103;Vaduvos;KODĖLČIUKAI;6210729584;Taip;0;0;3;3
15104;Vaduvos;KODĖLČIUKAI;9540008495;Taip;5;0;4;9
15105;Vaduvos;KODĖLČIUKAI;4177935331;Taip;0;3;0;3
15106;Vaduvos;KODĖLČIUKAI;9072097216;Ne;14;0;0;14
15107;Vaduvos;KODĖLČIUKAI;9062135043;Taip;6;2;0;8
15108;Vaduvos;KODĖLČIUKAI;6810198013;Taip;5;0;0;5
15109;Vaduvos;KODĖLČIUKAI;9178907705;Ne;16;0;0;16
15110;Vaduvos;KODĖLČIUKAI;3641822841;Taip;14;3;0;17
15111;Vaduvos;KODĖLČIUKAI;4270137614;Taip;5;1;0;6
15112;Vaduvos;KODĖLČIUKAI;3682708061;Taip;9;0;0;9
15113;Vaduvos;KODĖLČIUKAI;7181151562;Taip;0;12;0;12
15114;Vaduvos;KODĖLČIUKAI;5262165284;Taip;12;0;3;15
15115;Vaduvos;KODĖLČIUKAI;8603418399;Taip;0;6;0;6
15116;Vaduvos;KODĖLČIUKAI;3096104197;Taip;19;0;0;19
15117;Vaduvos;KODĖLČIUKAI;5761137540;Ne;0;14;1;15
15118;Vaduvos;KODĖLČIUKAI;9597857664;Taip;5;5;0;10
15119;Vaduvos;KODĖLČIUKAI;1054097622;Taip;4;5;0;9
15120;Vaduvos;SMALSUČIAI;5307128703;Taip;0;6;0;6
15121;Vaduvos;SMALSUČIAI;6121365922;Taip;22;0;0;22
15122;Vaduvos;SMALSUČIAI;62183976729;Taip;10;0;0;10
15123;Vaduvos;SMALSUČIAI;1825188497;Taip;1;0;0;1
15124;Vaduvos;SMALSUČIAI;1622695085;Taip;5;0;7;12
15125;Vaduvos;SMALSUČIAI;3555513755;Taip;4;0;0;4
15126;Vaduvos;SMALSUČIAI;7537754249;Taip;0;4;0;4
15127;Vaduvos;SMALSUČIAI;4565556635;Taip;5;0;6;11
15128;Vaduvos;SMALSUČIAI;5573145836;Taip;11;0;6;17
15129;Vaduvos;SMALSUČIAI;4615315809;Taip;5;0;3;8
15130;Vaduvos;SMALSUČIAI;7337663549;Taip;0;0;3;3
15131;Vaduvos;SMALSUČIAI;5055972872;Taip;3;1;0;4
15132;Vaduvos;SMALSUČIAI;6192828320;Taip;4;3;0;7
15133;Vaduvos;SMALSUČIAI;13888236429;Taip;0;0;7;7
15134;Vaduvos;SMALSUČIAI;3174998523;Ne;8;0;1;9
15135;Vaduvos;SMALSUČIAI;3091707832;Ne;5;0;5;10
15136;Vaduvos;SMALSUČIAI;13178417729;Taip;0;11;0;11
15137;Vaduvos;GILIUKAI;11202010413;Taip;4;5;0;9
15138;Vaduvos;GILIUKAI;1046867513;Ne;3;2;0;5
15139;Vaduvos;GILIUKAI;15757662594;Taip;0;2;0;2
15140;Vaduvos;GILIUKAI;41870343319;Taip;5;4;0;9
15141;Vaduvos;GILIUKAI;1464016847;Taip;0;11;0;11
15142;Vaduvos;GILIUKAI;2006018986;Taip;0;3;0;3
15143;Vaduvos;GILIUKAI;46608435244;Taip;0;0;1;1
15144;Vaduvos;GILIUKAI;86095539298;Taip;0;0;1;1
15145;Vaduvos;GILIUKAI;21499108813;Taip;2;0;0;2
15146;Vaduvos;GILIUKAI;59616893535;Taip;10;0;1;11
15147;Vaduvos;GILIUKAI;87008942241;Taip;5;0;0;5
15148;Vaduvos;GILIUKAI;56280470781;Taip;0;0;1;1
15149;Vaduvos;GILIUKAI;79437154441;Taip;5;0;1;6
15150;Vaduvos;GILIUKAI;68937983441;Taip;0;13;0;13
15151;Vaduvos;GILIUKAI;1703266825;Taip;7;0;0;7
15152;Vaduvos;GILIUKAI;65843855427;Ne;0;4;0;4
15153;Vaduvos;BORUŽĖLĖS;24887196729;Taip;0;7;0;7
15154;Vaduvos;BORUŽĖLĖS;16882774330;Taip;0;2;0;2
15155;Vaduvos;BORUŽĖLĖS;70693742936;Taip;0;10;5;15
15156;Vaduvos;BORUŽĖLĖS;4670249904;Taip;0;0;6;6
15157;Vaduvos;BORUŽĖLĖS;1385184350;Taip;0;0;2;2
15158;Vaduvos;BORUŽĖLĖS;65647119496;Taip;0;1;0;1
15159;Vaduvos;BORUŽĖLĖS;68420568339;Taip;3;0;0;3
15160;Vaduvos;BORUŽĖLĖS;96803174459;Ne;5;3;0;8
15161;Vaduvos;BORUŽĖLĖS;19390879176;Taip;6;0;0;6
15162;Vaduvos;BORUŽĖLĖS;47465933557;Taip;0;6;0;6
15163;Vaduvos;BORUŽĖLĖS;16006064074;Taip;0;0;2;2
15164;Vaduvos;BORUŽĖLĖS;55138588393;Taip;0;7;0;7
15165;Vaduvos;BORUŽĖLĖS;3172047211;Taip;0;0;3;3
15166;Vaduvos;BORUŽĖLĖS;93924290247;Taip;0;6;4;10
15167;Vaduvos;BORUŽĖLĖS;95104294893;Taip;0;0;8;8
15168;Vaduvos;BORUŽĖLĖS;6155494370;Ne;9;4;1;14
15169;Vaduvos;BORUŽĖLĖS;94906586734;Ne;5;2;0;7
15170;Vaduvos;BORUŽĖLĖS;6386205227;Taip;0;0;1;1
15171;Vaduvos;DRUGELIAI;39687066893;Ne;0;0;3;3
15172;Vaduvos;DRUGELIAI;87671358423;Taip;0;1;0;1
15173;Vaduvos;DRUGELIAI;40872193458;Taip;0;0;1;1
15174;Vaduvos;DRUGELIAI;1241148402;Taip;0;4;0;4
15175;Vaduvos;DRUGELIAI;93406851755;Taip;6;0;0;6
15176;Vaduvos;DRUGELIAI;13203715320;Taip;11;0;2;13
15177;Vaduvos;DRUGELIAI;26736566969;Taip;0;0;5;5
15178;Vaduvos;DRUGELIAI;64074141491;Taip;0;0;3;3
15179;Vaduvos;DRUGELIAI;66359913774;Taip;0;9;0;9
15180;Vaduvos;DRUGELIAI;49738318631;Taip;0;0;4;4
15181;Vaduvos;DRUGELIAI;8802765960;Taip;0;0;2;2
15182;Vaduvos;DRUGELIAI;1107557891;Ne;16;0;0;16
15183;Vaduvos;DRUGELIAI;78931952732;Ne;0;11;0;11
15184;Vaduvos;DRUGELIAI;3632802933;Ne;0;0;4;4
15185;Vaduvos;DRUGELIAI;54193761898;Taip;2;0;4;6
15186;Vaduvos;DRUGELIAI;1010061503;Taip;0;0;6;6
15187;Vaduvos;DRUGELIAI;2348627375;Taip;0;2;0;2
15188;Vaduvos;DRUGELIAI;1139509471;Taip;0;0;7;7
15189;Vaduvos;RIEŠUTĖLIAI;1422507884;Taip;0;10;3;13
15190;Vaduvos;RIEŠUTĖLIAI;2417613291;Taip;0;0;2;2
15191;Vaduvos;RIEŠUTĖLIAI;6439773886;Taip;0;10;2;12
15192;Vaduvos;RIEŠUTĖLIAI;6593754016;Taip;14;1;0;15
15193;Vaduvos;RIEŠUTĖLIAI;8324927031;Taip;0;9;0;9
15194;Vaduvos;RIEŠUTĖLIAI;5717064754;Ne;0;0;13;13
15195;Vaduvos;RIEŠUTĖLIAI;5634252033;Taip;13;0;1;14
15196;Vaduvos;RIEŠUTĖLIAI;9705185906;Taip;0;0;1;1
15197;Vaduvos;RIEŠUTĖLIAI;7904713344;Taip;3;0;0;3
15198;Vaduvos;RIEŠUTĖLIAI;2277525837;Taip;0;0;2;2
15199;Vaduvos;RIEŠUTĖLIAI;4465504676;Taip;4;0;0;4
15200;Vaduvos;RIEŠUTĖLIAI;6462126837;Taip;0;4;0;4
15201;Vaduvos;RIEŠUTĖLIAI;6991960029;Taip;10;0;0;10
15202;Vaduvos;RIEŠUTĖLIAI;7521846747;Ne;0;6;0;6
15203;Vaduvos;RIEŠUTĖLIAI;5510687497;Ne;0;6;0;6
15204;Vaduvos;RIEŠUTĖLIAI;5356902834;Taip;7;0;4;11
15205;Vaduvos;RIEŠUTĖLIAI;3461756429;Taip;9;0;1;10
15206;Vaduvos;"1 klasė";42498568346;Taip;0;1;0;1
15207;Vaduvos;"1 klasė";38504924027;Taip;0;1;0;1
15208;Vaduvos;"1 klasė";96148085691;Taip;0;1;0;1
15209;Vaduvos;"1 klasė";33277362439;Ne;0;7;0;7
15210;Vaduvos;"1 klasė";32138087379;Taip;0;10;0;10
15211;Vaduvos;"1 klasė";67324784528;Taip;0;1;0;1
15212;Vaduvos;"1 klasė";2181614424;Taip;0;1;0;1
15213;Vaduvos;"1 klasė";2019573643;Ne;0;1;0;1
15214;Vaduvos;"1 klasė";27419094487;Taip;0;1;0;1
15215;Vaduvos;"1 klasė";41272273463;Taip;0;1;0;1
15216;Vaduvos;"1 klasė";89793734700;Taip;0;1;0;1
15217;Vaduvos;"1 klasė";17473821556;Ne;0;1;0;1
15218;Vaduvos;"1 klasė";53866301875;Ne;0;6;0;6
15219;Vaduvos;"1 klasė";1532675814;Taip;0;7;0;7
15220;Vaduvos;"1 klasė";36931517006;Taip;0;1;0;1
15221;Vaduvos;"1 klasė";61243424057;Taip;0;1;0;1
15222;Vaduvos;"1 klasė";30979103892;Taip;0;1;0;1
15223;Vaduvos;"1 klasė";78245732319;Taip;0;1;0;1
15224;Vaduvos;"1 klasė";97878811046;Taip;0;1;0;1
15225;Vaduvos;"1 klasė";48433447683;Taip;0;1;0;1
15226;Vaduvos;"1 klasė";12330772986;Taip;0;1;0;1
15227;Vaduvos;"1 klasė";4807104855;Taip;0;4;0;4
15228;Vaduvos;"1 klasė";7786986697;Taip;0;6;0;6
15229;Vaduvos;"1 klasė";98259624669;Taip;0;1;0;1
15230;Vaduvos;"1 klasė";85090873161;Taip;0;1;0;1
15231;Vaduvos;"1 klasė";97423576166;Taip;0;1;0;1
15232;Vaduvos;"1 klasė";9147332638;Taip;0;1;0;1
15233;Vaduvos;"2 klasė";96473212525;Taip;0;1;0;1
15234;Vaduvos;"2 klasė";8188624118;Ne;0;22;0;22
15235;Vaduvos;"2 klasė";7172286009;Taip;0;2;0;2
15236;Vaduvos;"2 klasė";6049882391;Ne;0;2;0;2
15237;Vaduvos;"2 klasė";38013859931;Taip;0;2;0;2
15238;Vaduvos;"2 klasė";61830127618;Taip;0;14;0;14
15239;Vaduvos;"2 klasė";4591744662;Taip;0;2;0;2
15240;Vaduvos;"2 klasė";76662161382;Taip;0;3;0;3
15241;Vaduvos;"2 klasė";26934740147;Taip;0;22;0;22
15242;Vaduvos;"2 klasė";18300713872;Taip;0;22;0;22
15243;Vaduvos;"2 klasė";768455288;Ne;0;22;0;22
15244;Vaduvos;"2 klasė";1768173501;Taip;0;2;0;2
15245;Vaduvos;"2 klasė";38462664426;Ne;0;10;0;10
15246;Vaduvos;"2 klasė";1821644443;Ne;0;14;0;14
15247;Vaduvos;"2 klasė";1171210935;Taip;0;4;0;4
15248;Vaduvos;"3 klasė";8009941823;Taip;0;1;0;1
15249;Vaduvos;"3 klasė";2423925079;Taip;0;22;0;22
15250;Vaduvos;"3 klasė";7410760461;Taip;0;22;0;22
15251;Vaduvos;"3 klasė";6487033699;Taip;0;1;0;1
15252;Vaduvos;"3 klasė";1671409152;Taip;0;1;0;1
15253;Vaduvos;"3 klasė";5072769647;Taip;0;1;0;1
15254;Vaduvos;"3 klasė";4637670260;Taip;0;3;0;3
15255;Vaduvos;"3 klasė";7236550835;Taip;0;1;0;1
15256;Vaduvos;"3 klasė";9372936408;Taip;0;1;0;1
15257;Vaduvos;"3 klasė";7243175751;Taip;0;1;0;1
15258;Vaduvos;"3 klasė";2482212122;Taip;0;1;0;1
15259;Vaduvos;"3 klasė";1982860223;Taip;0;1;0;1
15260;Vaduvos;"3 klasė";4447152355;Taip;0;1;0;1
15261;Vaduvos;"3 klasė";3325229112;Taip;0;1;0;1
15262;Vaduvos;"3 klasė";5531150399;Taip;0;22;0;22
15263;Vaduvos;"3 klasė";6980440631;Taip;0;1;0;1
15264;Vaduvos;"3 klasė";1091221509;Ne;0;1;0;1
15265;Vaduvos;"3 klasė";7614692200;Taip;0;1;0;1
15266;Vaduvos;"3 klasė";8216757208;Taip;0;1;0;1
15267;Vaduvos;"3 klasė";5459268700;Ne;0;22;0;22
15268;Vaduvos;"3 klasė";5593756016;Taip;0;1;0;1
15269;Vaduvos;"3 klasė";1642242442;Taip;0;1;0;1
15270;Vaduvos;"3 klasė";8928517238;Taip;0;1;0;1
15271;Vaduvos;"3 klasė";5099560123;Taip;0;1;0;1
15272;Vaduvos;"3 klasė";7899239147;Taip;0;1;0;1
15273;Vaduvos;"4 klasė";6896561963;Taip;0;6;0;6
15274;Vaduvos;"4 klasė";2149582337;Taip;0;3;0;3
15275;Vaduvos;"4 klasė";2520421584;Ne;0;3;0;3
15276;Vaduvos;"4 klasė";8241399720;Taip;0;1;0;1
15277;Vaduvos;"4 klasė";7719637673;Taip;0;3;0;3
15278;Vaduvos;"4 klasė";9644782309;Taip;0;3;0;3
15279;Vaduvos;"4 klasė";5523290081;Taip;0;3;0;3
15280;Vaduvos;"4 klasė";5786723345;Ne;0;4;0;4
15281;Vaduvos;"4 klasė";1461738157;Taip;0;2;0;2
15282;Vaduvos;"4 klasė";7786044620;Taip;0;22;0;22
15283;Vaduvos;"4 klasė";4347558872;Taip;0;1;0;1
15284;Vaduvos;"4 klasė";1954540001;Taip;0;4;0;4
15285;Vaduvos;"4 klasė";9271050464;Taip;0;1;0;1
15286;Vaduvos;"4 klasė";3755145838;Taip;0;22;0;22
15287;Vaduvos;"4 klasė";9494193819;Taip;0;22;0;22
15288;Vaduvos;"4 klasė";7838224919;Ne;0;1;0;1
15289;Vaduvos;"4 klasė";1086186628;Taip;0;3;0;3
15290;Vaduvos;"4 klasė";9441676636;Ne;0;1;0;1
15291;Vaduvos;"4 klasė";1841919654;Ne;0;2;0;2
15292;Vaduvos;"4 klasė";6964778383;Taip;0;3;0;3
15293;Vaduvos;"4 klasė";6748405557;Taip;0;1;0;1
15294;Vaduvos;"4 klasė";1730710569;Taip;0;2;0;2
15295;Vaduvos;"4 klasė";6744521293;Ne;0;1;0;1
15296;Vaduvos;"4 klasė";8801412437;Taip;0;1;0;1
15297;Vaduvos;"4 klasė";3583694770;Taip;0;4;0;4
15298;Vilkpėdės;BORUŽĖLĖS;8969001990;Taip;0;0;1;1
15299;Vilkpėdės;BORUŽĖLĖS;6744834487;Taip;13;0;1;14
15300;Vilkpėdės;BORUŽĖLĖS;7401886306;Ne;5;2;0;7
15301;Vilkpėdės;BORUŽĖLĖS;1528619779;Taip;2;3;0;5
15302;Vilkpėdės;BORUŽĖLĖS;6820236577;Taip;17;0;1;18
15303;Vilkpėdės;BORUŽĖLĖS;4255757333;Ne;13;0;0;13
15304;Vilkpėdės;BORUŽĖLĖS;4166416292;Taip;6;4;0;10
15305;Vilkpėdės;BORUŽĖLĖS;3785308006;Taip;0;0;1;1
15306;Vilkpėdės;BORUŽĖLĖS;6283767445;Taip;0;1;0;1
15307;Vilkpėdės;BORUŽĖLĖS;9605430333;Taip;0;2;0;2
15308;Vilkpėdės;BORUŽĖLĖS;3888880306;Taip;0;6;0;6
15309;Vilkpėdės;BORUŽĖLĖS;9601934563;Taip;4;0;1;5
15310;Vilkpėdės;BORUŽĖLĖS;1571869318;Ne;4;0;0;4
15311;Vilkpėdės;SKRUZDĖLIUKAI;8820585407;Ne;3;1;1;5
15312;Vilkpėdės;SKRUZDĖLIUKAI;7661268641;Ne;0;8;1;9
15313;Vilkpėdės;SKRUZDĖLIUKAI;4018140154;Ne;12;3;0;15
15314;Vilkpėdės;SKRUZDĖLIUKAI;2419661008;Ne;0;5;7;12
15315;Vilkpėdės;SKRUZDĖLIUKAI;7114183123;Ne;4;0;19;23
15316;Vilkpėdės;SKRUZDĖLIUKAI;8804335248;Ne;12;0;0;12
15317;Vilkpėdės;SKRUZDĖLIUKAI;8385974099;Ne;13;0;1;14
15318;Vilkpėdės;SKRUZDĖLIUKAI;2525399410;Ne;16;0;1;17
15319;Vilkpėdės;SKRUZDĖLIUKAI;4656475161;Ne;0;0;15;15
15320;Vilkpėdės;SKRUZDĖLIUKAI;6778288398;Ne;0;0;1;1
15321;Vilkpėdės;SKRUZDĖLIUKAI;2359315281;Ne;22;0;0;22
15322;Vilkpėdės;SKRUZDĖLIUKAI;3948025914;Ne;0;19;0;19
15323;Vilkpėdės;SKRUZDĖLIUKAI;1655985778;Ne;5;0;1;6
15324;Vilkpėdės;SKRUZDĖLIUKAI;8018718405;Taip;10;0;1;11
15325;Vilkpėdės;SKRUZDĖLIUKAI;6514256499;Taip;0;1;1;2
15326;Vilkpėdės;DRUGELIAI;2420271759;Taip;5;2;0;7
15327;Vilkpėdės;DRUGELIAI;2377248778;Taip;5;1;0;6
15328;Vilkpėdės;DRUGELIAI;7698759895;Taip;3;3;0;6
15329;Vilkpėdės;DRUGELIAI;1019057127;Taip;5;3;0;8
15330;Vilkpėdės;DRUGELIAI;1807884737;Taip;10;0;0;10
15331;Vilkpėdės;DRUGELIAI;6816745585;Taip;3;0;0;3
15332;Vilkpėdės;DRUGELIAI;8015392054;Taip;0;1;0;1
15333;Vilkpėdės;DRUGELIAI;2320350937;Taip;3;4;0;7
15334;Vilkpėdės;DRUGELIAI;7894766629;Taip;0;5;0;5
15335;Vilkpėdės;DRUGELIAI;9795696242;Taip;5;0;0;5
15336;Vilkpėdės;DRUGELIAI;8581661608;Taip;2;1;0;3
15337;Vilkpėdės;DRUGELIAI;6261547304;Taip;9;0;0;9
15338;Vilkpėdės;DRUGELIAI;4095366279;Taip;7;0;0;7
15339;Vilkpėdės;DRUGELIAI;8128254701;Taip;0;0;2;2
15340;Vilkpėdės;DRUGELIAI;7747013579;Taip;2;7;0;9
15341;Vilkpėdės;DRUGELIAI;6522707709;Ne;3;12;0;15
15342;Vilkpėdės;ŽIOGELIAI;1267187553;Taip;5;0;0;5
15343;Vilkpėdės;ŽIOGELIAI;7508333714;Taip;4;5;0;9
15344;Vilkpėdės;ŽIOGELIAI;1396827668;Taip;4;0;1;5
15345;Vilkpėdės;ŽIOGELIAI;5551822633;Taip;22;0;0;22
15346;Vilkpėdės;ŽIOGELIAI;9544418642;Taip;0;0;1;1
15347;Vilkpėdės;ŽIOGELIAI;1063740772;Taip;13;0;0;13
15348;Vilkpėdės;ŽIOGELIAI;3666145718;Taip;0;6;0;6
15349;Vilkpėdės;ŽIOGELIAI;5633014328;Taip;10;1;0;11
15350;Vilkpėdės;ŽIOGELIAI;5422061533;Taip;4;0;0;4
15351;Vilkpėdės;ŽIOGELIAI;4311938034;Taip;5;2;0;7
15352;Vilkpėdės;ŽIOGELIAI;3833382641;Taip;7;0;0;7
15353;Vilkpėdės;ŽIOGELIAI;5346798201;Taip;2;8;0;10
15354;Vilkpėdės;ŽIOGELIAI;5340239466;Taip;0;10;1;11
15355;Vilkpėdės;ŽIOGELIAI;3720639726;Taip;0;0;1;1
15356;Vilkpėdės;ŽIOGELIAI;7745776486;Taip;13;0;1;14
15357;Vilkpėdės;BITUTĖS;9605399822;Taip;0;1;0;1
15358;Vilkpėdės;BITUTĖS;7875898177;Taip;0;8;0;8
15359;Vilkpėdės;BITUTĖS;46561435465;Ne;0;11;0;11
15360;Vilkpėdės;BITUTĖS;48059844727;Taip;0;4;0;4
15361;Vilkpėdės;BITUTĖS;1195392132;Taip;13;0;0;13
15362;Vilkpėdės;BITUTĖS;7634355147;Taip;0;2;0;2
15363;Vilkpėdės;BITUTĖS;4392760215;Ne;0;4;0;4
15364;Vilkpėdės;BITUTĖS;2955411131;Taip;0;5;0;5
15365;Vilkpėdės;BITUTĖS;2736368118;Taip;0;8;0;8
15366;Vilkpėdės;BITUTĖS;4515945951;Taip;0;0;4;4
15367;Vilkpėdės;BITUTĖS;2900581406;Taip;4;1;0;5
15368;Vilkpėdės;BITUTĖS;7527929277;Taip;0;22;0;22
15369;Vilkpėdės;BITUTĖS;8865545376;Ne;0;8;0;8
15370;Vilkpėdės;BITUTĖS;4276158771;Taip;0;4;0;4
15371;Vilkpėdės;BITUTĖS;7889480219;Taip;0;1;0;1
15372;Vilkpėdės;BITUTĖS;5048931309;Taip;13;0;0;13
15373;Vilkpėdės;"2 klasė";14499651046;Ne;0;8;0;8
15374;Vilkpėdės;"2 klasė";90217345315;Taip;0;1;0;1
15375;Vilkpėdės;"2 klasė";51286525404;Taip;1;1;0;2
15376;Vilkpėdės;"2 klasė";49513181091;Taip;0;1;0;1
15377;Vilkpėdės;"2 klasė";1032216128;Taip;6;1;0;7
15378;Vilkpėdės;"2 klasė";37450374921;Taip;0;1;0;1
15379;Vilkpėdės;"2 klasė";36704555745;Taip;1;2;0;3
15380;Vilkpėdės;"2 klasė";66356984763;Taip;0;4;0;4
15381;Vilkpėdės;"2 klasė";88279045901;Taip;1;7;0;8
15382;Vilkpėdės;"2 klasė";66451097025;Taip;0;1;0;1
15383;Vilkpėdės;"2 klasė";2806307083;Taip;0;1;0;1
15384;Vilkpėdės;"2 klasė";51799865091;Taip;0;1;0;1
15385;Vilkpėdės;"2 klasė";79269485254;Taip;3;3;0;6
15386;Vilkpėdės;"2 klasė";61833757576;Taip;0;1;0;1
15387;Vilkpėdės;"2 klasė";64216245300;Taip;0;2;0;2
15388;Vilkpėdės;"3 klasė";54583403159;Taip;0;1;1;2
15389;Vilkpėdės;"3 klasė";6750171948;Ne;0;1;3;4
15390;Vilkpėdės;"3 klasė";3330174377;Ne;0;1;0;1
15391;Vilkpėdės;"3 klasė";1894949069;Ne;0;1;1;2
15392;Vilkpėdės;"3 klasė";2877690064;Ne;0;1;2;3
15393;Vilkpėdės;"3 klasė";63399321230;Taip;0;1;0;1
15394;Vilkpėdės;"3 klasė";5753361387;Ne;0;1;0;1
15395;Vilkpėdės;"3 klasė";7567054902;Ne;0;1;0;1
15396;Vilkpėdės;"3 klasė";3096541013;Ne;0;1;0;1
15397;Vilkpėdės;"3 klasė";2621713818;Ne;0;1;0;1
15398;Vilkpėdės;"3 klasė";2334044794;Ne;0;1;2;3
15399;Vilkpėdės;"3 klasė";4450490805;Ne;0;1;0;1
15400;Vilkpėdės;"3 klasė";45282785781;Taip;0;1;0;1
15401;Vilkpėdės;"3 klasė";87882890428;Taip;0;1;0;1
15402;Vilkpėdės;"3 klasė";9422266523;Ne;0;1;0;1
15403;Vilkpėdės;"3 klasė";4467711387;Ne;0;1;0;1
15404;Vilkpėdės;"3 klasė";4562930821;Ne;0;1;0;1
15405;Vilkpėdės;GUDRUČIAI;19719432462;Taip;0;4;0;4
15406;Vilkpėdės;GUDRUČIAI;63180329851;Ne;0;9;0;9
15407;Vilkpėdės;GUDRUČIAI;93775558547;Ne;0;2;0;2
15408;Vilkpėdės;GUDRUČIAI;5218466024;Taip;0;8;2;10
15409;Vilkpėdės;GUDRUČIAI;4457851703;Taip;0;8;0;8
15410;Vilkpėdės;GUDRUČIAI;70184817311;Taip;0;5;0;5
15411;Vilkpėdės;GUDRUČIAI;81712437117;Taip;0;1;0;1
15412;Vilkpėdės;GUDRUČIAI;61457409195;Ne;0;8;0;8
15413;Vilkpėdės;GUDRUČIAI;60687258266;Taip;0;5;0;5
15414;Vilkpėdės;GUDRUČIAI;25846393751;Taip;0;2;0;2
15415;Vilkpėdės;GUDRUČIAI;95615604947;Taip;3;5;0;8
15416;Vilkpėdės;GUDRUČIAI;90226911248;Taip;0;9;0;9
15417;Vilkpėdės;GUDRUČIAI;18860888473;Taip;0;1;0;1
15418;Vilkpėdės;GUDRUČIAI;73812058890;Taip;0;10;0;10
15419;Vilkpėdės;GUDRUČIAI;33842357499;Taip;0;4;0;4
15420;Vilkpėdės;GUDRUČIAI;21841574426;Taip;0;13;0;13
15421;Vilkpėdės;GUDRUČIAI;32683398503;Taip;0;3;0;3
15422;Vilkpėdės;GUDRUČIAI;58037049872;Taip;0;6;0;6
15423;Vilkpėdės;GUDRUČIAI;89601406730;Taip;0;3;0;3
15424;Vilkpėdės;SMALSUČIAI;2065010940;Taip;0;5;0;5
15425;Vilkpėdės;SMALSUČIAI;1137529145;Taip;0;3;0;3
15426;Vilkpėdės;SMALSUČIAI;1052719398;Taip;0;5;0;5
15427;Vilkpėdės;SMALSUČIAI;55747681017;Taip;0;7;0;7
15428;Vilkpėdės;SMALSUČIAI;1136036746;Taip;0;11;0;11
15429;Vilkpėdės;SMALSUČIAI;51976067616;Taip;1;1;0;2
15430;Vilkpėdės;SMALSUČIAI;73470824566;Ne;0;2;0;2
15431;Vilkpėdės;SMALSUČIAI;5912919726;Taip;0;4;0;4
15432;Vilkpėdės;SMALSUČIAI;72227817278;Ne;0;1;0;1
15433;Vilkpėdės;SMALSUČIAI;2000428715;Taip;9;0;0;9
15434;Vilkpėdės;SMALSUČIAI;1042000830;Taip;0;0;1;1
15435;Vilkpėdės;SMALSUČIAI;72899151328;Taip;2;0;1;3
15436;Vilkpėdės;SMALSUČIAI;1527272055;Ne;5;0;0;5
15437;Vilkpėdės;SMALSUČIAI;25008201566;Taip;0;13;1;14
15438;Vilkpėdės;SMALSUČIAI;9393571483;Taip;2;0;4;6
15439;Žiburėlis;Nykštukai;6696156248;Taip;8;1;0;9
15440;Žiburėlis;Nykštukai;7163594513;Taip;9;0;0;9
15441;Žiburėlis;Nykštukai;5174211773;Ne;4;2;0;6
15442;Žiburėlis;Nykštukai;5209976632;Taip;0;1;0;1
15443;Žiburėlis;Nykštukai;5408766721;Ne;5;1;0;6
15444;Žiburėlis;Nykštukai;3646988912;Taip;1;2;0;3
15445;Žiburėlis;Nykštukai;8535429783;Ne;15;0;0;15
15446;Žiburėlis;Nykštukai;9670396828;Taip;17;1;0;18
15447;Žiburėlis;Nykštukai;7211961512;Ne;0;5;0;5
15448;Žiburėlis;Nykštukai;2928528630;Ne;6;0;0;6
15449;Žiburėlis;Nykštukai;2624326930;Taip;20;0;0;20
15450;Žiburėlis;Nykštukai;6300247811;Taip;4;1;0;5
15451;Žiburėlis;Nykštukai;3033049328;Taip;0;5;0;5
15452;Žiburėlis;Nykštukai;5303511810;Taip;4;10;0;14
15453;Žiburėlis;Nykštukai;3262856058;Ne;12;2;0;14
15454;Žiburėlis;Nykštukai;5816890413;Taip;10;0;0;10
15455;Žiburėlis;"Žiniukai ";1463581257;Ne;0;5;0;5
15456;Žiburėlis;"Žiniukai ";90296810303;Taip;0;1;0;1
15457;Žiburėlis;"Žiniukai ";78896331135;Taip;3;2;0;5
15458;Žiburėlis;"Žiniukai ";32837087738;Taip;0;2;0;2
15459;Žiburėlis;"Žiniukai ";78861342608;Ne;4;0;0;4
15460;Žiburėlis;"Žiniukai ";49081936325;Taip;0;6;0;6
15461;Žiburėlis;"Žiniukai ";7135920347;Taip;10;0;0;10
15462;Žiburėlis;"Žiniukai ";61148040564;Taip;10;2;0;12
15463;Žiburėlis;"Žiniukai ";25826760783;Taip;8;2;0;10
15464;Žiburėlis;"Žiniukai ";45509849089;Taip;5;0;0;5
15465;Žiburėlis;"Žiniukai ";73054546792;Taip;5;9;0;14
15466;Žiburėlis;"Žiniukai ";16721946185;Taip;0;2;0;2
15467;Žiburėlis;"Žiniukai ";1937753510;Taip;6;5;0;11
15468;Žiburėlis;"Žiniukai ";42442737710;Taip;0;4;0;4
15469;Žiburėlis;"Žiniukai ";64418469679;Ne;0;7;0;7
15470;Žiburėlis;"Žiniukai ";16215414453;Ne;0;3;0;3
15471;Žiburėlis;"Žiniukai ";77674964341;Taip;0;1;0;1
15472;Žiburėlis;"Smalsiukai ";4631640931;Ne;11;5;0;16
15473;Žiburėlis;"Smalsiukai ";5006361324;Taip;0;1;0;1
15474;Žiburėlis;"Smalsiukai ";1876645582;Taip;0;4;0;4
15475;Žiburėlis;"Smalsiukai ";8109335587;Taip;0;2;0;2
15476;Žiburėlis;"Smalsiukai ";4187381976;Taip;7;4;0;11
15477;Žiburėlis;"Smalsiukai ";7424129974;Ne;7;5;0;12
15478;Žiburėlis;"Smalsiukai ";2982016133;Taip;0;1;2;3
15479;Žiburėlis;"Smalsiukai ";1720078356;Taip;9;0;0;9
15480;Žiburėlis;"Smalsiukai ";57892276898;Taip;10;0;0;10
15481;Žiburėlis;"Smalsiukai ";13256396372;Taip;6;0;0;6
15482;Žiburėlis;"Smalsiukai ";87417486808;Ne;0;7;0;7
15483;Žiburėlis;"Smalsiukai ";68423991252;Taip;12;4;0;16
15484;Žiburėlis;"Smalsiukai ";7518552326;Taip;0;7;1;8
15485;Žiburėlis;"Smalsiukai ";25134435204;Taip;3;5;0;8
15486;Žiburėlis;"Smalsiukai ";3966740507;Ne;0;2;0;2
15487;Žiburėlis;"Smalsiukai ";1115857147;Taip;17;2;0;19
15488;Žiburėlis;"Giliukai ";52216192635;Taip;6;1;0;7
15489;Žiburėlis;"Giliukai ";4355778076;Ne;2;1;0;3
15490;Žiburėlis;"Giliukai ";92490398630;Ne;0;2;0;2
15491;Žiburėlis;"Giliukai ";67168630669;Taip;12;2;0;14
15492;Žiburėlis;"Giliukai ";3867540155;Taip;0;1;0;1
15493;Žiburėlis;"Giliukai ";7578655857;Ne;0;10;0;10
15494;Žiburėlis;"Giliukai ";75538036055;Taip;0;1;0;1
15495;Žiburėlis;"Giliukai ";9253393819;Taip;0;3;0;3
15496;Žiburėlis;"Giliukai ";2796489509;Taip;5;1;0;6
15497;Žiburėlis;"Giliukai ";18739941845;Taip;0;2;0;2
15498;Žiburėlis;"Giliukai ";24639355056;Taip;9;1;0;10
15499;Žiburėlis;"Giliukai ";1842029645;Taip;0;5;0;5
15500;Žiburėlis;"Giliukai ";6519139977;Taip;0;18;0;18
15501;Žiburėlis;"Giliukai ";7861704875;Ne;5;0;0;5
15502;Žiburėlis;"Giliukai ";34873231652;Taip;3;1;0;4
15503;Žiburėlis;"Giliukai ";1125662904;Taip;13;0;0;13
15504;Žiburėlis;"Giliukai ";2175751377;Taip;4;0;0;4
15505;Žiburėlis;"Giliukai ";8531121002;Ne;14;0;0;14
15506;Žiburėlis;"Giliukai ";28985997205;Taip;10;0;0;10
15507;Žiburėlis;"Giliukai ";1599112927;Taip;4;0;2;6
15508;Žiburėlis;"1 klasė";5914668910;Ne;0;1;0;1
15509;Žiburėlis;"1 klasė";95216886081;Taip;0;1;0;1
15510;Žiburėlis;"1 klasė";37375035477;Taip;0;1;0;1
15511;Žiburėlis;"1 klasė";54487369856;Ne;3;1;0;4
15512;Žiburėlis;"1 klasė";1483522393;Taip;0;1;0;1
15513;Žiburėlis;"1 klasė";93584914250;Taip;0;1;0;1
15514;Žiburėlis;"1 klasė";1858285649;Taip;0;1;0;1
15515;Žiburėlis;"1 klasė";41774939326;Taip;0;1;0;1
15516;Žiburėlis;"1 klasė";5778346952;Taip;0;1;0;1
15517;Žiburėlis;"1 klasė";67896676967;Taip;0;1;0;1
15518;Žiburėlis;"1 klasė";1852949849;Ne;3;1;0;4
15519;Žiburėlis;"1 klasė";95176636771;Taip;0;1;0;1
15520;Žiburėlis;"1 klasė";88801862582;Taip;0;1;0;1
15521;Žiburėlis;Meškiukai;7070952018;Taip;0;2;0;2
15522;Žiburėlis;Meškiukai;38096163093;Taip;4;0;0;4
15523;Žiburėlis;Meškiukai;96004573835;Taip;0;5;0;5
15524;Žiburėlis;Meškiukai;549348368;Taip;0;2;0;2
15525;Žiburėlis;Meškiukai;2270893326;Taip;0;2;2;4
15526;Žiburėlis;Meškiukai;1728059994;Taip;2;2;0;4
15527;Žiburėlis;Meškiukai;9069606713;Ne;14;2;0;16
15528;Žiburėlis;Meškiukai;46449810717;Taip;0;10;1;11
15529;Žiburėlis;Meškiukai;3678560815;Taip;3;6;0;9
15530;Žiburėlis;Meškiukai;57749440744;Taip;0;2;1;3
15531;Žiburėlis;Meškiukai;808556747;Taip;0;14;0;14
15532;Žiburėlis;Meškiukai;43206636255;Taip;0;1;3;4
15533;Žiburėlis;Meškiukai;60150682872;Taip;0;10;0;10
15534;Žiburėlis;Meškiukai;50869669391;Taip;0;3;0;3
15535;Žiburėlis;Meškiukai;31669188580;Taip;3;2;1;6
15536;Žiburėlis;Meškiukai;30337030701;Ne;0;9;0;9
15537;Žiburėlis;Meškiukai;1612968712;Taip;0;1;0;1
15538;Žiburėlis;Meškiukai;5495813195;Taip;0;2;0;2
15539;Žiburėlis;Viščiukai;2491972986;Taip;7;9;0;16
15540;Žiburėlis;Viščiukai;8970153523;Taip;10;2;0;12
15541;Žiburėlis;Viščiukai;2702814930;Taip;5;3;0;8
15542;Žiburėlis;Viščiukai;4387021429;Taip;0;9;0;9
15543;Žiburėlis;Viščiukai;7865562941;Ne;3;1;0;4
15544;Žiburėlis;Viščiukai;8973307069;Ne;6;1;0;7
15545;Žiburėlis;Viščiukai;5002691930;Taip;0;7;0;7
15546;Žiburėlis;Viščiukai;8133371774;Taip;0;22;0;22
15547;Žiburėlis;Viščiukai;4916545915;Taip;0;3;0;3
15548;Žiburėlis;Viščiukai;6802308420;Taip;15;0;0;15
15549;Žiburėlis;Viščiukai;1775465307;Taip;0;10;0;10
15550;Žiburėlis;Viščiukai;6647598068;Taip;12;0;0;12
15551;Žiburėlis;Viščiukai;4109288891;Taip;12;0;0;12
15552;Žiburėlis;Viščiukai;7111530833;Ne;7;0;0;7
15553;Žiburėlis;Viščiukai;7825665451;Taip;14;1;0;15
15554;Žiburėlis;"Drambliukai ";7633450988;Taip;0;1;0;1
15555;Žiburėlis;"Drambliukai ";2741301903;Ne;0;4;0;4
15556;Žiburėlis;"Drambliukai ";6830200578;Ne;17;0;0;17
15557;Žiburėlis;"Drambliukai ";2253167147;Ne;11;4;0;15
15558;Žiburėlis;"Drambliukai ";7402647048;Taip;7;0;0;7
15559;Žiburėlis;"Drambliukai ";8215816053;Ne;0;1;0;1
15560;Žiburėlis;"Drambliukai ";9352485231;Taip;0;1;0;1
15561;Žiburėlis;"Drambliukai ";4710995351;Taip;4;2;0;6
15562;Žiburėlis;"Drambliukai ";2292895729;Taip;16;0;0;16
15563;Žiburėlis;"Drambliukai ";5098955523;Taip;0;5;0;5
15564;Žiburėlis;"Drambliukai ";5629404179;Taip;0;10;0;10
15565;Žiburėlis;"Drambliukai ";9806454408;Ne;0;1;0;1
15566;Žiburėlis;"Drambliukai ";8686565770;Taip;8;1;0;9
15567;Žiburėlis;"Drambliukai ";3938379566;Taip;16;0;0;16
15568;Žiburėlis;"Drambliukai ";5556807335;Taip;5;0;0;5
15569;Žiburėlis;"Drambliukai ";8346571253;Taip;3;1;0;4
15570;Žiburėlis;"2 klasė";85928090100;Taip;6;1;0;7
15571;Žiburėlis;"2 klasė";78965453247;Ne;0;1;0;1
15572;Žiburėlis;"2 klasė";91489560481;Taip;9;1;0;10
15573;Žiburėlis;"2 klasė";86214644730;Taip;0;1;0;1
15574;Žiburėlis;"2 klasė";50386629614;Taip;0;1;0;1
15575;Žiburėlis;"2 klasė";29289711001;Ne;0;22;0;22
15576;Žiburėlis;"2 klasė";3462265950;Taip;0;22;0;22
15577;Žiburėlis;"2 klasė";97596344387;Taip;2;1;0;3
15578;Žiburėlis;"2 klasė";67880120356;Taip;0;1;0;1
15579;Žiburėlis;"2 klasė";83887875309;Taip;0;1;0;1
15580;Žiburėlis;"2 klasė";75779767358;Ne;0;1;0;1
15581;Žiburėlis;"2 klasė";33877368082;Taip;0;1;0;1
15582;Žiburėlis;"2 klasė";40167464240;Taip;0;1;0;1
15583;Žiburėlis;"2 klasė";91397954329;Taip;0;1;0;1
15584;Žiburėlis;"2 klasė";1266445858;Taip;0;1;0;1
15585;Žiburėlis;"2 klasė";19924188057;Taip;0;1;0;1
15586;Žiburėlis;"2 klasė";16657264022;Taip;0;1;0;1
15587;Žiburėlis;"2 klasė";23334642950;Ne;0;22;0;22
15588;Žiburėlis;"2 klasė";4909760547;Taip;2;1;0;3
15589;Žiburėlis;"3 klasė";8108287017;Ne;0;22;0;22
15590;Žiburėlis;"3 klasė";7328501055;Ne;3;1;0;4
15591;Žiburėlis;"3 klasė";6555937866;Ne;0;1;0;1
15592;Žiburėlis;"3 klasė";9986286327;Ne;0;22;0;22
15593;Žiburėlis;"3 klasė";8967516850;Ne;0;2;0;2
15594;Žiburėlis;"3 klasė";4955196776;Ne;6;1;0;7
15595;Žiburėlis;"3 klasė";5730454385;Ne;0;2;0;2
15596;Žiburėlis;"3 klasė";7420310542;Ne;0;2;0;2
15597;Žiburėlis;"3 klasė";9030168070;Ne;0;1;0;1
15598;Žiburėlis;"3 klasė";5120367724;Ne;0;22;0;22
15599;Žiburėlis;"3 klasė";5154752431;Ne;0;1;0;1
15600;Žiburėlis;"3 klasė";2895056046;Ne;3;1;0;4
15601;Žiburėlis;"3 klasė";2980656238;Ne;0;1;0;1
15602;Žiburėlis;"3 klasė";9444201589;Ne;4;2;0;6
15603;Žiburėlis;"3 klasė";6532799193;Ne;0;1;0;1
15604;Žiburėlis;"3 klasė";5587135070;Ne;4;1;0;5
15605;Žiburėlis;"3 klasė";7971654401;Ne;7;1;0;8
15606;Žiburėlis;"3 klasė";7244452816;Ne;4;1;0;5
15607;Žiburėlis;"4 klasė";2145461317;Ne;3;1;0;4
15608;Žiburėlis;"4 klasė";6992801094;Ne;1;1;0;2
15609;Žiburėlis;"4 klasė";7451312098;Ne;0;1;0;1
15610;Žiburėlis;"4 klasė";4444164248;Ne;1;1;0;2
15611;Žiburėlis;"4 klasė";8755335337;Ne;0;22;0;22
15612;Žiburėlis;"4 klasė";9803636658;Ne;0;22;0;22
15613;Žiburėlis;"4 klasė";7239532785;Ne;0;1;0;1
15614;Žiburėlis;"4 klasė";9676316394;Ne;0;1;0;1
15615;Žiburėlis;"4 klasė";8942909201;Ne;2;1;0;3
15616;Žiburėlis;"4 klasė";3493549126;Ne;0;22;0;22
15617;Žiburėlis;"4 klasė";6088424692;Ne;0;22;0;22
15618;Žiburėlis;"4 klasė";5999075406;Ne;0;22;0;22
15619;Žiburėlis;"4 klasė";8539444386;Ne;0;1;0;1
15620;Žiburėlis;"4 klasė";3931688013;Ne;2;1;0;3
15621;Žiburėlis;"4 klasė";1769155142;Ne;0;1;0;1
15622;Aidas;Boružėlių;2027860670;Ne;10;1;0;11
15623;Aidas;Boružėlių;8915901727;Taip;1;1;0;2
15624;Aidas;Boružėlių;5311183877;Taip;4;3;0;7
15625;Aidas;Boružėlių;5962551687;Taip;1;1;0;2
15626;Aidas;Boružėlių;1538635985;Taip;13;3;0;16
15627;Aidas;Drugelių;3237698420;Taip;4;0;0;4
15628;Aidas;Drugelių;7094228848;Ne;4;0;0;4
15629;Aidas;Drugelių;5560434420;Ne;0;7;0;7
15630;Aidas;Drugelių;2070454339;Ne;0;12;0;12
15631;Aidas;Aitvariukų;1505697405;Ne;0;1;0;1
15632;Aidas;Aitvariukų;6835234112;Taip;0;2;0;2
15633;Aidas;Aitvariukų;3748420427;Taip;13;0;0;13
15634;Aidas;"Meškučių kl.";2970002617;Taip;0;22;0;22
15635;Aidas;"Meškučių kl.";4980030389;Ne;0;22;0;22
15636;Aidas;"Meškučių kl.";7803641933;Ne;5;0;0;5
15637;Aidas;"Meškučių kl.";9719250101;Ne;5;0;0;5
15638;Aidas;"Gaidelių kl.";2501187241;Ne;0;1;0;1
15639;Aidas;"Gaidelių kl.";6213577188;Ne;0;2;0;2
15640;Aidas;"Gaidelių kl.";9057435844;Ne;4;0;0;4
15641;Aidas;"Gaidelių kl.";2681438925;Ne;0;1;0;1
15642;Aidas;"Gaidelių kl.";2234931428;Ne;0;22;0;22
15643;Aidas;"Kiškelių kl";5388697695;Ne;0;1;0;1
15644;Aidas;"Kiškelių kl";7354905114;Ne;5;2;0;7
15645;Aidas;"Kiškelių kl";9613466086;Taip;0;22;0;22
15646;Aidas;"Ančiukų kl.";63508565206;Ne;0;3;0;3
15647;Aidas;"Ančiukų kl.";1079077463;Taip;0;1;0;1
15648;Aidas;"Ančiukų kl.";3194974747;Ne;5;1;0;6
15649;Aidas;"Ančiukų kl.";72751441075;Taip;5;1;0;6
15650;Aidas;"Ančiukų kl.";3366848846;Taip;0;3;0;3
15651;Aidas;"Ančiukų kl.";2954393415;Taip;3;9;0;12
15652;Aidas;"Pelėdžiukų kl.";3279914631;Ne;0;2;0;2
15653;Aidas;"Pelėdžiukų kl.";2945444897;Taip;0;3;0;3
15654;Aidas;"Papūgėlių kl.";3447250754;Ne;22;0;0;22
15655;Aidas;"Papūgėlių kl.";2184123290;Taip;4;0;0;4
15656;Aidas;"Papūgėlių kl.";4372628947;Ne;0;4;0;4
15657;Aidas;"Papūgėlių kl.";7821044288;Ne;0;3;0;3
15658;Aidas;"Papūgėlių kl.";1322335360;Taip;0;1;0;1
15659;Aidas;"Papūgėlių kl.";3808707012;Ne;0;1;0;1
15660;Aidas;"Papūgėlių kl.";5309862220;Taip;0;3;0;3
15661;Aidas;"Saulutės kl.";1535004699;Ne;0;14;0;14
15662;Aidas;"Saulutės kl.";62142659591;Ne;0;3;0;3
15663;Aidas;"Saulutės kl.";74897451962;Taip;0;6;0;6
15664;Aidas;"Saulutės kl.";4890362155;Ne;0;1;0;1
15665;Aidas;"Saulutės kl.";6778658540;Taip;0;1;0;1
15666;Aidas;"Saulutės kl.";88721781220;Ne;4;1;0;5
15667;Aidas;"Saulutės kl.";3127870635;Taip;8;0;0;8
15668;Aidas;"Saulutės kl.";1999375828;Taip;0;15;0;15
15669;Aidas;"Saulutės kl.";7013192521;Ne;0;1;0;1
15670;Aidas;"Katinėlių kl.";6356218442;Ne;0;1;0;1
15671;Aidas;"Katinėlių kl.";4990112920;Taip;0;1;0;1
15672;Aidas;"Katinėlių kl.";92425322676;Ne;0;1;0;1
15673;Aidas;"Katinėlių kl.";4081645294;Ne;0;2;0;2
15674;Aidas;"Katinėlių kl.";81654551230;Taip;0;6;0;6
15675;Aidas;"Katinėlių kl.";9944901942;Ne;0;4;0;4
15676;Bangelė;Aštuonkojai;1953702121;Taip;4;0;0;4
15677;Bangelė;Aštuonkojai;1377575533;Taip;17;0;0;17
15678;Bangelė;Aštuonkojai;7059603451;Taip;0;4;0;4
15679;Bangelė;Aštuonkojai;4342844311;Taip;5;0;0;5
15680;Bangelė;Aštuonkojai;2045465669;Taip;0;12;0;12
15681;Bangelė;Aštuonkojai;4865289474;Taip;22;0;0;22
15682;Bangelė;Aštuonkojai;5135762163;Ne;0;0;21;21
15683;Bangelė;Aštuonkojai;6559186441;Taip;0;0;20;20
15684;Bangelė;Aštuonkojai;1053744221;Taip;20;0;0;20
15685;Bangelė;Aštuonkojai;95548866362;Taip;0;10;0;10
15686;Bangelė;Aštuonkojai;7263228478;Taip;0;6;3;9
15687;Bangelė;Aštuonkojai;4187165474;Taip;6;0;1;7
15688;Bangelė;Aštuonkojai;1594486275;Taip;4;3;0;7
15689;Bangelė;Aštuonkojai;6508452044;Taip;7;0;0;7
15690;Bangelė;Aštuonkojai;6739499483;Taip;15;2;0;17
15691;Bangelė;Delfinukai,;2503946448;Taip;7;0;0;7
15692;Bangelė;Delfinukai,;2027892816;Taip;0;1;0;1
15693;Bangelė;Delfinukai,;3338203753;Taip;9;0;0;9
15694;Bangelė;Delfinukai,;9150185864;Taip;11;3;0;14
15695;Bangelė;Delfinukai,;9341038058;Taip;0;1;0;1
15696;Bangelė;Delfinukai,;6173470021;Taip;9;0;0;9
15697;Bangelė;Delfinukai,;1728085772;Taip;17;0;0;17
15698;Bangelė;Delfinukai,;55668308050;Taip;0;19;0;19
15699;Bangelė;Delfinukai,;1032881464;Ne;5;0;0;5
15700;Bangelė;Delfinukai,;1377734102;Taip;8;4;0;12
15701;Bangelė;Delfinukai,;5504180016;Taip;0;0;2;2
15702;Bangelė;Delfinukai,;6927540308;Taip;0;1;0;1
15703;Bangelė;Delfinukai,;4122927034;Ne;9;0;0;9
15704;Bangelė;Delfinukai,;4401389067;Ne;3;0;1;4
15705;Bangelė;Delfinukai,;9464115339;Taip;9;3;0;12
15706;Bangelė;Delfinukai,;5034268767;Taip;0;9;0;9
15707;Bangelė;Delfinukai,;6026399355;Taip;9;0;0;9
15708;Bangelė;"Saulės spindulėliai";81379253837;Ne;6;0;7;13
15709;Bangelė;"Saulės spindulėliai";83691968186;Taip;0;10;0;10
15710;Bangelė;"Saulės spindulėliai";76618850202;Taip;0;5;0;5
15711;Bangelė;"Saulės spindulėliai";84855013193;Taip;0;1;0;1
15712;Bangelė;"Saulės spindulėliai";68082711504;Taip;0;1;0;1
15713;Bangelė;"Saulės spindulėliai";24895047229;Taip;9;5;0;14
15714;Bangelė;"Saulės spindulėliai";1593861817;Taip;0;4;0;4
15715;Bangelė;"Saulės spindulėliai";45145282759;Ne;0;0;5;5
15716;Bangelė;"Saulės spindulėliai";1312545465;Taip;5;1;0;6
15717;Bangelė;"Saulės spindulėliai";1862514267;Taip;0;1;0;1
15718;Bangelė;"Saulės spindulėliai";61812452736;Taip;3;0;2;5
15719;Bangelė;"Pingvinukai ";1390623903;Taip;0;2;0;2
15720;Bangelė;"Pingvinukai ";6145050734;Taip;13;0;0;13
15721;Bangelė;"Pingvinukai ";3634678954;Taip;14;0;0;14
15722;Bangelė;"Pingvinukai ";2156837975;Taip;8;0;5;13
15723;Bangelė;"Pingvinukai ";3063439996;Ne;18;0;0;18
15724;Bangelė;"Pingvinukai ";6953698592;Taip;13;0;0;13
15725;Bangelė;"Pingvinukai ";1754002501;Taip;5;0;0;5
15726;Bangelė;"Pingvinukai ";1351714626;Taip;8;0;0;8
15727;Bangelė;"Pingvinukai ";8336001702;Ne;0;15;0;15
15728;Bangelė;"Pingvinukai ";5546256869;Taip;6;9;0;15
15729;Bangelė;"Pingvinukai ";8748218387;Taip;9;0;0;9
15730;Bangelė;"Pingvinukai ";6980232224;Ne;0;1;0;1
15731;Bangelė;"Pingvinukai ";9842873660;Ne;4;6;0;10
15732;Bangelė;"Pingvinukai ";3696611509;Taip;22;0;0;22
15733;Bangelė;"Pingvinukai ";3022508446;Taip;0;0;1;1
15734;Bangelė;"Pingvinukai ";9788923823;Taip;9;2;0;11
15735;Bangelė;"Pingvinukai ";6091573086;Taip;17;4;0;21
15736;Bangelė;"Pingvinukai ";7136625230;Taip;5;2;0;7
15737;Bangelė;"Pingvinukai ";2858929915;Taip;0;5;1;6
15738;Bangelė;"Pingvinukai ";9488932192;Taip;8;0;0;8
15739;Bangelė;"Jūros žvaigždutės ";6861123988;Taip;0;3;0;3
15740;Bangelė;"Jūros žvaigždutės ";2658414287;Taip;10;0;0;10
15741;Bangelė;"Jūros žvaigždutės ";8758933649;Taip;13;0;0;13
15742;Bangelė;"Jūros žvaigždutės ";9041585534;Taip;18;0;0;18
15743;Bangelė;"Jūros žvaigždutės ";4338067260;Taip;7;1;0;8
15744;Bangelė;"Jūros žvaigždutės ";4412780063;Taip;4;0;2;6
15745;Bangelė;"Jūros žvaigždutės ";9009809585;Ne;0;5;0;5
15746;Bangelė;"Jūros žvaigždutės ";6044653707;Taip;0;1;0;1
15747;Bangelė;"Jūros žvaigždutės ";1915827035;Taip;0;1;0;1
15748;Bangelė;"Jūros žvaigždutės ";7685394517;Taip;0;0;2;2
15749;Bangelė;"Jūros žvaigždutės ";9706351115;Taip;7;0;0;7
15750;Bangelė;"Jūros žvaigždutės ";3991021350;Ne;8;0;4;12
15751;Bangelė;"Jūros žvaigždutės ";3990966706;Taip;4;11;0;15
15752;Bangelė;"Jūros žvaigždutės ";2764009011;Taip;1;0;0;1
15753;Bangelė;"Jūros žvaigždutės ";8799415648;Taip;7;11;1;19
15754;Bangelė;"Jūros žvaigždutės ";7230987338;Taip;0;0;4;4
15755;Bangelė;"Jūros žvaigždutės ";7337449523;Taip;19;0;1;20
15756;Bangelė;"Jūros žvaigždutės ";8316505307;Taip;0;0;4;4
15757;Bangelė;"Jūros žvaigždutės ";5190563034;Taip;22;0;0;22
15758;Bangelė;Žuvytės;9983202427;Ne;0;1;0;1
15759;Bangelė;Žuvytės;47454787439;Taip;0;0;1;1
15760;Bangelė;Žuvytės;2112394008;Taip;11;0;0;11
15761;Bangelė;Žuvytės;8836861853;Taip;0;2;0;2
15762;Bangelė;Žuvytės;6712145066;Taip;10;0;0;10
15763;Bangelė;Žuvytės;1528387105;Taip;0;4;0;4
15764;Bangelė;Žuvytės;4506651162;Taip;0;0;7;7
15765;Bangelė;Žuvytės;9672505885;Ne;0;0;16;16
15766;Bangelė;Žuvytės;7248631013;Taip;11;0;0;11
15767;Bangelė;Žuvytės;7723290276;Taip;7;0;0;7
15768;Bangelė;Žuvytės;2872188915;Taip;2;0;0;2
15769;Bangelė;Žuvytės;9822287576;Taip;8;12;2;22
15770;Bangelė;Žuvytės;7375004714;Ne;0;0;1;1
15771;Bangelė;Žuvytės;7701956270;Taip;10;12;0;22
15772;Bangelė;Žuvytės;1367082230;Taip;14;0;0;14
15773;Bangelė;Žuvytės;1348995498;Ne;0;7;0;7
15774;Bangelė;Žuvytės;2017886238;Taip;10;0;0;10
15775;Bangelė;Žuvytės;8149880453;Taip;0;0;1;1
15776;Bangelė;Ruoniai;76353372848;Taip;0;0;1;1
15777;Bangelė;Ruoniai;99771696381;Taip;0;1;0;1
15778;Bangelė;Ruoniai;17608442103;Taip;14;0;0;14
15779;Bangelė;Ruoniai;1189143700;Taip;0;0;1;1
15780;Bangelė;Ruoniai;84797019693;Ne;0;4;0;4
15781;Bangelė;Ruoniai;99823581960;Taip;0;1;0;1
15782;Bangelė;Ruoniai;2423625777;Taip;0;12;0;12
15783;Bangelė;Ruoniai;1823592268;Taip;8;0;0;8
15784;Bangelė;Ruoniai;77615973000;Taip;0;0;2;2
15785;Bangelė;Ruoniai;411039166;Taip;0;6;0;6
15786;Bangelė;Ruoniai;3115177810;Ne;4;0;2;6
15787;Bangelė;Ruoniai;1790881495;Taip;0;3;0;3
15788;Bangelė;Ruoniai;7114709352;Taip;4;3;0;7
15789;Bangelė;Ruoniai;5159962168;Taip;22;0;0;22
15790;Bangelė;Ruoniai;1766156349;Taip;0;2;0;2
15791;Bangelė;Ruoniai;1065164865;Taip;0;0;13;13
15792;Bangelė;Ruoniai;2195543161;Ne;8;0;0;8
15793;Bangelė;Ruoniai;42739113312;Ne;0;0;4;4
15794;Bangelė;"Pagrandukai ";4250589212;Taip;0;0;19;19
15795;Bangelė;"Pagrandukai ";4222017733;Taip;0;15;0;15
15796;Bangelė;"Pagrandukai ";4036461205;Taip;4;0;0;4
15797;Bangelė;"Pagrandukai ";7434358474;Taip;0;12;0;12
15798;Bangelė;"Pagrandukai ";6216334243;Taip;8;4;0;12
15799;Bangelė;"Pagrandukai ";9801978617;Ne;0;2;0;2
15800;Bangelė;"Pagrandukai ";7434879947;Taip;12;0;0;12
15801;Bangelė;"Pagrandukai ";2491928697;Taip;0;3;0;3
15802;Bangelė;"Pagrandukai ";6819322060;Taip;3;0;0;3
15803;Bangelė;"Pagrandukai ";9790680407;Taip;5;0;0;5
15804;Bangelė;"Pagrandukai ";8575020060;Taip;0;2;0;2
15805;Bangelė;"Pagrandukai ";5747403413;Ne;0;16;0;16
15806;Bangelė;"Pagrandukai ";5994720767;Taip;0;9;0;9
15807;Bangelė;"Pagrandukai ";1940743710;Taip;8;12;0;20
15808;Bangelė;"Pagrandukai ";6480681705;Taip;0;4;0;4
15809;Gėlynas;PAKALNUTĖ;6375754699;Ne;0;0;1;1
15810;Gėlynas;PAKALNUTĖ;5145396320;Taip;6;0;3;9
15811;Gėlynas;PAKALNUTĖ;2349352560;Taip;2;0;2;4
15812;Gėlynas;PAKALNUTĖ;4445250490;Taip;0;2;0;2
15813;Gėlynas;PAKALNUTĖ;1897547388;Taip;0;6;0;6
15814;Gėlynas;PAKALNUTĖ;9911225363;Taip;5;2;0;7
15815;Gėlynas;PAKALNUTĖ;2400929266;Taip;0;0;1;1
15816;Gėlynas;PAKALNUTĖ;1257113113;Taip;5;0;0;5
15817;Gėlynas;PAKALNUTĖ;6898127005;Ne;0;6;0;6
15818;Gėlynas;PAKALNUTĖ;2906909558;Taip;5;0;0;5
15819;Gėlynas;PAKALNUTĖ;3365442661;Taip;13;0;0;13
15820;Gėlynas;PAKALNUTĖ;77283628988;Ne;9;5;0;14
15821;Gėlynas;PAKALNUTĖ;6528464599;Taip;5;0;2;7
15822;Gėlynas;PAKALNUTĖ;8464074679;Taip;0;0;5;5
15823;Gėlynas;PAKALNUTĖ;5395474698;Ne;0;8;0;8
15824;Gėlynas;PAKALNUTĖ;90046802421;Taip;0;6;0;6
15825;Gėlynas;PAKALNUTĖ;8615943743;Taip;0;3;0;3
15826;Gėlynas;PAKALNUTĖ;7814357385;Taip;0;1;0;1
15827;Gėlynas;PAKALNUTĖ;1674569569;Taip;3;1;0;4
15828;Gėlynas;PAKALNUTĖ;5695333666;Ne;5;6;0;11
15829;Gėlynas;VARPELIS;72991081966;Taip;4;9;0;13
15830;Gėlynas;VARPELIS;72544014665;Taip;8;0;4;12
15831;Gėlynas;VARPELIS;93919808581;Taip;12;3;0;15
15832;Gėlynas;VARPELIS;31532261756;Taip;0;10;0;10
15833;Gėlynas;VARPELIS;7735904549;Ne;3;1;0;4
15834;Gėlynas;VARPELIS;85912494214;Taip;0;5;0;5
15835;Gėlynas;VARPELIS;22067595840;Taip;14;0;0;14
15836;Gėlynas;VARPELIS;91530210644;Ne;0;0;1;1
15837;Gėlynas;VARPELIS;75222833700;Taip;10;0;0;10
15838;Gėlynas;VARPELIS;95681874019;Taip;0;1;0;1
15839;Gėlynas;VARPELIS;40702362906;Taip;0;12;0;12
15840;Gėlynas;VARPELIS;1406567756;Taip;0;1;0;1
15841;Gėlynas;VARPELIS;23134075402;Taip;3;0;1;4
15842;Gėlynas;VARPELIS;2100188574;Taip;0;3;0;3
15843;Gėlynas;RAKTAŽOLĖ;1797681067;Ne;0;0;3;3
15844;Gėlynas;RAKTAŽOLĖ;1117528954;Taip;10;0;0;10
15845;Gėlynas;RAKTAŽOLĖ;57429063547;Ne;9;2;0;11
15846;Gėlynas;RAKTAŽOLĖ;7796794153;Ne;0;0;3;3
15847;Gėlynas;RAKTAŽOLĖ;6264361257;Ne;9;0;0;9
15848;Gėlynas;RAKTAŽOLĖ;1754734306;Ne;0;4;0;4
15849;Gėlynas;RAKTAŽOLĖ;84546885977;Ne;0;7;0;7
15850;Gėlynas;RAKTAŽOLĖ;5135747448;Taip;0;1;0;1
15851;Gėlynas;RAKTAŽOLĖ;7808971151;Ne;0;7;0;7
15852;Gėlynas;RAKTAŽOLĖ;1036951275;Taip;0;0;3;3
15853;Gėlynas;RAKTAŽOLĖ;7337987259;Taip;0;5;0;5
15854;Gėlynas;RAKTAŽOLĖ;9026298982;Ne;0;5;0;5
15855;Gėlynas;RAKTAŽOLĖ;4382465307;Taip;9;3;0;12
15856;Gėlynas;RAKTAŽOLĖ;7562201835;Taip;0;1;0;1
15857;Gėlynas;RAKTAŽOLĖ;3572020585;Taip;2;0;0;2
15858;Gėlynas;RAKTAŽOLĖ;1557503831;Taip;0;6;0;6
15859;Gėlynas;RAKTAŽOLĖ;2417880374;Taip;0;0;2;2
15860;Gėlynas;RAKTAŽOLĖ;5634213306;Taip;5;0;0;5
15861;Gėlynas;RAKTAŽOLĖ;3491517766;Taip;3;4;0;7
15862;Gėlynas;SAULĖGRĄŽA;1995694892;Taip;0;0;2;2
15863;Gėlynas;SAULĖGRĄŽA;1191494598;Taip;0;0;7;7
15864;Gėlynas;SAULĖGRĄŽA;1407350449;Taip;9;0;0;9
15865;Gėlynas;SAULĖGRĄŽA;1676904275;Ne;11;0;0;11
15866;Gėlynas;SAULĖGRĄŽA;85310323038;Taip;6;0;0;6
15867;Gėlynas;SAULĖGRĄŽA;47220216751;Taip;0;1;0;1
15868;Gėlynas;SAULĖGRĄŽA;2099722437;Taip;0;1;0;1
15869;Gėlynas;SAULĖGRĄŽA;86881175896;Ne;11;0;0;11
15870;Gėlynas;SAULĖGRĄŽA;1053422007;Ne;7;0;1;8
15871;Gėlynas;SAULĖGRĄŽA;1608626732;Taip;8;2;0;10
15872;Gėlynas;SAULĖGRĄŽA;44391516295;Taip;1;0;0;1
15873;Gėlynas;SAULĖGRĄŽA;17587435701;Taip;0;1;0;1
15874;Gėlynas;SAULĖGRĄŽA;1363040744;Taip;0;0;3;3
15875;Gėlynas;SAULĖGRĄŽA;2018911523;Taip;0;0;22;22
15876;Gėlynas;SAULĖGRĄŽA;8324564359;Taip;7;0;0;7
15877;Gėlynas;SAULĖGRĄŽA;1004866224;Ne;0;4;0;4
15878;Gėlynas;RAMUNĖLĖ;6451922757;Taip;6;0;1;7
15879;Gėlynas;RAMUNĖLĖ;3549079170;Ne;5;0;3;8
15880;Gėlynas;RAMUNĖLĖ;4983822000;Ne;0;0;4;4
15881;Gėlynas;RAMUNĖLĖ;2742456983;Ne;8;0;0;8
15882;Gėlynas;RAMUNĖLĖ;5124029118;Taip;0;14;0;14
15883;Gėlynas;RAMUNĖLĖ;6815740588;Ne;0;13;0;13
15884;Gėlynas;RAMUNĖLĖ;5541707540;Taip;5;0;0;5
15885;Gėlynas;RAMUNĖLĖ;4824667762;Taip;0;2;0;2
15886;Gėlynas;RAMUNĖLĖ;2141722631;Taip;0;11;0;11
15887;Gėlynas;RAMUNĖLĖ;1505666690;Taip;5;0;0;5
15888;Gėlynas;RAMUNĖLĖ;3492361041;Taip;4;0;10;14
15889;Gėlynas;RAMUNĖLĖ;4505012978;Taip;0;9;0;9
15890;Gėlynas;RAMUNĖLĖ;3606076029;Taip;0;8;0;8
15891;Gėlynas;RAMUNĖLĖ;9305282699;Ne;0;13;0;13
15892;Gėlynas;ŽIBUTĖ;1015554617;Taip;5;0;0;5
15893;Gėlynas;ŽIBUTĖ;2377323648;Taip;7;0;1;8
15894;Gėlynas;ŽIBUTĖ;5320531856;Taip;10;0;0;10
15895;Gėlynas;ŽIBUTĖ;9724668402;Taip;0;1;0;1
15896;Gėlynas;ŽIBUTĖ;1822933936;Taip;8;6;0;14
15897;Gėlynas;ŽIBUTĖ;8999346908;Taip;9;10;0;19
15898;Gėlynas;ŽIBUTĖ;6114995335;Taip;13;0;0;13
15899;Gėlynas;ŽIBUTĖ;8444505017;Ne;6;14;0;20
15900;Gėlynas;ŽIBUTĖ;7998013477;Ne;12;0;0;12
15901;Gėlynas;ŽIBUTĖ;9330385153;Ne;7;0;0;7
15902;Gėlynas;ŽIBUTĖ;2784709117;Ne;7;0;0;7
15903;Gėlynas;ŽIBUTĖ;9462822190;Ne;5;3;0;8
15904;Gėlynas;ŽIBUTĖ;9508507084;Taip;5;3;0;8
15905;Gėlynas;ŽIBUTĖ;5291444399;Ne;4;0;0;4
15906;Gėlynas;ŽIBUTĖ;9252696260;Taip;0;2;0;2
15907;Gėlynas;ŽIBUTĖ;4075611307;Taip;8;0;0;8
15908;Obelėlė;Bildukai;43664898514;Taip;0;0;3;3
15909;Obelėlė;Bildukai;58388471530;Taip;7;0;0;7
15910;Obelėlė;Bildukai;34628612328;Taip;4;0;2;6
15911;Obelėlė;Bildukai;2024391462;Taip;2;0;0;2
15912;Obelėlė;Bildukai;52857531341;Taip;4;0;0;4
15913;Obelėlė;Bildukai;68222818886;Ne;0;0;1;1
15914;Obelėlė;Bildukai;1831642058;Taip;9;4;0;13
15915;Obelėlė;Bildukai;13913516066;Ne;9;0;4;13
15916;Obelėlė;Bildukai;14986936220;Taip;0;0;3;3
15917;Obelėlė;Bildukai;29677456066;Taip;0;0;3;3
15918;Obelėlė;Bildukai;646883449;Taip;0;0;1;1
15919;Obelėlė;Bildukai;89380447507;Taip;0;0;1;1
15920;Obelėlė;Bildukai;19376935875;Taip;6;0;4;10
15921;Obelėlė;Gudručiai;2014314139;Taip;4;0;1;5
15922;Obelėlė;Gudručiai;9900484892;Taip;14;0;2;16
15923;Obelėlė;Gudručiai;9586720282;Taip;4;0;3;7
15924;Obelėlė;Gudručiai;9567704282;Taip;6;0;0;6
15925;Obelėlė;Gudručiai;9305279614;Taip;7;1;0;8
15926;Obelėlė;Gudručiai;4015702815;Taip;10;0;1;11
15927;Obelėlė;Gudručiai;5141585309;Taip;0;0;4;4
15928;Obelėlė;Gudručiai;9736557012;Taip;0;0;4;4
15929;Obelėlė;Gudručiai;4451814487;Taip;4;0;0;4
15930;Obelėlė;Gudručiai;2053807216;Taip;12;0;0;12
15931;Obelėlė;Gudručiai;2204293216;Taip;0;0;1;1
15932;Obelėlė;Gudručiai;1184082097;Taip;17;0;0;17
15933;Obelėlė;Gudručiai;6466755394;Taip;0;9;0;9
15934;Obelėlė;Gudručiai;2533715287;Taip;0;0;8;8
15935;Obelėlė;Gudručiai;1312484983;Taip;22;0;0;22
15936;Obelėlė;Gudručiai;1598785483;Taip;17;0;0;17
15937;Obelėlė;Drugeliai;5960204860;Taip;4;9;0;13
15938;Obelėlė;Drugeliai;1874574001;Taip;2;0;0;2
15939;Obelėlė;Drugeliai;1271351257;Taip;15;4;0;19
15940;Obelėlė;Drugeliai;1980250599;Taip;3;0;0;3
15941;Obelėlė;Drugeliai;1185247095;Taip;0;0;1;1
15942;Obelėlė;Drugeliai;4111486929;Taip;0;0;1;1
15943;Obelėlė;Drugeliai;8115772385;Taip;0;0;1;1
15944;Obelėlė;Drugeliai;2018689468;Taip;6;0;1;7
15945;Obelėlė;Drugeliai;7120041402;Taip;0;0;5;5
15946;Obelėlė;Drugeliai;9059791812;Taip;5;0;2;7
15947;Obelėlė;Drugeliai;4835765774;Taip;0;0;1;1
15948;Obelėlė;Drugeliai;8173154620;Taip;0;1;1;2
15949;Obelėlė;Drugeliai;46597815116;Taip;8;0;1;9
15950;Obelėlė;Drugeliai;65578250853;Taip;8;0;1;9
15951;Obelėlė;Drugeliai;1044733634;Taip;4;0;0;4
15952;Obelėlė;Drugeliai;1847501295;Taip;1;0;1;2
15953;Obelėlė;Drugeliai;6006139132;Taip;0;6;0;6
15954;Obelėlė;Drugeliai;6676145522;Taip;4;0;3;7
15955;Obelėlė;Drugeliai;6693601673;Taip;18;0;0;18
15956;Obelėlė;Pasakaitė;1695933896;Taip;5;0;1;6
15957;Obelėlė;Pasakaitė;1833543299;Taip;0;1;0;1
15958;Obelėlė;Pasakaitė;1555780072;Taip;0;0;3;3
15959;Obelėlė;Pasakaitė;77743243622;Taip;0;0;1;1
15960;Obelėlė;Pasakaitė;1543298097;Taip;3;0;0;3
15961;Obelėlė;Pasakaitė;79601449969;Ne;3;0;1;4
15962;Obelėlė;Pasakaitė;3330983614;Taip;4;0;3;7
15963;Obelėlė;Pasakaitė;4257479486;Ne;2;0;5;7
15964;Obelėlė;Pasakaitė;8394566707;Taip;0;0;3;3
15965;Obelėlė;Pasakaitė;9527363918;Taip;0;3;0;3
15966;Obelėlė;Pasakaitė;10939948244;Taip;0;1;2;3
15967;Obelėlė;Pasakaitė;1707652145;Taip;4;0;0;4
15968;Obelėlė;Pasakaitė;1141707374;Taip;0;0;4;4
15969;Obelėlė;Pasakaitė;6789881144;Taip;0;0;1;1
15970;Obelėlė;Pasakaitė;6253266504;Taip;10;0;0;10
15971;Obelėlė;Pasakaitė;9934596750;Ne;0;0;1;1
15972;Obelėlė;Pasakaitė;1893470952;Taip;2;0;5;7
15973;Obelėlė;Pasakaitė;7754276632;Taip;0;22;0;22
15974;Obelėlė;Svajokliai;6525446418;Taip;1;0;2;3
15975;Obelėlė;Svajokliai;2093164210;Taip;0;0;2;2
15976;Obelėlė;Svajokliai;8202131299;Taip;5;0;2;7
15977;Obelėlė;Svajokliai;58153232854;Taip;8;0;0;8
15978;Obelėlė;Svajokliai;57788788343;Taip;0;7;0;7
15979;Obelėlė;Svajokliai;2014450377;Taip;0;0;1;1
15980;Obelėlė;Svajokliai;5512990125;Taip;5;0;1;6
15981;Obelėlė;Svajokliai;1824412493;Taip;0;7;0;7
15982;Obelėlė;Svajokliai;2105005710;Taip;0;0;1;1
15983;Obelėlė;Svajokliai;31721462678;Ne;0;3;0;3
15984;Obelėlė;Svajokliai;52277220462;Ne;8;0;0;8
15985;Obelėlė;Svajokliai;1210385417;Taip;5;0;6;11
15986;Obelėlė;Svajokliai;8904956649;Ne;0;0;3;3
15987;Obelėlė;Svajokliai;82119081040;Taip;0;0;3;3
15988;Obelėlė;Svajokliai;1670594471;Ne;0;0;1;1
15989;Obelėlė;Svajokliai;1536889615;Taip;12;0;0;12
15990;Obelėlė;Svajokliai;1484822838;Taip;0;0;3;3
15991;Obelėlė;Smalsučiai;43103357250;Ne;0;0;2;2
15992;Obelėlė;Smalsučiai;1337679766;Taip;0;0;4;4
15993;Obelėlė;Smalsučiai;2107924334;Taip;5;0;0;5
15994;Obelėlė;Smalsučiai;75387550210;Taip;14;0;0;14
15995;Obelėlė;Smalsučiai;72224972200;Taip;0;3;0;3
15996;Obelėlė;Smalsučiai;1844067391;Taip;5;0;0;5
15997;Obelėlė;Smalsučiai;72467035839;Taip;0;7;0;7
15998;Obelėlė;Smalsučiai;3220190193;Ne;0;0;1;1
15999;Obelėlė;Smalsučiai;20691217408;Taip;0;0;1;1
16000;Obelėlė;Smalsučiai;35495444231;Ne;0;0;2;2
16001;Obelėlė;Smalsučiai;68776273648;Taip;0;0;3;3
16002;Obelėlė;Smalsučiai;1915402358;Taip;0;0;2;2
16003;Obelėlė;Smalsučiai;1758206243;Taip;0;0;1;1
16004;Obelėlė;Smalsučiai;78242377913;Taip;6;0;0;6
16005;Obelėlė;Pabiručiai;1547195948;Taip;0;6;1;7
16006;Obelėlė;Pabiručiai;1586544097;Taip;0;10;0;10
16007;Obelėlė;Pabiručiai;94350358246;Taip;0;0;1;1
16008;Obelėlė;Pabiručiai;74915473313;Taip;3;0;0;3
16009;Obelėlė;Pabiručiai;79388410820;Taip;10;4;0;14
16010;Obelėlė;Pabiručiai;40103909643;Taip;0;5;0;5
16011;Obelėlė;Pabiručiai;2662966388;Taip;3;0;0;3
16012;Obelėlė;Pabiručiai;2678719111;Taip;4;0;1;5
16013;Obelėlė;Pabiručiai;1420633482;Taip;0;0;3;3
16014;Obelėlė;Pabiručiai;1698995389;Taip;6;0;0;6
16015;Obelėlė;Pabiručiai;79669290078;Ne;0;0;1;1
16016;Obelėlė;Pabiručiai;31018018065;Taip;13;0;0;13
16017;Obelėlė;Pabiručiai;2015165566;Ne;0;10;0;10
16018;Obelėlė;Pabiručiai;8882103124;Taip;0;3;1;4
16019;Obelėlė;Pabiručiai;5471194804;Taip;0;13;0;13
16020;Obelėlė;Pabiručiai;69055416041;Taip;5;4;0;9
16021;Obelėlė;Pabiručiai;74455701543;Taip;16;0;0;16
16022;Obelėlė;Pabiručiai;74564453474;Taip;0;0;5;5
16023;Obelėlė;Strakaliukai;1706102918;Taip;0;0;2;2
16024;Obelėlė;Strakaliukai;2770477678;Taip;0;4;1;5
16025;Obelėlė;Strakaliukai;8754552660;Taip;0;20;2;22
16026;Obelėlė;Strakaliukai;8092024850;Taip;0;0;1;1
16027;Obelėlė;Strakaliukai;4251418414;Taip;4;0;0;4
16028;Obelėlė;Strakaliukai;7128421330;Taip;0;0;14;14
16029;Obelėlė;Strakaliukai;5943314566;Taip;0;22;0;22
16030;Obelėlė;Strakaliukai;3116100694;Taip;2;7;1;10
16031;Obelėlė;Strakaliukai;5326258755;Ne;0;0;11;11
16032;Obelėlė;Strakaliukai;5741823041;Taip;0;0;2;2
16033;Obelėlė;Strakaliukai;8050551266;Taip;10;0;4;14
16034;Obelėlė;Strakaliukai;7468335279;Taip;0;0;1;1
16035;Obelėlė;Strakaliukai;1180508643;Taip;0;0;1;1
16036;Obelėlė;Strakaliukai;7124393375;Taip;2;0;5;7
16037;Obelėlė;Strakaliukai;2571249434;Ne;10;0;0;10
16038;Obelėlė;Strakaliukai;7514587933;Taip;0;22;0;22
16039;Obelėlė;Strakaliukai;5001844064;Taip;0;3;0;3
16040;Obelėlė;Saulutė;98290583667;Ne;10;0;1;11
16041;Obelėlė;Saulutė;77954383604;Taip;9;0;2;11
16042;Obelėlė;Saulutė;1826138505;Taip;0;0;2;2
16043;Obelėlė;Saulutė;1987783063;Taip;4;0;1;5
16044;Obelėlė;Saulutė;38968623613;Taip;7;0;1;8
16045;Obelėlė;Saulutė;1741425229;Taip;8;0;0;8
16046;Obelėlė;Saulutė;1336592238;Taip;5;0;1;6
16047;Obelėlė;Saulutė;1240673124;Taip;10;0;0;10
16048;Obelėlė;Saulutė;24010838180;Taip;0;11;0;11
16049;Obelėlė;Saulutė;1935023634;Ne;13;0;1;14
16050;Obelėlė;Saulutė;1061262980;Taip;0;0;3;3
16051;Obelėlė;Saulutė;1352415596;Ne;0;0;3;3
16052;Obelėlė;Saulutė;6054898307;Taip;6;5;0;11
16053;Obelėlė;Saulutė;3076493150;Taip;0;2;0;2
16054;Obelėlė;Saulutė;1521926754;Ne;7;0;5;12
16055;Obelėlė;Saulutė;6720229368;Ne;0;9;3;12
16056;Obelėlė;Saulutė;1021948127;Taip;11;0;0;11
16057;Obelėlė;Saulutė;4107928390;Taip;0;0;6;6
16058;Obelėlė;Saulutė;4396725994;Taip;0;0;5;5
16059;Obelėlė;Rieduliukai;8173307704;Taip;0;22;0;22
16060;Obelėlė;Rieduliukai;6691540418;Taip;9;0;0;9
16061;Obelėlė;Rieduliukai;6008839269;Taip;8;2;0;10
16062;Obelėlė;Rieduliukai;4987747783;Taip;5;0;0;5
16063;Obelėlė;Rieduliukai;5085970254;Taip;0;0;2;2
16064;Obelėlė;Rieduliukai;8709758561;Ne;0;0;7;7
16065;Obelėlė;Rieduliukai;5739522736;Taip;0;0;3;3
16066;Obelėlė;Rieduliukai;2631405243;Taip;7;0;1;8
16067;Obelėlė;Rieduliukai;9796759067;Taip;8;4;0;12
16068;Obelėlė;Rieduliukai;6720808705;Taip;3;0;0;3
16069;Obelėlė;Rieduliukai;7850656031;Taip;5;0;2;7
16070;Obelėlė;Rieduliukai;9084969712;Taip;13;6;1;20
16071;Obelėlė;Žirniukai;5312394513;Taip;6;0;2;8
16072;Obelėlė;Žirniukai;7794072582;Taip;18;0;0;18
16073;Obelėlė;Žirniukai;9641297002;Taip;0;2;1;3
16074;Obelėlė;Žirniukai;8918176312;Taip;3;0;2;5
16075;Obelėlė;Žirniukai;9070960601;Taip;7;0;0;7
16076;Obelėlė;Žirniukai;7003947655;Taip;7;1;0;8
16077;Obelėlė;Žirniukai;3986892111;Taip;0;13;0;13
16078;Obelėlė;Žirniukai;1705232474;Taip;7;0;1;8
16079;Obelėlė;Žirniukai;5620250331;Taip;11;0;0;11
16080;Obelėlė;Žirniukai;5588467580;Taip;13;4;0;17
16081;Obelėlė;Žirniukai;6325027163;Taip;5;0;0;5
16082;Obelėlė;Žirniukai;8231489868;Taip;9;0;0;9
16083;Obelėlė;Žirniukai;4489212434;Taip;3;0;3;6
16084;Obelėlė;Žirniukai;8183287212;Taip;7;0;0;7
16085;Obelėlė;Žirniukai;8604451971;Taip;9;8;0;17
16086;Obelėlė;Bičiuliai;9031690002;Taip;11;0;4;15
16087;Obelėlė;Bičiuliai;3425736276;Taip;7;0;0;7
16088;Obelėlė;Bičiuliai;1507072248;Taip;7;8;0;15
16089;Obelėlė;Bičiuliai;5776116844;Taip;8;3;1;12
16090;Obelėlė;Bičiuliai;8487088625;Taip;12;1;1;14
16091;Obelėlė;Bičiuliai;1630067014;Taip;9;1;0;10
16092;Obelėlė;Bičiuliai;1537769810;Taip;7;0;0;7
16093;Obelėlė;Bičiuliai;8371648703;Taip;0;0;1;1
16094;Obelėlė;Bičiuliai;3517342646;Taip;14;0;1;15
16095;Obelėlė;Bičiuliai;8757731600;Taip;10;0;2;12
16096;Obelėlė;Bičiuliai;1419189517;Taip;3;0;1;4
16097;Obelėlė;Bičiuliai;8155712451;Ne;4;1;4;9
16098;Obelėlė;Bičiuliai;7934760271;Taip;14;0;0;14
16099;Obelėlė;Bičiuliai;4849175527;Taip;10;0;0;10
16100;Obelėlė;Bičiuliai;1362135757;Ne;8;0;3;11
16101;Obelėlė;Bičiuliai;3769993089;Taip;6;0;1;7
16102;Obelėlė;Bičiuliai;5374979248;Taip;4;0;2;6
16103;Obelėlė;Bičiuliai;5568285702;Taip;10;0;3;13
16104;Spygliukas;Bitutės;5827455834;Taip;4;0;0;4
16105;Spygliukas;Bitutės;9975117461;Taip;0;0;5;5
16106;Spygliukas;Bitutės;16828631895;Ne;3;0;2;5
16107;Spygliukas;Bitutės;4653108810;Ne;0;4;0;4
16108;Spygliukas;Bitutės;7421000718;Taip;5;0;3;8
16109;Spygliukas;Bitutės;8103481313;Taip;21;0;0;21
16110;Spygliukas;Bitutės;4430242310;Taip;3;3;0;6
16111;Spygliukas;Bitutės;1228469923;Ne;9;0;0;9
16112;Spygliukas;Bitutės;5022615426;Taip;0;13;0;13
16113;Spygliukas;Bitutės;7250958367;Taip;5;2;0;7
16114;Spygliukas;Bitutės;1679263120;Taip;4;0;0;4
16115;Spygliukas;Bitutės;9001243644;Taip;0;9;0;9
16116;Spygliukas;Bitutės;8646122773;Taip;8;5;3;16
16117;Spygliukas;Bitutės;2935281062;Taip;0;0;22;22
16118;Spygliukas;Bitutės;8992822256;Ne;7;1;1;9
16119;Spygliukas;Bitutės;1940209166;Ne;9;2;0;11
16120;Spygliukas;Bitutės;1855897974;Ne;0;1;0;1
16121;Spygliukas;Kiškučiai;1401951658;Ne;0;0;3;3
16122;Spygliukas;Kiškučiai;8802722601;Taip;0;2;5;7
16123;Spygliukas;Kiškučiai;6248409896;Ne;19;0;0;19
16124;Spygliukas;Kiškučiai;3416275094;Taip;0;0;3;3
16125;Spygliukas;Kiškučiai;1341333016;Taip;22;0;0;22
16126;Spygliukas;Kiškučiai;5493599614;Taip;0;9;2;11
16127;Spygliukas;Kiškučiai;4477402331;Taip;4;0;0;4
16128;Spygliukas;Kiškučiai;6917435881;Taip;6;3;0;9
16129;Spygliukas;Kiškučiai;3569857813;Taip;9;2;0;11
16130;Spygliukas;Kiškučiai;2772801133;Ne;0;0;6;6
16131;Spygliukas;Kiškučiai;5561426508;Taip;4;0;0;4
16132;Spygliukas;Kiškučiai;2177856916;Taip;13;0;4;17
16133;Spygliukas;Kiškučiai;6931145017;Taip;0;0;3;3
16134;Spygliukas;Kiškučiai;9285259322;Taip;8;0;0;8
16135;Spygliukas;Kiškučiai;8806126755;Taip;9;0;0;9
16136;Spygliukas;Kiškučiai;4245624629;Taip;0;0;3;3
16137;Spygliukas;Kiškučiai;6332646009;Taip;0;4;0;4
16138;Spygliukas;Kiškučiai;5765106914;Taip;9;0;0;9
16139;Spygliukas;Kiškučiai;8825264090;Taip;0;7;9;16
16140;Spygliukas;Boružėlės;1939828587;Taip;0;0;1;1
16141;Spygliukas;Boružėlės;1238940921;Taip;0;0;2;2
16142;Spygliukas;Boružėlės;93029375520;Taip;0;1;0;1
16143;Spygliukas;Boružėlės;1151844475;Taip;6;0;0;6
16144;Spygliukas;Boružėlės;4104158994;Taip;0;0;1;1
16145;Spygliukas;Boružėlės;10858715103;Taip;0;2;4;6
16146;Spygliukas;Boružėlės;1002603766;Taip;5;9;0;14
16147;Spygliukas;Boružėlės;1842315404;Taip;3;0;1;4
16148;Spygliukas;Boružėlės;73047963456;Taip;0;6;1;7
16149;Spygliukas;Boružėlės;92279064240;Taip;0;9;0;9
16150;Spygliukas;Boružėlės;1323720621;Taip;0;4;3;7
16151;Spygliukas;Boružėlės;30201229961;Ne;0;6;1;7
16152;Spygliukas;Boružėlės;79584454527;Taip;0;4;0;4
16153;Spygliukas;Boružėlės;1321926079;Taip;0;0;1;1
16154;Spygliukas;Boružėlės;9513387087;Ne;0;0;6;6
16155;Spygliukas;Boružėlės;1193015656;Taip;1;1;1;3
16156;Spygliukas;Ežiukai;1832756255;Taip;4;4;0;8
16157;Spygliukas;Ežiukai;9593700812;Taip;3;0;0;3
16158;Spygliukas;Ežiukai;2126162527;Taip;2;0;0;2
16159;Spygliukas;Ežiukai;1260920726;Ne;7;0;0;7
16160;Spygliukas;Ežiukai;42285404110;Taip;12;0;1;13
16161;Spygliukas;Ežiukai;2040903312;Taip;9;3;0;12
16162;Spygliukas;Ežiukai;3037648954;Taip;0;1;0;1
16163;Spygliukas;Ežiukai;1211969263;Taip;19;0;0;19
16164;Spygliukas;Ežiukai;7219659640;Taip;0;1;0;1
16165;Spygliukas;Ežiukai;1881745347;Taip;3;5;0;8
16166;Spygliukas;Ežiukai;53324066837;Ne;2;1;0;3
16167;Spygliukas;Ežiukai;9957292202;Taip;3;0;0;3
16168;Spygliukas;Ežiukai;1298381738;Taip;7;0;4;11
16169;Spygliukas;Ežiukai;7649832094;Ne;0;2;1;3
16170;Spygliukas;Ežiukai;5780485510;Taip;0;4;1;5
16171;Spygliukas;Ežiukai;8686118262;Taip;0;8;0;8
16172;Spygliukas;Ežiukai;5253108181;Taip;0;2;0;2
16173;Spygliukas;Ežiukai;3785469286;Taip;0;0;12;12
16174;Spygliukas;Ežiukai;84556142803;Taip;0;2;0;2
16175;Spygliukas;Geniukai;6242194100;Taip;0;0;1;1
16176;Spygliukas;Geniukai;4577592862;Taip;11;0;1;12
16177;Spygliukas;Geniukai;4721066953;Ne;0;0;8;8
16178;Spygliukas;Geniukai;4949371837;Taip;4;0;3;7
16179;Spygliukas;Geniukai;4650693672;Taip;0;7;0;7
16180;Spygliukas;Geniukai;6835488489;Ne;5;0;0;5
16181;Spygliukas;Geniukai;3658613027;Ne;11;0;0;11
16182;Spygliukas;Geniukai;2463585133;Taip;2;0;0;2
16183;Spygliukas;Geniukai;3365209400;Ne;0;4;3;7
16184;Spygliukas;Geniukai;6457632191;Taip;17;0;3;20
16185;Spygliukas;Geniukai;1691209405;Taip;8;0;0;8
16186;Spygliukas;Geniukai;5962360012;Taip;5;0;0;5
16187;Spygliukas;Geniukai;2739564216;Taip;0;0;5;5
16188;Spygliukas;Geniukai;4610504338;Taip;7;0;0;7
16189;Spygliukas;Geniukai;7900652746;Taip;7;1;0;8
16190;Spygliukas;Geniukai;5778081118;Taip;13;1;0;14
16191;Spygliukas;Geniukai;6000906766;Taip;0;0;22;22
16192;Spygliukas;Geniukai;50047868918;Ne;11;1;1;13
16193;Spygliukas;Riešutėliai;1227595604;Ne;0;7;0;7
16194;Spygliukas;Riešutėliai;21074122407;Taip;6;1;0;7
16195;Spygliukas;Riešutėliai;26697357569;Taip;0;1;0;1
16196;Spygliukas;Riešutėliai;84487759175;Taip;0;0;1;1
16197;Spygliukas;Riešutėliai;47077562116;Taip;10;0;0;10
16198;Spygliukas;Riešutėliai;12711940653;Taip;10;0;0;10
16199;Spygliukas;Riešutėliai;68487983068;Taip;0;0;6;6
16200;Spygliukas;Riešutėliai;1341415412;Taip;7;0;0;7
16201;Spygliukas;Riešutėliai;1122973994;Taip;3;0;0;3
16202;Spygliukas;Riešutėliai;45296663285;Taip;0;1;1;2
16203;Spygliukas;Riešutėliai;56991221970;Taip;11;1;0;12
16204;Spygliukas;Riešutėliai;1971162865;Taip;4;0;8;12
16205;Spygliukas;Riešutėliai;1076152986;Ne;2;1;0;3
16206;Spygliukas;Riešutėliai;97773415559;Taip;0;0;2;2
16207;Spygliukas;Riešutėliai;7020789651;Taip;8;0;1;9
16208;Spygliukas;Riešutėliai;77970187363;Taip;0;0;1;1
16209;Spygliukas;Riešutėliai;43541072654;Taip;3;0;4;7
16210;Spygliukas;Pelėdžiukai;57098709793;Taip;0;11;0;11
16211;Spygliukas;Pelėdžiukai;80768950728;Ne;0;3;0;3
16212;Spygliukas;Pelėdžiukai;28639466275;Taip;3;0;0;3
16213;Spygliukas;Pelėdžiukai;67896776952;Ne;5;1;0;6
16214;Spygliukas;Pelėdžiukai;88332181449;Taip;0;0;3;3
16215;Spygliukas;Pelėdžiukai;20248450562;Ne;2;0;1;3
16216;Spygliukas;Pelėdžiukai;90555084491;Ne;0;7;0;7
16217;Spygliukas;Pelėdžiukai;1012592509;Taip;5;0;0;5
16218;Spygliukas;Pelėdžiukai;1398592801;Ne;0;4;0;4
16219;Spygliukas;Pelėdžiukai;1482370515;Taip;8;2;0;10
16220;Spygliukas;Pelėdžiukai;35839138942;Taip;0;6;0;6
16221;Spygliukas;Zylutės;7271659513;Taip;1;7;0;8
16222;Spygliukas;Zylutės;8604767396;Ne;7;0;2;9
16223;Spygliukas;Zylutės;4634660174;Taip;4;0;0;4
16224;Spygliukas;Zylutės;4368224847;Taip;7;12;0;19
16225;Spygliukas;Zylutės;9316731983;Taip;0;2;0;2
16226;Spygliukas;Zylutės;5012876830;Taip;0;8;0;8
16227;Spygliukas;Zylutės;8708083787;Taip;0;12;0;12
16228;Spygliukas;Zylutės;7125425492;Taip;8;0;1;9
16229;Spygliukas;Zylutės;7928675053;Taip;9;0;0;9
16230;Spygliukas;Zylutės;4505044604;Ne;9;0;0;9
16231;Spygliukas;Zylutės;2989701249;Ne;4;0;3;7
16232;Spygliukas;Zylutės;6630979640;Taip;16;0;0;16
16233;Spygliukas;Zylutės;5214431060;Taip;0;0;1;1
16234;Spygliukas;Zylutės;9086986643;Ne;0;1;0;1
16235;Spygliukas;Zylutės;9052337501;Taip;5;2;0;7
16236;Spygliukas;Skruzdėliukai;8404929784;Taip;6;0;0;6
16237;Spygliukas;Skruzdėliukai;9070219319;Taip;3;4;0;7
16238;Spygliukas;Skruzdėliukai;8476882854;Taip;22;0;0;22
16239;Spygliukas;Skruzdėliukai;9112172144;Ne;15;1;0;16
16240;Spygliukas;Skruzdėliukai;9413950200;Taip;0;6;0;6
16241;Spygliukas;Skruzdėliukai;1333556956;Taip;0;7;2;9
16242;Spygliukas;Skruzdėliukai;4835818382;Taip;13;1;0;14
16243;Spygliukas;Skruzdėliukai;8869320003;Taip;17;0;0;17
16244;Spygliukas;Skruzdėliukai;8270525839;Taip;8;0;0;8
16245;Spygliukas;Skruzdėliukai;3697691132;Taip;22;0;0;22
16246;Spygliukas;Skruzdėliukai;4053158210;Taip;12;0;0;12
16247;Spygliukas;Skruzdėliukai;9444569348;Taip;0;0;1;1
16248;Spygliukas;Voveraitės;5049529300;Ne;9;0;0;9
16249;Spygliukas;Voveraitės;1987926577;Ne;0;0;1;1
16250;Spygliukas;Voveraitės;1773639994;Ne;0;0;5;5
16251;Spygliukas;Voveraitės;2066739772;Ne;9;0;1;10
16252;Spygliukas;Voveraitės;8596667547;Ne;7;0;1;8
16253;Spygliukas;Voveraitės;1590677993;Ne;7;0;3;10
16254;Spygliukas;Voveraitės;1935233612;Ne;0;4;0;4
16255;Spygliukas;Voveraitės;8801225066;Ne;5;0;2;7
16256;Spygliukas;Voveraitės;8453683673;Ne;0;0;2;2
16257;Spygliukas;Voveraitės;1045253540;Ne;0;0;1;1
16258;Spygliukas;Voveraitės;8048474808;Ne;22;0;0;22
16259;Spygliukas;Voveraitės;52719709314;Ne;0;3;0;3
16260;Spygliukas;Voveraitės;45881077771;Ne;0;5;0;5
16261;Spygliukas;Giliukų;6405496193;Taip;0;0;6;6
16262;Spygliukas;Giliukų;7113913750;Ne;0;0;2;2
16263;Spygliukas;Giliukų;9219327706;Taip;4;0;0;4
16264;Spygliukas;Giliukų;1426267001;Taip;4;0;0;4
16265;Spygliukas;Giliukų;1234195733;Taip;9;5;0;14
16266;Spygliukas;Giliukų;8189748611;Ne;15;1;0;16
16267;Spygliukas;Giliukų;9945315122;Taip;14;0;1;15
16268;Spygliukas;Giliukų;6758336405;Taip;14;0;6;20
16269;Spygliukas;Giliukų;6587957213;Taip;0;8;0;8
16270;Spygliukas;Giliukų;8877911083;Taip;21;0;0;21
16271;Spygliukas;Giliukų;7897603878;Taip;0;7;0;7
16272;Spygliukas;Giliukų;1177439438;Taip;0;1;2;3
16273;Spygliukas;Giliukų;7313828707;Taip;6;1;0;7
16274;Spygliukas;Giliukų;3668191959;Taip;17;0;0;17
16275;Spygliukas;Giliukų;2272141731;Taip;3;5;0;8
16276;Spygliukas;Giliukų;7611880543;Ne;8;0;1;9
16277;Vieversys;Žirniukai;8129139979;Taip;9;0;0;9
16278;Vieversys;Žirniukai;1149316471;Taip;0;3;0;3
16279;Vieversys;Žirniukai;6787960120;Ne;11;0;0;11
16280;Vieversys;Žirniukai;9612415733;Taip;9;0;0;9
16281;Vieversys;Žirniukai;5917328379;Ne;13;0;0;13
16282;Vieversys;Žirniukai;53977164888;Taip;2;4;0;6
16283;Vieversys;Žirniukai;82594887399;Taip;0;3;0;3
16284;Vieversys;Žirniukai;7500147648;Taip;0;1;0;1
16285;Vieversys;Žirniukai;2621046003;Taip;9;0;0;9
16286;Vieversys;Žirniukai;9835682858;Taip;0;0;22;22
16287;Vieversys;Žirniukai;5286521728;Taip;9;7;0;16
16288;Vieversys;Žirniukai;8038341998;Taip;11;0;0;11
16289;Vieversys;Žirniukai;1247565595;Taip;8;0;0;8
16290;Vieversys;Žirniukai;6720355390;Ne;17;0;0;17
16291;Vieversys;Žirniukai;4313822180;Taip;8;1;0;9
16292;Vieversys;Žirniukai;4455039401;Taip;8;0;0;8
16293;Vieversys;Žirniukai;5810605263;Taip;2;3;4;9
16294;Vieversys;Varpelių;38299255111;Taip;4;1;0;5
16295;Vieversys;Varpelių;34168958939;Taip;0;9;0;9
16296;Vieversys;Varpelių;35783466157;Taip;0;1;0;1
16297;Vieversys;Varpelių;25198979253;Taip;0;1;0;1
16298;Vieversys;Varpelių;50929651251;Ne;2;3;0;5
16299;Vieversys;Varpelių;65625227882;Taip;0;2;0;2
16300;Vieversys;Varpelių;29002693436;Taip;3;2;0;5
16301;Vieversys;Varpelių;41282339758;Taip;5;5;0;10
16302;Vieversys;Varpelių;6427430220;Taip;0;1;0;1
16303;Vieversys;Varpelių;72475350152;Taip;0;2;0;2
16304;Vieversys;Varpelių;61074394922;Taip;4;10;0;14
16305;Vieversys;Varpelių;11528430680;Taip;5;1;0;6
16306;Vieversys;Varpelių;67471794738;Taip;2;0;0;2
16307;Vieversys;Varpelių;13768739410;Taip;0;2;0;2
16308;Vieversys;Varpelių;79197759451;Taip;0;2;0;2
16309;Vieversys;Varpelių;89564962534;Taip;0;4;0;4
16310;Vieversys;Varpelių;65696183376;Taip;3;1;0;4
16311;Vieversys;Varpelių;2561825171;Taip;0;0;4;4
16312;Vieversys;Varpelių;87314456133;Ne;0;4;0;4
16313;Vieversys;Kiškučių;2511719188;Ne;0;1;0;1
16314;Vieversys;Kiškučių;5337856442;Taip;0;1;10;11
16315;Vieversys;Kiškučių;5051310223;Taip;6;2;4;12
16316;Vieversys;Kiškučių;83420473111;Ne;0;1;0;1
16317;Vieversys;Kiškučių;22717987850;Taip;8;5;0;13
16318;Vieversys;Kiškučių;26092685300;Ne;0;17;0;17
16319;Vieversys;Kiškučių;72651951788;Taip;9;0;0;9
16320;Vieversys;Kiškučių;22275121492;Taip;0;4;0;4
16321;Vieversys;Kiškučių;34494816770;Taip;0;7;0;7
16322;Vieversys;Kiškučių;27123496741;Taip;0;1;0;1
16323;Vieversys;Kiškučių;63139698249;Taip;0;7;0;7
16324;Vieversys;Kiškučių;66155667200;Taip;0;6;0;6
16325;Vieversys;Kiškučių;7126970560;Taip;0;2;0;2
16326;Vieversys;Kiškučių;61951858540;Taip;4;0;0;4
16327;Vieversys;Kiškučių;1371669237;Taip;0;2;0;2
16328;Vieversys;Kiškučių;93582609868;Taip;0;1;1;2
16329;Vieversys;Kiškučių;35144734547;Taip;9;2;0;11
16330;Vieversys;Pelėdžiukų;8421719030;Taip;8;0;2;10
16331;Vieversys;Pelėdžiukų;77272293257;Taip;22;0;0;22
16332;Vieversys;Pelėdžiukų;5434952733;Taip;7;0;3;10
16333;Vieversys;Pelėdžiukų;7578552471;Taip;4;5;0;9
16334;Vieversys;Pelėdžiukų;7007620994;Taip;0;1;7;8
16335;Vieversys;Pelėdžiukų;9499315463;Taip;0;1;0;1
16336;Vieversys;Pelėdžiukų;9774365819;Taip;0;3;0;3
16337;Vieversys;Pelėdžiukų;9494957750;Taip;0;0;6;6
16338;Vieversys;Pelėdžiukų;2521488728;Taip;0;7;0;7
16339;Vieversys;Pelėdžiukų;6473759470;Taip;0;1;0;1
16340;Vieversys;Pelėdžiukų;1273951001;Taip;4;3;0;7
16341;Vieversys;Pelėdžiukų;48430863473;Taip;4;0;0;4
16342;Vieversys;Pelėdžiukų;50181034746;Taip;12;0;3;15
16343;Vieversys;Pelėdžiukų;1027693153;Taip;0;0;2;2
16344;Vieversys;Pelėdžiukų;5871715452;Taip;0;0;1;1
16345;Vieversys;Pelėdžiukų;9659337657;Ne;0;19;0;19
16346;Vieversys;Pelėdžiukų;3458399180;Taip;7;5;0;12
16347;Vieversys;Pelėdžiukų;1361156816;Taip;9;1;0;10
16348;Vieversys;Saulučių;81494754248;Taip;2;1;0;3
16349;Vieversys;Saulučių;12419984038;Taip;0;0;3;3
16350;Vieversys;Saulučių;1601102808;Ne;0;1;0;1
16351;Vieversys;Saulučių;9980447111;Taip;0;0;1;1
16352;Vieversys;Saulučių;2733479642;Taip;0;3;0;3
16353;Vieversys;Saulučių;25507613416;Ne;0;8;1;9
16354;Vieversys;Saulučių;1307701524;Taip;0;7;0;7
16355;Vieversys;Saulučių;8966153890;Taip;7;1;0;8
16356;Vieversys;Saulučių;2006826758;Taip;3;0;0;3
16357;Vieversys;Saulučių;3907748584;Taip;9;0;0;9
16358;Vieversys;Saulučių;93675768307;Taip;8;2;0;10
16359;Vieversys;Saulučių;4216521988;Taip;0;0;1;1
16360;Vieversys;Saulučių;6077365803;Taip;0;0;1;1
16361;Vieversys;Kregždučių;55553505459;Taip;0;8;0;8
16362;Vieversys;Kregždučių;16002848795;Taip;0;8;0;8
16363;Vieversys;Kregždučių;1933907389;Taip;3;7;0;10
16364;Vieversys;Kregždučių;1462608187;Ne;6;1;0;7
16365;Vieversys;Kregždučių;44086673096;Taip;0;2;2;4
16366;Vieversys;Kregždučių;89223502405;Taip;0;3;0;3
16367;Vieversys;Kregždučių;41215224179;Taip;7;0;0;7
16368;Vieversys;Kregždučių;938801303;Taip;0;1;0;1
16369;Vieversys;Kregždučių;2141967793;Taip;0;5;3;8
16370;Vieversys;Kregždučių;2128428329;Taip;0;5;0;5
16371;Vieversys;Kregždučių;1190396975;Taip;0;3;0;3
16372;Vieversys;Kregždučių;62465517391;Taip;9;0;0;9
16373;Vieversys;Kregždučių;5123994167;Taip;5;0;0;5
16374;Vieversys;Kregždučių;12524976076;Taip;0;1;0;1
16375;Vieversys;Kregždučių;1300013110;Taip;0;1;0;1
16376;Vieversys;Kregždučių;61101237391;Taip;0;1;0;1
16377;Vieversys;Kregždučių;1716198618;Taip;0;8;0;8
16378;Vieversys;Kregždučių;8213134622;Taip;11;4;0;15
16379;Vieversys;Kregždučių;2879546284;Taip;9;0;0;9
16380;Vieversys;Kregždučių;3839507103;Taip;0;1;0;1
16381;Vieversys;Kregždučių;46624143347;Taip;7;0;0;7
16382;Vieversys;Kregždučių;73657188876;Ne;1;6;0;7
16383;Vieversys;Kregždučių;78901148667;Taip;0;1;0;1
16384;Vieversys;Boružėlių;6116471730;Ne;0;1;0;1
16385;Vieversys;Boružėlių;1815073796;Taip;0;5;1;6
16386;Vieversys;Boružėlių;32630544785;Taip;0;1;2;3
16387;Vieversys;Boružėlių;20960056744;Ne;4;1;0;5
16388;Vieversys;Boružėlių;58287759954;Taip;10;0;0;10
16389;Vieversys;Boružėlių;72395946516;Ne;0;1;0;1
16390;Vieversys;Boružėlių;86213464121;Taip;0;1;0;1
16391;Vieversys;Boružėlių;1588939300;Taip;6;5;0;11
16392;Vieversys;Boružėlių;57223617591;Taip;1;0;0;1
16393;Vieversys;Boružėlių;1028950997;Taip;0;0;3;3
16394;Vieversys;Boružėlių;95886969053;Taip;6;7;0;13
16395;Vieversys;Boružėlių;95891054066;Taip;5;0;0;5
16396;Vieversys;Boružėlių;5197639355;Taip;0;4;0;4
16397;Vieversys;Boružėlių;15473504836;Taip;3;4;0;7
16398;Vieversys;Boružėlių;8744701209;Taip;0;4;0;4
16399;Vieversys;Boružėlių;50192413803;Ne;9;0;0;9
16400;Vieversys;Boružėlių;1715902540;Taip;5;2;0;7
16401;Vieversys;Bitučių;5654533451;Taip;9;0;0;9
16402;Vieversys;Bitučių;6127272124;Taip;0;0;1;1
16403;Vieversys;Bitučių;3405502715;Taip;5;6;2;13
16404;Vieversys;Bitučių;1748006118;Taip;6;0;0;6
16405;Vieversys;Bitučių;9985374057;Taip;8;2;0;10
16406;Vieversys;Bitučių;9308040716;Taip;0;0;2;2
16407;Vieversys;Bitučių;4741252829;Taip;0;0;2;2
16408;Vieversys;Bitučių;7048475906;Taip;4;0;0;4
16409;Vieversys;Bitučių;6031200259;Ne;0;6;0;6
16410;Vieversys;Bitučių;6110034652;Taip;0;9;0;9
16411;Vieversys;Bitučių;2663322242;Ne;3;0;0;3
16412;Vieversys;Bitučių;7596355010;Taip;0;17;0;17
16413;Vieversys;Bitučių;4892622551;Ne;0;6;1;7
16414;Vieversys;Bitučių;4690095102;Taip;8;0;1;9
16415;Vieversys;Bitučių;4968278870;Taip;12;0;0;12
16416;Vieversys;Smalsučių;3681120339;Taip;7;0;0;7
16417;Vieversys;Smalsučių;9164615794;Taip;0;1;0;1
16418;Vieversys;Smalsučių;3684937630;Taip;10;2;0;12
16419;Vieversys;Smalsučių;6563139211;Taip;0;2;0;2
16420;Vieversys;Smalsučių;1757028935;Taip;9;0;0;9
16421;Vieversys;Smalsučių;4488027554;Taip;9;0;0;9
16422;Vieversys;Smalsučių;4294676988;Taip;3;1;0;4
16423;Vieversys;Smalsučių;3917758713;Taip;5;0;0;5
16424;Vieversys;Smalsučių;4835022593;Taip;0;15;0;15
16425;Vieversys;Smalsučių;3249717073;Taip;9;1;0;10
16426;Vieversys;Smalsučių;7120329258;Taip;9;1;0;10
16427;Vieversys;Smalsučių;9387421639;Taip;15;2;0;17
16428;Vieversys;Smalsučių;8174124875;Taip;15;2;0;17
16429;Vieversys;Smalsučių;4187114865;Taip;0;1;0;1
16430;Vieversys;Smalsučių;5789530087;Taip;18;0;0;18
16431;Vieversys;Smalsučių;1322495361;Taip;10;1;0;11
16432;Vieversys;Kodėlčiukų;69275621813;Taip;0;10;0;10
16433;Vieversys;Kodėlčiukų;1455615413;Taip;8;0;2;10
16434;Vieversys;Kodėlčiukų;1970088958;Taip;0;1;0;1
16435;Vieversys;Kodėlčiukų;9012978017;Taip;6;8;1;15
16436;Vieversys;Kodėlčiukų;1599787985;Ne;5;0;0;5
16437;Vieversys;Kodėlčiukų;1491424075;Taip;18;0;1;19
16438;Vieversys;Kodėlčiukų;1361494430;Taip;7;2;0;9
16439;Vieversys;Kodėlčiukų;9829388743;Taip;5;0;0;5
16440;Vieversys;Kodėlčiukų;1878278158;Taip;8;0;2;10
16441;Vieversys;Kodėlčiukų;7315438787;Taip;0;1;0;1
16442;Vieversys;Kodėlčiukų;16617102917;Taip;0;5;0;5
16443;Vieversys;Kodėlčiukų;1793994492;Taip;0;0;13;13
16444;Vieversys;Kodėlčiukų;2236904814;Taip;11;0;2;13
16445;Vieversys;Kodėlčiukų;3792076932;Taip;0;0;1;1
16446;Vieversys;Kodėlčiukų;9680719247;Taip;0;0;1;1
16447;Vieversys;Kodėlčiukų;2294276744;Taip;0;1;0;1
16448;Vieversys;Kodėlčiukų;3640960566;Taip;10;0;1;11
16449;Vieversys;Kodėlčiukų;2006325359;Taip;0;1;0;1
16450;Vieversys;NYKŠTUKAI;9453100342;Taip;10;0;0;10
16451;Vieversys;NYKŠTUKAI;3731412573;Ne;7;0;0;7
16452;Vieversys;NYKŠTUKAI;9826657384;Taip;6;0;0;6
16453;Vieversys;NYKŠTUKAI;7364582681;Taip;0;1;0;1
16454;Vieversys;NYKŠTUKAI;4088189914;Taip;15;0;0;15
16455;Vieversys;NYKŠTUKAI;7399326463;Taip;8;0;0;8
16456;Vieversys;NYKŠTUKAI;4565799599;Taip;9;1;0;10
16457;Vieversys;NYKŠTUKAI;6765094662;Taip;9;0;0;9
16458;Vieversys;NYKŠTUKAI;5683183310;Taip;0;1;0;1
16459;Vieversys;NYKŠTUKAI;8587368497;Taip;0;2;0;2
16460;Vieversys;NYKŠTUKAI;6838828193;Taip;5;10;0;15
16461;Vieversys;NYKŠTUKAI;1478357320;Taip;6;8;0;14
16462;Vieversys;DRUGELIAI;9093088054;Taip;8;1;0;9
16463;Vieversys;DRUGELIAI;6808541662;Ne;5;9;1;15
16464;Vieversys;DRUGELIAI;5912306325;Taip;0;12;0;12
16465;Vieversys;DRUGELIAI;5486475468;Taip;8;0;0;8
16466;Vieversys;DRUGELIAI;8141710663;Taip;3;0;0;3
16467;Vieversys;DRUGELIAI;2230503026;Taip;5;0;1;6
16468;Vieversys;DRUGELIAI;5645852451;Taip;14;0;0;14
16469;Vieversys;DRUGELIAI;3122763958;Taip;7;0;3;10
16470;Vieversys;DRUGELIAI;2529690060;Taip;7;0;1;8
16471;Vieversys;DRUGELIAI;9088171869;Taip;0;5;2;7
16472;Vieversys;DRUGELIAI;1685531183;Taip;1;0;0;1
16473;Vieversys;DRUGELIAI;7998100115;Taip;8;0;0;8
16474;Vieversys;DRUGELIAI;3156245273;Taip;0;11;1;12
16475;Vieversys;DRUGELIAI;7568415178;Taip;0;0;1;1
16476;Vieversys;DRUGELIAI;4870401841;Taip;8;0;0;8
16477;Žirmūnėliai;SAULUTĖS;8030469722;Taip;0;1;0;1
16478;Žirmūnėliai;SAULUTĖS;1258769646;Taip;0;1;0;1
16479;Žirmūnėliai;SAULUTĖS;3166454638;Taip;0;3;0;3
16480;Žirmūnėliai;SAULUTĖS;73664204182;Taip;0;0;1;1
16481;Žirmūnėliai;SAULUTĖS;1725143117;Taip;0;8;0;8
16482;Žirmūnėliai;SAULUTĖS;1073135587;Taip;0;17;0;17
16483;Žirmūnėliai;SAULUTĖS;4598761492;Taip;0;7;0;7
16484;Žirmūnėliai;SAULUTĖS;3128190518;Taip;0;1;0;1
16485;Žirmūnėliai;SAULUTĖS;8317328771;Taip;4;1;0;5
16486;Žirmūnėliai;SAULUTĖS;1478039469;Taip;3;0;0;3
16487;Žirmūnėliai;SAULUTĖS;6896145409;Taip;12;0;0;12
16488;Žirmūnėliai;SAULUTĖS;1255857051;Taip;0;4;0;4
16489;Žirmūnėliai;SAULUTĖS;72738770293;Taip;4;1;0;5
16490;Žirmūnėliai;SAULUTĖS;4517290068;Taip;9;1;0;10
16491;Žirmūnėliai;SAULUTĖS;1582563837;Taip;12;0;0;12
16492;Žirmūnėliai;SAULUTĖS;1381923106;Taip;0;1;0;1
16493;Žirmūnėliai;SAULUTĖS;5037669167;Taip;0;1;0;1
16494;Žirmūnėliai;SAULUTĖS;1761284228;Ne;0;1;0;1
16495;Žirmūnėliai;SAULUTĖS;41018224936;Taip;5;1;0;6
16496;Žirmūnėliai;SAULUTĖS;1894070647;Taip;0;4;0;4
16497;Žirmūnėliai;GILIUKAI;5673929155;Taip;0;4;0;4
16498;Žirmūnėliai;GILIUKAI;50829749038;Taip;0;2;0;2
16499;Žirmūnėliai;GILIUKAI;68678277635;Taip;9;1;0;10
16500;Žirmūnėliai;GILIUKAI;1963980356;Taip;0;5;0;5
16501;Žirmūnėliai;GILIUKAI;1302040861;Ne;0;1;0;1
16502;Žirmūnėliai;GILIUKAI;1816123753;Taip;0;1;0;1
16503;Žirmūnėliai;GILIUKAI;1308593517;Taip;0;8;0;8
16504;Žirmūnėliai;GILIUKAI;53028161711;Taip;0;12;0;12
16505;Žirmūnėliai;GILIUKAI;6578685370;Ne;0;2;1;3
16506;Žirmūnėliai;GILIUKAI;1493536049;Taip;0;4;0;4
16507;Žirmūnėliai;GILIUKAI;1626619024;Taip;4;13;5;22
16508;Žirmūnėliai;GILIUKAI;8824743884;Taip;0;2;3;5
16509;Žirmūnėliai;GILIUKAI;1556389237;Taip;0;9;0;9
16510;Žirmūnėliai;GILIUKAI;1764226619;Taip;0;1;0;1
16511;Žirmūnėliai;GILIUKAI;1183883183;Taip;0;15;0;15
16512;Žirmūnėliai;GILIUKAI;7929881052;Ne;0;10;0;10
16513;Žirmūnėliai;GILIUKAI;5996547081;Taip;0;8;0;8
16514;Žirmūnėliai;DAINORĖLIAI;6493142538;Taip;4;1;0;5
16515;Žirmūnėliai;DAINORĖLIAI;1655437833;Taip;7;0;0;7
16516;Žirmūnėliai;DAINORĖLIAI;2693415717;Ne;0;0;6;6
16517;Žirmūnėliai;DAINORĖLIAI;8930536051;Taip;7;0;0;7
16518;Žirmūnėliai;DAINORĖLIAI;7953019230;Taip;0;5;0;5
16519;Žirmūnėliai;DAINORĖLIAI;6982109508;Taip;0;9;3;12
16520;Žirmūnėliai;DAINORĖLIAI;3458810185;Ne;4;0;4;8
16521;Žirmūnėliai;DAINORĖLIAI;3994865244;Taip;0;0;9;9
16522;Žirmūnėliai;DAINORĖLIAI;3640979388;Taip;0;11;0;11
16523;Žirmūnėliai;DAINORĖLIAI;6878528100;Taip;0;0;5;5
16524;Žirmūnėliai;DAINORĖLIAI;8440187348;Ne;4;0;3;7
16525;Žirmūnėliai;DAINORĖLIAI;9759491055;Ne;18;0;0;18
16526;Žirmūnėliai;DAINORĖLIAI;3297360222;Ne;8;0;0;8
16527;Žirmūnėliai;DAINORĖLIAI;4101748829;Taip;9;4;0;13
16528;Žirmūnėliai;DAINORĖLIAI;2379638934;Taip;5;1;0;6
16529;Žirmūnėliai;DAINORĖLIAI;6448582622;Ne;4;2;2;8
16530;Žirmūnėliai;DAINORĖLIAI;2661052835;Taip;0;4;0;4
16531;Žirmūnėliai;DAINORĖLIAI;7011701994;Ne;9;2;0;11
16532;Žirmūnėliai;DRUGELIAI;4218266688;Taip;5;0;0;5
16533;Žirmūnėliai;DRUGELIAI;3449815783;Taip;4;0;0;4
16534;Žirmūnėliai;DRUGELIAI;5736502380;Ne;5;4;0;9
16535;Žirmūnėliai;DRUGELIAI;9154874729;Taip;11;1;0;12
16536;Žirmūnėliai;DRUGELIAI;9378860669;Taip;15;1;0;16
16537;Žirmūnėliai;DRUGELIAI;8607934394;Taip;0;2;0;2
16538;Žirmūnėliai;DRUGELIAI;5723289396;Ne;10;0;0;10
16539;Žirmūnėliai;DRUGELIAI;8999160836;Taip;9;13;0;22
16540;Žirmūnėliai;DRUGELIAI;8209309240;Taip;0;1;0;1
16541;Žirmūnėliai;DRUGELIAI;5209700153;Taip;6;0;0;6
16542;Žirmūnėliai;DRUGELIAI;2837129621;Taip;13;2;0;15
16543;Žirmūnėliai;DRUGELIAI;1273684243;Taip;5;0;0;5
16544;Žirmūnėliai;DRUGELIAI;2971175236;Taip;0;2;1;3
16545;Žirmūnėliai;DRUGELIAI;6594728970;Ne;9;1;0;10
16546;Žirmūnėliai;DRUGELIAI;7422544482;Taip;9;0;0;9
16547;Žirmūnėliai;DRUGELIAI;4336415033;Taip;7;0;0;7
16548;Žirmūnėliai;DRUGELIAI;9241738140;Ne;8;2;4;14
16549;Žirmūnėliai;BORUŽIUKAI;99393944540;Taip;0;3;0;3
16550;Žirmūnėliai;BORUŽIUKAI;76779474158;Taip;0;6;0;6
16551;Žirmūnėliai;BORUŽIUKAI;19044383213;Taip;0;2;2;4
16552;Žirmūnėliai;BORUŽIUKAI;99980167497;Taip;0;2;0;2
16553;Žirmūnėliai;BORUŽIUKAI;88436070676;Taip;0;1;1;2
16554;Žirmūnėliai;BORUŽIUKAI;66100956443;Taip;0;0;12;12
16555;Žirmūnėliai;BORUŽIUKAI;85286691926;Taip;0;1;3;4
16556;Žirmūnėliai;BORUŽIUKAI;7777166572;Taip;0;2;1;3
16557;Žirmūnėliai;BORUŽIUKAI;20851917855;Taip;0;16;0;16
16558;Žirmūnėliai;BORUŽIUKAI;26463655365;Taip;0;1;0;1
16559;Žirmūnėliai;BORUŽIUKAI;32213803056;Taip;0;4;0;4
16560;Žirmūnėliai;BORUŽIUKAI;1157270725;Taip;0;15;0;15
16561;Žirmūnėliai;BORUŽIUKAI;78535860714;Taip;0;3;0;3
16562;Žirmūnėliai;EŽIUKAI;75310341519;Taip;6;0;0;6
16563;Žirmūnėliai;EŽIUKAI;36822027549;Ne;0;0;11;11
16564;Žirmūnėliai;EŽIUKAI;22385656372;Taip;0;1;0;1
16565;Žirmūnėliai;EŽIUKAI;1563132542;Taip;0;0;6;6
16566;Žirmūnėliai;EŽIUKAI;31231655300;Taip;8;0;7;15
16567;Žirmūnėliai;EŽIUKAI;5450253994;Taip;0;0;1;1
16568;Žirmūnėliai;EŽIUKAI;67024451309;Taip;0;0;3;3
16569;Žirmūnėliai;EŽIUKAI;39347099487;Taip;0;2;0;2
16570;Žirmūnėliai;EŽIUKAI;6380354636;Ne;0;0;4;4
16571;Žirmūnėliai;EŽIUKAI;2548081116;Taip;0;0;3;3
16572;Žirmūnėliai;EŽIUKAI;58158145123;Taip;0;0;1;1
16573;Žirmūnėliai;EŽIUKAI;30933761145;Taip;0;0;1;1
16574;Žirmūnėliai;EŽIUKAI;33441696614;Taip;0;0;1;1
16575;Žirmūnėliai;EŽIUKAI;51268874840;Taip;0;1;0;1
16576;Žirmūnėliai;EŽIUKAI;57457297276;Taip;0;0;1;1
16577;Žirmūnėliai;EŽIUKAI;1023642666;Taip;0;0;3;3
16578;Žirmūnėliai;EŽIUKAI;9039313646;Taip;0;0;1;1
16579;Žirmūnėliai;EŽIUKAI;7386776624;Taip;0;0;1;1
16580;Žirmūnėliai;ŽVIRBLIUKAI;73552867802;Taip;0;1;0;1
16581;Žirmūnėliai;ŽVIRBLIUKAI;38316483993;Taip;7;2;1;10
16582;Žirmūnėliai;ŽVIRBLIUKAI;1250060420;Taip;7;0;1;8
16583;Žirmūnėliai;ŽVIRBLIUKAI;1477593223;Ne;0;4;0;4
16584;Žirmūnėliai;ŽVIRBLIUKAI;3896978775;Taip;0;0;3;3
16585;Žirmūnėliai;ŽVIRBLIUKAI;1235090013;Taip;0;6;0;6
16586;Žirmūnėliai;ŽVIRBLIUKAI;4136421440;Taip;4;10;0;14
16587;Žirmūnėliai;ŽVIRBLIUKAI;87693490164;Ne;0;1;0;1
16588;Žirmūnėliai;ŽVIRBLIUKAI;45541156029;Ne;0;2;5;7
16589;Žirmūnėliai;ŽVIRBLIUKAI;28826938550;Taip;0;3;2;5
16590;Žirmūnėliai;ŽVIRBLIUKAI;65810358813;Taip;0;9;0;9
16591;Žirmūnėliai;ŽVIRBLIUKAI;12766765793;Taip;0;8;0;8
16592;Žirmūnėliai;ŽVIRBLIUKAI;86142962074;Taip;0;1;0;1
16593;Žirmūnėliai;ŽVIRBLIUKAI;61531418513;Taip;0;1;0;1
16594;Žirmūnėliai;ŽVIRBLIUKAI;20902834369;Taip;0;4;0;4
16595;Žirmūnėliai;SPALVELĖS;86501162211;Taip;0;1;0;1
16596;Žirmūnėliai;SPALVELĖS;3691651489;Taip;2;0;8;10
16597;Žirmūnėliai;SPALVELĖS;1120531178;Taip;0;2;0;2
16598;Žirmūnėliai;SPALVELĖS;1273301982;Taip;6;1;0;7
16599;Žirmūnėliai;SPALVELĖS;29952298800;Taip;4;1;3;8
16600;Žirmūnėliai;SPALVELĖS;2127930970;Taip;0;2;0;2
16601;Žirmūnėliai;SPALVELĖS;3150467744;Taip;0;0;1;1
16602;Žirmūnėliai;SPALVELĖS;4330975876;Taip;0;0;1;1
16603;Žirmūnėliai;SPALVELĖS;7918747416;Taip;2;6;0;8
16604;Žirmūnėliai;SPALVELĖS;1865240339;Taip;2;0;5;7
16605;Žirmūnėliai;SPALVELĖS;51723882387;Taip;0;2;2;4
16606;Žirmūnėliai;SPALVELĖS;8308074932;Taip;0;2;0;2
16607;Žirmūnėliai;SPALVELĖS;1017903291;Ne;0;12;0;12
16608;Žirmūnėliai;SPALVELĖS;52524235797;Taip;0;2;0;2
16609;Žirmūnėliai;SPALVELĖS;9482910388;Taip;0;17;0;17
16610;Žirmūnėliai;DEBESĖLIAI;64969220116;Taip;0;21;0;21
16611;Žirmūnėliai;DEBESĖLIAI;1542147528;Ne;4;0;0;4
16612;Žirmūnėliai;DEBESĖLIAI;5527904792;Taip;0;16;0;16
16613;Žirmūnėliai;DEBESĖLIAI;6161223611;Taip;9;0;0;9
16614;Žirmūnėliai;DEBESĖLIAI;31403739893;Taip;15;0;2;17
16615;Žirmūnėliai;DEBESĖLIAI;9926432375;Ne;0;3;0;3
16616;Žirmūnėliai;DEBESĖLIAI;5367009184;Taip;0;0;2;2
16617;Žirmūnėliai;DEBESĖLIAI;1885292520;Ne;0;1;0;1
16618;Žirmūnėliai;DEBESĖLIAI;1618573494;Taip;0;8;0;8
16619;Žirmūnėliai;DEBESĖLIAI;5611315994;Taip;2;0;0;2
16620;Žirmūnėliai;DEBESĖLIAI;6337036947;Taip;4;0;0;4
16621;Žirmūnėliai;DEBESĖLIAI;2739395691;Ne;8;4;0;12
16622;Žirmūnėliai;DEBESĖLIAI;7528704460;Taip;2;0;0;2
16623;Žirmūnėliai;DEBESĖLIAI;8623037038;Taip;0;0;2;2
16624;Žirmūnėliai;DEBESĖLIAI;3006508357;Taip;7;1;5;13
16625;Žirmūnėliai;DEBESĖLIAI;5125341440;Taip;2;0;0;2
16626;Žirmūnėliai;DEBESĖLIAI;6647641423;Taip;0;5;0;5
16627;Žirmūnėliai;DEBESĖLIAI;3351861764;Taip;0;7;0;7
16628;Žirmūnėliai;DEBESĖLIAI;3274576752;Taip;0;9;0;9
16629;Žirmūnėliai;DEBESĖLIAI;1234956674;Taip;0;9;1;10
16630;Žirmūnėliai;DEBESĖLIAI;3540307559;Taip;7;1;0;8
16631;Žirmūnėliai;VIŠČIUKAI;6597451758;Ne;0;0;1;1
16632;Žirmūnėliai;VIŠČIUKAI;7410921362;Taip;1;0;0;1
16633;Žirmūnėliai;VIŠČIUKAI;3431320961;Ne;0;0;1;1
16634;Žirmūnėliai;VIŠČIUKAI;3532895278;Taip;0;0;1;1
16635;Žirmūnėliai;VIŠČIUKAI;8432654056;Taip;0;5;0;5
16636;Žirmūnėliai;VIŠČIUKAI;8459217612;Taip;5;5;0;10
16637;Žirmūnėliai;VIŠČIUKAI;2959090234;Taip;6;0;0;6
16638;Žirmūnėliai;VIŠČIUKAI;5089884149;Taip;8;0;0;8
16639;Žirmūnėliai;VIŠČIUKAI;1356219744;Taip;11;5;0;16
16640;Žirmūnėliai;VIŠČIUKAI;1791977446;Ne;4;3;0;7
16641;Žirmūnėliai;VIŠČIUKAI;6259368139;Taip;14;0;0;14
16642;Žirmūnėliai;VIŠČIUKAI;4548601585;Taip;0;5;0;5
16643;Žirmūnėliai;VIŠČIUKAI;9367849317;Taip;0;0;4;4
16644;Žirmūnėliai;VIŠČIUKAI;9892620134;Taip;3;0;0;3
16645;Žirmūnėliai;VIŠČIUKAI;8627403283;Taip;0;5;3;8
16646;Žirmūnėliai;ZUIKUČIŲ;3562689670;Taip;0;8;0;8
16647;Žirmūnėliai;ZUIKUČIŲ;1571242696;Taip;9;0;0;9
16648;Žirmūnėliai;ZUIKUČIŲ;1401001989;Ne;2;1;4;7
16649;Žirmūnėliai;ZUIKUČIŲ;8631248243;Taip;6;1;2;9
16650;Žirmūnėliai;ZUIKUČIŲ;2866010286;Taip;12;1;0;13
16651;Žirmūnėliai;ZUIKUČIŲ;2904787614;Taip;5;1;0;6
16652;Žirmūnėliai;ZUIKUČIŲ;1025809131;Taip;4;1;3;8
16653;Žirmūnėliai;ZUIKUČIŲ;5929166560;Ne;0;0;14;14
16654;Žirmūnėliai;ZUIKUČIŲ;5104310002;Taip;10;0;0;10
16655;Žirmūnėliai;ZUIKUČIŲ;2506945279;Taip;0;1;0;1
16656;Žirmūnėliai;ZUIKUČIŲ;1473482823;Ne;0;12;0;12
16657;Žirmūnėliai;ZUIKUČIŲ;6899109664;Taip;5;4;0;9
16658;Žirmūnėliai;ZUIKUČIŲ;3949374730;Taip;10;4;0;14
16659;Žirmūnėliai;ZUIKUČIŲ;3767421827;Taip;0;1;2;3
16660;Žirmūnėliai;ZUIKUČIŲ;4327504033;Taip;10;3;0;13
16661;Žirmūnėliai;ZUIKUČIŲ;6869102228;Ne;7;1;1;9
16662;Žirmūnėliai;ZUIKUČIŲ;2841958534;Taip;0;1;6;7
16663;Žirmūnėliai;ZUIKUČIŲ;6430944858;Taip;7;0;5;12
16664;Žirmūnėliai;OBUOLIUKAI;9666769523;Taip;3;4;0;7
16665;Žirmūnėliai;OBUOLIUKAI;24877884441;Taip;0;3;0;3
16666;Žirmūnėliai;OBUOLIUKAI;85408994677;Taip;0;0;1;1
16667;Žirmūnėliai;OBUOLIUKAI;2336720944;Taip;0;10;0;10
16668;Žirmūnėliai;OBUOLIUKAI;1110585472;Taip;0;1;0;1
16669;Žirmūnėliai;OBUOLIUKAI;93072181228;Taip;4;2;0;6
16670;Žirmūnėliai;OBUOLIUKAI;1259227112;Taip;0;15;0;15
16671;Žirmūnėliai;OBUOLIUKAI;155054610;Taip;0;0;1;1
16672;Žirmūnėliai;OBUOLIUKAI;89429083939;Taip;0;2;0;2
16673;Žirmūnėliai;OBUOLIUKAI;35353356752;Ne;9;0;0;9
16674;Žirmūnėliai;OBUOLIUKAI;4030572434;Taip;0;2;0;2
16675;Žirmūnėliai;OBUOLIUKAI;6758118659;Taip;0;2;0;2
16676;Žirmūnėliai;OBUOLIUKAI;53081289792;Taip;9;0;0;9
16677;Žirmūnėliai;OBUOLIUKAI;4675716163;Taip;0;0;4;4
16678;Žirmūnėliai;OBUOLIUKAI;2216383670;Ne;0;0;13;13
16679;Žirmūnėliai;OBUOLIUKAI;47645482781;Taip;0;2;0;2
16680;Žirmūnėliai;OBUOLIUKAI;9448136354;Taip;0;0;5;5
16681;Žirmūnėliai;OBUOLIUKAI;1946226949;Taip;0;5;0;5
16682;Žirmūnėliai;OBUOLIUKAI;19389343819;Taip;0;0;1;1
16683;Žirmūnėliai;OBUOLIUKAI;2094542223;Ne;0;7;0;7
16684;Dainorėliai;VARPELIAI;31902102771;Taip;0;2;16;18
16685;Dainorėliai;VARPELIAI;18233813290;Ne;0;1;0;1
16686;Dainorėliai;VARPELIAI;6176171443;Taip;0;2;4;6
16687;Dainorėliai;VARPELIAI;88781762328;Ne;10;2;1;13
16688;Dainorėliai;VARPELIAI;9319771186;Taip;0;2;4;6
16689;Dainorėliai;VARPELIAI;8719834064;Taip;0;2;7;9
16690;Dainorėliai;VARPELIAI;5693385617;Taip;0;2;4;6
16691;Dainorėliai;VARPELIAI;8267213392;Ne;0;3;0;3
16692;Dainorėliai;VARPELIAI;5959380807;Ne;4;0;0;4
16693;Dainorėliai;VARPELIAI;3183793211;Taip;0;2;5;7
16694;Dainorėliai;VARPELIAI;2797544232;Taip;0;2;6;8
16695;Dainorėliai;VARPELIAI;65467351140;Taip;0;2;1;3
16696;Dainorėliai;VARPELIAI;8521878734;Taip;0;2;0;2
16697;Dainorėliai;VARPELIAI;6430425182;Taip;0;1;0;1
16698;Dainorėliai;VARPELIAI;4269946363;Taip;0;2;11;13
16699;Dainorėliai;VARPELIAI;1088248393;Taip;0;0;5;5
16700;Dainorėliai;VARPELIAI;2074070030;Ne;0;2;2;4
16701;Dainorėliai;ŽIOGELIAI;99597416067;Taip;5;0;0;5
16702;Dainorėliai;ŽIOGELIAI;88201007119;Taip;0;3;0;3
16703;Dainorėliai;ŽIOGELIAI;31267856584;Ne;7;2;0;9
16704;Dainorėliai;ŽIOGELIAI;87717571411;Taip;0;1;0;1
16705;Dainorėliai;ŽIOGELIAI;18936645521;Ne;2;3;0;5
16706;Dainorėliai;ŽIOGELIAI;35528654099;Taip;0;2;0;2
16707;Dainorėliai;ŽIOGELIAI;29132059636;Taip;0;1;0;1
16708;Dainorėliai;ŽIOGELIAI;32573583030;Taip;0;1;0;1
16709;Dainorėliai;ŽIOGELIAI;1470784692;Taip;0;1;0;1
16710;Dainorėliai;ŽIOGELIAI;17358842027;Ne;5;1;1;7
16711;Dainorėliai;ŽIOGELIAI;54344466523;Taip;0;0;2;2
16712;Dainorėliai;ŽIOGELIAI;45577031767;Taip;0;16;0;16
16713;Dainorėliai;ŽIOGELIAI;80499999855;Taip;2;0;0;2
16714;Dainorėliai;ŽIOGELIAI;78002267589;Ne;2;0;0;2
16715;Dainorėliai;ŽIOGELIAI;3761026792;Taip;3;1;1;5
16716;Dainorėliai;ŽIOGELIAI;71027372459;Taip;0;1;0;1
16717;Dainorėliai;DRUGELIAI;19286303769;Taip;0;2;0;2
16718;Dainorėliai;DRUGELIAI;2483267929;Taip;0;2;3;5
16719;Dainorėliai;DRUGELIAI;5212308610;Taip;0;5;0;5
16720;Dainorėliai;DRUGELIAI;6404337541;Taip;4;0;1;5
16721;Dainorėliai;DRUGELIAI;94480397292;Taip;4;0;1;5
16722;Dainorėliai;DRUGELIAI;53935690864;Taip;0;3;0;3
16723;Dainorėliai;DRUGELIAI;27521381629;Taip;0;11;0;11
16724;Dainorėliai;DRUGELIAI;86187568203;Taip;0;6;0;6
16725;Dainorėliai;DRUGELIAI;5238082419;Taip;10;0;0;10
16726;Dainorėliai;DRUGELIAI;49483881135;Taip;8;0;0;8
16727;Dainorėliai;DRUGELIAI;1626877066;Taip;0;0;2;2
16728;Dainorėliai;DRUGELIAI;1158895670;Ne;0;13;0;13
16729;Dainorėliai;DRUGELIAI;4087344015;Taip;0;8;0;8
16730;Dainorėliai;DRUGELIAI;3128897752;Taip;3;3;0;6
16731;Dainorėliai;DRUGELIAI;1357413314;Taip;0;0;2;2
16732;Dainorėliai;DRUGELIAI;1515552402;Taip;0;2;2;4
16733;Dainorėliai;DRUGELIAI;36313982965;Taip;7;0;0;7
16734;Dainorėliai;DRUGELIAI;1333499160;Taip;0;3;0;3
16735;Dainorėliai;"1 klasė";1889037823;Ne;1;0;0;1
16736;Dainorėliai;"1 klasė";2922026996;Taip;8;0;0;8
16737;Dainorėliai;"1 klasė";69556449215;Taip;2;0;0;2
16738;Dainorėliai;"1 klasė";84084897419;Taip;1;0;0;1
16739;Dainorėliai;"1 klasė";34686211072;Taip;2;0;0;2
16740;Dainorėliai;"1 klasė";47323045857;Taip;1;0;0;1
16741;Dainorėliai;"1 klasė";69732047046;Taip;1;0;0;1
16742;Dainorėliai;"1 klasė";65118883315;Taip;1;0;0;1
16743;Dainorėliai;"1 klasė";42402953271;Ne;5;0;0;5
16744;Dainorėliai;"1 klasė";2142553899;Taip;3;0;0;3
16745;Dainorėliai;"2 klasė";6203511535;Ne;4;0;0;4
16746;Dainorėliai;"2 klasė";23144978287;Taip;2;0;0;2
16747;Dainorėliai;"2 klasė";77907054102;Taip;1;0;0;1
16748;Dainorėliai;"2 klasė";19292860218;Taip;0;2;0;2
16749;Dainorėliai;"2 klasė";81956978417;Taip;1;0;0;1
16750;Dainorėliai;"2 klasė";3018657993;Taip;1;0;0;1
16751;Dainorėliai;"2 klasė";57179351170;Taip;2;0;0;2
16752;Dainorėliai;"2 klasė";48245075123;Taip;1;0;0;1
16753;Dainorėliai;"3 klasė";4792505132;Taip;0;1;0;1
16754;Dainorėliai;"3 klasė";9028699114;Taip;2;1;0;3
16755;Dainorėliai;"3 klasė";6513001151;Taip;2;1;0;3
16756;Dainorėliai;"3 klasė";7332518731;Taip;0;1;0;1
16757;Dainorėliai;"3 klasė";7013545705;Taip;4;1;0;5
16758;Dainorėliai;"3 klasė";5181789063;Taip;3;1;0;4
16759;Dainorėliai;"3 klasė";4642369086;Taip;4;1;0;5
16760;Dainorėliai;"3 klasė";7589862952;Taip;0;1;0;1
16761;Dainorėliai;"3 klasė";2135997501;Taip;4;1;0;5
16762;Dainorėliai;"3 klasė";2991348691;Taip;0;1;0;1
16763;Dainorėliai;"3 klasė";1472986325;Ne;0;1;0;1
16764;Dainorėliai;"3 klasė";9691052273;Taip;6;1;0;7
16765;Dainorėliai;"3 klasė";4631981231;Ne;0;1;0;1
16766;Dainorėliai;"3 klasė";6576505338;Ne;1;1;0;2
16767;Dainorėliai;"3 klasė";47031645815;Ne;4;1;0;5
16768;Dainorėliai;"3 klasė";1734712911;Taip;0;1;0;1
16769;Dainorėliai;"3 klasė";6898321145;Taip;0;1;0;1
16770;Dainorėliai;"3 klasė";8014881349;Taip;0;1;0;1
16771;Dainorėliai;"3 klasė";2685423821;Taip;2;1;0;3
16772;Dainorėliai;"3 klasė";3713835329;Taip;3;1;0;4
16773;Dainorėliai;"3 klasė";4309610318;Taip;2;1;0;3
16774;Dainorėliai;"3 klasė";3916502039;Taip;4;1;0;5
16775;Dainorėliai;"4 klasė";1289801462;Taip;2;1;0;3
16776;Dainorėliai;"4 klasė";7327414673;Taip;2;1;0;3
16777;Dainorėliai;"4 klasė";6497830034;Taip;1;1;0;2
16778;Dainorėliai;"4 klasė";8569165891;Taip;1;1;0;2
16779;Dainorėliai;"4 klasė";7309477306;Taip;0;1;0;1
16780;Dainorėliai;"4 klasė";3683531357;Ne;0;1;0;1
16781;Dainorėliai;"4 klasė";4490125789;Taip;2;1;0;3
16782;Dainorėliai;"4 klasė";4497264004;Taip;5;1;0;6
16783;Dainorėliai;"4 klasė";2704452184;Taip;3;1;0;4
16784;Dainorėliai;"4 klasė";5468429196;Taip;1;1;0;2
16785;Dainorėliai;"4 klasė";2519518637;Taip;0;1;0;1
16786;Dainorėliai;"4 klasė";5072041112;Taip;0;1;0;1
16787;Dainorėliai;"4 klasė";1347410803;Taip;1;1;0;2
16788;Dainorėliai;"4 klasė";2164782968;Ne;0;1;0;1
16789;Dainorėliai;"4 klasė";1311444933;Taip;0;1;0;1
16790;Dainorėliai;"4 klasė";3053044929;Taip;0;1;0;1
16791;Dainorėliai;"4 klasė";5177714429;Ne;4;1;0;5
16792;Dainorėliai;"4 klasė";4275023010;Taip;6;1;0;7
16793;Dainorėliai;"4 klasė";74881322515;Taip;0;1;0;1
16794;Dainorėliai;"4 klasė";4691497223;Taip;2;1;0;3
16795;Dainorėliai;SAULUTĖS;4798415786;Ne;2;1;0;3
16796;Dainorėliai;SAULUTĖS;5102030168;Ne;0;1;0;1
16797;Dainorėliai;SAULUTĖS;6385439136;Taip;2;4;0;6
16798;Dainorėliai;SAULUTĖS;6704354150;Taip;8;5;0;13
16799;Dainorėliai;SAULUTĖS;6697149560;Taip;4;0;0;4
16800;Dainorėliai;SAULUTĖS;8977759216;Ne;3;0;0;3
16801;Dainorėliai;SAULUTĖS;8857018998;Ne;6;0;0;6
16802;Dainorėliai;SAULUTĖS;7118473669;Ne;16;0;0;16
16803;Dainorėliai;SAULUTĖS;4307591123;Taip;12;0;0;12
16804;Dainorėliai;SAULUTĖS;2070086316;Taip;2;0;0;2
16805;Dainorėliai;SAULUTĖS;5632663846;Taip;12;0;0;12
16806;Dainorėliai;SAULUTĖS;7804441689;Taip;5;0;0;5
16807;Dainorėliai;SAULUTĖS;6090746954;Taip;8;0;0;8
16808;Dainorėliai;SAULUTĖS;5410183494;Taip;9;0;0;9
16809;Dainorėliai;SAULUTĖS;9130473411;Taip;2;0;0;2
16810;Dainorėliai;SAULUTĖS;5587907483;Ne;5;0;0;5
16811;Dainorėliai;SAULUTĖS;1547686786;Ne;13;0;0;13
16812;Dainorėliai;SAULUTĖS;1552829080;Taip;1;4;0;5
16813;Dainorėliai;SAULUTĖS;3762178533;Ne;12;0;0;12
16814;Dainorėliai;PUMPURĖLIŲ;6513417505;Ne;4;10;0;14
16815;Dainorėliai;PUMPURĖLIŲ;8015545426;Taip;0;0;3;3
16816;Dainorėliai;PUMPURĖLIŲ;5691833295;Taip;4;0;0;4
16817;Dainorėliai;PUMPURĖLIŲ;4286864865;Taip;0;4;0;4
16818;Dainorėliai;PUMPURĖLIŲ;1554081754;Taip;0;5;8;13
16819;Dainorėliai;PUMPURĖLIŲ;2823401633;Taip;0;1;5;6
16820;Dainorėliai;PUMPURĖLIŲ;9562194143;Ne;0;1;1;2
16821;Dainorėliai;PUMPURĖLIŲ;1381923971;Taip;0;13;0;13
16822;Dainorėliai;PUMPURĖLIŲ;4033317616;Taip;9;0;0;9
16823;Dainorėliai;PUMPURĖLIŲ;9285865812;Taip;0;1;4;5
16824;Dainorėliai;PUMPURĖLIŲ;6284140548;Ne;1;1;9;11
16825;Dainorėliai;PUMPURĖLIŲ;5283566263;Taip;9;1;0;10
16826;Dainorėliai;PUMPURĖLIŲ;1826360100;Taip;3;0;0;3
16827;Dainorėliai;DEBESĖLIŲ;1300411811;Taip;0;24;0;24
16828;Dainorėliai;DEBESĖLIŲ;2003536788;Taip;7;8;0;15
16829;Dainorėliai;DEBESĖLIŲ;40087119136;Ne;0;5;0;5
16830;Dainorėliai;DEBESĖLIŲ;14071513289;Ne;0;7;0;7
16831;Dainorėliai;DEBESĖLIŲ;6378297641;Ne;0;1;0;1
16832;Dainorėliai;DEBESĖLIŲ;40762091796;Taip;0;9;0;9
16833;Dainorėliai;DEBESĖLIŲ;1355661922;Taip;0;10;0;10
16834;Dainorėliai;DEBESĖLIŲ;42514000113;Taip;0;3;0;3
16835;Dainorėliai;DEBESĖLIŲ;2093218810;Ne;4;3;0;7
16836;Dainorėliai;DEBESĖLIŲ;4058545269;Taip;0;3;0;3
16837;Dainorėliai;DEBESĖLIŲ;2531690903;Ne;6;5;0;11
16838;Dainorėliai;DEBESĖLIŲ;25015347703;Taip;15;6;0;21
16839;Dainorėliai;DEBESĖLIŲ;6994378824;Taip;5;2;0;7
16840;Lokiukas;BITUTĖS;6758550653;Taip;22;0;0;22
16841;Lokiukas;BITUTĖS;1040288021;Taip;0;10;1;11
16842;Lokiukas;BITUTĖS;1733486244;Taip;22;0;0;22
16843;Lokiukas;BITUTĖS;6336140882;Taip;0;4;4;8
16844;Lokiukas;BITUTĖS;9142262360;Taip;10;0;2;12
16845;Lokiukas;BITUTĖS;8775608581;Taip;3;0;4;7
16846;Lokiukas;BITUTĖS;1752784666;Taip;10;0;0;10
16847;Lokiukas;BITUTĖS;34546519642;Taip;13;0;0;13
16848;Lokiukas;BITUTĖS;1025576053;Taip;15;0;0;15
16849;Lokiukas;BITUTĖS;6069516217;Taip;0;11;0;11
16850;Lokiukas;BITUTĖS;7943213321;Taip;0;5;1;6
16851;Lokiukas;BITUTĖS;4007839265;Taip;7;1;1;9
16852;Lokiukas;BITUTĖS;8796640190;Taip;4;1;0;5
16853;Lokiukas;BITUTĖS;5943412920;Taip;4;1;1;6
16854;Lokiukas;BITUTĖS;4379238557;Taip;0;6;0;6
16855;Lokiukas;BITUTĖS;2052174669;Taip;10;5;0;15
16856;Lokiukas;BITUTĖS;8902619265;Taip;13;5;0;18
16857;Lokiukas;BITUTĖS;9336617879;Taip;5;1;1;7
16858;Lokiukas;BITUTĖS;3485639108;Taip;3;1;0;4
16859;Lokiukas;BITUTĖS;4060641736;Ne;0;5;1;6
16860;Lokiukas;"1 B klasė";18336619115;Taip;2;0;0;2
16861;Lokiukas;"1 B klasė";32506466236;Taip;4;0;0;4
16862;Lokiukas;"1 B klasė";7324496782;Taip;22;0;0;22
16863;Lokiukas;"1 B klasė";10811780420;Taip;4;0;0;4
16864;Lokiukas;"1 B klasė";28796727185;Ne;7;0;0;7
16865;Lokiukas;"1 B klasė";96046361641;Taip;10;0;0;10
16866;Lokiukas;"1 B klasė";95910336503;Taip;5;0;0;5
16867;Lokiukas;"1 B klasė";88415635113;Taip;5;0;0;5
16868;Lokiukas;"1 B klasė";7497324442;Ne;22;0;0;22
16869;Lokiukas;"1 B klasė";7903535850;Taip;5;0;0;5
16870;Lokiukas;"1 B klasė";61890775725;Taip;10;0;0;10
16871;Lokiukas;"1 B klasė";24221829774;Taip;5;0;0;5
16872;Lokiukas;"1 B klasė";58513885211;Taip;7;0;0;7
16873;Lokiukas;"1 B klasė";57958699478;Ne;6;0;0;6
16874;Lokiukas;"1 B klasė";79109699217;Taip;11;0;0;11
16875;Lokiukas;"1 B klasė";18646642032;Taip;12;0;0;12
16876;Lokiukas;"1 B klasė";50713289266;Taip;22;0;0;22
16877;Lokiukas;"1 B klasė";20231469825;Ne;1;0;0;1
16878;Lokiukas;"1 B klasė";1146878499;Ne;11;0;0;11
16879;Lokiukas;"1 B klasė";46587243900;Ne;8;0;0;8
16880;Lokiukas;"1 B klasė";9141446821;Taip;5;0;0;5
16881;Lokiukas;"1 B klasė";75507005694;Taip;10;0;0;10
16882;Lokiukas;"1 B klasė";73426072972;Ne;6;0;0;6
16883;Lokiukas;"1 B klasė";59913848400;Taip;6;0;0;6
16884;Lokiukas;"1 B klasė";39867459515;Taip;9;0;0;9
16885;Lokiukas;"1 B klasė";2105377652;Taip;5;0;0;5
16886;Lokiukas;"1 B klasė";62268017779;Taip;6;0;0;6
16887;Lokiukas;"1 A klasė";15406362908;Taip;6;0;0;6
16888;Lokiukas;"1 A klasė";45122233067;Taip;5;0;0;5
16889;Lokiukas;"1 A klasė";21802863853;Taip;5;0;0;5
16890;Lokiukas;"1 A klasė";84682977618;Taip;4;0;0;4
16891;Lokiukas;"1 A klasė";22979689191;Taip;7;0;0;7
16892;Lokiukas;"1 A klasė";80754592972;Taip;10;0;0;10
16893;Lokiukas;"1 A klasė";14903100496;Taip;5;0;0;5
16894;Lokiukas;"1 A klasė";99706061553;Taip;5;0;0;5
16895;Lokiukas;"1 A klasė";7785940412;Taip;22;0;0;22
16896;Lokiukas;"1 A klasė";24099693663;Taip;22;0;0;22
16897;Lokiukas;"1 A klasė";72092394330;Taip;5;0;0;5
16898;Lokiukas;"1 A klasė";9413274607;Taip;4;0;0;4
16899;Lokiukas;"1 A klasė";35769782473;Taip;4;0;0;4
16900;Lokiukas;"1 A klasė";38531751377;Taip;7;0;0;7
16901;Lokiukas;"1 A klasė";80793623068;Ne;5;0;0;5
16902;Lokiukas;"1 A klasė";25170045140;Ne;22;0;0;22
16903;Lokiukas;"1 A klasė";10948160841;Taip;22;0;0;22
16904;Lokiukas;"1 A klasė";4608275224;Taip;5;0;0;5
16905;Lokiukas;"1 A klasė";43070670534;Taip;4;0;0;4
16906;Lokiukas;"1 A klasė";59840033826;Taip;22;0;0;22
16907;Lokiukas;"1 A klasė";1855267362;Taip;5;0;0;5
16908;Lokiukas;"1 A klasė";84273668685;Taip;5;0;0;5
16909;Lokiukas;"1 A klasė";9747265775;Taip;22;0;0;22
16910;Lokiukas;"1 A klasė";5198408183;Taip;4;0;0;4
16911;Lokiukas;"1 A klasė";93374754851;Ne;5;0;0;5
16912;Lokiukas;"1 A klasė";15685936471;Taip;5;0;0;5
16913;Lokiukas;"1 A klasė";97609897018;Taip;6;0;0;6
16914;Lokiukas;"1 A klasė";23688235312;Taip;4;0;0;4
16915;Lokiukas;"1 A klasė";15574258138;Ne;5;0;0;5
16916;Lokiukas;"1 A klasė";9077016953;Taip;4;0;0;4
16917;Lokiukas;GUDRUČIAI;7334971595;Taip;4;0;1;5
16918;Lokiukas;GUDRUČIAI;83279104490;Taip;7;0;0;7
16919;Lokiukas;GUDRUČIAI;7235277422;Taip;0;2;0;2
16920;Lokiukas;GUDRUČIAI;7130407913;Taip;8;0;0;8
16921;Lokiukas;GUDRUČIAI;1072148409;Taip;7;0;1;8
16922;Lokiukas;GUDRUČIAI;7628603262;Taip;0;3;1;4
16923;Lokiukas;GUDRUČIAI;2959877846;Taip;0;0;1;1
16924;Lokiukas;GUDRUČIAI;32714964224;Taip;8;1;0;9
16925;Lokiukas;GUDRUČIAI;8920359311;Taip;8;1;0;9
16926;Lokiukas;GUDRUČIAI;1133294157;Taip;0;4;0;4
16927;Lokiukas;GUDRUČIAI;38884246104;Ne;0;0;1;1
16928;Lokiukas;GUDRUČIAI;29396361769;Ne;5;0;0;5
16929;Lokiukas;GUDRUČIAI;51059574159;Taip;6;0;1;7
16930;Lokiukas;GUDRUČIAI;61807094999;Taip;2;0;0;2
16931;Lokiukas;GUDRUČIAI;2955445066;Ne;0;0;3;3
16932;Lokiukas;BORUŽĖLĖS;4849031542;Taip;0;10;4;14
16933;Lokiukas;BORUŽĖLĖS;9307491947;Taip;7;1;0;8
16934;Lokiukas;BORUŽĖLĖS;3744484616;Taip;6;2;0;8
16935;Lokiukas;BORUŽĖLĖS;8286358519;Taip;0;1;2;3
16936;Lokiukas;BORUŽĖLĖS;2625981190;Taip;9;0;0;9
16937;Lokiukas;BORUŽĖLĖS;4585621105;Taip;0;12;0;12
16938;Lokiukas;BORUŽĖLĖS;8576418875;Taip;10;12;0;22
16939;Lokiukas;BORUŽĖLĖS;6869785650;Taip;5;3;0;8
16940;Lokiukas;BORUŽĖLĖS;8630112458;Taip;9;0;0;9
16941;Lokiukas;BORUŽĖLĖS;5467387832;Ne;6;1;0;7
16942;Lokiukas;BORUŽĖLĖS;3930463578;Taip;0;0;3;3
16943;Lokiukas;BORUŽĖLĖS;3333990952;Taip;10;0;0;10
16944;Lokiukas;BORUŽĖLĖS;5548875714;Taip;7;0;0;7
16945;Lokiukas;BORUŽĖLĖS;6277388612;Taip;2;0;0;2
16946;Lokiukas;BORUŽĖLĖS;1833001939;Taip;7;2;0;9
16947;Lokiukas;BORUŽĖLĖS;2660616022;Taip;6;0;0;6
16948;Lokiukas;BORUŽĖLĖS;9798351980;Taip;0;7;0;7
16949;Lokiukas;BORUŽĖLĖS;5401463671;Ne;0;22;0;22
16950;Lokiukas;BORUŽĖLĖS;9996442005;Ne;0;22;0;22
16951;Lokiukas;BORUŽĖLĖS;1226376844;Ne;0;1;0;1
16952;Lokiukas;ANČIUKAI;5518041213;Taip;5;3;0;8
16953;Lokiukas;ANČIUKAI;8738488104;Taip;5;0;0;5
16954;Lokiukas;ANČIUKAI;9834746275;Taip;3;0;0;3
16955;Lokiukas;ANČIUKAI;4197547631;Taip;5;9;0;14
16956;Lokiukas;ANČIUKAI;8596706753;Taip;0;6;0;6
16957;Lokiukas;ANČIUKAI;7006828256;Taip;4;3;0;7
16958;Lokiukas;ANČIUKAI;2782818158;Taip;0;6;0;6
16959;Lokiukas;ANČIUKAI;1170293017;Taip;0;12;0;12
16960;Lokiukas;ANČIUKAI;7532603655;Taip;2;5;0;7
16961;Lokiukas;ANČIUKAI;2021477393;Taip;0;6;0;6
16962;Lokiukas;ANČIUKAI;4442073527;Taip;5;2;0;7
16963;Lokiukas;ANČIUKAI;4858829710;Taip;9;0;1;10
16964;Lokiukas;ANČIUKAI;8329540746;Taip;0;0;1;1
16965;Lokiukas;KODĖLČIUKAI;2548712970;Taip;0;1;0;1
16966;Lokiukas;KODĖLČIUKAI;2673522432;Taip;7;2;0;9
16967;Lokiukas;KODĖLČIUKAI;9625041533;Ne;2;2;0;4
16968;Lokiukas;KODĖLČIUKAI;8399364170;Taip;4;6;0;10
16969;Lokiukas;KODĖLČIUKAI;4427448272;Taip;3;1;0;4
16970;Lokiukas;KODĖLČIUKAI;4580716838;Taip;0;1;0;1
16971;Lokiukas;KODĖLČIUKAI;1201125655;Taip;0;2;0;2
16972;Lokiukas;KODĖLČIUKAI;67133709394;Taip;5;0;0;5
16973;Lokiukas;KODĖLČIUKAI;73696992182;Taip;8;3;0;11
16974;Lokiukas;KODĖLČIUKAI;1056075876;Taip;5;0;0;5
16975;Lokiukas;KODĖLČIUKAI;82025637099;Taip;7;0;0;7
16976;Lokiukas;KODĖLČIUKAI;8846527481;Taip;0;12;0;12
16977;Lokiukas;KODĖLČIUKAI;73515179103;Taip;0;0;1;1
16978;Lokiukas;KODĖLČIUKAI;131300206;Taip;0;6;0;6
16979;Lokiukas;KODĖLČIUKAI;66528256040;Taip;0;2;0;2
16980;Lokiukas;KODĖLČIUKAI;7495691956;Ne;5;3;0;8
16981;Lokiukas;KODĖLČIUKAI;83528495608;Ne;0;7;0;7
16982;Lokiukas;KODĖLČIUKAI;1333650630;Ne;3;3;0;6
16983;Lokiukas;KODĖLČIUKAI;52940830874;Ne;4;4;0;8
16984;Lokiukas;KODĖLČIUKAI;8240261104;Taip;0;1;0;1
16985;Lokiukas;KODĖLČIUKAI;41809745552;Taip;4;0;0;4
16986;Lokiukas;KODĖLČIUKAI;83086633109;Taip;0;0;1;1
16987;Lokiukas;KODĖLČIUKAI;4353695640;Ne;0;3;0;3
16988;Lokiukas;KODĖLČIUKAI;2170176922;Ne;0;5;0;5
16989;Lokiukas;DRUGELIAI;8568285232;Taip;18;1;0;19
16990;Lokiukas;DRUGELIAI;5453470660;Taip;5;3;0;8
16991;Lokiukas;DRUGELIAI;5879386524;Taip;6;4;2;12
16992;Lokiukas;DRUGELIAI;46838695582;Taip;18;0;0;18
16993;Lokiukas;DRUGELIAI;2642065594;Taip;6;1;0;7
16994;Lokiukas;DRUGELIAI;1626698185;Taip;9;1;0;10
16995;Lokiukas;DRUGELIAI;39222094073;Taip;7;3;0;10
16996;Lokiukas;DRUGELIAI;69364831994;Taip;0;0;1;1
16997;Lokiukas;DRUGELIAI;78106313493;Taip;2;2;0;4
16998;Lokiukas;DRUGELIAI;1625137322;Taip;0;7;0;7
16999;Lokiukas;DRUGELIAI;1381505711;Taip;0;10;0;10
17000;Lokiukas;DRUGELIAI;8452600632;Taip;9;5;0;14
17001;Lokiukas;DRUGELIAI;7386571822;Ne;6;7;0;13
17002;Lokiukas;DRUGELIAI;35890122494;Taip;11;1;0;12
17003;Lokiukas;DRUGELIAI;1210407640;Taip;8;0;0;8
17004;Lokiukas;DRUGELIAI;7591418969;Taip;14;0;0;14
17005;Lokiukas;DRUGELIAI;8036643654;Taip;10;1;0;11
17006;Lokiukas;DRUGELIAI;2476231041;Ne;3;2;0;5
17007;Lokiukas;DRUGELIAI;5528406839;Ne;0;2;0;2
17008;Lokiukas;DRUGELIAI;1230490562;Ne;4;6;0;10
17009;Lokiukas;"2 A klasė";67818191566;Ne;7;0;0;7
17010;Lokiukas;"2 A klasė";45280536946;Taip;22;0;0;22
17011;Lokiukas;"2 A klasė";53087036306;Taip;22;0;0;22
17012;Lokiukas;"2 A klasė";79223457439;Ne;4;0;0;4
17013;Lokiukas;"2 A klasė";75613665040;Taip;5;0;0;5
17014;Lokiukas;"2 A klasė";1143130271;Ne;7;0;0;7
17015;Lokiukas;"2 A klasė";86623153797;Taip;5;0;0;5
17016;Lokiukas;"2 A klasė";27050402360;Ne;4;0;0;4
17017;Lokiukas;"2 A klasė";43389930516;Taip;5;0;0;5
17018;Lokiukas;"2 A klasė";53245573692;Taip;6;0;0;6
17019;Lokiukas;"2 A klasė";23222644824;Taip;7;0;0;7
17020;Lokiukas;"2 A klasė";52296454506;Ne;9;0;0;9
17021;Lokiukas;"2 A klasė";66999644935;Taip;22;0;0;22
17022;Lokiukas;"2 A klasė";72167964645;Ne;5;0;0;5
17023;Lokiukas;"2 A klasė";2143040924;Taip;22;0;0;22
17024;Lokiukas;"2 A klasė";3206276637;Taip;22;0;0;22
17025;Lokiukas;"2 A klasė";5775631777;Ne;5;0;0;5
17026;Lokiukas;"2 A klasė";38636200254;Ne;7;0;0;7
17027;Lokiukas;"2 A klasė";47410036889;Taip;4;0;0;4
17028;Lokiukas;"2 A klasė";53544600623;Taip;4;0;0;4
17029;Lokiukas;"2 A klasė";14341255985;Taip;5;0;0;5
17030;Lokiukas;"2 A klasė";6702448475;Taip;10;0;0;10
17031;Lokiukas;"2 A klasė";82966541165;Taip;5;0;0;5
17032;Lokiukas;"2 A klasė";80180114948;Taip;9;0;0;9
17033;Lokiukas;"2 A klasė";42292408557;Taip;6;0;0;6
17034;Lokiukas;"2 A klasė";10240586503;Taip;22;0;0;22
17035;Lokiukas;"2 A klasė";3703002168;Taip;4;0;0;4
17036;Lokiukas;"2 B klasė";35018370441;Taip;1;0;0;1
17037;Lokiukas;"2 B klasė";60370754283;Taip;10;0;0;10
17038;Lokiukas;"2 B klasė";98289469398;Taip;3;0;0;3
17039;Lokiukas;"2 B klasė";15445053855;Taip;5;0;0;5
17040;Lokiukas;"2 B klasė";3262579895;Taip;6;0;0;6
17041;Lokiukas;"2 B klasė";51554951703;Taip;9;0;0;9
17042;Lokiukas;"2 B klasė";88947878548;Ne;5;0;0;5
17043;Lokiukas;"2 B klasė";29198900240;Taip;4;0;0;4
17044;Lokiukas;"2 B klasė";17034757778;Taip;3;0;0;3
17045;Lokiukas;"2 B klasė";1716358913;Taip;5;0;0;5
17046;Lokiukas;"2 B klasė";77441549037;Taip;5;0;0;5
17047;Lokiukas;"2 B klasė";79301547085;Taip;1;0;0;1
17048;Lokiukas;"2 B klasė";10897713744;Taip;3;0;0;3
17049;Lokiukas;"2 B klasė";16889795010;Taip;22;0;0;22
17050;Lokiukas;"2 B klasė";5067673212;Taip;7;0;0;7
17051;Lokiukas;"2 B klasė";1104333637;Taip;9;0;0;9
17052;Lokiukas;"2 B klasė";79597160668;Taip;3;0;0;3
17053;Lokiukas;"2 B klasė";45735190114;Taip;22;0;0;22
17054;Lokiukas;"2 B klasė";37669645510;Taip;3;0;0;3
17055;Lokiukas;"2 B klasė";2353550739;Taip;22;0;0;22
17056;Lokiukas;"2 B klasė";15004419516;Taip;6;0;0;6
17057;Lokiukas;"2 B klasė";69089214980;Taip;4;0;0;4
17058;Lokiukas;"3 A klasė";2374089307;Taip;6;0;0;6
17059;Lokiukas;"3 A klasė";2607988265;Taip;8;0;0;8
17060;Lokiukas;"3 A klasė";4992275038;Taip;6;0;0;6
17061;Lokiukas;"3 A klasė";1492303633;Taip;5;0;0;5
17062;Lokiukas;"3 A klasė";6856770462;Ne;5;0;0;5
17063;Lokiukas;"3 A klasė";8766212402;Ne;6;0;0;6
17064;Lokiukas;"3 A klasė";5559967651;Taip;22;0;0;22
17065;Lokiukas;"3 A klasė";3528533437;Taip;22;0;0;22
17066;Lokiukas;"3 A klasė";5465758477;Taip;5;0;0;5
17067;Lokiukas;"3 A klasė";5700685872;Ne;9;0;0;9
17068;Lokiukas;"3 A klasė";6496662759;Taip;14;0;0;14
17069;Lokiukas;"3 A klasė";5737714024;Ne;9;0;0;9
17070;Lokiukas;"3 A klasė";7069020705;Ne;7;0;0;7
17071;Lokiukas;"3 A klasė";6129602024;Ne;6;0;0;6
17072;Lokiukas;"3 A klasė";9199283952;Taip;22;0;0;22
17073;Lokiukas;"3 A klasė";8378630091;Taip;5;0;0;5
17074;Lokiukas;"3 A klasė";3138145333;Ne;22;0;0;22
17075;Lokiukas;"3 A klasė";3506723678;Taip;13;0;0;13
17076;Lokiukas;"3 A klasė";1555365851;Ne;12;0;0;12
17077;Lokiukas;"3 A klasė";4615481025;Ne;9;0;0;9
17078;Lokiukas;"3 A klasė";5889819809;Ne;6;0;0;6
17079;Lokiukas;"3 A klasė";8499895935;Taip;22;0;0;22
17080;Lokiukas;"3 A klasė";7553457572;Ne;12;0;0;12
17081;Lokiukas;"3 A klasė";1571404671;Taip;7;0;0;7
17082;Lokiukas;"3 A klasė";1729941577;Taip;7;0;0;7
17083;Lokiukas;"3 B klasė";5745254234;Taip;6;0;0;6
17084;Lokiukas;"3 B klasė";8189433550;Taip;22;0;0;22
17085;Lokiukas;"3 B klasė";9114504810;Taip;8;0;0;8
17086;Lokiukas;"3 B klasė";1048772300;Taip;8;0;0;8
17087;Lokiukas;"3 B klasė";2021690274;Taip;5;0;0;5
17088;Lokiukas;"3 B klasė";5918592397;Taip;15;0;0;15
17089;Lokiukas;"3 B klasė";6538311120;Taip;14;0;0;14
17090;Lokiukas;"3 B klasė";7595514531;Taip;9;0;0;9
17091;Lokiukas;"3 B klasė";7144013238;Taip;22;0;0;22
17092;Lokiukas;"3 B klasė";8235437961;Taip;5;0;0;5
17093;Lokiukas;"3 B klasė";2905935730;Taip;22;0;0;22
17094;Lokiukas;"3 B klasė";8395026474;Ne;10;0;0;10
17095;Lokiukas;"3 B klasė";7439047502;Taip;5;0;0;5
17096;Lokiukas;"3 B klasė";8954484534;Taip;12;0;0;12
17097;Lokiukas;"3 B klasė";7722830021;Taip;5;0;0;5
17098;Lokiukas;"3 B klasė";9681048306;Taip;6;0;0;6
17099;Lokiukas;"3 B klasė";1388342336;Taip;10;0;0;10
17100;Lokiukas;"3 B klasė";1746819279;Taip;7;0;0;7
17101;Lokiukas;"3 B klasė";4418425219;Taip;8;0;0;8
17102;Lokiukas;"3 B klasė";3364994110;Taip;22;0;0;22
17103;Lokiukas;"3 B klasė";6063796643;Taip;7;0;0;7
17104;Lokiukas;"3 B klasė";6663700618;Taip;5;0;0;5
17105;Lokiukas;"3 B klasė";6151885589;Taip;6;0;0;6
17106;Lokiukas;"3 B klasė";1440437389;Taip;8;0;0;8
17107;Lokiukas;"3 B klasė";2059112380;Taip;12;0;0;12
17108;Lokiukas;"3 B klasė";1676862169;Ne;5;0;0;5
17109;Lokiukas;"4 A klasė";2220223549;Taip;22;0;0;22
17110;Lokiukas;"4 A klasė";7349936354;Ne;22;0;0;22
17111;Lokiukas;"4 A klasė";8192834838;Taip;7;0;0;7
17112;Lokiukas;"4 A klasė";7086818828;Taip;22;0;0;22
17113;Lokiukas;"4 A klasė";8959417696;Taip;6;0;0;6
17114;Lokiukas;"4 A klasė";1362995666;Taip;5;0;0;5
17115;Lokiukas;"4 A klasė";4873942674;Taip;22;0;0;22
17116;Lokiukas;"4 A klasė";2745780921;Taip;6;0;0;6
17117;Lokiukas;"4 A klasė";3007573139;Taip;18;0;0;18
17118;Lokiukas;"4 A klasė";5058488696;Taip;6;0;0;6
17119;Lokiukas;"4 A klasė";6008557035;Taip;16;0;0;16
17120;Lokiukas;"4 A klasė";1243245356;Taip;6;0;0;6
17121;Lokiukas;"4 A klasė";9322204885;Taip;22;0;0;22
17122;Lokiukas;"4 A klasė";1822055099;Ne;22;0;0;22
17123;Lokiukas;"4 A klasė";3700837936;Taip;6;0;0;6
17124;Lokiukas;"4 A klasė";6022402998;Taip;6;0;0;6
17125;Lokiukas;"4 A klasė";9743363133;Taip;13;0;0;13
17126;Lokiukas;"4 A klasė";2029507962;Taip;11;0;0;11
17127;Lokiukas;"4 A klasė";88967710414;Taip;8;0;0;8
17128;Lokiukas;"4 A klasė";2129701351;Taip;15;0;0;15
17129;Lokiukas;"4 B klasė";1692231191;Taip;5;0;0;5
17130;Lokiukas;"4 B klasė";2284932363;Taip;22;0;0;22
17131;Lokiukas;"4 B klasė";4160279615;Taip;14;0;0;14
17132;Lokiukas;"4 B klasė";4368235682;Taip;5;0;0;5
17133;Lokiukas;"4 B klasė";9376247296;Taip;9;0;0;9
17134;Lokiukas;"4 B klasė";7943448919;Ne;6;0;0;6
17135;Lokiukas;"4 B klasė";9922964495;Taip;10;0;0;10
17136;Lokiukas;"4 B klasė";8822883914;Ne;8;0;0;8
17137;Lokiukas;"4 B klasė";6270747705;Taip;13;0;0;13
17138;Lokiukas;"4 B klasė";9390626220;Taip;22;0;0;22
17139;Lokiukas;"4 B klasė";5562737843;Taip;5;0;0;5
17140;Lokiukas;"4 B klasė";4467643205;Taip;10;0;0;10
17141;Lokiukas;"4 B klasė";6110849113;Taip;6;0;0;6
17142;Lokiukas;"4 B klasė";8175005473;Taip;9;0;0;9
17143;Lokiukas;"4 B klasė";4504812769;Taip;12;0;0;12
17144;Lokiukas;"4 B klasė";6210160161;Taip;18;0;0;18
17145;Lokiukas;"4 B klasė";1727242060;Taip;22;0;0;22
17146;Lokiukas;"4 B klasė";8300861451;Taip;17;0;0;17
17147;Lokiukas;"4 B klasė";7692067948;Taip;5;0;0;5
17148;Lokiukas;"4 B klasė";7728788069;Taip;22;0;0;22
17149;Lokiukas;"4 B klasė";9985555940;Ne;22;0;0;22
17150;Lokiukas;"4 B klasė";4447860405;Taip;22;0;0;22
17151;Lokiukas;"4 B klasė";3823547337;Taip;6;0;0;6
17152;Lokiukas;"4 B klasė";5496591880;Taip;22;0;0;22
17153;Lokiukas;"4 B klasė";1491789191;Taip;8;0;0;8
17154;Lokiukas;"4 B klasė";1419846182;Taip;17;0;0;17
17155;Lokiukas;"4 B klasė";9310088026;Taip;5;0;0;5
17156;Lokiukas;"4 B klasė";1787800667;Taip;7;0;0;7
17157;Šaltinėlis;Ančiukų;3011747942;Taip;0;6;0;6
17158;Šaltinėlis;Ančiukų;9769491789;Taip;0;11;0;11
17159;Šaltinėlis;Ančiukų;56396772538;Taip;12;2;0;14
17160;Šaltinėlis;Ančiukų;6462738640;Taip;0;1;1;2
17161;Šaltinėlis;Ančiukų;3493429067;Taip;7;0;2;9
17162;Šaltinėlis;Ančiukų;77872075694;Taip;5;0;0;5
17163;Šaltinėlis;Ančiukų;9218883174;Ne;6;0;0;6
17164;Šaltinėlis;Ančiukų;7133143923;Taip;11;2;0;13
17165;Šaltinėlis;Ančiukų;9820788524;Taip;0;12;0;12
17166;Šaltinėlis;Ančiukų;3691635011;Ne;8;0;0;8
17167;Šaltinėlis;Ančiukų;2630875135;Taip;11;0;0;11
17168;Šaltinėlis;Ančiukų;2973820849;Ne;0;9;0;9
17169;Šaltinėlis;Ančiukų;1464992631;Taip;9;4;0;13
17170;Šaltinėlis;Ančiukų;9274165569;Taip;0;6;0;6
17171;Šaltinėlis;Ančiukų;8500790262;Taip;0;6;0;6
17172;Šaltinėlis;Ančiukų;4332884673;Taip;0;2;0;2
17173;Šaltinėlis;Ančiukų;9362495172;Ne;0;11;0;11
17174;Šaltinėlis;Ančiukų;7737797979;Taip;8;5;0;13
17175;Šaltinėlis;Ančiukų;5455278072;Taip;0;9;0;9
17176;Šaltinėlis;Ančiukų;6887838949;Taip;18;0;0;18
17177;Šaltinėlis;Ančiukų;2084451705;Ne;6;0;0;6
17178;Šaltinėlis;Bitučių;3455754351;Taip;3;2;0;5
17179;Šaltinėlis;Bitučių;1224027643;Taip;0;6;0;6
17180;Šaltinėlis;Bitučių;35748040565;Taip;0;3;0;3
17181;Šaltinėlis;Bitučių;86592374576;Taip;0;0;16;16
17182;Šaltinėlis;Bitučių;3022926855;Taip;4;1;0;5
17183;Šaltinėlis;Bitučių;32264290873;Ne;0;8;0;8
17184;Šaltinėlis;Bitučių;1767635282;Taip;0;4;0;4
17185;Šaltinėlis;Bitučių;1390316465;Taip;0;12;0;12
17186;Šaltinėlis;Bitučių;37786438977;Taip;0;7;0;7
17187;Šaltinėlis;Bitučių;5442943843;Taip;0;6;0;6
17188;Šaltinėlis;Bitučių;6764006747;Taip;0;8;0;8
17189;Šaltinėlis;Bitučių;1658370782;Ne;4;7;0;11
17190;Šaltinėlis;Bitučių;10918276041;Taip;0;5;0;5
17191;Šaltinėlis;Bitučių;66575684640;Taip;5;2;0;7
17192;Šaltinėlis;Bitučių;1718488108;Taip;0;3;0;3
17193;Šaltinėlis;Bitučių;79406746980;Taip;0;4;0;4
17194;Šaltinėlis;Bitučių;3577137327;Taip;0;5;0;5
17195;Šaltinėlis;Bitučių;48525545812;Taip;0;3;0;3
17196;Šaltinėlis;Bitučių;7073644279;Taip;0;7;0;7
17197;Šaltinėlis;Bitučių;1456486363;Taip;0;17;0;17
17198;Šaltinėlis;Bitučių;32949623652;Taip;0;13;0;13
17199;Šaltinėlis;Bitučių;1614411921;Ne;0;10;0;10
17200;Šaltinėlis;Saulutės;7311831014;Taip;2;1;0;3
17201;Šaltinėlis;Saulutės;5854723120;Taip;0;6;0;6
17202;Šaltinėlis;Saulutės;5833136956;Taip;6;0;0;6
17203;Šaltinėlis;Saulutės;3483756240;Taip;13;0;1;14
17204;Šaltinėlis;Saulutės;6380346298;Taip;5;0;0;5
17205;Šaltinėlis;Saulutės;5799032398;Taip;18;0;0;18
17206;Šaltinėlis;Saulutės;5525740049;Taip;9;4;0;13
17207;Šaltinėlis;Saulutės;9762392403;Ne;22;0;0;22
17208;Šaltinėlis;Saulutės;5343279219;Ne;7;1;0;8
17209;Šaltinėlis;Saulutės;7118672118;Taip;10;0;0;10
17210;Šaltinėlis;Saulutės;2465009553;Taip;10;0;0;10
17211;Šaltinėlis;Saulutės;9108653045;Taip;10;4;0;14
17212;Šaltinėlis;Saulutės;5345738219;Ne;17;0;0;17
17213;Šaltinėlis;Saulutės;6721510313;Taip;18;0;0;18
17214;Šaltinėlis;Saulutės;7650840990;Taip;12;1;0;13
17215;Šaltinėlis;Saulutės;3507180650;Ne;9;0;0;9
17216;Šaltinėlis;Saulutės;1678450741;Ne;22;0;0;22
17217;Šaltinėlis;Meškiukų;3264138693;Taip;0;9;0;9
17218;Šaltinėlis;Meškiukų;2013810425;Taip;3;3;0;6
17219;Šaltinėlis;Meškiukų;1045163890;Ne;22;0;0;22
17220;Šaltinėlis;Meškiukų;7231645416;Ne;7;0;0;7
17221;Šaltinėlis;Meškiukų;8555517284;Taip;10;8;0;18
17222;Šaltinėlis;Meškiukų;9757246434;Taip;22;0;0;22
17223;Šaltinėlis;Meškiukų;1073305554;Taip;0;0;1;1
17224;Šaltinėlis;Meškiukų;7483928256;Taip;0;1;0;1
17225;Šaltinėlis;Meškiukų;3516760367;Taip;7;0;0;7
17226;Šaltinėlis;Meškiukų;2628936055;Taip;14;0;0;14
17227;Šaltinėlis;Meškiukų;5256665649;Taip;3;0;1;4
17228;Šaltinėlis;Meškiukų;2700475528;Taip;0;6;0;6
17229;Šaltinėlis;Meškiukų;1035890284;Taip;10;0;1;11
17230;Šaltinėlis;Meškiukų;6880337593;Ne;0;2;0;2
17231;Šaltinėlis;Meškiukų;9968637187;Taip;0;13;0;13
17232;Šaltinėlis;Nykštukai;1823048790;Taip;11;0;0;11
17233;Šaltinėlis;Nykštukai;9522524163;Ne;13;0;0;13
17234;Šaltinėlis;Nykštukai;4681460322;Ne;0;5;0;5
17235;Šaltinėlis;Nykštukai;4430546695;Taip;5;0;0;5
17236;Šaltinėlis;Nykštukai;1686009371;Taip;0;22;0;22
17237;Šaltinėlis;Nykštukai;9075507649;Taip;9;0;0;9
17238;Šaltinėlis;Nykštukai;7068058767;Ne;5;5;0;10
17239;Šaltinėlis;Nykštukai;8914777163;Taip;8;5;0;13
17240;Šaltinėlis;Nykštukai;7387221265;Taip;0;2;0;2
17241;Šaltinėlis;Nykštukai;3073692882;Taip;0;10;0;10
17242;Šaltinėlis;Nykštukai;2126751248;Taip;7;0;0;7
17243;Šaltinėlis;Nykštukai;7133044918;Taip;14;0;0;14
17244;Šaltinėlis;Nykštukai;2806453623;Taip;13;0;0;13
17245;Šaltinėlis;Nykštukai;8695191968;Taip;22;0;0;22
17246;Šaltinėlis;Nykštukai;2825412170;Taip;19;0;0;19
17247;Šaltinėlis;Perliukų;17147527171;Ne;2;1;0;3
17248;Šaltinėlis;Perliukų;11083638216;Taip;0;9;0;9
17249;Šaltinėlis;Perliukų;1091056386;Taip;6;0;0;6
17250;Šaltinėlis;Perliukų;52507085619;Taip;0;1;3;4
17251;Šaltinėlis;Perliukų;1958647188;Ne;0;8;0;8
17252;Šaltinėlis;Perliukų;2034838765;Taip;9;0;0;9
17253;Šaltinėlis;Perliukų;1935762293;Taip;3;0;1;4
17254;Šaltinėlis;Perliukų;1583520894;Ne;9;0;0;9
17255;Šaltinėlis;Perliukų;1023238509;Taip;0;9;0;9
17256;Šaltinėlis;Perliukų;84494627465;Taip;2;1;0;3
17257;Šaltinėlis;Perliukų;98941037508;Taip;0;1;0;1
17258;Šaltinėlis;Perliukų;1004445904;Taip;0;1;0;1
17259;Šaltinėlis;Perliukų;9425353041;Taip;0;10;0;10
17260;Šaltinėlis;Perliukų;526307704;Taip;0;17;0;17
17261;Šaltinėlis;Perliukų;7262120071;Ne;4;0;0;4
17262;Šaltinėlis;Perliukų;6068980312;Taip;0;4;0;4
17263;Šaltinėlis;Perliukų;5869977541;Taip;6;3;0;9
17264;Šaltinėlis;Perliukų;2333071711;Ne;10;0;0;10
17265;Šaltinėlis;Perliukų;1580090516;Taip;0;6;1;7
17266;Šaltinėlis;BORUŽĖLĖS;8896316882;Taip;3;0;1;4
17267;Šaltinėlis;BORUŽĖLĖS;5325974488;Taip;14;0;0;14
17268;Šaltinėlis;BORUŽĖLĖS;1445108285;Taip;9;1;0;10
17269;Šaltinėlis;BORUŽĖLĖS;9759912102;Taip;0;1;0;1
17270;Šaltinėlis;BORUŽĖLĖS;6586783795;Taip;10;2;0;12
17271;Šaltinėlis;BORUŽĖLĖS;9691993251;Taip;9;0;0;9
17272;Šaltinėlis;BORUŽĖLĖS;4248763165;Ne;8;0;0;8
17273;Šaltinėlis;BORUŽĖLĖS;2189112609;Taip;9;0;0;9
17274;Šaltinėlis;BORUŽĖLĖS;9674923143;Taip;8;0;0;8
17275;Šaltinėlis;BORUŽĖLĖS;2022956307;Taip;16;0;0;16
17276;Šaltinėlis;BORUŽĖLĖS;7955094634;Taip;9;0;0;9
17277;Šaltinėlis;BORUŽĖLĖS;4664741207;Taip;15;0;0;15
17278;Šaltinėlis;BORUŽĖLĖS;9950106412;Taip;19;0;0;19
17279;Šaltinėlis;BORUŽĖLĖS;8995077908;Taip;20;0;0;20
17280;Šaltinėlis;BORUŽĖLĖS;5982188743;Ne;16;0;0;16
17281;Šaltinėlis;"4B klasė";2413295020;Ne;0;22;0;22
17282;Šaltinėlis;"4B klasė";7404225862;Ne;0;4;0;4
17283;Šaltinėlis;"4B klasė";3375856084;Ne;0;5;0;5
17284;Šaltinėlis;"4B klasė";8670777468;Ne;0;5;0;5
17285;Šaltinėlis;"4B klasė";1687964284;Ne;0;4;0;4
17286;Šaltinėlis;"4B klasė";5105961386;Ne;0;9;0;9
17287;Šaltinėlis;"4B klasė";7121732840;Ne;0;22;0;22
17288;Šaltinėlis;"4B klasė";7917468152;Taip;0;3;0;3
17289;Šaltinėlis;"4B klasė";4335720836;Ne;0;3;0;3
17290;Šaltinėlis;"4B klasė";4994088781;Ne;0;1;0;1
17291;Šaltinėlis;"4B klasė";3680528737;Ne;0;5;0;5
17292;Šaltinėlis;"4B klasė";9708038079;Ne;0;7;0;7
17293;Šaltinėlis;"4B klasė";2160937385;Ne;0;22;0;22
17294;Šaltinėlis;"4B klasė";6381956693;Ne;0;22;0;22
17295;Šaltinėlis;"4B klasė";5181754988;Ne;0;5;0;5
17296;Šaltinėlis;"4B klasė";4543101402;Ne;0;6;0;6
17297;Šaltinėlis;1A;14213856824;Taip;0;3;0;3
17298;Šaltinėlis;1A;80649337160;Taip;0;3;0;3
17299;Šaltinėlis;1A;92958012146;Taip;0;4;0;4
17300;Šaltinėlis;1A;84656960510;Taip;0;4;0;4
17301;Šaltinėlis;1A;83621946293;Taip;0;22;0;22
17302;Šaltinėlis;1A;67808618878;Ne;0;3;0;3
17303;Šaltinėlis;1A;1278910777;Taip;0;4;0;4
17304;Šaltinėlis;1A;9647785988;Ne;0;22;0;22
17305;Šaltinėlis;1A;82671662416;Taip;0;9;0;9
17306;Šaltinėlis;1A;54025577281;Taip;0;3;0;3
17307;Šaltinėlis;1A;29482180151;Taip;0;4;0;4
17308;Šaltinėlis;1A;54753218491;Taip;0;2;0;2
17309;Šaltinėlis;1A;86029472773;Taip;0;2;0;2
17310;Šaltinėlis;1A;64821172553;Taip;0;9;0;9
17311;Šaltinėlis;1A;5744976843;Taip;0;22;0;22
17312;Šaltinėlis;1A;25459069972;Ne;0;5;0;5
17313;Šaltinėlis;1A;6669392157;Taip;0;5;0;5
17314;Šaltinėlis;1A;89358384113;Taip;0;10;0;10
17315;Šaltinėlis;1A;28956971978;Taip;0;3;0;3
17316;Šaltinėlis;1A;4050444191;Taip;0;3;0;3
17317;Šaltinėlis;1A;89093437170;Taip;0;3;0;3
17318;Šaltinėlis;1A;51872331010;Taip;0;11;0;11
17319;Šaltinėlis;1A;5056986469;Taip;0;22;0;22
17320;Šaltinėlis;1A;488285764;Taip;0;3;0;3
17321;Šaltinėlis;"2A klasė";83657465071;Taip;0;3;0;3
17322;Šaltinėlis;"2A klasė";86309198604;Taip;0;3;0;3
17323;Šaltinėlis;"2A klasė";9705941341;Taip;0;22;0;22
17324;Šaltinėlis;"2A klasė";38496350161;Taip;0;22;0;22
17325;Šaltinėlis;"2A klasė";62612067151;Taip;0;8;0;8
17326;Šaltinėlis;"2A klasė";96133834896;Ne;0;22;0;22
17327;Šaltinėlis;"2A klasė";2323456393;Ne;0;22;0;22
17328;Šaltinėlis;"2A klasė";56279691365;Taip;0;5;0;5
17329;Šaltinėlis;"2A klasė";4587186145;Taip;0;4;0;4
17330;Šaltinėlis;"2A klasė";70948186548;Taip;0;5;0;5
17331;Šaltinėlis;"2A klasė";47045578599;Taip;0;11;0;11
17332;Šaltinėlis;"2A klasė";36718328105;Taip;0;3;0;3
17333;Šaltinėlis;"2A klasė";86995081866;Taip;0;3;0;3
17334;Šaltinėlis;"2A klasė";7929809205;Ne;0;4;0;4
17335;Šaltinėlis;"2A klasė";29683761586;Ne;0;7;0;7
17336;Šaltinėlis;"2A klasė";40769315138;Taip;0;9;0;9
17337;Šaltinėlis;"2A klasė";7563879445;Ne;0;7;0;7
17338;Šaltinėlis;"2A klasė";66754907606;Taip;0;22;0;22
17339;Šaltinėlis;"2A klasė";35387543586;Taip;0;6;0;6
17340;Šaltinėlis;"2A klasė";9927833966;Ne;0;4;0;4
17341;Šaltinėlis;"3A klasė";7214517805;Ne;0;22;0;22
17342;Šaltinėlis;"3A klasė";9978493148;Ne;0;5;0;5
17343;Šaltinėlis;"3A klasė";1839665658;Ne;0;3;0;3
17344;Šaltinėlis;"3A klasė";8445115141;Ne;0;5;0;5
17345;Šaltinėlis;"3A klasė";1450894955;Ne;0;22;0;22
17346;Šaltinėlis;"3A klasė";8898225999;Ne;0;22;0;22
17347;Šaltinėlis;"3A klasė";6044895102;Ne;0;4;0;4
17348;Šaltinėlis;"3A klasė";7967108692;Ne;0;3;0;3
17349;Šaltinėlis;"3A klasė";4843823058;Ne;0;7;0;7
17350;Šaltinėlis;"3A klasė";92001008485;Taip;0;5;0;5
17351;Šaltinėlis;"3A klasė";7264810605;Ne;0;4;0;4
17352;Šaltinėlis;"3A klasė";7058348243;Ne;0;4;0;4
17353;Šaltinėlis;"3A klasė";5012608633;Ne;0;3;0;3
17354;Šaltinėlis;"3A klasė";2076892804;Ne;0;8;0;8
17355;Šaltinėlis;"3A klasė";8680271000;Ne;0;22;0;22
17356;Šaltinėlis;"3A klasė";6876036723;Ne;0;4;0;4
17357;Šaltinėlis;"3A klasė";6171441011;Ne;0;5;0;5
17358;Šaltinėlis;"4A klasė";9057225956;Ne;0;4;0;4
17359;Šaltinėlis;"4A klasė";8714253922;Ne;0;4;0;4
17360;Šaltinėlis;"4A klasė";6765467361;Ne;0;5;0;5
17361;Šaltinėlis;"4A klasė";2010277249;Ne;0;7;0;7
17362;Šaltinėlis;"4A klasė";3636296862;Ne;0;5;0;5
17363;Šaltinėlis;"4A klasė";4062628468;Ne;0;6;0;6
17364;Šaltinėlis;"4A klasė";6948074305;Ne;0;4;0;4
17365;Šaltinėlis;"4A klasė";2154195956;Ne;0;22;0;22
17366;Šaltinėlis;"4A klasė";47857916979;Taip;0;22;0;22
17367;Šaltinėlis;"4A klasė";6443537515;Ne;0;22;0;22
17368;Šaltinėlis;"4A klasė";57928407025;Ne;0;22;0;22
17369;Šaltinėlis;"4A klasė";8503985429;Ne;0;6;0;6
17370;Šaltinėlis;"4A klasė";4977611599;Ne;0;6;0;6
17371;Šaltinėlis;"4A klasė";24414070672;Ne;0;22;0;22
17372;Šaltinėlis;"4A klasė";3553168020;Ne;0;3;0;3
17373;Šaltinėlis;3B;7142082502;Ne;0;22;0;22
17374;Šaltinėlis;3B;6719801285;Ne;0;7;0;7
17375;Šaltinėlis;3B;1756003648;Taip;0;22;0;22
17376;Šaltinėlis;3B;4141263000;Ne;0;6;0;6
17377;Šaltinėlis;3B;3863654037;Ne;0;9;0;9
17378;Šaltinėlis;3B;5776007602;Ne;0;5;0;5
17379;Šaltinėlis;3B;3037854361;Ne;0;5;0;5
17380;Šaltinėlis;3B;2089316824;Ne;0;10;0;10
17381;Šaltinėlis;3B;7420737103;Ne;0;8;0;8
17382;Šaltinėlis;3B;8380122669;Ne;0;6;0;6
17383;Šaltinėlis;3B;82404351290;Taip;0;4;0;4
17384;Šaltinėlis;3B;5999279571;Ne;0;5;0;5
17385;Šaltinėlis;3B;3329317171;Ne;0;5;0;5
17386;Šaltinėlis;3B;8219291385;Ne;0;3;0;3
17387;Šaltinėlis;3B;49275031765;Taip;0;6;0;6
17388;Šaltinėlis;1B;93256161233;Taip;0;4;0;4
17389;Šaltinėlis;1B;83173349544;Taip;0;4;0;4
17390;Šaltinėlis;1B;39088869084;Taip;0;7;0;7
17391;Šaltinėlis;1B;95542489944;Taip;0;4;0;4
17392;Šaltinėlis;1B;3072314714;Taip;0;3;0;3
17393;Šaltinėlis;1B;1220687492;Taip;0;2;0;2
17394;Šaltinėlis;1B;74337710550;Ne;0;5;0;5
17395;Šaltinėlis;1B;35401075864;Ne;0;22;0;22
17396;Šaltinėlis;1B;19630605543;Taip;0;5;0;5
17397;Šaltinėlis;1B;3626545396;Ne;0;6;0;6
17398;Šaltinėlis;1B;72372808270;Taip;0;5;0;5
17399;Šaltinėlis;1B;1924418657;Taip;0;5;0;5
17400;Šaltinėlis;1B;77194317310;Taip;0;4;0;4
17401;Šaltinėlis;1B;57847832778;Taip;0;6;0;6
17402;Šaltinėlis;1B;70315400705;Ne;0;3;0;3
17403;Šaltinėlis;1B;81082410620;Taip;0;3;0;3
17404;Šaltinėlis;1B;1422035829;Taip;0;22;0;22
17405;Šaltinėlis;1B;84522552145;Ne;0;8;0;8
17406;Šaltinėlis;1B;7711903999;Ne;0;4;0;4
17407;Šaltinėlis;1B;6317111400;Ne;0;4;0;4
17408;Šaltinėlis;1B;4762756751;Ne;0;2;0;2
17409;Gabijėlė;GANDRIUKŲ;4498088417;Taip;2;0;0;2
17410;Gabijėlė;GANDRIUKŲ;9706026832;Taip;0;3;0;3
17411;Gabijėlė;GANDRIUKŲ;2277489032;Taip;2;0;2;4
17412;Gabijėlė;GANDRIUKŲ;8994076883;Taip;2;0;2;4
17413;Gabijėlė;GANDRIUKŲ;7087892822;Taip;1;0;2;3
17414;Gabijėlė;GANDRIUKŲ;5057272847;Taip;2;0;13;15
17415;Gabijėlė;GANDRIUKŲ;3548399391;Taip;0;0;6;6
17416;Gabijėlė;GANDRIUKŲ;3532989398;Taip;6;0;0;6
17417;Gabijėlė;GANDRIUKŲ;2215880644;Taip;14;0;1;15
17418;Gabijėlė;GANDRIUKŲ;8904768332;Taip;6;0;0;6
17419;Gabijėlė;GANDRIUKŲ;3799003783;Taip;7;0;0;7
17420;Gabijėlė;GANDRIUKŲ;8572833698;Ne;4;0;2;6
17421;Gabijėlė;GANDRIUKŲ;2491503656;Taip;0;3;0;3
17422;Gabijėlė;GANDRIUKŲ;9116153981;Taip;10;0;0;10
17423;Gabijėlė;LAKŠTINGALIUKŲ;92624581275;Taip;0;1;4;5
17424;Gabijėlė;LAKŠTINGALIUKŲ;38094271521;Taip;0;1;6;7
17425;Gabijėlė;LAKŠTINGALIUKŲ;53325200270;Taip;0;0;2;2
17426;Gabijėlė;LAKŠTINGALIUKŲ;45682950511;Taip;0;0;3;3
17427;Gabijėlė;LAKŠTINGALIUKŲ;48032842307;Taip;0;5;0;5
17428;Gabijėlė;LAKŠTINGALIUKŲ;49951048159;Taip;0;3;3;6
17429;Gabijėlė;LAKŠTINGALIUKŲ;1451870519;Ne;0;3;0;3
17430;Gabijėlė;LAKŠTINGALIUKŲ;2131349938;Taip;0;6;0;6
17431;Gabijėlė;LAKŠTINGALIUKŲ;67649373235;Ne;0;0;1;1
17432;Gabijėlė;LAKŠTINGALIUKŲ;9376398157;Taip;0;0;1;1
17433;Gabijėlė;LAKŠTINGALIUKŲ;80455285324;Taip;0;1;0;1
17434;Gabijėlė;LAKŠTINGALIUKŲ;2220139259;Ne;0;0;3;3
17435;Gabijėlė;LAKŠTINGALIUKŲ;82760473229;Taip;0;0;1;1
17436;Gabijėlė;LAKŠTINGALIUKŲ;77966124767;Taip;0;1;0;1
17437;Gabijėlė;LAKŠTINGALIUKŲ;54950294060;Taip;0;1;0;1
17438;Gabijėlė;LAKŠTINGALIUKŲ;89100449385;Taip;11;0;0;11
17439;Gabijėlė;LAKŠTINGALIUKŲ;67189240970;Taip;0;8;0;8
17440;Gabijėlė;LAKŠTINGALIUKŲ;1240051312;Taip;0;0;6;6
17441;Gabijėlė;LAKŠTINGALIUKŲ;4662981914;Taip;4;6;0;10
17442;Gabijėlė;LAKŠTINGALIUKŲ;1945407792;Taip;0;0;1;1
17443;Gabijėlė;ŽVIRBLIUKŲ;4475530177;Taip;0;0;2;2
17444;Gabijėlė;ŽVIRBLIUKŲ;5743861607;Taip;8;0;2;10
17445;Gabijėlė;ŽVIRBLIUKŲ;7410541320;Taip;0;11;0;11
17446;Gabijėlė;ŽVIRBLIUKŲ;4493192224;Taip;6;0;4;10
17447;Gabijėlė;ŽVIRBLIUKŲ;3268231136;Ne;0;8;0;8
17448;Gabijėlė;ŽVIRBLIUKŲ;8879972953;Taip;0;12;0;12
17449;Gabijėlė;ŽVIRBLIUKŲ;5332825339;Taip;16;0;3;19
17450;Gabijėlė;ŽVIRBLIUKŲ;9627906252;Taip;0;0;2;2
17451;Gabijėlė;ŽVIRBLIUKŲ;1725665169;Ne;1;0;0;1
17452;Gabijėlė;ŽVIRBLIUKŲ;2264669298;Ne;14;5;3;22
17453;Gabijėlė;ŽVIRBLIUKŲ;5942625633;Taip;4;0;4;8
17454;Gabijėlė;ŽVIRBLIUKŲ;7417179112;Taip;5;0;1;6
17455;Gabijėlė;ŽVIRBLIUKŲ;5387026410;Taip;5;0;1;6
17456;Gabijėlė;ŽVIRBLIUKŲ;8292463617;Taip;9;0;0;9
17457;Gabijėlė;ŽVIRBLIUKŲ;3155403180;Taip;11;7;1;19
17458;Gabijėlė;ŽVIRBLIUKŲ;1158461185;Taip;11;7;1;19
17459;Gabijėlė;ŽVIRBLIUKŲ;6604681536;Ne;3;1;0;4
17460;Gabijėlė;ŽVIRBLIUKŲ;3218415151;Taip;5;0;10;15
17461;Gabijėlė;ŽVIRBLIUKŲ;4146051969;Ne;0;4;0;4
17462;Gabijėlė;ŽVIRBLIUKŲ;6674038058;Ne;5;0;0;5
17463;Gabijėlė;ŽVIRBLIUKŲ;8823299212;Taip;7;0;0;7
17464;Gabijėlė;GENIUKŲ;3445433386;Taip;0;4;0;4
17465;Gabijėlė;GENIUKŲ;2980295345;Taip;9;0;0;9
17466;Gabijėlė;GENIUKŲ;7312628876;Taip;4;0;2;6
17467;Gabijėlė;GENIUKŲ;1581688238;Taip;0;0;4;4
17468;Gabijėlė;GENIUKŲ;5301905117;Taip;0;6;0;6
17469;Gabijėlė;GENIUKŲ;3176075887;Taip;0;6;0;6
17470;Gabijėlė;GENIUKŲ;6866641272;Taip;0;0;3;3
17471;Gabijėlė;GENIUKŲ;9972967198;Taip;17;0;0;17
17472;Gabijėlė;GENIUKŲ;8305098808;Ne;7;0;0;7
17473;Gabijėlė;GENIUKŲ;1589534853;Ne;0;2;3;5
17474;Gabijėlė;GENIUKŲ;3020599503;Ne;0;14;0;14
17475;Gabijėlė;GENIUKŲ;4234733280;Taip;0;5;0;5
17476;Gabijėlė;GENIUKŲ;1922979974;Taip;9;0;0;9
17477;Gabijėlė;GENIUKŲ;6482824000;Taip;8;0;1;9
17478;Gabijėlė;GENIUKŲ;5962852108;Taip;0;4;0;4
17479;Gabijėlė;GENIUKŲ;2009199650;Taip;0;0;1;1
17480;Gabijėlė;DAGILIUKŲ;9348393550;Taip;7;4;0;11
17481;Gabijėlė;DAGILIUKŲ;4264925447;Taip;6;4;0;10
17482;Gabijėlė;DAGILIUKŲ;9120107749;Taip;3;0;2;5
17483;Gabijėlė;DAGILIUKŲ;9494313873;Taip;0;0;1;1
17484;Gabijėlė;DAGILIUKŲ;7426579018;Taip;22;0;0;22
17485;Gabijėlė;DAGILIUKŲ;9783343968;Taip;0;0;3;3
17486;Gabijėlė;DAGILIUKŲ;6438144206;Taip;5;6;0;11
17487;Gabijėlė;DAGILIUKŲ;4462129182;Taip;6;0;0;6
17488;Gabijėlė;DAGILIUKŲ;8662914262;Taip;0;4;0;4
17489;Gabijėlė;DAGILIUKŲ;9280283478;Ne;10;0;0;10
17490;Gabijėlė;DAGILIUKŲ;9503639471;Taip;0;5;0;5
17491;Gabijėlė;DAGILIUKŲ;1988597157;Ne;19;0;0;19
17492;Gabijėlė;DAGILIUKŲ;8036572198;Taip;22;0;0;22
17493;Gabijėlė;DAGILIUKŲ;9895518740;Taip;7;0;5;12
17494;Gabijėlė;DAGILIUKŲ;1455856766;Taip;3;0;6;9
17495;Gabijėlė;DAGILIUKŲ;6322094719;Taip;10;1;0;11
17496;Gabijėlė;DAGILIUKŲ;9449023766;Taip;0;4;0;4
17497;Gabijėlė;DAGILIUKŲ;2254104149;Taip;7;0;0;7
17498;Gabijėlė;DAGILIUKŲ;1286688629;Taip;5;0;0;5
17499;Gabijėlė;DAGILIUKŲ;4797994026;Ne;0;3;1;4
17500;Gabijėlė;PELEDŽIUKŲ;94478599707;Taip;10;0;0;10
17501;Gabijėlė;PELEDŽIUKŲ;2067646395;Taip;11;0;0;11
17502;Gabijėlė;PELEDŽIUKŲ;1068556799;Taip;0;1;0;1
17503;Gabijėlė;PELEDŽIUKŲ;1171257945;Ne;10;2;2;14
17504;Gabijėlė;PELEDŽIUKŲ;8044682830;Taip;9;2;1;12
17505;Gabijėlė;PELEDŽIUKŲ;43109352262;Taip;9;2;0;11
17506;Gabijėlė;PELEDŽIUKŲ;1491653325;Taip;5;0;1;6
17507;Gabijėlė;PELEDŽIUKŲ;1608940997;Taip;3;0;0;3
17508;Gabijėlė;PELEDŽIUKŲ;3610392405;Ne;6;1;0;7
17509;Gabijėlė;PELEDŽIUKŲ;4916964663;Taip;6;1;0;7
17510;Gabijėlė;PELEDŽIUKŲ;17443601729;Ne;13;0;0;13
17511;Gabijėlė;PELEDŽIUKŲ;1286307671;Ne;3;0;0;3
17512;Gabijėlė;PELEDŽIUKŲ;37544281230;Taip;5;0;2;7
17513;Gabijėlė;PELEDŽIUKŲ;8428069167;Taip;9;0;0;9
17514;Gabijėlė;PELEDŽIUKŲ;4726771205;Ne;11;0;3;14
17515;Gabijėlė;PELEDŽIUKŲ;24035160251;Taip;14;0;0;14
17516;Gabijėlė;PELEDŽIUKŲ;38497069329;Taip;7;0;0;7
17517;Gabijėlė;PELEDŽIUKŲ;65735862964;Taip;3;0;0;3
17518;Gabijėlė;PELEDŽIUKŲ;8746641978;Ne;10;3;0;13
17519;Gabijėlė;KREGZDŽIUKŲ;84945768423;Taip;0;0;2;2
17520;Gabijėlė;KREGZDŽIUKŲ;41661694634;Taip;0;0;2;2
17521;Gabijėlė;KREGZDŽIUKŲ;1743647754;Ne;0;2;0;2
17522;Gabijėlė;KREGZDŽIUKŲ;79544806044;Taip;0;0;1;1
17523;Gabijėlė;KREGZDŽIUKŲ;34683603878;Ne;0;2;1;3
17524;Gabijėlė;KREGZDŽIUKŲ;13013873198;Taip;0;4;0;4
17525;Gabijėlė;KREGZDŽIUKŲ;91643373754;Taip;0;12;0;12
17526;Gabijėlė;KREGZDŽIUKŲ;7298662616;Taip;8;0;2;10
17527;Gabijėlė;KREGZDŽIUKŲ;61217725255;Ne;0;0;1;1
17528;Gabijėlė;KREGZDŽIUKŲ;53576382572;Ne;0;3;0;3
17529;Gabijėlė;KREGZDŽIUKŲ;2958504770;Taip;0;0;2;2
17530;Gabijėlė;KREGZDŽIUKŲ;34998957585;Taip;9;0;5;14
17531;Gabijėlė;KREGZDŽIUKŲ;1455625997;Taip;0;4;1;5
17532;Gabijėlė;KREGZDŽIUKŲ;1937862725;Ne;0;0;1;1
17533;Gabijėlė;KREGZDŽIUKŲ;1217019582;Taip;4;0;1;5
17534;Gabijėlė;KREGZDŽIUKŲ;46552208567;Taip;0;1;0;1
17535;Gabijėlė;KREGZDŽIUKŲ;2075744479;Taip;0;0;1;1
17536;Gabijėlė;KREGZDŽIUKŲ;62457368692;Taip;3;0;0;3
17537;Gabijėlė;KREGZDŽIUKŲ;26058036933;Ne;3;0;1;4
17538;Gabijėlė;KREGZDŽIUKŲ;84120660883;Ne;3;0;1;4
17539;Gabijėlė;KREGZDŽIUKŲ;36447115547;Taip;0;4;0;4
17540;Gabijėlė;KREGZDŽIUKŲ;69294465170;Taip;0;0;1;1
17541;Gabijėlė;ZYLIUKŲ;90540638931;Taip;7;0;0;7
17542;Gabijėlė;ZYLIUKŲ;20248530233;Taip;0;5;0;5
17543;Gabijėlė;ZYLIUKŲ;25691510343;Taip;0;0;2;2
17544;Gabijėlė;ZYLIUKŲ;84464214049;Taip;0;3;0;3
17545;Gabijėlė;ZYLIUKŲ;62562568076;Taip;0;0;3;3
17546;Gabijėlė;ZYLIUKŲ;1257150362;Ne;3;0;0;3
17547;Gabijėlė;ZYLIUKŲ;1036201997;Taip;0;3;0;3
17548;Gabijėlė;ZYLIUKŲ;7778613039;Taip;4;0;2;6
17549;Gabijėlė;ZYLIUKŲ;31458685084;Taip;4;2;0;6
17550;Gabijėlė;ZYLIUKŲ;16804922682;Ne;1;0;0;1
17551;Gabijėlė;ZYLIUKŲ;1213013384;Ne;0;0;3;3
17552;Gabijėlė;ZYLIUKŲ;1145863002;Ne;5;0;0;5
17553;Gabijėlė;ZYLIUKŲ;1649556120;Taip;0;0;2;2
17554;Gabijėlė;VOLUNGĖLIŲ;1779924073;Taip;6;0;1;7
17555;Gabijėlė;VOLUNGĖLIŲ;4166739739;Taip;0;10;0;10
17556;Gabijėlė;VOLUNGĖLIŲ;1492231030;Taip;0;10;0;10
17557;Gabijėlė;VOLUNGĖLIŲ;1317309811;Taip;0;4;0;4
17558;Gabijėlė;VOLUNGĖLIŲ;1523331860;Taip;0;2;0;2
17559;Gabijėlė;VOLUNGĖLIŲ;21740150080;Taip;0;8;0;8
17560;Gabijėlė;VOLUNGĖLIŲ;9683524530;Taip;0;0;8;8
17561;Gabijėlė;VOLUNGĖLIŲ;46021970332;Ne;0;8;0;8
17562;Gabijėlė;VOLUNGĖLIŲ;8480479946;Taip;0;5;0;5
17563;Gabijėlė;VOLUNGĖLIŲ;43737170074;Taip;0;0;3;3
17564;Gabijėlė;VOLUNGĖLIŲ;1480704497;Taip;0;2;0;2
17565;Gabijėlė;VOLUNGĖLIŲ;1669529717;Taip;2;0;0;2
17566;Gabijėlė;VOLUNGĖLIŲ;5704281727;Taip;0;0;3;3
17567;Gabijėlė;VOLUNGĖLIŲ;95685721388;Taip;0;6;0;6
17568;Gabijėlė;VOLUNGĖLIŲ;76416239647;Ne;9;0;0;9
17569;Gabijėlė;VOLUNGĖLIŲ;6271780003;Taip;0;0;1;1
17570;Gabijėlė;VOLUNGĖLIŲ;2051109865;Ne;0;11;0;11
17571;Gabijėlė;VOLUNGĖLIŲ;64252867351;Ne;0;10;0;10
17572;Gabijėlė;ANČIUKŲ;43123279348;Taip;0;7;0;7
17573;Gabijėlė;ANČIUKŲ;2036978425;Taip;0;12;0;12
17574;Gabijėlė;ANČIUKŲ;5219706067;Taip;0;3;0;3
17575;Gabijėlė;ANČIUKŲ;10796114623;Ne;0;14;0;14
17576;Gabijėlė;ANČIUKŲ;3454412432;Ne;0;0;1;1
17577;Gabijėlė;ANČIUKŲ;4752631976;Taip;0;0;2;2
17578;Gabijėlė;ANČIUKŲ;9822093084;Taip;9;0;3;12
17579;Gabijėlė;ANČIUKŲ;1415184607;Taip;0;0;2;2
17580;Gabijėlė;ANČIUKŲ;85836097485;Taip;4;0;3;7
17581;Gabijėlė;ANČIUKŲ;28017865889;Taip;0;2;0;2
17582;Gabijėlė;ANČIUKŲ;1917587420;Ne;7;4;0;11
17583;Gabijėlė;ANČIUKŲ;1465584524;Taip;12;0;1;13
17584;Gabijėlė;ANČIUKŲ;6198439092;Taip;5;0;2;7
17585;Gabijėlė;ANČIUKŲ;5783373671;Taip;0;3;0;3
17586;Gabijėlė;ANČIUKŲ;7948343328;Taip;0;0;1;1
17587;Gabijėlė;ANČIUKŲ;2052892422;Ne;0;0;1;1
17588;Gabijėlė;ANČIUKŲ;8111239476;Ne;19;2;0;21
17589;Gabijėlė;ANČIUKŲ;6766770793;Taip;9;0;0;9
17590;Gabijėlė;ANČIUKŲ;8778396292;Taip;0;0;2;2
17591;Gabijėlė;ANČIUKŲ;4085049535;Taip;0;17;0;17
17592;Gabijėlė;ANČIUKŲ;8893637755;Taip;0;15;0;15
17593;Gabijėlė;BALANDŽIUKŲ;4110081664;Taip;3;0;0;3
17594;Gabijėlė;BALANDŽIUKŲ;6719097956;Taip;0;5;0;5
17595;Gabijėlė;BALANDŽIUKŲ;9157819780;Taip;0;7;0;7
17596;Gabijėlė;BALANDŽIUKŲ;1045338865;Ne;0;13;0;13
17597;Gabijėlė;BALANDŽIUKŲ;33124420723;Taip;0;0;1;1
17598;Gabijėlė;BALANDŽIUKŲ;2097260657;Taip;3;0;2;5
17599;Gabijėlė;BALANDŽIUKŲ;8525869648;Taip;3;0;2;5
17600;Gabijėlė;BALANDŽIUKŲ;56914218692;Ne;10;0;0;10
17601;Gabijėlė;BALANDŽIUKŲ;2070050969;Taip;0;5;0;5
17602;Gabijėlė;BALANDŽIUKŲ;7144977279;Ne;7;0;0;7
17603;Gabijėlė;BALANDŽIUKŲ;15049855022;Taip;0;2;0;2
17604;Gabijėlė;BALANDŽIUKŲ;2776579713;Taip;4;4;0;8
17605;Gabijėlė;BALANDŽIUKŲ;7977751362;Taip;7;0;0;7
17606;Gabijėlė;BALANDŽIUKŲ;5906952432;Taip;7;0;0;7
17607;Gabijėlė;BALANDŽIUKŲ;9197020006;Taip;13;1;0;14
17608;Gabijėlė;BALANDŽIUKŲ;1273722177;Ne;12;0;0;12
17609;Gabijėlė;VYTURIUKŲ;2059859352;Taip;1;0;1;2
17610;Gabijėlė;VYTURIUKŲ;87868591956;Taip;0;3;0;3
17611;Gabijėlė;VYTURIUKŲ;1859288888;Ne;5;1;0;6
17612;Gabijėlė;VYTURIUKŲ;44322663690;Ne;0;0;2;2
17613;Gabijėlė;VYTURIUKŲ;1479311429;Ne;4;0;1;5
17614;Gabijėlė;VYTURIUKŲ;4765125810;Taip;0;1;1;2
17615;Gabijėlė;VYTURIUKŲ;1219257874;Taip;9;0;0;9
17616;Gabijėlė;VYTURIUKŲ;39269336820;Ne;4;4;0;8
17617;Gabijėlė;VYTURIUKŲ;1829866148;Ne;0;0;5;5
17618;Gabijėlė;VYTURIUKŲ;1949644078;Taip;0;2;0;2
17619;Gabijėlė;VYTURIUKŲ;47989272121;Ne;4;4;0;8
17620;Gabijėlė;VYTURIUKŲ;5736000160;Taip;0;0;1;1
17621;Gabijėlė;VYTURIUKŲ;9320327120;Taip;6;0;1;7
17622;Gabijėlė;VYTURIUKŲ;4632508075;Taip;7;0;0;7
17623;Gabijėlė;VYTURIUKŲ;1426802917;Taip;0;15;2;17
17624;Gabijėlė;VYTURIUKŲ;41212490042;Ne;10;0;3;13
17625;Gabijėlė;VYTURIUKŲ;1287165224;Taip;0;1;0;1
17626;Gabijėlė;VYTURIUKŲ;34609028374;Taip;0;4;0;4
17627;Gabijėlė;VYTURIUKŲ;48342584892;Taip;0;1;0;1
17628;Gabijėlė;VYTURIUKŲ;1185452849;Taip;5;0;0;5
17629;Gabijėlė;VYTURIUKŲ;90520726029;Taip;2;0;1;3
17630;Gabijėlė;VYTURIUKŲ;6492199649;Ne;0;1;2;3
17631;Pilaitukas;BITUTĖS;4305634374;Taip;12;2;0;14
17632;Pilaitukas;BITUTĖS;3519198814;Taip;8;0;0;8
17633;Pilaitukas;BITUTĖS;8169484415;Taip;4;1;0;5
17634;Pilaitukas;BITUTĖS;1253300093;Taip;17;0;0;17
17635;Pilaitukas;BITUTĖS;2242454299;Taip;0;3;0;3
17636;Pilaitukas;BITUTĖS;4082490488;Taip;8;9;0;17
17637;Pilaitukas;BITUTĖS;3345387791;Taip;0;0;2;2
17638;Pilaitukas;BITUTĖS;3541354283;Taip;0;6;0;6
17639;Pilaitukas;BITUTĖS;5740951665;Taip;11;1;3;15
17640;Pilaitukas;BITUTĖS;4591799893;Taip;22;0;0;22
17641;Pilaitukas;BITUTĖS;6308557885;Taip;19;0;0;19
17642;Pilaitukas;BITUTĖS;6514731102;Taip;19;0;0;19
17643;Pilaitukas;BITUTĖS;5988165204;Taip;2;0;0;2
17644;Pilaitukas;BITUTĖS;3037850837;Ne;8;0;0;8
17645;Pilaitukas;BITUTĖS;9126553732;Taip;6;0;1;7
17646;Pilaitukas;BITUTĖS;7438112270;Taip;4;0;2;6
17647;Pilaitukas;BITUTĖS;1295215465;Taip;8;0;2;10
17648;Pilaitukas;ZUIKUČIAI;8993885764;Ne;14;2;0;16
17649;Pilaitukas;ZUIKUČIAI;5206637809;Taip;4;0;0;4
17650;Pilaitukas;ZUIKUČIAI;5288784331;Taip;5;0;0;5
17651;Pilaitukas;ZUIKUČIAI;8255398803;Ne;13;0;0;13
17652;Pilaitukas;ZUIKUČIAI;2862447956;Taip;12;0;0;12
17653;Pilaitukas;ZUIKUČIAI;8727175656;Taip;12;0;0;12
17654;Pilaitukas;ZUIKUČIAI;8207194955;Taip;0;3;1;4
17655;Pilaitukas;ZUIKUČIAI;5640802570;Ne;12;1;1;14
17656;Pilaitukas;ZUIKUČIAI;4623818227;Taip;7;0;0;7
17657;Pilaitukas;ZUIKUČIAI;9260893320;Taip;0;5;0;5
17658;Pilaitukas;ZUIKUČIAI;9988041515;Taip;9;1;0;10
17659;Pilaitukas;ZUIKUČIAI;9108428738;Taip;9;1;0;10
17660;Pilaitukas;ZUIKUČIAI;9878890346;Ne;10;0;0;10
17661;Pilaitukas;ZUIKUČIAI;6838035491;Taip;3;0;1;4
17662;Pilaitukas;ZUIKUČIAI;5710747769;Ne;9;9;0;18
17663;Pilaitukas;ZUIKUČIAI;7568744500;Taip;10;0;0;10
17664;Pilaitukas;ZUIKUČIAI;5407354218;Taip;14;0;0;14
17665;Pilaitukas;ZUIKUČIAI;9414051187;Taip;12;0;0;12
17666;Pilaitukas;ZUIKUČIAI;1704055907;Taip;0;4;0;4
17667;Pilaitukas;ANČIUKAI;5949185075;Taip;11;0;0;11
17668;Pilaitukas;ANČIUKAI;92108889661;Ne;0;0;2;2
17669;Pilaitukas;ANČIUKAI;9724892897;Taip;0;0;2;2
17670;Pilaitukas;ANČIUKAI;36338976218;Taip;0;2;0;2
17671;Pilaitukas;ANČIUKAI;1114477688;Ne;3;6;0;9
17672;Pilaitukas;ANČIUKAI;1512181401;Taip;8;0;0;8
17673;Pilaitukas;ANČIUKAI;6222888898;Taip;5;0;0;5
17674;Pilaitukas;ANČIUKAI;8319676743;Taip;0;0;1;1
17675;Pilaitukas;ANČIUKAI;4505384039;Taip;5;0;0;5
17676;Pilaitukas;ANČIUKAI;5206439753;Taip;2;4;0;6
17677;Pilaitukas;ANČIUKAI;79485847381;Taip;3;0;0;3
17678;Pilaitukas;ANČIUKAI;2117570444;Taip;0;3;0;3
17679;Pilaitukas;ANČIUKAI;87760608710;Ne;0;22;0;22
17680;Pilaitukas;ANČIUKAI;7909465673;Taip;0;1;2;3
17681;Pilaitukas;ANČIUKAI;2298935154;Taip;4;0;0;4
17682;Pilaitukas;ANČIUKAI;4694691187;Taip;5;0;3;8
17683;Pilaitukas;ANČIUKAI;9224653856;Taip;7;0;1;8
17684;Pilaitukas;ANČIUKAI;58250008277;Taip;7;0;4;11
17685;Pilaitukas;ANČIUKAI;5252233127;Taip;0;5;0;5
17686;Pilaitukas;MEŠKIUKAI;57931719105;Taip;0;9;0;9
17687;Pilaitukas;MEŠKIUKAI;14554050141;Taip;0;1;2;3
17688;Pilaitukas;MEŠKIUKAI;9015675095;Taip;6;0;0;6
17689;Pilaitukas;MEŠKIUKAI;1135880899;Taip;8;0;3;11
17690;Pilaitukas;MEŠKIUKAI;4505147961;Taip;0;0;1;1
17691;Pilaitukas;MEŠKIUKAI;9618329726;Taip;4;0;0;4
17692;Pilaitukas;MEŠKIUKAI;6514784647;Taip;4;0;0;4
17693;Pilaitukas;MEŠKIUKAI;4038320896;Taip;8;9;0;17
17694;Pilaitukas;MEŠKIUKAI;18466900688;Taip;0;15;0;15
17695;Pilaitukas;MEŠKIUKAI;2736736697;Ne;0;3;0;3
17696;Pilaitukas;MEŠKIUKAI;3214740183;Taip;0;0;2;2
17697;Pilaitukas;MEŠKIUKAI;39600380611;Ne;3;0;0;3
17698;Pilaitukas;MEŠKIUKAI;5604992163;Taip;4;4;0;8
17699;Pilaitukas;MEŠKIUKAI;9450834035;Taip;0;5;0;5
17700;Pilaitukas;MEŠKIUKAI;5689385925;Taip;2;0;0;2
17701;Pilaitukas;MEŠKIUKAI;1003278169;Ne;0;0;6;6
17702;Pilaitukas;MEŠKIUKAI;5939557073;Taip;2;0;2;4
17703;Pilaitukas;MEŠKIUKAI;6117985788;Taip;4;0;0;4
17704;Pilaitukas;MEŠKIUKAI;9924612250;Taip;0;0;1;1
17705;Pilaitukas;ŽUVYTĖS;86572852457;Taip;0;0;2;2
17706;Pilaitukas;ŽUVYTĖS;83886439719;Taip;8;0;2;10
17707;Pilaitukas;ŽUVYTĖS;74367577786;Ne;3;0;0;3
17708;Pilaitukas;ŽUVYTĖS;79398058989;Taip;0;0;11;11
17709;Pilaitukas;ŽUVYTĖS;53049608654;Taip;0;3;0;3
17710;Pilaitukas;ŽUVYTĖS;62992423192;Taip;0;0;6;6
17711;Pilaitukas;ŽUVYTĖS;1707355162;Ne;0;0;2;2
17712;Pilaitukas;ŽUVYTĖS;27233065857;Ne;0;1;0;1
17713;Pilaitukas;ŽUVYTĖS;49728283339;Taip;0;4;0;4
17714;Pilaitukas;ŽUVYTĖS;1824063553;Taip;0;0;1;1
17715;Pilaitukas;ŽUVYTĖS;37415672544;Taip;3;0;0;3
17716;Pilaitukas;ŽUVYTĖS;44413072002;Taip;6;0;0;6
17717;Pilaitukas;ŽUVYTĖS;63470473930;Taip;8;0;0;8
17718;Pilaitukas;ŽUVYTĖS;1286286153;Ne;0;0;10;10
17719;Pilaitukas;ŽUVYTĖS;1896452184;Taip;0;2;14;16
17720;Pilaitukas;ŽUVYTĖS;49542027658;Taip;4;0;3;7
17721;Pilaitukas;ŽUVYTĖS;3723836301;Taip;0;0;5;5
17722;Pilaitukas;ŽUVYTĖS;6913383121;Ne;0;4;0;4
17723;Pilaitukas;ŽUVYTĖS;50368168240;Taip;0;0;1;1
17724;Pilaitukas;ŽUVYTĖS;81347327136;Taip;4;0;0;4
17725;Pilaitukas;ŽUVYTĖS;72753220553;Taip;4;0;0;4
17726;Pilaitukas;PAUKŠTELIAI;68262699910;Taip;0;0;1;1
17727;Pilaitukas;PAUKŠTELIAI;25872504305;Taip;0;0;1;1
17728;Pilaitukas;PAUKŠTELIAI;26318820010;Taip;3;5;0;8
17729;Pilaitukas;PAUKŠTELIAI;99558991322;Taip;0;2;0;2
17730;Pilaitukas;PAUKŠTELIAI;61458733284;Taip;0;0;1;1
17731;Pilaitukas;PAUKŠTELIAI;92116532227;Taip;0;2;0;2
17732;Pilaitukas;PAUKŠTELIAI;95753711905;Taip;0;1;5;6
17733;Pilaitukas;PAUKŠTELIAI;46467461875;Ne;0;16;0;16
17734;Pilaitukas;PAUKŠTELIAI;89335569661;Taip;0;1;0;1
17735;Pilaitukas;PAUKŠTELIAI;49882457703;Ne;0;0;1;1
17736;Pilaitukas;PAUKŠTELIAI;17314387753;Taip;17;0;1;18
17737;Pilaitukas;PAUKŠTELIAI;56237836622;Taip;3;2;0;5
17738;Pilaitukas;PAUKŠTELIAI;98123777614;Taip;3;1;0;4
17739;Pilaitukas;PAUKŠTELIAI;93292073339;Taip;9;0;0;9
17740;Pilaitukas;PAUKŠTELIAI;27134663020;Taip;14;0;0;14
17741;Pilaitukas;PAUKŠTELIAI;74933839730;Taip;0;0;1;1
17742;Pilaitukas;PAUKŠTELIAI;29035791508;Ne;0;1;0;1
17743;Pilaitukas;BORUŽĖLĖS;98045145204;Taip;4;3;0;7
17744;Pilaitukas;BORUŽĖLĖS;2145561638;Taip;0;4;0;4
17745;Pilaitukas;BORUŽĖLĖS;14937983736;Taip;0;2;6;8
17746;Pilaitukas;BORUŽĖLĖS;1704733670;Ne;5;0;0;5
17747;Pilaitukas;BORUŽĖLĖS;2308673826;Taip;0;0;3;3
17748;Pilaitukas;BORUŽĖLĖS;1714711904;Taip;8;0;2;10
17749;Pilaitukas;BORUŽĖLĖS;2436416327;Taip;7;0;0;7
17750;Pilaitukas;BORUŽĖLĖS;2561804291;Taip;0;0;5;5
17751;Pilaitukas;BORUŽĖLĖS;56069293343;Taip;0;0;2;2
17752;Pilaitukas;BORUŽĖLĖS;7156205658;Taip;19;0;1;20
17753;Pilaitukas;BORUŽĖLĖS;8364902911;Taip;8;4;1;13
17754;Pilaitukas;BORUŽĖLĖS;5063602139;Ne;8;0;3;11
17755;Pilaitukas;BORUŽĖLĖS;5464065587;Taip;8;0;0;8
17756;Pilaitukas;BORUŽĖLĖS;5984878126;Taip;0;3;0;3
17757;Pilaitukas;BORUŽĖLĖS;84508228457;Taip;0;0;2;2
17758;Pilaitukas;BORUŽĖLĖS;1142014148;Taip;0;2;1;3
17759;Pilaitukas;BORUŽĖLĖS;95439358242;Taip;2;0;0;2
17760;Pilaitukas;BORUŽĖLĖS;6024861998;Taip;6;0;0;6
17761;Pilaitukas;BORUŽĖLĖS;58416972423;Taip;9;0;3;12
17762;Pilaitukas;BORUŽĖLĖS;9898379569;Taip;3;0;2;5
17763;Pilaitukas;BORUŽĖLĖS;5324806808;Taip;13;0;2;15
17764;Pilaitukas;DRUGELIAI;7961518607;Taip;0;0;7;7
17765;Pilaitukas;DRUGELIAI;7082054458;Taip;0;0;3;3
17766;Pilaitukas;DRUGELIAI;64601938351;Taip;0;4;0;4
17767;Pilaitukas;DRUGELIAI;38456484551;Taip;0;8;0;8
17768;Pilaitukas;DRUGELIAI;7838787153;Taip;0;0;4;4
17769;Pilaitukas;DRUGELIAI;2613078582;Taip;0;1;0;1
17770;Pilaitukas;DRUGELIAI;9246391309;Ne;5;0;0;5
17771;Pilaitukas;DRUGELIAI;1677962644;Taip;6;5;0;11
17772;Pilaitukas;DRUGELIAI;4745358362;Taip;6;5;0;11
17773;Pilaitukas;DRUGELIAI;3483758882;Taip;3;1;0;4
17774;Pilaitukas;DRUGELIAI;7853910193;Taip;9;0;0;9
17775;Pilaitukas;DRUGELIAI;6646474196;Taip;22;0;0;22
17776;Pilaitukas;DRUGELIAI;9801214344;Ne;6;0;3;9
17777;Pilaitukas;DRUGELIAI;5331915157;Taip;0;0;3;3
17778;Pilaitukas;DRUGELIAI;8302624354;Taip;3;0;3;6
17779;Pilaitukas;DRUGELIAI;5422289286;Taip;0;0;3;3
17780;Pilaitukas;DRUGELIAI;1272758839;Taip;4;0;1;5
17781;Pilaitukas;DRUGELIAI;7082099968;Taip;0;8;0;8
17782;Pilaitukas;DRUGELIAI;6712878938;Taip;11;0;0;11
17783;Pilaitukas;PELIUKAI;71302602535;Taip;0;0;1;1
17784;Pilaitukas;PELIUKAI;29229117661;Taip;4;8;0;12
17785;Pilaitukas;PELIUKAI;15303269615;Taip;0;1;0;1
17786;Pilaitukas;PELIUKAI;26063381713;Ne;0;6;0;6
17787;Pilaitukas;PELIUKAI;90148331957;Taip;0;0;1;1
17788;Pilaitukas;PELIUKAI;89719236172;Taip;0;7;0;7
17789;Pilaitukas;PELIUKAI;49084081967;Taip;2;0;1;3
17790;Pilaitukas;PELIUKAI;3685682772;Taip;14;8;0;22
17791;Pilaitukas;PELIUKAI;54706920576;Taip;6;0;0;6
17792;Pilaitukas;PELIUKAI;8152280709;Taip;14;0;0;14
17793;Pilaitukas;PELIUKAI;42514613325;Taip;0;0;2;2
17794;Pilaitukas;PELIUKAI;1611616941;Taip;0;7;0;7
17795;Pilaitukas;PELIUKAI;68571454940;Ne;0;0;1;1
17796;Pilaitukas;PELIUKAI;4306078592;Ne;0;0;1;1
17797;Pilaitukas;KAČIUKAI;74264627858;Taip;9;4;0;13
17798;Pilaitukas;KAČIUKAI;71072645939;Taip;0;1;0;1
17799;Pilaitukas;KAČIUKAI;70465651068;Taip;0;1;0;1
17800;Pilaitukas;KAČIUKAI;4283157555;Taip;8;0;0;8
17801;Pilaitukas;KAČIUKAI;78293798850;Ne;0;1;0;1
17802;Pilaitukas;KAČIUKAI;90472705680;Taip;5;0;1;6
17803;Pilaitukas;KAČIUKAI;58064353914;Taip;0;2;0;2
17804;Pilaitukas;KAČIUKAI;92823052045;Taip;5;0;0;5
17805;Pilaitukas;KAČIUKAI;7032684121;Ne;0;9;0;9
17806;Pilaitukas;KAČIUKAI;91980974377;Taip;0;8;1;9
17807;Pilaitukas;KAČIUKAI;28902841059;Taip;2;1;0;3
17808;Pilaitukas;KAČIUKAI;2045735700;Taip;9;0;1;10
17809;Pilaitukas;KAČIUKAI;78048449266;Taip;0;4;0;4
17810;Pilaitukas;KAČIUKAI;82688660737;Taip;4;0;0;4
17811;Pilaitukas;KAČIUKAI;1508672511;Taip;0;3;0;3
17812;Pilaitukas;KAČIUKAI;4348058482;Taip;9;1;0;10
17813;Pilaitukas;KAČIUKAI;1056269188;Taip;0;3;0;3
17814;Pilaitukas;KAČIUKAI;34346418650;Taip;2;1;1;4
17815;Pilaitukas;KAČIUKAI;8640149293;Ne;0;2;0;2
17816;Pilaitukas;KAČIUKAI;9496336005;Taip;0;4;0;4
17817;Pilaitukas;KAČIUKAI;6069797837;Taip;0;11;1;12
17818;Pilaitukas;SAULUTĖS;7222856683;Taip;6;0;1;7
17819;Pilaitukas;SAULUTĖS;4719223490;Taip;4;0;2;6
17820;Pilaitukas;SAULUTĖS;8787181006;Taip;0;1;0;1
17821;Pilaitukas;SAULUTĖS;3825942473;Taip;0;5;0;5
17822;Pilaitukas;SAULUTĖS;9870994949;Taip;6;0;2;8
17823;Pilaitukas;SAULUTĖS;3298272815;Taip;0;0;9;9
17824;Pilaitukas;SAULUTĖS;1731106179;Taip;15;4;0;19
17825;Pilaitukas;SAULUTĖS;8767785444;Taip;0;6;0;6
17826;Pilaitukas;SAULUTĖS;2697591669;Ne;3;0;7;10
17827;Pilaitukas;SAULUTĖS;3954210452;Ne;0;1;1;2
17828;Pilaitukas;SAULUTĖS;3772830210;Ne;0;22;0;22
17829;Pilaitukas;SAULUTĖS;1611371690;Taip;9;0;1;10
17830;Pilaitukas;SAULUTĖS;9974310580;Taip;0;4;0;4
17831;Pilaitukas;SAULUTĖS;3035456834;Ne;0;22;0;22
17832;Pilaitukas;SAULUTĖS;8322980583;Taip;0;0;1;1
17833;Pilaitukas;SAULUTĖS;2830212921;Taip;6;1;0;7
17834;Pilaitukas;SAULUTĖS;2476942319;Taip;0;22;0;22
17835;Pilaitukas;MENULIUKAI;9774222130;Taip;0;0;7;7
17836;Pilaitukas;MENULIUKAI;4810825253;Taip;4;1;0;5
17837;Pilaitukas;MENULIUKAI;8877142428;Taip;10;0;1;11
17838;Pilaitukas;MENULIUKAI;9556421129;Taip;13;0;0;13
17839;Pilaitukas;MENULIUKAI;8168228529;Ne;0;3;0;3
17840;Pilaitukas;MENULIUKAI;5421602723;Taip;13;0;0;13
17841;Pilaitukas;MENULIUKAI;7604004800;Taip;6;0;1;7
17842;Pilaitukas;MENULIUKAI;8769116377;Taip;0;0;3;3
17843;Pilaitukas;MENULIUKAI;8501376663;Taip;4;2;0;6
17844;Pilaitukas;MENULIUKAI;6833933586;Taip;6;3;0;9
17845;Pilaitukas;MENULIUKAI;1270365948;Ne;5;0;1;6
17846;Pilaitukas;MENULIUKAI;2416277190;Taip;0;22;0;22
17847;Pilaitukas;MENULIUKAI;7808204054;Ne;0;1;2;3
17848;Pilaitukas;MENULIUKAI;9322351120;Ne;22;0;0;22
17849;Pilaitukas;MENULIUKAI;9343707166;Taip;6;0;0;6
17850;Pilaitukas;MENULIUKAI;9246925227;Taip;7;0;0;7
17851;Pilaitukas;ĖŽIUKAI;9653647227;Taip;1;0;16;17
17852;Pilaitukas;ĖŽIUKAI;5326689274;Taip;1;0;16;17
17853;Pilaitukas;ĖŽIUKAI;2463482642;Ne;2;0;0;2
17854;Pilaitukas;ĖŽIUKAI;9038324313;Taip;4;0;0;4
17855;Pilaitukas;ĖŽIUKAI;2406183145;Taip;0;0;1;1
17856;Pilaitukas;ĖŽIUKAI;2379660463;Taip;0;0;1;1
17857;Pilaitukas;ĖŽIUKAI;3080014745;Taip;10;0;0;10
17858;Pilaitukas;ĖŽIUKAI;5353687011;Taip;11;1;0;12
17859;Pilaitukas;ĖŽIUKAI;6102253106;Taip;0;1;1;2
17860;Pilaitukas;ĖŽIUKAI;8009040109;Taip;2;1;2;5
17861;Pilaitukas;ĖŽIUKAI;4022543517;Taip;0;9;0;9
17862;Pilaitukas;ĖŽIUKAI;7594484959;Taip;4;2;0;6
17863;Pilaitukas;ĖŽIUKAI;6525191057;Taip;5;0;1;6
17864;Pilaitukas;ĖŽIUKAI;1999942175;Taip;0;0;1;1
17865;Pilaitukas;ĖŽIUKAI;2105380328;Taip;12;0;0;12
17866;Pilaitukas;ĖŽIUKAI;6234641884;Taip;6;4;0;10
17867;"Naujųjų verkių";Lopšelinė;1994856959;Taip;0;1;0;1
17868;"Naujųjų verkių";Lopšelinė;1045355492;Taip;3;2;0;5
17869;"Naujųjų verkių";Lopšelinė;8223747534;Ne;19;0;0;19
17870;"Naujųjų verkių";Lopšelinė;7916257692;Taip;0;1;0;1
17871;"Naujųjų verkių";Lopšelinė;9200073539;Taip;3;0;0;3
17872;"Naujųjų verkių";Lopšelinė;8429923120;Taip;0;18;0;18
17873;"Naujųjų verkių";Lopšelinė;9462019924;Taip;0;3;0;3
17874;"Naujųjų verkių";Lopšelinė;7734802846;Taip;0;2;0;2
17875;"Naujųjų verkių";Lopšelinė;3459439843;Taip;8;2;0;10
17876;"Naujųjų verkių";Lopšelinė;7510541192;Taip;0;8;0;8
17877;"Naujųjų verkių";Lopšelinė;6162836315;Taip;6;0;0;6
17878;"Naujųjų verkių";Lopšelinė;9045108717;Taip;16;3;0;19
17879;"Naujųjų verkių";Lopšelinė;5738933125;Ne;0;8;0;8
17880;"Naujųjų verkių";Lopšelinė;6193540660;Taip;0;10;0;10
17881;"Naujųjų verkių";Darželinė;12970840107;Taip;7;0;0;7
17882;"Naujųjų verkių";Darželinė;70974231925;Taip;0;13;0;13
17883;"Naujųjų verkių";Darželinė;96956603806;Taip;0;2;0;2
17884;"Naujųjų verkių";Darželinė;60556803369;Taip;0;1;0;1
17885;"Naujųjų verkių";Darželinė;2636744220;Taip;0;6;0;6
17886;"Naujųjų verkių";Darželinė;4419831934;Taip;0;3;0;3
17887;"Naujųjų verkių";Darželinė;1273331977;Taip;0;5;0;5
17888;"Naujųjų verkių";Darželinė;45101251137;Taip;0;5;0;5
17889;"Naujųjų verkių";Darželinė;1321551506;Taip;0;5;0;5
17890;"Naujųjų verkių";Darželinė;1061601585;Ne;0;9;0;9
17891;"Naujųjų verkių";Darželinė;49937307547;Taip;0;16;0;16
17892;"Naujųjų verkių";Darželinė;89540088936;Taip;4;0;0;4
17893;"Naujųjų verkių";Darželinė;7872515649;Taip;4;0;0;4
17894;"Naujųjų verkių";Darželinė;63932903598;Taip;0;1;0;1
17895;"Naujųjų verkių";Darželinė;6425840559;Taip;0;6;0;6
17896;"Naujųjų verkių";Darželinė;3572188688;Taip;5;3;0;8
17897;"Naujųjų verkių";Darželinė;1695680881;Taip;5;0;0;5
17898;Švelnukas;Pelėdžiukai;97312326369;Taip;5;5;0;10
17899;Švelnukas;Pelėdžiukai;35501839416;Taip;1;0;0;1
17900;Švelnukas;Pelėdžiukai;54159329795;Taip;0;1;0;1
17901;Švelnukas;Pelėdžiukai;56353311492;Taip;0;0;18;18
17902;Švelnukas;Pelėdžiukai;23911831780;Taip;3;0;0;3
17903;Švelnukas;Pelėdžiukai;73720184241;Taip;3;5;0;8
17904;Švelnukas;Pelėdžiukai;94832155557;Taip;5;11;0;16
17905;Švelnukas;Pelėdžiukai;1398812288;Taip;0;1;0;1
17906;Švelnukas;Pelėdžiukai;4006769867;Taip;0;1;0;1
17907;Švelnukas;Pelėdžiukai;39249642586;Taip;0;9;0;9
17908;Švelnukas;Pelėdžiukai;81569596159;Taip;0;0;2;2
17909;Švelnukas;Pelėdžiukai;12011187563;Taip;0;0;1;1
17910;Švelnukas;Pelėdžiukai;72764312386;Ne;0;1;0;1
17911;Švelnukas;Pelėdžiukai;59229958089;Taip;2;6;0;8
17912;Švelnukas;Pelėdžiukai;57026029080;Taip;2;5;2;9
17913;Švelnukas;Pelėdžiukai;30679686753;Taip;0;0;4;4
17914;Švelnukas;Pelėdžiukai;32473329970;Ne;0;3;0;3
17915;Švelnukas;Pelėdžiukai;50326830712;Ne;0;6;0;6
17916;Švelnukas;Pelėdžiukai;88430357193;Taip;4;0;1;5
17917;Švelnukas;Pelėdžiukai;52477782880;Taip;11;0;0;11
17918;Švelnukas;Pelėdžiukai;2123115761;Taip;0;0;4;4
17919;Švelnukas;Ežiukai;79306550532;Taip;1;1;0;2
17920;Švelnukas;Ežiukai;68248605297;Taip;0;0;3;3
17921;Švelnukas;Ežiukai;41867077386;Ne;0;0;7;7
17922;Švelnukas;Ežiukai;64192510147;Taip;0;1;0;1
17923;Švelnukas;Ežiukai;41365412569;Taip;0;3;0;3
17924;Švelnukas;Ežiukai;25374873288;Taip;0;3;1;4
17925;Švelnukas;Ežiukai;15308444101;Ne;0;0;5;5
17926;Švelnukas;Ežiukai;6282389058;Taip;0;0;1;1
17927;Švelnukas;Ežiukai;1755384216;Ne;0;0;1;1
17928;Švelnukas;Ežiukai;38902466526;Taip;9;0;0;9
17929;Švelnukas;Ežiukai;33263455673;Taip;0;0;5;5
17930;Švelnukas;Ežiukai;8399963483;Taip;1;4;0;5
17931;Švelnukas;Ežiukai;4711482287;Taip;0;1;0;1
17932;Švelnukas;Ežiukai;3126384599;Ne;0;0;5;5
17933;Švelnukas;Ežiukai;4373567509;Ne;0;0;5;5
17934;Švelnukas;Ežiukai;56642886337;Taip;0;0;1;1
17935;Švelnukas;Švelnukai;4681584014;Taip;5;0;2;7
17936;Švelnukas;Švelnukai;8211289456;Taip;2;1;0;3
17937;Švelnukas;Švelnukai;6607578153;Taip;0;5;0;5
17938;Švelnukas;Švelnukai;5212827184;Taip;0;3;0;3
17939;Švelnukas;Švelnukai;9829912750;Taip;7;4;0;11
17940;Švelnukas;Švelnukai;2464467471;Taip;6;0;1;7
17941;Švelnukas;Švelnukai;5213589179;Taip;11;5;0;16
17942;Švelnukas;Švelnukai;1963518457;Taip;0;17;0;17
17943;Švelnukas;Boružiukai;1951447127;Taip;7;0;1;8
17944;Švelnukas;Boružiukai;3849957906;Taip;6;0;2;8
17945;Švelnukas;Boružiukai;5550841477;Taip;0;0;2;2
17946;Švelnukas;Boružiukai;2400781175;Taip;0;6;5;11
17947;Švelnukas;Boružiukai;1264256177;Ne;0;2;2;4
17948;Švelnukas;Boružiukai;1332533332;Taip;1;11;0;12
17949;Švelnukas;Boružiukai;8787505507;Taip;0;3;0;3
17950;Švelnukas;Boružiukai;4134678301;Ne;8;0;0;8
17951;Švelnukas;Boružiukai;8458233793;Taip;0;5;5;10
17952;Švelnukas;Boružiukai;8951980999;Taip;9;0;1;10
17953;Švelnukas;Boružiukai;4990399144;Taip;17;0;0;17
17954;Švelnukas;Boružiukai;9575767514;Taip;14;0;3;17
17955;Švelnukas;Boružiukai;6282137936;Taip;0;0;1;1
17956;Švelnukas;Boružiukai;5409130195;Taip;12;0;0;12
17957;Švelnukas;Boružiukai;2088128734;Ne;0;0;4;4
17958;Švelnukas;Boružiukai;2077614498;Ne;12;0;2;14
17959;Švelnukas;Boružiukai;3145935641;Taip;0;4;1;5
17960;Švelnukas;Smalsučiai;82202942341;Taip;0;4;0;4
17961;Švelnukas;Smalsučiai;63394075248;Taip;6;8;0;14
17962;Švelnukas;Smalsučiai;53619702326;Taip;0;5;1;6
17963;Švelnukas;Smalsučiai;1183982303;Taip;0;1;0;1
17964;Švelnukas;Smalsučiai;87770765141;Taip;2;1;0;3
17965;Švelnukas;Smalsučiai;47645479348;Taip;0;2;0;2
17966;Švelnukas;Smalsučiai;19117783391;Taip;0;8;1;9
17967;Švelnukas;Smalsučiai;26077395334;Ne;0;12;0;12
17968;Švelnukas;Smalsučiai;15711256627;Taip;0;3;0;3
17969;Švelnukas;Smalsučiai;95780894209;Taip;0;0;2;2
17970;Švelnukas;Smalsučiai;76563731138;Taip;0;11;2;13
17971;Švelnukas;Smalsučiai;3388721433;Taip;0;1;0;1
17972;Švelnukas;Smalsučiai;1742714140;Ne;0;2;1;3
17973;Švelnukas;Smalsučiai;54425041280;Taip;0;5;0;5
17974;Švelnukas;Smalsučiai;91569132037;Taip;0;7;0;7
17975;Švelnukas;Smalsučiai;34570338962;Ne;0;0;1;1
17976;Švelnukas;Smalsučiai;78611632021;Taip;0;3;0;3
17977;Švelnukas;Smalsučiai;1139744541;Ne;0;5;3;8
17978;Švelnukas;Smalsučiai;15774114007;Taip;0;0;22;22
17979;Švelnukas;Smalsučiai;26312856720;Taip;0;0;5;5
17980;Švelnukas;Nykštukai;5518267134;Ne;0;0;5;5
17981;Švelnukas;Nykštukai;2141519946;Taip;0;1;0;1
17982;Švelnukas;Nykštukai;8771953161;Taip;0;0;1;1
17983;Švelnukas;Nykštukai;2282356211;Taip;14;0;0;14
17984;Švelnukas;Nykštukai;4697253853;Ne;0;0;1;1
17985;Švelnukas;Nykštukai;7387060610;Taip;0;2;0;2
17986;Švelnukas;Nykštukai;1762528313;Taip;0;0;1;1
17987;Švelnukas;Nykštukai;7380948648;Taip;0;2;2;4
17988;Švelnukas;Nykštukai;3473146893;Taip;0;2;2;4
17989;Švelnukas;Nykštukai;3370028567;Taip;0;6;0;6
17990;Švelnukas;Nykštukai;62969317035;Ne;7;0;0;7
17991;Švelnukas;Nykštukai;6633233824;Taip;4;0;0;4
17992;Švelnukas;Nykštukai;2106591525;Ne;6;0;1;7
17993;Švelnukas;Nykštukai;93497358197;Taip;0;2;0;2
17994;Švelnukas;Nykštukai;2971380970;Ne;0;1;1;2
17995;Švelnukas;Nykštukai;3389897065;Ne;0;1;2;3
17996;Švelnukas;Nykštukai;4302735157;Taip;8;0;1;9
17997;Švelnukas;Nykštukai;2785396019;Ne;0;0;4;4
17998;Boružėlė;"Nykštukai gudručiai";17133057179;Taip;15;2;0;17
17999;Boružėlė;"Nykštukai gudručiai";48975225740;Taip;6;0;0;6
18000;Boružėlė;"Nykštukai gudručiai";61157651941;Ne;9;0;0;9
18001;Boružėlė;"Nykštukai gudručiai";62849453206;Taip;5;0;0;5
18002;Boružėlė;"Nykštukai gudručiai";90752643228;Taip;0;6;0;6
18003;Boružėlė;"Nykštukai gudručiai";91349343635;Taip;10;0;0;10
18004;Boružėlė;"Nykštukai gudručiai";3659004986;Taip;5;0;0;5
18005;Boružėlė;"Nykštukai gudručiai";28726593347;Taip;3;8;0;11
18006;Boružėlė;"Nykštukai gudručiai";29807061047;Taip;0;1;0;1
18007;Boružėlė;"Nykštukai gudručiai";55985459125;Ne;0;2;2;4
18008;Boružėlė;"Nykštukai gudručiai";68875252308;Taip;0;1;0;1
18009;Boružėlė;"Nykštukai gudručiai";22491205325;Taip;3;4;0;7
18010;Boružėlė;"Nykštukai gudručiai";82591189080;Ne;19;0;0;19
18011;Boružėlė;"Nykštukai gudručiai";5105514215;Taip;3;0;0;3
18012;Boružėlė;"Nykštukai gudručiai";95194187600;Taip;3;0;0;3
18013;Boružėlė;"Nykštukai gudručiai";473765285;Taip;4;0;0;4
18014;Boružėlė;"Saulės zuikučiai";4554260776;Ne;8;2;0;10
18015;Boružėlė;"Saulės zuikučiai";8259586236;Taip;0;2;0;2
18016;Boružėlė;"Saulės zuikučiai";3955841578;Taip;0;1;0;1
18017;Boružėlė;"Saulės zuikučiai";1583223569;Taip;0;2;0;2
18018;Boružėlė;"Saulės zuikučiai";5516103398;Taip;4;0;2;6
18019;Boružėlė;"Saulės zuikučiai";5298170118;Taip;0;5;0;5
18020;Boružėlė;"Saulės zuikučiai";9271331800;Taip;9;1;0;10
18021;Boružėlė;"Saulės zuikučiai";2133849514;Taip;5;0;0;5
18022;Boružėlė;"Saulės zuikučiai";1116012068;Ne;14;2;0;16
18023;Boružėlė;"Saulės zuikučiai";1292298259;Taip;0;2;0;2
18024;Boružėlė;"Saulės zuikučiai";3130977416;Taip;0;2;0;2
18025;Boružėlė;"Saulės zuikučiai";7256396576;Taip;0;2;0;2
18026;Boružėlė;"Saulės zuikučiai";4999277693;Taip;14;0;0;14
18027;Boružėlė;"Saulės zuikučiai";6990311896;Taip;14;0;0;14
18028;Boružėlė;"Saulės zuikučiai";4509233532;Taip;8;2;0;10
18029;Boružėlė;"Saulės zuikučiai";3952645542;Taip;12;9;0;21
18030;Boružėlė;Gėlytės;4023646693;Taip;5;0;0;5
18031;Boružėlė;Gėlytės;51321138507;Taip;0;0;1;1
18032;Boružėlė;Gėlytės;62298785353;Taip;5;0;0;5
18033;Boružėlė;Gėlytės;84087304104;Taip;12;0;1;13
18034;Boružėlė;Gėlytės;11785706048;Taip;7;0;0;7
18035;Boružėlė;Gėlytės;41726574939;Taip;8;2;0;10
18036;Boružėlė;Gėlytės;81433480408;Taip;6;0;0;6
18037;Boružėlė;Gėlytės;51923600458;Taip;0;0;2;2
18038;Boružėlė;Gėlytės;86742600111;Taip;0;2;1;3
18039;Boružėlė;Gėlytės;54530233692;Taip;0;4;2;6
18040;Boružėlė;Gėlytės;25443948372;Taip;5;0;0;5
18041;Boružėlė;Gėlytės;33639051694;Taip;0;7;0;7
18042;Boružėlė;Gėlytės;57842027470;Taip;4;0;0;4
18043;Boružėlė;Gėlytės;1010790194;Taip;2;2;4;8
18044;Boružėlė;Gėlytės;1813949172;Taip;0;10;0;10
18045;Boružėlė;Gėlytės;9148646597;Taip;5;0;1;6
18046;Boružėlė;Gėlytės;5306841409;Taip;9;0;0;9
18047;Boružėlė;Gėlytės;43198292519;Taip;0;0;11;11
18048;Boružėlė;Smalsutis;2086485441;Taip;4;0;0;4
18049;Boružėlė;Smalsutis;5129244830;Taip;6;5;0;11
18050;Boružėlė;Smalsutis;6927100979;Ne;0;8;0;8
18051;Boružėlė;Smalsutis;2887130633;Taip;4;0;1;5
18052;Boružėlė;Smalsutis;5267216044;Taip;0;2;0;2
18053;Boružėlė;Smalsutis;2917508421;Taip;3;0;0;3
18054;Boružėlė;Smalsutis;5708558321;Taip;0;2;0;2
18055;Boružėlė;Smalsutis;6484173786;Taip;2;1;0;3
18056;Boružėlė;Smalsutis;6742157071;Taip;4;0;0;4
18057;Boružėlė;Smalsutis;2132904457;Ne;0;2;2;4
18058;Boružėlė;Smalsutis;77513300382;Ne;0;9;0;9
18059;Boružėlė;Smalsutis;39553430808;Taip;7;0;4;11
18060;Boružėlė;Smalsutis;4958704459;Taip;9;2;1;12
18061;Boružėlė;Smalsutis;8493908653;Taip;0;9;0;9
18062;Boružėlė;Smalsutis;4283064680;Taip;0;6;0;6
18063;Boružėlė;Smalsutis;2447148171;Ne;0;2;0;2
18064;Boružėlė;Smalsutis;7386694567;Taip;0;0;2;2
18065;Boružėlė;Drugeliai;1130980139;Taip;2;2;0;4
18066;Boružėlė;Drugeliai;6463583187;Taip;0;1;0;1
18067;Boružėlė;Drugeliai;8683282162;Taip;0;1;0;1
18068;Boružėlė;Drugeliai;3136028536;Taip;5;0;0;5
18069;Boružėlė;Drugeliai;2211576663;Taip;3;6;0;9
18070;Boružėlė;Drugeliai;1559001916;Taip;7;2;0;9
18071;Boružėlė;Drugeliai;4233602822;Taip;0;2;1;3
18072;Boružėlė;Drugeliai;9463322491;Taip;10;1;0;11
18073;Boružėlė;Drugeliai;8482813204;Ne;3;1;0;4
18074;Boružėlė;Drugeliai;6902130914;Taip;10;0;0;10
18075;Boružėlė;Drugeliai;1545244006;Taip;6;2;2;10
18076;Boružėlė;Drugeliai;6980022864;Taip;0;2;0;2
18077;Boružėlė;Drugeliai;5726187445;Taip;0;0;3;3
18078;Boružėlė;Vyturėliai;1913540317;Taip;0;4;0;4
18079;Boružėlė;Vyturėliai;1950269258;Taip;0;6;0;6
18080;Boružėlė;Vyturėliai;1591582954;Ne;0;9;0;9
18081;Boružėlė;Vyturėliai;9180459278;Taip;2;0;0;2
18082;Boružėlė;Vyturėliai;1718509953;Taip;0;2;0;2
18083;Boružėlė;Vyturėliai;8311383437;Taip;11;1;6;18
18084;Boružėlė;Vyturėliai;7534482245;Ne;14;1;0;15
18085;Boružėlė;Vyturėliai;3310676316;Taip;0;1;0;1
18086;Boružėlė;Vyturėliai;87834777247;Ne;8;1;0;9
18087;Boružėlė;Vyturėliai;50071056728;Taip;10;10;0;20
18088;Boružėlė;Vyturėliai;2098408445;Taip;5;1;0;6
18089;Boružėlė;Vyturėliai;8706461730;Taip;0;8;0;8
18090;Boružėlė;Vyturėliai;5337704114;Taip;0;2;1;3
18091;Boružėlė;Vyturėliai;8146684259;Taip;0;5;0;5
18092;Boružėlė;Vyturėliai;67504667512;Taip;5;0;0;5
18093;Boružėlė;Vyturėliai;9150703371;Taip;0;2;0;2
18094;Boružėlė;Vyturėliai;5811751925;Ne;0;8;0;8
18095;Boružėlė;Vyturėliai;7136428795;Taip;0;3;0;3
18096;Boružėlė;Žvaigždutės;4990831292;Taip;13;0;0;13
18097;Boružėlė;Žvaigždutės;9838823214;Taip;12;0;0;12
18098;Boružėlė;Žvaigždutės;7825636053;Taip;0;5;0;5
18099;Boružėlė;Žvaigždutės;6293878183;Taip;3;4;0;7
18100;Boružėlė;Žvaigždutės;6242220139;Taip;0;4;1;5
18101;Boružėlė;Žvaigždutės;1663216529;Taip;0;3;0;3
18102;Boružėlė;Žvaigždutės;3489498503;Taip;5;2;0;7
18103;Boružėlė;Žvaigždutės;5274016839;Taip;0;2;0;2
18104;Boružėlė;Žvaigždutės;6972646373;Taip;2;0;0;2
18105;Boružėlė;Žvaigždutės;9720535449;Taip;3;1;0;4
18106;Boružėlė;Žvaigždutės;6435556131;Taip;3;1;0;4
18107;Boružėlė;Žvaigždutės;5804189049;Taip;0;0;7;7
18108;Boružėlė;Žvaigždutės;8029389952;Taip;5;3;0;8
18109;Boružėlė;Žvaigždutės;5307997577;Taip;0;0;11;11
18110;Boružėlė;Žvaigždutės;7078709057;Taip;4;2;1;7
18111;Boružėlė;Žvaigždutės;8213060214;Taip;9;0;0;9
18112;Boružėlė;Žvaigždutės;8916241914;Taip;0;9;0;9
18113;Boružėlė;Žvaigždutės;6724101421;Taip;0;2;3;5
18114;Boružėlė;Ąžuoliukai;5774358876;Ne;0;2;0;2
18115;Boružėlė;Ąžuoliukai;4519645340;Taip;0;5;0;5
18116;Boružėlė;Ąžuoliukai;24315678618;Taip;17;0;0;17
18117;Boružėlė;Ąžuoliukai;4994696176;Ne;0;4;0;4
18118;Boružėlė;Ąžuoliukai;5138737297;Taip;10;0;0;10
18119;Boružėlė;Ąžuoliukai;2618814096;Ne;0;4;1;5
18120;Boružėlė;Ąžuoliukai;6439902117;Taip;13;1;0;14
18121;Boružėlė;Ąžuoliukai;3040376382;Taip;5;1;0;6
18122;Boružėlė;Ąžuoliukai;3912668735;Taip;5;1;0;6
18123;Boružėlė;Ąžuoliukai;3840860155;Ne;0;0;1;1
18124;Boružėlė;Ąžuoliukai;3869817904;Taip;4;2;0;6
18125;Boružėlė;Ąžuoliukai;7722277859;Taip;7;1;0;8
18126;Boružėlė;Ąžuoliukai;6954794465;Taip;0;2;2;4
18127;Boružėlė;Ąžuoliukai;6545116373;Taip;9;2;0;11
18128;Boružėlė;Ąžuoliukai;5832223872;Taip;0;2;0;2
18129;Boružėlė;Ąžuoliukai;3695411422;Ne;0;10;0;10
18130;Boružėlė;Ąžuoliukai;5148410392;Ne;4;0;0;4
18131;Boružėlė;Ąžuoliukai;45181369655;Taip;0;6;0;6
18132;Boružėlė;Ąžuoliukai;2077228543;Taip;3;0;0;3
18133;Boružėlė;Ąžuoliukai;6022191251;Taip;3;2;2;7
18134;Boružėlė;Saulutės;55049551150;Taip;0;3;0;3
18135;Boružėlė;Saulutės;1311485296;Taip;11;2;0;13
18136;Boružėlė;Saulutės;64389558278;Taip;0;4;3;7
18137;Boružėlė;Saulutės;1399195259;Taip;5;6;0;11
18138;Boružėlė;Saulutės;1247185819;Taip;0;1;0;1
18139;Boružėlė;Saulutės;1910653135;Ne;0;14;5;19
18140;Boružėlė;Saulutės;8814486475;Taip;0;10;0;10
18141;Boružėlė;Saulutės;4567360023;Taip;7;5;0;12
18142;Boružėlė;Saulutės;96500755145;Ne;5;0;0;5
18143;Boružėlė;Saulutės;1506999888;Taip;0;3;0;3
18144;Boružėlė;Saulutės;2402968573;Taip;0;3;0;3
18145;Boružėlė;Saulutės;2690216341;Ne;5;2;0;7
18146;Boružėlė;Saulutės;8659850691;Taip;0;2;1;3
18147;Boružėlė;Saulutės;4562962568;Taip;0;2;1;3
18148;Boružėlė;Saulutės;64347371263;Taip;0;2;0;2
18149;Boružėlė;Saulutės;1040409859;Taip;0;4;2;6
18150;Boružėlė;Saulutės;1750151078;Ne;0;2;3;5
18151;Boružėlė;Saulutės;1580917200;Taip;5;4;0;9
18152;Boružėlė;Ežiukai;1637965530;Taip;0;2;0;2
18153;Boružėlė;Ežiukai;80490841186;Taip;12;0;3;15
18154;Boružėlė;Ežiukai;97765175729;Taip;10;0;0;10
18155;Boružėlė;Ežiukai;9436674675;Taip;10;0;0;10
18156;Boružėlė;Ežiukai;58923894463;Taip;3;2;0;5
18157;Boružėlė;Ežiukai;27456755162;Taip;0;2;0;2
18158;Boružėlė;Ežiukai;1339605077;Taip;0;1;0;1
18159;Boružėlė;Ežiukai;80239337645;Taip;0;2;0;2
18160;Boružėlė;Ežiukai;1007058344;Taip;0;3;0;3
18161;Boružėlė;Ežiukai;86859788504;Taip;0;10;0;10
18162;Boružėlė;Ežiukai;2138048547;Ne;0;1;0;1
18163;Boružėlė;Ežiukai;1474967056;Taip;0;7;0;7
18164;Boružėlė;Ežiukai;62548032852;Taip;0;1;0;1
18165;Boružėlė;Ežiukai;87991501724;Taip;0;1;0;1
18166;Boružėlė;Ežiukai;17258743024;Taip;0;1;0;1
18167;Boružėlė;Ežiukai;31109596405;Taip;22;0;0;22
18168;Boružėlė;Ežiukai;49403734292;Taip;0;0;2;2
18169;Boružėlė;Ežiukai;46486992436;Taip;0;4;0;4
18170;Boružėlė;Ežiukai;39704329817;Ne;0;2;0;2
18171;Boružėlė;Ežiukai;61932744418;Taip;9;2;0;11
18172;Boružėlė;Ežiukai;1459630343;Taip;0;13;0;13
18173;Boružėlė;Ežiukai;8266904750;Taip;0;3;0;3
18174;Boružėlė;Boružiukai;4433248526;Taip;0;0;2;2
18175;Boružėlė;Boružiukai;9520696660;Taip;5;0;3;8
18176;Boružėlė;Boružiukai;3288141024;Taip;10;0;0;10
18177;Boružėlė;Boružiukai;7942043844;Taip;0;2;1;3
18178;Boružėlė;Boružiukai;3226733236;Taip;0;3;0;3
18179;Boružėlė;Boružiukai;2842256033;Taip;2;0;0;2
18180;Boružėlė;Boružiukai;7262515868;Taip;7;4;0;11
18181;Boružėlė;Boružiukai;1146297996;Taip;0;2;0;2
18182;Boružėlė;Boružiukai;3340082011;Taip;5;1;0;6
18183;Boružėlė;Boružiukai;4020348640;Taip;8;0;0;8
18184;Boružėlė;Boružiukai;1166207929;Ne;5;0;0;5
18185;Boružėlė;Boružiukai;2561969142;Taip;10;4;2;16
18186;Boružėlė;Boružiukai;7956982615;Ne;11;1;6;18
18187;Boružėlė;Boružiukai;6070356395;Taip;6;1;0;7
18188;Boružėlė;Boružiukai;1547802140;Taip;5;5;0;10
18189;Boružėlė;Boružiukai;4637656311;Taip;6;0;0;6
18190;Boružėlė;Boružiukai;5768415821;Taip;8;1;0;9
18191;Boružėlė;Boružiukai;2524469162;Ne;17;0;0;17
18192;Boružėlė;Nykštukai;6590829182;Ne;15;0;0;15
18193;Boružėlė;Nykštukai;8141240094;Taip;6;1;0;7
18194;Boružėlė;Nykštukai;3129825206;Taip;0;5;0;5
18195;Boružėlė;Nykštukai;2926620929;Taip;8;6;0;14
18196;Boružėlė;Nykštukai;2349571778;Taip;3;7;0;10
18197;Boružėlė;Nykštukai;1894170218;Taip;13;0;0;13
18198;Boružėlė;Nykštukai;3509512899;Taip;13;2;0;15
18199;Boružėlė;Nykštukai;8888151470;Taip;13;2;0;15
18200;Boružėlė;Nykštukai;3430953692;Ne;8;1;0;9
18201;Boružėlė;Nykštukai;6166247730;Taip;0;1;0;1
18202;Boružėlė;Nykštukai;8365962523;Taip;2;0;0;2
18203;Boružėlė;Nykštukai;6876323023;Taip;0;0;8;8
18204;Boružėlė;Nykštukai;2744894565;Taip;0;0;6;6
18205;Boružėlė;Nykštukai;9771767352;Taip;13;0;0;13
18206;Boružėlė;Nykštukai;2571360077;Taip;0;2;0;2
18207;Boružėlė;Nykštukai;5825164520;Taip;10;0;2;12
18208;Boružėlė;Nykštukai;8789209196;Taip;7;0;1;8
18209;Boružėlė;Nykštukai;3592853535;Taip;0;1;0;1
18210;Žaliakalnio;Drugeliai;38025903441;Taip;0;0;1;1
18211;Žaliakalnio;Drugeliai;98394011032;Ne;3;0;5;8
18212;Žaliakalnio;Drugeliai;96127127960;Ne;8;0;0;8
18213;Žaliakalnio;Drugeliai;69892069029;Taip;3;0;0;3
18214;Žaliakalnio;Drugeliai;1012597457;Taip;5;2;0;7
18215;Žaliakalnio;Drugeliai;55967554391;Taip;9;0;0;9
18216;Žaliakalnio;Drugeliai;1357321617;Taip;0;1;0;1
18217;Žaliakalnio;Drugeliai;1967580906;Ne;0;0;2;2
18218;Žaliakalnio;Drugeliai;19165022144;Taip;0;3;0;3
18219;Žaliakalnio;Drugeliai;5428225559;Ne;3;0;2;5
18220;Žaliakalnio;Drugeliai;1902477771;Taip;0;0;1;1
18221;Žaliakalnio;Drugeliai;56222558457;Taip;8;1;0;9
18222;Žaliakalnio;Drugeliai;21032761681;Taip;7;0;2;9
18223;Žaliakalnio;Drugeliai;1919996835;Ne;0;1;0;1
18224;Žaliakalnio;Drugeliai;12010376482;Taip;12;0;0;12
18225;Žaliakalnio;Drugeliai;12932356909;Taip;7;0;0;7
18226;Žaliakalnio;Boružėlių;5843020412;Taip;1;4;0;5
18227;Žaliakalnio;Boružėlių;9625531462;Taip;0;18;0;18
18228;Žaliakalnio;Boružėlių;6699373334;Taip;0;18;0;18
18229;Žaliakalnio;Boružėlių;7087535800;Taip;4;1;0;5
18230;Žaliakalnio;Boružėlių;1528111839;Ne;4;3;0;7
18231;Žaliakalnio;Boružėlių;7023886811;Taip;0;3;0;3
18232;Žaliakalnio;Boružėlių;1673321992;Taip;14;8;0;22
18233;Žaliakalnio;Boružėlių;2284465378;Taip;0;13;0;13
18234;Žaliakalnio;Boružėlių;7977009681;Taip;0;4;0;4
18235;Žaliakalnio;Boružėlių;2808776865;Taip;1;0;1;2
18236;Žaliakalnio;Boružėlių;2278681435;Taip;0;10;0;10
18237;Žaliakalnio;Boružėlių;6547167325;Taip;1;0;0;1
18238;Žaliakalnio;Boružėlių;5157814568;Taip;1;0;2;3
18239;Žaliakalnio;Boružėlių;9421259943;Taip;11;0;0;11
18240;Žaliakalnio;Boružėlių;3105500733;Taip;1;11;0;12
18241;Žaliakalnio;Boružėlių;4864834075;Taip;0;3;0;3
18242;Žaliakalnio;Boružėlių;5764128482;Taip;5;0;0;5
18243;Žaliakalnio;Boružėlių;1200844791;Ne;5;17;0;22
18244;Žaliakalnio;Boružėlių;8052539476;Taip;12;0;0;12
18245;Žaliakalnio;Zuikučiai;1592051491;Ne;0;4;0;4
18246;Žaliakalnio;Zuikučiai;6088333997;Taip;0;4;0;4
18247;Žaliakalnio;Zuikučiai;2621828772;Taip;0;1;0;1
18248;Žaliakalnio;Zuikučiai;2673619031;Taip;0;6;0;6
18249;Žaliakalnio;Zuikučiai;5843314345;Ne;4;3;0;7
18250;Žaliakalnio;Zuikučiai;7447278960;Taip;0;11;0;11
18251;Žaliakalnio;Zuikučiai;2180165053;Taip;0;4;0;4
18252;Žaliakalnio;Zuikučiai;6823528666;Ne;5;8;0;13
18253;Žaliakalnio;Zuikučiai;3509064089;Taip;0;8;0;8
18254;Žaliakalnio;Zuikučiai;7000429934;Taip;0;14;0;14
18255;Žaliakalnio;Zuikučiai;5730610895;Taip;0;9;0;9
18256;Žaliakalnio;Zuikučiai;6881070397;Taip;0;10;0;10
18257;Žaliakalnio;Zuikučiai;8209559343;Taip;13;1;0;14
18258;Žaliakalnio;Zuikučiai;3835667120;Taip;0;4;0;4
18259;Žaliakalnio;Zuikučiai;9799056285;Taip;0;11;0;11
18260;Žaliakalnio;Zuikučiai;1321592040;Taip;0;4;0;4
18261;Žaliakalnio;Zuikučiai;8298313285;Taip;0;4;0;4
18262;Žaliakalnio;Zuikučiai;9331287916;Taip;10;4;0;14
18263;Žaliakalnio;Zuikučiai;6726832258;Taip;0;5;0;5
18264;Žaliakalnio;Zuikučiai;4511376806;Ne;0;4;0;4
18265;Žaliakalnio;Bitutė;23692122313;Ne;0;10;0;10
18266;Žaliakalnio;Bitutė;47735728560;Taip;4;2;0;6
18267;Žaliakalnio;Bitutė;1581365258;Taip;0;1;0;1
18268;Žaliakalnio;Bitutė;26003637304;Taip;2;9;0;11
18269;Žaliakalnio;Bitutė;46360583256;Taip;0;1;0;1
18270;Žaliakalnio;Bitutė;1027036769;Ne;0;5;0;5
18271;Žaliakalnio;Bitutė;1142844672;Taip;0;12;0;12
18272;Žaliakalnio;Bitutė;1447567627;Taip;0;15;0;15
18273;Žaliakalnio;Bitutė;1113616994;Ne;6;1;0;7
18274;Žaliakalnio;Bitutė;64628389691;Taip;6;3;0;9
18275;Žaliakalnio;Bitutė;1909837418;Ne;9;0;0;9
18276;Žaliakalnio;Bitutė;56508324349;Taip;0;14;0;14
18277;Žaliakalnio;Bitutė;92533370070;Ne;0;12;0;12
18278;Žaliakalnio;Bitutė;7700118291;Ne;9;2;0;11
18279;Žaliakalnio;Bitutė;5761499050;Taip;9;10;0;19
18280;Žaliakalnio;Bitutė;40283689721;Taip;5;4;0;9
18281;Žaliakalnio;Nykštukų;9057678671;Ne;0;7;0;7
18282;Žaliakalnio;Nykštukų;8640423692;Ne;0;3;0;3
18283;Žaliakalnio;Nykštukų;19192494119;Taip;0;2;0;2
18284;Žaliakalnio;Nykštukų;91524700281;Taip;0;4;0;4
18285;Žaliakalnio;Nykštukų;1753760382;Taip;0;4;0;4
18286;Žaliakalnio;Nykštukų;61215164827;Ne;0;6;0;6
18287;Žaliakalnio;Nykštukų;1657390839;Taip;0;1;0;1
18288;Žaliakalnio;Nykštukų;2655227703;Taip;0;8;0;8
18289;Žaliakalnio;Nykštukų;8085215871;Taip;0;1;0;1
18290;Žaliakalnio;Nykštukų;8469042778;Taip;0;3;0;3
18291;Žaliakalnio;Nykštukų;41844570217;Ne;0;2;0;2
18292;Žaliakalnio;Nykštukų;6638075273;Ne;0;12;0;12
18293;Žaliakalnio;Nykštukų;21744638321;Taip;0;9;0;9
18294;Žaliakalnio;Nykštukų;1514982516;Taip;10;12;0;22
18295;Žaliakalnio;Nykštukų;1497932659;Ne;0;0;1;1
18296;Žaliakalnio;Nykštukų;5946168564;Ne;0;10;0;10
18297;Žaliakalnio;Nykštukų;1589546605;Taip;0;1;0;1
18298;Žaliakalnio;Nykštukų;44058368949;Ne;0;7;0;7
18299;Žaliakalnio;Nykštukų;1511544568;Taip;0;7;0;7
18300;Žaliakalnio;ŽIOGELIAI;1413563085;Ne;0;5;0;5
18301;Žaliakalnio;ŽIOGELIAI;6379145626;Ne;10;1;0;11
18302;Žaliakalnio;ŽIOGELIAI;7094914749;Taip;13;3;0;16
18303;Žaliakalnio;ŽIOGELIAI;2432935088;Ne;0;2;0;2
18304;Žaliakalnio;ŽIOGELIAI;3058369504;Ne;4;0;0;4
18305;Žaliakalnio;ŽIOGELIAI;9771191966;Taip;14;2;0;16
18306;Žaliakalnio;ŽIOGELIAI;6919074533;Taip;0;1;0;1
18307;Žaliakalnio;ŽIOGELIAI;2426844621;Ne;0;7;0;7
18308;Žaliakalnio;ŽIOGELIAI;5752912101;Ne;8;1;0;9
18309;Žaliakalnio;ŽIOGELIAI;9967098834;Ne;6;1;0;7
18310;Žaliakalnio;ŽIOGELIAI;1133557422;Taip;5;1;0;6
18311;Žaliakalnio;ŽIOGELIAI;3464935314;Taip;12;1;0;13
18312;Žaliakalnio;ŽIOGELIAI;4497938258;Taip;0;2;0;2
18313;Žaliakalnio;ŽIOGELIAI;7648422668;Ne;8;3;0;11
18314;Žaliakalnio;ŽIOGELIAI;4702470511;Ne;0;7;0;7
18315;Žaliakalnio;ŽIOGELIAI;2272043654;Taip;0;0;2;2
18316;Žaliakalnio;ŽIOGELIAI;2305496316;Ne;6;0;0;6
18317;Volungė;Bitutės;1866419277;Taip;0;4;0;4
18318;Volungė;Bitutės;73677227470;Taip;0;0;2;2
18319;Volungė;Bitutės;58770101384;Taip;0;0;10;10
18320;Volungė;Bitutės;77965211614;Taip;0;0;4;4
18321;Volungė;Bitutės;33437446320;Taip;0;3;0;3
18322;Volungė;Bitutės;57009443613;Taip;0;11;0;11
18323;Volungė;Bitutės;87185412767;Ne;9;0;6;15
18324;Volungė;Bitutės;51999447522;Taip;0;0;4;4
18325;Volungė;Bitutės;50724446122;Taip;0;0;2;2
18326;Volungė;Bitutės;33864104545;Taip;0;22;0;22
18327;Volungė;Bitutės;1673755671;Taip;0;0;6;6
18328;Volungė;Bitutės;1177104323;Ne;0;0;9;9
18329;Volungė;Bitutės;7623915697;Taip;0;0;2;2
18330;Volungė;Bitutės;6426464927;Taip;0;0;5;5
18331;Volungė;Bitutės;81531599643;Ne;0;0;1;1
18332;Volungė;Boružiukai;28521139566;Ne;0;0;3;3
18333;Volungė;Boružiukai;44878463386;Taip;0;5;5;10
18334;Volungė;Boružiukai;1812871720;Taip;0;0;6;6
18335;Volungė;Boružiukai;1574141255;Taip;5;0;2;7
18336;Volungė;Boružiukai;18572342676;Ne;0;3;3;6
18337;Volungė;Boružiukai;16359638255;Taip;0;4;0;4
18338;Volungė;Boružiukai;83169035513;Taip;0;0;1;1
18339;Volungė;Boružiukai;52112359999;Ne;0;0;7;7
18340;Volungė;Boružiukai;55920793056;Taip;4;0;0;4
18341;Volungė;Boružiukai;50525901200;Taip;8;0;0;8
18342;Volungė;Boružiukai;1766449043;Taip;0;0;3;3
18343;Volungė;Boružiukai;55892369610;Taip;0;1;0;1
18344;Volungė;Žvirbliukai;7965601199;Taip;0;1;4;5
18345;Volungė;Žvirbliukai;8287344195;Taip;4;7;0;11
18346;Volungė;Žvirbliukai;5710662590;Taip;0;0;3;3
18347;Volungė;Žvirbliukai;1528289101;Taip;0;1;0;1
18348;Volungė;Žvirbliukai;4839484528;Taip;7;0;5;12
18349;Volungė;Žvirbliukai;9188994935;Taip;0;13;0;13
18350;Volungė;Žvirbliukai;8285309230;Taip;0;4;1;5
18351;Volungė;Žvirbliukai;5174427959;Taip;0;0;6;6
18352;Volungė;Žvirbliukai;7867741556;Ne;10;0;1;11
18353;Volungė;Žvirbliukai;3430719834;Taip;0;2;0;2
18354;Volungė;Žvirbliukai;8459167833;Taip;0;4;3;7
18355;Volungė;Žvirbliukai;6028582927;Taip;6;0;1;7
18356;Volungė;Žvirbliukai;8784150784;Taip;5;6;0;11
18357;Volungė;Žvirbliukai;1137713075;Taip;9;4;0;13
18358;Volungė;Žvirbliukai;9578228103;Taip;15;2;0;17
18359;Volungė;Žvirbliukai;6431477042;Taip;0;0;7;7
18360;Volungė;Žvirbliukai;4598763851;Taip;0;1;2;3
18361;Volungė;Žvirbliukai;2322594823;Ne;9;0;2;11
18362;Volungė;Žiogeliai;6360834021;Taip;5;2;0;7
18363;Volungė;Žiogeliai;4856240879;Taip;0;0;2;2
18364;Volungė;Žiogeliai;8767261039;Taip;0;0;1;1
18365;Volungė;Žiogeliai;9100947038;Taip;2;0;1;3
18366;Volungė;Žiogeliai;4694016281;Ne;0;0;3;3
18367;Volungė;Žiogeliai;9816038480;Taip;7;0;0;7
18368;Volungė;Žiogeliai;8640511964;Ne;0;0;13;13
18369;Volungė;Žiogeliai;5170536566;Taip;0;0;1;1
18370;Volungė;Žiogeliai;8421730419;Ne;5;0;3;8
18371;Volungė;Žiogeliai;6532202782;Taip;13;0;0;13
18372;Volungė;Žiogeliai;2712034356;Taip;0;5;0;5
18373;Volungė;Žiogeliai;6074678642;Ne;6;0;6;12
18374;Volungė;Žiogeliai;2246291631;Ne;5;0;2;7
18375;Volungė;Žiogeliai;2456643081;Taip;0;0;1;1
18376;Volungė;Žiogeliai;1781838937;Taip;0;7;0;7
18377;Volungė;Pelėdžiukai;1032406917;Taip;0;2;0;2
18378;Volungė;Pelėdžiukai;1105647976;Ne;8;0;0;8
18379;Volungė;Pelėdžiukai;1705153224;Taip;5;0;1;6
18380;Volungė;Pelėdžiukai;2048619311;Taip;0;0;8;8
18381;Volungė;Pelėdžiukai;3675279848;Taip;0;1;4;5
18382;Volungė;Pelėdžiukai;9097775073;Ne;0;5;0;5
18383;Volungė;Pelėdžiukai;1938717633;Taip;0;9;0;9
18384;Volungė;Pelėdžiukai;6977873198;Taip;0;0;2;2
18385;Volungė;Pelėdžiukai;1917593287;Taip;0;0;11;11
18386;Volungė;Pelėdžiukai;85731265908;Taip;0;0;2;2
18387;Volungė;Pelėdžiukai;1861218588;Ne;0;0;1;1
18388;Volungė;Pelėdžiukai;8236836742;Taip;0;1;2;3
18389;Volungė;Pelėdžiukai;1158253769;Ne;0;0;2;2
18390;Volungė;Pelėdžiukai;3632828615;Ne;0;0;3;3
18391;Volungė;Drugeliai;1742777458;Taip;0;0;7;7
18392;Volungė;Drugeliai;2139675610;Taip;0;3;0;3
18393;Volungė;Drugeliai;1752357091;Taip;3;0;0;3
18394;Volungė;Drugeliai;1974360497;Taip;0;0;9;9
18395;Volungė;Drugeliai;86784613109;Taip;0;0;3;3
18396;Volungė;Drugeliai;3803129970;Ne;11;0;1;12
18397;Volungė;Drugeliai;1726933019;Taip;0;0;6;6
18398;Volungė;Drugeliai;1333045175;Ne;0;7;4;11
18399;Volungė;Drugeliai;1900204936;Taip;4;0;0;4
18400;Volungė;Drugeliai;1333755594;Taip;0;0;7;7
18401;Volungė;Drugeliai;1539188909;Taip;0;0;7;7
18402;Volungė;Drugeliai;1731981819;Ne;10;0;1;11
18403;Volungė;Drugeliai;2763686861;Taip;0;0;6;6
18404;Volungė;Drugeliai;19340864795;Taip;0;10;2;12
18405;Volungė;Drugeliai;3155184296;Taip;0;0;1;1
18406;Volungė;Drugeliai;7075466773;Taip;0;0;5;5
18407;Volungė;Drugeliai;1291153830;Taip;0;15;0;15
18408;Volungė;Drugeliai;1167124464;Taip;4;0;0;4
18409;Volungė;"SKRUZDĖLIUKAI ";8174587725;Taip;3;0;9;12
18410;Volungė;"SKRUZDĖLIUKAI ";7521910384;Taip;7;0;0;7
18411;Volungė;"SKRUZDĖLIUKAI ";5240126123;Taip;0;0;8;8
18412;Volungė;"SKRUZDĖLIUKAI ";8268202101;Ne;0;0;2;2
18413;Volungė;"SKRUZDĖLIUKAI ";2566901599;Taip;11;0;2;13
18414;Volungė;"SKRUZDĖLIUKAI ";7281448136;Ne;0;0;2;2
18415;Volungė;"SKRUZDĖLIUKAI ";2420242319;Taip;0;0;4;4
18416;Volungė;"SKRUZDĖLIUKAI ";1120682487;Taip;4;0;1;5
18417;Volungė;"SKRUZDĖLIUKAI ";1366066359;Taip;0;4;3;7
18418;Volungė;"SKRUZDĖLIUKAI ";9068889427;Ne;0;0;5;5
18419;Volungė;"SKRUZDĖLIUKAI ";1225378067;Ne;8;0;1;9
18420;Volungė;"SKRUZDĖLIUKAI ";3356901662;Taip;22;0;0;22
18421;Volungė;"SKRUZDĖLIUKAI ";9082860913;Taip;0;0;7;7
18422;Volungė;"SKRUZDĖLIUKAI ";9629567682;Taip;0;0;4;4
18423;Volungė;"SKRUZDĖLIUKAI ";3814647332;Taip;0;0;2;2
18424;Volungė;"SKRUZDĖLIUKAI ";4123080241;Taip;18;0;1;19
18425;Volungė;Zylutės;8905401944;Taip;9;0;1;10
18426;Volungė;Zylutės;9973604148;Taip;0;9;1;10
18427;Volungė;Zylutės;6782622442;Ne;12;0;5;17
18428;Volungė;Zylutės;5354511593;Taip;9;10;0;19
18429;Volungė;Zylutės;7574856429;Ne;11;0;1;12
18430;Volungė;Zylutės;9729285419;Taip;0;0;13;13
18431;Volungė;Zylutės;5284011092;Taip;0;0;3;3
18432;Volungė;Zylutės;2981560931;Taip;3;0;0;3
18433;Volungė;Zylutės;4252713086;Taip;0;0;2;2
18434;Volungė;Zylutės;4427076715;Taip;12;1;0;13
18435;Volungė;Zylutės;3020629341;Taip;2;0;3;5
18436;Volungė;Zylutės;1164632050;Taip;0;0;2;2
18437;Giliukas;SMALSUČIAI;1289574961;Taip;0;2;1;3
18438;Giliukas;SMALSUČIAI;1664239181;Taip;9;2;0;11
18439;Giliukas;SMALSUČIAI;9747155435;Taip;3;0;0;3
18440;Giliukas;SMALSUČIAI;2006450088;Ne;0;1;0;1
18441;Giliukas;SMALSUČIAI;89954209937;Taip;0;2;0;2
18442;Giliukas;SMALSUČIAI;40373221046;Taip;0;2;3;5
18443;Giliukas;SMALSUČIAI;9461909264;Taip;2;0;0;2
18444;Giliukas;SMALSUČIAI;8575067944;Ne;0;1;0;1
18445;Giliukas;SMALSUČIAI;1463748654;Taip;0;1;0;1
18446;Giliukas;SMALSUČIAI;45270647252;Taip;0;2;0;2
18447;Giliukas;SMALSUČIAI;1417138570;Taip;5;0;0;5
18448;Giliukas;SMALSUČIAI;4053376466;Ne;14;1;0;15
18449;Giliukas;SMALSUČIAI;1406371374;Ne;5;2;0;7
18450;Giliukas;SMALSUČIAI;34155615138;Taip;0;4;0;4
18451;Giliukas;SMALSUČIAI;10326073797;Taip;0;2;0;2
18452;Giliukas;SMALSUČIAI;7732836522;Taip;14;0;0;14
18453;Giliukas;SMALSUČIAI;5914236976;Taip;0;5;0;5
18454;Giliukas;SMALSUČIAI;9225515816;Taip;0;2;0;2
18455;Giliukas;SMALSUČIAI;6453425490;Taip;22;0;0;22
18456;Giliukas;SMALSUČIAI;1190611675;Ne;0;2;0;2
18457;Giliukas;SMALSUČIAI;14318411597;Taip;0;1;0;1
18458;Giliukas;SMALSUČIAI;1595057434;Taip;8;0;0;8
18459;Giliukas;GUDRUČIAI;2099862126;Taip;0;3;1;4
18460;Giliukas;GUDRUČIAI;2617670085;Ne;0;2;0;2
18461;Giliukas;GUDRUČIAI;1649456516;Taip;4;3;0;7
18462;Giliukas;GUDRUČIAI;1431811346;Taip;0;1;0;1
18463;Giliukas;GUDRUČIAI;76716908362;Taip;0;3;0;3
18464;Giliukas;GUDRUČIAI;1771662094;Taip;3;1;0;4
18465;Giliukas;GUDRUČIAI;1869027087;Taip;0;2;0;2
18466;Giliukas;GUDRUČIAI;7223355423;Ne;0;2;0;2
18467;Giliukas;GUDRUČIAI;84750777858;Taip;0;2;0;2
18468;Giliukas;GUDRUČIAI;1910800137;Taip;0;5;1;6
18469;Giliukas;GUDRUČIAI;9826756136;Taip;0;0;4;4
18470;Giliukas;GUDRUČIAI;1733875411;Taip;0;2;3;5
18471;Giliukas;GUDRUČIAI;8284364049;Taip;0;1;0;1
18472;Giliukas;GUDRUČIAI;80254838594;Taip;8;0;0;8
18473;Giliukas;GUDRUČIAI;6154379463;Taip;0;0;6;6
18474;Giliukas;GUDRUČIAI;5365204441;Taip;0;0;1;1
18475;Giliukas;ŠNEKUČIAI;3691791222;Taip;7;0;0;7
18476;Giliukas;ŠNEKUČIAI;24030146209;Taip;0;0;4;4
18477;Giliukas;ŠNEKUČIAI;3847358328;Taip;0;2;1;3
18478;Giliukas;ŠNEKUČIAI;1469477982;Ne;0;5;0;5
18479;Giliukas;ŠNEKUČIAI;3983555939;Taip;0;1;0;1
18480;Giliukas;ŠNEKUČIAI;7780118692;Taip;0;5;0;5
18481;Giliukas;ŠNEKUČIAI;2951628295;Taip;0;1;0;1
18482;Giliukas;ŠNEKUČIAI;9401247559;Taip;0;2;0;2
18483;Giliukas;ŠNEKUČIAI;4916844983;Taip;4;0;0;4
18484;Giliukas;ŠNEKUČIAI;5787041097;Taip;3;5;0;8
18485;Giliukas;ŠNEKUČIAI;4987348316;Taip;0;2;2;4
18486;Giliukas;ŠNEKUČIAI;1734336095;Taip;2;0;0;2
18487;Giliukas;ŠNEKUČIAI;3252419072;Taip;22;0;0;22
18488;Giliukas;ŠNEKUČIAI;6790396551;Taip;0;0;1;1
18489;Giliukas;PABIRUČIAI;8267507304;Ne;21;0;0;21
18490;Giliukas;PABIRUČIAI;2692141913;Taip;9;0;0;9
18491;Giliukas;PABIRUČIAI;4854370266;Taip;0;2;0;2
18492;Giliukas;PABIRUČIAI;9608331265;Taip;0;5;5;10
18493;Giliukas;PABIRUČIAI;1870173947;Taip;8;0;1;9
18494;Giliukas;PABIRUČIAI;9644050818;Taip;5;4;4;13
18495;Giliukas;PABIRUČIAI;3150981084;Taip;14;1;0;15
18496;Giliukas;PABIRUČIAI;3137768675;Taip;3;2;0;5
18497;Giliukas;PABIRUČIAI;5816317197;Ne;7;1;0;8
18498;Giliukas;PABIRUČIAI;9408948207;Ne;13;0;0;13
18499;Giliukas;PABIRUČIAI;2003990493;Taip;0;1;0;1
18500;Giliukas;PABIRUČIAI;4960232685;Taip;5;0;2;7
18501;Giliukas;PABIRUČIAI;6338583515;Taip;0;1;0;1
18502;Giliukas;PABIRUČIAI;9458151965;Taip;6;0;3;9
18503;Giliukas;PABIRUČIAI;6703080106;Taip;9;2;0;11
18504;Giliukas;PABIRUČIAI;8502974441;Taip;0;5;0;5
18505;Giliukas;PABIRUČIAI;6134554678;Ne;4;10;0;14
18506;Giliukas;PABIRUČIAI;4314782482;Taip;0;0;1;1
18507;"Lazdynų mokykla";Drugeliai;10453975773;Taip;0;9;0;9
18508;"Lazdynų mokykla";Drugeliai;1117304239;Taip;0;4;0;4
18509;"Lazdynų mokykla";Drugeliai;2079967590;Taip;5;0;0;5
18510;"Lazdynų mokykla";Drugeliai;6209271043;Ne;7;2;0;9
18511;"Lazdynų mokykla";Drugeliai;7154882168;Taip;0;22;0;22
18512;"Lazdynų mokykla";Drugeliai;6835150864;Taip;6;7;0;13
18513;"Lazdynų mokykla";Drugeliai;4520091712;Taip;0;0;1;1
18514;"Lazdynų mokykla";Drugeliai;1177208864;Ne;5;1;2;8
18515;"Lazdynų mokykla";Drugeliai;8472834181;Taip;0;1;0;1
18516;"Lazdynų mokykla";Drugeliai;9196184984;Taip;8;0;1;9
18517;"Lazdynų mokykla";Drugeliai;2469486746;Taip;0;1;0;1
18518;"Lazdynų mokykla";Drugeliai;6394098306;Taip;0;0;6;6
18519;"Lazdynų mokykla";Drugeliai;2767732459;Ne;0;3;0;3
18520;"Lazdynų mokykla";Zuikučiai;1065999533;Taip;2;1;1;4
18521;"Lazdynų mokykla";Zuikučiai;40995112936;Taip;11;0;0;11
18522;"Lazdynų mokykla";Zuikučiai;9591838054;Taip;0;10;0;10
18523;"Lazdynų mokykla";Zuikučiai;8847547438;Ne;15;1;0;16
18524;"Lazdynų mokykla";Zuikučiai;6615724604;Taip;8;3;0;11
18525;"Lazdynų mokykla";Zuikučiai;9386629495;Taip;8;0;0;8
18526;"Lazdynų mokykla";Zuikučiai;1817040419;Taip;0;6;0;6
18527;"Lazdynų mokykla";Zuikučiai;25106446270;Ne;10;1;0;11
18528;"Lazdynų mokykla";Zuikučiai;9123178095;Taip;0;10;0;10
18529;"Lazdynų mokykla";Zuikučiai;6848743350;Taip;6;9;0;15
18530;"Lazdynų mokykla";Zuikučiai;1365362641;Taip;3;0;1;4
18531;"Lazdynų mokykla";Zuikučiai;3435025978;Taip;0;0;5;5
18532;"Lazdynų mokykla";Zuikučiai;7549389699;Ne;15;1;0;16
18533;"Lazdynų mokykla";Zuikučiai;8899186547;Taip;8;0;0;8
18534;"Lazdynų mokykla";Zuikučiai;5465094647;Taip;3;0;0;3
18535;"Lazdynų mokykla";Zuikučiai;1044630813;Taip;0;2;0;2
18536;"Lazdynų mokykla";Zuikučiai;3268305561;Taip;5;1;7;13
18537;"Lazdynų mokykla";RUPG;8280802645;Ne;6;0;0;6
18538;"Lazdynų mokykla";RUPG;2495494392;Taip;0;22;0;22
18539;"Lazdynų mokykla";RUPG;11571302488;Taip;0;2;0;2
18540;"Lazdynų mokykla";RUPG;83425301719;Taip;9;0;0;9
18541;"Lazdynų mokykla";RUPG;1558843252;Taip;0;0;1;1
18542;"Lazdynų mokykla";RUPG;5286305468;Ne;8;2;0;10
18543;"Lazdynų mokykla";RUPG;7639418071;Ne;11;0;1;12
18544;"Lazdynų mokykla";RUPG;3746366243;Taip;8;0;1;9
18545;"Lazdynų mokykla";RUPG;59028339197;Taip;4;0;1;5
18546;"Lazdynų mokykla";RUPG;13284428796;Taip;0;4;0;4
18547;"Lazdynų mokykla";RUPG;2054450461;Taip;0;0;5;5
18548;"Lazdynų mokykla";RUPG;9380814933;Taip;3;0;6;9
18549;"Lazdynų mokykla";RUPG;1837465174;Taip;0;9;0;9
18550;"Lazdynų mokykla";RUPG;7957072941;Taip;0;0;7;7
18551;"Lazdynų mokykla";RUPG;79937811039;Taip;0;0;2;2
18552;"Lazdynų mokykla";PG;6813765251;Taip;0;12;0;12
18553;"Lazdynų mokykla";PG;6453272974;Taip;0;2;0;2
18554;"Lazdynų mokykla";PG;1602013811;Taip;0;5;0;5
18555;"Lazdynų mokykla";PG;38094866639;Ne;0;0;4;4
18556;"Lazdynų mokykla";PG;58679808617;Ne;0;7;1;8
18557;"Lazdynų mokykla";PG;3349776899;Taip;0;4;0;4
18558;"Lazdynų mokykla";PG;5039060603;Taip;6;0;2;8
18559;"Lazdynų mokykla";PG;5357769446;Taip;0;1;0;1
18560;"Lazdynų mokykla";PG;7276376278;Taip;0;22;0;22
18561;"Lazdynų mokykla";PG;24160611392;Taip;0;6;0;6
18562;"Lazdynų mokykla";PG;62416017620;Taip;0;0;1;1
18563;"Lazdynų mokykla";PG;1224477393;Ne;0;6;0;6
18564;"„Atžalyno” mokykla-darželis";Giliukai;40936892543;Taip;8;0;1;9
18565;"„Atžalyno” mokykla-darželis";Giliukai;28021807339;Taip;0;0;4;4
18566;"„Atžalyno” mokykla-darželis";Giliukai;67652620656;Taip;5;0;1;6
18567;"„Atžalyno” mokykla-darželis";Giliukai;17110908746;Taip;0;0;3;3
18568;"„Atžalyno” mokykla-darželis";Giliukai;1481021352;Taip;18;0;1;19
18569;"„Atžalyno” mokykla-darželis";Giliukai;8495976081;Ne;4;0;6;10
18570;"„Atžalyno” mokykla-darželis";Giliukai;1342370096;Ne;0;0;3;3
18571;"„Atžalyno” mokykla-darželis";Riešutėliai;4784990018;Taip;0;1;0;1
18572;"„Atžalyno” mokykla-darželis";Riešutėliai;4345420422;Taip;13;0;0;13
18573;"„Atžalyno” mokykla-darželis";Riešutėliai;71840666522;Ne;0;1;0;1
18574;"„Atžalyno” mokykla-darželis";Riešutėliai;4290226052;Ne;10;5;7;22
18575;"„Atžalyno” mokykla-darželis";Riešutėliai;5596753512;Ne;0;5;2;7
18576;"„Atžalyno” mokykla-darželis";Riešutėliai;9806203065;Taip;14;2;0;16
18577;"„Atžalyno” mokykla-darželis";Riešutėliai;1151879281;Taip;0;7;0;7
18578;"„Atžalyno” mokykla-darželis";Riešutėliai;3484401937;Ne;0;0;5;5
18579;"„Atžalyno” mokykla-darželis";Riešutėliai;7652421432;Taip;1;0;0;1
18580;"„Atžalyno” mokykla-darželis";Riešutėliai;37897965773;Ne;0;0;1;1
18581;"„Atžalyno” mokykla-darželis";Riešutėliai;9013323901;Taip;0;6;0;6
18582;"„Atžalyno” mokykla-darželis";Riešutėliai;3529875728;Ne;5;0;1;6
18583;"„Atžalyno” mokykla-darželis";Riešutėliai;3770972703;Ne;0;0;1;1
18584;"„Atžalyno” mokykla-darželis";Riešutėliai;3461773781;Taip;0;0;17;17
18585;"„Atžalyno” mokykla-darželis";Riešutėliai;8688627865;Ne;19;0;0;19
18586;"„Atžalyno” mokykla-darželis";Žirniukai;6903825217;Ne;4;1;0;5
18587;"„Atžalyno” mokykla-darželis";Žirniukai;9101301819;Taip;8;2;0;10
18588;"„Atžalyno” mokykla-darželis";Žirniukai;6602037942;Taip;4;0;0;4
18589;"„Atžalyno” mokykla-darželis";Žirniukai;7579781779;Taip;8;0;0;8
18590;"„Atžalyno” mokykla-darželis";Žirniukai;1915676392;Ne;5;0;0;5
18591;"„Atžalyno” mokykla-darželis";Žirniukai;7669725276;Taip;0;11;0;11
18592;"„Atžalyno” mokykla-darželis";Žirniukai;9913048992;Taip;12;2;0;14
18593;"„Atžalyno” mokykla-darželis";Žirniukai;4616870552;Taip;0;0;4;4
18594;"„Atžalyno” mokykla-darželis";Žirniukai;4107946143;Taip;0;5;0;5
18595;"„Atžalyno” mokykla-darželis";Žirniukai;7883570492;Ne;0;3;0;3
18596;"„Atžalyno” mokykla-darželis";Žirniukai;8320161812;Taip;17;0;0;17
18597;"„Atžalyno” mokykla-darželis";Žirniukai;5335059675;Taip;4;1;0;5
18598;"„Atžalyno” mokykla-darželis";Žirniukai;1766599777;Taip;0;2;0;2
18599;"„Atžalyno” mokykla-darželis";Žirniukai;6922776405;Taip;7;0;0;7
18600;"„Atžalyno” mokykla-darželis";Žirniukai;9690554753;Taip;22;0;0;22
18601;"„Atžalyno” mokykla-darželis";Žirniukai;1961428224;Ne;9;0;1;10
18602;"Vilniaus Emilijos Pliaterytės progimnazija";PELĖDŽIUKAI;1475766630;Ne;3;19;0;22
18603;"Vilniaus Emilijos Pliaterytės progimnazija";PELĖDŽIUKAI;6025990670;Taip;0;0;3;3
18604;"Vilniaus Emilijos Pliaterytės progimnazija";PELĖDŽIUKAI;11101488283;Taip;0;0;1;1
18605;"Vilniaus Emilijos Pliaterytės progimnazija";PELĖDŽIUKAI;1551926849;Taip;0;0;9;9
18606;"Vilniaus Emilijos Pliaterytės progimnazija";PELĖDŽIUKAI;9980215936;Ne;0;1;2;3
18607;"Vilniaus Emilijos Pliaterytės progimnazija";PELĖDŽIUKAI;6406833864;Taip;0;5;0;5
18608;"Vilniaus Emilijos Pliaterytės progimnazija";PELĖDŽIUKAI;7540156488;Taip;0;6;0;6
18609;"Vilniaus Emilijos Pliaterytės progimnazija";PELĖDŽIUKAI;4146983741;Taip;0;1;2;3
18610;"Vilniaus Emilijos Pliaterytės progimnazija";PELĖDŽIUKAI;1412529910;Taip;0;1;0;1
18611;"Vilniaus Emilijos Pliaterytės progimnazija";PELĖDŽIUKAI;8202177756;Taip;2;0;0;2
18612;"Vilniaus Emilijos Pliaterytės progimnazija";PELĖDŽIUKAI;96590022188;Taip;0;4;0;4
18613;"Vilniaus Emilijos Pliaterytės progimnazija";PELĖDŽIUKAI;63585262568;Taip;0;0;6;6
18614;"Vilniaus Emilijos Pliaterytės progimnazija";PELĖDŽIUKAI;1653793823;Taip;0;2;0;2
18615;"Vilniaus Emilijos Pliaterytės progimnazija";PELĖDŽIUKAI;1537383115;Taip;5;10;0;15
18616;"Vilniaus Emilijos Pliaterytės progimnazija";BITUTĖS;68989648581;Taip;0;2;19;21
18617;"Vilniaus Emilijos Pliaterytės progimnazija";BITUTĖS;8848135087;Taip;5;0;1;6
18618;"Vilniaus Emilijos Pliaterytės progimnazija";BITUTĖS;18253351529;Taip;6;0;0;6
18619;"Vilniaus Emilijos Pliaterytės progimnazija";BITUTĖS;40082135876;Taip;0;2;3;5
18620;"Vilniaus Emilijos Pliaterytės progimnazija";BITUTĖS;57217727711;Taip;3;4;0;7
18621;"Vilniaus Emilijos Pliaterytės progimnazija";BITUTĖS;57461575212;Taip;0;1;0;1
18622;"Vilniaus Emilijos Pliaterytės progimnazija";BITUTĖS;3419150668;Ne;0;3;0;3
18623;"Vilniaus Emilijos Pliaterytės progimnazija";BITUTĖS;9371122369;Taip;0;0;4;4
18624;"Vilniaus Emilijos Pliaterytės progimnazija";BITUTĖS;4680059512;Taip;0;4;0;4
18625;"Vilniaus Emilijos Pliaterytės progimnazija";BITUTĖS;8303408604;Taip;13;0;7;20
18626;"Vilniaus Emilijos Pliaterytės progimnazija";BITUTĖS;1082350468;Taip;2;0;1;3
18627;"Vilniaus Emilijos Pliaterytės progimnazija";BITUTĖS;3431209621;Ne;0;4;1;5
18628;"Vilniaus Emilijos Pliaterytės progimnazija";BITUTĖS;2519294942;Taip;3;0;1;4
18629;"Vilniaus Emilijos Pliaterytės progimnazija";BITUTĖS;61701898739;Taip;0;0;1;1
18630;"Vilniaus Karaliaus Mindaugo pagrindinė mokykla";"PUG 3";1860540266;Ne;0;0;5;5
18631;"Vilniaus Karaliaus Mindaugo pagrindinė mokykla";"PUG 3";9555191234;Ne;0;0;22;22
18632;"Vilniaus Karaliaus Mindaugo pagrindinė mokykla";"PUG 3";3680257542;Ne;7;0;1;8
18633;"Vilniaus Karaliaus Mindaugo pagrindinė mokykla";"PUG 3";1401502095;Ne;0;0;16;16
18634;"Vilniaus Karaliaus Mindaugo pagrindinė mokykla";"PUG 3";65541524010;Taip;0;0;1;1
18635;"Vilniaus Karaliaus Mindaugo pagrindinė mokykla";"PUG 3";61864833085;Taip;10;0;0;10
18636;"Vilniaus Karaliaus Mindaugo pagrindinė mokykla";"PUG 3";1823039323;Taip;2;0;0;2
18637;"Vilniaus Karaliaus Mindaugo pagrindinė mokykla";"PUG 3";1969208564;Ne;0;0;10;10
18638;"Vilniaus Karaliaus Mindaugo pagrindinė mokykla";"PUG 3";3447871828;Taip;0;0;5;5
18639;"Vilniaus Karaliaus Mindaugo pagrindinė mokykla";"PUG 3";45774870210;Taip;0;5;0;5
18640;"Vilniaus Karaliaus Mindaugo pagrindinė mokykla";"PUG 3";10083948781;Taip;3;1;0;4
18641;"Vilniaus Karaliaus Mindaugo pagrindinė mokykla";"PUG 2";2027114365;Taip;2;0;1;3
18642;"Vilniaus Karaliaus Mindaugo pagrindinė mokykla";"PUG 2";2787942076;Taip;0;0;1;1
18643;"Vilniaus Karaliaus Mindaugo pagrindinė mokykla";"PUG 2";39088931809;Taip;0;0;8;8
18644;"Vilniaus Karaliaus Mindaugo pagrindinė mokykla";"PUG 2";1812197417;Ne;0;0;7;7
18645;"Vilniaus Karaliaus Mindaugo pagrindinė mokykla";"PUG 2";46282997811;Ne;4;0;0;4
18646;"Vilniaus Karaliaus Mindaugo pagrindinė mokykla";"PUG 2";41323355319;Taip;0;0;5;5
18647;"Vilniaus Karaliaus Mindaugo pagrindinė mokykla";"PUG 2";7641286244;Taip;0;0;4;4
18648;"Vilniaus Karaliaus Mindaugo pagrindinė mokykla";"PUG 2";1245722149;Taip;0;0;14;14
18649;"Vilniaus Karaliaus Mindaugo pagrindinė mokykla";"PUG 2";7259413060;Taip;0;22;0;22
18650;"Vilniaus Karaliaus Mindaugo pagrindinė mokykla";"PUG 2";13211267463;Taip;0;0;2;2
18651;"Vilniaus Karaliaus Mindaugo pagrindinė mokykla";"PUG 2";57220861535;Ne;0;10;1;11
18652;"Vilniaus Karaliaus Mindaugo pagrindinė mokykla";"PUG 2";48069555680;Taip;0;0;5;5
18653;"Vilniaus Karaliaus Mindaugo pagrindinė mokykla";"PUG 2";55747365118;Taip;0;0;7;7
18654;"Vilniaus Karaliaus Mindaugo pagrindinė mokykla";"PUG 1";11446344891;Taip;0;0;1;1
18655;"Vilniaus Karaliaus Mindaugo pagrindinė mokykla";"PUG 1";5049742406;Ne;0;0;1;1
18656;"Vilniaus Karaliaus Mindaugo pagrindinė mokykla";"PUG 1";56814748796;Taip;0;6;1;7
18657;"Vilniaus Karaliaus Mindaugo pagrindinė mokykla";"PUG 1";14054918119;Ne;0;22;0;22
18658;"Vilniaus Karaliaus Mindaugo pagrindinė mokykla";"PUG 1";152363521;Taip;0;22;0;22
18659;"Vilniaus Karaliaus Mindaugo pagrindinė mokykla";"PUG 1";18443760034;Taip;0;6;1;7
18660;"Vilniaus Karaliaus Mindaugo pagrindinė mokykla";"PUG 1";61301531283;Taip;8;11;0;19
18661;"Vilniaus Karaliaus Mindaugo pagrindinė mokykla";"PUG 1";5052576808;Taip;0;11;2;13
18662;"Vilniaus Karaliaus Mindaugo pagrindinė mokykla";"PUG 1";8567961973;Taip;0;22;0;22
18663;"Vilniaus Karaliaus Mindaugo pagrindinė mokykla";"PUG 1";3468743460;Taip;0;22;0;22
18664;"Vilniaus Karaliaus Mindaugo pagrindinė mokykla";"PUG 1";1934113564;Ne;0;0;1;1
18665;"Vilniaus Karaliaus Mindaugo pagrindinė mokykla";"PUG 1";1967327730;Taip;0;0;5;5
18666;"Vilniaus Karaliaus Mindaugo pagrindinė mokykla";"PUG 1";1417730062;Taip;0;0;5;5
18667;"Vilniaus Karaliaus Mindaugo pagrindinė mokykla";"PUG 1";7798858993;Taip;0;0;1;1
18668;"Vilniaus Karaliaus Mindaugo pagrindinė mokykla";"PUG 1";2026314698;Taip;0;22;0;22
18669;"Vilniaus Levo Karsavino vidurinė mokykla";"Priešmokyklinukai A";6379177542;Taip;0;1;0;1
18670;"Vilniaus Levo Karsavino vidurinė mokykla";"Priešmokyklinukai A";1840757726;Ne;0;8;0;8
18671;"Vilniaus Levo Karsavino vidurinė mokykla";"Priešmokyklinukai A";36362624522;Taip;11;0;0;11
18672;"Vilniaus Levo Karsavino vidurinė mokykla";"Priešmokyklinukai A";60768660940;Taip;0;3;0;3
18673;"Vilniaus Levo Karsavino vidurinė mokykla";"Priešmokyklinukai A";9756832600;Taip;0;2;0;2
18674;"Vilniaus Levo Karsavino vidurinė mokykla";"Priešmokyklinukai A";6965021762;Taip;0;1;0;1
18675;"Vilniaus Levo Karsavino vidurinė mokykla";"Priešmokyklinukai A";71494345484;Taip;0;1;0;1
18676;"Vilniaus Levo Karsavino vidurinė mokykla";"Priešmokyklinukai A";1035415228;Taip;0;1;0;1
18677;"Vilniaus Levo Karsavino vidurinė mokykla";"Priešmokyklinukai A";26012978171;Taip;0;0;1;1
18678;"Vilniaus Levo Karsavino vidurinė mokykla";"Priešmokyklinukai A";24566804095;Taip;0;14;0;14
18679;"Vilniaus Levo Karsavino vidurinė mokykla";"Priešmokyklinukai A";27116746304;Ne;6;0;0;6
18680;"Vilniaus Levo Karsavino vidurinė mokykla";"Priešmokyklinukai A";86343860903;Taip;0;13;0;13
18681;"Vilniaus Levo Karsavino vidurinė mokykla";"Priešmokyklinukai A";11546608192;Taip;0;0;2;2
18682;"Vilniaus Levo Karsavino vidurinė mokykla";"Priešmokyklinukai A";3847912854;Taip;0;0;3;3
18683;"Vilniaus Levo Karsavino vidurinė mokykla";"Priešmokyklinukai A";1620139958;Taip;0;8;0;8
18684;"Vilniaus Levo Karsavino vidurinė mokykla";"Priešmokyklinukai A";1356029457;Taip;7;0;0;7
18685;"Vilniaus Levo Karsavino vidurinė mokykla";"Priešmokyklinukai A";89044270439;Taip;4;0;0;4
18686;"Vilniaus Levo Karsavino vidurinė mokykla";"Priešmokyklinukai A";27150769109;Taip;4;0;0;4
18687;"Vilniaus Liepkalnio Pagrindinė Mokykla";Bitutės;1181500775;Taip;0;7;0;7
18688;"Vilniaus Liepkalnio Pagrindinė Mokykla";Bitutės;5028304472;Taip;0;7;0;7
18689;"Vilniaus Liepkalnio Pagrindinė Mokykla";Bitutės;3784549444;Ne;8;7;0;15
18690;"Vilniaus Liepkalnio Pagrindinė Mokykla";Bitutės;73391370015;Taip;0;10;1;11
18691;"Vilniaus Liepkalnio Pagrindinė Mokykla";Bitutės;8550048533;Ne;0;7;1;8
18692;"Vilniaus Liepkalnio Pagrindinė Mokykla";Bitutės;1614647892;Taip;0;7;1;8
18693;"Vilniaus Liepkalnio Pagrindinė Mokykla";Bitutės;1886141947;Ne;0;7;1;8
18694;"Vilniaus Liepkalnio Pagrindinė Mokykla";Bitutės;8372336161;Ne;0;7;2;9
18695;"Vilniaus Liepkalnio Pagrindinė Mokykla";Bitutės;1141466643;Ne;0;7;0;7
18696;"Vilniaus Liepkalnio Pagrindinė Mokykla";Bitutės;1500770218;Taip;9;7;0;16
18697;"Vilniaus Liepkalnio Pagrindinė Mokykla";Bitutės;1280722706;Taip;0;7;5;12
18698;"Vilniaus Pranciškaus Skorinos gimnazija";Saulytė;72376520386;Taip;11;0;3;14
18699;"Vilniaus Pranciškaus Skorinos gimnazija";Saulytė;6268191102;Ne;3;0;4;7
18700;"Vilniaus Pranciškaus Skorinos gimnazija";Saulytė;9902282505;Taip;0;3;4;7
18701;"Vilniaus Pranciškaus Skorinos gimnazija";Saulytė;3374669528;Taip;12;0;0;12
18702;"Vilniaus Pranciškaus Skorinos gimnazija";Saulytė;2214122633;Taip;0;14;0;14
18703;"Vilniaus Pranciškaus Skorinos gimnazija";Saulytė;48454225305;Taip;5;0;1;6
18704;"Vilniaus Pranciškaus Skorinos gimnazija";Saulytė;77518622497;Taip;18;0;0;18
18705;"Vilniaus Pranciškaus Skorinos gimnazija";Saulytė;69884900143;Taip;8;0;4;12
18706;"Vilniaus Pranciškaus Skorinos gimnazija";Saulytė;10188975432;Ne;0;3;0;3
18707;"Vilniaus Pranciškaus Skorinos gimnazija";Saulytė;1326855282;Taip;3;0;6;9
18708;"Vilniaus Pranciškaus Skorinos gimnazija";Saulytė;8996622650;Ne;0;4;0;4
18709;"Vilniaus Pranciškaus Skorinos gimnazija";Saulytė;1332354208;Taip;3;1;0;4
18710;"Vilniaus Pranciškaus Skorinos gimnazija";Saulytė;78048289126;Taip;2;0;2;4
18711;"Vilniaus Pranciškaus Skorinos gimnazija";Saulytė;2135571148;Ne;8;2;0;10
18712;"Vilniaus Pranciškaus Skorinos gimnazija";Saulytė;1098174103;Ne;0;6;0;6
18713;"Vilniaus Pranciškaus Skorinos gimnazija";Saulytė;3697024369;Taip;0;0;2;2
18714;"Vilniaus Pranciškaus Skorinos gimnazija";Saulytė;2034261990;Taip;0;2;2;4
18715;"Vilniaus Pranciškaus Skorinos gimnazija";Saulytė;91720422401;Taip;2;0;1;3
18716;"Vilniaus Pranciškaus Skorinos gimnazija";Saulytė;1590889839;Taip;0;19;0;19
18717;"Vilniaus Pranciškaus Skorinos gimnazija";Saulytė;8198614500;Taip;3;0;4;7
18718;"Vilniaus Pranciškaus Skorinos gimnazija";Saulytė;8585340012;Ne;3;12;1;16
18719;"Vilniaus Simono Konarskio mokykla";"1 gr.";51558463647;Taip;2;0;0;2
18720;"Vilniaus Simono Konarskio mokykla";"1 gr.";7559190407;Taip;8;0;0;8
18721;"Vilniaus Simono Konarskio mokykla";"1 gr.";28845494407;Ne;7;0;0;7
18722;"Vilniaus Simono Konarskio mokykla";"1 gr.";2125176999;Ne;7;0;0;7
18723;"Vilniaus Trakų Vokės gimnazija";Priešmokyklinė;37080835526;Taip;0;1;0;1
18724;"Vilniaus Trakų Vokės gimnazija";Priešmokyklinė;49616069190;Taip;4;0;0;4
18725;"Vilniaus Trakų Vokės gimnazija";Priešmokyklinė;76399539244;Ne;0;1;1;2
18726;"Vilniaus Trakų Vokės gimnazija";Priešmokyklinė;9642375918;Taip;0;4;1;5
18727;"Vilniaus Trakų Vokės gimnazija";Priešmokyklinė;1809637955;Taip;0;2;0;2
18728;"Vilniaus Trakų Vokės gimnazija";Priešmokyklinė;43780546254;Taip;0;5;0;5
18729;"Vilniaus Trakų Vokės gimnazija";Priešmokyklinė;1858168427;Ne;0;0;2;2
18730;"Vilniaus Trakų Vokės gimnazija";Priešmokyklinė;39658854196;Taip;0;5;0;5
18731;"Vilniaus Trakų Vokės gimnazija";Priešmokyklinė;32336388708;Taip;0;0;2;2
18732;"Vilniaus Trakų Vokės gimnazija";Priešmokyklinė;1805549433;Taip;0;0;2;2
18733;"Vilniaus Trakų Vokės gimnazija";Priešmokyklinė;1837766168;Taip;0;4;0;4
18734;"Vilniaus Trakų Vokės gimnazija";Priešmokyklinė;66607811394;Taip;0;0;1;1
18735;"Vilniaus Trakų Vokės gimnazija";Priešmokyklinė;2052523633;Taip;3;1;1;5
18736;"Vilniaus Trakų Vokės gimnazija";Priešmokyklinė;95403241312;Taip;10;3;0;13
18737;"Vilniaus Trakų Vokės gimnazija";"Priešmokyklinė 2";28609993291;Taip;7;0;0;7
18738;"Vilniaus Trakų Vokės gimnazija";"Priešmokyklinė 2";2742109510;Ne;0;3;0;3
18739;"Vilniaus Trakų Vokės gimnazija";"Priešmokyklinė 2";4137954109;Taip;0;0;5;5
18740;"Vilniaus Trakų Vokės gimnazija";"Priešmokyklinė 2";76000339425;Ne;0;0;4;4
18741;"Vilniaus Trakų Vokės gimnazija";"Priešmokyklinė 2";4025564140;Ne;0;0;2;2
18742;"Vilniaus Trakų Vokės gimnazija";"Priešmokyklinė 2";7405750799;Ne;0;13;0;13
18743;"Vilniaus Trakų Vokės gimnazija";"Priešmokyklinė 2";9212173480;Taip;4;0;0;4
18744;"Vilniaus Trakų Vokės gimnazija";"Priešmokyklinė 2";29983824202;Taip;0;0;2;2
18745;"Vilniaus Trakų Vokės gimnazija";"Priešmokyklinė 2";39185053006;Ne;0;3;0;3
18746;"Vilniaus Trakų Vokės gimnazija";"Priešmokyklinė 2";6075862061;Taip;0;11;0;11
18747;"Vilniaus Trakų Vokės gimnazija";"Priešmokyklinė 2";1100961040;Taip;0;0;7;7
18748;"Vilniaus Trakų Vokės gimnazija";"Priešmokyklinė 2";1246702054;Taip;0;0;2;2
18749;"Vilniaus Trakų Vokės gimnazija";"Priešmokyklinė 2";1604147234;Taip;7;0;2;9
18750;"Vilniaus Trakų Vokės gimnazija";"Priešmokyklinė 2";2671842885;Taip;0;0;1;1
18751;"Vilniaus Ryto progimnazija";Pelėdžiukai;8927710614;Taip;0;0;2;2
18752;"Vilniaus Ryto progimnazija";Pelėdžiukai;1498045991;Taip;0;2;0;2
18753;"Vilniaus Ryto progimnazija";Pelėdžiukai;5003717844;Taip;0;0;1;1
18754;"Vilniaus Ryto progimnazija";Pelėdžiukai;2033804954;Taip;4;4;0;8
18755;"Vilniaus Ryto progimnazija";Pelėdžiukai;4459592042;Taip;3;0;2;5
18756;"Vilniaus Ryto progimnazija";Pelėdžiukai;53152433196;Taip;0;0;1;1
18757;"Vilniaus Ryto progimnazija";Pelėdžiukai;4334517915;Ne;0;1;0;1
18758;"Vilniaus Ryto progimnazija";Pelėdžiukai;1434737480;Ne;1;0;0;1
18759;"Vilniaus Ryto progimnazija";Pelėdžiukai;1927843089;Taip;14;0;0;14
18760;"Vilniaus Ryto progimnazija";Pelėdžiukai;6707289955;Taip;14;0;0;14
18761;"Vilniaus Ryto progimnazija";Vyturiukai;79094523868;Taip;0;0;1;1
18762;"Vilniaus Ryto progimnazija";Vyturiukai;98670272543;Taip;0;9;0;9
18763;"Vilniaus Ryto progimnazija";Vyturiukai;58253869146;Taip;0;8;0;8
18764;"Vilniaus Ryto progimnazija";Vyturiukai;5202479867;Taip;9;0;0;9
18765;"Vilniaus Ryto progimnazija";Vyturiukai;35463696785;Taip;0;1;0;1
18766;"Vilniaus Ryto progimnazija";Vyturiukai;9651077239;Taip;0;2;0;2
18767;"Vilniaus Ryto progimnazija";Vyturiukai;11940207202;Taip;0;2;0;2
18768;"Vilniaus Ryto progimnazija";Vyturiukai;8782782031;Taip;0;7;0;7
18769;"Vilniaus Ryto progimnazija";Vyturiukai;5157022077;Taip;0;1;0;1
18770;"Vilniaus Ryto progimnazija";Vyturiukai;24547508796;Ne;9;0;0;9
18771;"Vilniaus Ryto progimnazija";Vyturiukai;2877310618;Taip;0;6;0;6
18772;"Vilniaus Salininkų gimnazija";"Priešmokyklinė A";8897523583;Taip;0;7;0;7
18773;"Vilniaus Salininkų gimnazija";"Priešmokyklinė A";1507178637;Taip;0;7;0;7
18774;"Vilniaus Salininkų gimnazija";"Priešmokyklinė A";77477857775;Taip;0;0;1;1
18775;"Vilniaus Salininkų gimnazija";"Priešmokyklinė A";93466518815;Taip;0;5;0;5
18776;"Vilniaus Salininkų gimnazija";"Priešmokyklinė A";86262807558;Taip;3;0;0;3
18777;"Vilniaus Salininkų gimnazija";"Priešmokyklinė A";1614501473;Taip;0;11;0;11
18778;"Vilniaus Salininkų gimnazija";"Priešmokyklinė A";75056599725;Taip;0;16;0;16
18779;"Vilniaus Salininkų gimnazija";"Priešmokyklinė A";72090235276;Taip;0;0;1;1
18780;"Vilniaus Salininkų gimnazija";"PRIEŠMOKYKLINĖ B";87653480003;Taip;7;0;0;7
18781;"Vilniaus Salininkų gimnazija";"PRIEŠMOKYKLINĖ B";2035304515;Ne;0;21;0;21
18782;"Vilniaus Salininkų gimnazija";"PRIEŠMOKYKLINĖ B";1632485114;Taip;0;21;0;21
18783;"Vilniaus Salininkų gimnazija";"PRIEŠMOKYKLINĖ B";1619190849;Taip;16;0;0;16
18784;"Vilniaus Salininkų gimnazija";"PRIEŠMOKYKLINĖ B";5483806059;Taip;0;21;0;21
18785;"Vilniaus Salininkų gimnazija";"PRIEŠMOKYKLINĖ B";6978618796;Taip;8;0;0;8
18786;"Vilniaus Salininkų gimnazija";"PRIEŠMOKYKLINĖ B";61252066272;Ne;0;21;0;21
18787;"Vilniaus Salininkų gimnazija";"PRIEŠMOKYKLINĖ B";9441176013;Taip;0;21;0;21
18788;"Vilniaus Salininkų gimnazija";"PRIEŠMOKYKLINĖ B";16879258172;Ne;0;21;0;21
18789;"Vilniaus Salininkų gimnazija";"PRIEŠMOKYKLINĖ B";88149790626;Taip;1;0;0;1
18790;"Vilniaus Salininkų gimnazija";"PRIEŠMOKYKLINĖ B";2081621978;Taip;0;21;0;21
18791;"Vilniaus Salininkų gimnazija";"PRIEŠMOKYKLINĖ B";2097313917;Taip;2;0;0;2
18792;"Vilniaus Salininkų gimnazija";"PRIEŠMOKYKLINĖ B";56301286871;Ne;0;21;0;21
18793;"Vilniaus Salininkų gimnazija";"PRIEŠMOKYKLINĖ B";8258045565;Taip;9;0;0;9
18794;"Vilniaus Salininkų gimnazija";"PRIEŠMOKYKLINĖ B";10179604964;Taip;6;0;0;6
18795;"Vilniaus „Spindulio“ progimnazija";PM3;22293456491;Taip;0;22;0;22
18796;"Vilniaus „Spindulio“ progimnazija";PM3;90681333497;Taip;0;3;9;12
18797;"Vilniaus „Spindulio“ progimnazija";PM3;77980907763;Taip;0;0;8;8
18798;"Vilniaus „Spindulio“ progimnazija";PM3;43582907178;Ne;0;1;5;6
18799;"Vilniaus „Spindulio“ progimnazija";PM3;3310208029;Taip;0;7;0;7
18800;"Vilniaus „Spindulio“ progimnazija";PM3;88850421821;Taip;0;0;6;6
18801;"Vilniaus „Spindulio“ progimnazija";PM3;83704349624;Ne;0;5;0;5
18802;"Vilniaus „Spindulio“ progimnazija";PM3;51686992586;Taip;10;3;3;16
18803;"Vilniaus „Spindulio“ progimnazija";PM3;4549364929;Taip;0;5;0;5
18804;"Vilniaus „Spindulio“ progimnazija";PM3;4497323553;Taip;0;5;0;5
18805;"Vilniaus „Spindulio“ progimnazija";PM3;96655135353;Taip;0;1;0;1
18806;"Vilniaus „Spindulio“ progimnazija";PM3;1452723869;Ne;0;22;0;22
18807;"Vilniaus „Spindulio“ progimnazija";PM3;1535907893;Ne;0;1;3;4
18808;"Vilniaus „Spindulio“ progimnazija";PM3;1876110301;Taip;7;3;0;10
18809;"Vilniaus „Spindulio“ progimnazija";PM3;1201971467;Taip;0;22;0;22
18810;"Vilniaus „Spindulio“ progimnazija";PM3;2141617594;Taip;0;1;0;1
18811;"Vilniaus „Spindulio“ progimnazija";PM3;9330213866;Taip;2;0;2;4
18812;"Vilniaus „Spindulio“ progimnazija";PM3;11528618044;Taip;0;2;0;2
18813;"Vilniaus „Spindulio“ progimnazija";PM3;65948673886;Taip;11;0;0;11
18814;"Vilniaus „Spindulio“ progimnazija";PM3;33466088300;Ne;5;3;0;8
18815;"Vilniaus „Spindulio“ progimnazija";PM3;8838175732;Taip;0;22;0;22
18816;"Vilniaus „Spindulio“ progimnazija";PM2;24363585231;Taip;11;0;0;11
18817;"Vilniaus „Spindulio“ progimnazija";PM2;46792667256;Taip;0;0;1;1
18818;"Vilniaus „Spindulio“ progimnazija";PM2;1882976317;Taip;0;0;1;1
18819;"Vilniaus „Spindulio“ progimnazija";PM2;30064453011;Ne;0;1;1;2
18820;"Vilniaus „Spindulio“ progimnazija";PM2;37530814188;Taip;5;0;0;5
18821;"Vilniaus „Spindulio“ progimnazija";PM2;94392092103;Ne;0;0;3;3
18822;"Vilniaus „Spindulio“ progimnazija";PM2;8335398345;Taip;9;0;0;9
18823;"Vilniaus „Spindulio“ progimnazija";PM2;1119763619;Taip;9;1;2;12
18824;"Vilniaus „Spindulio“ progimnazija";PM2;1275460051;Taip;11;0;0;11
18825;"Vilniaus „Spindulio“ progimnazija";PM2;51442842468;Taip;7;0;0;7
18826;"Vilniaus „Spindulio“ progimnazija";PM2;89455376961;Taip;0;14;0;14
18827;"Vilniaus „Spindulio“ progimnazija";PM2;8096536272;Ne;6;0;0;6
18828;"Vilniaus „Spindulio“ progimnazija";PM2;1382754985;Taip;2;1;0;3
18829;"Vilniaus „Spindulio“ progimnazija";PM2;38262299304;Taip;0;1;0;1
18830;"Vilniaus „Spindulio“ progimnazija";PM2;4402050671;Taip;0;5;0;5
18831;"Vilniaus „Spindulio“ progimnazija";PM2;98839852579;Taip;0;1;0;1
18832;"Vilniaus „Spindulio“ progimnazija";PM2;96133788423;Taip;7;1;0;8
18833;"Vilniaus „Spindulio“ progimnazija";PM1;71828460624;Taip;0;0;5;5
18834;"Vilniaus „Spindulio“ progimnazija";PM1;1435104895;Taip;0;0;1;1
18835;"Vilniaus „Spindulio“ progimnazija";PM1;1963422247;Taip;0;0;1;1
18836;"Vilniaus „Spindulio“ progimnazija";PM1;26554152266;Taip;0;0;6;6
18837;"Vilniaus „Spindulio“ progimnazija";PM1;1101237825;Taip;0;0;6;6
18838;"Vilniaus „Spindulio“ progimnazija";PM1;2960662435;Taip;13;0;2;15
18839;"Vilniaus „Spindulio“ progimnazija";PM1;8461648619;Taip;0;22;0;22
18840;"Vilniaus „Spindulio“ progimnazija";PM1;29959372638;Taip;0;0;1;1
18841;"Vilniaus „Spindulio“ progimnazija";PM1;82936702613;Taip;0;0;1;1
18842;"Vilniaus „Spindulio“ progimnazija";PM1;42543506690;Ne;1;0;1;2
18843;"Vilniaus „Spindulio“ progimnazija";PM1;47377556072;Taip;0;0;1;1
18844;"Vilniaus „Spindulio“ progimnazija";PM1;6460911796;Taip;9;5;0;14
18845;"Vilniaus „Spindulio“ progimnazija";PM1;54282609151;Taip;8;0;0;8
18846;"Vilniaus Vladislavo Sirokomlės gimnazija";Nykštukai;3757723755;Taip;0;22;0;22
18847;"Vilniaus Vladislavo Sirokomlės gimnazija";Nykštukai;6973757062;Taip;0;3;0;3
18848;"Vilniaus Vladislavo Sirokomlės gimnazija";Nykštukai;67365224459;Ne;0;3;2;5
18849;"Vilniaus Vladislavo Sirokomlės gimnazija";Nykštukai;1182643102;Ne;7;1;0;8
18850;"Vilniaus Vladislavo Sirokomlės gimnazija";Nykštukai;6027613840;Taip;5;2;0;7
18851;"Vilniaus Vladislavo Sirokomlės gimnazija";Nykštukai;7921336790;Taip;0;3;0;3
18852;"Vilniaus Vladislavo Sirokomlės gimnazija";Nykštukai;93097026538;Taip;0;2;0;2
18853;"Vilniaus Vladislavo Sirokomlės gimnazija";Nykštukai;87849011303;Taip;0;3;2;5
18854;"Vilniaus Vladislavo Sirokomlės gimnazija";Nykštukai;80664259551;Taip;0;3;2;5
18855;"Vilniaus Vladislavo Sirokomlės gimnazija";Nykštukai;19918665437;Taip;4;2;0;6
18856;"Vilniaus Vladislavo Sirokomlės gimnazija";Nykštukai;1755934341;Taip;0;22;0;22
18857;"Vilniaus Vladislavo Sirokomlės gimnazija";Nykštukai;8471020975;Taip;5;3;6;14
18858;"Vilniaus Vladislavo Sirokomlės gimnazija";Nykštukai;9715654332;Taip;0;9;2;11
18859;"Vilniaus Vladislavo Sirokomlės gimnazija";Nykštukai;67716590566;Taip;0;2;0;2
18860;"Vilniaus Vladislavo Sirokomlės gimnazija";Nykštukai;68958022216;Ne;0;22;0;22
18861;"Vilniaus Vladislavo Sirokomlės gimnazija";Smurfai;91568484446;Taip;0;7;0;7
18862;"Vilniaus Vladislavo Sirokomlės gimnazija";Smurfai;1277422207;Taip;0;7;0;7
18863;"Vilniaus Vladislavo Sirokomlės gimnazija";Smurfai;18847368957;Taip;0;2;0;2
18864;"Vilniaus Vladislavo Sirokomlės gimnazija";Smurfai;1824370122;Taip;0;7;0;7
18865;"Vilniaus Vladislavo Sirokomlės gimnazija";Smurfai;8377601628;Ne;0;2;0;2
18866;"Vilniaus Vladislavo Sirokomlės gimnazija";Smurfai;1292350264;Taip;9;2;0;11
18867;"Vilniaus Vladislavo Sirokomlės gimnazija";Smurfai;4727762605;Taip;0;5;0;5
18868;"Vilniaus Vladislavo Sirokomlės gimnazija";Smurfai;93964052608;Ne;0;14;0;14
18869;"Vilniaus Vladislavo Sirokomlės gimnazija";Smurfai;1775227032;Taip;6;4;0;10
18870;"Vilniaus Vladislavo Sirokomlės gimnazija";Smurfai;18652266729;Ne;0;3;0;3
18871;"Vilniaus Vladislavo Sirokomlės gimnazija";Smurfai;1380861719;Taip;0;2;0;2
18872;"Vilniaus „Pelėdos” pradinė mokykla";Bitutės;72626222053;Ne;14;0;0;14
18873;"Vilniaus „Pelėdos” pradinė mokykla";Bitutės;1962802968;Taip;0;0;4;4
18874;"Vilniaus „Pelėdos” pradinė mokykla";Bitutės;70334519732;Taip;0;0;1;1
18875;"Vilniaus „Pelėdos” pradinė mokykla";Bitutės;31817312555;Taip;8;0;4;12
18876;"Vilniaus „Pelėdos” pradinė mokykla";Bitutės;55808304356;Taip;0;0;1;1
18877;"Vilniaus „Pelėdos” pradinė mokykla";Bitutės;42486181827;Taip;5;0;4;9
18878;"Vilniaus „Pelėdos” pradinė mokykla";Bitutės;86774266699;Taip;5;0;1;6
18879;"Vilniaus „Pelėdos” pradinė mokykla";Bitutės;1846303993;Taip;0;0;3;3
18880;"Vilniaus „Pelėdos” pradinė mokykla";Bitutės;46373287636;Taip;20;0;0;20
18881;"Vilniaus „Pelėdos” pradinė mokykla";Bitutės;23762150256;Taip;0;0;2;2
18882;"Vilniaus „Pelėdos” pradinė mokykla";Bitutės;72517122863;Taip;9;0;0;9
18883;"Vilniaus „Pelėdos” pradinė mokykla";Bitutės;53571863888;Taip;3;0;5;8
18884;"Vilniaus „Pelėdos” pradinė mokykla";Bitutės;45490599266;Taip;1;0;9;10
18885;"Vilniaus „Pelėdos” pradinė mokykla";Bitutės;42959183109;Taip;0;0;6;6
18886;"Vilniaus „Pelėdos” pradinė mokykla";Bitutės;21904117684;Taip;10;0;0;10
18887;"Vilniaus „Pelėdos” pradinė mokykla";Bitutės;94562009887;Taip;0;0;1;1
18888;"Vilniaus „Pelėdos” pradinė mokykla";Bitutės;76659578448;Taip;0;0;3;3
18889;"Vilniaus „Pelėdos” pradinė mokykla";Bitutės;1206482166;Taip;8;0;7;15
18890;"Vilniaus „Pelėdos” pradinė mokykla";Bitutės;1655237708;Ne;0;0;4;4
18891;"Vilniaus „Pelėdos” pradinė mokykla";Boružėlės;60187200;Taip;0;0;2;2
18892;"Vilniaus „Pelėdos” pradinė mokykla";Boružėlės;1022310072;Taip;0;0;2;2
18893;"Vilniaus „Pelėdos” pradinė mokykla";Boružėlės;42308434800;Taip;0;0;2;2
18894;"Vilniaus „Pelėdos” pradinė mokykla";Boružėlės;1557388485;Taip;6;0;0;6
18895;"Vilniaus „Pelėdos” pradinė mokykla";Boružėlės;10573989701;Taip;8;0;0;8
18896;"Vilniaus „Pelėdos” pradinė mokykla";Boružėlės;4946448574;Taip;7;0;0;7
18897;"Vilniaus „Pelėdos” pradinė mokykla";Boružėlės;11824002845;Ne;0;0;1;1
18898;"Vilniaus „Pelėdos” pradinė mokykla";Boružėlės;1266695122;Ne;0;0;3;3
18899;"Vilniaus „Pelėdos” pradinė mokykla";Boružėlės;33481357566;Taip;5;0;1;6
18900;"Vilniaus „Pelėdos” pradinė mokykla";Boružėlės;51111749099;Taip;6;0;1;7
18901;"Vilniaus „Pelėdos” pradinė mokykla";Boružėlės;74887990218;Taip;13;0;0;13
18902;"Vilniaus „Pelėdos” pradinė mokykla";Boružėlės;67436657541;Taip;4;0;0;4
18903;"Vilniaus „Pelėdos” pradinė mokykla";Boružėlės;89566764594;Taip;3;0;2;5
18904;"Vilniaus „Pelėdos” pradinė mokykla";Boružėlės;29009575642;Taip;1;0;0;1
18905;"Vilniaus „Pelėdos” pradinė mokykla";Boružėlės;29696816177;Taip;0;0;1;1
18906;"Vilniaus „Pelėdos” pradinė mokykla";Boružėlės;38087400506;Taip;5;0;0;5
18907;"Vilniaus „Pelėdos” pradinė mokykla";Boružėlės;41914970891;Taip;0;0;1;1
18908;"Vilniaus „Pelėdos” pradinė mokykla";Boružėlės;20865224818;Ne;4;0;0;4
18909;"Vilniaus „Pelėdos” pradinė mokykla";Boružėlės;91433727359;Taip;5;0;1;6
18910;"Vilniaus „Pelėdos” pradinė mokykla";Boružėlės;1378219785;Taip;0;0;2;2
18911;"Vilniaus „Pelėdos” pradinė mokykla";Boružėlės;6961211392;Taip;0;0;1;1
18912;"Vilniaus Joachimo Lelevelio inžinerijos mokykla";0A;2854451964;Taip;0;5;0;5
18913;"Vilniaus Joachimo Lelevelio inžinerijos mokykla";0A;6406533101;Taip;0;3;0;3
18914;"Vilniaus Joachimo Lelevelio inžinerijos mokykla";0A;3842907348;Taip;0;14;0;14
18915;"Vilniaus Joachimo Lelevelio inžinerijos mokykla";0A;28504617099;Taip;0;22;0;22
18916;"Vilniaus Joachimo Lelevelio inžinerijos mokykla";0A;4513335615;Taip;10;1;0;11
18917;"Vilniaus Joachimo Lelevelio inžinerijos mokykla";0A;4250816034;Taip;0;5;0;5
18918;"Vilniaus Joachimo Lelevelio inžinerijos mokykla";0A;1771141306;Taip;0;10;0;10
18919;"Vilniaus Joachimo Lelevelio inžinerijos mokykla";0A;7557437205;Taip;0;0;7;7
18920;"Vilniaus Joachimo Lelevelio inžinerijos mokykla";0A;2062489205;Taip;0;1;0;1
18921;"Vilniaus Joachimo Lelevelio inžinerijos mokykla";0A;52212151760;Taip;6;0;1;7
18922;"Vilniaus Joachimo Lelevelio inžinerijos mokykla";0A;98526928421;Taip;0;0;2;2
18923;"Vilniaus Joachimo Lelevelio inžinerijos mokykla";0A;18542160352;Taip;0;2;0;2
18924;"Vilniaus Joachimo Lelevelio inžinerijos mokykla";0A;1701035826;Ne;0;0;3;3
18925;"Vilniaus Joachimo Lelevelio inžinerijos mokykla";0A;2059267616;Taip;1;0;0;1
18926;"Vilniaus Joachimo Lelevelio inžinerijos mokykla";0B;7498447014;Ne;0;22;0;22
18927;"Vilniaus Joachimo Lelevelio inžinerijos mokykla";0B;12358360731;Taip;0;1;0;1
18928;"Vilniaus Joachimo Lelevelio inžinerijos mokykla";0B;1294879767;Taip;0;4;0;4
18929;"Vilniaus Joachimo Lelevelio inžinerijos mokykla";0B;13127077816;Taip;0;22;0;22
18930;"Vilniaus Joachimo Lelevelio inžinerijos mokykla";0B;5734485363;Ne;0;1;3;4
18931;"Vilniaus Joachimo Lelevelio inžinerijos mokykla";0B;97106889191;Taip;0;22;0;22
18932;"Vilniaus Joachimo Lelevelio inžinerijos mokykla";0B;1400614987;Taip;0;3;0;3
18933;"Vilniaus Joachimo Lelevelio inžinerijos mokykla";0B;5826045578;Ne;13;1;1;15
18934;"Vilniaus Joachimo Lelevelio inžinerijos mokykla";0B;94748215851;Ne;0;1;1;2
18935;"Vilniaus Joachimo Lelevelio inžinerijos mokykla";0B;65825430797;Taip;0;1;1;2
18936;"Vilniaus Joachimo Lelevelio inžinerijos mokykla";0B;4537724747;Ne;0;1;6;7
18937;"Vilniaus Joachimo Lelevelio inžinerijos mokykla";0B;84799078638;Ne;5;0;0;5
18938;"Vilniaus Joachimo Lelevelio inžinerijos mokykla";0C;77834846979;Taip;0;22;0;22
18939;"Vilniaus Joachimo Lelevelio inžinerijos mokykla";0C;7474239709;Taip;0;22;0;22
18940;"Vilniaus Joachimo Lelevelio inžinerijos mokykla";0C;4298878720;Ne;0;22;0;22
18941;"Vilniaus Joachimo Lelevelio inžinerijos mokykla";0C;2066262598;Ne;1;2;0;3
18942;"Vilniaus Joachimo Lelevelio inžinerijos mokykla";0C;6729635545;Taip;0;4;0;4
18943;"Vilniaus Joachimo Lelevelio inžinerijos mokykla";0C;47825918748;Taip;3;8;0;11
18944;"Vilniaus Joachimo Lelevelio inžinerijos mokykla";0C;74314676598;Taip;1;1;1;3
18945;"Vilniaus Joachimo Lelevelio inžinerijos mokykla";0C;1634442815;Taip;0;6;0;6
18946;"Vilniaus Joachimo Lelevelio inžinerijos mokykla";0C;8552721960;Taip;0;2;3;5
18947;"Vilniaus Juzefo Ignacijaus Kraševskio gimnazija";Priešmokyklinė;3992602769;Ne;0;3;2;5
18948;"Vilniaus Juzefo Ignacijaus Kraševskio gimnazija";Priešmokyklinė;96528175390;Taip;9;0;1;10
18949;"Vilniaus Juzefo Ignacijaus Kraševskio gimnazija";Priešmokyklinė;7947779677;Taip;6;0;3;9
18950;"Vilniaus Juzefo Ignacijaus Kraševskio gimnazija";Priešmokyklinė;45246620717;Taip;0;6;0;6
18951;"Vilniaus Juzefo Ignacijaus Kraševskio gimnazija";Priešmokyklinė;9640287886;Ne;8;0;4;12
18952;"Vilniaus Juzefo Ignacijaus Kraševskio gimnazija";Priešmokyklinė;67676283920;Taip;0;1;0;1
18953;"Vilniaus Juzefo Ignacijaus Kraševskio gimnazija";Priešmokyklinė;85741340293;Taip;0;0;1;1
18954;"Vilniaus Juzefo Ignacijaus Kraševskio gimnazija";Priešmokyklinė;3041637447;Taip;9;1;0;10
18955;"Vilniaus Juzefo Ignacijaus Kraševskio gimnazija";Priešmokyklinė;52109524827;Ne;0;0;7;7
18956;"Vilniaus Juzefo Ignacijaus Kraševskio gimnazija";Priešmokyklinė;42562816168;Ne;0;0;3;3
18957;"Vilniaus Juzefo Ignacijaus Kraševskio gimnazija";Priešmokyklinė;4917899323;Taip;0;4;1;5
18958;"Vilniaus Juzefo Ignacijaus Kraševskio gimnazija";Priešmokyklinė;1963122314;Taip;0;9;4;13
18959;"Vilniaus Juzefo Ignacijaus Kraševskio gimnazija";Priešmokyklinė;9167719015;Ne;6;6;1;13
18960;"Vilniaus Juzefo Ignacijaus Kraševskio gimnazija";Priešmokyklinė;6560740320;Taip;0;5;0;5
18961;"Vilniaus Juzefo Ignacijaus Kraševskio gimnazija";Priešmokyklinė;6224053661;Taip;0;9;4;13
18962;"Vilniaus Juzefo Ignacijaus Kraševskio gimnazija";Priešmokyklinė;6879140016;Taip;0;21;0;21
18963;"Vilniaus Juzefo Ignacijaus Kraševskio gimnazija";Priešmokyklinė;3738703854;Taip;0;3;0;3
18964;"Vilniaus Juzefo Ignacijaus Kraševskio gimnazija";Priešmokyklinė;1812071213;Taip;0;1;3;4
18965;"Vilniaus Jono Pauliaus II progimnazija";Nykštukai;33235320630;Taip;0;22;0;22
18966;"Vilniaus Jono Pauliaus II progimnazija";Nykštukai;62887824954;Taip;4;4;0;8
18967;"Vilniaus Jono Pauliaus II progimnazija";Nykštukai;33266635443;Taip;4;7;0;11
18968;"Vilniaus Jono Pauliaus II progimnazija";Nykštukai;21391476676;Ne;0;4;0;4
18969;"Vilniaus Jono Pauliaus II progimnazija";Nykštukai;9286664165;Ne;0;4;0;4
18970;"Vilniaus Jono Pauliaus II progimnazija";Nykštukai;2441033469;Ne;0;6;0;6
18971;"Vilniaus Jono Pauliaus II progimnazija";Nykštukai;69740475863;Ne;2;4;0;6
18972;"Vilniaus Jono Pauliaus II progimnazija";Nykštukai;9711206546;Taip;5;5;0;10
18973;"Vilniaus Jono Pauliaus II progimnazija";Nykštukai;63900641942;Taip;0;7;0;7
18974;"Vilniaus Jono Pauliaus II progimnazija";Nykštukai;72881976363;Taip;0;7;0;7
18975;"Vilniaus Jono Pauliaus II progimnazija";Nykštukai;1448250372;Taip;0;6;0;6
18976;"Vilniaus Jono Pauliaus II progimnazija";Nykštukai;1974161463;Taip;5;4;0;9
18977;"Vilniaus Jono Pauliaus II progimnazija";Nykštukai;6069988171;Taip;4;4;0;8
18978;"Vilniaus Jono Pauliaus II progimnazija";Nykštukai;69919525470;Taip;0;22;0;22
18979;"Vilniaus Jono Pauliaus II progimnazija";Nykštukai;12487059850;Taip;0;4;0;4
18980;"Vilniaus Jono Pauliaus II progimnazija";Nykštukai;47716333909;Taip;0;5;0;5
18981;"Vilniaus Jono Pauliaus II progimnazija";Nykštukai;62372417041;Taip;0;4;2;6
18982;"Vilniaus Jono Pauliaus II progimnazija";Nykštukai;43690245314;Taip;8;4;0;12
18983;"Vilniaus Jono Pauliaus II progimnazija";Nykštukai;2030227606;Taip;0;4;0;4
18984;"Vilniaus Jono Pauliaus II progimnazija";Nykštukai;1623576857;Taip;0;5;0;5
18985;"Vilniaus Jono Pauliaus II progimnazija";Nykštukai;29087363179;Taip;0;4;0;4
18986;"Vilniaus Jono Pauliaus II progimnazija";Nykštukai;40427909744;Taip;0;6;0;6
18987;"Vilniaus Jono Pauliaus II progimnazija";Nykštukai;86192743256;Taip;0;4;0;4
18988;"Vilniaus Jono Pauliaus II progimnazija";Žiniukai;1911748280;Taip;0;3;0;3
18989;"Vilniaus Jono Pauliaus II progimnazija";Žiniukai;5306416511;Ne;0;6;0;6
18990;"Vilniaus Jono Pauliaus II progimnazija";Žiniukai;84947394033;Taip;4;4;1;9
18991;"Vilniaus Jono Pauliaus II progimnazija";Žiniukai;1148796296;Taip;4;5;0;9
18992;"Vilniaus Jono Pauliaus II progimnazija";Žiniukai;66327590524;Taip;0;5;0;5
18993;"Vilniaus Jono Pauliaus II progimnazija";Žiniukai;71909273139;Taip;0;5;0;5
18994;"Vilniaus Jono Pauliaus II progimnazija";Žiniukai;9949006053;Taip;0;15;4;19
18995;"Vilniaus Jono Pauliaus II progimnazija";Žiniukai;9000145666;Taip;0;22;0;22
18996;"Vilniaus Jono Pauliaus II progimnazija";Žiniukai;8259564583;Taip;0;4;3;7
18997;"Vilniaus Jono Pauliaus II progimnazija";Žiniukai;5323116194;Taip;0;5;0;5
18998;"Vilniaus Jono Pauliaus II progimnazija";Žiniukai;15597884044;Taip;0;4;0;4
18999;"Vilniaus Jono Pauliaus II progimnazija";Žiniukai;21795184411;Taip;0;8;0;8
19000;"Vilniaus Jono Pauliaus II progimnazija";Žiniukai;90741594830;Taip;0;4;1;5
19001;"Vilniaus Jono Pauliaus II progimnazija";Žiniukai;92871710315;Taip;0;4;0;4
19002;"Vilniaus Jono Pauliaus II progimnazija";Žiniukai;66338689682;Taip;0;8;0;8
19003;"Vilniaus Jono Pauliaus II progimnazija";Žiniukai;40117721972;Taip;8;4;0;12
19004;"Vilniaus Jono Pauliaus II progimnazija";Žiniukai;56656769188;Taip;0;6;1;7
19005;"Vilniaus Jono Pauliaus II progimnazija";Žiniukai;9962282406;Taip;0;4;0;4
19006;"Vilniaus Jono Pauliaus II progimnazija";Žiniukai;1000417905;Taip;8;7;0;15
19007;"Vilniaus Jono Pauliaus II progimnazija";Žiniukai;2132492766;Taip;0;4;0;4
19008;"Vilniaus Jono Pauliaus II progimnazija";Žiniukai;52202199212;Taip;0;4;0;4
19009;"Vilniaus Jono Pauliaus II progimnazija";Žiniukai;64337451741;Taip;0;6;1;7
19010;"Vilniaus Jono Pauliaus II progimnazija";Spindulėlis;6312963672;Taip;0;22;0;22
19011;"Vilniaus Jono Pauliaus II progimnazija";Spindulėlis;73847154996;Taip;0;4;0;4
19012;"Vilniaus Jono Pauliaus II progimnazija";Spindulėlis;38517844902;Taip;0;4;0;4
19013;"Vilniaus Jono Pauliaus II progimnazija";Spindulėlis;14754302946;Ne;0;22;0;22
19014;"Vilniaus Jono Pauliaus II progimnazija";Spindulėlis;1053502203;Ne;0;22;0;22
19015;"Vilniaus Jono Pauliaus II progimnazija";Spindulėlis;53090437775;Taip;0;4;1;5
19016;"Vilniaus Jono Pauliaus II progimnazija";Spindulėlis;82679341920;Ne;0;4;0;4
19017;"Vilniaus Jono Pauliaus II progimnazija";Spindulėlis;99037281876;Taip;0;4;0;4
19018;"Vilniaus Jono Pauliaus II progimnazija";Spindulėlis;78465993753;Ne;7;3;0;10
19019;"Vilniaus Jono Pauliaus II progimnazija";Spindulėlis;92991242443;Taip;0;4;0;4
19020;"Vilniaus Jono Pauliaus II progimnazija";Spindulėlis;85352317063;Taip;0;5;0;5
19021;"Vilniaus Jono Pauliaus II progimnazija";Spindulėlis;7126070419;Ne;0;5;0;5
19022;"Vilniaus Jono Pauliaus II progimnazija";Spindulėlis;1481976292;Taip;0;4;0;4
19023;"Vilniaus Jono Pauliaus II progimnazija";Spindulėlis;68841073274;Taip;0;7;0;7
19024;"Vilniaus Jono Pauliaus II progimnazija";Spindulėlis;9989277772;Taip;0;5;0;5
19025;"Vilniaus Jono Pauliaus II progimnazija";Spindulėlis;9275686861;Ne;11;5;0;16
19026;"Vilniaus Jono Pauliaus II progimnazija";Spindulėlis;17472648959;Taip;0;4;0;4
19027;"Vilniaus Jono Pauliaus II progimnazija";Spindulėlis;2957745091;Taip;0;4;0;4
19028;"Vilniaus Jono Pauliaus II progimnazija";Spindulėlis;4502784565;Ne;0;3;0;3
19029;"Vilniaus Jono Pauliaus II progimnazija";Spindulėlis;4113350416;Taip;16;3;0;19
19030;"Vilniaus Jono Pauliaus II progimnazija";Spindulėlis;2939189437;Ne;0;6;2;8
19031;"Vilniaus Jono Pauliaus II progimnazija";Spindulėlis;1573790467;Taip;0;6;1;7
19032;"Vilniaus Senamiesčio vidurinė mokykla";PG1;3511904436;Taip;5;7;0;12
19033;"Vilniaus Senamiesčio vidurinė mokykla";PG1;87869418489;Ne;0;5;2;7
19034;"Vilniaus Senamiesčio vidurinė mokykla";PG1;1905141424;Taip;0;5;3;8
19035;"Vilniaus Senamiesčio vidurinė mokykla";PG1;9906690140;Taip;0;5;4;9
19036;"Vilniaus Senamiesčio vidurinė mokykla";PG1;1984531468;Taip;0;6;0;6
19037;"Vilniaus Senamiesčio vidurinė mokykla";PG1;78593862724;Taip;0;5;3;8
19038;"Vilniaus Senamiesčio vidurinė mokykla";PG1;91834332717;Taip;0;6;0;6
19039;"Vilniaus Senamiesčio vidurinė mokykla";PG1;1882022060;Ne;0;5;2;7
19040;"Vilniaus Senamiesčio vidurinė mokykla";PG1;47953806522;Taip;0;5;0;5
19041;"Vilniaus Senamiesčio vidurinė mokykla";PG1;5536467023;Ne;0;5;0;5
19042;"Vilniaus Senamiesčio vidurinė mokykla";PG1;5721777059;Ne;0;5;0;5
19043;"Vilniaus Senamiesčio vidurinė mokykla";PG1;2864419137;Taip;0;14;0;14
19044;"Vilniaus Senamiesčio vidurinė mokykla";PG1;2764636358;Taip;0;21;0;21
19045;"Vilniaus Senamiesčio vidurinė mokykla";PG1;1369622524;Taip;0;21;0;21
19046;"Vilniaus Senamiesčio vidurinė mokykla";PG1;8449484660;Taip;0;5;3;8
19047;"Vilniaus Senamiesčio vidurinė mokykla";PG1;2094485999;Taip;0;5;4;9
19048;"Vilniaus Senamiesčio vidurinė mokykla";PG1;1813072867;Taip;0;6;0;6
19049;"Vilniaus Senamiesčio vidurinė mokykla";PG1;7764171885;Taip;12;5;0;17
19050;Gluosnis;KIŠKUČIAI;4591550636;Taip;4;6;3;13
19051;Gluosnis;KIŠKUČIAI;2984134115;Taip;0;0;2;2
19052;Gluosnis;KIŠKUČIAI;6955695422;Taip;7;1;0;8
19053;Gluosnis;KIŠKUČIAI;6140294839;Taip;19;0;0;19
19054;Gluosnis;KIŠKUČIAI;1305651237;Taip;8;0;0;8
19055;Gluosnis;KIŠKUČIAI;1341265560;Taip;0;13;9;22
19056;Gluosnis;KIŠKUČIAI;4285562600;Taip;4;11;1;16
19057;Gluosnis;KIŠKUČIAI;5432102004;Taip;1;0;1;2
19058;Gluosnis;KIŠKUČIAI;8009719622;Ne;4;0;1;5
19059;Gluosnis;KIŠKUČIAI;9833971809;Ne;13;0;0;13
19060;Gluosnis;KIŠKUČIAI;6883663577;Ne;19;0;0;19
19061;Gluosnis;KIŠKUČIAI;1512855055;Taip;5;3;2;10
19062;Gluosnis;KIŠKUČIAI;8337313448;Taip;0;0;17;17
19063;Gluosnis;KIŠKUČIAI;4632419177;Ne;7;0;4;11
19064;Gluosnis;EŽIUKAI;6113153127;Taip;2;0;3;5
19065;Gluosnis;EŽIUKAI;4153713911;Taip;6;0;0;6
19066;Gluosnis;EŽIUKAI;7073637619;Taip;0;0;2;2
19067;Gluosnis;EŽIUKAI;4493877427;Taip;4;0;0;4
19068;Gluosnis;EŽIUKAI;6612468095;Taip;15;0;0;15
19069;Gluosnis;EŽIUKAI;3323237449;Ne;4;5;0;9
19070;Gluosnis;EŽIUKAI;7769522093;Taip;10;0;0;10
19071;Gluosnis;EŽIUKAI;8928597187;Taip;0;0;15;15
19072;Gluosnis;EŽIUKAI;9993638596;Taip;5;0;0;5
19073;Gluosnis;EŽIUKAI;4107344313;Taip;0;7;0;7
19074;Gluosnis;EŽIUKAI;1101472999;Taip;0;8;0;8
19075;Gluosnis;EŽIUKAI;9888037899;Taip;8;0;1;9
19076;Gluosnis;EŽIUKAI;3273127718;Taip;13;0;3;16
19077;Gluosnis;EŽIUKAI;1301904113;Taip;0;1;0;1
19078;Gluosnis;EŽIUKAI;6994005000;Taip;0;0;1;1
19079;Gluosnis;MEŠKIUKAI;4022182529;Taip;14;0;8;22
19080;Gluosnis;MEŠKIUKAI;8981904827;Taip;9;0;0;9
19081;Gluosnis;MEŠKIUKAI;8998776286;Taip;0;8;0;8
19082;Gluosnis;MEŠKIUKAI;1846499141;Taip;16;0;2;18
19083;Gluosnis;MEŠKIUKAI;7935750427;Taip;8;0;0;8
19084;Gluosnis;MEŠKIUKAI;9201769624;Taip;0;0;3;3
19085;Gluosnis;MEŠKIUKAI;9102081648;Taip;12;5;1;18
19086;Gluosnis;MEŠKIUKAI;4498429439;Taip;13;0;0;13
19087;Gluosnis;MEŠKIUKAI;6067801976;Taip;5;3;7;15
19088;Gluosnis;MEŠKIUKAI;8259160584;Ne;3;0;0;3
19089;Gluosnis;MEŠKIUKAI;1235091885;Taip;14;7;1;22
19090;Gluosnis;MEŠKIUKAI;1165636758;Taip;0;0;1;1
19091;Gluosnis;MEŠKIUKAI;8499748544;Taip;5;0;2;7
19092;Gluosnis;MEŠKIUKAI;9699577397;Taip;13;0;0;13
19093;Gluosnis;MEŠKIUKAI;1712795835;Taip;9;0;0;9
19094;Gluosnis;BORUŽĖLĖS;8840658383;Taip;0;2;1;3
19095;Gluosnis;BORUŽĖLĖS;2167312808;Taip;8;0;0;8
19096;Gluosnis;BORUŽĖLĖS;4204797742;Ne;0;5;0;5
19097;Gluosnis;BORUŽĖLĖS;6302765948;Taip;2;0;4;6
19098;Gluosnis;BORUŽĖLĖS;9938235476;Taip;12;1;0;13
19099;Gluosnis;BORUŽĖLĖS;2945796648;Taip;0;8;0;8
19100;Gluosnis;BORUŽĖLĖS;2173191971;Taip;6;3;2;11
19101;Gluosnis;BORUŽĖLĖS;4237053702;Taip;4;10;3;17
19102;Gluosnis;BORUŽĖLĖS;6320411660;Ne;0;10;0;10
19103;Gluosnis;BORUŽĖLĖS;7731887361;Taip;0;0;4;4
19104;Gluosnis;BORUŽĖLĖS;8502947568;Taip;0;1;0;1
19105;Gluosnis;BORUŽĖLĖS;9664090375;Taip;5;0;0;5
19106;Gluosnis;BORUŽĖLĖS;1335152703;Taip;5;6;0;11
19107;Gluosnis;BORUŽĖLĖS;1314992969;Taip;6;6;0;12
19108;Gluosnis;BORUŽĖLĖS;7833136455;Ne;7;0;1;8
19109;Gluosnis;BORUŽĖLĖS;5556821953;Ne;7;4;0;11
19110;Gluosnis;BORUŽĖLĖS;2515646510;Taip;0;0;5;5
19111;Gluosnis;BORUŽĖLĖS;3212658311;Taip;6;0;3;9
19112;Gluosnis;BORUŽĖLĖS;2603201633;Ne;0;0;19;19
19113;Gluosnis;LAPIUKAI;94487630173;Taip;0;2;1;3
19114;Gluosnis;LAPIUKAI;7445566160;Taip;22;0;0;22
19115;Gluosnis;LAPIUKAI;8259035822;Taip;4;9;0;13
19116;Gluosnis;LAPIUKAI;5354082364;Ne;0;1;0;1
19117;Gluosnis;LAPIUKAI;6536698798;Taip;9;0;0;9
19118;Gluosnis;LAPIUKAI;4960167173;Taip;0;7;0;7
19119;Gluosnis;LAPIUKAI;3504197974;Taip;4;0;1;5
19120;Gluosnis;LAPIUKAI;1153781469;Taip;2;11;0;13
19121;Gluosnis;LAPIUKAI;2181550091;Taip;0;0;1;1
19122;Gluosnis;LAPIUKAI;2810808007;Taip;18;1;0;19
19123;Gluosnis;LAPIUKAI;6163009686;Taip;5;0;0;5
19124;Gluosnis;LAPIUKAI;9146356004;Taip;9;0;4;13
19125;Gluosnis;LAPIUKAI;1671693932;Taip;0;0;5;5
19126;Gluosnis;LAPIUKAI;4005023841;Ne;4;0;6;10
19127;Gluosnis;LAPIUKAI;9497547057;Ne;13;0;0;13
19128;Gluosnis;LAPIUKAI;1119389682;Taip;0;0;1;1
19129;Gluosnis;LAPIUKAI;1298724775;Taip;0;1;0;1
19130;Gluosnis;LAPIUKAI;2819283284;Taip;20;0;0;20
19131;Gluosnis;PELĖDŽIUKAI;3840001741;Ne;10;0;1;11
19132;Gluosnis;PELĖDŽIUKAI;4856769984;Taip;17;0;2;19
19133;Gluosnis;PELĖDŽIUKAI;1944291082;Taip;8;0;0;8
19134;Gluosnis;PELĖDŽIUKAI;54773515741;Taip;1;0;6;7
19135;Gluosnis;PELĖDŽIUKAI;75777330223;Taip;0;4;0;4
19136;Gluosnis;PELĖDŽIUKAI;1319664504;Ne;0;0;7;7
19137;Gluosnis;PELĖDŽIUKAI;62170308628;Taip;0;4;0;4
19138;Gluosnis;PELĖDŽIUKAI;1269360325;Taip;0;1;0;1
19139;Gluosnis;PELĖDŽIUKAI;3107005229;Taip;5;0;0;5
19140;Gluosnis;PELĖDŽIUKAI;8014916932;Ne;1;0;7;8
19141;Gluosnis;PELĖDŽIUKAI;98818207299;Ne;10;0;0;10
19142;Gluosnis;PELĖDŽIUKAI;1244309058;Taip;0;0;1;1
19143;Gluosnis;PELĖDŽIUKAI;8788880196;Ne;9;2;1;12
19144;Gluosnis;VOVERIUKAI;8719047997;Taip;15;0;0;15
19145;Gluosnis;VOVERIUKAI;5059528135;Taip;16;0;0;16
19146;Gluosnis;VOVERIUKAI;7075070566;Taip;4;0;1;5
19147;Gluosnis;VOVERIUKAI;7761376910;Taip;0;0;5;5
19148;Gluosnis;VOVERIUKAI;1147279898;Taip;9;0;0;9
19149;Gluosnis;VOVERIUKAI;8928237970;Ne;20;0;0;20
19150;Gluosnis;VOVERIUKAI;9786252471;Taip;4;0;3;7
19151;Gluosnis;VOVERIUKAI;6493474181;Taip;0;9;0;9
19152;Gluosnis;VOVERIUKAI;6944918504;Taip;2;0;7;9
19153;Gluosnis;VOVERIUKAI;9669118189;Taip;9;13;0;22
19154;Gluosnis;VOVERIUKAI;4757276892;Taip;0;0;1;1
19155;Gluosnis;VOVERIUKAI;3961201852;Taip;10;0;0;10
19156;Gluosnis;VOVERIUKAI;1185903576;Taip;0;0;1;1
19157;Gluosnis;VOVERIUKAI;6113600571;Taip;0;0;1;1
19158;Gluosnis;VOVERIUKAI;6443602669;Taip;0;0;3;3
19159;Gluosnis;VOVERIUKAI;1565251804;Taip;9;10;0;19
19160;Gluosnis;DRUGELIAI;5949954525;Taip;13;0;0;13
19161;Gluosnis;DRUGELIAI;7537587118;Taip;14;0;1;15
19162;Gluosnis;DRUGELIAI;1716235604;Taip;5;1;0;6
19163;Gluosnis;DRUGELIAI;7642311375;Taip;1;0;0;1
19164;Gluosnis;DRUGELIAI;8430102757;Taip;3;5;0;8
19165;Gluosnis;DRUGELIAI;4125830926;Taip;0;0;11;11
19166;Gluosnis;DRUGELIAI;6358187113;Taip;14;0;0;14
19167;Gluosnis;DRUGELIAI;2260938817;Taip;2;0;0;2
19168;Gluosnis;DRUGELIAI;9084785666;Taip;8;0;4;12
19169;Gluosnis;DRUGELIAI;4940563623;Ne;11;0;0;11
19170;Gluosnis;DRUGELIAI;1113731535;Taip;0;4;0;4
19171;Gluosnis;DRUGELIAI;4653963373;Ne;16;0;0;16
19172;Gluosnis;DRUGELIAI;2458662117;Taip;0;2;0;2
19173;Gluosnis;DRUGELIAI;3936418539;Ne;0;0;1;1
19174;Gluosnis;DRUGELIAI;8314366921;Taip;5;0;0;5
19175;Gluosnis;DRUGELIAI;4220504133;Ne;0;0;1;1
19176;Gluosnis;DRUGELIAI;9931766935;Taip;8;0;0;8
19177;Gluosnis;DRUGELIAI;3527418865;Taip;22;0;0;22
19178;Gluosnis;DRUGELIAI;6914171069;Taip;4;0;1;5
19179;Gluosnis;BITUTĖS;4176300773;Taip;2;0;0;2
19180;Gluosnis;BITUTĖS;1848647593;Taip;2;1;0;3
19181;Gluosnis;BITUTĖS;2554790908;Taip;9;1;0;10
19182;Gluosnis;BITUTĖS;8281499182;Taip;14;0;3;17
19183;Gluosnis;BITUTĖS;5186060122;Taip;3;0;1;4
19184;Gluosnis;BITUTĖS;8690911930;Taip;0;0;2;2
19185;Gluosnis;BITUTĖS;2403029153;Ne;5;0;1;6
19186;Gluosnis;BITUTĖS;9963769327;Taip;3;5;0;8
19187;Gluosnis;BITUTĖS;9542889575;Taip;1;0;0;1
19188;Gluosnis;BITUTĖS;1966484574;Taip;3;0;0;3
19189;Gluosnis;BITUTĖS;4353195155;Taip;13;5;0;18
19190;Gluosnis;BITUTĖS;5889360726;Taip;2;0;3;5
19191;Gluosnis;BITUTĖS;8035097045;Taip;2;7;0;9
19192;Gluosnis;BITUTĖS;3362089746;Taip;0;0;7;7
19193;Gluosnis;BITUTĖS;6767500085;Ne;22;0;0;22
19194;Gluosnis;BITUTĖS;4505504276;Taip;0;12;0;12
19195;Gluosnis;BITUTĖS;7390361159;Ne;4;0;0;4
19196;Gluosnis;BITUTĖS;8380310240;Taip;10;0;0;10
19197;Gluosnis;BITUTĖS;4481544177;Ne;0;0;4;4
19198;"Vilniaus Saulėtekio mokykla-daugiafunkcinis centras";Priešmokyklinė;7047619741;Taip;8;0;0;8
19199;"Vilniaus Saulėtekio mokykla-daugiafunkcinis centras";Priešmokyklinė;3447120578;Ne;0;0;9;9
19200;"Vilniaus Saulėtekio mokykla-daugiafunkcinis centras";Priešmokyklinė;1024982577;Ne;0;0;5;5
19201;"Vilniaus Saulėtekio mokykla-daugiafunkcinis centras";Priešmokyklinė;7061749750;Taip;0;0;2;2
19202;"Vilniaus Saulėtekio mokykla-daugiafunkcinis centras";Priešmokyklinė;51312232477;Taip;0;0;1;1
19203;"Vilniaus Saulėtekio mokykla-daugiafunkcinis centras";Priešmokyklinė;6414861823;Taip;1;0;7;8
19204;"Vilniaus Saulėtekio mokykla-daugiafunkcinis centras";Priešmokyklinė;7563665059;Ne;0;0;3;3
19205;"Vilniaus Saulėtekio mokykla-daugiafunkcinis centras";Priešmokyklinė;1421523719;Taip;0;0;16;16
19206;"Vilniaus Saulėtekio mokykla-daugiafunkcinis centras";Priešmokyklinė;5867141673;Taip;0;0;18;18
19207;"Vilniaus Saulėtekio mokykla-daugiafunkcinis centras";Priešmokyklinė;5248302086;Taip;0;0;13;13
19208;"Vilniaus Saulėtekio mokykla-daugiafunkcinis centras";Priešmokyklinė;80029915729;Taip;0;0;4;4
19209;"Vilniaus Saulėtekio mokykla-daugiafunkcinis centras";Priešmokyklinė;1772051140;Taip;0;0;11;11
19210;"Vilniaus Saulėtekio mokykla-daugiafunkcinis centras";Priešmokyklinė;9932216845;Taip;0;0;8;8
19211;"Vilniaus Saulėtekio mokykla-daugiafunkcinis centras";Priešmokyklinė;9665282942;Ne;0;0;19;19
19212;"Vilniaus Martyno Mažvydo progimnazija";PRIEŠMOKYKLINĖ;96793345108;Taip;0;0;5;5
19213;"Vilniaus Martyno Mažvydo progimnazija";PRIEŠMOKYKLINĖ;19181545360;Taip;0;7;0;7
19214;"Vilniaus Martyno Mažvydo progimnazija";PRIEŠMOKYKLINĖ;4858524232;Taip;0;22;0;22
19215;"Vilniaus Martyno Mažvydo progimnazija";PRIEŠMOKYKLINĖ;68127870846;Taip;0;0;5;5
19216;"Vilniaus Martyno Mažvydo progimnazija";PRIEŠMOKYKLINĖ;3964251862;Taip;0;2;0;2
19217;"Vilniaus Martyno Mažvydo progimnazija";PRIEŠMOKYKLINĖ;2032732500;Taip;3;2;1;6
19218;"Vilniaus Martyno Mažvydo progimnazija";PRIEŠMOKYKLINĖ;18742574853;Taip;2;1;0;3
19219;"Vilniaus Martyno Mažvydo progimnazija";PRIEŠMOKYKLINĖ;1126288017;Taip;3;0;1;4
19220;"Vilniaus Martyno Mažvydo progimnazija";PRIEŠMOKYKLINĖ;1148912605;Ne;0;7;0;7
19221;"Vilniaus Martyno Mažvydo progimnazija";PRIEŠMOKYKLINĖ;83270172138;Taip;0;0;1;1
19222;"Vilniaus Martyno Mažvydo progimnazija";PRIEŠMOKYKLINĖ;1693121016;Taip;0;0;1;1
19223;"Vilniaus Martyno Mažvydo progimnazija";PRIEŠMOKYKLINĖ;1993355696;Ne;5;4;0;9
19224;"Vilniaus Martyno Mažvydo progimnazija";PRIEŠMOKYKLINĖ;25732368565;Ne;0;22;0;22
19225;"Vilniaus Martyno Mažvydo progimnazija";PRIEŠMOKYKLINĖ;5973303255;Ne;1;0;8;9
19226;"Vilniaus Martyno Mažvydo progimnazija";PRIEŠMOKYKLINĖ;15196087730;Ne;7;0;0;7
19227;"Vilniaus Martyno Mažvydo progimnazija";PRIEŠMOKYKLINĖ;4134546404;Ne;0;7;0;7
19228;"Vilniaus „Genio“ progimnazija";Priešmokyklinė;3158067311;Taip;0;1;0;1
19229;"Vilniaus „Genio“ progimnazija";Priešmokyklinė;4754232120;Ne;0;2;1;3
19230;"Vilniaus „Genio“ progimnazija";Priešmokyklinė;6265455084;Taip;0;2;7;9
19231;"Vilniaus „Genio“ progimnazija";Priešmokyklinė;50466456602;Taip;0;2;0;2
19232;"Vilniaus „Genio“ progimnazija";Priešmokyklinė;1924335940;Ne;0;2;0;2
19233;"Vilniaus „Genio“ progimnazija";Priešmokyklinė;2259206809;Taip;0;1;1;2
19234;"Vilniaus „Genio“ progimnazija";Priešmokyklinė;2085116521;Taip;3;2;0;5
19235;"Vilniaus „Genio“ progimnazija";Priešmokyklinė;1877764699;Ne;0;1;0;1
19236;"Vilniaus „Genio“ progimnazija";Priešmokyklinė;2104449007;Ne;0;1;0;1
19237;"Vilniaus „Genio“ progimnazija";Priešmokyklinė;2238619197;Taip;2;1;0;3
19238;"Vilniaus „Genio“ progimnazija";Priešmokyklinė;93664116601;Ne;0;1;2;3
19239;"Vilniaus „Genio“ progimnazija";Priešmokyklinė;1203715568;Taip;4;1;3;8
19240;"Vilniaus „Genio“ progimnazija";Priešmokyklinė;8585966469;Ne;0;1;3;4
19241;"Vilniaus „Genio“ progimnazija";Priešmokyklinė;47677246360;Taip;3;1;0;4
19242;"Vilniaus „Genio“ progimnazija";Priešmokyklinė;7961006993;Taip;0;2;0;2
19243;"Vilniaus „Genio“ progimnazija";Priešmokyklinė;80762814965;Taip;0;1;1;2
19244;"Vilniaus „Genio“ progimnazija";Priešmokyklinė;4550479746;Taip;5;1;0;6
19245;"Vilniaus „Genio“ progimnazija";Priešmokyklinė;93498963556;Ne;0;2;0;2
19246;"Vilniaus „Genio“ progimnazija";Priešmokyklinė;4674740550;Taip;0;22;0;22
19247;"Vilniaus „Genio“ progimnazija";Priešmokyklinė;40432227553;Taip;0;1;0;1
