Nr.;"Darželio pavadinimas";"Grupės pavadinimas";"Vaiko Identifikacinis Nr.";"Deklaruotas mieste";"Pateisintos dėl ligos";"Pateisintos dėl kitų priežasčių";"Nepateisintos dienos";"Praleistos dienos Viso"
1;Aitvaras;"VIJURKAI (ALERG.)";9649742132;Taip;0;3;0;3
2;Aitvaras;"VIJURKAI (ALERG.)";84922258988;Taip;0;1;0;1
3;Aitvaras;"VIJURKAI (ALERG.)";1201862001;Ne;10;0;0;10
4;Aitvaras;"VIJURKAI (ALERG.)";8970519668;Taip;0;1;0;1
5;Aitvaras;"VIJURKAI (ALERG.)";1600657305;Taip;10;0;2;12
6;Aitvaras;"VIJURKAI (ALERG.)";1621302802;Taip;0;2;0;2
7;Aitvaras;"VIJURKAI (ALERG.)";94080483856;Taip;0;2;0;2
8;Aitvaras;"VIJURKAI (ALERG.)";5083382326;Taip;0;11;0;11
9;Aitvaras;"VIJURKAI (ALERG.)";1773366241;Taip;12;0;1;13
10;Aitvaras;"VIJURKAI (ALERG.)";1553462849;Taip;0;1;0;1
11;Aitvaras;"VIJURKAI (ALERG.)";1398792964;Taip;0;1;0;1
12;Aitvaras;"VIJURKAI (ALERG.)";5770779699;Taip;0;10;0;10
13;Aitvaras;"VIJURKAI (ALERG.)";2159901439;Taip;4;10;0;14
14;Aitvaras;"VIJURKAI (ALERG.)";3716313515;Taip;0;1;2;3
15;Aitvaras;"VIJURKAI (ALERG.)";8366627546;Taip;6;1;0;7
16;Aitvaras;"VIJURKAI (ALERG.)";1481849611;Taip;10;2;0;12
17;Aitvaras;"VIJURKAI (ALERG.)";1090979323;Taip;3;1;0;4
18;Aitvaras;"SMALSUČIAI (ALERG.)";14251469975;Taip;0;0;2;2
19;Aitvaras;"SMALSUČIAI (ALERG.)";61721665912;Taip;3;0;0;3
20;Aitvaras;"SMALSUČIAI (ALERG.)";30174058452;Taip;5;0;0;5
21;Aitvaras;"SMALSUČIAI (ALERG.)";55369747065;Ne;0;1;0;1
22;Aitvaras;"SMALSUČIAI (ALERG.)";69352006024;Taip;0;3;0;3
23;Aitvaras;"SMALSUČIAI (ALERG.)";2083332491;Ne;1;6;0;7
24;Aitvaras;"SMALSUČIAI (ALERG.)";6745376381;Taip;3;0;0;3
25;Aitvaras;"SMALSUČIAI (ALERG.)";6238828251;Taip;3;0;0;3
26;Aitvaras;"SMALSUČIAI (ALERG.)";3433178644;Ne;0;4;0;4
27;Aitvaras;"SMALSUČIAI (ALERG.)";1872130301;Taip;0;0;1;1
28;Aitvaras;"SMALSUČIAI (ALERG.)";1207249857;Taip;0;2;1;3
29;Aitvaras;"SMALSUČIAI (ALERG.)";34735287315;Taip;6;6;0;12
30;Aitvaras;"SMALSUČIAI (ALERG.)";3471031093;Ne;7;1;0;8
31;Aitvaras;"SMALSUČIAI (ALERG.)";3133031845;Taip;6;0;0;6
32;Aitvaras;PADAUŽIUKAI;40344230133;Taip;5;0;1;6
33;Aitvaras;PADAUŽIUKAI;1493048970;Ne;4;0;0;4
34;Aitvaras;PADAUŽIUKAI;70367340825;Taip;0;0;5;5
35;Aitvaras;PADAUŽIUKAI;54496602809;Taip;0;0;4;4
36;Aitvaras;PADAUŽIUKAI;42556460388;Taip;9;0;0;9
37;Aitvaras;PADAUŽIUKAI;74628671065;Taip;0;2;0;2
38;Aitvaras;PADAUŽIUKAI;1306408890;Taip;0;1;0;1
39;Aitvaras;PADAUŽIUKAI;1500548803;Taip;3;0;0;3
40;Aitvaras;PADAUŽIUKAI;1886917840;Taip;8;0;2;10
41;Aitvaras;PADAUŽIUKAI;46021715174;Taip;0;0;4;4
42;Aitvaras;PADAUŽIUKAI;59572108690;Taip;10;0;0;10
43;Aitvaras;PADAUŽIUKAI;3836513736;Taip;4;0;3;7
44;Aitvaras;PADAUŽIUKAI;26906648835;Taip;0;3;4;7
45;Aitvaras;"AITVARIUKAI (ALERG.)";9810370596;Taip;0;5;0;5
46;Aitvaras;"AITVARIUKAI (ALERG.)";9745864667;Taip;0;4;0;4
47;Aitvaras;"AITVARIUKAI (ALERG.)";5389627560;Taip;15;0;0;15
48;Aitvaras;"AITVARIUKAI (ALERG.)";5956333024;Taip;0;1;0;1
49;Aitvaras;"AITVARIUKAI (ALERG.)";2953536545;Taip;5;2;1;8
50;Aitvaras;"AITVARIUKAI (ALERG.)";3535659630;Taip;0;4;1;5
51;Aitvaras;"AITVARIUKAI (ALERG.)";2566375128;Taip;0;2;1;3
52;Aitvaras;"AITVARIUKAI (ALERG.)";6356432078;Taip;14;0;0;14
53;Aitvaras;"AITVARIUKAI (ALERG.)";3639102842;Taip;0;2;0;2
54;Aitvaras;"AITVARIUKAI (ALERG.)";7243387750;Taip;0;4;0;4
55;Aitvaras;"AITVARIUKAI (ALERG.)";6587437949;Taip;0;2;0;2
56;Aitvaras;"AITVARIUKAI (ALERG.)";7461284958;Taip;0;4;0;4
57;Aitvaras;"AITVARIUKAI (ALERG.)";5330618557;Ne;17;0;0;17
58;Aitvaras;"AITVARIUKAI (ALERG.)";5504431748;Taip;6;5;0;11
59;Aitvaras;"AITVARIUKAI (ALERG.)";1877245088;Taip;4;5;0;9
60;Aitvaras;"AITVARIUKAI (ALERG.)";24247118884;Taip;0;2;0;2
61;Aitvaras;"AITVARIUKAI (ALERG.)";3394251305;Taip;2;0;0;2
62;Aitvaras;"AITVARIUKAI (ALERG.)";1954364886;Taip;8;0;0;8
63;Aitvaras;"SAULĖS ZUIKUČIAI  (ALERG.)";1019661577;Taip;0;2;0;2
64;Aitvaras;"SAULĖS ZUIKUČIAI  (ALERG.)";5619137905;Taip;0;4;0;4
65;Aitvaras;"SAULĖS ZUIKUČIAI  (ALERG.)";4426643908;Taip;0;1;0;1
66;Aitvaras;"SAULĖS ZUIKUČIAI  (ALERG.)";4106097701;Taip;0;2;0;2
67;Aitvaras;"SAULĖS ZUIKUČIAI  (ALERG.)";4902627153;Taip;6;0;4;10
68;Aitvaras;"SAULĖS ZUIKUČIAI  (ALERG.)";2184231202;Taip;5;0;0;5
69;Aitvaras;"SAULĖS ZUIKUČIAI  (ALERG.)";2478737835;Taip;4;0;1;5
70;Aitvaras;"SAULĖS ZUIKUČIAI  (ALERG.)";1136438927;Taip;3;0;0;3
71;Aitvaras;"SAULĖS ZUIKUČIAI  (ALERG.)";8137900398;Taip;8;0;0;8
72;Aitvaras;"SAULĖS ZUIKUČIAI  (ALERG.)";9147954612;Taip;5;0;1;6
73;Aitvaras;"SAULĖS ZUIKUČIAI  (ALERG.)";2511844613;Taip;10;0;0;10
74;Aitvaras;"SAULĖS ZUIKUČIAI  (ALERG.)";7907357058;Taip;7;0;0;7
75;Aitvaras;"SAULĖS ZUIKUČIAI  (ALERG.)";9534206000;Taip;8;4;0;12
76;Aitvaras;"SAULĖS ZUIKUČIAI  (ALERG.)";3737054758;Taip;10;0;1;11
77;Aitvaras;"SAULĖS ZUIKUČIAI  (ALERG.)";4646876966;Taip;0;1;0;1
78;Aitvaras;"SAULĖS ZUIKUČIAI  (ALERG.)";3730442890;Taip;0;8;0;8
79;Aitvaras;"SAULĖS ZUIKUČIAI  (ALERG.)";8849563638;Taip;0;1;1;2
80;Aitvaras;"ŽEMYNUKAI (ALERG.)";1652681820;Taip;2;2;0;4
81;Aitvaras;"ŽEMYNUKAI (ALERG.)";6166757095;Taip;0;11;0;11
82;Aitvaras;"ŽEMYNUKAI (ALERG.)";5595233402;Taip;4;12;0;16
83;Aitvaras;"ŽEMYNUKAI (ALERG.)";2650483861;Taip;0;1;0;1
84;Aitvaras;"ŽEMYNUKAI (ALERG.)";5922357091;Taip;0;2;1;3
85;Aitvaras;"ŽEMYNUKAI (ALERG.)";6951219468;Taip;0;1;0;1
86;Aitvaras;"ŽEMYNUKAI (ALERG.)";4868552034;Taip;0;11;0;11
87;Aitvaras;"ŽEMYNUKAI (ALERG.)";1494094426;Taip;0;8;0;8
88;Aitvaras;"ŽEMYNUKAI (ALERG.)";9562494357;Taip;5;1;0;6
89;Aitvaras;"ŽEMYNUKAI (ALERG.)";6021342178;Taip;0;3;0;3
90;Aitvaras;"ŽEMYNUKAI (ALERG.)";9142513631;Taip;10;3;0;13
91;Aitvaras;"ŽEMYNUKAI (ALERG.)";2737503753;Taip;11;0;2;13
92;Aitvaras;"ŽEMYNUKAI (ALERG.)";4480921300;Taip;13;4;0;17
93;Aitvaras;"ŽEMYNUKAI (ALERG.)";6218019092;Taip;0;0;5;5
94;Aitvaras;"ŽEMYNUKAI (ALERG.)";7560642918;Taip;0;2;0;2
95;Aitvaras;"ŽEMYNUKAI (ALERG.)";3820930777;Taip;11;1;0;12
96;Aitvaras;"ŽEMYNUKAI (ALERG.)";6624986090;Taip;5;0;6;11
97;Aitvaras;"ŽEMYNUKAI (ALERG.)";4733627644;Taip;10;2;9;21
98;Aitvaras;"ŽEMYNUKAI (ALERG.)";3104109370;Taip;0;0;1;1
99;Aitvaras;"ŽEMYNUKAI (ALERG.)";1949144346;Taip;8;0;1;9
100;Aitvaras;"ŽEMYNUKAI (ALERG.)";8641433486;Taip;5;0;1;6
101;Aitvaras;"ŽEMYNUKAI (ALERG.)";7853714142;Taip;12;0;0;12
102;Aitvaras;"LINKSMUČIAI (ALERG.)";5238819066;Taip;0;2;0;2
103;Aitvaras;"LINKSMUČIAI (ALERG.)";7109001184;Taip;1;0;1;2
104;Aitvaras;"LINKSMUČIAI (ALERG.)";5378212904;Ne;16;0;0;16
105;Aitvaras;"LINKSMUČIAI (ALERG.)";3655710511;Taip;8;0;0;8
106;Aitvaras;"LINKSMUČIAI (ALERG.)";1091372798;Taip;0;2;2;4
107;Aitvaras;"LINKSMUČIAI (ALERG.)";8666824607;Taip;3;0;0;3
108;Aitvaras;"LINKSMUČIAI (ALERG.)";8178703988;Taip;0;0;6;6
109;Aitvaras;"LINKSMUČIAI (ALERG.)";7260577885;Taip;3;2;2;7
110;Aitvaras;"LINKSMUČIAI (ALERG.)";1599183050;Taip;0;6;2;8
111;Aitvaras;"LINKSMUČIAI (ALERG.)";7029464687;Taip;17;0;0;17
112;Aitvaras;"LINKSMUČIAI (ALERG.)";4613894944;Taip;0;0;2;2
113;Aitvaras;"LINKSMUČIAI (ALERG.)";4120515569;Taip;17;0;0;17
114;Aitvaras;"LINKSMUČIAI (ALERG.)";9885781306;Taip;5;2;2;9
115;Aitvaras;"LINKSMUČIAI (ALERG.)";4564723798;Taip;11;0;5;16
116;Aitvaras;"LINKSMUČIAI (ALERG.)";4612994715;Taip;14;0;1;15
117;Aitvaras;"LINKSMUČIAI (ALERG.)";4176681907;Taip;5;8;0;13
118;Aitvaras;"LINKSMUČIAI (ALERG.)";8996590628;Taip;0;20;0;20
119;Aitvaras;"LINKSMUČIAI (ALERG.)";7392689023;Taip;0;6;0;6
120;Aitvaras;NAMINUKAI;3053557807;Taip;3;0;0;3
121;Aitvaras;NAMINUKAI;6126913961;Taip;7;0;1;8
122;Aitvaras;NAMINUKAI;3347213578;Taip;13;0;3;16
123;Aitvaras;NAMINUKAI;9024245490;Taip;0;1;2;3
124;Aitvaras;NAMINUKAI;8512502118;Taip;0;6;1;7
125;Aitvaras;NAMINUKAI;1376605323;Taip;5;1;0;6
126;Aitvaras;NAMINUKAI;6060880045;Taip;8;1;0;9
127;Aitvaras;NAMINUKAI;2821221241;Taip;13;0;0;13
128;Aitvaras;NAMINUKAI;9039303562;Taip;0;8;0;8
129;Aitvaras;NAMINUKAI;6080549524;Taip;0;8;0;8
130;Aitvaras;NAMINUKAI;6048701733;Taip;0;2;0;2
131;Aitvaras;NAMINUKAI;6110226958;Taip;0;1;3;4
132;Aitvaras;NAMINUKAI;4555281655;Taip;21;0;0;21
133;Aitvaras;NAMINUKAI;8043062737;Taip;0;0;1;1
134;Aitvaras;NAMINUKAI;3005447572;Taip;0;1;0;1
135;Aitvaras;NAMINUKAI;1549552392;Taip;0;0;1;1
136;Aitvaras;NAMINUKAI;4498792867;Taip;0;4;0;4
137;Aitvaras;NAMINUKAI;9490714865;Taip;5;0;1;6
138;Aitvaras;NAMINUKAI;1498630458;Taip;1;0;0;1
139;Aitvaras;NAMINUKAI;5161069611;Taip;0;0;2;2
140;Aitvaras;NAMINUKAI;7934344218;Taip;0;0;4;4
141;Aitvaras;NAMINUKAI;6279152796;Taip;0;1;0;1
142;Aitvaras;ŠELMIAI;9332771711;Ne;10;2;0;12
143;Aitvaras;ŠELMIAI;6550426644;Taip;0;5;0;5
144;Aitvaras;ŠELMIAI;5818794912;Taip;0;5;0;5
145;Aitvaras;ŠELMIAI;58780461337;Taip;9;2;1;12
146;Aitvaras;ŠELMIAI;1116271183;Taip;1;0;0;1
147;Aitvaras;ŠELMIAI;44046627149;Taip;0;11;1;12
148;Aitvaras;ŠELMIAI;43711349817;Taip;11;0;1;12
149;Aitvaras;ŠELMIAI;7469656671;Taip;0;1;0;1
150;Aitvaras;ŠELMIAI;2408952971;Taip;3;2;0;5
151;Aitvaras;ŠELMIAI;2330782717;Taip;1;10;0;11
152;Aitvaras;ŠELMIAI;47875842134;Taip;6;0;0;6
153;Aitvaras;ŠELMIAI;40799643122;Taip;0;4;0;4
154;Aitvaras;ŠELMIAI;8503279655;Taip;3;2;0;5
155;Aitvaras;ŠELMIAI;2034293999;Ne;11;1;0;12
156;Aitvaras;ŠELMIAI;2804106417;Taip;7;1;0;8
157;Aitvaras;ŠELMIAI;2711888522;Taip;7;0;0;7
158;Aitvaras;ŠELMIAI;1996524718;Taip;1;2;2;5
159;Aitvaras;ŠELMIAI;4110585744;Ne;0;4;0;4
160;Aitvaras;ŠELMIAI;6010324894;Taip;0;1;0;1
161;Aitvaras;ŠELMIAI;1105354193;Taip;13;0;0;13
162;Aitvaras;ŠELMIAI;1387254053;Taip;0;1;0;1
163;Aitvaras;KODĖLČIUKAI;6214572150;Taip;15;1;0;16
164;Aitvaras;KODĖLČIUKAI;3323458595;Ne;1;0;0;1
165;Aitvaras;KODĖLČIUKAI;8065540507;Taip;5;6;0;11
166;Aitvaras;KODĖLČIUKAI;1288810999;Taip;11;0;0;11
167;Aitvaras;KODĖLČIUKAI;6501943902;Taip;13;0;0;13
168;Aitvaras;KODĖLČIUKAI;3101015381;Taip;8;0;0;8
169;Aitvaras;KODĖLČIUKAI;4350590529;Taip;2;0;1;3
170;Aitvaras;KODĖLČIUKAI;7777235021;Ne;8;1;0;9
171;Aitvaras;KODĖLČIUKAI;5641224483;Taip;0;4;1;5
172;Aitvaras;KODĖLČIUKAI;1830134108;Taip;0;13;0;13
173;Aitvaras;KODĖLČIUKAI;8121858940;Taip;3;0;0;3
174;Aitvaras;KODĖLČIUKAI;3178965623;Taip;0;2;0;2
175;Aitvaras;KODĖLČIUKAI;5905456814;Ne;0;2;0;2
176;Aitvaras;KODĖLČIUKAI;6739827530;Taip;4;1;0;5
177;Aitvaras;KODĖLČIUKAI;2807595769;Taip;0;8;0;8
178;Aitvaras;KODĖLČIUKAI;1252145346;Taip;0;0;2;2
179;Aitvaras;KODĖLČIUKAI;8439586875;Taip;1;0;0;1
180;Aitvaras;KODĖLČIUKAI;2328771385;Taip;14;0;0;14
181;Aitvaras;KODĖLČIUKAI;3735941659;Taip;8;0;0;8
182;Aitvaras;KODĖLČIUKAI;8360380303;Taip;18;0;0;18
183;Aitvaras;KODĖLČIUKAI;1594675221;Taip;1;0;0;1
184;Aitvaras;PABIRUČIAI;4551774368;Ne;10;0;0;10
185;Aitvaras;PABIRUČIAI;8558414510;Ne;10;0;0;10
186;Aitvaras;PABIRUČIAI;4158520145;Ne;7;0;0;7
187;Aitvaras;PABIRUČIAI;1203732956;Ne;20;0;0;20
188;Aitvaras;PABIRUČIAI;8644983502;Taip;5;0;0;5
189;Aitvaras;PABIRUČIAI;5782609781;Taip;0;1;0;1
190;Aitvaras;PABIRUČIAI;7805819121;Taip;4;0;0;4
191;Aitvaras;PABIRUČIAI;7352233454;Ne;9;1;1;11
192;Aitvaras;PABIRUČIAI;1019103539;Taip;7;2;1;10
193;Aitvaras;PABIRUČIAI;4812423010;Taip;5;2;2;9
194;Aitvaras;PABIRUČIAI;8756012613;Taip;2;0;0;2
195;Aitvaras;PABIRUČIAI;1901118931;Taip;0;1;1;2
196;Aitvaras;PABIRUČIAI;2185746898;Taip;3;1;0;4
197;Aitvaras;PABIRUČIAI;8119154459;Taip;15;1;0;16
198;Aitvaras;PABIRUČIAI;1112142035;Taip;8;1;0;9
199;Aitvaras;"SVAJOKLIAI  (ALERG.)";2004112424;Taip;5;2;0;7
200;Aitvaras;"SVAJOKLIAI  (ALERG.)";6084096300;Taip;0;2;0;2
201;Aitvaras;"SVAJOKLIAI  (ALERG.)";5750154036;Taip;0;1;0;1
202;Aitvaras;"SVAJOKLIAI  (ALERG.)";6201118021;Taip;14;1;0;15
203;Aitvaras;"SVAJOKLIAI  (ALERG.)";1275561645;Ne;0;1;0;1
204;Aitvaras;"SVAJOKLIAI  (ALERG.)";1879540041;Taip;3;3;0;6
205;Aitvaras;"SVAJOKLIAI  (ALERG.)";5425259260;Taip;0;1;0;1
206;Aitvaras;"SVAJOKLIAI  (ALERG.)";9228736015;Taip;18;0;0;18
207;Aitvaras;"SVAJOKLIAI  (ALERG.)";9763502346;Taip;12;0;0;12
208;Aitvaras;"SVAJOKLIAI  (ALERG.)";7568388141;Taip;12;4;0;16
209;Aitvaras;"SVAJOKLIAI  (ALERG.)";4204923580;Taip;14;0;0;14
210;Aitvaras;"SVAJOKLIAI  (ALERG.)";1532588441;Taip;11;0;0;11
211;Aitvaras;"SVAJOKLIAI  (ALERG.)";3775634117;Taip;0;1;0;1
212;Aitvaras;"SVAJOKLIAI  (ALERG.)";2615576367;Taip;0;0;1;1
213;Aitvaras;"SVAJOKLIAI  (ALERG.)";2146963673;Taip;21;0;0;21
214;Aitvaras;"SVAJOKLIAI  (ALERG.)";4777266938;Ne;8;0;0;8
215;Aitvaras;"SVAJOKLIAI  (ALERG.)";3954840915;Taip;5;2;0;7
216;Aitvaras;"SVAJOKLIAI  (ALERG.)";9157794193;Taip;17;0;0;17
217;Aitvaras;"SVAJOKLIAI  (ALERG.)";5659897032;Taip;8;1;0;9
218;Atžalėlės;Gėlytės;5742471497;Taip;0;0;5;5
219;Atžalėlės;Gėlytės;4284673729;Ne;8;5;8;21
220;Atžalėlės;Gėlytės;8695865604;Ne;0;6;0;6
221;Atžalėlės;Gėlytės;1137741059;Taip;11;0;0;11
222;Atžalėlės;Gėlytės;2385614957;Taip;0;0;5;5
223;Atžalėlės;Gėlytės;5432433423;Taip;0;3;0;3
224;Atžalėlės;Gėlytės;9715625283;Taip;0;13;4;17
225;Atžalėlės;Gėlytės;6024189665;Taip;0;0;11;11
226;Atžalėlės;Gėlytės;4682216852;Ne;0;0;1;1
227;Atžalėlės;Gėlytės;4238773173;Taip;0;0;3;3
228;Atžalėlės;Gėlytės;2131592139;Taip;0;4;0;4
229;Atžalėlės;Gėlytės;3191066669;Taip;3;0;0;3
230;Atžalėlės;Gėlytės;1500456945;Taip;0;0;5;5
231;Atžalėlės;Gėlytės;6177038838;Taip;0;6;0;6
232;Atžalėlės;Gėlytės;1722233272;Taip;0;12;0;12
233;Atžalėlės;Gėlytės;5310990513;Taip;8;0;0;8
234;Atžalėlės;Gėlytės;7702502252;Taip;0;13;0;13
235;Atžalėlės;Gėlytės;9189223222;Taip;10;2;0;12
236;Atžalėlės;Gėlytės;3283415814;Taip;2;0;0;2
237;Atžalėlės;Gėlytės;1146492807;Taip;6;0;1;7
238;Atžalėlės;Gėlytės;3870758086;Taip;0;0;2;2
239;Atžalėlės;Gėlytės;1036410428;Taip;0;3;0;3
240;Atžalėlės;Gėlytės;1450609695;Taip;0;15;0;15
241;Atžalėlės;Gėlytės;6202250600;Taip;0;0;4;4
242;Atžalėlės;Drugeliai;4643154006;Taip;0;1;0;1
243;Atžalėlės;Drugeliai;6903666624;Ne;2;0;1;3
244;Atžalėlės;Drugeliai;4902947406;Taip;0;0;5;5
245;Atžalėlės;Drugeliai;6570245757;Taip;0;0;3;3
246;Atžalėlės;Drugeliai;2315790531;Ne;0;1;0;1
247;Atžalėlės;Drugeliai;6782007470;Taip;0;0;2;2
248;Atžalėlės;Drugeliai;8393217418;Taip;2;0;1;3
249;Atžalėlės;Drugeliai;1805496887;Taip;0;0;5;5
250;Atžalėlės;Drugeliai;5417971068;Taip;0;6;0;6
251;Atžalėlės;Drugeliai;9463215947;Taip;0;8;0;8
252;Atžalėlės;Drugeliai;1830572633;Taip;0;0;1;1
253;Atžalėlės;Drugeliai;5147078840;Taip;0;6;0;6
254;Atžalėlės;Drugeliai;9222670655;Taip;0;4;0;4
255;Atžalėlės;Drugeliai;77261118958;Taip;0;1;7;8
256;Atžalėlės;Drugeliai;1429493246;Taip;0;6;0;6
257;Atžalėlės;Drugeliai;6114426973;Taip;3;7;0;10
258;Atžalėlės;Drugeliai;1456979448;Taip;6;7;0;13
259;Atžalėlės;Drugeliai;4032519781;Taip;0;0;1;1
260;Atžalėlės;Drugeliai;1426744251;Taip;0;0;1;1
261;Atžalėlės;Drugeliai;7756889911;Taip;4;0;0;4
262;Atžalėlės;Gandriukai;28910361902;Taip;0;13;0;13
263;Atžalėlės;Gandriukai;93452036571;Taip;0;2;0;2
264;Atžalėlės;Gandriukai;4483002806;Ne;0;0;1;1
265;Atžalėlės;Gandriukai;16442821393;Taip;0;4;0;4
266;Atžalėlės;Gandriukai;1197205716;Taip;2;0;0;2
267;Atžalėlės;Gandriukai;70694002130;Taip;0;0;13;13
268;Atžalėlės;Gandriukai;1204800605;Taip;0;5;0;5
269;Atžalėlės;Gandriukai;1074259644;Taip;0;1;0;1
270;Atžalėlės;Gandriukai;66107666615;Taip;3;1;3;7
271;Atžalėlės;Gandriukai;63867153552;Taip;0;0;1;1
272;Atžalėlės;Gandriukai;87567915519;Taip;0;2;0;2
273;Atžalėlės;Gandriukai;1011601294;Taip;0;5;0;5
274;Atžalėlės;Gandriukai;54869610865;Taip;0;1;0;1
275;Atžalėlės;Gandriukai;80500800894;Taip;0;0;6;6
276;Atžalėlės;Gandriukai;519493490;Ne;0;7;0;7
277;Atžalėlės;Gandriukai;82777644548;Taip;0;0;5;5
278;Atžalėlės;Gandriukai;23453799177;Taip;0;1;0;1
279;Atžalėlės;Gandriukai;78664848612;Taip;2;1;0;3
280;Atžalėlės;Voveriukai;1312772153;Taip;0;0;6;6
281;Atžalėlės;Voveriukai;6975941393;Taip;0;0;1;1
282;Atžalėlės;Voveriukai;1865339755;Taip;0;0;5;5
283;Atžalėlės;Voveriukai;8138683218;Taip;0;3;0;3
284;Atžalėlės;Voveriukai;4467364336;Taip;0;0;4;4
285;Atžalėlės;Voveriukai;1804802235;Taip;0;3;0;3
286;Atžalėlės;Voveriukai;1316154666;Taip;0;6;0;6
287;Atžalėlės;Voveriukai;9699811980;Taip;0;2;0;2
288;Atžalėlės;Voveriukai;8847754477;Taip;5;5;0;10
289;Atžalėlės;Voveriukai;7689394485;Taip;6;0;1;7
290;Atžalėlės;Voveriukai;2013707106;Ne;4;3;0;7
291;Atžalėlės;Voveriukai;2757744826;Taip;1;0;0;1
292;Atžalėlės;Voveriukai;3795729265;Taip;0;0;9;9
293;Atžalėlės;Voveriukai;8201582382;Taip;0;0;5;5
294;Atžalėlės;Voveriukai;4362058013;Taip;0;0;5;5
295;Atžalėlės;Voveriukai;8819893830;Ne;0;0;4;4
296;Atžalėlės;Voveriukai;2662384275;Taip;0;4;0;4
297;Atžalėlės;Voveriukai;2067246260;Taip;0;0;6;6
298;Atžalėlės;Voveriukai;7532672266;Ne;0;0;3;3
299;Atžalėlės;Voveriukai;5705303891;Taip;10;0;1;11
300;Atžalėlės;Voveriukai;57580381980;Taip;0;2;0;2
301;Atžalėlės;Žirniukai;2374624441;Taip;0;1;0;1
302;Atžalėlės;Žirniukai;7613931447;Ne;9;2;0;11
303;Atžalėlės;Žirniukai;7522643082;Ne;9;2;0;11
304;Atžalėlės;Žirniukai;5584105084;Taip;0;0;3;3
305;Atžalėlės;Žirniukai;9677943321;Taip;0;0;2;2
306;Atžalėlės;Žirniukai;9967641617;Taip;0;6;0;6
307;Atžalėlės;Žirniukai;6368553568;Taip;0;0;1;1
308;Atžalėlės;Žirniukai;9085453655;Taip;0;2;0;2
309;Atžalėlės;Žirniukai;1538643591;Taip;17;0;0;17
310;Atžalėlės;Žirniukai;3143856911;Taip;0;8;0;8
311;Atžalėlės;Žirniukai;4661388894;Taip;10;0;1;11
312;Atžalėlės;Žirniukai;5148142239;Taip;0;1;2;3
313;Atžalėlės;Žirniukai;9736390705;Taip;3;0;0;3
314;Atžalėlės;Ežiukai;1423254771;Taip;0;0;3;3
315;Atžalėlės;Ežiukai;4227804985;Taip;0;5;0;5
316;Atžalėlės;Ežiukai;9053620501;Taip;0;0;1;1
317;Atžalėlės;Ežiukai;9054589111;Taip;0;1;0;1
318;Atžalėlės;Ežiukai;6665199013;Taip;0;6;0;6
319;Atžalėlės;Ežiukai;3333808381;Taip;7;0;0;7
320;Atžalėlės;Ežiukai;1710646812;Taip;12;0;0;12
321;Atžalėlės;Ežiukai;8145965849;Taip;5;0;0;5
322;Atžalėlės;Ežiukai;8631507231;Taip;9;0;2;11
323;Atžalėlės;Ežiukai;9481268935;Taip;0;15;0;15
324;Atžalėlės;Ežiukai;5693413287;Ne;8;0;0;8
325;Atžalėlės;Ežiukai;6447615639;Taip;0;0;3;3
326;Atžalėlės;Ežiukai;5972419628;Taip;9;2;0;11
327;Atžalėlės;Paukšteliai;4081717007;Taip;16;0;0;16
328;Atžalėlės;Paukšteliai;7807313362;Taip;9;0;0;9
329;Atžalėlės;Paukšteliai;6537864486;Taip;5;0;1;6
330;Atžalėlės;Paukšteliai;8768704484;Taip;0;0;1;1
331;Atžalėlės;Paukšteliai;6675588261;Taip;0;0;1;1
332;Atžalėlės;Paukšteliai;8524244526;Taip;15;0;0;15
333;Atžalėlės;Paukšteliai;1704679306;Taip;0;10;0;10
334;Atžalėlės;Paukšteliai;7321516783;Taip;1;0;5;6
335;Atžalėlės;Paukšteliai;6265777690;Taip;0;16;0;16
336;Atžalėlės;Paukšteliai;1844980319;Ne;8;0;1;9
337;Atžalėlės;Paukšteliai;5997958773;Ne;3;0;0;3
338;Atžalėlės;Paukšteliai;7356877676;Ne;0;15;0;15
339;Atžalėlės;Paukšteliai;8512283024;Taip;20;0;0;20
340;Atžalėlės;Paukšteliai;4081717007;Taip;16;0;0;16
341;Atžalėlės;Paukšteliai;7807313362;Taip;9;0;1;10
342;Atžalėlės;Paukšteliai;6537864486;Taip;5;0;1;6
343;Atžalėlės;Paukšteliai;8768704484;Taip;0;0;2;2
344;Atžalėlės;Paukšteliai;6675588261;Taip;0;0;2;2
345;Atžalėlės;Paukšteliai;8524244526;Taip;16;0;0;16
346;Atžalėlės;Paukšteliai;1704679306;Taip;0;10;0;10
347;Atžalėlės;Paukšteliai;7321516783;Taip;1;0;6;7
348;Atžalėlės;Paukšteliai;6265777690;Taip;0;16;0;16
349;Atžalėlės;Paukšteliai;1844980319;Ne;8;0;2;10
350;Atžalėlės;Paukšteliai;5997958773;Ne;3;0;1;4
351;Atžalėlės;Paukšteliai;7356877676;Ne;0;15;0;15
352;Atžalėlės;Paukšteliai;8512283024;Taip;21;0;0;21
353;Atžalėlės;Paukšteliai;2078781673;Taip;0;5;6;11
354;Atžalėlės;Paukšteliai;1520206753;Taip;0;0;6;6
355;Atžalėlės;Paukšteliai;1089221288;Taip;0;0;2;2
356;Atžalėlės;Paukšteliai;4790322154;Taip;5;2;0;7
357;Atžalėlės;Paukšteliai;9327437508;Ne;0;0;7;7
358;Atžalėlės;Meškiukai;1431197358;Taip;0;0;15;15
359;Atžalėlės;Meškiukai;8508450500;Taip;0;4;0;4
360;Atžalėlės;Meškiukai;4177753994;Taip;0;0;2;2
361;Atžalėlės;Meškiukai;3982090601;Taip;0;0;1;1
362;Atžalėlės;Meškiukai;8586739429;Taip;7;0;0;7
363;Atžalėlės;Meškiukai;9925178685;Taip;0;0;1;1
364;Atžalėlės;Meškiukai;2617568019;Taip;0;3;2;5
365;Atžalėlės;Meškiukai;3743308789;Taip;3;5;1;9
366;Atžalėlės;Meškiukai;4233689945;Taip;0;5;0;5
367;Atžalėlės;Meškiukai;8619613890;Taip;4;0;3;7
368;Atžalėlės;Meškiukai;3281114596;Taip;0;0;3;3
369;Atžalėlės;Meškiukai;1431197358;Taip;0;0;16;16
370;Atžalėlės;Meškiukai;8508450500;Taip;0;4;0;4
371;Atžalėlės;Meškiukai;4177753994;Taip;0;0;3;3
372;Atžalėlės;Meškiukai;3982090601;Taip;0;0;1;1
373;Atžalėlės;Meškiukai;8586739429;Taip;7;0;1;8
374;Atžalėlės;Meškiukai;9925178685;Taip;0;0;2;2
375;Atžalėlės;Meškiukai;2617568019;Taip;0;3;3;6
376;Atžalėlės;Meškiukai;3743308789;Taip;3;6;1;10
377;Atžalėlės;Meškiukai;4233689945;Taip;0;5;0;5
378;Atžalėlės;Meškiukai;8619613890;Taip;4;0;3;7
379;Atžalėlės;Meškiukai;3281114596;Taip;0;0;4;4
380;Atžalėlės;Meškiukai;5466374223;Taip;0;0;5;5
381;Atžalėlės;Meškiukai;2433029299;Taip;0;0;2;2
382;Atžalėlės;Meškiukai;5682652546;Taip;0;0;1;1
383;Atžalėlės;Meškiukai;2930612059;Ne;9;0;3;12
384;Atžalėlės;Meškiukai;6385777303;Taip;0;0;5;5
385;Aušrelė;PASAKIUKAI;1659335142;Taip;0;3;0;3
386;Aušrelė;PASAKIUKAI;2974714806;Ne;10;5;0;15
387;Aušrelė;PASAKIUKAI;1327431679;Taip;2;0;0;2
388;Aušrelė;PASAKIUKAI;8960462835;Taip;0;0;8;8
389;Aušrelė;PASAKIUKAI;1408751702;Taip;0;1;7;8
390;Aušrelė;PASAKIUKAI;6995749373;Taip;0;3;0;3
391;Aušrelė;PASAKIUKAI;8372554796;Taip;0;0;2;2
392;Aušrelė;PASAKIUKAI;8341539501;Taip;0;1;0;1
393;Aušrelė;PASAKIUKAI;8230362307;Taip;5;0;5;10
394;Aušrelė;PASAKIUKAI;9440600785;Ne;0;2;0;2
395;Aušrelė;PASAKIUKAI;4306578299;Taip;8;2;0;10
396;Aušrelė;PASAKIUKAI;5777214701;Taip;0;7;0;7
397;Aušrelė;PASAKIUKAI;6277405405;Taip;0;14;0;14
398;Aušrelė;PASAKIUKAI;34891640909;Taip;0;0;5;5
399;Aušrelė;PASAKIUKAI;2125080379;Taip;0;0;8;8
400;Aušrelė;BORUŽĖLĖS;6673034329;Taip;5;11;0;16
401;Aušrelė;BORUŽĖLĖS;4957581753;Ne;5;1;2;8
402;Aušrelė;BORUŽĖLĖS;1928260563;Taip;5;0;1;6
403;Aušrelė;BORUŽĖLĖS;2626569015;Taip;5;0;6;11
404;Aušrelė;BORUŽĖLĖS;1543314096;Taip;0;0;12;12
405;Aušrelė;BORUŽĖLĖS;6084682084;Taip;3;3;0;6
406;Aušrelė;BORUŽĖLĖS;8243716759;Taip;0;3;0;3
407;Aušrelė;BORUŽĖLĖS;1549962200;Taip;0;0;1;1
408;Aušrelė;BORUŽĖLĖS;4505922394;Taip;4;0;11;15
409;Aušrelė;BORUŽĖLĖS;7190665397;Taip;0;0;7;7
410;Aušrelė;BORUŽĖLĖS;2991828434;Taip;0;0;1;1
411;Aušrelė;BORUŽĖLĖS;2260623869;Taip;0;0;16;16
412;Aušrelė;SMALSUČIAI;6761263775;Taip;3;0;4;7
413;Aušrelė;SMALSUČIAI;3015028879;Taip;0;5;1;6
414;Aušrelė;SMALSUČIAI;5935579452;Taip;5;0;0;5
415;Aušrelė;SMALSUČIAI;2863655361;Taip;12;0;0;12
416;Aušrelė;SMALSUČIAI;2390128933;Taip;0;1;2;3
417;Aušrelė;SMALSUČIAI;8503309819;Taip;0;3;0;3
418;Aušrelė;SMALSUČIAI;2827216981;Taip;3;1;0;4
419;Aušrelė;SMALSUČIAI;9443641849;Taip;0;2;0;2
420;Aušrelė;SMALSUČIAI;7930717076;Taip;5;1;1;7
421;Aušrelė;SMALSUČIAI;7609339123;Taip;15;0;0;15
422;Aušrelė;SMALSUČIAI;1556010005;Ne;6;0;0;6
423;Aušrelė;SMALSUČIAI;5478028396;Ne;0;10;0;10
424;Aušrelė;SMALSUČIAI;7070013052;Taip;6;0;0;6
425;Aušrelė;SMALSUČIAI;3581155949;Taip;15;0;0;15
426;Aušrelė;SMALSUČIAI;2266390402;Taip;0;2;3;5
427;Aušrelė;SMALSUČIAI;8032661062;Taip;1;0;2;3
428;Aušrelė;SMALSUČIAI;4262596104;Taip;0;1;0;1
429;Aušrelė;SMALSUČIAI;1976613166;Ne;0;1;2;3
430;Aušrelė;KODĖLČIUKAI;7723159748;Taip;10;0;0;10
431;Aušrelė;KODĖLČIUKAI;7367268748;Taip;6;0;3;9
432;Aušrelė;KODĖLČIUKAI;3623813061;Taip;0;8;0;8
433;Aušrelė;KODĖLČIUKAI;4288695809;Taip;3;0;0;3
434;Aušrelė;KODĖLČIUKAI;8693750994;Taip;0;0;2;2
435;Aušrelė;KODĖLČIUKAI;7327544406;Ne;0;0;1;1
436;Aušrelė;KODĖLČIUKAI;9566144610;Taip;0;5;0;5
437;Aušrelė;KODĖLČIUKAI;6308519574;Taip;0;0;2;2
438;Aušrelė;KODĖLČIUKAI;6186758486;Taip;0;0;5;5
439;Aušrelė;KODĖLČIUKAI;3320399046;Taip;6;0;0;6
440;Aušrelė;KODĖLČIUKAI;6911735462;Taip;12;0;1;13
441;Aušrelė;KODĖLČIUKAI;4248808572;Taip;0;11;10;21
442;Aušrelė;KODĖLČIUKAI;5046027475;Taip;0;15;0;15
443;Aušrelė;KODĖLČIUKAI;8338569001;Taip;0;0;3;3
444;Aušrelė;KODĖLČIUKAI;2766357229;Ne;10;0;0;10
445;Aušrelė;KODĖLČIUKAI;5358315970;Taip;0;0;2;2
446;Aušrelė;KODĖLČIUKAI;7515666888;Taip;0;3;0;3
447;Aušrelė;KODĖLČIUKAI;9559257794;Taip;0;0;1;1
448;Aušrelė;PELĖDŽIUKAI;5955421544;Ne;0;0;1;1
449;Aušrelė;PELĖDŽIUKAI;1296552763;Taip;0;4;0;4
450;Aušrelė;PELĖDŽIUKAI;1160772086;Taip;0;4;0;4
451;Aušrelė;PELĖDŽIUKAI;1352195876;Taip;0;6;1;7
452;Aušrelė;PELĖDŽIUKAI;1599595256;Taip;0;11;0;11
453;Aušrelė;PELĖDŽIUKAI;1539176090;Taip;0;5;0;5
454;Aušrelė;PELĖDŽIUKAI;1225272131;Taip;0;8;0;8
455;Aušrelė;PELĖDŽIUKAI;2987088389;Ne;0;0;3;3
456;Aušrelė;PELĖDŽIUKAI;1506444915;Taip;4;2;0;6
457;Aušrelė;PELĖDŽIUKAI;5304765447;Taip;4;0;0;4
458;Aušrelė;PELĖDŽIUKAI;85739624682;Taip;8;0;5;13
459;Aušrelė;PELĖDŽIUKAI;6837623034;Taip;0;1;6;7
460;Aušrelė;PELĖDŽIUKAI;3974308431;Ne;2;0;2;4
461;Aušrelė;PELĖDŽIUKAI;42721248496;Taip;6;1;0;7
462;Aušrelė;PELĖDŽIUKAI;1177022224;Taip;16;0;0;16
463;Aušrelė;PELĖDŽIUKAI;1738313365;Taip;0;1;1;2
464;Aušrelė;PELĖDŽIUKAI;1666811336;Taip;8;0;0;8
465;Aušrelė;PELĖDŽIUKAI;6337567632;Ne;4;16;0;20
466;Aušrelė;AITVARIUKAI;2045076279;Taip;0;1;0;1
467;Aušrelė;AITVARIUKAI;1153416324;Taip;0;21;0;21
468;Aušrelė;AITVARIUKAI;1340754039;Ne;0;3;1;4
469;Aušrelė;AITVARIUKAI;79695989966;Taip;15;1;0;16
470;Aušrelė;AITVARIUKAI;1045290039;Taip;0;20;0;20
471;Aušrelė;AITVARIUKAI;51119593813;Taip;0;2;0;2
472;Aušrelė;AITVARIUKAI;5813735533;Taip;0;5;0;5
473;Aušrelė;AITVARIUKAI;18117725053;Taip;0;1;0;1
474;Aušrelė;AITVARIUKAI;27629722512;Taip;0;3;0;3
475;Aušrelė;AITVARIUKAI;1830501248;Ne;0;1;0;1
476;Aušrelė;AITVARIUKAI;65369497777;Taip;0;21;0;21
477;Aušrelė;AITVARIUKAI;1750555187;Taip;0;10;0;10
478;Aušrelė;AITVARIUKAI;8221635058;Taip;9;0;0;9
479;Aušrelė;AITVARIUKAI;1163757003;Taip;2;11;0;13
480;Aušrelė;AITVARIUKAI;1792774415;Taip;0;1;1;2
481;Aušrelė;AITVARIUKAI;6604163285;Ne;5;1;0;6
482;Aušrelė;AITVARIUKAI;1306572766;Ne;0;1;1;2
483;Aušrelė;AITVARIUKAI;9004468035;Taip;7;0;1;8
484;Aušrelė;AITVARIUKAI;13826429088;Taip;2;1;0;3
485;Aušrelė;BITUTĖS;4882556718;Ne;0;6;0;6
486;Aušrelė;BITUTĖS;1741716341;Ne;9;12;0;21
487;Aušrelė;BITUTĖS;2366843609;Taip;0;2;0;2
488;Aušrelė;BITUTĖS;4989544273;Taip;10;0;0;10
489;Aušrelė;BITUTĖS;9960201865;Taip;0;1;0;1
490;Aušrelė;BITUTĖS;2071674661;Ne;0;4;0;4
491;Aušrelė;BITUTĖS;1450827353;Taip;2;0;0;2
492;Aušrelė;BITUTĖS;4935192851;Ne;0;0;1;1
493;Aušrelė;BITUTĖS;9505496063;Ne;0;2;0;2
494;Aušrelė;BITUTĖS;1931955562;Taip;0;0;1;1
495;Aušrelė;BITUTĖS;5614774250;Ne;0;0;13;13
496;Aušrelė;BITUTĖS;4500226170;Ne;4;0;4;8
497;Aušrelė;BITUTĖS;8203256528;Ne;0;6;0;6
498;Aušrelė;BITUTĖS;5741252819;Ne;0;6;0;6
499;Aušrelė;BITUTĖS;1243825974;Ne;4;1;0;5
500;Aušrelė;ŽIRNIUKAI;8661284187;Taip;0;7;2;9
501;Aušrelė;ŽIRNIUKAI;9733877752;Taip;3;1;0;4
502;Aušrelė;ŽIRNIUKAI;2221714044;Ne;0;0;1;1
503;Aušrelė;ŽIRNIUKAI;9008462505;Ne;0;0;4;4
504;Aušrelė;ŽIRNIUKAI;1544869163;Taip;0;0;1;1
505;Aušrelė;ŽIRNIUKAI;6577540623;Ne;4;0;0;4
506;Aušrelė;ŽIRNIUKAI;5460833944;Ne;4;0;0;4
507;Aušrelė;ŽIRNIUKAI;6372004855;Taip;0;14;0;14
508;Aušrelė;ŽIRNIUKAI;3795172018;Ne;0;2;0;2
509;Aušrelė;ŽIRNIUKAI;1798478023;Taip;0;0;2;2
510;Aušrelė;GRYBUKAI;1463724119;Taip;0;6;0;6
511;Aušrelė;GRYBUKAI;6761874176;Taip;0;0;2;2
512;Aušrelė;GRYBUKAI;6672975558;Taip;7;0;0;7
513;Aušrelė;GRYBUKAI;4565813136;Taip;8;0;1;9
514;Aušrelė;GRYBUKAI;9877307844;Taip;5;0;1;6
515;Aušrelė;GRYBUKAI;8947695521;Taip;2;0;0;2
516;Aušrelė;GRYBUKAI;2311552230;Taip;5;6;0;11
517;Aušrelė;GRYBUKAI;1458580523;Taip;12;6;0;18
518;Aušrelė;GRYBUKAI;1871799626;Taip;6;0;1;7
519;Aušrelė;GRYBUKAI;5733298006;Taip;5;9;0;14
520;Aušrelė;DRUGELIAI;2468245186;Taip;7;0;0;7
521;Aušrelė;DRUGELIAI;8210698019;Taip;0;21;0;21
522;Aušrelė;DRUGELIAI;2545065554;Taip;0;13;1;14
523;Aušrelė;DRUGELIAI;8411336992;Taip;14;1;0;15
524;Aušrelė;DRUGELIAI;2656152037;Taip;0;5;0;5
525;Aušrelė;DRUGELIAI;8917907028;Taip;8;0;0;8
526;Aušrelė;DRUGELIAI;7494298336;Taip;11;1;0;12
527;Aušrelė;DRUGELIAI;4012186237;Taip;0;7;0;7
528;Aušrelė;DRUGELIAI;3738923947;Ne;10;0;1;11
529;Aušrelė;DRUGELIAI;3223092149;Taip;0;0;6;6
530;Aušrelė;DRUGELIAI;8580241126;Taip;2;0;3;5
531;Aušrelė;DRUGELIAI;4227228548;Taip;5;0;0;5
532;Aušrelė;DRUGELIAI;8996445434;Taip;2;0;0;2
533;Aušrelė;DRUGELIAI;6109859056;Ne;11;2;0;13
534;Aušrelė;DRUGELIAI;4942168388;Taip;0;21;0;21
535;Aušrelė;NYKŠTUKAI;6434548772;Taip;21;0;0;21
536;Aušrelė;NYKŠTUKAI;4595435635;Taip;0;9;4;13
537;Aušrelė;NYKŠTUKAI;9158248746;Taip;5;5;0;10
538;Aušrelė;NYKŠTUKAI;5708459561;Taip;4;0;0;4
539;Aušrelė;NYKŠTUKAI;5125295651;Taip;6;2;0;8
540;Aušrelė;NYKŠTUKAI;6833654667;Taip;0;2;0;2
541;Aušrelė;NYKŠTUKAI;6601922746;Taip;0;1;0;1
542;Aušrelė;NYKŠTUKAI;8029484123;Taip;12;0;0;12
543;Aušrelė;NYKŠTUKAI;9608444990;Taip;0;2;2;4
544;Aušrelė;NYKŠTUKAI;1081603034;Taip;0;21;0;21
545;Aušrelė;NYKŠTUKAI;5602774323;Taip;0;1;1;2
546;Aušrelė;NYKŠTUKAI;1039180129;Taip;0;0;2;2
547;Aušrelė;NYKŠTUKAI;2030555139;Taip;6;0;1;7
548;Aušrelė;NYKŠTUKAI;3807967685;Taip;4;2;0;6
549;Aušrelė;NYKŠTUKAI;8102749675;Taip;5;1;1;7
550;Aušrelė;NYKŠTUKAI;7978186455;Taip;0;19;0;19
551;Aušrelė;NYKŠTUKAI;7847650967;Ne;3;2;1;6
552;Beržynėlis;SVIRPLIUKAI;74856278886;Taip;0;1;0;1
553;Beržynėlis;SVIRPLIUKAI;1682929565;Taip;1;0;0;1
554;Beržynėlis;SVIRPLIUKAI;71505149611;Taip;0;2;0;2
555;Beržynėlis;SVIRPLIUKAI;1395819329;Taip;10;0;1;11
556;Beržynėlis;SVIRPLIUKAI;7248602510;Ne;0;2;0;2
557;Beržynėlis;SVIRPLIUKAI;3641421009;Taip;5;1;0;6
558;Beržynėlis;SVIRPLIUKAI;2791734213;Taip;5;0;0;5
559;Beržynėlis;SVIRPLIUKAI;9566341884;Taip;0;2;0;2
560;Beržynėlis;SVIRPLIUKAI;3278699117;Taip;6;1;0;7
561;Beržynėlis;SVIRPLIUKAI;1838631438;Taip;7;0;0;7
562;Beržynėlis;SVIRPLIUKAI;2681482042;Taip;2;0;0;2
563;Beržynėlis;SVIRPLIUKAI;1136091326;Taip;1;2;0;3
564;Beržynėlis;SVIRPLIUKAI;1516309509;Taip;8;2;0;10
565;Beržynėlis;SVIRPLIUKAI;6395436937;Taip;5;0;0;5
566;Beržynėlis;SVIRPLIUKAI;7929997884;Taip;9;1;0;10
567;Beržynėlis;SVIRPLIUKAI;5189335842;Taip;0;2;0;2
568;Beržynėlis;PELEDŽIUKAI;1464556813;Taip;0;6;0;6
569;Beržynėlis;PELEDŽIUKAI;17743947386;Taip;0;2;1;3
570;Beržynėlis;PELEDŽIUKAI;1578089280;Taip;0;1;0;1
571;Beržynėlis;PELEDŽIUKAI;1527942602;Taip;0;1;0;1
572;Beržynėlis;PELEDŽIUKAI;1466742506;Taip;8;0;0;8
573;Beržynėlis;PELEDŽIUKAI;1910024785;Taip;4;12;1;17
574;Beržynėlis;PELEDŽIUKAI;1823144276;Ne;0;1;0;1
575;Beržynėlis;PELEDŽIUKAI;95544821432;Taip;0;2;2;4
576;Beržynėlis;PELEDŽIUKAI;1367442186;Taip;0;0;2;2
577;Beržynėlis;PELEDŽIUKAI;1014895926;Ne;0;1;0;1
578;Beržynėlis;PELEDŽIUKAI;1391844432;Ne;0;1;0;1
579;Beržynėlis;PELEDŽIUKAI;1945230630;Taip;9;0;1;10
580;Beržynėlis;PELEDŽIUKAI;30539063473;Taip;0;4;0;4
581;Beržynėlis;PELEDŽIUKAI;81022321678;Taip;0;0;2;2
582;Beržynėlis;PELEDŽIUKAI;45685658789;Taip;0;0;5;5
583;Beržynėlis;PELEDŽIUKAI;1207208151;Taip;3;0;2;5
584;Beržynėlis;PELEDŽIUKAI;29356394553;Taip;0;11;0;11
585;Beržynėlis;PELEDŽIUKAI;1895493234;Taip;0;1;0;1
586;Beržynėlis;PELEDŽIUKAI;1612137286;Taip;0;2;0;2
587;Beržynėlis;PELEDŽIUKAI;1893270997;Taip;0;2;0;2
588;Beržynėlis;ŽIOGELIAI;5308596559;Taip;3;1;0;4
589;Beržynėlis;ŽIOGELIAI;4035764376;Taip;0;1;0;1
590;Beržynėlis;ŽIOGELIAI;4970999989;Taip;0;2;1;3
591;Beržynėlis;ŽIOGELIAI;1325972861;Taip;5;3;0;8
592;Beržynėlis;ŽIOGELIAI;9540292311;Taip;5;16;0;21
593;Beržynėlis;ŽIOGELIAI;9088059487;Taip;3;1;0;4
594;Beržynėlis;ŽIOGELIAI;5473666098;Taip;0;6;0;6
595;Beržynėlis;ŽIOGELIAI;7589778533;Taip;0;11;0;11
596;Beržynėlis;ŽIOGELIAI;8591800387;Taip;0;1;0;1
597;Beržynėlis;ŽIOGELIAI;6739927917;Taip;0;2;0;2
598;Beržynėlis;ŽIOGELIAI;2971686368;Taip;0;3;0;3
599;Beržynėlis;ŽIOGELIAI;9409317403;Taip;0;2;2;4
600;Beržynėlis;ŽIOGELIAI;6334152631;Taip;4;12;0;16
601;Beržynėlis;ŽIOGELIAI;8114761925;Ne;7;0;0;7
602;Beržynėlis;ŽVIRBLIUKAI;2193460960;Ne;10;2;0;12
603;Beržynėlis;ŽVIRBLIUKAI;2482395208;Ne;8;2;0;10
604;Beržynėlis;ŽVIRBLIUKAI;2740093399;Taip;13;2;0;15
605;Beržynėlis;ŽVIRBLIUKAI;7057284039;Ne;8;2;0;10
606;Beržynėlis;ŽVIRBLIUKAI;2892553878;Taip;4;3;0;7
607;Beržynėlis;ŽVIRBLIUKAI;4466393687;Ne;5;1;0;6
608;Beržynėlis;ŽVIRBLIUKAI;9503352345;Ne;10;2;0;12
609;Beržynėlis;ŽVIRBLIUKAI;8881566865;Taip;0;0;13;13
610;Beržynėlis;ŽVIRBLIUKAI;8280378527;Taip;0;7;0;7
611;Beržynėlis;ŽVIRBLIUKAI;9754455116;Taip;7;1;0;8
612;Beržynėlis;ŽVIRBLIUKAI;3334994408;Taip;11;1;0;12
613;Beržynėlis;ŽVIRBLIUKAI;9777841895;Taip;6;2;0;8
614;Beržynėlis;ŽVIRBLIUKAI;6293884233;Taip;11;0;0;11
615;Beržynėlis;ŽVIRBLIUKAI;4161974847;Ne;7;2;2;11
616;Beržynėlis;ŽVIRBLIUKAI;3209966996;Taip;8;1;0;9
617;Beržynėlis;ŽVIRBLIUKAI;5194416351;Taip;5;5;0;10
618;Beržynėlis;ŽIRNIUKAI;8701990625;Taip;0;1;0;1
619;Beržynėlis;ŽIRNIUKAI;8880151537;Taip;0;2;0;2
620;Beržynėlis;ŽIRNIUKAI;2221708263;Taip;15;1;0;16
621;Beržynėlis;ŽIRNIUKAI;9580286493;Taip;3;0;0;3
622;Beržynėlis;ŽIRNIUKAI;1468551784;Taip;0;0;6;6
623;Beržynėlis;ŽIRNIUKAI;6516665294;Taip;9;1;0;10
624;Beržynėlis;ŽIRNIUKAI;7389141619;Taip;0;2;0;2
625;Beržynėlis;ŽIRNIUKAI;2813336498;Taip;13;0;0;13
626;Beržynėlis;ŽIRNIUKAI;5027712732;Taip;0;6;0;6
627;Beržynėlis;ŽIRNIUKAI;7555487759;Taip;8;2;0;10
628;Beržynėlis;ŽIRNIUKAI;4595080695;Taip;3;0;0;3
629;Beržynėlis;ŽIRNIUKAI;6673910279;Taip;0;2;0;2
630;Beržynėlis;VIŠČIUKAI;7953957525;Taip;0;5;0;5
631;Beržynėlis;VIŠČIUKAI;8233464088;Taip;3;1;0;4
632;Beržynėlis;VIŠČIUKAI;4013099670;Taip;0;2;0;2
633;Beržynėlis;VIŠČIUKAI;7788532819;Ne;0;1;0;1
634;Beržynėlis;VIŠČIUKAI;7360345539;Taip;5;0;3;8
635;Beržynėlis;VIŠČIUKAI;7016454952;Taip;15;0;0;15
636;Beržynėlis;VIŠČIUKAI;3418730586;Taip;0;0;1;1
637;Beržynėlis;VIŠČIUKAI;4134371415;Taip;0;1;0;1
638;Beržynėlis;VIŠČIUKAI;3841363368;Taip;0;0;2;2
639;Beržynėlis;VIŠČIUKAI;8303684788;Taip;7;0;0;7
640;Beržynėlis;VIŠČIUKAI;1707585750;Taip;17;0;0;17
641;Beržynėlis;VIŠČIUKAI;4382068779;Taip;17;0;0;17
642;Bildukas;"Svetliački savaitinė";70033583066;Taip;0;8;0;8
643;Bildukas;"Svetliački savaitinė";75301544496;Taip;5;0;0;5
644;Bildukas;"Svetliački savaitinė";13885215871;Taip;0;1;0;1
645;Bildukas;"Svetliački savaitinė";25050688839;Ne;5;6;0;11
646;Bildukas;"Svetliački savaitinė";6219872984;Taip;9;0;2;11
647;Bildukas;"Svetliački savaitinė";2091204077;Taip;0;1;0;1
648;Bildukas;"Svetliački savaitinė";3531285331;Taip;0;1;2;3
649;Bildukas;"Svetliački savaitinė";1786822865;Ne;8;0;0;8
650;Bildukas;"Svetliački savaitinė";1470907829;Taip;0;0;2;2
651;Bildukas;"Svetliački savaitinė";6031087595;Ne;0;1;0;1
652;Bildukas;"Svetliački savaitinė";1557237011;Taip;0;1;0;1
653;Bildukas;"Svetliački savaitinė";4168864882;Ne;0;2;0;2
654;Bildukas;"Svetliački savaitinė";5794471794;Taip;0;4;0;4
655;Bildukas;"Svetliački savaitinė";9098427210;Taip;0;0;2;2
656;Bildukas;"Svetliački savaitinė";3418924977;Taip;4;0;1;5
657;Bildukas;"Svetliački savaitinė";1125206576;Taip;0;12;0;12
658;Bildukas;"Zaičiata savaitinė ( keli alergiški vaikai)";8694887879;Taip;0;4;0;4
659;Bildukas;"Zaičiata savaitinė ( keli alergiški vaikai)";6376189019;Taip;15;0;0;15
660;Bildukas;"Zaičiata savaitinė ( keli alergiški vaikai)";8496678513;Taip;6;0;0;6
661;Bildukas;"Zaičiata savaitinė ( keli alergiški vaikai)";2154916232;Taip;18;0;0;18
662;Bildukas;"Zaičiata savaitinė ( keli alergiški vaikai)";5828514911;Ne;11;0;0;11
663;Bildukas;"Zaičiata savaitinė ( keli alergiški vaikai)";4271185150;Taip;0;0;1;1
664;Bildukas;"Zaičiata savaitinė ( keli alergiški vaikai)";8994705290;Taip;6;1;0;7
665;Bildukas;"Zaičiata savaitinė ( keli alergiški vaikai)";5546604017;Ne;1;2;0;3
666;Bildukas;"Zaičiata savaitinė ( keli alergiški vaikai)";5543899899;Ne;5;0;5;10
667;Bildukas;"Zaičiata savaitinė ( keli alergiški vaikai)";6497373567;Taip;0;0;1;1
668;Bildukas;"Zaičiata savaitinė ( keli alergiški vaikai)";7313963137;Taip;5;0;1;6
669;Bildukas;"Zaičiata savaitinė ( keli alergiški vaikai)";4998847820;Ne;5;0;2;7
670;Bildukas;"Zaičiata savaitinė ( keli alergiški vaikai)";6311116034;Taip;7;0;0;7
671;Bildukas;"Zaičiata savaitinė ( keli alergiški vaikai)";2494202134;Ne;5;2;1;8
672;Bildukas;Gnomiki;4116831802;Ne;9;0;0;9
673;Bildukas;Gnomiki;1916522637;Taip;0;0;1;1
674;Bildukas;Gnomiki;1848018684;Ne;0;3;0;3
675;Bildukas;Gnomiki;1166429762;Taip;5;2;0;7
676;Bildukas;Gnomiki;5532063862;Taip;0;1;0;1
677;Bildukas;Gnomiki;6514730230;Taip;0;0;2;2
678;Bildukas;Gnomiki;2709547427;Taip;13;1;0;14
679;Bildukas;Gnomiki;8348978878;Taip;10;0;0;10
680;Bildukas;Gnomiki;4356525620;Taip;3;15;0;18
681;Bildukas;Gnomiki;2539486337;Taip;3;2;0;5
682;Bildukas;Gnomiki;1312165385;Taip;0;0;3;3
683;Bildukas;Gnomiki;1566191212;Taip;0;1;1;2
684;Bildukas;Gnomiki;3239566139;Ne;0;2;0;2
685;Bildukas;Zvonočki;91777282521;Ne;0;1;2;3
686;Bildukas;Zvonočki;1713133196;Ne;2;0;1;3
687;Bildukas;Zvonočki;4404602365;Taip;0;12;0;12
688;Bildukas;Zvonočki;4014493868;Taip;0;6;0;6
689;Bildukas;Zvonočki;6388514464;Taip;0;6;0;6
690;Bildukas;Zvonočki;4377803110;Taip;0;4;0;4
691;Bildukas;Zvonočki;7898746258;Taip;0;0;13;13
692;Bildukas;Zvonočki;1502213914;Taip;5;0;1;6
693;Bildukas;Zvonočki;9569296370;Taip;5;1;9;15
694;Bildukas;Zvonočki;4623727349;Taip;6;1;5;12
695;Bildukas;Zvonočki;5217751936;Taip;0;15;0;15
696;Bildukas;Zvonočki;4392299046;Taip;0;2;0;2
697;Bildukas;Zvonočki;8835111916;Taip;0;0;13;13
698;Bildukas;Zvonočki;5724787637;Taip;0;0;11;11
699;Bildukas;Zvonočki;9835391223;Taip;15;0;0;15
700;Bildukas;Zvonočki;4677564389;Taip;0;10;0;10
701;Bildukas;Zvonočki;2429527586;Taip;0;0;7;7
702;Bildukas;Zvonočki;8999239172;Taip;1;2;0;3
703;Bildukas;Zvonočki;9156801640;Ne;15;0;0;15
704;Bildukas;Zvonočki;9756326725;Taip;5;0;4;9
705;Birutės;SKRUZDELIUKŲ;4968068043;Ne;0;0;1;1
706;Birutės;SKRUZDELIUKŲ;1761065941;Taip;5;4;0;9
707;Birutės;SKRUZDELIUKŲ;4027700332;Taip;0;2;0;2
708;Birutės;SKRUZDELIUKŲ;7685356079;Taip;0;2;0;2
709;Birutės;SKRUZDELIUKŲ;1105133326;Ne;4;1;2;7
710;Birutės;SKRUZDELIUKŲ;8636113039;Taip;0;8;0;8
711;Birutės;SKRUZDELIUKŲ;9411016611;Taip;0;0;1;1
712;Birutės;SKRUZDELIUKŲ;7119951690;Taip;5;2;0;7
713;Birutės;SKRUZDELIUKŲ;1945532852;Taip;0;2;1;3
714;Birutės;SKRUZDELIUKŲ;5154903444;Ne;0;1;0;1
715;Birutės;SKRUZDELIUKŲ;9541516589;Taip;4;0;0;4
716;Birutės;SKRUZDELIUKŲ;6815916679;Taip;7;0;0;7
717;Birutės;SKRUZDELIUKŲ;7940403585;Ne;0;1;0;1
718;Birutės;SKRUZDELIUKŲ;4253571334;Ne;5;1;1;7
719;Birutės;SKRUZDELIUKŲ;9187671201;Ne;6;1;0;7
720;Birutės;SKRUZDELIUKŲ;8413760872;Taip;4;0;0;4
721;Birutės;BITUČIŲ;1599159924;Taip;0;0;1;1
722;Birutės;BITUČIŲ;33770983649;Ne;9;1;0;10
723;Birutės;BITUČIŲ;87693588654;Taip;0;4;0;4
724;Birutės;BITUČIŲ;2975442228;Taip;0;0;8;8
725;Birutės;BITUČIŲ;5770026060;Ne;16;0;0;16
726;Birutės;BITUČIŲ;98391790116;Taip;0;0;4;4
727;Birutės;BITUČIŲ;5947971037;Taip;0;6;0;6
728;Birutės;BITUČIŲ;3870702348;Taip;0;2;0;2
729;Birutės;BITUČIŲ;3436637062;Taip;3;5;0;8
730;Birutės;BITUČIŲ;8465645434;Taip;16;0;1;17
731;Birutės;BITUČIŲ;9722922540;Ne;1;0;2;3
732;Birutės;BITUČIŲ;7856891698;Taip;0;1;0;1
733;Birutės;BITUČIŲ;5164196372;Taip;0;0;3;3
734;Birutės;BITUČIŲ;3061210677;Taip;0;0;9;9
735;Birutės;BITUČIŲ;6431396285;Taip;0;0;6;6
736;Birutės;BITUČIŲ;6081472534;Taip;0;0;1;1
737;Birutės;BITUČIŲ;2674259453;Ne;0;0;2;2
738;Birutės;BORUŽIUKAI;1400510886;Taip;5;0;0;5
739;Birutės;BORUŽIUKAI;5457357625;Taip;5;0;0;5
740;Birutės;BORUŽIUKAI;5869137292;Taip;0;0;2;2
741;Birutės;BORUŽIUKAI;5026442722;Taip;5;3;0;8
742;Birutės;BORUŽIUKAI;6977276295;Taip;13;2;0;15
743;Birutės;BORUŽIUKAI;9904827482;Taip;4;0;2;6
744;Birutės;BORUŽIUKAI;8011210158;Ne;0;1;0;1
745;Birutės;BORUŽIUKAI;7398022393;Taip;4;2;0;6
746;Birutės;BORUŽIUKAI;4906874758;Ne;0;0;2;2
747;Birutės;BORUŽIUKAI;7494879160;Taip;7;0;4;11
748;Birutės;BORUŽIUKAI;9263238557;Taip;0;2;0;2
749;Birutės;BORUŽIUKAI;6460415179;Taip;3;0;4;7
750;Birutės;DRUGELIAI;1884820602;Ne;0;2;0;2
751;Birutės;DRUGELIAI;1447494370;Ne;2;1;0;3
752;Birutės;DRUGELIAI;79438789443;Taip;0;3;1;4
753;Birutės;DRUGELIAI;49162494334;Taip;10;0;1;11
754;Birutės;DRUGELIAI;3213573357;Taip;0;6;0;6
755;Birutės;DRUGELIAI;23540610503;Ne;0;2;0;2
756;Birutės;DRUGELIAI;1163666527;Taip;0;0;1;1
757;Birutės;DRUGELIAI;32780299044;Ne;0;0;1;1
758;Birutės;DRUGELIAI;1346957081;Ne;0;1;0;1
759;Birutės;DRUGELIAI;88939598407;Ne;0;0;1;1
760;Birutės;DRUGELIAI;1950295916;Ne;0;0;1;1
761;Birutės;DRUGELIAI;9662009307;Taip;3;2;1;6
762;Birutės;DRUGELIAI;9860683556;Taip;0;0;3;3
763;Birutės;DRUGELIAI;5574120561;Taip;9;1;0;10
764;Birutės;DRUGELIAI;6880300182;Ne;2;0;0;2
765;Birutės;DRUGELIAI;10932023263;Ne;0;7;0;7
766;Bitutė;Aitvariukų;8394685672;Taip;7;1;0;8
767;Bitutė;Aitvariukų;1162903905;Taip;1;2;1;4
768;Bitutė;Aitvariukų;1560715159;Taip;0;3;0;3
769;Bitutė;Aitvariukų;6204566294;Taip;0;1;0;1
770;Bitutė;Aitvariukų;2518730247;Taip;6;1;0;7
771;Bitutė;Aitvariukų;8743734366;Taip;0;4;0;4
772;Bitutė;Aitvariukų;2804203556;Taip;10;10;0;20
773;Bitutė;Aitvariukų;5455919343;Taip;0;2;0;2
774;Bitutė;Aitvariukų;3432065233;Taip;5;1;0;6
775;Bitutė;Aitvariukų;5679397165;Taip;4;6;0;10
776;Bitutė;Aitvariukų;7056737587;Ne;8;1;0;9
777;Bitutė;Aitvariukų;1564763789;Taip;0;2;0;2
778;Bitutė;Aitvariukų;1331133962;Taip;5;0;2;7
779;Bitutė;Aitvariukų;7729210895;Ne;5;0;1;6
780;Bitutė;Ežiukų;40949937934;Taip;3;9;0;12
781;Bitutė;Ežiukų;1262030751;Taip;0;0;4;4
782;Bitutė;Ežiukų;57841590670;Ne;0;1;0;1
783;Bitutė;Ežiukų;56287634684;Ne;0;1;2;3
784;Bitutė;Ežiukų;4315172747;Taip;4;1;0;5
785;Bitutė;Ežiukų;5126303823;Taip;5;4;0;9
786;Bitutė;Ežiukų;9838379838;Taip;0;21;0;21
787;Bitutė;Ežiukų;42098027592;Ne;4;0;1;5
788;Bitutė;Ežiukų;17953339860;Taip;0;11;0;11
789;Bitutė;Ežiukų;4764586168;Taip;0;0;7;7
790;Bitutė;Ežiukų;8905075899;Taip;19;0;0;19
791;Bitutė;Ežiukų;2812580726;Ne;0;0;3;3
792;Bitutė;Ežiukų;8186706520;Taip;0;21;0;21
793;Bitutė;Ežiukų;9602659259;Taip;9;2;0;11
794;Bitutė;Žvirbliukų;3804171750;Taip;0;2;0;2
795;Bitutė;Žvirbliukų;8545377054;Taip;4;0;0;4
796;Bitutė;Žvirbliukų;5406667195;Taip;0;1;0;1
797;Bitutė;Žvirbliukų;4458990772;Ne;9;0;1;10
798;Bitutė;Žvirbliukų;3723040682;Taip;0;1;0;1
799;Bitutė;Žvirbliukų;2190439190;Taip;0;0;6;6
800;Bitutė;Žvirbliukų;7113693496;Taip;10;0;1;11
801;Bitutė;Žvirbliukų;4177331531;Taip;0;0;1;1
802;Bitutė;Žvirbliukų;2483462846;Taip;0;4;0;4
803;Bitutė;Žvirbliukų;7678106084;Taip;3;0;0;3
804;Bitutė;Žvirbliukų;6044969600;Taip;0;3;0;3
805;Bitutė;Žvirbliukų;2444289145;Ne;0;6;0;6
806;Bitutė;Žvirbliukų;3517750478;Taip;0;7;0;7
807;Bitutė;Žvirbliukų;5291764696;Taip;0;0;4;4
808;Bitutė;Žvirbliukų;1942685472;Taip;0;1;0;1
809;Bitutė;Žvirbliukų;4303490614;Ne;11;3;0;14
810;Bitutė;Žvirbliukų;3654065124;Taip;0;2;0;2
811;Bitutė;Žvirbliukų;9166624750;Taip;0;12;1;13
812;Bitutė;Žvirbliukų;6014726741;Ne;3;0;1;4
813;Bitutė;Žvirbliukų;6140816959;Taip;0;0;2;2
814;Bitutė;Gandriukų;4054959628;Taip;0;2;1;3
815;Bitutė;Gandriukų;14787330368;Taip;0;1;0;1
816;Bitutė;Gandriukų;11128936533;Taip;0;1;1;2
817;Bitutė;Gandriukų;9314363274;Taip;0;21;0;21
818;Bitutė;Gandriukų;84694903978;Taip;0;1;0;1
819;Bitutė;Gandriukų;86636444738;Taip;0;16;0;16
820;Bitutė;Gandriukų;1703630417;Taip;5;0;0;5
821;Bitutė;Gandriukų;6591291681;Taip;18;0;0;18
822;Bitutė;Gandriukų;74038944722;Taip;4;3;0;7
823;Bitutė;Gandriukų;1956718350;Ne;0;8;2;10
824;Bitutė;Gandriukų;22504941477;Taip;0;5;0;5
825;Bitutė;Gandriukų;8754340459;Taip;0;3;0;3
826;Bitutė;Pelėdžiukai;8912459968;Taip;4;0;2;6
827;Bitutė;Pelėdžiukai;1064809221;Taip;11;0;1;12
828;Bitutė;Pelėdžiukai;1354608761;Taip;0;1;2;3
829;Bitutė;Pelėdžiukai;87960363246;Taip;0;4;0;4
830;Bitutė;Pelėdžiukai;61233878620;Taip;5;0;1;6
831;Bitutė;Pelėdžiukai;26206836171;Ne;0;0;1;1
832;Bitutė;Pelėdžiukai;1130379531;Taip;0;1;2;3
833;Bitutė;Pelėdžiukai;1307910515;Taip;0;0;2;2
834;Bitutė;Pelėdžiukai;2126118124;Taip;0;1;2;3
835;Bitutė;Pelėdžiukai;38436660859;Taip;21;0;0;21
836;Bitutė;Pelėdžiukai;95252521365;Taip;0;7;1;8
837;Bitutė;Pelėdžiukai;1521753712;Taip;2;0;4;6
838;Bitutė;Pelėdžiukai;37364063140;Ne;4;0;0;4
839;Bitutė;Pelėdžiukai;1913421864;Taip;0;0;1;1
840;Bitutė;Pelėdžiukai;6969112590;Taip;0;0;1;1
841;Bitutė;Pelėdžiukai;12719290707;Taip;9;0;1;10
842;Bitutė;Pelėdžiukai;1082091910;Taip;0;0;1;1
843;Bitutė;Boružėlių;6586888742;Taip;0;0;4;4
844;Bitutė;Boružėlių;5783154071;Taip;0;2;0;2
845;Bitutė;Boružėlių;37105491775;Ne;0;0;4;4
846;Bitutė;Boružėlių;7352524951;Taip;0;2;3;5
847;Bitutė;Boružėlių;27144303911;Taip;0;0;2;2
848;Bitutė;Boružėlių;1802887869;Ne;9;0;1;10
849;Bitutė;Boružėlių;51054491845;Taip;0;1;2;3
850;Bitutė;Boružėlių;5653055907;Taip;5;0;1;6
851;Bitutė;Boružėlių;1809034174;Taip;11;0;0;11
852;Bitutė;Boružėlių;5644789669;Taip;0;0;3;3
853;Bitutė;Boružėlių;2350260809;Taip;10;0;3;13
854;Bitutė;Boružėlių;1307749129;Taip;0;5;0;5
855;Bitutė;Boružėlių;3980455738;Taip;8;0;1;9
856;Bitutė;Boružėlių;6678928989;Taip;3;0;1;4
857;Bitutė;Boružėlių;11567978993;Ne;12;0;0;12
858;Bitutė;Boružėlių;8519978626;Taip;0;16;5;21
859;Bitutė;Boružėlių;6659750060;Taip;5;0;1;6
860;Bitutė;Boružėlių;7387822939;Ne;5;0;0;5
861;Bitutė;Boružėlių;90943054285;Taip;0;4;1;5
862;Bitutė;Šokliukų;8211710975;Taip;7;0;3;10
863;Bitutė;Šokliukų;8872286273;Taip;7;1;1;9
864;Bitutė;Šokliukų;5169768042;Taip;10;0;1;11
865;Bitutė;Šokliukų;4917599786;Taip;6;0;2;8
866;Bitutė;Šokliukų;1348548294;Taip;6;9;0;15
867;Bitutė;Šokliukų;4527880105;Taip;0;0;1;1
868;Bitutė;Šokliukų;9855080887;Taip;5;0;1;6
869;Bitutė;Šokliukų;7318555933;Taip;0;0;3;3
870;Bitutė;Šokliukų;9834697190;Ne;0;10;1;11
871;Bitutė;Šokliukų;1012702386;Taip;0;5;0;5
872;Bitutė;Šokliukų;9924340801;Taip;5;0;2;7
873;Bitutė;Šokliukų;7979566741;Taip;8;0;1;9
874;Bitutė;Šokliukų;7165511381;Taip;0;4;0;4
875;Bitutė;Šokliukų;9465186207;Taip;0;11;0;11
876;Bitutė;Šokliukų;2853616585;Taip;11;0;0;11
877;Bitutė;Šokliukų;5109258680;Taip;0;1;1;2
878;Bitutė;Šokliukų;3417576747;Taip;0;1;4;5
879;Bitutė;Šokliukų;8422448947;Taip;8;3;0;11
880;Bitutė;Šokliukų;7926482326;Taip;0;0;4;4
881;Bitutė;Šokliukų;5876700984;Taip;0;1;0;1
882;Bitutė;Šokliukų;5759407291;Ne;0;1;0;1
883;Bitutė;Drugelių;57770829048;Taip;0;2;0;2
884;Bitutė;Drugelių;2531472741;Taip;0;2;0;2
885;Bitutė;Drugelių;55812244900;Taip;0;2;0;2
886;Bitutė;Drugelių;74525712637;Taip;0;8;0;8
887;Bitutė;Drugelių;56620848568;Taip;0;1;0;1
888;Bitutė;Drugelių;2049938111;Taip;2;0;0;2
889;Bitutė;Drugelių;58668298206;Taip;0;2;0;2
890;Bitutė;Drugelių;1863634233;Taip;2;2;0;4
891;Bitutė;Drugelių;9550491607;Taip;0;20;0;20
892;Bitutė;Drugelių;3982159333;Taip;15;4;0;19
893;Bitutė;Drugelių;27461264704;Taip;0;5;2;7
894;Bitutė;Drugelių;29300327608;Taip;0;0;1;1
895;Bitutė;Drugelių;50605497381;Taip;0;7;0;7
896;Bitutė;Drugelių;1030677273;Taip;0;1;0;1
897;Bitutė;Drugelių;3319657847;Taip;0;1;0;1
898;Bitutė;Drugelių;48695762145;Ne;5;0;0;5
899;Bitutė;Drugelių;72872147664;Taip;0;11;0;11
900;Bitutė;Kiškučių;9451529077;Ne;21;0;0;21
901;Bitutė;Kiškučių;1907876695;Taip;2;5;0;7
902;Bitutė;Kiškučių;7720798466;Taip;2;5;0;7
903;Bitutė;Kiškučių;1662815358;Taip;0;7;0;7
904;Bitutė;Kiškučių;1733189730;Taip;0;2;0;2
905;Bitutė;Kiškučių;3227252972;Taip;0;0;1;1
906;Bitutė;Kiškučių;9966437881;Taip;0;7;2;9
907;Bitutė;Kiškučių;8373296210;Taip;9;0;0;9
908;Bitutė;Kiškučių;1985958540;Taip;10;3;0;13
909;Bitutė;Kiškučių;8743960488;Taip;2;0;12;14
910;Bitutė;Kiškučių;9337144831;Taip;12;0;0;12
911;Bitutė;Kiškučių;1024337077;Taip;10;1;1;12
912;Bitutė;Kiškučių;4566919587;Taip;3;0;0;3
913;Bitutė;Kiškučių;2806899030;Taip;0;0;1;1
914;Bitutė;Kiškučių;5443722813;Taip;10;0;0;10
915;Bitutė;Kiškučių;1241863345;Taip;5;7;1;13
916;Bitutė;Kiškučių;8789574593;Taip;14;0;1;15
917;Bitutė;Kiškučių;8799003374;Taip;7;0;1;8
918;Bitutė;Kiškučių;4639968278;Taip;0;18;0;18
919;Bitutė;Kiškučių;4845620063;Taip;15;0;0;15
920;Bitutė;Kiškučių;7272922948;Ne;0;0;1;1
921;Bitutė;"Viščiukų ";9521938997;Taip;6;0;1;7
922;Bitutė;"Viščiukų ";1218462939;Ne;4;0;1;5
923;Bitutė;"Viščiukų ";6035394425;Taip;0;2;0;2
924;Bitutė;"Viščiukų ";5471241132;Taip;0;3;1;4
925;Bitutė;"Viščiukų ";7095475821;Taip;7;0;0;7
926;Bitutė;"Viščiukų ";7132616264;Taip;5;6;0;11
927;Bitutė;"Viščiukų ";6455582149;Taip;7;0;1;8
928;Bitutė;"Viščiukų ";4884898917;Taip;7;5;0;12
929;Bitutė;"Viščiukų ";6030674568;Taip;0;0;1;1
930;Bitutė;"Viščiukų ";6840722112;Taip;5;0;0;5
931;Bitutė;"Viščiukų ";8796728627;Taip;0;6;0;6
932;Bitutė;"Viščiukų ";9668365838;Taip;3;0;0;3
933;Bitutė;"Skruzdėliukai ";5686278261;Taip;5;0;0;5
934;Bitutė;"Skruzdėliukai ";5942493696;Taip;3;0;0;3
935;Bitutė;"Skruzdėliukai ";6311396261;Taip;9;0;1;10
936;Bitutė;"Skruzdėliukai ";5188828679;Taip;0;8;0;8
937;Bitutė;"Skruzdėliukai ";8109028957;Taip;0;8;0;8
938;Bitutė;"Skruzdėliukai ";7145036085;Taip;0;0;3;3
939;Bitutė;"Skruzdėliukai ";2144568225;Taip;0;0;6;6
940;Bitutė;"Skruzdėliukai ";2252157473;Taip;5;0;6;11
941;Bitutė;"Skruzdėliukai ";6169426273;Taip;10;0;0;10
942;Bitutė;"Skruzdėliukai ";4513783927;Ne;8;0;1;9
943;Bitutė;"Skruzdėliukai ";8667259778;Taip;0;0;1;1
944;Bitutė;"Skruzdėliukai ";8607718704;Ne;0;1;0;1
945;Bitutė;"Skruzdėliukai ";4413880918;Taip;5;0;4;9
946;Bitutė;"Skruzdėliukai ";9436414962;Taip;7;0;5;12
947;Bitutė;"Skruzdėliukai ";9864771568;Taip;0;0;3;3
948;Bitutė;"Skruzdėliukai ";6353690252;Taip;9;2;5;16
949;Bitutė;"Skruzdėliukai ";2160735504;Taip;5;0;0;5
950;Bitutė;"Skruzdėliukai ";3156654672;Ne;3;0;4;7
951;Bitutė;"Skruzdėliukai ";7245807233;Taip;18;0;0;18
952;Bitutė;"Skruzdėliukai ";4467090141;Taip;4;0;0;4
953;Bitutė;"Nykštukų ";1024559742;Taip;11;0;3;14
954;Bitutė;"Nykštukų ";8962725357;Taip;3;0;0;3
955;Bitutė;"Nykštukų ";5759595005;Taip;12;0;0;12
956;Bitutė;"Nykštukų ";6325890676;Taip;5;0;3;8
957;Bitutė;"Nykštukų ";1558826102;Taip;0;5;0;5
958;Bitutė;"Nykštukų ";2029309955;Taip;9;0;0;9
959;Bitutė;"Nykštukų ";2085899696;Taip;10;0;0;10
960;Bitutė;"Nykštukų ";6534527571;Taip;10;6;0;16
961;Bitutė;"Nykštukų ";5845408472;Taip;7;0;1;8
962;Bitutė;"Nykštukų ";8181348948;Ne;11;0;0;11
963;Bitutė;"Nykštukų ";3611348253;Ne;9;0;1;10
964;Bitutė;"Nykštukų ";8727525320;Ne;4;0;2;6
965;Bitutė;"Nykštukų ";5796600501;Taip;0;1;1;2
966;Bitutė;"Nykštukų ";2748400429;Taip;12;0;0;12
967;Bitutė;"Nykštukų ";9094567866;Taip;0;0;1;1
968;Bitutė;"Nykštukų ";5278510767;Taip;5;2;0;7
969;Bitutė;"Nykštukų ";4471813998;Taip;3;0;0;3
970;Coliukė;DRUGELIAI;6725408547;Taip;0;9;0;9
971;Coliukė;DRUGELIAI;9885547263;Taip;5;0;0;5
972;Coliukė;DRUGELIAI;5139645108;Taip;0;7;0;7
973;Coliukė;DRUGELIAI;9462610674;Taip;0;2;0;2
974;Coliukė;DRUGELIAI;2167230398;Taip;15;0;0;15
975;Coliukė;DRUGELIAI;9331485675;Ne;2;0;0;2
976;Coliukė;DRUGELIAI;2275327607;Taip;0;1;1;2
977;Coliukė;DRUGELIAI;4845247006;Taip;8;4;0;12
978;Coliukė;DRUGELIAI;9334564869;Taip;10;1;0;11
979;Coliukė;DRUGELIAI;3719547522;Ne;5;0;0;5
980;Coliukė;DRUGELIAI;9083546061;Taip;0;1;0;1
981;Coliukė;DRUGELIAI;8715608220;Taip;5;1;0;6
982;Coliukė;DRUGELIAI;3384332079;Ne;15;0;0;15
983;Coliukė;DRUGELIAI;5018335921;Taip;3;0;0;3
984;Coliukė;DRUGELIAI;2469993058;Ne;10;0;0;10
985;Coliukė;DRUGELIAI;7216221020;Taip;0;6;0;6
986;Coliukė;DRUGELIAI;8149118599;Ne;5;0;0;5
987;Coliukė;DRUGELIAI;7358018315;Taip;4;0;2;6
988;Coliukė;BITUTĖS;82989338835;Taip;0;8;0;8
989;Coliukė;BITUTĖS;1960898805;Ne;0;5;0;5
990;Coliukė;BITUTĖS;58421006265;Taip;0;7;0;7
991;Coliukė;BITUTĖS;9311775782;Taip;6;1;0;7
992;Coliukė;BITUTĖS;36554487034;Taip;0;3;0;3
993;Coliukė;BITUTĖS;7920728387;Taip;0;2;0;2
994;Coliukė;BITUTĖS;4408284518;Taip;0;11;0;11
995;Coliukė;BITUTĖS;1458763954;Taip;0;1;0;1
996;Coliukė;BITUTĖS;1968467455;Ne;5;0;0;5
997;Coliukė;BITUTĖS;3919482569;Ne;0;1;0;1
998;Coliukė;BITUTĖS;1328505569;Ne;6;3;0;9
999;Coliukė;BITUTĖS;4645245689;Taip;0;1;0;1
1000;Coliukė;BITUTĖS;6011110970;Ne;0;6;0;6
1001;Coliukė;BITUTĖS;8835394030;Taip;0;5;0;5
1002;Coliukė;BITUTĖS;3427704550;Taip;0;1;0;1
1003;Coliukė;BITUTĖS;8767261039;Taip;0;1;0;1
1004;Coliukė;VABALIUKAI;62876576078;Taip;0;6;0;6
1005;Coliukė;VABALIUKAI;33587152454;Ne;0;6;0;6
1006;Coliukė;VABALIUKAI;4649987214;Taip;0;2;0;2
1007;Coliukė;VABALIUKAI;1476750428;Ne;0;1;0;1
1008;Coliukė;VABALIUKAI;5596775091;Ne;6;0;0;6
1009;Coliukė;VABALIUKAI;6333099356;Taip;0;2;0;2
1010;Coliukė;VABALIUKAI;9526108197;Ne;6;2;0;8
1011;Coliukė;VABALIUKAI;2363472917;Ne;12;0;0;12
1012;Coliukė;VABALIUKAI;4739310916;Taip;6;5;0;11
1013;Coliukė;VABALIUKAI;1318558913;Taip;0;0;2;2
1014;Coliukė;VABALIUKAI;7622526793;Taip;0;5;0;5
1015;Coliukė;VABALIUKAI;4626722910;Taip;9;0;3;12
1016;Coliukė;VABALIUKAI;6475497234;Ne;6;0;0;6
1017;Coliukė;VABALIUKAI;4493314926;Taip;13;0;0;13
1018;Coliukė;VABALIUKAI;3905904092;Ne;9;0;1;10
1019;Coliukė;VABALIUKAI;8521846076;Ne;11;5;0;16
1020;Coliukė;VABALIUKAI;1105879142;Taip;10;0;2;12
1021;Coliukė;VABALIUKAI;9879369365;Taip;7;1;0;8
1022;Coliukė;NYKŠTUKAI;2168987649;Ne;3;0;0;3
1023;Coliukė;NYKŠTUKAI;2684151591;Ne;7;6;0;13
1024;Coliukė;NYKŠTUKAI;4499924331;Taip;0;1;0;1
1025;Coliukė;NYKŠTUKAI;7566429633;Taip;0;3;0;3
1026;Coliukė;NYKŠTUKAI;7670166244;Taip;0;6;0;6
1027;Coliukė;NYKŠTUKAI;4845049639;Taip;6;0;2;8
1028;Coliukė;NYKŠTUKAI;1537341012;Ne;3;14;2;19
1029;Coliukė;NYKŠTUKAI;6403149921;Ne;7;0;5;12
1030;Coliukė;NYKŠTUKAI;1600495468;Ne;5;9;0;14
1031;Coliukė;NYKŠTUKAI;6781303455;Taip;5;3;0;8
1032;Coliukė;NYKŠTUKAI;7502911642;Taip;5;8;0;13
1033;Coliukė;NYKŠTUKAI;7993975989;Ne;8;4;0;12
1034;Coliukė;NYKŠTUKAI;7870865302;Ne;10;0;0;10
1035;Coliukė;NYKŠTUKAI;1263306271;Ne;5;0;0;5
1036;Coliukė;NYKŠTUKAI;3493175211;Taip;5;5;0;10
1037;Coliukė;NYKŠTUKAI;6984254334;Taip;12;0;0;12
1038;Coliukė;NYKŠTUKAI;6441253648;Ne;7;0;0;7
1039;Coliukė;NYKŠTUKAI;5450167562;Taip;4;1;0;5
1040;Coliukė;NYKŠTUKAI;9693392372;Ne;0;1;8;9
1041;Coliukė;NYKŠTUKAI;1198781036;Ne;0;1;1;2
1042;Coliukė;GĖLYTĖS;4881447596;Ne;3;3;0;6
1043;Coliukė;GĖLYTĖS;9750447455;Ne;10;5;0;15
1044;Coliukė;GĖLYTĖS;2385917598;Ne;5;0;1;6
1045;Coliukė;GĖLYTĖS;3628571567;Taip;5;5;0;10
1046;Coliukė;GĖLYTĖS;8478006305;Ne;6;0;1;7
1047;Coliukė;GĖLYTĖS;6781663126;Ne;5;0;2;7
1048;Coliukė;GĖLYTĖS;9107676840;Ne;10;0;0;10
1049;Coliukė;GĖLYTĖS;7345905007;Ne;3;1;0;4
1050;Coliukė;"BORUŽĖLĖS (SPEC.)";2080118127;Taip;10;0;0;10
1051;Coliukė;"BORUŽĖLĖS (SPEC.)";2617816991;Ne;5;2;0;7
1052;Coliukė;"BORUŽĖLĖS (SPEC.)";9368334915;Taip;9;3;0;12
1053;Coliukė;"BORUŽĖLĖS (SPEC.)";1233731506;Ne;13;0;0;13
1054;Coliukė;"BORUŽĖLĖS (SPEC.)";5706671963;Taip;13;0;0;13
1055;Coliukė;"BORUŽĖLĖS (SPEC.)";4961762841;Ne;5;0;0;5
1056;Coliukė;"BORUŽĖLĖS (SPEC.)";6920961967;Taip;0;3;0;3
1057;Coliukė;"BORUŽĖLĖS (SPEC.)";1134875499;Ne;7;0;1;8
1058;Coliukė;"BORUŽĖLĖS (SPEC.)";2351866339;Taip;5;0;1;6
1059;Coliukė;"BORUŽĖLĖS (SPEC.)";21764273722;Taip;0;3;0;3
1060;Coliukė;"BORUŽĖLĖS (SPEC.)";5756690199;Ne;10;0;0;10
1061;Coliukė;"BORUŽĖLĖS (SPEC.)";6972921877;Ne;9;0;0;9
1062;Čiauškutis;BITUTĖS;7893181156;Taip;1;0;1;2
1063;Čiauškutis;BITUTĖS;7976738303;Ne;5;0;1;6
1064;Čiauškutis;BITUTĖS;7477630138;Taip;13;0;0;13
1065;Čiauškutis;BITUTĖS;4026881335;Taip;0;0;10;10
1066;Čiauškutis;BITUTĖS;9753680961;Taip;0;1;1;2
1067;Čiauškutis;BITUTĖS;4852837431;Taip;4;0;1;5
1068;Čiauškutis;BITUTĖS;3837360101;Taip;5;0;2;7
1069;Čiauškutis;BITUTĖS;2319237497;Taip;7;0;1;8
1070;Čiauškutis;BITUTĖS;1765857419;Taip;10;0;0;10
1071;Čiauškutis;ŽVIRBLIUKAI;4037117222;Taip;0;0;3;3
1072;Čiauškutis;ŽVIRBLIUKAI;3490305325;Taip;8;0;4;12
1073;Čiauškutis;ŽVIRBLIUKAI;2633243682;Taip;5;0;1;6
1074;Čiauškutis;ŽVIRBLIUKAI;7009893338;Taip;10;0;0;10
1075;Čiauškutis;ŽVIRBLIUKAI;7654242839;Ne;5;0;2;7
1076;Čiauškutis;ŽVIRBLIUKAI;5957587644;Taip;0;0;6;6
1077;Čiauškutis;ŽVIRBLIUKAI;1733251156;Ne;0;1;1;2
1078;Čiauškutis;ŽVIRBLIUKAI;5575614158;Taip;7;0;7;14
1079;Čiauškutis;SAULUTĖS;1503190001;Taip;0;0;2;2
1080;Čiauškutis;SAULUTĖS;22717947028;Taip;0;7;0;7
1081;Čiauškutis;SAULUTĖS;2099735647;Taip;0;0;6;6
1082;Čiauškutis;SAULUTĖS;72264057427;Taip;0;14;1;15
1083;Čiauškutis;SAULUTĖS;1849532875;Ne;0;0;1;1
1084;Čiauškutis;SAULUTĖS;1621605644;Taip;11;0;0;11
1085;Čiauškutis;SAULUTĖS;4917339896;Taip;4;1;0;5
1086;Čiauškutis;SAULUTĖS;4898534899;Ne;0;6;0;6
1087;Čiauškutis;SAULUTĖS;2030362509;Ne;0;2;0;2
1088;Čiauškutis;EŽIUKAI;7746580858;Taip;7;0;0;7
1089;Čiauškutis;EŽIUKAI;2686038029;Taip;0;0;4;4
1090;Čiauškutis;EŽIUKAI;1928404791;Taip;0;1;0;1
1091;Čiauškutis;EŽIUKAI;7489733038;Ne;0;0;1;1
1092;Čiauškutis;EŽIUKAI;7239878097;Taip;8;1;3;12
1093;Čiauškutis;EŽIUKAI;5910818962;Ne;11;0;0;11
1094;Čiauškutis;DRUGELIAI;7080320173;Taip;5;1;0;6
1095;Čiauškutis;DRUGELIAI;7312776041;Ne;3;1;1;5
1096;Čiauškutis;DRUGELIAI;9072764004;Ne;11;0;2;13
1097;Čiauškutis;DRUGELIAI;1036358147;Taip;10;0;0;10
1098;Čiauškutis;DRUGELIAI;1750040659;Taip;0;1;0;1
1099;Čiauškutis;DRUGELIAI;8346845876;Taip;0;0;1;1
1100;Čiauškutis;DRUGELIAI;98579606504;Taip;8;0;0;8
1101;Čiauškutis;DRUGELIAI;3724324861;Taip;0;1;0;1
1102;Čiauškutis;DRUGELIAI;2237570705;Taip;0;1;4;5
1103;Čiauškutis;GENELIAI;54635137954;Taip;0;0;6;6
1104;Čiauškutis;GENELIAI;1732370199;Ne;12;0;2;14
1105;Čiauškutis;GENELIAI;5900996969;Taip;2;0;0;2
1106;Čiauškutis;GENELIAI;1804509009;Taip;0;0;1;1
1107;Čiauškutis;GENELIAI;3370047940;Taip;0;0;3;3
1108;Čiauškutis;GENELIAI;31203540590;Taip;0;0;2;2
1109;Čiauškutis;GENELIAI;1422589887;Taip;0;0;3;3
1110;Čiauškutis;GENELIAI;8709039752;Taip;8;0;4;12
1111;Čiauškutis;GENELIAI;46847640903;Taip;13;0;0;13
1112;Čiauškutis;LINKSMUČIAI;3499391608;Taip;0;1;0;1
1113;Čiauškutis;LINKSMUČIAI;30480486366;Taip;5;0;1;6
1114;Čiauškutis;LINKSMUČIAI;1443155220;Ne;0;5;0;5
1115;Čiauškutis;LINKSMUČIAI;8808041204;Taip;5;0;0;5
1116;Čiauškutis;LINKSMUČIAI;95770489933;Taip;0;0;4;4
1117;Čiauškutis;LINKSMUČIAI;5513758257;Taip;7;0;0;7
1118;Čiauškutis;LINKSMUČIAI;6572444114;Taip;1;0;1;2
1119;Čiauškutis;LINKSMUČIAI;7060197354;Taip;0;0;8;8
1120;Čiauškutis;LINKSMUČIAI;1480363762;Taip;0;2;0;2
1121;Čiauškutis;KIŠKUČIAI;2218793969;Taip;5;1;1;7
1122;Čiauškutis;KIŠKUČIAI;6115354862;Taip;0;0;3;3
1123;Čiauškutis;KIŠKUČIAI;5759367884;Taip;0;1;2;3
1124;Čiauškutis;KIŠKUČIAI;1456067541;Taip;5;0;1;6
1125;Čiauškutis;KIŠKUČIAI;7367933940;Taip;5;0;0;5
1126;Čiauškutis;KIŠKUČIAI;7440425102;Ne;4;1;0;5
1127;Čiauškutis;KIŠKUČIAI;4658994599;Taip;4;0;0;4
1128;Čiauškutis;LAPIUKAI;60265156684;Taip;4;0;1;5
1129;Čiauškutis;LAPIUKAI;8857039064;Taip;0;1;0;1
1130;Čiauškutis;LAPIUKAI;1657452686;Ne;11;0;1;12
1131;Čiauškutis;LAPIUKAI;43313173294;Taip;0;0;2;2
1132;Čiauškutis;LAPIUKAI;1739403100;Taip;0;0;4;4
1133;Čiauškutis;LAPIUKAI;9897499968;Taip;6;4;0;10
1134;Čiauškutis;MEŠKUČIAI;5857013272;Taip;0;0;8;8
1135;Čiauškutis;MEŠKUČIAI;7135435979;Ne;10;0;1;11
1136;Čiauškutis;MEŠKUČIAI;7274368180;Taip;0;0;2;2
1137;Čiauškutis;MEŠKUČIAI;6146321785;Taip;0;0;2;2
1138;Čiauškutis;MEŠKUČIAI;6434727608;Taip;12;4;0;16
1139;Čiauškutis;MEŠKUČIAI;7526975680;Ne;0;8;0;8
1140;Čiauškutis;MEŠKUČIAI;2172687454;Taip;7;0;0;7
1141;Čiauškutis;PELĖDŽIUKAI;9228568063;Ne;9;0;1;10
1142;Čiauškutis;PELĖDŽIUKAI;1561833758;Taip;4;0;2;6
1143;Čiauškutis;PELĖDŽIUKAI;3700692073;Taip;7;0;0;7
1144;Čiauškutis;PELĖDŽIUKAI;3833382641;Taip;5;0;0;5
1145;Čiauškutis;PELĖDŽIUKAI;5854702576;Taip;0;0;6;6
1146;Čiauškutis;PELĖDŽIUKAI;6615319751;Taip;0;0;20;20
1147;Čiauškutis;PELĖDŽIUKAI;2377986721;Ne;15;0;0;15
1148;Čiauškutis;PELĖDŽIUKAI;5446546214;Taip;0;0;1;1
1149;Čiauškutis;NYKŠTUKAI;8030685444;Ne;0;8;0;8
1150;Čiauškutis;NYKŠTUKAI;1533938659;Ne;3;0;0;3
1151;Čiauškutis;NYKŠTUKAI;8689127061;Taip;0;6;0;6
1152;Čiauškutis;NYKŠTUKAI;1224986101;Taip;11;5;0;16
1153;Delfinukas;Boružėlių;7224966634;Taip;14;0;0;14
1154;Delfinukas;Boružėlių;4196156707;Taip;3;0;1;4
1155;Delfinukas;Boružėlių;8411289299;Taip;4;1;0;5
1156;Delfinukas;Boružėlių;3365778697;Taip;0;0;21;21
1157;Delfinukas;Boružėlių;9514189769;Taip;0;4;0;4
1158;Delfinukas;Boružėlių;9184207705;Ne;0;4;5;9
1159;Delfinukas;Boružėlių;6938708939;Taip;0;1;0;1
1160;Delfinukas;Boružėlių;9898427089;Ne;0;2;0;2
1161;Delfinukas;Boružėlių;6604115681;Taip;17;1;0;18
1162;Delfinukas;Boružėlių;2730512600;Ne;0;4;0;4
1163;Delfinukas;Boružėlių;8884939114;Taip;0;1;0;1
1164;Delfinukas;Boružėlių;2819680099;Taip;0;2;0;2
1165;Delfinukas;Boružėlių;3205671100;Taip;0;2;0;2
1166;Delfinukas;Boružėlių;1119373532;Ne;8;0;0;8
1167;Delfinukas;Boružėlių;4488260667;Taip;0;2;0;2
1168;Delfinukas;Boružėlių;6325092903;Taip;0;2;0;2
1169;Delfinukas;Boružėlių;5990192934;Taip;3;2;0;5
1170;Delfinukas;Saulytės;8315269427;Taip;5;0;9;14
1171;Delfinukas;Saulytės;4215887291;Taip;0;1;0;1
1172;Delfinukas;Saulytės;3631520143;Taip;11;0;0;11
1173;Delfinukas;Saulytės;9424966984;Taip;5;0;2;7
1174;Delfinukas;Saulytės;6069600728;Taip;7;0;7;14
1175;Delfinukas;Saulytės;9729550922;Taip;0;6;0;6
1176;Delfinukas;Saulytės;1404270345;Taip;3;0;2;5
1177;Delfinukas;Saulytės;3842160990;Taip;3;2;0;5
1178;Delfinukas;Saulytės;8402529296;Taip;11;1;0;12
1179;Delfinukas;Saulytės;5125346405;Taip;7;0;0;7
1180;Delfinukas;Saulytės;5642328792;Taip;0;2;0;2
1181;Delfinukas;Saulytės;8176576958;Taip;9;0;1;10
1182;Delfinukas;Saulytės;8275943176;Taip;2;0;2;4
1183;Delfinukas;Saulytės;2062677955;Taip;0;0;3;3
1184;Delfinukas;Saulytės;8085530134;Taip;15;0;0;15
1185;Delfinukas;Saulytės;8148610460;Taip;0;2;1;3
1186;Delfinukas;Saulytės;6935992202;Taip;11;0;0;11
1187;Delfinukas;Saulytės;8186312409;Taip;0;14;0;14
1188;Delfinukas;Saulytės;7904803011;Taip;9;1;0;10
1189;Delfinukas;Pelėdžiukų;8774145277;Taip;0;8;0;8
1190;Delfinukas;Pelėdžiukų;1395257200;Taip;1;2;0;3
1191;Delfinukas;Pelėdžiukų;3770227955;Taip;2;0;0;2
1192;Delfinukas;Pelėdžiukų;6113662246;Taip;8;1;0;9
1193;Delfinukas;Pelėdžiukų;1526129772;Taip;9;0;0;9
1194;Delfinukas;Pelėdžiukų;8659309242;Taip;0;1;0;1
1195;Delfinukas;Pelėdžiukų;8267992425;Taip;0;1;0;1
1196;Delfinukas;Pelėdžiukų;4096274346;Taip;5;1;0;6
1197;Delfinukas;Pelėdžiukų;5246300518;Taip;6;3;0;9
1198;Delfinukas;Pelėdžiukų;8107171123;Taip;0;0;11;11
1199;Delfinukas;Pelėdžiukų;3702341009;Taip;9;1;0;10
1200;Delfinukas;Pelėdžiukų;2420308954;Taip;11;0;0;11
1201;Delfinukas;Pelėdžiukų;6286748047;Taip;2;0;0;2
1202;Delfinukas;Pelėdžiukų;8432654056;Taip;5;0;3;8
1203;Delfinukas;Varliukų;1153333591;Ne;0;3;0;3
1204;Delfinukas;Varliukų;1091165849;Taip;0;0;1;1
1205;Delfinukas;Varliukų;9573336239;Taip;3;0;0;3
1206;Delfinukas;Varliukų;1251961268;Taip;5;1;0;6
1207;Delfinukas;Varliukų;1789047913;Taip;0;10;4;14
1208;Delfinukas;Varliukų;1194444282;Ne;0;10;0;10
1209;Delfinukas;Varliukų;9347513042;Taip;0;2;3;5
1210;Delfinukas;Varliukų;8875479631;Taip;0;8;0;8
1211;Delfinukas;Varliukų;3955783379;Ne;6;1;0;7
1212;Delfinukas;Varliukų;9502789660;Taip;0;0;2;2
1213;Delfinukas;Varliukų;3489297719;Taip;0;9;2;11
1214;Delfinukas;Varliukų;1948438336;Ne;0;10;0;10
1215;Delfinukas;Varliukų;9266646602;Taip;10;0;1;11
1216;Delfinukas;Varliukų;3674481373;Taip;0;3;0;3
1217;Delfinukas;Varliukų;9516852657;Taip;0;2;6;8
1218;Delfinukas;Varliukų;1338476746;Taip;0;2;0;2
1219;Delfinukas;Varliukų;60320557464;Ne;1;0;0;1
1220;Delfinukas;Varliukų;46276990963;Taip;0;2;0;2
1221;Delfinukas;Varliukų;7528505426;Ne;3;1;0;4
1222;Delfinukas;Varpelių;3093606855;Ne;6;0;0;6
1223;Delfinukas;Varpelių;2531571615;Taip;0;2;0;2
1224;Delfinukas;Varpelių;1325054642;Ne;0;3;0;3
1225;Delfinukas;Varpelių;7163839896;Ne;0;1;0;1
1226;Delfinukas;Varpelių;7493037613;Ne;0;1;0;1
1227;Delfinukas;Varpelių;4239224971;Taip;0;0;6;6
1228;Delfinukas;Varpelių;1650166115;Ne;0;10;0;10
1229;Delfinukas;Varpelių;5123666058;Taip;7;0;0;7
1230;Delfinukas;Varpelių;4713803167;Ne;0;6;0;6
1231;Delfinukas;Varpelių;8936645508;Taip;0;2;0;2
1232;Delfinukas;Varpelių;3818558339;Ne;4;9;0;13
1233;Delfinukas;Varpelių;4877757730;Ne;4;0;2;6
1234;Delfinukas;Varpelių;7973858761;Ne;4;0;2;6
1235;Delfinukas;Varpelių;3562066765;Ne;10;2;0;12
1236;Delfinukas;Delfinukai;3239635507;Taip;0;0;1;1
1237;Delfinukas;Delfinukai;5339993544;Taip;5;0;1;6
1238;Delfinukas;Delfinukai;6929926768;Taip;10;2;0;12
1239;Delfinukas;Delfinukai;5557399916;Taip;4;0;1;5
1240;Delfinukas;Delfinukai;5179080544;Ne;9;0;4;13
1241;Delfinukas;Delfinukai;7727263761;Taip;2;0;2;4
1242;Delfinukas;Delfinukai;9941631164;Taip;0;0;2;2
1243;Delfinukas;Delfinukai;8081895401;Taip;5;0;1;6
1244;Delfinukas;Delfinukai;7310363229;Ne;16;0;2;18
1245;Delfinukas;Delfinukai;5600320855;Ne;0;14;0;14
1246;Delfinukas;Drugeliai;2402204674;Taip;2;0;1;3
1247;Delfinukas;Drugeliai;6561536457;Ne;0;0;5;5
1248;Delfinukas;Drugeliai;2701448160;Taip;5;0;2;7
1249;Delfinukas;Drugeliai;6201567680;Taip;5;0;1;6
1250;Delfinukas;Drugeliai;1672021829;Ne;0;0;1;1
1251;Delfinukas;Drugeliai;9921730735;Taip;17;1;0;18
1252;Delfinukas;Drugeliai;1000049779;Taip;0;0;3;3
1253;Delfinukas;Drugeliai;3071312399;Ne;4;0;5;9
1254;Delfinukas;Drugeliai;1160537966;Taip;7;1;0;8
1255;Delfinukas;Drugeliai;1430155044;Taip;0;2;1;3
1256;Delfinukas;Drugeliai;1188049956;Taip;0;0;1;1
1257;Delfinukas;Drugeliai;6700068320;Taip;0;0;3;3
1258;Delfinukas;Drugeliai;9099945815;Ne;0;14;0;14
1259;Delfinukas;Drugeliai;1212995285;Taip;6;0;3;9
1260;Delfinukas;Drugeliai;7277680544;Taip;0;2;1;3
1261;Delfinukas;Drugeliai;1293348150;Ne;0;0;1;1
1262;Delfinukas;Drugeliai;1364873935;Ne;0;0;1;1
1263;Delfinukas;Drugeliai;5912904296;Ne;8;0;0;8
1264;Delfinukas;Drugeliai;6325235208;Ne;0;0;1;1
1265;Delfinukas;Žuvytės;6572690788;Taip;0;2;0;2
1266;Delfinukas;Žuvytės;9520598359;Ne;3;1;0;4
1267;Delfinukas;Žuvytės;3804996594;Taip;0;1;0;1
1268;Delfinukas;Žuvytės;1136182876;Taip;1;6;0;7
1269;Delfinukas;Žuvytės;7873373923;Taip;0;0;7;7
1270;Delfinukas;Žuvytės;2066127119;Taip;3;1;0;4
1271;Delfinukas;Žuvytės;7487111570;Ne;0;3;2;5
1272;Delfinukas;Žuvytės;6844500395;Taip;0;2;1;3
1273;Delfinukas;Žuvytės;9074294473;Taip;0;2;10;12
1274;Delfinukas;Žuvytės;2445742257;Taip;0;21;0;21
1275;Delfinukas;Žuvytės;9934325492;Taip;2;0;0;2
1276;Delfinukas;Žuvytės;8160982025;Taip;0;4;0;4
1277;Delfinukas;Žuvytės;6949000708;Taip;0;0;6;6
1278;Delfinukas;Žuvytės;6322255194;Taip;0;8;1;9
1279;Delfinukas;Žuvytės;9898412288;Taip;0;2;5;7
1280;Delfinukas;Žuvytės;6445868759;Taip;3;2;2;7
1281;Delfinukas;Žuvytės;6578506861;Taip;4;0;0;4
1282;Delfinukas;Delfinai;2890469172;Ne;15;0;0;15
1283;Delfinukas;Delfinai;9628317328;Taip;0;0;3;3
1284;Delfinukas;Delfinai;8038737019;Ne;5;0;0;5
1285;Delfinukas;Delfinai;5797308373;Taip;0;4;0;4
1286;Delfinukas;Delfinai;6337962165;Taip;3;1;0;4
1287;Delfinukas;Delfinai;5241426445;Taip;12;2;1;15
1288;Delfinukas;Delfinai;8099120371;Taip;5;0;0;5
1289;Delfinukas;Delfinai;3108430680;Taip;0;5;0;5
1290;Delfinukas;Delfinai;2382077576;Taip;9;0;0;9
1291;Delfinukas;Delfinai;1200205376;Taip;15;0;0;15
1292;Delfinukas;Delfinai;7629622746;Ne;6;1;0;7
1293;Delfinukas;Delfinai;4347116918;Taip;6;0;1;7
1294;Delfinukas;Delfinai;2784942324;Taip;0;1;0;1
1295;Delfinukas;Delfinai;6270012707;Taip;12;0;3;15
1296;Delfinukas;Delfinai;8085481968;Taip;0;10;0;10
1297;Delfinukas;Delfinai;9605756229;Taip;9;0;0;9
1298;Delfinukas;Delfinai;3407321091;Taip;0;1;0;1
1299;Delfinukas;Paukšteliai;7609115506;Taip;0;0;1;1
1300;Delfinukas;Paukšteliai;6873181103;Ne;2;0;0;2
1301;Delfinukas;Paukšteliai;5060445169;Taip;0;2;0;2
1302;Delfinukas;Paukšteliai;6992505341;Ne;0;2;19;21
1303;Delfinukas;Paukšteliai;9927854348;Taip;7;1;0;8
1304;Delfinukas;Paukšteliai;8028279246;Taip;1;10;0;11
1305;Delfinukas;Paukšteliai;9592384914;Taip;0;0;3;3
1306;Delfinukas;Paukšteliai;2985669766;Taip;0;0;6;6
1307;Delfinukas;Paukšteliai;8328481987;Ne;14;0;0;14
1308;Delfinukas;Paukšteliai;9635669748;Ne;10;0;0;10
1309;Delfinukas;Paukšteliai;8526813977;Taip;10;0;0;10
1310;Delfinukas;Paukšteliai;6457042338;Taip;6;2;5;13
1311;Delfinukas;Paukšteliai;3134897964;Taip;2;2;5;9
1312;Delfinukas;Paukšteliai;3796051179;Ne;4;6;0;10
1313;Delfinukas;Kiškučiai;2094258481;Taip;0;2;4;6
1314;Delfinukas;Kiškučiai;4119370256;Taip;15;1;0;16
1315;Delfinukas;Kiškučiai;9663975293;Taip;15;0;2;17
1316;Delfinukas;Kiškučiai;9602317911;Taip;0;2;0;2
1317;Delfinukas;Kiškučiai;8625023976;Taip;1;1;2;4
1318;Delfinukas;Kiškučiai;6352250868;Ne;9;0;0;9
1319;Delfinukas;Kiškučiai;3284212595;Taip;7;0;1;8
1320;Delfinukas;Kiškučiai;6531930806;Ne;0;2;0;2
1321;Delfinukas;Kiškučiai;8076961367;Ne;0;2;2;4
1322;Delfinukas;Kiškučiai;8439204095;Taip;6;0;0;6
1323;Delfinukas;Kiškučiai;5783537897;Taip;0;0;2;2
1324;Delfinukas;Kiškučiai;5794346039;Ne;15;1;0;16
1325;Delfinukas;Kiškučiai;7638190553;Ne;6;5;0;11
1326;Delfinukas;Kiškučiai;1153948822;Ne;0;1;0;1
1327;Delfinukas;Kiškučiai;2010703982;Ne;0;1;0;1
1328;Delfinukas;Kiškučiai;8728791932;Taip;13;0;0;13
1329;Delfinukas;Kiškučiai;9662566992;Taip;0;5;0;5
1330;Delfinukas;Kiškučiai;2883959240;Ne;10;2;4;16
1331;Delfinukas;Kiškučiai;4179507316;Ne;6;0;0;6
1332;Delfinukas;Kiškučiai;8440546956;Taip;13;0;0;13
1333;Drevinukas;ZUIKUČIAI;5679723776;Taip;0;0;1;1
1334;Drevinukas;ZUIKUČIAI;7753238387;Taip;0;0;1;1
1335;Drevinukas;ZUIKUČIAI;8936058501;Taip;0;0;1;1
1336;Drevinukas;ZUIKUČIAI;8611131264;Taip;0;0;1;1
1337;Drevinukas;ZUIKUČIAI;6833120798;Taip;0;0;1;1
1338;Drevinukas;ZUIKUČIAI;7607135647;Taip;0;0;1;1
1339;Drevinukas;ZUIKUČIAI;3392249574;Ne;0;0;3;3
1340;Drevinukas;ZUIKUČIAI;7642022439;Ne;0;0;2;2
1341;Drevinukas;ZUIKUČIAI;6582186497;Ne;0;0;2;2
1342;Drevinukas;ZUIKUČIAI;7753238387;Taip;0;0;1;1
1343;Drevinukas;ZUIKUČIAI;6833120798;Taip;0;0;1;1
1344;Drevinukas;ZUIKUČIAI;7607135647;Taip;0;0;1;1
1345;Drevinukas;ZUIKUČIAI;3032536983;Taip;4;0;2;6
1346;Drevinukas;ZUIKUČIAI;5524567803;Taip;0;5;0;5
1347;Drevinukas;ZUIKUČIAI;2929598743;Taip;0;3;0;3
1348;Drevinukas;ZUIKUČIAI;4076576850;Taip;0;0;20;20
1349;Drevinukas;ZUIKUČIAI;6373230526;Taip;14;0;0;14
1350;Drevinukas;ZUIKUČIAI;4312429104;Taip;0;0;2;2
1351;Drevinukas;ZUIKUČIAI;6316000019;Taip;0;0;3;3
1352;Drevinukas;ZUIKUČIAI;4404254932;Taip;0;0;1;1
1353;Drevinukas;ZUIKUČIAI;1859208322;Taip;2;0;2;4
1354;Drevinukas;ZUIKUČIAI;8984653958;Taip;0;2;0;2
1355;Drevinukas;ZUIKUČIAI;2281463885;Ne;4;0;1;5
1356;Drevinukas;ZUIKUČIAI;4662426451;Taip;0;0;3;3
1357;Drevinukas;ZUIKUČIAI;5875459639;Taip;0;15;2;17
1358;Drevinukas;ZUIKUČIAI;7218201733;Taip;9;0;2;11
1359;Drevinukas;BORUŽĖLĖS;7519369167;Taip;0;0;1;1
1360;Drevinukas;BORUŽĖLĖS;1123115847;Taip;0;0;1;1
1361;Drevinukas;BORUŽĖLĖS;9336227821;Taip;0;0;1;1
1362;Drevinukas;BORUŽĖLĖS;4784716615;Taip;0;0;1;1
1363;Drevinukas;BORUŽĖLĖS;2070374746;Taip;0;0;1;1
1364;Drevinukas;BORUŽĖLĖS;9803670483;Taip;0;0;1;1
1365;Drevinukas;BORUŽĖLĖS;16952164778;Taip;0;1;0;1
1366;Drevinukas;BORUŽĖLĖS;3657451903;Taip;0;0;1;1
1367;Drevinukas;BORUŽĖLĖS;8180027849;Taip;0;0;1;1
1368;Drevinukas;BORUŽĖLĖS;4332606643;Ne;0;0;1;1
1369;Drevinukas;BORUŽĖLĖS;7632515230;Taip;0;0;1;1
1370;Drevinukas;BORUŽĖLĖS;1019214451;Taip;0;0;1;1
1371;Drevinukas;BORUŽĖLĖS;9336227821;Taip;0;0;1;1
1372;Drevinukas;BORUŽĖLĖS;4784716615;Taip;0;0;1;1
1373;Drevinukas;BORUŽĖLĖS;9803670483;Taip;0;0;1;1
1374;Drevinukas;BORUŽĖLĖS;16952164778;Taip;0;1;0;1
1375;Drevinukas;BORUŽĖLĖS;3657451903;Taip;0;0;1;1
1376;Drevinukas;BORUŽĖLĖS;8180027849;Taip;0;0;1;1
1377;Drevinukas;BORUŽĖLĖS;4332606643;Ne;0;0;1;1
1378;Drevinukas;BORUŽĖLĖS;2935175014;Taip;0;0;10;10
1379;Drevinukas;BORUŽĖLĖS;5348609358;Taip;11;2;0;13
1380;Drevinukas;BORUŽĖLĖS;1098647410;Taip;0;0;3;3
1381;Drevinukas;BORUŽĖLĖS;2312241894;Taip;4;0;1;5
1382;Drevinukas;BORUŽĖLĖS;5394143000;Taip;2;3;0;5
1383;Drevinukas;BORUŽĖLĖS;4260123123;Taip;0;6;1;7
1384;Drevinukas;BORUŽĖLĖS;3871506691;Taip;0;2;1;3
1385;Drevinukas;BORUŽĖLĖS;6914111231;Taip;0;2;1;3
1386;Drevinukas;BORUŽĖLĖS;3046196006;Taip;0;6;1;7
1387;Drevinukas;BORUŽĖLĖS;3377957769;Ne;0;0;1;1
1388;Drevinukas;BORUŽĖLĖS;7334626684;Taip;0;0;5;5
1389;Drevinukas;BORUŽĖLĖS;2423143170;Taip;0;0;3;3
1390;Drevinukas;BORUŽĖLĖS;1343431478;Taip;0;2;0;2
1391;Drevinukas;BORUŽĖLĖS;8262224710;Taip;5;3;0;8
1392;Drevinukas;SMALSUČIAI;1644656704;Taip;0;0;1;1
1393;Drevinukas;SMALSUČIAI;5673244101;Taip;0;0;1;1
1394;Drevinukas;SMALSUČIAI;1564065835;Taip;0;1;0;1
1395;Drevinukas;SMALSUČIAI;8143614891;Ne;0;1;0;1
1396;Drevinukas;SMALSUČIAI;4262951360;Taip;0;0;1;1
1397;Drevinukas;SMALSUČIAI;5323434566;Taip;0;0;1;1
1398;Drevinukas;SMALSUČIAI;3725760478;Ne;0;0;1;1
1399;Drevinukas;SMALSUČIAI;6243097297;Taip;0;0;8;8
1400;Drevinukas;SMALSUČIAI;7054681115;Taip;0;0;1;1
1401;Drevinukas;SMALSUČIAI;1094428951;Taip;0;0;2;2
1402;Drevinukas;SMALSUČIAI;5704489483;Taip;0;0;5;5
1403;Drevinukas;SMALSUČIAI;5928234487;Taip;0;0;2;2
1404;Drevinukas;SMALSUČIAI;8143614891;Ne;0;1;0;1
1405;Drevinukas;SMALSUČIAI;4262951360;Taip;0;0;1;1
1406;Drevinukas;SMALSUČIAI;1564065835;Taip;0;1;0;1
1407;Drevinukas;SMALSUČIAI;3725760478;Ne;0;0;1;1
1408;Drevinukas;SMALSUČIAI;5323434566;Taip;0;0;1;1
1409;Drevinukas;SMALSUČIAI;3293457412;Taip;0;0;2;2
1410;Drugelis;NYKŠTUKŲ;9316073597;Taip;0;1;0;1
1411;Drugelis;NYKŠTUKŲ;3551095669;Taip;0;1;0;1
1412;Drugelis;NYKŠTUKŲ;1785724340;Taip;0;10;0;10
1413;Drugelis;NYKŠTUKŲ;6632884258;Taip;0;3;8;11
1414;Drugelis;NYKŠTUKŲ;7447519502;Taip;0;1;0;1
1415;Drugelis;NYKŠTUKŲ;4523513611;Taip;4;1;0;5
1416;Drugelis;NYKŠTUKŲ;6594452094;Taip;5;4;0;9
1417;Drugelis;NYKŠTUKŲ;7477547789;Taip;5;2;0;7
1418;Drugelis;NYKŠTUKŲ;8752459733;Taip;10;1;0;11
1419;Drugelis;NYKŠTUKŲ;8717445483;Taip;0;9;0;9
1420;Drugelis;NYKŠTUKŲ;4158475365;Ne;0;1;0;1
1421;Drugelis;NYKŠTUKŲ;4867387611;Taip;10;10;0;20
1422;Drugelis;NYKŠTUKŲ;7609530453;Taip;0;5;0;5
1423;Drugelis;NYKŠTUKŲ;8070030439;Taip;0;5;0;5
1424;Drugelis;NYKŠTUKŲ;3061896520;Taip;0;5;0;5
1425;Drugelis;NYKŠTUKŲ;4927896706;Ne;0;1;0;1
1426;Drugelis;NYKŠTUKŲ;5692743298;Taip;0;0;1;1
1427;Drugelis;NYKŠTUKŲ;6452921695;Taip;1;0;0;1
1428;Drugelis;NYKŠTUKŲ;5902687211;Taip;0;0;2;2
1429;Drugelis;NYKŠTUKŲ;8591548746;Taip;0;0;2;2
1430;Drugelis;NYKŠTUKŲ;6321332888;Ne;0;13;0;13
1431;Drugelis;SMALSUČIŲ;3096906506;Taip;0;11;0;11
1432;Drugelis;SMALSUČIŲ;1856912386;Ne;7;1;2;10
1433;Drugelis;SMALSUČIŲ;1255315664;Taip;1;1;0;2
1434;Drugelis;SMALSUČIŲ;68223183150;Taip;6;2;2;10
1435;Drugelis;SMALSUČIŲ;3479833265;Taip;0;0;1;1
1436;Drugelis;SMALSUČIŲ;3202149560;Taip;0;1;0;1
1437;Drugelis;SMALSUČIŲ;27569805506;Taip;0;4;0;4
1438;Drugelis;SMALSUČIŲ;1901608445;Taip;0;1;6;7
1439;Drugelis;SMALSUČIŲ;1843605624;Taip;0;3;3;6
1440;Drugelis;SMALSUČIŲ;1506988472;Taip;0;2;0;2
1441;Drugelis;SMALSUČIŲ;1991420008;Taip;0;1;0;1
1442;Drugelis;SMALSUČIŲ;1421438458;Ne;0;1;0;1
1443;Drugelis;SMALSUČIŲ;53874036107;Taip;0;2;0;2
1444;Drugelis;SMALSUČIŲ;4788423265;Taip;0;0;1;1
1445;Drugelis;SMALSUČIŲ;1541276266;Taip;0;1;0;1
1446;Drugelis;SMALSUČIŲ;5954059321;Ne;9;1;2;12
1447;Drugelis;SMALSUČIŲ;1217635751;Taip;0;0;14;14
1448;Drugelis;SMALSUČIŲ;7406396614;Taip;0;3;0;3
1449;Drugelis;MUMINUKŲ;7390061272;Taip;8;0;0;8
1450;Drugelis;MUMINUKŲ;3311620018;Ne;0;1;0;1
1451;Drugelis;MUMINUKŲ;8812550811;Taip;5;1;0;6
1452;Drugelis;MUMINUKŲ;5661335344;Taip;0;7;0;7
1453;Drugelis;MUMINUKŲ;3085309902;Ne;6;0;1;7
1454;Drugelis;MUMINUKŲ;9345527734;Taip;0;1;0;1
1455;Drugelis;MUMINUKŲ;6038184222;Taip;4;0;0;4
1456;Drugelis;MUMINUKŲ;3037496936;Taip;0;21;0;21
1457;Drugelis;MUMINUKŲ;9851124145;Taip;5;0;0;5
1458;Drugelis;MUMINUKŲ;7253876812;Taip;4;0;0;4
1459;Drugelis;MUMINUKŲ;1666992752;Taip;5;0;2;7
1460;Drugelis;MUMINUKŲ;9510744779;Taip;2;1;0;3
1461;Drugelis;MUMINUKŲ;9029137302;Taip;6;0;0;6
1462;Drugelis;MUMINUKŲ;9907121223;Taip;3;0;1;4
1463;Drugelis;MUMINUKŲ;8500348389;Taip;2;1;0;3
1464;Drugelis;MUMINUKŲ;1858504360;Taip;5;0;0;5
1465;Drugelis;MUMINUKŲ;8366330478;Taip;0;0;1;1
1466;Drugelis;MUMINUKŲ;8107970910;Taip;7;6;0;13
1467;Drugelis;MUMINUKŲ;5515894973;Taip;0;1;0;1
1468;Drugelis;MUMINUKŲ;8282807535;Taip;5;0;0;5
1469;Drugelis;MUMINUKŲ;3293212749;Taip;0;4;0;4
1470;Drugelis;MUMINUKŲ;2256221485;Taip;3;2;0;5
1471;Drugelis;PŪKUOTUKAI;3156382280;Taip;0;1;0;1
1472;Drugelis;PŪKUOTUKAI;26436464504;Taip;0;5;0;5
1473;Drugelis;PŪKUOTUKAI;1657445173;Taip;0;1;1;2
1474;Drugelis;PŪKUOTUKAI;27379769302;Taip;0;0;1;1
1475;Drugelis;PŪKUOTUKAI;91538620813;Taip;0;1;0;1
1476;Drugelis;PŪKUOTUKAI;1162058481;Taip;0;2;1;3
1477;Drugelis;PŪKUOTUKAI;1667056936;Taip;0;18;0;18
1478;Drugelis;PŪKUOTUKAI;63777226415;Taip;0;1;0;1
1479;Drugelis;PŪKUOTUKAI;1005872691;Taip;3;3;0;6
1480;Drugelis;PŪKUOTUKAI;3403116175;Taip;10;0;7;17
1481;Drugelis;PŪKUOTUKAI;1546655542;Taip;10;1;0;11
1482;Drugelis;PŪKUOTUKAI;1160161173;Taip;0;1;0;1
1483;Drugelis;PŪKUOTUKAI;48956671934;Taip;15;1;0;16
1484;Drugelis;PŪKUOTUKAI;9149748841;Ne;15;1;0;16
1485;Drugelis;SPINDULIUKAI;6890441262;Taip;0;21;0;21
1486;Drugelis;SPINDULIUKAI;2196445523;Taip;3;3;1;7
1487;Drugelis;SPINDULIUKAI;3645668411;Taip;5;3;1;9
1488;Drugelis;SPINDULIUKAI;3261462674;Taip;3;3;1;7
1489;Drugelis;SPINDULIUKAI;5533529267;Taip;4;1;0;5
1490;Drugelis;SPINDULIUKAI;8965139441;Taip;0;2;2;4
1491;Drugelis;SPINDULIUKAI;9066572677;Taip;4;0;0;4
1492;Drugelis;SPINDULIUKAI;2217868951;Taip;0;3;5;8
1493;Drugelis;SPINDULIUKAI;2644563881;Taip;0;6;0;6
1494;Drugelis;SPINDULIUKAI;9650052415;Taip;4;0;1;5
1495;Drugelis;KIŠKUČIAI;8962657389;Taip;0;1;0;1
1496;Drugelis;KIŠKUČIAI;4628926113;Taip;2;0;0;2
1497;Drugelis;KIŠKUČIAI;7307032077;Taip;0;1;0;1
1498;Drugelis;KIŠKUČIAI;6980045156;Taip;8;0;0;8
1499;Drugelis;KIŠKUČIAI;4871624566;Taip;0;0;1;1
1500;Drugelis;KIŠKUČIAI;4805858183;Taip;12;0;0;12
1501;Drugelis;KIŠKUČIAI;1213610973;Taip;6;0;1;7
1502;Drugelis;KIŠKUČIAI;2269864490;Taip;5;0;0;5
1503;Drugelis;KIŠKUČIAI;9211760307;Taip;5;0;0;5
1504;Drugelis;KIŠKUČIAI;6071997970;Taip;5;2;0;7
1505;Drugelis;KIŠKUČIAI;8819853863;Taip;10;0;0;10
1506;Drugelis;KIŠKUČIAI;4058293462;Taip;0;0;1;1
1507;Drugelis;KIŠKUČIAI;6533325098;Taip;0;3;0;3
1508;Drugelis;KIŠKUČIAI;4898099506;Ne;0;1;2;3
1509;"Du gaideliai";Uodelių;8042203623;Taip;0;1;0;1
1510;"Du gaideliai";Uodelių;9585785202;Ne;0;5;0;5
1511;"Du gaideliai";Uodelių;5611102395;Ne;11;0;0;11
1512;"Du gaideliai";Uodelių;3019797369;Taip;5;0;0;5
1513;"Du gaideliai";Uodelių;2845145754;Taip;0;2;7;9
1514;"Du gaideliai";Uodelių;7726490359;Taip;15;1;0;16
1515;"Du gaideliai";Uodelių;5728374219;Taip;0;2;0;2
1516;"Du gaideliai";Uodelių;8410547195;Ne;9;0;0;9
1517;"Du gaideliai";Uodelių;2905083899;Ne;7;0;0;7
1518;"Du gaideliai";Uodelių;1156396094;Taip;1;12;0;13
1519;"Du gaideliai";Uodelių;9356275460;Taip;0;0;3;3
1520;"Du gaideliai";Uodelių;6120647567;Taip;0;6;0;6
1521;"Du gaideliai";Uodelių;8043896286;Taip;0;0;2;2
1522;"Du gaideliai";Uodelių;6015360076;Taip;0;13;0;13
1523;"Du gaideliai";Uodelių;5801081015;Taip;15;0;0;15
1524;"Du gaideliai";Uodelių;7391278306;Ne;0;0;6;6
1525;"Du gaideliai";OŽIUKŲ;2240947701;Taip;0;0;2;2
1526;"Du gaideliai";OŽIUKŲ;3507387826;Ne;0;8;0;8
1527;"Du gaideliai";OŽIUKŲ;4144269068;Taip;0;2;0;2
1528;"Du gaideliai";OŽIUKŲ;1785976627;Taip;0;0;2;2
1529;"Du gaideliai";OŽIUKŲ;5894974508;Taip;0;1;0;1
1530;"Du gaideliai";OŽIUKŲ;5652662610;Taip;0;0;3;3
1531;"Du gaideliai";OŽIUKŲ;5103483956;Taip;0;2;0;2
1532;"Du gaideliai";OŽIUKŲ;1268479215;Taip;0;2;0;2
1533;"Du gaideliai";OŽIUKŲ;3854355215;Ne;0;12;3;15
1534;"Du gaideliai";OŽIUKŲ;3849899284;Ne;10;0;0;10
1535;"Du gaideliai";OŽIUKŲ;2262425557;Ne;5;11;0;16
1536;"Du gaideliai";OŽIUKŲ;8744467866;Ne;0;0;3;3
1537;"Du gaideliai";OŽIUKŲ;7033276798;Taip;6;4;0;10
1538;"Du gaideliai";OŽIUKŲ;8047413507;Taip;0;0;2;2
1539;"Du gaideliai";OŽIUKŲ;5998344519;Taip;0;14;0;14
1540;"Du gaideliai";OŽIUKŲ;6870356241;Taip;3;1;0;4
1541;"Du gaideliai";OŽIUKŲ;5788923258;Taip;0;2;0;2
1542;"Du gaideliai";OŽIUKŲ;1751328192;Ne;6;0;0;6
1543;"Du gaideliai";Vištyčių;1758546983;Ne;0;9;0;9
1544;"Du gaideliai";Vištyčių;7783203480;Taip;0;0;1;1
1545;"Du gaideliai";Vištyčių;94639433266;Ne;0;2;0;2
1546;"Du gaideliai";Vištyčių;9324740716;Taip;7;3;0;10
1547;"Du gaideliai";Vištyčių;6715434585;Ne;5;2;0;7
1548;"Du gaideliai";Vištyčių;7084763712;Taip;5;1;0;6
1549;"Du gaideliai";Vištyčių;1500684755;Taip;5;7;0;12
1550;"Du gaideliai";Vištyčių;4387568448;Taip;6;10;0;16
1551;"Du gaideliai";Vištyčių;6750787450;Taip;0;2;0;2
1552;"Du gaideliai";Vištyčių;5430986033;Taip;0;1;0;1
1553;"Du gaideliai";Vištyčių;1549762923;Ne;0;0;6;6
1554;"Du gaideliai";Vištyčių;2159833613;Taip;0;16;0;16
1555;"Du gaideliai";Vištyčių;3771563320;Ne;4;0;0;4
1556;"Du gaideliai";Vištyčių;6203383711;Taip;5;3;0;8
1557;"Du gaideliai";Vištyčių;1557413692;Taip;0;5;0;5
1558;"Du gaideliai";Vištyčių;3560637865;Taip;0;3;0;3
1559;"Du gaideliai";Vištyčių;3216423543;Taip;0;0;1;1
1560;"Du gaideliai";Vištyčių;1135098595;Taip;0;5;0;5
1561;"Du gaideliai";Vištyčių;3370029981;Taip;0;5;0;5
1562;"Du gaideliai";Vištyčių;7373413569;Taip;0;2;0;2
1563;"Du gaideliai";GAIDŽIUKŲ;13384312035;Taip;0;0;1;1
1564;"Du gaideliai";GAIDŽIUKŲ;1906486044;Taip;0;1;0;1
1565;"Du gaideliai";GAIDŽIUKŲ;1923863232;Taip;0;2;2;4
1566;"Du gaideliai";GAIDŽIUKŲ;1291620608;Taip;5;4;1;10
1567;"Du gaideliai";GAIDŽIUKŲ;1304400387;Taip;0;0;1;1
1568;"Du gaideliai";GAIDŽIUKŲ;73447542654;Taip;1;0;0;1
1569;"Du gaideliai";GAIDŽIUKŲ;1261678548;Ne;10;0;2;12
1570;"Du gaideliai";GAIDŽIUKŲ;1128234653;Taip;2;1;1;4
1571;"Du gaideliai";GAIDŽIUKŲ;14681393632;Taip;0;2;0;2
1572;"Du gaideliai";GAIDŽIUKŲ;1628346439;Taip;0;6;0;6
1573;"Du gaideliai";GAIDŽIUKŲ;25738622801;Taip;0;0;2;2
1574;"Du gaideliai";GAIDŽIUKŲ;50087080642;Taip;0;0;2;2
1575;"Du gaideliai";GAIDŽIUKŲ;1479672134;Taip;5;1;0;6
1576;"Du gaideliai";GAIDŽIUKŲ;1791530261;Taip;0;10;0;10
1577;"Du gaideliai";GAIDŽIUKŲ;1512578437;Ne;5;0;0;5
1578;"Du gaideliai";Musyčių;4408537397;Taip;8;0;0;8
1579;"Du gaideliai";Musyčių;9374869616;Ne;0;0;1;1
1580;"Du gaideliai";Musyčių;5726096980;Ne;5;0;1;6
1581;"Du gaideliai";Musyčių;1527839162;Taip;0;0;3;3
1582;"Du gaideliai";Musyčių;5809089345;Taip;0;7;0;7
1583;"Du gaideliai";Musyčių;1968978650;Taip;3;10;0;13
1584;"Du gaideliai";Musyčių;9126780620;Taip;0;0;1;1
1585;"Du gaideliai";Musyčių;7193151965;Ne;4;0;0;4
1586;"Du gaideliai";Musyčių;9798727946;Ne;0;0;5;5
1587;"Du gaideliai";MALŪNO;4799107717;Taip;0;2;0;2
1588;"Du gaideliai";MALŪNO;3654057453;Taip;10;0;0;10
1589;"Du gaideliai";MALŪNO;9506572113;Taip;5;0;0;5
1590;"Du gaideliai";MALŪNO;5291934919;Taip;10;0;0;10
1591;"Du gaideliai";MALŪNO;8174023197;Ne;7;0;0;7
1592;"Du gaideliai";MALŪNO;7372149799;Taip;0;3;0;3
1593;Eglutė;BORUŽIUKAI;5407757245;Taip;0;6;0;6
1594;Eglutė;BORUŽIUKAI;7831541089;Taip;0;9;0;9
1595;Eglutė;BORUŽIUKAI;9964146295;Taip;6;1;1;8
1596;Eglutė;BORUŽIUKAI;1420067187;Taip;2;1;0;3
1597;Eglutė;BORUŽIUKAI;5875585426;Taip;0;7;0;7
1598;"Geniukų kalvė";SAULUTĖS;9557055841;Ne;15;0;0;15
1599;"Geniukų kalvė";SAULUTĖS;3111400962;Taip;10;0;2;12
1600;"Geniukų kalvė";SAULUTĖS;4329782598;Taip;0;9;0;9
1601;"Geniukų kalvė";SAULUTĖS;8932671578;Taip;0;11;5;16
1602;"Geniukų kalvė";SAULUTĖS;9711047774;Taip;0;0;1;1
1603;"Geniukų kalvė";SAULUTĖS;1910363787;Taip;3;2;0;5
1604;"Geniukų kalvė";SAULUTĖS;7940706717;Taip;0;0;3;3
1605;"Geniukų kalvė";SAULUTĖS;9522911738;Taip;3;1;1;5
1606;"Geniukų kalvė";SAULUTĖS;4603185679;Taip;14;0;0;14
1607;"Geniukų kalvė";SAULUTĖS;5348211316;Taip;0;9;4;13
1608;"Geniukų kalvė";SAULUTĖS;7886553419;Taip;0;2;1;3
1609;"Geniukų kalvė";SAULUTĖS;6384832317;Taip;0;4;9;13
1610;"Geniukų kalvė";SAULUTĖS;4946218794;Taip;0;0;1;1
1611;"Geniukų kalvė";SAULUTĖS;4525874796;Taip;0;0;2;2
1612;"Geniukų kalvė";SAULUTĖS;7289942679;Ne;10;6;0;16
1613;"Geniukų kalvė";SAULUTĖS;4745451344;Taip;7;6;0;13
1614;"Geniukų kalvė";SAULUTĖS;9768077014;Taip;0;3;0;3
1615;"Geniukų kalvė";SAULUTĖS;7889781552;Taip;0;0;2;2
1616;"Geniukų kalvė";SAULUTĖS;3889643236;Taip;11;0;2;13
1617;"Geniukų kalvė";SAULUTĖS;6102906310;Taip;0;0;1;1
1618;"Geniukų kalvė";SAULUTĖS;6016735700;Taip;0;0;2;2
1619;"Geniukų kalvė";BITUTĖS;7745656622;Ne;0;13;0;13
1620;"Geniukų kalvė";BITUTĖS;6520429663;Taip;0;5;0;5
1621;"Geniukų kalvė";BITUTĖS;6466912385;Taip;0;5;0;5
1622;"Geniukų kalvė";BITUTĖS;2718961466;Taip;3;1;0;4
1623;"Geniukų kalvė";BITUTĖS;4967513360;Ne;10;1;0;11
1624;"Geniukų kalvė";BITUTĖS;2016254460;Taip;0;5;0;5
1625;"Geniukų kalvė";BITUTĖS;5776314197;Taip;0;11;0;11
1626;"Geniukų kalvė";BITUTĖS;1897809684;Taip;0;1;0;1
1627;"Geniukų kalvė";BITUTĖS;4105170344;Taip;0;1;0;1
1628;"Geniukų kalvė";BITUTĖS;8872900558;Taip;0;2;0;2
1629;"Geniukų kalvė";BITUTĖS;6511955882;Taip;0;1;0;1
1630;"Geniukų kalvė";BITUTĖS;6500641378;Taip;0;11;0;11
1631;"Geniukų kalvė";BITUTĖS;2143334688;Taip;0;1;0;1
1632;"Geniukų kalvė";BITUTĖS;3984265624;Taip;0;5;0;5
1633;"Geniukų kalvė";BITUTĖS;4813232640;Taip;0;0;1;1
1634;"Geniukų kalvė";BITUTĖS;9676782662;Taip;1;0;0;1
1635;"Geniukų kalvė";BITUTĖS;2031800114;Taip;0;2;3;5
1636;"Geniukų kalvė";BITUTĖS;2233161242;Taip;1;0;0;1
1637;"Geniukų kalvė";KIŠKUČIAI;1568133009;Ne;11;2;0;13
1638;"Geniukų kalvė";KIŠKUČIAI;4758435835;Taip;3;4;0;7
1639;"Geniukų kalvė";KIŠKUČIAI;2729442911;Ne;0;2;0;2
1640;"Geniukų kalvė";KIŠKUČIAI;4661051023;Taip;13;5;1;19
1641;"Geniukų kalvė";KIŠKUČIAI;23023070502;Taip;5;0;0;5
1642;"Geniukų kalvė";KIŠKUČIAI;2262014110;Taip;0;3;0;3
1643;"Geniukų kalvė";KIŠKUČIAI;1947173142;Taip;0;1;0;1
1644;"Geniukų kalvė";KIŠKUČIAI;2043786151;Taip;0;1;0;1
1645;"Geniukų kalvė";KIŠKUČIAI;8939171238;Ne;4;1;0;5
1646;"Geniukų kalvė";KIŠKUČIAI;2140334255;Taip;3;0;0;3
1647;"Geniukų kalvė";KIŠKUČIAI;2301758912;Taip;0;4;0;4
1648;"Geniukų kalvė";KIŠKUČIAI;8635708009;Taip;10;0;0;10
1649;"Geniukų kalvė";KIŠKUČIAI;9081596975;Taip;6;0;0;6
1650;"Geniukų kalvė";KIŠKUČIAI;30932565379;Taip;8;2;1;11
1651;"Geniukų kalvė";KIŠKUČIAI;2337226175;Taip;1;3;0;4
1652;"Geniukų kalvė";VYTURĖLIAI;1716204178;Taip;0;20;0;20
1653;"Geniukų kalvė";VYTURĖLIAI;83443339743;Taip;11;0;0;11
1654;"Geniukų kalvė";VYTURĖLIAI;3599151643;Taip;0;1;0;1
1655;"Geniukų kalvė";VYTURĖLIAI;3553253934;Taip;5;1;0;6
1656;"Geniukų kalvė";VYTURĖLIAI;1084055203;Taip;0;1;0;1
1657;"Geniukų kalvė";VYTURĖLIAI;1818485774;Taip;3;1;1;5
1658;"Geniukų kalvė";VYTURĖLIAI;1774738349;Taip;0;11;0;11
1659;"Geniukų kalvė";VYTURĖLIAI;88504194684;Taip;0;1;0;1
1660;"Geniukų kalvė";VYTURĖLIAI;75791398203;Taip;0;1;0;1
1661;"Geniukų kalvė";VYTURĖLIAI;2120890722;Taip;0;2;0;2
1662;"Geniukų kalvė";VYTURĖLIAI;54856843273;Taip;4;0;0;4
1663;"Geniukų kalvė";VYTURĖLIAI;2094764804;Taip;4;0;2;6
1664;"Geniukų kalvė";VYTURĖLIAI;1776042329;Taip;0;0;2;2
1665;"Geniukų kalvė";VYTURĖLIAI;26215340428;Taip;0;8;0;8
1666;"Geniukų kalvė";VYTURĖLIAI;87718471880;Taip;0;1;0;1
1667;"Geniukų kalvė";VYTURĖLIAI;90227736128;Taip;0;1;0;1
1668;"Geniukų kalvė";VYTURĖLIAI;37079991701;Taip;0;1;0;1
1669;"Geniukų kalvė";DRUGELIAI;45542289762;Taip;0;3;0;3
1670;"Geniukų kalvė";DRUGELIAI;2003986836;Taip;0;10;0;10
1671;"Geniukų kalvė";DRUGELIAI;19181427380;Taip;0;4;0;4
1672;"Geniukų kalvė";DRUGELIAI;5792552722;Taip;0;4;0;4
1673;"Geniukų kalvė";DRUGELIAI;1684481833;Taip;0;0;3;3
1674;"Geniukų kalvė";DRUGELIAI;14939415217;Taip;4;7;1;12
1675;"Geniukų kalvė";DRUGELIAI;82277353185;Taip;0;0;3;3
1676;"Geniukų kalvė";DRUGELIAI;1248190435;Taip;2;1;0;3
1677;"Geniukų kalvė";DRUGELIAI;90435684305;Taip;0;1;1;2
1678;"Geniukų kalvė";DRUGELIAI;67762121244;Ne;0;1;0;1
1679;"Geniukų kalvė";DRUGELIAI;1990303616;Taip;5;1;0;6
1680;"Geniukų kalvė";DRUGELIAI;23964009189;Taip;0;1;0;1
1681;"Geniukų kalvė";DRUGELIAI;6253940549;Taip;0;0;1;1
1682;"Geniukų kalvė";DRUGELIAI;93834840514;Taip;0;11;0;11
1683;"Geniukų kalvė";DRUGELIAI;44345867922;Taip;5;0;1;6
1684;"Geniukų kalvė";DRUGELIAI;97616612192;Ne;0;1;0;1
1685;"Geniukų kalvė";DRUGELIAI;1663744490;Taip;0;1;0;1
1686;"Geniukų kalvė";"SAULĖS ZUIKUČIAI";7033628178;Taip;1;0;0;1
1687;"Geniukų kalvė";"SAULĖS ZUIKUČIAI";7082945033;Taip;0;1;0;1
1688;"Geniukų kalvė";"SAULĖS ZUIKUČIAI";2313382307;Taip;0;0;3;3
1689;"Geniukų kalvė";"SAULĖS ZUIKUČIAI";8309953586;Taip;4;0;0;4
1690;"Geniukų kalvė";"SAULĖS ZUIKUČIAI";1443348537;Taip;5;0;0;5
1691;"Geniukų kalvė";"SAULĖS ZUIKUČIAI";2783285969;Taip;9;0;1;10
1692;"Geniukų kalvė";"SAULĖS ZUIKUČIAI";7500079028;Taip;0;0;3;3
1693;"Geniukų kalvė";"SAULĖS ZUIKUČIAI";8071493871;Taip;0;10;0;10
1694;"Geniukų kalvė";"SAULĖS ZUIKUČIAI";1718428600;Taip;3;0;0;3
1695;"Geniukų kalvė";"SAULĖS ZUIKUČIAI";6016585056;Taip;0;6;0;6
1696;"Geniukų kalvė";"SAULĖS ZUIKUČIAI";2816691996;Taip;9;1;0;10
1697;"Geniukų kalvė";"SAULĖS ZUIKUČIAI";5512172533;Ne;11;4;1;16
1698;"Geniukų kalvė";"SAULĖS ZUIKUČIAI";1375674317;Taip;0;1;0;1
1699;"Geniukų kalvė";"SAULĖS ZUIKUČIAI";4722801116;Taip;0;1;1;2
1700;"Geniukų kalvė";"SAULĖS ZUIKUČIAI";5763009912;Taip;0;1;0;1
1701;"Geniukų kalvė";"SAULĖS ZUIKUČIAI";5245434552;Taip;5;0;1;6
1702;"Geniukų kalvė";"SAULĖS ZUIKUČIAI";5725034297;Taip;6;1;0;7
1703;"Geniukų kalvė";"SAULĖS ZUIKUČIAI";4186376527;Taip;0;1;0;1
1704;"Geniukų kalvė";SMALSUČIAI;7915720190;Taip;13;0;1;14
1705;"Geniukų kalvė";SMALSUČIAI;5993223458;Taip;5;0;0;5
1706;"Geniukų kalvė";SMALSUČIAI;8985466295;Taip;5;0;0;5
1707;"Geniukų kalvė";SMALSUČIAI;2596680448;Taip;0;1;0;1
1708;"Geniukų kalvė";SMALSUČIAI;6730270449;Ne;0;0;2;2
1709;"Geniukų kalvė";SMALSUČIAI;6473724074;Taip;7;0;2;9
1710;"Geniukų kalvė";SMALSUČIAI;1896980533;Taip;4;0;2;6
1711;"Geniukų kalvė";SMALSUČIAI;3250913116;Taip;0;0;3;3
1712;"Geniukų kalvė";SMALSUČIAI;3627418555;Ne;0;0;5;5
1713;"Geniukų kalvė";SMALSUČIAI;9155681194;Taip;4;0;6;10
1714;"Geniukų kalvė";SMALSUČIAI;7440029486;Ne;0;0;1;1
1715;"Geniukų kalvė";SMALSUČIAI;6168422514;Taip;15;0;0;15
1716;"Geniukų kalvė";RUDNOSIUKAI;9696452101;Taip;0;13;0;13
1717;"Geniukų kalvė";RUDNOSIUKAI;5205178173;Taip;5;0;2;7
1718;"Geniukų kalvė";RUDNOSIUKAI;2836282651;Taip;0;0;1;1
1719;"Geniukų kalvė";RUDNOSIUKAI;9847003556;Taip;0;0;1;1
1720;"Geniukų kalvė";RUDNOSIUKAI;5443596677;Taip;8;0;0;8
1721;"Geniukų kalvė";RUDNOSIUKAI;7300853810;Taip;0;5;0;5
1722;"Geniukų kalvė";RUDNOSIUKAI;2839299179;Taip;0;1;0;1
1723;"Geniukų kalvė";RUDNOSIUKAI;4664026888;Taip;0;2;0;2
1724;"Geniukų kalvė";RUDNOSIUKAI;3852896932;Taip;5;0;3;8
1725;"Geniukų kalvė";RUDNOSIUKAI;2165793561;Taip;0;11;0;11
1726;"Geniukų kalvė";RUDNOSIUKAI;8973285553;Taip;0;10;2;12
1727;"Geniukų kalvė";RUDNOSIUKAI;5559324196;Taip;3;0;0;3
1728;"Geniukų kalvė";RUDNOSIUKAI;4985606198;Ne;1;0;3;4
1729;"Geniukų kalvė";RUDNOSIUKAI;3152130511;Taip;0;0;1;1
1730;"Geniukų kalvė";PELĖDŽIUKAI;2217221922;Taip;8;0;0;8
1731;"Geniukų kalvė";PELĖDŽIUKAI;3826265557;Taip;0;1;2;3
1732;"Geniukų kalvė";PELĖDŽIUKAI;8271041553;Ne;0;1;0;1
1733;"Geniukų kalvė";PELĖDŽIUKAI;1237228692;Taip;0;1;0;1
1734;"Geniukų kalvė";PELĖDŽIUKAI;2938446054;Taip;0;1;1;2
1735;"Geniukų kalvė";PELĖDŽIUKAI;3055777730;Taip;0;0;5;5
1736;"Geniukų kalvė";PELĖDŽIUKAI;9976423099;Taip;15;0;0;15
1737;"Geniukų kalvė";PELĖDŽIUKAI;1051563985;Taip;0;0;9;9
1738;"Geniukų kalvė";PELĖDŽIUKAI;6174114461;Ne;13;0;0;13
1739;"Geniukų kalvė";PELĖDŽIUKAI;2659298240;Taip;0;8;0;8
1740;"Geniukų kalvė";PELĖDŽIUKAI;6024288147;Taip;0;2;1;3
1741;"Geniukų kalvė";PELĖDŽIUKAI;6737863183;Taip;10;1;0;11
1742;"Geniukų kalvė";PELĖDŽIUKAI;5704223824;Taip;0;1;0;1
1743;"Geniukų kalvė";PELĖDŽIUKAI;1811866428;Ne;2;8;0;10
1744;"Geniukų kalvė";PELĖDŽIUKAI;6410008429;Taip;0;1;0;1
1745;"Geniukų kalvė";PELĖDŽIUKAI;4843411757;Taip;6;4;0;10
1746;"Geniukų kalvė";PELĖDŽIUKAI;8770345339;Taip;13;0;3;16
1747;"Geniukų kalvė";PELĖDŽIUKAI;5146141771;Taip;4;0;0;4
1748;"Geniukų kalvė";PELĖDŽIUKAI;1611845627;Taip;5;0;1;6
1749;"Geniukų kalvė";PELĖDŽIUKAI;9677583445;Ne;0;0;3;3
1750;"Geniukų kalvė";BORUŽĖLĖS;4958738745;Taip;0;3;0;3
1751;"Geniukų kalvė";BORUŽĖLĖS;9069256760;Ne;5;11;0;16
1752;"Geniukų kalvė";BORUŽĖLĖS;5161535756;Taip;0;1;0;1
1753;"Geniukų kalvė";BORUŽĖLĖS;7501831333;Taip;0;12;0;12
1754;"Geniukų kalvė";BORUŽĖLĖS;3085228868;Taip;0;1;0;1
1755;"Geniukų kalvė";BORUŽĖLĖS;2904091819;Ne;0;1;0;1
1756;"Geniukų kalvė";BORUŽĖLĖS;6794151223;Taip;0;1;0;1
1757;"Geniukų kalvė";BORUŽĖLĖS;4777155321;Taip;5;0;1;6
1758;"Geniukų kalvė";BORUŽĖLĖS;2180860623;Ne;0;2;0;2
1759;"Geniukų kalvė";BORUŽĖLĖS;2205515766;Taip;5;1;0;6
1760;"Geniukų kalvė";BORUŽĖLĖS;8769761434;Taip;0;4;1;5
1761;"Geniukų kalvė";BORUŽĖLĖS;1891205998;Ne;0;2;0;2
1762;"Geniukų kalvė";BORUŽĖLĖS;9643242164;Taip;2;4;0;6
1763;"Geniukų kalvė";BORUŽĖLĖS;2665955524;Taip;0;2;0;2
1764;"Geniukų kalvė";BORUŽĖLĖS;4872435715;Taip;2;0;1;3
1765;"Geniukų kalvė";BORUŽĖLĖS;3297360222;Taip;0;2;0;2
1766;"Geniukų kalvė";PAGRANDUKAI;6149037133;Taip;0;0;2;2
1767;"Geniukų kalvė";PAGRANDUKAI;4507631652;Taip;0;0;1;1
1768;"Geniukų kalvė";PAGRANDUKAI;9543553237;Ne;7;0;1;8
1769;"Geniukų kalvė";PAGRANDUKAI;2032408983;Ne;0;0;1;1
1770;"Geniukų kalvė";PAGRANDUKAI;2798750158;Taip;0;0;1;1
1771;"Geniukų kalvė";PAGRANDUKAI;9041901202;Ne;10;0;0;10
1772;"Geniukų kalvė";PAGRANDUKAI;5078771341;Taip;11;0;0;11
1773;"Geniukų kalvė";PAGRANDUKAI;9075192344;Taip;12;0;0;12
1774;"Geniukų kalvė";PAGRANDUKAI;9730758999;Taip;3;0;0;3
1775;"Geniukų kalvė";PAGRANDUKAI;4864216994;Taip;7;0;0;7
1776;"Geniukų kalvė";PAGRANDUKAI;5883913787;Taip;0;2;1;3
1777;"Geniukų kalvė";PAGRANDUKAI;4639389587;Taip;3;0;0;3
1778;"Geniukų kalvė";PAGRANDUKAI;7079072084;Taip;2;0;0;2
1779;"Geniukų kalvė";PAGRANDUKAI;9579750299;Taip;2;0;0;2
1780;"Geniukų kalvė";PAGRANDUKAI;4849740486;Ne;4;0;1;5
1781;"Geniukų kalvė";NYKŠTUKAI;4633553106;Taip;5;1;2;8
1782;"Geniukų kalvė";NYKŠTUKAI;7744441981;Taip;0;0;10;10
1783;"Geniukų kalvė";NYKŠTUKAI;1209268848;Taip;0;0;10;10
1784;"Geniukų kalvė";NYKŠTUKAI;2110578252;Taip;0;0;1;1
1785;"Geniukų kalvė";NYKŠTUKAI;6214681079;Taip;0;4;0;4
1786;"Geniukų kalvė";NYKŠTUKAI;3669378459;Taip;10;0;0;10
1787;"Geniukų kalvė";NYKŠTUKAI;4201333532;Taip;6;0;0;6
1788;"Geniukų kalvė";NYKŠTUKAI;7453065865;Taip;4;0;0;4
1789;"Geniukų kalvė";NYKŠTUKAI;8577323715;Taip;0;0;4;4
1790;"Geniukų kalvė";NYKŠTUKAI;7747615302;Taip;0;0;5;5
1791;"Geniukų kalvė";NYKŠTUKAI;6351861630;Taip;0;0;1;1
1792;"Geniukų kalvė";NYKŠTUKAI;4691978116;Taip;0;0;2;2
1793;Gelvonėlis;ĄŽUOLIUKAI;7919814808;Ne;0;1;0;1
1794;Gelvonėlis;ĄŽUOLIUKAI;9323579468;Taip;0;0;1;1
1795;Gelvonėlis;ĄŽUOLIUKAI;3830940009;Taip;4;2;0;6
1796;Gelvonėlis;ĄŽUOLIUKAI;2742000725;Taip;1;0;0;1
1797;Gelvonėlis;ĄŽUOLIUKAI;3147489259;Taip;0;7;0;7
1798;Gelvonėlis;ĄŽUOLIUKAI;1284359362;Taip;7;3;0;10
1799;Gelvonėlis;ĄŽUOLIUKAI;75676389361;Taip;0;0;7;7
1800;Gelvonėlis;ĄŽUOLIUKAI;2077783219;Taip;0;0;1;1
1801;Gelvonėlis;ĄŽUOLIUKAI;3089755141;Ne;0;7;0;7
1802;Gelvonėlis;ĄŽUOLIUKAI;1408313697;Taip;0;0;3;3
1803;Gelvonėlis;ĄŽUOLIUKAI;3670612781;Taip;3;0;0;3
1804;Gelvonėlis;ĄŽUOLIUKAI;69073786634;Taip;6;2;0;8
1805;Gelvonėlis;ĄŽUOLIUKAI;6255253658;Ne;0;0;1;1
1806;Gelvonėlis;ĄŽUOLIUKAI;5511174729;Taip;0;0;5;5
1807;Gelvonėlis;ĄŽUOLIUKAI;1624125024;Taip;5;0;1;6
1808;Gelvonėlis;ĄŽUOLIUKAI;4855800131;Ne;2;0;1;3
1809;Gelvonėlis;ŽVIRBLIUKAI;6604992169;Taip;0;10;1;11
1810;Gelvonėlis;ŽVIRBLIUKAI;6556472766;Taip;9;0;2;11
1811;Gelvonėlis;ŽVIRBLIUKAI;7182180008;Taip;7;2;1;10
1812;Gelvonėlis;ŽVIRBLIUKAI;8885088900;Taip;0;7;1;8
1813;Gelvonėlis;ŽVIRBLIUKAI;2400289466;Ne;0;0;1;1
1814;Gelvonėlis;ŽVIRBLIUKAI;5129492284;Taip;0;1;0;1
1815;Gelvonėlis;ŽVIRBLIUKAI;9493536517;Taip;5;0;1;6
1816;Gelvonėlis;ŽVIRBLIUKAI;9059244134;Taip;0;3;0;3
1817;Gelvonėlis;ŽVIRBLIUKAI;1987204544;Taip;0;7;0;7
1818;Gelvonėlis;ŽVIRBLIUKAI;2288951845;Taip;4;0;0;4
1819;Gelvonėlis;ŽVIRBLIUKAI;2515471132;Taip;6;0;7;13
1820;Gelvonėlis;ŽVIRBLIUKAI;1085845218;Taip;10;0;1;11
1821;Gelvonėlis;ŽVIRBLIUKAI;6319058542;Ne;0;3;0;3
1822;Gelvonėlis;ŽVIRBLIUKAI;9538571448;Taip;0;1;0;1
1823;Gelvonėlis;ŽVIRBLIUKAI;9147186080;Taip;5;5;1;11
1824;Gelvonėlis;ŽVIRBLIUKAI;7620280474;Taip;2;0;6;8
1825;Gelvonėlis;RASELĖS;9847156800;Ne;0;5;0;5
1826;Gelvonėlis;RASELĖS;9108760720;Taip;0;0;1;1
1827;Gelvonėlis;RASELĖS;9387523651;Ne;0;15;0;15
1828;Gelvonėlis;RASELĖS;1183745610;Taip;0;9;0;9
1829;Gelvonėlis;RASELĖS;1597669426;Taip;0;0;4;4
1830;Gelvonėlis;RASELĖS;30812081628;Taip;0;0;7;7
1831;Gelvonėlis;RASELĖS;6256962184;Taip;10;0;2;12
1832;Gelvonėlis;RASELĖS;91441127098;Taip;5;0;0;5
1833;Gelvonėlis;RASELĖS;1610362831;Ne;0;4;0;4
1834;Gelvonėlis;RASELĖS;12715604772;Taip;0;2;0;2
1835;Gelvonėlis;RASELĖS;8050788182;Ne;0;0;4;4
1836;Gelvonėlis;RASELĖS;4917453676;Ne;0;0;1;1
1837;Gelvonėlis;RASELĖS;31744699590;Ne;0;0;4;4
1838;Gelvonėlis;RASELĖS;1030246127;Taip;0;2;0;2
1839;Gelvonėlis;RASELĖS;6266298514;Ne;0;0;21;21
1840;Gelvonėlis;RASELĖS;9777094764;Taip;12;0;2;14
1841;Gelvonėlis;RASELĖS;3379601736;Taip;0;2;0;2
1842;Gelvonėlis;SAULUTĖ;1512245903;Taip;6;0;0;6
1843;Gelvonėlis;SAULUTĖ;3121251271;Taip;0;4;0;4
1844;Gelvonėlis;SAULUTĖ;8475204684;Taip;0;15;0;15
1845;Gelvonėlis;SAULUTĖ;2622967319;Taip;0;2;0;2
1846;Gelvonėlis;SAULUTĖ;4830374546;Taip;8;2;0;10
1847;Gelvonėlis;SAULUTĖ;8016643568;Ne;0;3;0;3
1848;Gelvonėlis;SAULUTĖ;1734685590;Ne;0;0;8;8
1849;Gelvonėlis;SAULUTĖ;7936622964;Taip;6;6;0;12
1850;Gelvonėlis;SAULUTĖ;7194091189;Ne;0;0;1;1
1851;Gelvonėlis;SAULUTĖ;3719670896;Taip;6;0;0;6
1852;Gelvonėlis;PELĖDŽIUKAI;1373771258;Taip;0;11;0;11
1853;Gelvonėlis;PELĖDŽIUKAI;1772713183;Taip;0;6;0;6
1854;Gelvonėlis;PELĖDŽIUKAI;2997738880;Ne;0;0;1;1
1855;Gelvonėlis;PELĖDŽIUKAI;1355742622;Ne;0;1;0;1
1856;Gelvonėlis;PELĖDŽIUKAI;23181505838;Taip;0;4;0;4
1857;Gelvonėlis;PELĖDŽIUKAI;21250325232;Ne;0;0;2;2
1858;Gelvonėlis;PELĖDŽIUKAI;2096702999;Taip;0;8;0;8
1859;Gelvonėlis;PELĖDŽIUKAI;9919860358;Taip;0;1;0;1
1860;Gelvonėlis;PELĖDŽIUKAI;1827511187;Taip;0;6;0;6
1861;Gelvonėlis;PELĖDŽIUKAI;87746258537;Taip;0;6;0;6
1862;Gelvonėlis;PELĖDŽIUKAI;9784762153;Taip;7;0;4;11
1863;Gelvonėlis;PELĖDŽIUKAI;90961913967;Taip;0;0;4;4
1864;Gelvonėlis;PELĖDŽIUKAI;6635285387;Taip;0;0;3;3
1865;Gelvonėlis;PELĖDŽIUKAI;17044138057;Taip;0;0;2;2
1866;Gelvonėlis;PELĖDŽIUKAI;41610307448;Taip;0;0;1;1
1867;Gelvonėlis;DRUGELIAI;5305480599;Taip;9;0;0;9
1868;Gelvonėlis;DRUGELIAI;5407639095;Taip;5;0;0;5
1869;Gelvonėlis;DRUGELIAI;5633162524;Taip;5;0;0;5
1870;Gelvonėlis;DRUGELIAI;8792171281;Taip;6;0;1;7
1871;Gelvonėlis;DRUGELIAI;5598186460;Taip;8;0;0;8
1872;Gelvonėlis;DRUGELIAI;4268590631;Taip;4;0;0;4
1873;Gelvonėlis;DRUGELIAI;3771796903;Ne;16;0;0;16
1874;Gelvonėlis;DRUGELIAI;1939318286;Taip;8;0;0;8
1875;Gelvonėlis;DRUGELIAI;5427943841;Taip;4;0;0;4
1876;Gelvonėlis;DRUGELIAI;3514762919;Taip;5;0;0;5
1877;Gelvonėlis;DRUGELIAI;3687250255;Taip;8;0;0;8
1878;Gelvonėlis;DRUGELIAI;5281400074;Taip;12;0;0;12
1879;Gelvonėlis;DRUGELIAI;2452711535;Taip;13;0;0;13
1880;Gelvonėlis;DRUGELIAI;1980703633;Taip;5;0;3;8
1881;Gelvonėlis;VARPELIAI;3059903126;Taip;2;0;0;2
1882;Gelvonėlis;VARPELIAI;3483144401;Taip;0;0;5;5
1883;Gelvonėlis;VARPELIAI;6451557430;Ne;5;7;0;12
1884;Gelvonėlis;VARPELIAI;6225854165;Taip;0;0;2;2
1885;Gelvonėlis;VARPELIAI;2791652988;Taip;9;0;0;9
1886;Gelvonėlis;VARPELIAI;2638430817;Ne;5;0;8;13
1887;Gelvonėlis;VARPELIAI;9600526942;Taip;5;12;0;17
1888;Gelvonėlis;VARPELIAI;1387948936;Taip;0;5;0;5
1889;Gelvonėlis;VARPELIAI;9650922918;Taip;0;2;0;2
1890;Gelvonėlis;VARPELIAI;1462716950;Taip;8;10;0;18
1891;Gelvonėlis;VARPELIAI;6949090250;Taip;0;0;1;1
1892;Gelvonėlis;VARPELIAI;9622818893;Taip;5;0;1;6
1893;Gelvonėlis;VARPELIAI;3446593424;Taip;17;0;0;17
1894;Gelvonėlis;VARPELIAI;6869418701;Taip;0;0;2;2
1895;Gelvonėlis;VARPELIAI;5207153784;Taip;5;3;0;8
1896;Gelvonėlis;VARPELIAI;9963769327;Taip;0;1;0;1
1897;Gelvonėlis;VARPELIAI;1346691585;Ne;5;0;0;5
1898;Gelvonėlis;BORUŽĖLĖS;8209225630;Taip;13;0;0;13
1899;Gelvonėlis;BORUŽĖLĖS;6554989142;Taip;16;0;2;18
1900;Gelvonėlis;BORUŽĖLĖS;8056058298;Ne;0;6;0;6
1901;Gelvonėlis;BORUŽĖLĖS;2698853686;Taip;0;1;0;1
1902;Gelvonėlis;BORUŽĖLĖS;4112607183;Taip;3;3;0;6
1903;Gelvonėlis;BORUŽĖLĖS;6585504578;Taip;18;1;0;19
1904;Gelvonėlis;BORUŽĖLĖS;6243360625;Taip;0;8;0;8
1905;Gelvonėlis;BORUŽĖLĖS;5790038422;Taip;0;5;0;5
1906;Gelvonėlis;BORUŽĖLĖS;1587584701;Taip;5;0;1;6
1907;Gelvonėlis;BORUŽĖLĖS;8515746171;Taip;2;2;1;5
1908;Gelvonėlis;BORUŽĖLĖS;6647585785;Taip;9;0;1;10
1909;Gelvonėlis;BORUŽĖLĖS;1107633909;Ne;0;6;0;6
1910;Gelvonėlis;BORUŽĖLĖS;8973272332;Taip;10;0;0;10
1911;Gelvonėlis;BORUŽĖLĖS;9849765037;Ne;0;2;0;2
1912;Gelvonėlis;BORUŽĖLĖS;4749071286;Taip;5;0;0;5
1913;Gelvonėlis;BORUŽĖLĖS;5311512721;Ne;8;0;1;9
1914;Gelvonėlis;BORUŽĖLĖS;8806934077;Taip;4;0;2;6
1915;Gelvonėlis;BORUŽĖLĖS;3926733474;Taip;4;0;3;7
1916;Gelvonėlis;NYKŠTUKAI;8987012601;Taip;12;0;0;12
1917;Gelvonėlis;NYKŠTUKAI;1112841066;Taip;15;0;0;15
1918;Gelvonėlis;NYKŠTUKAI;2553846157;Taip;0;0;2;2
1919;Gelvonėlis;NYKŠTUKAI;8003522011;Taip;0;1;3;4
1920;Gelvonėlis;NYKŠTUKAI;5713586282;Taip;7;0;2;9
1921;Gelvonėlis;NYKŠTUKAI;9136771401;Ne;5;0;0;5
1922;Gelvonėlis;NYKŠTUKAI;8560940316;Taip;8;0;0;8
1923;Gelvonėlis;NYKŠTUKAI;1002088496;Taip;11;0;2;13
1924;Gelvonėlis;NYKŠTUKAI;8019072199;Taip;7;0;2;9
1925;Gelvonėlis;NYKŠTUKAI;8124516993;Taip;14;0;0;14
1926;Gelvonėlis;NYKŠTUKAI;9751580494;Taip;3;0;1;4
1927;Gelvonėlis;NYKŠTUKAI;4156493586;Taip;5;0;0;5
1928;Gelvonėlis;NYKŠTUKAI;2115362442;Taip;5;0;0;5
1929;Gelvonėlis;BITUTĖS;7759317220;Ne;1;5;0;6
1930;Gelvonėlis;BITUTĖS;2504468098;Taip;4;8;0;12
1931;Gelvonėlis;BITUTĖS;7983982378;Taip;0;2;0;2
1932;Gelvonėlis;BITUTĖS;5721858659;Taip;0;4;0;4
1933;Gelvonėlis;BITUTĖS;9667024635;Taip;0;2;0;2
1934;Gelvonėlis;BITUTĖS;2108690954;Taip;5;0;2;7
1935;Gelvonėlis;BITUTĖS;1753617545;Taip;10;1;0;11
1936;Gelvonėlis;BITUTĖS;9184192787;Taip;0;0;1;1
1937;Gelvonėlis;BITUTĖS;9369121356;Ne;5;0;0;5
1938;Gelvonėlis;BITUTĖS;2119550116;Taip;0;1;1;2
1939;Gelvonėlis;BITUTĖS;7826522180;Ne;0;0;1;1
1940;Gelvonėlis;BITUTĖS;1516164123;Taip;0;4;0;4
1941;Gelvonėlis;BITUTĖS;3788522708;Ne;2;15;0;17
1942;Gelvonėlis;BITUTĖS;5047022305;Taip;6;2;0;8
1943;Gelvonėlis;BITUTĖS;43407309643;Ne;0;0;1;1
1944;Gelvonėlis;RAMUNĖLĖS;4111774915;Taip;0;3;0;3
1945;Gelvonėlis;RAMUNĖLĖS;5368171142;Taip;7;0;0;7
1946;Gelvonėlis;RAMUNĖLĖS;8222112564;Taip;0;5;0;5
1947;Gelvonėlis;RAMUNĖLĖS;3942630720;Taip;0;2;0;2
1948;Gelvonėlis;RAMUNĖLĖS;1453271708;Taip;5;0;0;5
1949;Gelvonėlis;RAMUNĖLĖS;3165015754;Taip;1;0;0;1
1950;Gelvonėlis;RAMUNĖLĖS;1274119900;Taip;0;2;0;2
1951;Gelvonėlis;RAMUNĖLĖS;9058956012;Taip;0;1;0;1
1952;Gelvonėlis;RIEŠUTĖLIAI;3368423382;Taip;1;1;0;2
1953;Gelvonėlis;RIEŠUTĖLIAI;4193108560;Ne;10;0;4;14
1954;Gelvonėlis;RIEŠUTĖLIAI;5461812139;Taip;5;0;0;5
1955;Gelvonėlis;RIEŠUTĖLIAI;5986018609;Taip;10;0;4;14
1956;Gelvonėlis;RIEŠUTĖLIAI;8532801167;Taip;0;0;4;4
1957;Gelvonėlis;RIEŠUTĖLIAI;4208103106;Taip;6;0;1;7
1958;Gelvonėlis;RIEŠUTĖLIAI;8766702456;Taip;0;0;2;2
1959;Gelvonėlis;RIEŠUTĖLIAI;6305084811;Taip;9;0;1;10
1960;Gelvonėlis;RIEŠUTĖLIAI;1266479895;Taip;0;0;1;1
1961;Gelvonėlis;RIEŠUTĖLIAI;5934077931;Taip;0;0;4;4
1962;Gelvonėlis;RIEŠUTĖLIAI;4280463938;Taip;0;0;2;2
1963;Gelvonėlis;RIEŠUTĖLIAI;6068473734;Taip;0;0;1;1
1964;Gelvonėlis;RIEŠUTĖLIAI;2734462553;Taip;11;0;0;11
1965;Gervelė;ŽIRNIUKAI;6431701403;Taip;5;0;2;7
1966;Gervelė;ŽIRNIUKAI;7197089520;Taip;0;0;5;5
1967;Gervelė;ŽIRNIUKAI;1353920541;Taip;0;3;0;3
1968;Gervelė;ŽIRNIUKAI;3647044817;Taip;10;0;0;10
1969;Gervelė;ŽIRNIUKAI;8273301992;Taip;7;0;3;10
1970;Gervelė;ŽIRNIUKAI;6834663627;Taip;13;0;0;13
1971;Gervelė;ŽIRNIUKAI;2446758975;Taip;0;0;1;1
1972;Gervelė;ŽIRNIUKAI;7721421570;Taip;4;0;0;4
1973;Gervelė;ŽIRNIUKAI;7924884022;Ne;0;5;0;5
1974;Gervelė;ŽIRNIUKAI;3449674095;Taip;0;1;0;1
1975;Gervelė;ŽIRNIUKAI;1637204236;Taip;5;0;1;6
1976;Gervelė;ŽIRNIUKAI;8157865822;Taip;0;0;2;2
1977;Gervelė;ŽIRNIUKAI;1323074335;Ne;10;0;1;11
1978;Gervelė;ŽIRNIUKAI;6058944385;Taip;0;10;0;10
1979;Gervelė;ŽIRNIUKAI;5767158743;Taip;0;12;0;12
1980;Gervelė;ŽIRNIUKAI;4294916559;Taip;0;1;0;1
1981;Gervelė;ŽIRNIUKAI;2413995770;Taip;8;0;1;9
1982;Gervelė;ŽIRNIUKAI;1649724696;Ne;0;0;1;1
1983;Gervelė;LAŠIUKAI;1160084928;Taip;10;0;1;11
1984;Gervelė;LAŠIUKAI;3333885493;Taip;0;3;0;3
1985;Gervelė;LAŠIUKAI;7317091881;Taip;5;0;2;7
1986;Gervelė;LAŠIUKAI;7020599764;Taip;0;0;2;2
1987;Gervelė;LAŠIUKAI;4394752176;Taip;0;0;6;6
1988;Gervelė;LAŠIUKAI;6228025635;Taip;0;0;2;2
1989;Gervelė;LAŠIUKAI;6951455424;Taip;0;0;1;1
1990;Gervelė;LAŠIUKAI;9977349707;Taip;0;13;0;13
1991;Gervelė;LAŠIUKAI;4295743997;Taip;1;1;0;2
1992;Gervelė;LAŠIUKAI;7935059565;Taip;5;0;1;6
1993;Gervelė;LAŠIUKAI;5267617723;Taip;0;1;0;1
1994;Gervelė;LAŠIUKAI;5953552777;Taip;0;7;0;7
1995;Gervelė;LAŠIUKAI;6263562066;Ne;0;0;1;1
1996;Gervelė;LAŠIUKAI;6987657237;Taip;0;0;1;1
1997;Gervelė;LAŠIUKAI;8016341646;Taip;0;7;0;7
1998;Gervelė;LAŠIUKAI;5685222621;Taip;0;0;2;2
1999;Gervelė;LAŠIUKAI;1400044294;Taip;0;0;9;9
2000;Gervelė;LAŠIUKAI;6155979185;Taip;0;6;0;6
2001;Gervelė;PABIRUČIAI;7162551366;Taip;10;0;0;10
2002;Gervelė;PABIRUČIAI;2551280794;Taip;0;14;0;14
2003;Gervelė;PABIRUČIAI;1616949023;Taip;0;11;0;11
2004;Gervelė;PABIRUČIAI;3427400844;Taip;0;9;0;9
2005;Gervelė;PABIRUČIAI;8152446576;Taip;0;6;4;10
2006;Gervelė;PABIRUČIAI;7302238728;Ne;1;1;1;3
2007;Gervelė;PABIRUČIAI;8062089041;Taip;0;11;0;11
2008;Gervelė;PABIRUČIAI;7697761552;Taip;0;0;1;1
2009;Gervelė;PABIRUČIAI;5989713844;Taip;0;1;0;1
2010;Gervelė;PABIRUČIAI;4560752068;Taip;0;6;0;6
2011;Gervelė;PABIRUČIAI;1704033440;Taip;7;3;0;10
2012;Gervelė;PABIRUČIAI;4705514590;Ne;7;0;0;7
2013;Gervelė;PABIRUČIAI;89076506192;Taip;8;0;1;9
2014;Gervelė;PABIRUČIAI;87619285504;Taip;0;0;2;2
2015;Gervelė;PABIRUČIAI;1991238577;Taip;0;4;0;4
2016;Gervelė;PABIRUČIAI;2167744244;Taip;0;1;0;1
2017;Gervelė;PABIRUČIAI;3525060645;Taip;0;9;0;9
2018;Gervelė;BITUTĖS;50558260808;Taip;0;0;3;3
2019;Gervelė;BITUTĖS;8332516807;Taip;5;0;0;5
2020;Gervelė;BITUTĖS;2632272974;Ne;11;0;0;11
2021;Gervelė;BITUTĖS;1697536098;Taip;0;5;0;5
2022;Gervelė;BITUTĖS;1921567602;Taip;0;0;6;6
2023;Gervelė;BITUTĖS;3278950938;Taip;5;0;4;9
2024;Gervelė;BITUTĖS;6349428106;Taip;0;11;0;11
2025;Gervelė;BITUTĖS;2019214634;Ne;7;0;0;7
2026;Gervelė;BITUTĖS;73803372762;Taip;0;0;6;6
2027;Gervelė;BITUTĖS;2798349541;Ne;0;6;0;6
2028;Gervelė;BITUTĖS;8035942210;Taip;0;7;0;7
2029;Gervelė;BURATINO;1815418720;Taip;0;9;0;9
2030;Gervelė;BURATINO;92859033264;Taip;0;1;0;1
2031;Gervelė;BURATINO;1083567209;Taip;0;1;0;1
2032;Gervelė;BURATINO;3946391650;Taip;0;1;0;1
2033;Gervelė;BURATINO;7620764911;Taip;8;5;0;13
2034;Gervelė;BURATINO;5440557094;Taip;0;1;0;1
2035;Gervelė;BURATINO;2646901307;Taip;10;3;0;13
2036;Gervelė;BURATINO;9771780358;Taip;0;9;0;9
2037;Gervelė;BURATINO;9239897472;Taip;0;8;0;8
2038;Gervelė;BURATINO;8997525194;Taip;0;1;0;1
2039;Gervelė;BURATINO;6500709575;Taip;15;0;0;15
2040;Gervelė;BURATINO;9647340725;Ne;8;0;0;8
2041;Gervelė;BURATINO;5000209135;Taip;0;19;0;19
2042;Gervelė;BURATINO;3359793310;Taip;0;19;0;19
2043;Gervelė;BURATINO;9982951468;Ne;0;11;0;11
2044;Gervelė;BURATINO;5900623823;Taip;0;5;0;5
2045;Gervelė;BURATINO;4775822341;Taip;0;6;0;6
2046;Gervelė;BURATINO;2541771432;Ne;0;3;0;3
2047;Gervelė;VIŠČIUKŲ;6844406500;Taip;0;2;0;2
2048;Gervelė;VIŠČIUKŲ;2359854614;Taip;7;0;0;7
2049;Gervelė;VIŠČIUKŲ;8533480337;Taip;0;1;0;1
2050;Gervelė;VIŠČIUKŲ;2523056808;Taip;0;0;3;3
2051;Gervelė;VIŠČIUKŲ;8811086908;Taip;0;0;3;3
2052;Gervelė;VIŠČIUKŲ;3723783633;Taip;0;6;0;6
2053;Gervelė;VIŠČIUKŲ;1573560581;Taip;10;0;0;10
2054;Gervelė;VIŠČIUKŲ;6895415337;Taip;5;0;1;6
2055;Gervelė;VIŠČIUKŲ;7192663882;Taip;4;0;1;5
2056;Gervelė;VIŠČIUKŲ;8439479958;Taip;3;0;0;3
2057;Gervelė;VIŠČIUKŲ;3791175392;Taip;0;0;3;3
2058;Gervelė;VIŠČIUKŲ;5418274082;Ne;0;0;2;2
2059;Gilužis;Skruzdėliukų;35511006307;Taip;0;1;4;5
2060;Gilužis;Skruzdėliukų;44807904472;Taip;4;0;0;4
2061;Gilužis;Skruzdėliukų;1671692484;Taip;0;1;0;1
2062;Gilužis;Skruzdėliukų;1615293331;Taip;0;2;0;2
2063;Gilužis;Skruzdėliukų;9474400084;Taip;0;3;2;5
2064;Gilužis;Skruzdėliukų;70959404439;Taip;0;2;0;2
2065;Gilužis;Skruzdėliukų;8120898865;Taip;0;1;0;1
2066;Gilužis;Skruzdėliukų;4611735601;Taip;4;1;1;6
2067;Gilužis;Skruzdėliukų;5920357223;Taip;0;1;3;4
2068;Gilužis;Skruzdėliukų;5365582271;Taip;19;2;0;21
2069;Gilužis;Skruzdėliukų;7364297673;Taip;21;0;0;21
2070;Gilužis;Skruzdėliukų;4362244070;Ne;13;0;0;13
2071;Gilužis;Skruzdėliukų;2042514241;Taip;0;0;1;1
2072;Gilužis;Skruzdėliukų;3216004438;Taip;0;1;2;3
2073;Gilužis;Skruzdėliukų;7766747590;Taip;6;0;0;6
2074;Gilužis;Skruzdėliukų;48365991937;Ne;8;0;0;8
2075;Gilužis;Skruzdėliukų;1569805585;Taip;0;4;0;4
2076;Gilužis;Skruzdėliukų;1452016675;Taip;5;0;0;5
2077;Gilužis;Skruzdėliukų;29586826889;Taip;9;7;0;16
2078;Gilužis;Nykštukų;4147821853;Taip;1;2;1;4
2079;Gilužis;Nykštukų;7937643339;Ne;5;1;0;6
2080;Gilužis;Nykštukų;3473889426;Taip;11;0;0;11
2081;Gilužis;Nykštukų;9362581908;Taip;11;0;0;11
2082;Gilužis;Nykštukų;8899557365;Taip;0;2;3;5
2083;Gilužis;Nykštukų;2661894041;Ne;18;0;0;18
2084;Gilužis;Nykštukų;5109935385;Taip;7;5;0;12
2085;Gilužis;Nykštukų;7228498662;Taip;0;2;0;2
2086;Gilužis;Nykštukų;3335512812;Taip;0;1;0;1
2087;Gilužis;Nykštukų;1459273692;Taip;0;2;0;2
2088;Gilužis;Nykštukų;4156613717;Ne;5;4;1;10
2089;Gilužis;Nykštukų;5713786735;Ne;6;1;0;7
2090;Gilužis;Nykštukų;2784416935;Ne;15;0;0;15
2091;Gilužis;Nykštukų;4956685016;Taip;8;0;0;8
2092;Gilužis;Nykštukų;6315155554;Taip;5;1;0;6
2093;Gilužis;Nykštukų;1146713023;Taip;0;4;0;4
2094;Gilužis;Nykštukų;9332056404;Taip;0;16;0;16
2095;Gilužis;Nykštukų;4541291716;Taip;0;0;6;6
2096;Gilužis;Nykštukų;8522552650;Ne;0;2;1;3
2097;Gilužis;Nykštukų;3176305306;Taip;0;1;0;1
2098;Gilužis;Nykštukų;4795108770;Ne;0;2;0;2
2099;Gilužis;Nykštukų;4094486541;Taip;5;1;0;6
2100;Gilužis;Bitučių;6960673767;Taip;8;1;0;9
2101;Gilužis;Bitučių;2585736095;Ne;15;0;1;16
2102;Gilužis;Bitučių;4841014668;Taip;15;0;0;15
2103;Gilužis;Bitučių;3399162399;Taip;4;6;0;10
2104;Gilužis;Bitučių;5973671038;Taip;0;6;0;6
2105;Gilužis;Bitučių;1634295583;Ne;11;0;0;11
2106;Gilužis;Bitučių;4360261750;Ne;6;0;1;7
2107;Gilužis;Bitučių;6931726275;Taip;9;0;0;9
2108;Gilužis;Bitučių;1867185320;Taip;8;6;0;14
2109;Gilužis;Bitučių;8539946703;Taip;0;9;0;9
2110;Gilužis;Bitučių;9000351000;Taip;9;0;0;9
2111;Gilužis;Bitučių;5366174839;Taip;8;0;0;8
2112;Gilužis;Bitučių;5162397237;Taip;9;0;1;10
2113;Gilužis;Bitučių;7250617867;Taip;0;4;0;4
2114;Gilužis;Bitučių;9053608903;Taip;4;2;0;6
2115;Gilužis;Bitučių;6115776872;Taip;6;0;0;6
2116;Gilužis;Bitučių;5651799121;Taip;3;0;1;4
2117;Gilužis;Bitučių;1334619137;Taip;10;0;0;10
2118;Gilužis;Bitučių;2950813185;Taip;3;0;0;3
2119;Gilužis;Kačiukų;4978922821;Taip;13;3;0;16
2120;Gilužis;Kačiukų;2945406185;Taip;9;5;0;14
2121;Gilužis;Kačiukų;1582241363;Taip;0;10;0;10
2122;Gilužis;Kačiukų;7330938312;Taip;0;5;2;7
2123;Gilužis;Kačiukų;6571132974;Taip;0;21;0;21
2124;Gilužis;Kačiukų;7001112696;Taip;4;2;0;6
2125;Gilužis;Kačiukų;9034842169;Taip;2;0;2;4
2126;Gilužis;Kačiukų;6966795180;Ne;6;1;0;7
2127;Gilužis;Kačiukų;5128383851;Taip;3;0;4;7
2128;Gilužis;Kačiukų;7826015897;Taip;10;3;0;13
2129;Gilužis;Kačiukų;4403218878;Taip;0;1;0;1
2130;Gilužis;Kačiukų;9186274541;Taip;9;0;0;9
2131;Gilužis;Kačiukų;3419281756;Taip;5;0;0;5
2132;Gilužis;Kačiukų;1862524255;Taip;7;1;0;8
2133;Gilužis;Kačiukų;9421351780;Taip;10;1;0;11
2134;Gilužis;Kačiukų;6404411477;Taip;0;2;0;2
2135;Gilužis;Kačiukų;4128387076;Taip;0;9;4;13
2136;Gilužis;Kačiukų;3392212344;Taip;7;0;0;7
2137;Gilužis;Kačiukų;7042664923;Taip;10;0;0;10
2138;Gilužis;Kačiukų;9097165155;Taip;10;0;1;11
2139;Gilužis;Kačiukų;6853311695;Taip;8;0;1;9
2140;Gilužis;Pelėdžiukų;5217748032;Ne;5;6;0;11
2141;Gilužis;Pelėdžiukų;5989314494;Taip;0;0;1;1
2142;Gilužis;Pelėdžiukų;7998695149;Taip;16;0;0;16
2143;Gilužis;Pelėdžiukų;7742783427;Taip;20;0;0;20
2144;Gilužis;Pelėdžiukų;7358572344;Taip;10;1;0;11
2145;Gilužis;Pelėdžiukų;4617259961;Taip;13;0;0;13
2146;Gilužis;Pelėdžiukų;1222370750;Ne;10;1;0;11
2147;Gilužis;Pelėdžiukų;9503516686;Taip;4;0;0;4
2148;Gilužis;Pelėdžiukų;9833451628;Taip;8;10;0;18
2149;Gilužis;Pelėdžiukų;6270071724;Taip;0;1;0;1
2150;Gilužis;Pelėdžiukų;7505729606;Taip;15;0;0;15
2151;Gilužis;Pelėdžiukų;4051726208;Taip;5;0;1;6
2152;Gilužis;Pelėdžiukų;7092060789;Taip;0;0;1;1
2153;Gilužis;Pelėdžiukų;4435227217;Ne;0;0;1;1
2154;Gilužis;Pelėdžiukų;1804218972;Taip;0;0;2;2
2155;Gilužis;Pelėdžiukų;2434419240;Taip;6;0;2;8
2156;Gilužis;Pelėdžiukų;1832039250;Taip;0;0;7;7
2157;Gilužis;Pelėdžiukų;3166161973;Taip;8;0;0;8
2158;Gilužis;Pelėdžiukų;5070988982;Taip;11;3;0;14
2159;Gilužis;Pelėdžiukų;7899274495;Taip;0;0;2;2
2160;Gilužis;Pelėdžiukų;6469454991;Ne;5;0;7;12
2161;Gilužis;Pelėdžiukų;6093514885;Taip;5;0;0;5
2162;Gilužis;Drugelių;6121625070;Taip;8;0;0;8
2163;Gilužis;Drugelių;1770064694;Taip;6;0;0;6
2164;Gilužis;Drugelių;9092013248;Taip;12;0;0;12
2165;Gilužis;Drugelių;9109883577;Taip;6;0;2;8
2166;Gilužis;Drugelių;3190597262;Taip;5;0;0;5
2167;Gilužis;Drugelių;2988856911;Taip;10;0;0;10
2168;Gilužis;Drugelių;3532863024;Taip;0;21;0;21
2169;Gilužis;Drugelių;1376645277;Taip;1;0;0;1
2170;Gilužis;Drugelių;1914585195;Taip;8;0;3;11
2171;Gilužis;Drugelių;9112993465;Taip;0;12;0;12
2172;Gilužis;Drugelių;4909329417;Taip;10;0;0;10
2173;Gilužis;Drugelių;8244385001;Taip;10;0;0;10
2174;Gilužis;Drugelių;6429142049;Taip;14;0;0;14
2175;Gilužis;Drugelių;7731169885;Taip;8;7;0;15
2176;Gilužis;Drugelių;1093643746;Taip;0;3;0;3
2177;Gilužis;Drugelių;3902713866;Taip;10;0;0;10
2178;Gilužis;Drugelių;6950139609;Taip;1;0;0;1
2179;Gilužis;Drugelių;2397231165;Taip;7;0;0;7
2180;Gilužis;Saulučių;4209000927;Taip;0;0;1;1
2181;Gilužis;Saulučių;8595551150;Taip;6;1;0;7
2182;Gilužis;Saulučių;4575619425;Taip;3;0;0;3
2183;Gilužis;Saulučių;4473810097;Taip;0;0;1;1
2184;Gilužis;Saulučių;1649256496;Taip;0;3;0;3
2185;Gilužis;Saulučių;96550272401;Taip;2;0;0;2
2186;Gilužis;Saulučių;2391630554;Taip;0;1;0;1
2187;Gilužis;Saulučių;18997894859;Taip;5;0;0;5
2188;Gilužis;Saulučių;7744997250;Taip;0;0;2;2
2189;Gilužis;Saulučių;32730847948;Taip;0;6;0;6
2190;Gilužis;Saulučių;3181765606;Taip;15;0;1;16
2191;Gilužis;Saulučių;5905237803;Taip;0;0;1;1
2192;Gilužis;Saulučių;79805583046;Taip;3;0;0;3
2193;Gilužis;Saulučių;28447690974;Taip;0;5;4;9
2194;Gilužis;Saulučių;87425898496;Taip;0;1;0;1
2195;Gilužis;Saulučių;35650138667;Taip;0;1;0;1
2196;Gilužis;Saulučių;9367673896;Taip;11;0;0;11
2197;Gilužis;Saulučių;1453976300;Taip;0;2;0;2
2198;Gilužis;Paukštelių;1366594390;Taip;7;0;0;7
2199;Gilužis;Paukštelių;3091779337;Taip;0;0;1;1
2200;Gilužis;Paukštelių;4873135289;Taip;9;0;2;11
2201;Gilužis;Paukštelių;1873200936;Taip;3;0;0;3
2202;Gilužis;Paukštelių;98433672584;Taip;0;0;2;2
2203;Gilužis;Paukštelių;1930906118;Taip;0;5;0;5
2204;Gilužis;Paukštelių;8989448562;Taip;0;0;5;5
2205;Gilužis;Paukštelių;4416489866;Taip;2;0;0;2
2206;Gilužis;Paukštelių;4199640400;Taip;0;0;2;2
2207;Gilužis;Paukštelių;63332253507;Taip;12;0;4;16
2208;Gilužis;Paukštelių;89789237180;Taip;6;0;1;7
2209;Gilužis;Paukštelių;73793165310;Ne;0;1;0;1
2210;Gilužis;Paukštelių;28788742249;Ne;0;1;3;4
2211;Gilužis;Paukštelių;1129265551;Taip;1;0;1;2
2212;Gilužis;Obuoliukų;27834192987;Taip;0;3;0;3
2213;Gilužis;Obuoliukų;1050659357;Taip;0;2;0;2
2214;Gilužis;Obuoliukų;72582220264;Taip;0;5;0;5
2215;Gilužis;Obuoliukų;1840213846;Taip;0;2;0;2
2216;Gilužis;Obuoliukų;2134161601;Taip;4;1;0;5
2217;Gilužis;Obuoliukų;1637726675;Ne;0;3;0;3
2218;Gilužis;Obuoliukų;1404236599;Taip;0;13;0;13
2219;Gilužis;Obuoliukų;2031851095;Taip;0;3;0;3
2220;Gilužis;Obuoliukų;96799037695;Taip;7;0;0;7
2221;Gilužis;Obuoliukų;84834458261;Taip;9;10;0;19
2222;Gilužis;Obuoliukų;5121769570;Taip;0;6;0;6
2223;Gilužis;Obuoliukų;1428994411;Taip;0;1;0;1
2224;Gilužis;Obuoliukų;5899163275;Taip;5;5;0;10
2225;Gilužis;Obuoliukų;2126527730;Taip;0;7;0;7
2226;Gilužis;Obuoliukų;53388692764;Taip;0;2;0;2
2227;Gilužis;Obuoliukų;1067512693;Ne;5;0;1;6
2228;Gilužis;Obuoliukų;4777937216;Ne;9;1;0;10
2229;Gilužis;KIŠKUČIŲ;97906928411;Taip;6;1;0;7
2230;Gilužis;KIŠKUČIŲ;1191967409;Taip;0;2;0;2
2231;Gilužis;KIŠKUČIŲ;1025400197;Taip;7;0;1;8
2232;Gilužis;KIŠKUČIŲ;1841556598;Taip;0;0;4;4
2233;Gilužis;KIŠKUČIŲ;24558082285;Taip;10;3;0;13
2234;Gilužis;KIŠKUČIŲ;69205729963;Taip;0;0;1;1
2235;Gilužis;KIŠKUČIŲ;1869058578;Taip;2;0;0;2
2236;Gilužis;KIŠKUČIŲ;1464348972;Taip;8;0;1;9
2237;Gilužis;KIŠKUČIŲ;7740703388;Taip;4;0;0;4
2238;Gilužis;KIŠKUČIŲ;1589884646;Taip;1;7;3;11
2239;Gilužis;KIŠKUČIŲ;54636558233;Taip;0;0;1;1
2240;Gilužis;KIŠKUČIŲ;57074114440;Ne;0;2;0;2
2241;Gilužis;KIŠKUČIŲ;15192433393;Taip;0;3;0;3
2242;Gilužis;KIŠKUČIŲ;1307302669;Taip;17;0;1;18
2243;Gilužis;KIŠKUČIŲ;2246345257;Taip;2;0;0;2
2244;Gilužis;KIŠKUČIŲ;1163722642;Ne;0;0;1;1
2245;Gilužis;KIŠKUČIŲ;1495145663;Taip;15;0;0;15
2246;Gilužis;KIŠKUČIŲ;34330362446;Taip;3;0;0;3
2247;Gilužis;KIŠKUČIŲ;2118119414;Ne;3;0;0;3
2248;Gilužis;Meškučių;5008795520;Taip;0;1;0;1
2249;Gilužis;Meškučių;82153247890;Taip;0;1;0;1
2250;Gilužis;Meškučių;15672746324;Taip;5;0;0;5
2251;Gilužis;Meškučių;8278207628;Ne;0;2;0;2
2252;Gilužis;Meškučių;2144919007;Taip;0;1;0;1
2253;Gilužis;Meškučių;6840555273;Taip;5;6;0;11
2254;Gilužis;Meškučių;1664140841;Ne;3;0;0;3
2255;Gilužis;Meškučių;1201973661;Taip;0;5;0;5
2256;Gilužis;Meškučių;99889836604;Taip;1;1;0;2
2257;Gilužis;Meškučių;93541096118;Taip;9;1;0;10
2258;Gilužis;Meškučių;41791785706;Ne;0;21;0;21
2259;Gilužis;Meškučių;3104707033;Ne;10;0;0;10
2260;Gilužis;Meškučių;48400196395;Taip;2;0;0;2
2261;Gilužis;Meškučių;41887832166;Taip;0;2;0;2
2262;Gilužis;Meškučių;57285847418;Taip;8;0;0;8
2263;Gilužis;Meškučių;37771334557;Taip;0;10;0;10
2264;Gilužis;Meškučių;3451034791;Ne;0;1;0;1
2265;Gilužis;Pagrandukai;7560732216;Ne;4;0;0;4
2266;Gilužis;Pagrandukai;4242362889;Ne;4;0;0;4
2267;Gilužis;Pagrandukai;8194444043;Taip;1;0;0;1
2268;Gilužis;Pagrandukai;7413746493;Taip;0;0;1;1
2269;Gilužis;Pagrandukai;7398446674;Taip;4;0;0;4
2270;Gilužis;Pagrandukai;6172360933;Taip;5;0;0;5
2271;Gilužis;Pagrandukai;1540018160;Taip;11;0;0;11
2272;Gilužis;Pagrandukai;4058698645;Taip;2;3;0;5
2273;Gilužis;Pagrandukai;7606394325;Taip;5;0;0;5
2274;Gilužis;Pagrandukai;4226028904;Taip;4;0;0;4
2275;Gilužis;Pagrandukai;3131597174;Taip;0;0;1;1
2276;Gilužis;Pagrandukai;6239369861;Taip;1;0;0;1
2277;Gilužis;Pagrandukai;6737884137;Taip;4;0;0;4
2278;Gilužis;Boružėlių;5721924532;Taip;12;0;0;12
2279;Gilužis;Boružėlių;5497242500;Taip;5;0;0;5
2280;Gilužis;Boružėlių;5394693502;Taip;4;0;0;4
2281;Gilužis;Boružėlių;2633680406;Taip;13;0;0;13
2282;Gilužis;Boružėlių;2221786284;Taip;0;4;0;4
2283;Gilužis;Boružėlių;3002266577;Taip;8;0;0;8
2284;Gilužis;Boružėlių;9489594782;Taip;2;0;0;2
2285;Gilužis;Boružėlių;6323747855;Taip;4;0;0;4
2286;Gilužis;Boružėlių;5190752112;Ne;3;0;1;4
2287;Gilužis;Boružėlių;2440762487;Ne;1;0;3;4
2288;Gilužis;Boružėlių;8639633038;Taip;4;0;2;6
2289;Gilužis;Boružėlių;4509741536;Ne;15;0;1;16
2290;Gilužis;Boružėlių;2680643896;Taip;0;2;0;2
2291;Gintarėlis;PAPŪGĖLĖS;8498936096;Taip;0;1;0;1
2292;Gintarėlis;PAPŪGĖLĖS;8913652291;Taip;0;0;1;1
2293;Gintarėlis;PAPŪGĖLĖS;2485750596;Taip;7;0;2;9
2294;Gintarėlis;PAPŪGĖLĖS;1033624080;Taip;5;2;0;7
2295;Gintarėlis;PAPŪGĖLĖS;2919700367;Ne;5;1;0;6
2296;Gintarėlis;PAPŪGĖLĖS;1768789948;Taip;0;0;2;2
2297;Gintarėlis;PAPŪGĖLĖS;2235045173;Taip;4;1;0;5
2298;Gintarėlis;PAPŪGĖLĖS;9494521554;Taip;0;13;0;13
2299;Gintarėlis;PAPŪGĖLĖS;7494884360;Taip;0;2;0;2
2300;Gintarėlis;PAPŪGĖLĖS;7147842224;Taip;0;1;0;1
2301;Gintarėlis;PAPŪGĖLĖS;5783939567;Ne;0;1;0;1
2302;Gintarėlis;PAPŪGĖLĖS;7674351459;Taip;0;10;0;10
2303;Gintarėlis;PAPŪGĖLĖS;6292664833;Taip;0;1;15;16
2304;Gintarėlis;PAPŪGĖLĖS;8610886062;Taip;4;0;1;5
2305;Gintarėlis;PAPŪGĖLĖS;5811396263;Taip;0;1;0;1
2306;Gintarėlis;PAPŪGĖLĖS;4904966263;Taip;0;2;1;3
2307;Gintarėlis;PAPŪGĖLĖS;1648843117;Ne;3;2;3;8
2308;Gintarėlis;PAPŪGĖLĖS;1861324153;Taip;0;1;0;1
2309;Gintarėlis;PAPŪGĖLĖS;3457974670;Ne;5;2;0;7
2310;Gintarėlis;PAPŪGĖLĖS;9382662838;Taip;0;8;0;8
2311;Gintarėlis;PAPŪGĖLĖS;1511718436;Ne;0;15;0;15
2312;Gintarėlis;PAPŪGĖLĖS;4484711857;Taip;0;1;0;1
2313;Gintarėlis;SPINDULIUKAI;9903314418;Taip;0;0;1;1
2314;Gintarėlis;SPINDULIUKAI;50715082496;Taip;16;0;1;17
2315;Gintarėlis;SPINDULIUKAI;31365533022;Ne;0;0;2;2
2316;Gintarėlis;SPINDULIUKAI;2000986290;Taip;0;0;2;2
2317;Gintarėlis;SPINDULIUKAI;7610677403;Ne;0;0;1;1
2318;Gintarėlis;SPINDULIUKAI;98684742007;Ne;10;0;2;12
2319;Gintarėlis;SPINDULIUKAI;54145290842;Ne;4;0;3;7
2320;Gintarėlis;SPINDULIUKAI;6421537455;Taip;0;0;1;1
2321;Gintarėlis;SPINDULIUKAI;5451653510;Taip;0;0;1;1
2322;Gintarėlis;SPINDULIUKAI;58701768194;Taip;0;4;0;4
2323;Gintarėlis;SPINDULIUKAI;1595816431;Taip;0;0;1;1
2324;Gintarėlis;SPINDULIUKAI;1159773367;Taip;0;3;0;3
2325;Gintarėlis;SPINDULIUKAI;19813827223;Taip;0;1;0;1
2326;Gintarėlis;SPINDULIUKAI;26259581924;Taip;0;0;5;5
2327;Gintarėlis;SPINDULIUKAI;2050020230;Taip;0;0;2;2
2328;Gintarėlis;SPINDULIUKAI;3047429502;Taip;0;0;2;2
2329;Gintarėlis;SPINDULIUKAI;5880091191;Taip;0;0;1;1
2330;Gintarėlis;SPINDULIUKAI;6893183889;Taip;0;0;1;1
2331;Gintarėlis;LAŠIUKAI;77591601744;Taip;0;0;1;1
2332;Gintarėlis;LAŠIUKAI;29645999843;Taip;0;6;0;6
2333;Gintarėlis;LAŠIUKAI;90891401453;Taip;0;2;4;6
2334;Gintarėlis;LAŠIUKAI;1539226211;Taip;5;3;0;8
2335;Gintarėlis;LAŠIUKAI;1076400051;Taip;0;3;0;3
2336;Gintarėlis;LAŠIUKAI;2043878016;Taip;3;0;1;4
2337;Gintarėlis;LAŠIUKAI;5835437020;Ne;0;2;0;2
2338;Gintarėlis;LAŠIUKAI;1191846491;Taip;0;0;1;1
2339;Gintarėlis;LAŠIUKAI;83754732536;Taip;0;2;0;2
2340;Gintarėlis;LAŠIUKAI;85557344192;Taip;0;2;2;4
2341;Gintarėlis;LAŠIUKAI;78697777550;Taip;0;5;1;6
2342;Gintarėlis;LAŠIUKAI;1543013649;Taip;0;7;2;9
2343;Gintarėlis;LAŠIUKAI;1642627920;Taip;4;16;0;20
2344;Gintarėlis;LAŠIUKAI;3828845515;Taip;4;2;0;6
2345;Gintarėlis;LAŠIUKAI;8373623055;Taip;0;1;2;3
2346;Gintarėlis;LAŠIUKAI;1593455162;Taip;0;12;0;12
2347;Gintarėlis;LAŠIUKAI;9705808868;Taip;0;2;0;2
2348;Gintarėlis;GAIDŽIUKAI;45480802894;Taip;0;4;0;4
2349;Gintarėlis;GAIDŽIUKAI;1770479969;Taip;8;2;0;10
2350;Gintarėlis;GAIDŽIUKAI;1441282039;Taip;5;2;0;7
2351;Gintarėlis;GAIDŽIUKAI;4660581415;Taip;0;2;0;2
2352;Gintarėlis;GAIDŽIUKAI;3794027499;Taip;2;2;0;4
2353;Gintarėlis;GAIDŽIUKAI;1327681704;Taip;0;2;0;2
2354;Gintarėlis;GAIDŽIUKAI;9234476307;Ne;0;2;0;2
2355;Gintarėlis;GAIDŽIUKAI;5916948150;Taip;0;2;1;3
2356;Gintarėlis;GAIDŽIUKAI;2203238888;Taip;0;12;0;12
2357;Gintarėlis;GAIDŽIUKAI;3978892232;Taip;0;2;1;3
2358;Gintarėlis;GAIDŽIUKAI;7942036741;Taip;5;0;0;5
2359;Gintarėlis;GAIDŽIUKAI;6785086096;Ne;0;2;0;2
2360;Gintarėlis;GAIDŽIUKAI;6607854244;Taip;4;2;0;6
2361;Gintarėlis;GAIDŽIUKAI;6561070982;Taip;0;1;0;1
2362;Gintarėlis;GAIDŽIUKAI;7813187438;Taip;8;1;0;9
2363;Gintarėlis;GAIDŽIUKAI;7123016029;Taip;0;2;0;2
2364;Gintarėlis;GAIDŽIUKAI;3987801707;Taip;8;2;0;10
2365;Gintarėlis;GAIDŽIUKAI;2256002308;Taip;0;1;0;1
2366;Gintarėlis;GAIDŽIUKAI;3484172382;Taip;0;2;0;2
2367;Gintarėlis;GAIDŽIUKAI;9539570835;Taip;0;2;1;3
2368;Gintarėlis;MEŠKUČIAI;6618240550;Taip;5;1;0;6
2369;Gintarėlis;MEŠKUČIAI;8790078624;Taip;0;1;0;1
2370;Gintarėlis;MEŠKUČIAI;5581074417;Taip;0;1;0;1
2371;Gintarėlis;MEŠKUČIAI;2518840573;Taip;0;1;0;1
2372;Gintarėlis;MEŠKUČIAI;2262493530;Taip;5;0;0;5
2373;Gintarėlis;MEŠKUČIAI;5187894822;Taip;4;2;0;6
2374;Gintarėlis;MEŠKUČIAI;3630567294;Taip;0;1;0;1
2375;Gintarėlis;MEŠKUČIAI;5181872438;Taip;0;1;0;1
2376;Gintarėlis;MEŠKUČIAI;2072435242;Taip;5;2;1;8
2377;Gintarėlis;MEŠKUČIAI;7989239799;Taip;0;2;1;3
2378;Gintarėlis;MEŠKUČIAI;4356211536;Taip;0;0;4;4
2379;Gintarėlis;MEŠKUČIAI;1502740714;Taip;6;0;0;6
2380;Gintarėlis;MEŠKUČIAI;7948438165;Taip;0;1;0;1
2381;Gintarėlis;MEŠKUČIAI;4642142931;Taip;6;0;0;6
2382;Gintarėlis;MEŠKUČIAI;6711753930;Taip;0;5;0;5
2383;Gintarėlis;MEŠKUČIAI;9017592249;Taip;2;1;0;3
2384;Gintarėlis;MEŠKUČIAI;8375475174;Taip;0;1;0;1
2385;Gintarėlis;MEŠKUČIAI;7029401386;Taip;0;5;0;5
2386;Gintarėlis;DRUGELIAI;2127877544;Ne;3;2;0;5
2387;Gintarėlis;DRUGELIAI;14840692502;Ne;0;2;0;2
2388;Gintarėlis;DRUGELIAI;1462949250;Taip;12;2;0;14
2389;Gintarėlis;DRUGELIAI;9737200226;Taip;0;2;0;2
2390;Gintarėlis;DRUGELIAI;6655809299;Taip;6;0;0;6
2391;Gintarėlis;DRUGELIAI;2614258442;Taip;11;5;0;16
2392;Gintarėlis;DRUGELIAI;1452402931;Ne;0;1;1;2
2393;Gintarėlis;DRUGELIAI;1759217543;Taip;0;4;2;6
2394;Gintarėlis;DRUGELIAI;7571352126;Taip;6;1;0;7
2395;Gintarėlis;DRUGELIAI;50896429585;Taip;0;1;0;1
2396;Gintarėlis;DRUGELIAI;1042222561;Taip;0;4;2;6
2397;Gintarėlis;DRUGELIAI;1331684725;Ne;0;1;0;1
2398;Gintarėlis;DRUGELIAI;9687974376;Taip;0;2;1;3
2399;Gintarėlis;DRUGELIAI;8704248985;Taip;0;2;0;2
2400;Gintarėlis;DRUGELIAI;6655645997;Taip;4;2;0;6
2401;Gintarėlis;DRUGELIAI;6080108998;Taip;4;2;0;6
2402;Gintarėlis;DRUGELIAI;7449437199;Taip;0;3;1;4
2403;Gintarėlis;DRUGELIAI;4076421692;Ne;0;2;1;3
2404;Gintarėlis;DRUGELIAI;2016067859;Taip;0;0;2;2
2405;Gintarėlis;DRUGELIAI;5355691986;Taip;0;3;0;3
2406;Gintarėlis;DRUGELIAI;8116557698;Taip;0;9;0;9
2407;Gintarėlis;DRUGELIAI;6898320582;Ne;0;4;2;6
2408;Gintarėlis;KAČIUKAI;5569843168;Taip;4;5;0;9
2409;Gintarėlis;KAČIUKAI;3665764153;Taip;5;4;1;10
2410;Gintarėlis;KAČIUKAI;9774056578;Taip;5;4;1;10
2411;Gintarėlis;KAČIUKAI;2212296954;Taip;5;0;0;5
2412;Gintarėlis;KAČIUKAI;3825700024;Taip;4;0;0;4
2413;Gintarėlis;KAČIUKAI;7057877483;Taip;4;0;0;4
2414;Gintarėlis;KAČIUKAI;9825811100;Taip;10;0;4;14
2415;Gintarėlis;KAČIUKAI;7875981690;Taip;5;9;0;14
2416;Gintarėlis;KAČIUKAI;2544338275;Taip;5;9;0;14
2417;Gintarėlis;KAČIUKAI;9963329170;Taip;8;1;0;9
2418;Gintarėlis;KAČIUKAI;7182964126;Taip;2;1;0;3
2419;Gintarėlis;KAČIUKAI;4754929282;Taip;2;1;0;3
2420;Gintarėlis;KAČIUKAI;5214984111;Taip;0;1;0;1
2421;Gintarėlis;KAČIUKAI;1011749698;Taip;4;7;4;15
2422;Gintarėlis;KAČIUKAI;8261770154;Taip;15;5;0;20
2423;Gintarėlis;KAČIUKAI;7061545258;Taip;9;0;0;9
2424;Gintarėlis;KAČIUKAI;5436695400;Ne;6;1;0;7
2425;Gintarėlis;KAČIUKAI;5921751507;Taip;11;1;0;12
2426;Gintarėlis;KAČIUKAI;9450900915;Taip;12;0;2;14
2427;Gintarėlis;KAČIUKAI;3814485627;Taip;0;2;0;2
2428;Gintarėlis;KAČIUKAI;1571260478;Ne;15;1;0;16
2429;Gintarėlis;KIŠKUČIAI;9279399214;Taip;8;1;0;9
2430;Gintarėlis;KIŠKUČIAI;3921015919;Taip;8;1;0;9
2431;Gintarėlis;KIŠKUČIAI;9675201979;Taip;3;2;1;6
2432;Gintarėlis;KIŠKUČIAI;8000297636;Taip;11;2;2;15
2433;Gintarėlis;KIŠKUČIAI;7971810025;Ne;0;1;0;1
2434;Gintarėlis;KIŠKUČIAI;2814569415;Taip;0;12;0;12
2435;Gintarėlis;KIŠKUČIAI;7143014339;Taip;9;2;0;11
2436;Gintarėlis;KIŠKUČIAI;5796729245;Taip;9;3;0;12
2437;Gintarėlis;KIŠKUČIAI;9915887420;Taip;9;3;0;12
2438;Gintarėlis;KIŠKUČIAI;8287685690;Taip;0;7;0;7
2439;Gintarėlis;KIŠKUČIAI;6142819210;Taip;21;0;0;21
2440;Gintarėlis;KIŠKUČIAI;5919205817;Taip;21;0;0;21
2441;Gintarėlis;KIŠKUČIAI;3359584322;Taip;0;2;1;3
2442;Gintarėlis;KIŠKUČIAI;7815317644;Taip;3;2;0;5
2443;Gintarėlis;KIŠKUČIAI;2165332442;Taip;0;1;0;1
2444;Gintarėlis;KIŠKUČIAI;6914904213;Taip;7;2;3;12
2445;Gintarėlis;KIŠKUČIAI;1696337909;Taip;7;2;3;12
2446;Gintarėlis;KIŠKUČIAI;6862629244;Ne;5;2;1;8
2447;Gintarėlis;KIŠKUČIAI;3398936974;Taip;0;12;0;12
2448;Gintarėlis;KIŠKUČIAI;1918879534;Taip;10;1;0;11
2449;Gintarėlis;KIŠKUČIAI;7509100750;Ne;4;3;0;7
2450;Gintarėlis;VYTURIUKAI;1553747935;Taip;0;19;0;19
2451;Gintarėlis;VYTURIUKAI;34606130829;Taip;0;16;0;16
2452;Gintarėlis;VYTURIUKAI;21658913551;Taip;12;0;0;12
2453;Gintarėlis;VYTURIUKAI;18715625324;Ne;0;8;0;8
2454;Gintarėlis;VYTURIUKAI;8405210216;Ne;0;2;0;2
2455;Gintarėlis;VYTURIUKAI;5717123412;Taip;0;5;0;5
2456;Gintarėlis;BORUŽĖLĖS;4971574875;Taip;0;10;0;10
2457;Gintarėlis;BORUŽĖLĖS;1771868868;Ne;0;3;0;3
2458;Gintarėlis;BORUŽĖLĖS;39372328122;Taip;0;1;0;1
2459;Gintarėlis;BORUŽĖLĖS;25451522701;Taip;3;2;0;5
2460;Gintarėlis;BORUŽĖLĖS;82344200095;Taip;0;2;0;2
2461;Gintarėlis;BORUŽĖLĖS;9255623049;Taip;0;12;0;12
2462;Gintarėlis;BORUŽĖLĖS;88451515187;Taip;0;2;0;2
2463;Gintarėlis;BORUŽĖLĖS;7703150488;Taip;2;0;0;2
2464;Gintarėlis;BORUŽĖLĖS;2145479870;Taip;5;1;0;6
2465;Gintarėlis;BORUŽĖLĖS;49506158711;Taip;0;1;0;1
2466;Gintarėlis;BORUŽĖLĖS;30066476338;Taip;0;1;0;1
2467;Gintarėlis;BORUŽĖLĖS;63146841406;Taip;0;1;0;1
2468;Gintarėlis;BORUŽĖLĖS;30334064319;Taip;0;1;0;1
2469;Gintarėlis;BORUŽĖLĖS;91798408335;Taip;0;19;0;19
2470;Gintarėlis;BORUŽĖLĖS;25684002087;Taip;0;7;0;7
2471;Gintarėlis;BORUŽĖLĖS;10826255781;Taip;0;2;0;2
2472;Gintarėlis;BORUŽĖLĖS;1505703905;Taip;0;4;0;4
2473;Gintarėlis;BORUŽĖLĖS;1212639078;Taip;12;0;0;12
2474;Gintarėlis;BORUŽĖLĖS;49937307547;Taip;9;3;0;12
2475;Gintarėlis;BORUŽĖLĖS;1031911012;Taip;0;0;1;1
2476;Gintarėlis;EŽIUKAI;4676321193;Taip;0;9;0;9
2477;Gintarėlis;EŽIUKAI;4487346983;Taip;0;1;0;1
2478;Gintarėlis;EŽIUKAI;2263102527;Taip;0;0;1;1
2479;Gintarėlis;EŽIUKAI;7919771693;Taip;0;6;1;7
2480;Gintarėlis;EŽIUKAI;9040480798;Taip;0;0;1;1
2481;Gintarėlis;EŽIUKAI;8055928882;Taip;0;3;0;3
2482;Gintarėlis;EŽIUKAI;5024727902;Ne;0;1;0;1
2483;Gintarėlis;EŽIUKAI;2088008759;Taip;0;0;1;1
2484;Gintarėlis;EŽIUKAI;3799412062;Ne;0;1;0;1
2485;Gintarėlis;EŽIUKAI;6457288028;Taip;0;1;0;1
2486;Gintarėlis;EŽIUKAI;4660854883;Taip;0;0;1;1
2487;Gintarėlis;EŽIUKAI;94354056029;Ne;0;3;0;3
2488;Gintarėlis;EŽIUKAI;2036488789;Taip;0;0;3;3
2489;Gintarėlis;EŽIUKAI;96416364735;Taip;0;1;0;1
2490;Gintarėlis;EŽIUKAI;2970527490;Ne;0;1;0;1
2491;Gintarėlis;EŽIUKAI;1066741732;Taip;12;0;0;12
2492;Gintarėlis;EŽIUKAI;1778573935;Taip;0;5;0;5
2493;Gintarėlis;EŽIUKAI;9917367735;Taip;6;0;0;6
2494;Gintarėlis;VIŠČIUKAI;3973889495;Taip;0;2;1;3
2495;Gintarėlis;VIŠČIUKAI;4749559606;Taip;9;0;1;10
2496;Gintarėlis;VIŠČIUKAI;4458703839;Taip;3;0;0;3
2497;Gintarėlis;VIŠČIUKAI;6239242631;Taip;0;20;0;20
2498;Gintarėlis;VIŠČIUKAI;9073499040;Taip;0;1;0;1
2499;Gintarėlis;VIŠČIUKAI;6547060300;Taip;0;4;0;4
2500;Gintarėlis;VIŠČIUKAI;5930354746;Taip;6;0;0;6
2501;Gintarėlis;VIŠČIUKAI;4535071342;Taip;0;1;0;1
2502;Gintarėlis;VIŠČIUKAI;8448725884;Taip;0;1;0;1
2503;Gintarėlis;VIŠČIUKAI;6251670953;Taip;3;1;0;4
2504;Gintarėlis;VIŠČIUKAI;8805356168;Taip;5;1;0;6
2505;Gintarėlis;VIŠČIUKAI;4751066825;Taip;0;3;0;3
2506;Gintarėlis;VIŠČIUKAI;6042885133;Taip;8;2;0;10
2507;Gintarėlis;VIŠČIUKAI;7418672923;Taip;4;2;1;7
2508;Gintarėlis;"SAULĖS ZUIKUČIAI";6558614008;Taip;11;0;0;11
2509;Gintarėlis;"SAULĖS ZUIKUČIAI";3091731769;Taip;9;0;0;9
2510;Gintarėlis;"SAULĖS ZUIKUČIAI";6484966941;Taip;10;0;0;10
2511;Gintarėlis;"SAULĖS ZUIKUČIAI";9004590065;Taip;0;5;4;9
2512;Gintarėlis;"SAULĖS ZUIKUČIAI";2624469768;Taip;0;2;0;2
2513;Gintarėlis;"SAULĖS ZUIKUČIAI";8784796186;Taip;0;2;3;5
2514;Gintarėlis;"SAULĖS ZUIKUČIAI";8516817506;Taip;0;7;0;7
2515;Gintarėlis;"SAULĖS ZUIKUČIAI";4809352525;Taip;0;2;0;2
2516;Gintarėlis;"SAULĖS ZUIKUČIAI";7059730814;Taip;10;0;0;10
2517;Gintarėlis;"SAULĖS ZUIKUČIAI";9179216093;Taip;0;2;3;5
2518;Gintarėlis;"SAULĖS ZUIKUČIAI";9970786396;Taip;0;2;4;6
2519;Gintarėlis;"SAULĖS ZUIKUČIAI";3235154374;Taip;0;2;0;2
2520;Gintarėlis;"SAULĖS ZUIKUČIAI";4334349824;Taip;0;5;4;9
2521;Gintarėlis;"SAULĖS ZUIKUČIAI";6402043654;Taip;0;4;0;4
2522;Giraitė;Aviliukas;4031993742;Taip;3;0;4;7
2523;Giraitė;Aviliukas;82915040164;Taip;9;0;0;9
2524;Giraitė;Aviliukas;26032013284;Taip;9;0;0;9
2525;Giraitė;Aviliukas;2190246729;Ne;0;4;2;6
2526;Giraitė;Aviliukas;8941330547;Taip;4;0;0;4
2527;Giraitė;Aviliukas;1238299747;Ne;6;0;0;6
2528;Giraitė;Aviliukas;36650870278;Taip;0;1;0;1
2529;Giraitė;Aviliukas;1025627643;Taip;0;0;1;1
2530;Giraitė;Aviliukas;5810648237;Taip;5;0;1;6
2531;Giraitė;Aviliukas;5862292995;Taip;0;1;1;2
2532;Giraitė;Aviliukas;64357457379;Ne;0;0;1;1
2533;Giraitė;Aviliukas;7547897354;Taip;3;0;0;3
2534;Giraitė;Aviliukas;5435336235;Taip;0;11;0;11
2535;Giraitė;Aviliukas;4742424647;Taip;0;0;4;4
2536;Giraitė;LapiukaI;6141730004;Taip;11;0;0;11
2537;Giraitė;LapiukaI;7831526566;Taip;5;0;2;7
2538;Giraitė;LapiukaI;2740656695;Taip;0;0;4;4
2539;Giraitė;LapiukaI;1921430434;Ne;6;0;0;6
2540;Giraitė;LapiukaI;5006156109;Taip;0;3;0;3
2541;Giraitė;LapiukaI;2393713210;Taip;0;0;2;2
2542;Giraitė;LapiukaI;4663343304;Ne;5;0;0;5
2543;Giraitė;LapiukaI;5382004098;Taip;10;0;0;10
2544;Giraitė;LapiukaI;4811513778;Taip;0;0;2;2
2545;Giraitė;LapiukaI;9768754737;Ne;5;0;0;5
2546;Giraitė;LapiukaI;4296449093;Taip;0;3;0;3
2547;Giraitė;LapiukaI;1974159110;Taip;0;0;7;7
2548;Giraitė;LapiukaI;5532639133;Taip;4;0;1;5
2549;Giraitė;LapiukaI;5902161665;Taip;6;5;0;11
2550;Giraitė;LapiukaI;4955786826;Taip;0;3;0;3
2551;Giraitė;LapiukaI;4260343903;Taip;2;0;0;2
2552;Giraitė;LapiukaI;2748679414;Taip;0;0;2;2
2553;Giraitė;Voveriukai;7354834895;Taip;0;0;1;1
2554;Giraitė;Voveriukai;4387282125;Taip;3;0;0;3
2555;Giraitė;Voveriukai;4822168634;Taip;0;5;1;6
2556;Giraitė;Voveriukai;2088867630;Taip;0;4;0;4
2557;Giraitė;Voveriukai;3875214088;Taip;5;2;0;7
2558;Giraitė;Voveriukai;5202562049;Taip;0;0;2;2
2559;Giraitė;Voveriukai;7441871219;Taip;2;0;0;2
2560;Giraitė;Voveriukai;7481895278;Taip;14;0;0;14
2561;Giraitė;Voveriukai;1945918102;Ne;0;21;0;21
2562;Giraitė;Voveriukai;8799195526;Taip;8;0;0;8
2563;Giraitė;Voveriukai;6225092500;Taip;0;0;3;3
2564;Giraitė;Voveriukai;4137699629;Taip;3;2;0;5
2565;Giraitė;Voveriukai;4932174149;Taip;6;0;2;8
2566;Giraitė;Voveriukai;3896789232;Taip;0;0;1;1
2567;Giraitė;Voveriukai;7919088987;Taip;0;4;1;5
2568;Giraitė;Voveriukai;5616242311;Taip;0;0;1;1
2569;Giraitė;Voveriukai;7739516049;Taip;0;1;0;1
2570;Giraitė;Voveriukai;4773517160;Taip;4;0;0;4
2571;Giraitė;Voveriukai;2177856916;Taip;0;0;1;1
2572;Giraitė;Grybukai;1234136698;Taip;0;5;1;6
2573;Giraitė;Grybukai;1958553421;Taip;6;0;3;9
2574;Giraitė;Grybukai;1181578380;Taip;0;2;0;2
2575;Giraitė;Grybukai;8000958461;Ne;1;0;0;1
2576;Giraitė;Grybukai;1641872824;Taip;0;2;0;2
2577;Giraitė;Grybukai;1464444782;Taip;0;0;1;1
2578;Giraitė;Grybukai;56380808064;Taip;0;3;0;3
2579;Giraitė;Grybukai;1149254911;Taip;3;0;1;4
2580;Giraitė;Grybukai;1435017557;Taip;12;0;0;12
2581;Giraitė;Grybukai;77765768952;Taip;0;4;0;4
2582;Giraitė;Grybukai;1547711379;Taip;2;0;2;4
2583;Giraitė;Grybukai;48291239027;Taip;0;0;3;3
2584;Giraitė;Grybukai;2990968206;Ne;0;0;1;1
2585;Giraitė;Grybukai;81907805809;Taip;0;0;6;6
2586;Giraitė;Riešutėliai;3683700626;Taip;5;1;0;6
2587;Giraitė;Riešutėliai;8596389737;Taip;2;1;2;5
2588;Giraitė;Riešutėliai;5167002022;Ne;0;0;3;3
2589;Giraitė;Riešutėliai;9495968363;Taip;7;0;0;7
2590;Giraitė;Riešutėliai;1253151830;Taip;7;0;0;7
2591;Giraitė;Riešutėliai;5892950503;Taip;4;0;0;4
2592;Giraitė;Riešutėliai;4336519836;Ne;5;5;0;10
2593;Giraitė;Riešutėliai;9026736929;Taip;5;0;0;5
2594;Giraitė;Riešutėliai;9882372025;Taip;13;0;0;13
2595;Giraitė;Riešutėliai;5029839281;Ne;5;0;0;5
2596;Giraitė;Riešutėliai;23319979302;Taip;0;3;1;4
2597;Giraitė;Riešutėliai;4785524898;Taip;7;0;1;8
2598;Giraitė;Riešutėliai;8869728241;Taip;4;0;0;4
2599;Giraitė;Riešutėliai;4839351300;Taip;13;2;0;15
2600;Giraitė;Riešutėliai;1817075429;Taip;5;0;4;9
2601;Giraitė;Riešutėliai;6836412890;Taip;5;0;0;5
2602;Giraitė;Riešutėliai;9224845723;Taip;0;2;0;2
2603;Giraitė;Riešutėliai;4687228561;Taip;10;0;1;11
2604;Giraitė;Riešutėliai;9652807467;Ne;4;0;0;4
2605;Giraitė;Riešutėliai;9918028862;Taip;5;1;0;6
2606;Giraitė;Riešutėliai;1111614295;Taip;0;4;0;4
2607;Giraitė;Riešutėliai;1312761239;Taip;11;0;0;11
2608;Giraitė;Meškiukai;27501094616;Taip;0;1;0;1
2609;Giraitė;Meškiukai;2513312448;Taip;0;1;0;1
2610;Giraitė;Meškiukai;1608876140;Taip;0;1;0;1
2611;Giraitė;Meškiukai;5461837332;Ne;0;1;0;1
2612;Giraitė;Meškiukai;1355594003;Taip;0;8;0;8
2613;Giraitė;Meškiukai;1560868105;Taip;8;0;1;9
2614;Giraitė;Meškiukai;1050699551;Taip;2;5;1;8
2615;Giraitė;Meškiukai;1876815077;Taip;0;2;0;2
2616;Giraitė;Meškiukai;1063628206;Taip;0;5;0;5
2617;Giraitė;Meškiukai;1318214394;Taip;0;2;0;2
2618;Giraitė;Meškiukai;1846118720;Taip;2;0;0;2
2619;Giraitė;Meškiukai;9195735923;Taip;3;0;1;4
2620;Giraitė;Meškiukai;65251975467;Taip;5;10;0;15
2621;Giraitė;Meškiukai;1704154980;Taip;5;0;0;5
2622;Giraitė;Meškiukai;1819657811;Taip;8;1;0;9
2623;Giraitė;Meškiukai;1512384599;Taip;0;0;1;1
2624;Giraitė;Meškiukai;6156715234;Taip;7;0;1;8
2625;Giraitė;Meškiukai;1594965200;Ne;0;0;3;3
2626;Giraitė;Meškiukai;9723242940;Taip;6;0;0;6
2627;Giraitė;Meškiukai;5726182600;Taip;2;1;0;3
2628;Giraitė;Meškiukai;1772790396;Ne;10;0;1;11
2629;Giraitė;Šaltinėlis;8986196352;Taip;0;0;2;2
2630;Giraitė;Šaltinėlis;8590987283;Taip;0;0;10;10
2631;Giraitė;Šaltinėlis;31110630088;Taip;0;0;3;3
2632;Giraitė;Šaltinėlis;30804922053;Taip;0;3;0;3
2633;Giraitė;Šaltinėlis;1110792632;Taip;0;0;4;4
2634;Giraitė;Šaltinėlis;8824642760;Taip;0;0;1;1
2635;Giraitė;Šaltinėlis;99494458394;Taip;0;2;0;2
2636;Giraitė;Šaltinėlis;1103462199;Taip;0;1;0;1
2637;Giraitė;Šaltinėlis;99146206772;Taip;0;4;0;4
2638;Giraitė;Šaltinėlis;43475840493;Taip;0;2;0;2
2639;Giraitė;Šaltinėlis;1848908894;Taip;0;0;1;1
2640;Giraitė;Šaltinėlis;3031181239;Taip;0;8;0;8
2641;Giraitė;Boružėlės;7803047658;Taip;4;0;0;4
2642;Giraitė;Boružėlės;7566944002;Taip;0;0;2;2
2643;Giraitė;Boružėlės;3839432744;Taip;4;0;3;7
2644;Giraitė;Boružėlės;7423115504;Taip;2;0;0;2
2645;Giraitė;Boružėlės;6288016799;Taip;16;0;0;16
2646;Giraitė;Boružėlės;4371263826;Taip;8;0;0;8
2647;Giraitė;Boružėlės;5161383686;Taip;5;8;0;13
2648;Giraitė;Boružėlės;8567304224;Taip;18;0;0;18
2649;Giraitė;Boružėlės;7580600719;Taip;9;0;0;9
2650;Giraitė;Boružėlės;3116241918;Taip;4;0;0;4
2651;Giraitė;Boružėlės;4795464133;Taip;2;0;0;2
2652;Giraitė;Boružėlės;5148257412;Taip;15;0;0;15
2653;Giraitė;Boružėlės;7754329238;Taip;8;0;0;8
2654;Giraitė;Boružėlės;4168934880;Taip;8;0;0;8
2655;Giraitė;Boružėlės;9144465313;Taip;2;0;0;2
2656;Giraitė;Gandriukai;4680913596;Taip;2;0;0;2
2657;Giraitė;Gandriukai;5548434439;Taip;0;10;1;11
2658;Giraitė;Gandriukai;8525380061;Taip;8;3;1;12
2659;Giraitė;Gandriukai;7390702355;Taip;4;0;0;4
2660;Giraitė;Gandriukai;5826790173;Ne;17;0;0;17
2661;Giraitė;Gandriukai;4851987149;Taip;10;0;0;10
2662;Giraitė;Gandriukai;2205108811;Taip;2;1;0;3
2663;Giraitė;Gandriukai;3082550878;Taip;10;0;0;10
2664;Giraitė;Gandriukai;7767820565;Taip;0;0;2;2
2665;Giraitė;Gandriukai;8819218663;Taip;9;0;1;10
2666;Giraitė;Gandriukai;7269074498;Taip;3;0;1;4
2667;Giraitė;ŽVIRBLIUKAI;8461725999;Taip;5;0;1;6
2668;Giraitė;ŽVIRBLIUKAI;7395332578;Taip;0;14;1;15
2669;Giraitė;ŽVIRBLIUKAI;5086296808;Taip;0;13;0;13
2670;Giraitė;ŽVIRBLIUKAI;9471560738;Taip;0;2;0;2
2671;Giraitė;ŽVIRBLIUKAI;6677278422;Taip;16;0;0;16
2672;Giraitė;ŽVIRBLIUKAI;7230351549;Taip;0;3;0;3
2673;Giraitė;ŽVIRBLIUKAI;9728453316;Taip;8;0;0;8
2674;Giraitė;ŽVIRBLIUKAI;9392127689;Taip;5;0;0;5
2675;Giraitė;ŽVIRBLIUKAI;2416162886;Taip;4;0;0;4
2676;Giraitė;ŽVIRBLIUKAI;6293111179;Taip;9;0;0;9
2677;Giraitė;ŽVIRBLIUKAI;7543605905;Taip;9;1;0;10
2678;Giraitė;ŽVIRBLIUKAI;8128401630;Taip;5;0;0;5
2679;Giraitė;Kiškeliai;4288937528;Taip;7;0;0;7
2680;Giraitė;Kiškeliai;3085107071;Taip;8;0;1;9
2681;Giraitė;Kiškeliai;4440444700;Taip;11;0;0;11
2682;Giraitė;Kiškeliai;3348517050;Taip;9;0;1;10
2683;Giraitė;Kiškeliai;5275912609;Taip;0;0;2;2
2684;Giraitė;Kiškeliai;6315990604;Taip;9;0;0;9
2685;Giraitė;Kiškeliai;9751078590;Taip;2;0;2;4
2686;Giraitė;Kiškeliai;2219854347;Taip;10;0;0;10
2687;Giraitė;Kiškeliai;7807844145;Taip;13;0;0;13
2688;Giraitė;Kiškeliai;3757900478;Ne;2;0;0;2
2689;Giraitė;Kiškeliai;7876457529;Taip;5;0;1;6
2690;Giraitė;Kiškeliai;3992069614;Taip;10;0;0;10
2691;Giraitė;Kiškeliai;5356944812;Taip;10;0;0;10
2692;Gudrutis;Gandriukų;8621229735;Ne;0;0;1;1
2693;Gudrutis;Gandriukų;1225698076;Taip;11;0;0;11
2694;Gudrutis;Gandriukų;5408444872;Taip;0;0;1;1
2695;Gudrutis;Gandriukų;9697445037;Taip;4;0;0;4
2696;Gudrutis;Gandriukų;9752360809;Taip;0;4;0;4
2697;Gudrutis;Gandriukų;7934673005;Taip;6;0;1;7
2698;Gudrutis;Gandriukų;7006545234;Ne;0;2;0;2
2699;Gudrutis;Gandriukų;5241856014;Taip;2;0;0;2
2700;Gudrutis;Gandriukų;8500911420;Taip;0;0;3;3
2701;Gudrutis;Gandriukų;5728436444;Taip;0;1;0;1
2702;Gudrutis;Gandriukų;9041133527;Taip;0;1;0;1
2703;Gudrutis;Gandriukų;1384696362;Taip;3;1;1;5
2704;Gudrutis;Gandriukų;1587454709;Taip;6;0;0;6
2705;Gudrutis;"Saulės zuikučių";6835038962;Taip;7;0;2;9
2706;Gudrutis;"Saulės zuikučių";2118727861;Ne;11;0;1;12
2707;Gudrutis;"Saulės zuikučių";1725920873;Taip;5;0;1;6
2708;Gudrutis;"Saulės zuikučių";1901358996;Taip;9;0;0;9
2709;Gudrutis;"Saulės zuikučių";7664517480;Taip;0;0;6;6
2710;Gudrutis;"Saulės zuikučių";6731806925;Taip;0;0;1;1
2711;Gudrutis;"Saulės zuikučių";9701111916;Taip;0;5;4;9
2712;Gudrutis;"Saulės zuikučių";1228190677;Taip;5;0;2;7
2713;Gudrutis;"Saulės zuikučių";6198012431;Taip;0;1;0;1
2714;Gudrutis;"Saulės zuikučių";3646335609;Taip;0;21;0;21
2715;Gudrutis;"Saulės zuikučių";7871991275;Taip;0;0;5;5
2716;Gudrutis;"Saulės zuikučių";5580618896;Taip;0;0;5;5
2717;Gudrutis;"Saulės zuikučių";3625838131;Taip;0;4;0;4
2718;Gudrutis;"Saulės zuikučių";2337493193;Taip;0;7;0;7
2719;Gudrutis;"Saulės zuikučių";2764843216;Taip;8;8;2;18
2720;Gudrutis;"Saulės zuikučių";2468434676;Taip;0;0;2;2
2721;Gudrutis;"Saulės zuikučių";6700254479;Taip;4;0;2;6
2722;Gudrutis;"Saulės zuikučių";2408038213;Taip;0;0;2;2
2723;Gudrutis;"Saulės zuikučių";2293472716;Taip;0;0;1;1
2724;Gudrutis;Pelėdžiukų;7443277768;Taip;7;0;0;7
2725;Gudrutis;Pelėdžiukų;2592224860;Taip;5;1;0;6
2726;Gudrutis;Pelėdžiukų;6742455931;Ne;4;12;1;17
2727;Gudrutis;Pelėdžiukų;4193661251;Ne;0;2;0;2
2728;Gudrutis;Pelėdžiukų;9042793284;Taip;6;2;0;8
2729;Gudrutis;Pelėdžiukų;9797417587;Taip;0;1;0;1
2730;Gudrutis;Pelėdžiukų;5574287734;Taip;0;4;0;4
2731;Gudrutis;Pelėdžiukų;2431077357;Taip;0;2;0;2
2732;Gudrutis;Pelėdžiukų;7116979528;Taip;3;0;0;3
2733;Gudrutis;Pelėdžiukų;1693306014;Taip;0;4;0;4
2734;Gudrutis;Pelėdžiukų;8398961969;Taip;0;2;0;2
2735;Gudrutis;Pelėdžiukų;1991658503;Ne;0;1;5;6
2736;Gudrutis;Pelėdžiukų;9841172472;Taip;11;1;0;12
2737;Gudrutis;Pelėdžiukų;3359028602;Taip;0;1;5;6
2738;Gudrutis;Pelėdžiukų;4945755164;Taip;0;2;4;6
2739;Gudrutis;Pelėdžiukų;6443631536;Taip;0;0;1;1
2740;Gudrutis;Pelėdžiukų;3363824185;Taip;0;1;0;1
2741;Gudrutis;BITUČIŲ;1490739175;Taip;0;0;3;3
2742;Gudrutis;BITUČIŲ;35401545938;Taip;0;0;2;2
2743;Gudrutis;BITUČIŲ;1823786522;Taip;0;3;0;3
2744;Gudrutis;BITUČIŲ;80775017833;Taip;1;0;1;2
2745;Gudrutis;BITUČIŲ;87981934125;Taip;0;0;1;1
2746;Gudrutis;BITUČIŲ;1592255250;Taip;5;0;2;7
2747;Gudrutis;BITUČIŲ;1618442704;Taip;0;0;4;4
2748;Gudrutis;BITUČIŲ;77776725399;Taip;0;2;0;2
2749;Gudrutis;BITUČIŲ;8768627605;Taip;0;1;0;1
2750;Gudrutis;BITUČIŲ;21494647270;Taip;0;4;0;4
2751;Gudrutis;BITUČIŲ;18320321051;Taip;0;0;1;1
2752;Gudrutis;BITUČIŲ;1156575830;Taip;5;0;0;5
2753;Gudrutis;BITUČIŲ;11383212272;Taip;0;2;0;2
2754;Gudrutis;BITUČIŲ;1434565790;Taip;9;8;2;19
2755;Gudrutis;BITUČIŲ;1998630017;Taip;0;1;3;4
2756;Gudrutis;Boružėlių;2197278086;Ne;8;0;0;8
2757;Gudrutis;Boružėlių;1701035039;Taip;5;0;0;5
2758;Gudrutis;Boružėlių;7984911632;Taip;10;0;0;10
2759;Gudrutis;Boružėlių;7755882832;Taip;5;1;0;6
2760;Gudrutis;Boružėlių;8807008147;Taip;0;0;10;10
2761;Gudrutis;Boružėlių;1012579870;Ne;21;0;0;21
2762;Gudrutis;Boružėlių;8512130106;Taip;4;1;0;5
2763;Gudrutis;Boružėlių;3919786807;Taip;4;0;2;6
2764;Gudrutis;Boružėlių;2487363252;Ne;0;0;3;3
2765;Gudrutis;Boružėlių;8165828215;Taip;0;2;3;5
2766;Gudrutis;Boružėlių;5508723821;Taip;5;4;0;9
2767;Gudrutis;Boružėlių;7942601528;Ne;0;2;4;6
2768;Gudrutis;Boružėlių;4844838728;Taip;11;1;1;13
2769;Gudrutis;Boružėlių;1051407930;Taip;0;0;1;1
2770;Gudrutis;Boružėlių;7663746093;Taip;0;0;5;5
2771;Gudrutis;Boružėlių;1485530468;Taip;10;0;0;10
2772;Gudrutis;Boružėlių;5790418638;Taip;0;1;6;7
2773;Gudrutis;Boružėlių;9253468183;Taip;0;1;0;1
2774;Gudrutis;Drugeliai;4600814480;Ne;0;0;4;4
2775;Gudrutis;Drugeliai;9454206104;Taip;0;4;0;4
2776;Gudrutis;Drugeliai;5054363773;Taip;6;0;0;6
2777;Gudrutis;Drugeliai;3264829331;Taip;9;0;0;9
2778;Gudrutis;Drugeliai;7143849852;Taip;0;0;6;6
2779;Gudrutis;Drugeliai;9784116399;Taip;9;0;0;9
2780;Gudrutis;Drugeliai;3743529726;Taip;14;0;0;14
2781;Gudrutis;Drugeliai;3760014407;Taip;0;0;5;5
2782;Jurginėlis;Ąžuoliukai;7753784918;Ne;0;0;18;18
2783;Jurginėlis;Ąžuoliukai;4852619394;Taip;0;0;4;4
2784;Jurginėlis;Ąžuoliukai;8972814655;Taip;7;0;4;11
2785;Jurginėlis;Ąžuoliukai;1829089083;Taip;0;0;1;1
2786;Jurginėlis;Ąžuoliukai;8784076886;Taip;5;0;1;6
2787;Jurginėlis;Ąžuoliukai;47243459592;Taip;2;1;0;3
2788;Jurginėlis;Ąžuoliukai;1563317396;Taip;0;2;0;2
2789;Jurginėlis;Ąžuoliukai;3068120316;Taip;5;1;3;9
2790;Jurginėlis;Ąžuoliukai;6111863896;Taip;0;13;0;13
2791;Jurginėlis;Ąžuoliukai;4851923549;Taip;0;0;9;9
2792;Jurginėlis;Ąžuoliukai;1467200002;Taip;0;0;2;2
2793;Jurginėlis;Ąžuoliukai;1758862051;Taip;0;2;0;2
2794;Jurginėlis;Ąžuoliukai;8338173095;Taip;0;0;1;1
2795;Jurginėlis;Ąžuoliukai;9589394406;Taip;0;0;2;2
2796;Jurginėlis;Ąžuoliukai;3027573572;Taip;0;1;2;3
2797;Jurginėlis;Ąžuoliukai;2171115974;Taip;4;0;0;4
2798;Jurginėlis;Ąžuoliukai;8920304044;Taip;0;0;1;1
2799;Jurginėlis;Ąžuoliukai;5756997642;Taip;6;8;0;14
2800;Jurginėlis;Ąžuoliukai;2446630485;Taip;4;0;0;4
2801;Jurginėlis;Ąžuoliukai;5386710069;Taip;10;0;1;11
2802;Jurginėlis;Žiogeliai;5892180334;Taip;0;1;0;1
2803;Jurginėlis;Žiogeliai;8144038013;Taip;0;6;0;6
2804;Jurginėlis;Žiogeliai;7928799065;Taip;0;1;0;1
2805;Jurginėlis;Žiogeliai;2624313807;Taip;0;16;0;16
2806;Jurginėlis;Žiogeliai;1547101731;Taip;0;8;0;8
2807;Jurginėlis;Žiogeliai;9646318532;Taip;5;1;0;6
2808;Jurginėlis;Žiogeliai;5242359650;Taip;0;1;0;1
2809;Jurginėlis;Žiogeliai;903039398;Taip;0;1;0;1
2810;Jurginėlis;Žiogeliai;1102466152;Taip;0;2;0;2
2811;Jurginėlis;Žiogeliai;4806248290;Ne;0;1;0;1
2812;Jurginėlis;Žiogeliai;1082593212;Taip;0;6;0;6
2813;Jurginėlis;Žiogeliai;1175441410;Taip;0;11;0;11
2814;Jurginėlis;Žiogeliai;1983924909;Taip;0;7;0;7
2815;Jurginėlis;Žiogeliai;1586599624;Taip;0;2;0;2
2816;Jurginėlis;Žiogeliai;7297672386;Taip;0;2;0;2
2817;Jurginėlis;Žiogeliai;1787311340;Taip;0;11;0;11
2818;Jurginėlis;Žiogeliai;2639125463;Taip;2;1;0;3
2819;Jurginėlis;Žiogeliai;6413324051;Taip;0;10;0;10
2820;Jurginėlis;Žiogeliai;3708774681;Taip;21;0;0;21
2821;Jurginėlis;Žiogeliai;7920082372;Ne;14;2;0;16
2822;Jurginėlis;Žiogeliai;77480957625;Taip;8;1;0;9
2823;Jurginėlis;Pelėdžiukų;9882919290;Taip;0;0;1;1
2824;Jurginėlis;Pelėdžiukų;5984893389;Taip;0;4;0;4
2825;Jurginėlis;Pelėdžiukų;3079495897;Taip;16;0;0;16
2826;Jurginėlis;Pelėdžiukų;8727844649;Taip;13;0;0;13
2827;Jurginėlis;Pelėdžiukų;1455749921;Ne;13;6;0;19
2828;Jurginėlis;Pelėdžiukų;9946892497;Taip;13;2;1;16
2829;Jurginėlis;Pelėdžiukų;2417314519;Taip;8;0;0;8
2830;Jurginėlis;Pelėdžiukų;6968528293;Taip;0;4;0;4
2831;Jurginėlis;Pelėdžiukų;4292932046;Ne;0;1;2;3
2832;Jurginėlis;Pelėdžiukų;9507571301;Taip;0;0;1;1
2833;Jurginėlis;Pelėdžiukų;8779807396;Taip;10;0;0;10
2834;Jurginėlis;Pelėdžiukų;8876608072;Taip;0;11;0;11
2835;Jurginėlis;Pelėdžiukų;8443412187;Ne;0;0;6;6
2836;Jurginėlis;Pelėdžiukų;4967548277;Taip;10;14;0;24
2837;Jurginėlis;Pelėdžiukų;2925253653;Ne;15;0;1;16
2838;Jurginėlis;Pelėdžiukų;1340689348;Taip;9;0;0;9
2839;Jurginėlis;Pelėdžiukų;2221708420;Ne;8;0;3;11
2840;Jurginėlis;Pelėdžiukų;6181547354;Taip;18;0;0;18
2841;Jurginėlis;Pelėdžiukų;2490875633;Taip;18;0;1;19
2842;Jurginėlis;Pelėdžiukų;1454724752;Taip;0;0;1;1
2843;Jurginėlis;Pelėdžiukų;9760394658;Taip;5;0;0;5
2844;Jurginėlis;Boružėlių;51685299187;Ne;4;0;0;4
2845;Jurginėlis;Boružėlių;1828295769;Taip;0;2;0;2
2846;Jurginėlis;Boružėlių;68109772993;Taip;17;0;0;17
2847;Jurginėlis;Boružėlių;1329203545;Taip;0;2;0;2
2848;Jurginėlis;Boružėlių;1400142372;Taip;5;3;0;8
2849;Jurginėlis;Boružėlių;1881790340;Taip;0;6;0;6
2850;Jurginėlis;Boružėlių;81064432153;Taip;4;1;0;5
2851;Jurginėlis;Boružėlių;87991288027;Ne;1;1;0;2
2852;Jurginėlis;Boružėlių;1506649972;Taip;0;13;0;13
2853;Jurginėlis;Boružėlių;94107758268;Taip;0;6;0;6
2854;Jurginėlis;Boružėlių;20527253593;Taip;0;1;0;1
2855;Jurginėlis;Boružėlių;1258821883;Taip;0;1;0;1
2856;Jurginėlis;Boružėlių;92602685294;Taip;0;3;0;3
2857;Jurginėlis;Boružėlių;86427848578;Taip;0;2;0;2
2858;Jurginėlis;Bitučių;54494144846;Taip;0;6;0;6
2859;Jurginėlis;Bitučių;6072633581;Taip;0;5;0;5
2860;Jurginėlis;Bitučių;8414893303;Taip;0;1;0;1
2861;Jurginėlis;Bitučių;91909797332;Taip;0;1;0;1
2862;Jurginėlis;Bitučių;18273043496;Taip;0;1;0;1
2863;Jurginėlis;Bitučių;7449558199;Taip;10;1;0;11
2864;Jurginėlis;Bitučių;97726131559;Taip;0;0;3;3
2865;Jurginėlis;Bitučių;49181526821;Taip;0;1;0;1
2866;Jurginėlis;Bitučių;59935106302;Taip;0;0;5;5
2867;Jurginėlis;Bitučių;2544904907;Ne;7;1;0;8
2868;Jurginėlis;Bitučių;52877525045;Taip;5;0;0;5
2869;Jurginėlis;Bitučių;1295024976;Taip;3;3;1;7
2870;Jurginėlis;Bitučių;7278855565;Ne;0;0;6;6
2871;Jurginėlis;Skruzdeliukų;8509392550;Taip;13;0;0;13
2872;Jurginėlis;Skruzdeliukų;5734506036;Ne;8;4;0;12
2873;Jurginėlis;Skruzdeliukų;3038732180;Taip;18;0;1;19
2874;Jurginėlis;Skruzdeliukų;3699180485;Taip;6;6;0;12
2875;Jurginėlis;Skruzdeliukų;1634502874;Taip;5;0;4;9
2876;Jurginėlis;Skruzdeliukų;1763849354;Taip;4;0;5;9
2877;Jurginėlis;Skruzdeliukų;4944292549;Taip;0;11;0;11
2878;Jurginėlis;Skruzdeliukų;9506129699;Taip;5;0;1;6
2879;Jurginėlis;Skruzdeliukų;9550110246;Ne;10;2;1;13
2880;Jurginėlis;Skruzdeliukų;3822916547;Taip;17;0;1;18
2881;Jurginėlis;Skruzdeliukų;3541542063;Taip;8;0;0;8
2882;Jurginėlis;Skruzdeliukų;1204999684;Taip;10;0;2;12
2883;Jurginėlis;Skruzdeliukų;9937405742;Taip;11;0;0;11
2884;Jurginėlis;Skruzdeliukų;1726968598;Taip;0;17;0;17
2885;Jurginėlis;Skruzdeliukų;2332714713;Taip;6;0;0;6
2886;Jurginėlis;Skruzdeliukų;9961083854;Taip;0;6;0;6
2887;Jurginėlis;Skruzdeliukų;5180951251;Taip;0;7;0;7
2888;Jurginėlis;Skruzdeliukų;6542567172;Taip;10;4;0;14
2889;Jurginėlis;Drugelių;8823175066;Taip;6;0;0;6
2890;Jurginėlis;Drugelių;2820249307;Taip;5;0;0;5
2891;Jurginėlis;Drugelių;6197396872;Taip;0;0;4;4
2892;Jurginėlis;Drugelių;6341896288;Taip;6;0;7;13
2893;Jurginėlis;Drugelių;5958832413;Taip;0;7;0;7
2894;Jurginėlis;Drugelių;3558752347;Taip;4;4;0;8
2895;Jurginėlis;Drugelių;4432849717;Taip;0;2;2;4
2896;Jurginėlis;Drugelių;8017976529;Ne;7;1;1;9
2897;Jurginėlis;Drugelių;6587382160;Taip;0;0;15;15
2898;Jurginėlis;Drugelių;8097652962;Taip;5;0;1;6
2899;Jurginėlis;Drugelių;3530906368;Ne;0;0;2;2
2900;Jurginėlis;Drugelių;6671759364;Taip;10;0;2;12
2901;Jurginėlis;Drugelių;8937404520;Ne;0;0;1;1
2902;Jurginėlis;Drugelių;9146039217;Taip;3;1;0;4
2903;Jurginėlis;Drugelių;8161347781;Taip;0;8;0;8
2904;Jurginėlis;Drugelių;4113264904;Taip;5;0;0;5
2905;Jurginėlis;Žibučių;4979618298;Taip;9;1;0;10
2906;Jurginėlis;Žibučių;6636147085;Taip;10;0;0;10
2907;Jurginėlis;Žibučių;1438159631;Taip;2;2;0;4
2908;Jurginėlis;Žibučių;1336429135;Taip;5;0;0;5
2909;Jurginėlis;Žibučių;6988386438;Taip;0;2;0;2
2910;Jurginėlis;Žibučių;5936508522;Ne;8;1;0;9
2911;Jurginėlis;Žibučių;6717892969;Ne;15;0;0;15
2912;Jurginėlis;Žibučių;5126282685;Taip;16;0;0;16
2913;Jurginėlis;Žibučių;7977676733;Taip;10;0;0;10
2914;Jurginėlis;Žibučių;3899526893;Taip;0;1;0;1
2915;Jurginėlis;Žibučių;3861311860;Taip;5;1;0;6
2916;Jurginėlis;Žibučių;5549766339;Taip;10;3;0;13
2917;Jurginėlis;Žibučių;5563270020;Taip;9;3;0;12
2918;Jurginėlis;Žibučių;4429780802;Taip;5;3;0;8
2919;Jurginėlis;Zuikučių;1762685527;Ne;0;2;0;2
2920;Jurginėlis;Zuikučių;8178112926;Taip;0;3;0;3
2921;Jurginėlis;Zuikučių;78496894090;Taip;0;1;1;2
2922;Jurginėlis;Zuikučių;51603579121;Ne;0;5;0;5
2923;Jurginėlis;Zuikučių;9714764714;Taip;9;3;0;12
2924;Jurginėlis;Zuikučių;2264351097;Taip;0;0;4;4
2925;Jurginėlis;Zuikučių;6475508583;Taip;10;6;0;16
2926;Jurginėlis;Zuikučių;91517951071;Taip;0;2;0;2
2927;Jurginėlis;Zuikučių;7419836868;Ne;4;3;0;7
2928;Jurginėlis;Zuikučių;6217229672;Ne;0;1;0;1
2929;Jurginėlis;Zuikučių;1500087367;Taip;5;0;1;6
2930;Jurginėlis;Zuikučių;1773100970;Taip;5;0;1;6
2931;Jurginėlis;Zuikučių;1498351759;Ne;0;1;2;3
2932;Jurginėlis;Zuikučių;8084970770;Ne;5;0;0;5
2933;Jurginėlis;Zuikučių;1159550277;Taip;3;11;0;14
2934;Jurginėlis;Zuikučių;75383941896;Taip;0;1;3;4
2935;Jurginėlis;Zuikučių;87444065733;Taip;0;9;0;9
2936;Jurginėlis;Zuikučių;1927843089;Taip;5;0;0;5
2937;Jurginėlis;Zuikučių;6707289955;Taip;1;1;0;2
2938;Jurginėlis;Viščiukų;6794056622;Taip;0;0;4;4
2939;Jurginėlis;Viščiukų;7010130915;Taip;0;0;3;3
2940;Jurginėlis;Viščiukų;4763313715;Taip;7;0;0;7
2941;Jurginėlis;Viščiukų;7907096012;Taip;3;0;0;3
2942;Jurginėlis;Viščiukų;7250246853;Taip;0;11;0;11
2943;Jurginėlis;Viščiukų;4110053674;Taip;8;0;0;8
2944;Jurginėlis;Viščiukų;2896233141;Taip;0;1;0;1
2945;Jurginėlis;Viščiukų;6438669072;Taip;0;5;0;5
2946;Jurginėlis;Viščiukų;7300018733;Taip;6;3;0;9
2947;Jurginėlis;Viščiukų;4674128568;Taip;0;8;0;8
2948;Jurginėlis;Viščiukų;9305884152;Taip;0;0;1;1
2949;Jurginėlis;Meškiukų;6202225321;Taip;10;0;0;10
2950;Jurginėlis;Meškiukų;5861418459;Taip;3;0;0;3
2951;Jurginėlis;Meškiukų;6851855147;Taip;2;0;3;5
2952;Jurginėlis;Meškiukų;7081618073;Taip;2;1;0;3
2953;Jurginėlis;Meškiukų;2501462080;Taip;3;0;3;6
2954;Jurginėlis;Meškiukų;5869170503;Taip;0;2;3;5
2955;Jurginėlis;Meškiukų;5861832676;Taip;0;0;11;11
2956;Jurginėlis;Meškiukų;8571054905;Taip;8;0;1;9
2957;Jurginėlis;Meškiukų;6168508647;Taip;0;0;1;1
2958;Jurginėlis;Meškiukų;8969526123;Taip;10;0;3;13
2959;Jurginėlis;Meškiukų;9571275146;Taip;0;9;6;15
2960;Jurginėlis;Meškiukų;3933113321;Ne;0;10;0;10
2961;Jurginėlis;Gandriukų;6806704355;Taip;8;8;0;16
2962;Jurginėlis;Gandriukų;9288380246;Taip;0;6;0;6
2963;Jurginėlis;Gandriukų;2548920722;Taip;15;0;2;17
2964;Jurginėlis;Gandriukų;2627736026;Taip;16;2;1;19
2965;Jurginėlis;Gandriukų;7288921301;Ne;7;0;0;7
2966;Jurginėlis;Gandriukų;4827340942;Ne;20;0;0;20
2967;Jurginėlis;Gandriukų;4463258777;Taip;5;0;0;5
2968;Jurginėlis;Gandriukų;5921714669;Taip;10;1;0;11
2969;Jurginėlis;Gandriukų;1414888906;Taip;11;0;1;12
2970;Jurginėlis;Gandriukų;2225892248;Taip;5;0;0;5
2971;Jurginėlis;Gandriukų;6579565337;Taip;0;0;3;3
2972;Jurginėlis;Gandriukų;7990015623;Ne;12;1;0;13
2973;Jurginėlis;Gandriukų;4158502752;Taip;5;1;0;6
2974;Jurginėlis;Gandriukų;3284464951;Taip;12;5;0;17
2975;Jurginėlis;Gandriukų;2263818210;Ne;0;2;0;2
2976;Jurginėlis;Gandriukų;3091019969;Ne;13;0;0;13
2977;Jurginėlis;Gandriukų;2837099502;Taip;6;0;3;9
2978;Jurginėlis;Gandriukų;4295285885;Ne;0;8;0;8
2979;Jurginėlis;Gandriukų;3462969423;Ne;2;0;0;2
2980;Jurginėlis;Gandriukų;7486778826;Taip;17;1;0;18
2981;Karusėlė;PAGRANDUKAS;1621482372;Taip;0;19;0;19
2982;Karusėlė;PAGRANDUKAS;3330374479;Taip;5;0;1;6
2983;Karusėlė;PAGRANDUKAS;6183785840;Taip;5;2;0;7
2984;Karusėlė;PAGRANDUKAS;3984262482;Taip;12;0;1;13
2985;Karusėlė;PAGRANDUKAS;9130534156;Taip;16;0;0;16
2986;Karusėlė;PAGRANDUKAS;5132581245;Taip;0;4;0;4
2987;Karusėlė;PAGRANDUKAS;2412418335;Taip;7;0;1;8
2988;Karusėlė;PAGRANDUKAS;7393434659;Taip;6;0;1;7
2989;Karusėlė;PAGRANDUKAS;5695697634;Taip;5;0;2;7
2990;Karusėlė;PAGRANDUKAS;8127218866;Taip;7;0;3;10
2991;Karusėlė;PAGRANDUKAS;3620722907;Taip;0;14;0;14
2992;Karusėlė;PAGRANDUKAS;7013765804;Ne;0;0;7;7
2993;Karusėlė;PAGRANDUKAS;3429495073;Taip;5;0;0;5
2994;Karusėlė;PAGRANDUKAS;5951045233;Taip;0;0;2;2
2995;Karusėlė;PAGRANDUKAS;6252613489;Taip;10;0;2;12
2996;Karusėlė;PAGRANDUKAS;5595950213;Taip;0;8;0;8
2997;Karusėlė;PAGRANDUKAS;6004882312;Taip;10;0;2;12
2998;Karusėlė;PAGRANDUKAS;6856800484;Ne;5;0;0;5
2999;Karusėlė;PAGRANDUKAS;5028265234;Taip;8;0;0;8
3000;Karusėlė;PAGRANDUKAS;3972815393;Ne;6;0;1;7
3001;Karusėlė;PAGRANDUKAS;8157193503;Taip;12;2;0;14
3002;Karusėlė;PAGRANDUKAS;8656806219;Taip;0;0;1;1
3003;Karusėlė;NYKŠTUKAS;1560316431;Taip;0;9;0;9
3004;Karusėlė;NYKŠTUKAS;77290004668;Ne;9;0;0;9
3005;Karusėlė;NYKŠTUKAS;1250530261;Taip;14;0;1;15
3006;Karusėlė;NYKŠTUKAS;1397009220;Taip;6;8;0;14
3007;Karusėlė;NYKŠTUKAS;62938709605;Taip;8;0;0;8
3008;Karusėlė;NYKŠTUKAS;1534689679;Taip;11;0;0;11
3009;Karusėlė;NYKŠTUKAS;1226371512;Taip;0;0;1;1
3010;Karusėlė;NYKŠTUKAS;9377426384;Taip;0;3;0;3
3011;Karusėlė;NYKŠTUKAS;1311631554;Ne;6;7;0;13
3012;Karusėlė;NYKŠTUKAS;5481354767;Taip;13;0;1;14
3013;Karusėlė;NYKŠTUKAS;1135386852;Taip;11;0;1;12
3014;Karusėlė;NYKŠTUKAS;8419242504;Taip;0;6;0;6
3015;Karusėlė;NYKŠTUKAS;9683054409;Ne;0;0;1;1
3016;Karusėlė;NYKŠTUKAS;45634061915;Taip;0;10;0;10
3017;Karusėlė;NYKŠTUKAS;3453187182;Ne;0;0;1;1
3018;Karusėlė;NYKŠTUKAS;1886562437;Taip;0;5;0;5
3019;Karusėlė;NYKŠTUKAS;1915396083;Taip;7;1;0;8
3020;Karusėlė;BITUTĖ;1065703569;Taip;0;10;0;10
3021;Karusėlė;BITUTĖ;4291893779;Taip;6;1;0;7
3022;Karusėlė;BITUTĖ;1295435839;Taip;3;6;0;9
3023;Karusėlė;BITUTĖ;1883944064;Taip;0;0;3;3
3024;Karusėlė;BITUTĖ;3870601809;Taip;9;1;0;10
3025;Karusėlė;BITUTĖ;2001623432;Taip;5;0;0;5
3026;Karusėlė;BITUTĖ;8033732937;Taip;0;7;0;7
3027;Karusėlė;BITUTĖ;1593728369;Ne;7;2;0;9
3028;Karusėlė;BITUTĖ;9065247151;Taip;11;0;1;12
3029;Karusėlė;BITUTĖ;6417699445;Taip;0;6;0;6
3030;Karusėlė;BITUTĖ;1193711193;Taip;0;8;0;8
3031;Karusėlė;BITUTĖ;2426822679;Taip;10;0;0;10
3032;Karusėlė;BITUTĖ;1205498782;Taip;0;11;0;11
3033;Karusėlė;BITUTĖ;1322617786;Ne;4;0;0;4
3034;Karusėlė;BITUTĖ;7824913364;Taip;0;4;0;4
3035;Karusėlė;BITUTĖ;3875204515;Taip;10;0;0;10
3036;Karusėlė;BITUTĖ;7995385969;Taip;7;4;0;11
3037;Karusėlė;BITUTĖ;4993936605;Taip;0;9;1;10
3038;Karusėlė;BITUTĖ;8705188652;Ne;6;0;0;6
3039;Karusėlė;BORUŽĖLĖ;1705790474;Taip;0;2;1;3
3040;Karusėlė;BORUŽĖLĖ;8608177987;Taip;0;0;1;1
3041;Karusėlė;BORUŽĖLĖ;4890393582;Taip;0;11;0;11
3042;Karusėlė;BORUŽĖLĖ;1311907441;Taip;9;0;0;9
3043;Karusėlė;BORUŽĖLĖ;6313010762;Taip;0;3;0;3
3044;Karusėlė;BORUŽĖLĖ;5859827168;Taip;6;0;0;6
3045;Karusėlė;BORUŽĖLĖ;37349219339;Taip;5;0;0;5
3046;Karusėlė;BORUŽĖLĖ;49110267692;Taip;14;0;1;15
3047;Karusėlė;BORUŽĖLĖ;6811862463;Taip;0;12;0;12
3048;Karusėlė;BORUŽĖLĖ;5471989295;Taip;7;1;0;8
3049;Karusėlė;BORUŽĖLĖ;9753876554;Taip;10;0;1;11
3050;Karusėlė;BORUŽĖLĖ;1204919995;Taip;21;0;0;21
3051;Karusėlė;BORUŽĖLĖ;8717484092;Ne;5;3;0;8
3052;Karusėlė;BORUŽĖLĖ;1994682683;Taip;5;0;1;6
3053;Karusėlė;BORUŽĖLĖ;5632697184;Taip;7;0;1;8
3054;Karusėlė;BORUŽĖLĖ;2247913568;Taip;5;2;0;7
3055;Karusėlė;BORUŽĖLĖ;4262640017;Ne;5;4;0;9
3056;Karusėlė;BORUŽĖLĖ;4845558814;Taip;8;5;0;13
3057;Karusėlė;BORUŽĖLĖ;8406462155;Taip;8;0;0;8
3058;Karusėlė;BORUŽĖLĖ;6495631086;Taip;6;1;1;8
3059;Karusėlė;BORUŽĖLĖ;1183484176;Taip;0;16;0;16
3060;Karusėlė;BORUŽĖLĖ;2287979864;Ne;5;0;5;10
3061;Karusėlė;BORUŽĖLĖ;3389843421;Ne;0;4;0;4
3062;Karusėlė;UOGELĖ;9805481603;Taip;5;2;0;7
3063;Karusėlė;UOGELĖ;8182071103;Taip;5;0;2;7
3064;Karusėlė;UOGELĖ;8175498192;Taip;6;0;4;10
3065;Karusėlė;UOGELĖ;3053539045;Taip;0;0;5;5
3066;Karusėlė;UOGELĖ;9992989896;Taip;0;0;1;1
3067;Karusėlė;UOGELĖ;2084276906;Taip;0;11;0;11
3068;Karusėlė;UOGELĖ;1098106063;Taip;0;1;3;4
3069;Karusėlė;UOGELĖ;8665314366;Taip;0;6;0;6
3070;Karusėlė;UOGELĖ;4121668687;Taip;9;0;0;9
3071;Karusėlė;UOGELĖ;8316147204;Taip;0;3;0;3
3072;Karusėlė;UOGELĖ;5504719953;Taip;0;15;0;15
3073;Karusėlė;UOGELĖ;5919009583;Taip;10;3;0;13
3074;Karusėlė;UOGELĖ;4199597984;Taip;0;2;0;2
3075;Karusėlė;UOGELĖ;2383023280;Taip;10;1;0;11
3076;Karusėlė;UOGELĖ;1575408822;Taip;9;7;0;16
3077;Karusėlė;UOGELĖ;3917113787;Taip;3;0;0;3
3078;Karusėlė;UOGELĖ;1428516421;Taip;0;0;1;1
3079;Karusėlė;UOGELĖ;4638918427;Taip;0;0;2;2
3080;Karusėlė;UOGELĖ;3615957761;Taip;0;13;0;13
3081;Karusėlė;UOGELĖ;3514026443;Taip;0;15;0;15
3082;Karusėlė;UOGELĖ;1891147022;Taip;0;0;7;7
3083;Karusėlė;UOGELĖ;9389017016;Taip;4;0;0;4
3084;Karusėlė;GINTARĖLIS;89669425763;Taip;0;0;2;2
3085;Karusėlė;GINTARĖLIS;1058129883;Taip;11;0;1;12
3086;Karusėlė;GINTARĖLIS;1625704473;Taip;11;0;0;11
3087;Karusėlė;GINTARĖLIS;1467237683;Taip;6;0;2;8
3088;Karusėlė;GINTARĖLIS;33935704865;Taip;9;3;1;13
3089;Karusėlė;GINTARĖLIS;80377577910;Taip;0;0;7;7
3090;Karusėlė;GINTARĖLIS;1302846796;Taip;7;6;0;13
3091;Karusėlė;GINTARĖLIS;6181109173;Taip;0;0;1;1
3092;Karusėlė;GINTARĖLIS;90635580825;Taip;11;0;5;16
3093;Karusėlė;GINTARĖLIS;93635113154;Taip;4;0;5;9
3094;Karusėlė;GINTARĖLIS;2386140324;Taip;1;8;0;9
3095;Karusėlė;GINTARĖLIS;90731574209;Ne;0;0;10;10
3096;Karusėlė;GINTARĖLIS;77007130834;Taip;0;16;0;16
3097;Karusėlė;GINTARĖLIS;6596029324;Taip;3;10;0;13
3098;Karusėlė;GINTARĖLIS;1477282992;Taip;10;5;0;15
3099;Karusėlė;GINTARĖLIS;1487641646;Taip;0;2;0;2
3100;Karusėlė;GINTARĖLIS;9274456755;Taip;3;0;1;4
3101;Karusėlė;GINTARĖLIS;1159368221;Ne;7;5;0;12
3102;Karusėlė;GINTARĖLIS;2606829789;Ne;0;2;2;4
3103;Karusėlė;GINTARĖLIS;3224484582;Taip;0;0;1;1
3104;Karusėlė;GINTARĖLIS;47491327916;Taip;12;0;0;12
3105;Karusėlė;GINTARĖLIS;52452661421;Taip;4;1;0;5
3106;Karusėlė;SAULUTĖ;5627583683;Taip;0;0;6;6
3107;Karusėlė;SAULUTĖ;5985915835;Taip;8;0;0;8
3108;Karusėlė;SAULUTĖ;2242659064;Taip;0;0;9;9
3109;Karusėlė;SAULUTĖ;5704218177;Taip;10;0;1;11
3110;Karusėlė;SAULUTĖ;3696178849;Taip;12;0;5;17
3111;Karusėlė;SAULUTĖ;5146709341;Taip;2;1;0;3
3112;Karusėlė;SAULUTĖ;9996567374;Taip;0;3;0;3
3113;Karusėlė;SAULUTĖ;8331985564;Ne;6;0;0;6
3114;Karusėlė;SAULUTĖ;2007411601;Taip;4;0;2;6
3115;Karusėlė;SAULUTĖ;9400171357;Ne;17;0;0;17
3116;Karusėlė;SAULUTĖ;9656723409;Taip;0;0;3;3
3117;Karusėlė;SAULUTĖ;5766390337;Taip;7;0;0;7
3118;Karusėlė;SAULUTĖ;4879654321;Taip;0;0;11;11
3119;Karusėlė;SAULUTĖ;5803808409;Taip;0;4;0;4
3120;Karusėlė;SAULUTĖ;2269840705;Taip;0;9;0;9
3121;Karusėlė;SAULUTĖ;3149575456;Taip;5;0;2;7
3122;Karusėlė;SAULUTĖ;5640656442;Ne;12;0;1;13
3123;Karusėlė;SAULUTĖ;9451789237;Taip;10;0;1;11
3124;Karusėlė;SAULUTĖ;9450841251;Taip;12;0;1;13
3125;Karusėlė;SAULUTĖ;6338379641;Taip;10;0;2;12
3126;Karusėlė;SAULUTĖ;3082636224;Taip;3;0;6;9
3127;Karusėlė;SAULUTĖ;8830559511;Taip;5;0;0;5
3128;Karusėlė;TIGRIUKAS;18831943978;Taip;5;1;0;6
3129;Karusėlė;TIGRIUKAS;1305485683;Taip;5;0;0;5
3130;Karusėlė;TIGRIUKAS;1817869518;Taip;10;0;0;10
3131;Karusėlė;TIGRIUKAS;1773362652;Taip;1;1;0;2
3132;Karusėlė;TIGRIUKAS;3752570475;Ne;6;2;0;8
3133;Karusėlė;TIGRIUKAS;8881750322;Taip;0;1;0;1
3134;Karusėlė;TIGRIUKAS;8946147763;Taip;14;0;0;14
3135;Karusėlė;TIGRIUKAS;3960354989;Taip;10;0;0;10
3136;Karusėlė;TIGRIUKAS;1947403400;Taip;1;1;0;2
3137;Karusėlė;TIGRIUKAS;3690179876;Ne;0;0;3;3
3138;Karusėlė;TIGRIUKAS;7947148051;Taip;11;1;0;12
3139;Karusėlė;TIGRIUKAS;8076851284;Taip;5;0;0;5
3140;Karusėlė;TIGRIUKAS;4426462711;Taip;12;0;0;12
3141;Karusėlė;TIGRIUKAS;9484773068;Ne;14;0;0;14
3142;Karusėlė;TIGRIUKAS;8678437720;Taip;10;0;0;10
3143;Karusėlė;TIGRIUKAS;9868386182;Taip;2;0;0;2
3144;Karusėlė;TIGRIUKAS;1698478530;Taip;5;0;0;5
3145;Karusėlė;TIGRIUKAS;9561892809;Taip;17;0;0;17
3146;Karusėlė;TIGRIUKAS;9726299722;Taip;7;0;0;7
3147;Karusėlė;TIGRIUKAS;1576201225;Taip;16;0;0;16
3148;Karusėlė;TIGRIUKAS;9344514262;Taip;16;0;0;16
3149;Karusėlė;VAIVORYKŠTĖ;1289442716;Ne;13;0;2;15
3150;Karusėlė;VAIVORYKŠTĖ;9855242602;Taip;11;0;0;11
3151;Karusėlė;VAIVORYKŠTĖ;2894817418;Taip;0;0;13;13
3152;Karusėlė;VAIVORYKŠTĖ;6546648346;Taip;0;11;0;11
3153;Karusėlė;VAIVORYKŠTĖ;8063412271;Taip;5;1;0;6
3154;Karusėlė;VAIVORYKŠTĖ;9408843254;Taip;3;0;0;3
3155;Karusėlė;VAIVORYKŠTĖ;3514315636;Taip;8;0;0;8
3156;Karusėlė;VAIVORYKŠTĖ;8085919723;Taip;8;0;0;8
3157;Karusėlė;VAIVORYKŠTĖ;5444753290;Taip;12;0;3;15
3158;Karusėlė;VAIVORYKŠTĖ;1581504806;Taip;9;0;0;9
3159;Karusėlė;VAIVORYKŠTĖ;2215367063;Taip;13;0;0;13
3160;Karusėlė;VAIVORYKŠTĖ;6424622497;Taip;0;1;3;4
3161;Karusėlė;VAIVORYKŠTĖ;5855430678;Taip;0;6;0;6
3162;Karusėlė;VAIVORYKŠTĖ;1604997207;Taip;0;0;1;1
3163;Karusėlė;VAIVORYKŠTĖ;2757263085;Ne;3;0;0;3
3164;Karusėlė;VAIVORYKŠTĖ;6444553698;Taip;11;0;1;12
3165;Karusėlė;VAIVORYKŠTĖ;5767879226;Taip;0;5;0;5
3166;Karusėlė;VAIVORYKŠTĖ;9400856559;Ne;5;0;0;5
3167;Karusėlė;VAIVORYKŠTĖ;1083786182;Ne;5;0;0;5
3168;Karusėlė;VAIVORYKŠTĖ;6734936247;Taip;0;12;0;12
3169;Karusėlė;"AUKSINĖ ŽUVELĖ";3714893919;Taip;0;0;4;4
3170;Karusėlė;"AUKSINĖ ŽUVELĖ";8855096080;Taip;8;1;0;9
3171;Karusėlė;"AUKSINĖ ŽUVELĖ";2397938004;Taip;0;1;1;2
3172;Karusėlė;"AUKSINĖ ŽUVELĖ";3696384277;Taip;0;2;0;2
3173;Karusėlė;"AUKSINĖ ŽUVELĖ";4445214427;Taip;0;6;0;6
3174;Karusėlė;"AUKSINĖ ŽUVELĖ";7439791054;Taip;12;0;0;12
3175;Karusėlė;"AUKSINĖ ŽUVELĖ";3605966015;Taip;10;0;1;11
3176;Karusėlė;"AUKSINĖ ŽUVELĖ";2993499990;Taip;8;0;0;8
3177;Karusėlė;"AUKSINĖ ŽUVELĖ";9997776739;Taip;5;0;0;5
3178;Karusėlė;"AUKSINĖ ŽUVELĖ";9354431582;Taip;0;0;1;1
3179;Karusėlė;RAMUNĖ;8409412605;Taip;4;0;2;6
3180;Karusėlė;RAMUNĖ;8481143199;Taip;3;0;0;3
3181;Karusėlė;RAMUNĖ;7599328323;Ne;5;1;0;6
3182;Karusėlė;RAMUNĖ;1019322763;Taip;6;0;1;7
3183;Karusėlė;RAMUNĖ;3534074990;Taip;5;0;0;5
3184;Karusėlė;RAMUNĖ;3904453423;Taip;0;1;5;6
3185;Karusėlė;RAMUNĖ;7489136297;Taip;6;1;0;7
3186;Karusėlė;RAMUNĖ;3136606610;Taip;5;0;0;5
3187;Karusėlė;RAMUNĖ;6581798125;Taip;5;0;0;5
3188;Karusėlė;RAMUNĖ;2688863117;Taip;5;0;0;5
3189;Karusėlė;RAMUNĖ;3460470459;Ne;11;1;0;12
3190;Karusėlė;"NAUJA DARŽELIS";8012963667;Taip;0;1;4;5
3191;Karusėlė;"NAUJA DARŽELIS";7501323454;Taip;9;0;0;9
3192;Karusėlė;"NAUJA DARŽELIS";4130693235;Taip;12;1;0;13
3193;Karusėlė;"NAUJA DARŽELIS";2306922755;Taip;0;8;2;10
3194;Karusėlė;"NAUJA DARŽELIS";9340167973;Taip;5;1;0;6
3195;Karusėlė;"NAUJA DARŽELIS";6826455161;Taip;0;0;2;2
3196;Karusėlė;"NAUJA DARŽELIS";6062361348;Taip;5;6;0;11
3197;Karusėlė;"NAUJA DARŽELIS";2160071272;Taip;0;0;2;2
3198;Karusėlė;"NAUJA DARŽELIS";5135054911;Taip;5;0;0;5
3199;Karusėlė;"NAUJA DARŽELIS";2727440190;Taip;0;0;4;4
3200;Karusėlė;"NAUJA DARŽELIS";3049506194;Taip;5;0;5;10
3201;Karusėlė;"NAUJA DARŽELIS";3661917922;Taip;6;0;0;6
3202;Karusėlė;"NAUJA DARŽELIS";4211688032;Taip;0;0;2;2
3203;Karusėlė;"NAUJA DARŽELIS";3271464159;Taip;6;0;0;6
3204;Karusėlė;"NAUJA DARŽELIS";4735916273;Ne;5;0;0;5
3205;Karusėlė;"NAUJA DARŽELIS";4325959483;Taip;7;0;0;7
3206;Kaštonas;NYKŠTUKAI;4806350914;Taip;5;2;0;7
3207;Kaštonas;NYKŠTUKAI;9168456496;Taip;0;7;0;7
3208;Kaštonas;NYKŠTUKAI;8990194475;Taip;0;11;0;11
3209;Kaštonas;NYKŠTUKAI;5099098185;Taip;0;4;0;4
3210;Kaštonas;NYKŠTUKAI;8166925991;Taip;0;13;0;13
3211;Kaštonas;NYKŠTUKAI;2165890763;Taip;0;3;0;3
3212;Kaštonas;NYKŠTUKAI;5884427036;Taip;0;5;0;5
3213;Kaštonas;NYKŠTUKAI;9061158412;Ne;0;4;0;4
3214;Kaštonas;NYKŠTUKAI;2832688622;Ne;0;4;0;4
3215;Kaštonas;NYKŠTUKAI;6114301692;Ne;0;4;0;4
3216;Kaštonas;NYKŠTUKAI;8483888152;Taip;0;6;0;6
3217;Kaštonas;NYKŠTUKAI;7408901858;Taip;0;11;0;11
3218;Kaštonas;NYKŠTUKAI;8582453109;Taip;0;9;0;9
3219;Kaštonas;NYKŠTUKAI;6251564828;Ne;6;4;0;10
3220;Kaštonas;NYKŠTUKAI;8257643251;Taip;8;6;0;14
3221;Kaštonas;NYKŠTUKAI;5969052108;Taip;6;1;0;7
3222;Kaštonas;NYKŠTUKAI;2106924435;Ne;0;1;0;1
3223;Kaštonas;NYKŠTUKAI;5307755844;Taip;0;5;0;5
3224;Kaštonas;NYKŠTUKAI;4215759647;Taip;0;7;0;7
3225;Kaštonas;DRUGELIAI;37382772659;Taip;0;5;0;5
3226;Kaštonas;DRUGELIAI;1023364928;Taip;0;2;0;2
3227;Kaštonas;DRUGELIAI;1931800904;Taip;0;2;0;2
3228;Kaštonas;DRUGELIAI;46191613797;Ne;0;1;0;1
3229;Kaštonas;DRUGELIAI;6511223066;Ne;4;0;0;4
3230;Kaštonas;DRUGELIAI;9287426151;Taip;0;2;0;2
3231;Kaštonas;DRUGELIAI;81834426663;Taip;0;1;0;1
3232;Kaštonas;DRUGELIAI;1011339389;Ne;0;6;2;8
3233;Kaštonas;DRUGELIAI;9985164505;Ne;5;4;0;9
3234;Kaštonas;DRUGELIAI;5557487532;Taip;0;6;0;6
3235;Kaštonas;DRUGELIAI;70838449788;Taip;6;1;0;7
3236;Kaštonas;DRUGELIAI;9595277597;Ne;0;7;0;7
3237;Kaštonas;DRUGELIAI;8297662673;Taip;4;0;0;4
3238;Kaštonas;DRUGELIAI;8042807487;Taip;0;2;0;2
3239;Kaštonas;DRUGELIAI;5722934228;Taip;6;2;0;8
3240;Kaštonas;DRUGELIAI;9702914628;Taip;4;0;0;4
3241;Kaštonas;DRUGELIAI;2417951642;Taip;0;2;0;2
3242;Kaštonas;DRUGELIAI;3059036526;Taip;4;1;0;5
3243;Kaštonas;KIŠKUČIAI;6175014441;Taip;8;1;0;9
3244;Kaštonas;KIŠKUČIAI;5659508302;Taip;6;0;0;6
3245;Kaštonas;KIŠKUČIAI;8275673303;Taip;9;1;0;10
3246;Kaštonas;KIŠKUČIAI;3228788999;Taip;0;15;0;15
3247;Kaštonas;KIŠKUČIAI;2877124424;Taip;15;1;0;16
3248;Kaštonas;KIŠKUČIAI;8214699601;Taip;0;8;0;8
3249;Kaštonas;KIŠKUČIAI;4837002666;Taip;12;1;0;13
3250;Kaštonas;KIŠKUČIAI;1748975865;Taip;0;4;0;4
3251;Kaštonas;KIŠKUČIAI;9903176616;Ne;5;3;0;8
3252;Kaštonas;KIŠKUČIAI;4061364544;Taip;0;4;0;4
3253;Kaštonas;KIŠKUČIAI;1614180834;Taip;18;1;0;19
3254;Kaštonas;KIŠKUČIAI;1031628633;Ne;14;1;0;15
3255;Kaštonas;KIŠKUČIAI;4551111709;Ne;12;1;0;13
3256;Kaštonas;KIŠKUČIAI;8014645421;Taip;3;1;0;4
3257;Kaštonas;KIŠKUČIAI;1761520786;Taip;0;21;0;21
3258;Kaštonas;KIŠKUČIAI;9285927858;Taip;0;17;0;17
3259;Kaštonas;KIŠKUČIAI;8250964197;Taip;3;1;0;4
3260;Kaštonas;KIŠKUČIAI;9069518153;Taip;0;8;0;8
3261;Kaštonas;KIŠKUČIAI;7946379086;Ne;0;3;0;3
3262;Kaštonas;KIŠKUČIAI;6589898580;Taip;17;1;0;18
3263;Kaštonas;KIŠKUČIAI;9379171183;Taip;0;1;0;1
3264;Kaštonas;KIŠKUČIAI;2701042709;Taip;5;0;0;5
3265;Kaštonas;BITUTĖS;1162926887;Taip;0;2;0;2
3266;Kaštonas;BITUTĖS;1465714333;Taip;15;1;0;16
3267;Kaštonas;BITUTĖS;1252815477;Taip;0;7;0;7
3268;Kaštonas;BITUTĖS;9215070593;Taip;5;2;0;7
3269;Kaštonas;BITUTĖS;57362664278;Taip;0;1;0;1
3270;Kaštonas;BITUTĖS;1747580231;Ne;8;7;0;15
3271;Kaštonas;BITUTĖS;4449017708;Ne;0;12;0;12
3272;Kaštonas;BITUTĖS;3638565578;Ne;3;14;0;17
3273;Kaštonas;BITUTĖS;8906976150;Taip;7;1;0;8
3274;Kaštonas;BITUTĖS;2539596633;Taip;5;0;0;5
3275;Kaštonas;BITUTĖS;7776071299;Taip;4;1;0;5
3276;Kaštonas;BITUTĖS;3039980710;Taip;0;8;0;8
3277;Kaštonas;BITUTĖS;3507672150;Taip;8;4;0;12
3278;Kaštonas;BITUTĖS;1826015013;Ne;0;3;0;3
3279;Kaštonas;BITUTĖS;5630659056;Taip;6;3;0;9
3280;Kaštonas;BITUTĖS;2007064959;Taip;0;21;0;21
3281;Kaštonas;BITUTĖS;1859126564;Ne;0;12;0;12
3282;Kaštonas;BITUTĖS;2797443202;Taip;10;4;0;14
3283;Kaštonas;BITUTĖS;4033866425;Taip;6;3;0;9
3284;Kaštonas;BITUTĖS;7508357392;Taip;5;0;0;5
3285;Kaštonas;BITUTĖS;8151333699;Taip;6;0;0;6
3286;Kaštonas;BITUTĖS;7291448857;Taip;7;0;0;7
3287;Kaštonas;BITUTĖS;5328263421;Taip;5;6;0;11
3288;Kaštonas;BITUTĖS;3649329598;Taip;0;18;0;18
3289;Kaštonas;BITUTĖS;8152577445;Taip;5;0;0;5
3290;Kaštonas;MEŠKIUKAI;8797584508;Taip;13;0;0;13
3291;Kaštonas;MEŠKIUKAI;7138581709;Taip;6;2;0;8
3292;Kaštonas;MEŠKIUKAI;9965517774;Taip;6;2;0;8
3293;Kaštonas;MEŠKIUKAI;1196590128;Taip;0;4;0;4
3294;Kaštonas;MEŠKIUKAI;1385352925;Taip;0;1;0;1
3295;Kaštonas;MEŠKIUKAI;2125410714;Ne;5;7;0;12
3296;Kaštonas;MEŠKIUKAI;6606094891;Taip;7;6;0;13
3297;Kaštonas;MEŠKIUKAI;1364391105;Taip;7;6;0;13
3298;Kaštonas;MEŠKIUKAI;6967725663;Taip;0;15;0;15
3299;Kaštonas;MEŠKIUKAI;5153948802;Taip;3;1;0;4
3300;Kaštonas;MEŠKIUKAI;5157500600;Ne;3;8;0;11
3301;Kaštonas;MEŠKIUKAI;7911007041;Ne;4;5;0;9
3302;Kaštonas;MEŠKIUKAI;3554337770;Taip;5;2;0;7
3303;Kaštonas;MEŠKIUKAI;65960895249;Taip;5;0;0;5
3304;Kaštonas;MEŠKIUKAI;1249299633;Taip;0;5;5;10
3305;Kaštonas;MEŠKIUKAI;2597987154;Taip;8;0;0;8
3306;Kaštonas;MEŠKIUKAI;6289073634;Ne;0;15;0;15
3307;Kaštonas;MEŠKIUKAI;2434765663;Ne;10;0;0;10
3308;Kaštonas;MEŠKIUKAI;7553024183;Taip;0;21;0;21
3309;Kaštonas;MEŠKIUKAI;8446233414;Taip;11;5;0;16
3310;Kaštonas;MEŠKIUKAI;1801371129;Ne;0;1;0;1
3311;Kaštonas;MEŠKIUKAI;4824511567;Taip;6;1;0;7
3312;Kaštonas;MEŠKIUKAI;3961661158;Taip;6;3;0;9
3313;Kaštonas;MEŠKIUKAI;7956422880;Taip;7;6;0;13
3314;Kaštonas;MEŠKIUKAI;4444087861;Ne;12;2;0;14
3315;Kaštonas;MEŠKIUKAI;4616084852;Taip;5;6;0;11
3316;Kaštonas;BORUŽĖLĖS;7290414209;Ne;0;13;0;13
3317;Kaštonas;BORUŽĖLĖS;9320223622;Ne;0;8;0;8
3318;Kaštonas;BORUŽĖLĖS;6896372095;Ne;5;4;0;9
3319;Kaštonas;BORUŽĖLĖS;9356018629;Taip;5;1;0;6
3320;Kaštonas;BORUŽĖLĖS;7992154554;Taip;5;1;0;6
3321;Kaštonas;BORUŽĖLĖS;2020612346;Taip;5;1;0;6
3322;Kaštonas;BORUŽĖLĖS;4384907654;Ne;3;1;0;4
3323;Kaštonas;BORUŽĖLĖS;3544696101;Taip;0;13;0;13
3324;Kaštonas;BORUŽĖLĖS;4020980625;Ne;0;3;0;3
3325;Kaštonas;BORUŽĖLĖS;5391954600;Taip;0;2;0;2
3326;Kaštonas;BORUŽĖLĖS;3383390078;Taip;0;12;0;12
3327;Kaštonas;BORUŽĖLĖS;9778140363;Ne;0;3;0;3
3328;Krivūlė;SPINDULIUKAI;3233000497;Ne;2;0;2;4
3329;Krivūlė;SPINDULIUKAI;2191720088;Ne;2;0;2;4
3330;Krivūlė;SPINDULIUKAI;9865192795;Ne;0;0;1;1
3331;Krivūlė;SPINDULIUKAI;4094383258;Ne;0;0;4;4
3332;Krivūlė;SPINDULIUKAI;3913058095;Taip;0;0;2;2
3333;Krivūlė;SPINDULIUKAI;5057452653;Ne;5;0;0;5
3334;Krivūlė;SPINDULIUKAI;7335245963;Ne;4;0;0;4
3335;Krivūlė;SPINDULIUKAI;5802739148;Ne;10;0;1;11
3336;Krivūlė;SPINDULIUKAI;5667934115;Ne;0;0;1;1
3337;Krivūlė;SPINDULIUKAI;8348288864;Taip;5;0;0;5
3338;Krivūlė;SPINDULIUKAI;7155162698;Ne;3;0;3;6
3339;Krivūlė;SPINDULIUKAI;1151179495;Ne;6;0;0;6
3340;Krivūlė;SPINDULIUKAI;7997564406;Ne;0;5;0;5
3341;Krivūlė;SPINDULIUKAI;4750075323;Ne;0;0;1;1
3342;Krivūlė;BORUŽĖLĖS;4969782237;Taip;0;0;1;1
3343;Krivūlė;BORUŽĖLĖS;3605506478;Ne;7;0;1;8
3344;Krivūlė;BORUŽĖLĖS;4896656209;Ne;7;0;1;8
3345;Krivūlė;BORUŽĖLĖS;4845515196;Ne;0;1;3;4
3346;Krivūlė;BORUŽĖLĖS;6935969502;Taip;3;0;6;9
3347;Krivūlė;BORUŽĖLĖS;4972360440;Taip;17;0;0;17
3348;Krivūlė;BORUŽĖLĖS;7318064702;Taip;0;10;0;10
3349;Krivūlė;BORUŽĖLĖS;3912620138;Taip;3;0;4;7
3350;Krivūlė;BORUŽĖLĖS;5531566792;Taip;0;0;1;1
3351;Krivūlė;BORUŽĖLĖS;2386053480;Taip;0;10;6;16
3352;Krivūlė;BORUŽĖLĖS;8586287004;Taip;0;0;5;5
3353;Krivūlė;BORUŽĖLĖS;4540069843;Ne;0;0;10;10
3354;Krivūlė;BORUŽĖLĖS;4297876008;Taip;6;0;2;8
3355;Krivūlė;BORUŽĖLĖS;2138125571;Taip;4;0;1;5
3356;Krivūlė;BORUŽĖLĖS;4177660973;Taip;0;3;0;3
3357;Krivūlė;BORUŽĖLĖS;2517785727;Taip;11;0;0;11
3358;Krivūlė;BORUŽĖLĖS;2711010212;Taip;5;0;1;6
3359;Krivūlė;BORUŽĖLĖS;4025821636;Ne;17;0;0;17
3360;Krivūlė;BORUŽĖLĖS;7781918674;Ne;5;0;0;5
3361;Krivūlė;BORUŽĖLĖS;1987255206;Ne;13;0;3;16
3362;Krivūlė;BORUŽĖLĖS;7025398689;Taip;4;0;0;4
3363;Krivūlė;DRUGELIŲ;8463621294;Taip;0;0;5;5
3364;Krivūlė;DRUGELIŲ;4824008306;Ne;7;0;0;7
3365;Krivūlė;DRUGELIŲ;8500798014;Taip;0;0;1;1
3366;Krivūlė;DRUGELIŲ;65962324027;Ne;8;0;0;8
3367;Krivūlė;DRUGELIŲ;20743334216;Ne;0;3;0;3
3368;Krivūlė;DRUGELIŲ;55527703561;Ne;0;0;3;3
3369;Krivūlė;DRUGELIŲ;16591459661;Ne;3;0;0;3
3370;Krivūlė;DRUGELIŲ;76285364171;Ne;0;0;1;1
3371;Krivūlė;DRUGELIŲ;49106308532;Taip;6;0;2;8
3372;Krivūlė;DRUGELIŲ;1974755599;Taip;0;1;1;2
3373;Krivūlė;DRUGELIŲ;7477773004;Taip;0;0;2;2
3374;Krivūlė;DRUGELIŲ;50186813736;Taip;5;0;1;6
3375;Krivūlė;DRUGELIŲ;4648003100;Ne;9;1;0;10
3376;Krivūlė;DRUGELIŲ;10433396718;Taip;0;2;0;2
3377;Krivūlė;DRUGELIŲ;2125078552;Taip;0;0;1;1
3378;Krivūlė;DRUGELIŲ;86659723162;Taip;0;0;3;3
3379;Krivūlė;DRUGELIŲ;2099607493;Taip;12;1;0;13
3380;Krivūlė;DRUGELIŲ;1699961817;Taip;0;0;4;4
3381;Krivūlė;"BITUTĖS (VALDOFRO)";46337826378;Taip;0;8;1;9
3382;Krivūlė;"BITUTĖS (VALDOFRO)";3994278221;Taip;0;0;1;1
3383;Krivūlė;"BITUTĖS (VALDOFRO)";18486357195;Taip;0;0;1;1
3384;Krivūlė;"BITUTĖS (VALDOFRO)";4248042049;Taip;0;21;0;21
3385;Krivūlė;"BITUTĖS (VALDOFRO)";4982146852;Taip;0;21;0;21
3386;Krivūlė;"BITUTĖS (VALDOFRO)";3769812444;Taip;0;7;0;7
3387;Krivūlė;"BITUTĖS (VALDOFRO)";5128760019;Taip;0;7;0;7
3388;Krivūlė;"BITUTĖS (VALDOFRO)";1851097789;Taip;0;0;2;2
3389;Krivūlė;"BITUTĖS (VALDOFRO)";5113297248;Taip;0;0;7;7
3390;Krivūlė;"BITUTĖS (VALDOFRO)";7848471009;Ne;0;0;8;8
3391;Krivūlė;"BITUTĖS (VALDOFRO)";5405660104;Taip;0;0;2;2
3392;Krivūlė;"BITUTĖS (VALDOFRO)";8834855616;Ne;11;0;0;11
3393;Krivūlė;"BITUTĖS (VALDOFRO)";3655576855;Ne;0;0;2;2
3394;Krivūlė;"BITUTĖS (VALDOFRO)";9702372816;Taip;5;0;0;5
3395;Krivūlė;"BITUTĖS (VALDOFRO)";6753080815;Ne;13;0;8;21
3396;Krivūlė;"BITUTĖS (VALDOFRO)";4619224314;Ne;13;0;8;21
3397;Krivūlė;"BITUTĖS (VALDOFRO)";4244217571;Taip;10;0;0;10
3398;Krivūlė;"BITUTĖS (VALDOFRO)";1932209134;Taip;0;0;2;2
3399;Krivūlė;"BITUTĖS (VALDOFRO)";7768827505;Taip;0;10;0;10
3400;Krivūlė;EŽIUKAI;2302809484;Taip;0;0;1;1
3401;Krivūlė;EŽIUKAI;96319752378;Ne;5;0;0;5
3402;Krivūlė;EŽIUKAI;66981981114;Ne;0;0;1;1
3403;Krivūlė;EŽIUKAI;81401012140;Taip;5;0;2;7
3404;Krivūlė;EŽIUKAI;1039316424;Taip;0;0;2;2
3405;Krivūlė;EŽIUKAI;3787326918;Taip;0;0;4;4
3406;Krivūlė;EŽIUKAI;1940633287;Ne;0;0;3;3
3407;Krivūlė;EŽIUKAI;1807774373;Ne;6;0;0;6
3408;Krivūlė;EŽIUKAI;8628201310;Taip;0;0;5;5
3409;Krivūlė;EŽIUKAI;2764636358;Ne;0;0;7;7
3410;Krivūlė;EŽIUKAI;1738370642;Taip;0;0;3;3
3411;Krivūlė;NYKŠTUKAI;37502093836;Taip;0;2;2;4
3412;Krivūlė;NYKŠTUKAI;83840444975;Taip;0;2;2;4
3413;Krivūlė;NYKŠTUKAI;9267414141;Taip;0;0;1;1
3414;Krivūlė;NYKŠTUKAI;2109315338;Taip;0;0;2;2
3415;Krivūlė;NYKŠTUKAI;7873123757;Taip;0;1;1;2
3416;Krivūlė;NYKŠTUKAI;1515185307;Taip;0;0;3;3
3417;Krivūlė;NYKŠTUKAI;1217856292;Ne;3;0;0;3
3418;Krivūlė;NYKŠTUKAI;3064591570;Taip;20;0;0;20
3419;Krivūlė;NYKŠTUKAI;9311270695;Taip;0;0;7;7
3420;Krivūlė;NYKŠTUKAI;6861483854;Ne;5;7;3;15
3421;Krivūlė;NYKŠTUKAI;5818988913;Taip;0;1;0;1
3422;Krivūlė;NYKŠTUKAI;2654066358;Taip;8;0;2;10
3423;Krivūlė;NYKŠTUKAI;5966543639;Ne;0;0;7;7
3424;Krivūlė;NYKŠTUKAI;2903062788;Ne;6;0;1;7
3425;Krivūlė;"PABIRUČIŲ (Vokiečių g. 1)";3076382863;Ne;4;0;0;4
3426;Krivūlė;"PABIRUČIŲ (Vokiečių g. 1)";4845066055;Ne;0;0;10;10
3427;Krivūlė;"PABIRUČIŲ (Vokiečių g. 1)";7528273082;Ne;0;5;2;7
3428;Krivūlė;"PABIRUČIŲ (Vokiečių g. 1)";5592144285;Ne;0;0;1;1
3429;Krivūlė;"PABIRUČIŲ (Vokiečių g. 1)";8042469720;Ne;0;0;3;3
3430;Krivūlė;"PABIRUČIŲ (Vokiečių g. 1)";7508079584;Ne;0;0;5;5
3431;Krivūlė;"PABIRUČIŲ (Vokiečių g. 1)";6575864256;Ne;6;0;3;9
3432;Krivūlė;"PABIRUČIŲ (Vokiečių g. 1)";1815336153;Taip;0;0;4;4
3433;Krivūlė;"PABIRUČIŲ (Vokiečių g. 1)";4491462086;Ne;0;20;0;20
3434;Krivūlė;"PABIRUČIŲ (Vokiečių g. 1)";1561180871;Ne;0;5;0;5
3435;Krivūlė;"PABIRUČIŲ (Vokiečių g. 1)";6521798502;Ne;7;0;0;7
3436;Krivūlė;"PABIRUČIŲ (Vokiečių g. 1)";3324090723;Ne;6;0;0;6
3437;Krivūlė;"PABIRUČIŲ (Vokiečių g. 1)";1277485419;Ne;8;0;3;11
3438;Krivūlė;"PABIRUČIŲ (Vokiečių g. 1)";9328365491;Ne;0;0;3;3
3439;Krivūlė;"PABIRUČIŲ (Vokiečių g. 1)";4773564048;Taip;0;1;0;1
3440;Krivūlė;"PABIRUČIŲ (Vokiečių g. 1)";9229817861;Taip;0;0;6;6
3441;Krivūlė;"SMALSUČIŲ (Vokiečių g.1)";5753204752;Ne;0;0;6;6
3442;Krivūlė;"SMALSUČIŲ (Vokiečių g.1)";6241144079;Taip;0;0;3;3
3443;Krivūlė;"SMALSUČIŲ (Vokiečių g.1)";2659604299;Taip;1;0;1;2
3444;Krivūlė;"SMALSUČIŲ (Vokiečių g.1)";1622495013;Taip;0;7;4;11
3445;Krivūlė;"SMALSUČIŲ (Vokiečių g.1)";7436569684;Taip;9;1;0;10
3446;Krivūlė;"SMALSUČIŲ (Vokiečių g.1)";6072261879;Ne;5;0;6;11
3447;Krivūlė;"SMALSUČIŲ (Vokiečių g.1)";7904390075;Ne;11;0;1;12
3448;Krivūlė;"SMALSUČIŲ (Vokiečių g.1)";5149419581;Taip;10;0;1;11
3449;Krivūlė;"SMALSUČIŲ (Vokiečių g.1)";7789605738;Taip;0;0;2;2
3450;Krivūlė;"SMALSUČIŲ (Vokiečių g.1)";5097101097;Taip;4;0;0;4
3451;Krivūlė;"SMALSUČIŲ (Vokiečių g.1)";9693693101;Ne;0;0;11;11
3452;Krivūlė;"SMALSUČIŲ (Vokiečių g.1)";5462491857;Taip;10;1;1;12
3453;Krivūlė;"SMALSUČIŲ (Vokiečių g.1)";1791812461;Ne;0;6;0;6
3454;Krivūlė;"SMALSUČIŲ (Vokiečių g.1)";7727246187;Ne;0;0;1;1
3455;Krivūlė;"GUDRUČIŲ (Vokiečių g. 1)";1180183091;Taip;5;0;3;8
3456;Krivūlė;"GUDRUČIŲ (Vokiečių g. 1)";6543038595;Taip;0;1;11;12
3457;Krivūlė;"GUDRUČIŲ (Vokiečių g. 1)";3405470634;Ne;0;0;2;2
3458;Krivūlė;"GUDRUČIŲ (Vokiečių g. 1)";1371753067;Ne;3;3;0;6
3459;Krivūlė;"GUDRUČIŲ (Vokiečių g. 1)";8301938009;Ne;0;3;0;3
3460;Krivūlė;"GUDRUČIŲ (Vokiečių g. 1)";2012112541;Taip;0;7;4;11
3461;Krivūlė;"GUDRUČIŲ (Vokiečių g. 1)";4668155071;Taip;0;0;5;5
3462;Krivūlė;"GUDRUČIŲ (Vokiečių g. 1)";1774829898;Ne;0;6;0;6
3463;Krivūlė;"GUDRUČIŲ (Vokiečių g. 1)";4261133734;Taip;6;0;0;6
3464;Krivūlė;"GUDRUČIŲ (Vokiečių g. 1)";9388057389;Taip;5;0;5;10
3465;Krivūlė;"GUDRUČIŲ (Vokiečių g. 1)";3583848327;Ne;3;0;5;8
3466;Krivūlė;"GUDRUČIŲ (Vokiečių g. 1)";9801268758;Ne;4;0;0;4
3467;Krivūlė;"GUDRUČIŲ (Vokiečių g. 1)";6429160371;Taip;0;0;8;8
3468;Krivūlė;"GUDRUČIŲ (Vokiečių g. 1)";3924127476;Taip;0;5;0;5
3469;Krivūlė;"GUDRUČIŲ (Vokiečių g. 1)";5274553442;Taip;0;19;0;19
3470;Krivūlė;"GUDRUČIŲ (Vokiečių g. 1)";1956705813;Taip;0;0;5;5
3471;Krivūlė;"GUDRUČIŲ (Vokiečių g. 1)";24951231987;Taip;0;0;15;15
3472;Kodėlčiukas;Saulutės;1725624698;Taip;6;2;1;9
3473;Kodėlčiukas;Saulutės;7509476161;Taip;5;0;2;7
3474;Kodėlčiukas;Saulutės;1645680526;Taip;0;0;1;1
3475;Kodėlčiukas;Saulutės;8992265000;Taip;0;0;8;8
3476;Kodėlčiukas;Saulutės;6285018663;Taip;5;6;0;11
3477;Kodėlčiukas;Saulutės;1033969800;Taip;12;0;0;12
3478;Kodėlčiukas;Saulutės;2433094435;Ne;3;0;1;4
3479;Kodėlčiukas;Saulutės;3276075664;Taip;0;0;1;1
3480;Kodėlčiukas;Saulutės;3141225891;Taip;5;0;6;11
3481;Kodėlčiukas;Saulutės;7611485881;Taip;2;1;0;3
3482;Kodėlčiukas;Saulutės;7561763602;Taip;5;0;1;6
3483;Kodėlčiukas;Nežiniukai;6045564826;Ne;4;0;1;5
3484;Kodėlčiukas;Nežiniukai;7136890681;Taip;0;0;3;3
3485;Kodėlčiukas;Nežiniukai;7971932716;Taip;5;0;0;5
3486;Kodėlčiukas;Nežiniukai;7282579315;Taip;12;0;4;16
3487;Kodėlčiukas;Nežiniukai;6905424567;Taip;5;0;1;6
3488;Kodėlčiukas;Nežiniukai;1233880820;Taip;10;0;0;10
3489;Kodėlčiukas;Nežiniukai;5443377251;Taip;0;1;0;1
3490;Kodėlčiukas;Nežiniukai;3150006441;Taip;0;0;2;2
3491;Kodėlčiukas;Nežiniukai;7626940433;Taip;9;2;0;11
3492;Kodėlčiukas;Nežiniukai;9803206596;Taip;0;10;3;13
3493;Kodėlčiukas;Nežiniukai;4917910801;Taip;6;0;0;6
3494;Kodėlčiukas;Nežiniukai;6248137523;Ne;0;6;1;7
3495;Kodėlčiukas;Nežiniukai;3473981974;Taip;0;0;4;4
3496;Kodėlčiukas;Nežiniukai;4038168647;Taip;8;0;1;9
3497;Kodėlčiukas;Nežiniukai;8378295683;Taip;17;1;0;18
3498;Kodėlčiukas;Nežiniukai;6000831611;Taip;5;0;2;7
3499;Kodėlčiukas;Nežiniukai;7286497455;Taip;15;0;1;16
3500;Kodėlčiukas;Nežiniukai;1603752483;Taip;4;0;1;5
3501;Kodėlčiukas;Nežiniukai;6074758814;Ne;0;5;0;5
3502;Kodėlčiukas;Nežiniukai;1699358514;Taip;0;0;1;1
3503;Kodėlčiukas;Nežiniukai;1302383608;Ne;6;0;4;10
3504;Kodėlčiukas;Gintarėliai;2560864315;Taip;0;2;2;4
3505;Kodėlčiukas;Gintarėliai;58406224468;Taip;0;0;8;8
3506;Kodėlčiukas;Gintarėliai;1485012710;Taip;5;0;1;6
3507;Kodėlčiukas;Gintarėliai;2062878300;Ne;11;0;2;13
3508;Kodėlčiukas;Gintarėliai;20084022099;Taip;0;6;0;6
3509;Kodėlčiukas;Gintarėliai;1950934087;Taip;13;0;1;14
3510;Kodėlčiukas;Gintarėliai;9686497547;Taip;5;0;0;5
3511;Kodėlčiukas;Gintarėliai;4884104023;Ne;14;0;0;14
3512;Kodėlčiukas;Gintarėliai;1632458573;Taip;0;0;1;1
3513;Kodėlčiukas;Gintarėliai;9332136116;Taip;6;0;1;7
3514;Kodėlčiukas;Gintarėliai;8219424737;Taip;0;0;4;4
3515;Kodėlčiukas;Gintarėliai;4849314647;Taip;0;0;1;1
3516;Kodėlčiukas;Gintarėliai;5202375085;Taip;6;0;0;6
3517;Kodėlčiukas;Gintarėliai;3758606327;Taip;0;0;2;2
3518;Kodėlčiukas;Gintarėliai;8647609373;Taip;7;0;0;7
3519;Kodėlčiukas;Gintarėliai;5093139270;Taip;0;0;2;2
3520;Kodėlčiukas;Gintarėliai;4738357524;Taip;0;0;6;6
3521;Kodėlčiukas;Gintarėliai;8873629130;Taip;4;0;0;4
3522;Kodėlčiukas;Gintarėliai;1190408818;Taip;0;0;5;5
3523;Kodėlčiukas;Šnekučiai;1844016431;Taip;10;0;1;11
3524;Kodėlčiukas;Šnekučiai;1550915654;Taip;0;0;2;2
3525;Kodėlčiukas;Šnekučiai;1935757837;Taip;0;4;0;4
3526;Kodėlčiukas;Šnekučiai;41123326737;Taip;0;0;1;1
3527;Kodėlčiukas;Šnekučiai;8114859362;Taip;0;0;13;13
3528;Kodėlčiukas;Šnekučiai;1666743304;Ne;4;0;0;4
3529;Kodėlčiukas;Šnekučiai;9178209049;Taip;0;0;1;1
3530;Kodėlčiukas;Šnekučiai;5988863934;Taip;7;8;0;15
3531;Kodėlčiukas;Šnekučiai;2742365461;Taip;0;8;0;8
3532;Kodėlčiukas;Šnekučiai;76164689333;Ne;2;4;1;7
3533;Kodėlčiukas;Šnekučiai;5386820408;Taip;0;3;0;3
3534;Kodėlčiukas;Šnekučiai;6194726931;Taip;0;5;0;5
3535;Kodėlčiukas;Šnekučiai;5782600824;Taip;0;7;0;7
3536;Kodėlčiukas;Šnekučiai;7074381835;Ne;0;5;0;5
3537;Kodėlčiukas;Šnekučiai;7757494295;Taip;11;1;0;12
3538;Kodėlčiukas;Šnekučiai;2988674717;Taip;4;1;0;5
3539;Kodėlčiukas;Šnekučiai;4273202718;Taip;7;0;1;8
3540;Kodėlčiukas;Pabiručiai;7630180473;Taip;0;1;15;16
3541;Kodėlčiukas;Pabiručiai;8140940288;Taip;7;0;0;7
3542;Kodėlčiukas;Pabiručiai;7246243975;Ne;0;3;0;3
3543;Kodėlčiukas;Pabiručiai;1600501494;Taip;0;12;0;12
3544;Kodėlčiukas;Pabiručiai;3782714343;Taip;5;0;3;8
3545;Kodėlčiukas;Pabiručiai;3880019350;Taip;0;0;7;7
3546;Kodėlčiukas;Pabiručiai;4818678923;Ne;0;0;1;1
3547;Kodėlčiukas;Pabiručiai;9589692031;Taip;14;0;2;16
3548;Kodėlčiukas;Pabiručiai;1906128091;Taip;10;0;1;11
3549;Kodėlčiukas;Pabiručiai;8302606312;Taip;6;0;1;7
3550;Kodėlčiukas;Pabiručiai;9460792167;Taip;0;1;0;1
3551;Kodėlčiukas;Pabiručiai;1218904283;Taip;10;0;1;11
3552;Kodėlčiukas;Pabiručiai;2929946390;Taip;0;15;1;16
3553;Kodėlčiukas;Pabiručiai;1256650715;Taip;6;0;15;21
3554;Kodėlčiukas;Pabiručiai;1052656432;Taip;0;0;1;1
3555;Kodėlčiukas;Pabiručiai;9794875862;Taip;0;0;5;5
3556;Kodėlčiukas;Pabiručiai;9528997865;Taip;0;4;0;4
3557;Kodėlčiukas;Pabiručiai;1919722425;Taip;0;0;1;1
3558;Kodėlčiukas;Pabiručiai;2593524511;Taip;3;6;2;11
3559;Kodėlčiukas;Pabiručiai;8879977943;Taip;0;17;0;17
3560;Kodėlčiukas;Smalsučiai;1782784297;Taip;0;4;0;4
3561;Kodėlčiukas;Smalsučiai;12421864073;Taip;0;0;1;1
3562;Kodėlčiukas;Smalsučiai;1532235421;Taip;0;0;7;7
3563;Kodėlčiukas;Smalsučiai;8393750817;Ne;0;0;2;2
3564;Kodėlčiukas;Smalsučiai;1723716524;Taip;0;0;2;2
3565;Kodėlčiukas;Smalsučiai;1106092960;Taip;15;0;1;16
3566;Kodėlčiukas;Smalsučiai;20467065338;Ne;0;2;3;5
3567;Kodėlčiukas;Smalsučiai;6186365121;Ne;0;7;0;7
3568;Kodėlčiukas;Smalsučiai;1048653620;Ne;0;0;5;5
3569;Kodėlčiukas;Smalsučiai;1234971388;Ne;0;0;1;1
3570;Kodėlčiukas;Smalsučiai;32318234528;Ne;0;2;0;2
3571;Kodėlčiukas;Smalsučiai;84450296241;Taip;10;0;1;11
3572;Kodėlčiukas;Smalsučiai;2061169442;Taip;0;0;5;5
3573;Kodėlčiukas;Smalsučiai;70940790491;Taip;6;0;0;6
3574;Kodėlčiukas;Smalsučiai;6168432879;Taip;0;0;5;5
3575;Kodėlčiukas;Smalsučiai;3542081571;Taip;3;0;0;3
3576;Kodėlčiukas;Smalsučiai;1115828736;Taip;0;0;1;1
3577;Kodėlčiukas;Smalsučiai;1584936719;Taip;0;0;3;3
3578;Kodėlčiukas;Smalsučiai;1151612627;Ne;0;2;1;3
3579;Kodėlčiukas;Giliukai;26010333641;Taip;0;0;3;3
3580;Kodėlčiukas;Giliukai;97902789189;Ne;0;0;1;1
3581;Kodėlčiukas;Giliukai;99164081259;Taip;0;0;1;1
3582;Kodėlčiukas;Giliukai;93684599166;Taip;0;1;0;1
3583;Kodėlčiukas;Giliukai;88371652763;Taip;0;0;1;1
3584;Kodėlčiukas;Giliukai;80767435810;Taip;0;0;3;3
3585;Kodėlčiukas;Giliukai;1825630143;Taip;5;0;9;14
3586;Kodėlčiukas;Giliukai;11130172902;Ne;0;0;1;1
3587;Kodėlčiukas;Giliukai;2637712514;Taip;0;0;1;1
3588;Kodėlčiukas;Giliukai;45393129631;Taip;8;0;2;10
3589;Kodėlčiukas;Giliukai;47667750562;Taip;0;1;0;1
3590;Kodėlčiukas;Giliukai;8204069897;Taip;0;9;2;11
3591;Kodėlčiukas;Giliukai;29319461634;Taip;0;0;1;1
3592;Kodėlčiukas;Giliukai;37250933602;Taip;0;1;0;1
3593;Kodėlčiukas;Giliukai;1550337708;Taip;0;0;2;2
3594;Kodėlčiukas;Giliukai;4030981879;Taip;0;1;3;4
3595;Kodėlčiukas;Giliukai;44431255380;Taip;0;0;4;4
3596;Kodėlčiukas;Giliukai;1850261935;Taip;0;0;11;11
3597;Kodėlčiukas;Gudručiai;1191430672;Taip;0;6;0;6
3598;Kodėlčiukas;Gudručiai;6988515253;Taip;7;0;1;8
3599;Kodėlčiukas;Gudručiai;3385551650;Taip;6;0;1;7
3600;Kodėlčiukas;Gudručiai;7318908956;Taip;5;0;1;6
3601;Kodėlčiukas;Gudručiai;7430239198;Taip;1;0;0;1
3602;Kodėlčiukas;Gudručiai;8400610717;Taip;8;0;0;8
3603;Kodėlčiukas;Gudručiai;7116594055;Taip;0;0;5;5
3604;Kodėlčiukas;Gudručiai;1801366890;Taip;1;0;1;2
3605;Kodėlčiukas;Gudručiai;9483378853;Ne;0;6;0;6
3606;Kodėlčiukas;Gudručiai;8890987483;Taip;0;0;7;7
3607;Kodėlčiukas;Gudručiai;4687333060;Ne;5;1;0;6
3608;Kodėlčiukas;Gudručiai;1491160730;Taip;0;0;2;2
3609;Kodėlčiukas;Gudručiai;4543838852;Taip;6;0;1;7
3610;Kodėlčiukas;Gudručiai;2216791610;Taip;20;0;1;21
3611;Kodėlčiukas;Gudručiai;2987907651;Taip;10;0;1;11
3612;Kodėlčiukas;Gudručiai;9028856983;Taip;5;0;1;6
3613;Kodėlčiukas;Gudručiai;1588132166;Taip;0;1;0;1
3614;Kodėlčiukas;Gudručiai;6014084915;Taip;0;8;0;8
3615;Kodėlčiukas;Žirniukai;7937365710;Taip;9;0;0;9
3616;Kodėlčiukas;Žirniukai;8554322365;Taip;0;0;2;2
3617;Kodėlčiukas;Žirniukai;7007386353;Taip;10;0;0;10
3618;Kodėlčiukas;Žirniukai;2943146610;Taip;7;0;0;7
3619;Kodėlčiukas;Žirniukai;4689046394;Taip;5;0;0;5
3620;Kodėlčiukas;Žirniukai;2122779530;Taip;0;0;14;14
3621;Kodėlčiukas;Žirniukai;2740773904;Taip;0;0;5;5
3622;Kodėlčiukas;Žirniukai;8017465692;Taip;0;3;0;3
3623;Kodėlčiukas;Žirniukai;9733831323;Taip;3;0;0;3
3624;Kodėlčiukas;Žirniukai;9754425363;Taip;11;0;0;11
3625;Kodėlčiukas;Žirniukai;5587782917;Taip;4;0;0;4
3626;Kodėlčiukas;Žirniukai;9721353724;Taip;8;0;1;9
3627;Kodėlčiukas;Žirniukai;8785157050;Taip;2;0;5;7
3628;Kodėlčiukas;Žirniukai;5573845415;Taip;0;0;15;15
3629;Kodėlčiukas;Žirniukai;8100861190;Taip;0;0;8;8
3630;Kodėlčiukas;Katinėliai;8586746296;Ne;0;0;1;1
3631;Kodėlčiukas;Katinėliai;9278139998;Taip;1;0;0;1
3632;Kodėlčiukas;Katinėliai;5359866071;Taip;3;0;1;4
3633;Kodėlčiukas;Katinėliai;6008027505;Taip;9;0;1;10
3634;Kodėlčiukas;Katinėliai;9511144369;Taip;0;0;6;6
3635;Kodėlčiukas;Katinėliai;8189938439;Taip;1;14;0;15
3636;Kodėlčiukas;Katinėliai;2964318343;Taip;2;0;2;4
3637;Kodėlčiukas;Katinėliai;8427457478;Taip;5;0;1;6
3638;Kodėlčiukas;Katinėliai;6985788287;Taip;0;0;1;1
3639;Kodėlčiukas;Katinėliai;8444690698;Taip;5;0;0;5
3640;Kodėlčiukas;Katinėliai;5587200800;Taip;8;0;0;8
3641;Kodėlčiukas;Katinėliai;9480926599;Taip;10;0;0;10
3642;Kodėlčiukas;Katinėliai;7570122834;Taip;3;2;0;5
3643;Kodėlčiukas;Nykštukai;3882838712;Taip;0;0;2;2
3644;Kodėlčiukas;Nykštukai;6670171992;Taip;5;0;0;5
3645;Kodėlčiukas;Nykštukai;9992204262;Taip;5;0;2;7
3646;Kodėlčiukas;Nykštukai;3869826429;Taip;6;0;0;6
3647;Kodėlčiukas;Nykštukai;9830842598;Taip;10;0;0;10
3648;Kodėlčiukas;Nykštukai;8635107742;Taip;0;0;1;1
3649;Kodėlčiukas;Nykštukai;7705057116;Taip;5;0;0;5
3650;Kodėlčiukas;Nykštukai;8823086730;Taip;0;0;5;5
3651;Kodėlčiukas;Nykštukai;8759498015;Taip;3;0;0;3
3652;Kodėlčiukas;ŽIOGELIAI;7242653444;Taip;15;0;0;15
3653;Kodėlčiukas;ŽIOGELIAI;6232570825;Taip;0;0;5;5
3654;Kodėlčiukas;ŽIOGELIAI;2549153581;Taip;0;0;1;1
3655;Kodėlčiukas;ŽIOGELIAI;9398732476;Taip;0;0;4;4
3656;Kodėlčiukas;ŽIOGELIAI;1925590099;Taip;7;0;0;7
3657;Kodėlčiukas;ŽIOGELIAI;2298734536;Taip;0;4;3;7
3658;Kodėlčiukas;ŽIOGELIAI;7187797639;Taip;0;0;1;1
3659;Kodėlčiukas;ŽIOGELIAI;7643398934;Taip;0;0;5;5
3660;Kodėlčiukas;ŽIOGELIAI;7119815662;Taip;0;0;7;7
3661;Kodėlčiukas;ŽIOGELIAI;2871111867;Taip;1;0;0;1
3662;Kodėlčiukas;ŽIOGELIAI;3472862544;Taip;4;0;0;4
3663;Kodėlčiukas;ŽIOGELIAI;1808211253;Taip;3;0;2;5
3664;Kodėlčiukas;ŽIOGELIAI;8799798070;Taip;0;0;1;1
3665;Kodėlčiukas;BITUTĖS;3130715310;Taip;10;1;0;11
3666;Kodėlčiukas;BITUTĖS;2313607716;Taip;7;0;0;7
3667;Kodėlčiukas;BITUTĖS;5061852590;Taip;9;0;1;10
3668;Kodėlčiukas;BITUTĖS;8829986201;Taip;4;0;0;4
3669;Kodėlčiukas;BITUTĖS;3985455729;Taip;0;11;0;11
3670;Kodėlčiukas;BITUTĖS;3156788328;Taip;3;2;0;5
3671;Kodėlčiukas;BITUTĖS;5178305435;Taip;9;0;3;12
3672;Kodėlčiukas;BITUTĖS;8037386529;Taip;10;0;0;10
3673;Kodėlčiukas;BITUTĖS;5068611716;Taip;10;0;0;10
3674;Kodėlčiukas;BITUTĖS;8932472612;Taip;0;0;3;3
3675;Kodėlčiukas;BITUTĖS;7186835214;Taip;0;0;1;1
3676;Kodėlčiukas;VYŠNIUKAI;2162480212;Taip;3;0;0;3
3677;Kodėlčiukas;VYŠNIUKAI;3482802557;Taip;7;0;0;7
3678;Kodėlčiukas;VYŠNIUKAI;3778271049;Ne;6;6;3;15
3679;Kodėlčiukas;VYŠNIUKAI;1074477043;Ne;10;0;2;12
3680;Kodėlčiukas;VYŠNIUKAI;2542104903;Taip;0;4;0;4
3681;Kodėlčiukas;VYŠNIUKAI;3470151604;Taip;0;3;1;4
3682;Kodėlčiukas;VYŠNIUKAI;7510273691;Ne;5;0;1;6
3683;Kodėlčiukas;VYŠNIUKAI;4490196764;Ne;0;9;2;11
3684;Kodėlčiukas;VYŠNIUKAI;9527296531;Taip;0;5;0;5
3685;Kodėlčiukas;VYŠNIUKAI;2351468626;Taip;6;3;0;9
3686;Kodėlčiukas;VYŠNIUKAI;6764015170;Ne;9;5;1;15
3687;Kodėlčiukas;VYŠNIUKAI;8447045958;Taip;0;10;1;11
3688;Kodėlčiukas;VYŠNIUKAI;7647582987;Ne;4;0;3;7
3689;Kodėlčiukas;VYŠNIUKAI;3403889915;Taip;13;7;0;20
3690;Kodėlčiukas;VYŠNIUKAI;1160612316;Taip;11;0;3;14
3691;Kodėlčiukas;VYŠNIUKAI;8606551477;Taip;7;0;3;10
3692;Kodėlčiukas;VYŠNIUKAI;8070400563;Ne;0;0;1;1
3693;Kodėlčiukas;VYŠNIUKAI;1992569595;Ne;0;0;21;21
3694;Kodėlčiukas;BORUŽĖLĖS;9109362006;Taip;0;0;1;1
3695;Kodėlčiukas;BORUŽĖLĖS;9169500252;Taip;16;0;0;16
3696;Kodėlčiukas;BORUŽĖLĖS;9724373368;Taip;9;3;0;12
3697;Kodėlčiukas;BORUŽĖLĖS;6941978169;Taip;4;0;1;5
3698;Kodėlčiukas;BORUŽĖLĖS;5075801618;Taip;0;0;1;1
3699;Kodėlčiukas;BORUŽĖLĖS;2819860331;Taip;0;1;0;1
3700;Kodėlčiukas;BORUŽĖLĖS;4941186694;Ne;0;0;3;3
3701;Kodėlčiukas;BORUŽĖLĖS;4866089623;Ne;0;0;1;1
3702;Kodėlčiukas;BORUŽĖLĖS;5952121209;Taip;4;0;1;5
3703;Kodėlčiukas;BORUŽĖLĖS;4230906452;Ne;0;0;1;1
3704;Kodėlčiukas;BORUŽĖLĖS;6505671642;Taip;0;0;1;1
3705;Kodėlčiukas;BORUŽĖLĖS;9208137169;Ne;5;2;1;8
3706;Kodėlčiukas;BORUŽĖLĖS;5876187643;Taip;3;0;2;5
3707;Kodėlčiukas;BORUŽĖLĖS;1206798597;Taip;0;0;2;2
3708;Kodėlčiukas;BORUŽĖLĖS;1827752731;Taip;5;0;1;6
3709;Kodėlčiukas;BORUŽĖLĖS;1005178052;Taip;5;0;1;6
3710;Kodėlčiukas;VYTURĖLIAI;6714818379;Taip;0;7;0;7
3711;Kodėlčiukas;VYTURĖLIAI;4218096561;Taip;0;8;0;8
3712;Kodėlčiukas;VYTURĖLIAI;4514764005;Taip;4;0;2;6
3713;Kodėlčiukas;VYTURĖLIAI;2169307879;Taip;21;0;0;21
3714;Kodėlčiukas;VYTURĖLIAI;6476445296;Ne;2;6;1;9
3715;Kodėlčiukas;VYTURĖLIAI;2448536092;Taip;15;0;0;15
3716;Kodėlčiukas;VYTURĖLIAI;4585226357;Taip;16;0;2;18
3717;Kodėlčiukas;VYTURĖLIAI;4884233329;Taip;5;0;0;5
3718;Kodėlčiukas;VYTURĖLIAI;8263945732;Taip;0;0;4;4
3719;Kodėlčiukas;VYTURĖLIAI;7612531087;Taip;6;0;0;6
3720;Kodėlčiukas;VYTURĖLIAI;4937929385;Taip;1;0;0;1
3721;Kodėlčiukas;VYTURĖLIAI;2808361570;Taip;0;10;0;10
3722;Kodėlčiukas;VYTURĖLIAI;2904858964;Taip;16;0;1;17
3723;Kodėlčiukas;VYTURĖLIAI;9673271313;Taip;5;0;0;5
3724;Kodėlčiukas;VYTURĖLIAI;5710301153;Taip;0;0;2;2
3725;Kodėlčiukas;DRUGELIAI;4165123345;Taip;10;0;0;10
3726;Kodėlčiukas;DRUGELIAI;5772071707;Taip;7;0;0;7
3727;Kodėlčiukas;DRUGELIAI;1149682376;Taip;21;0;0;21
3728;Kodėlčiukas;DRUGELIAI;2353960861;Taip;0;0;2;2
3729;Kodėlčiukas;DRUGELIAI;6103959702;Taip;1;0;1;2
3730;Kodėlčiukas;DRUGELIAI;3267687337;Taip;21;0;0;21
3731;Kodėlčiukas;DRUGELIAI;5505788210;Taip;0;3;0;3
3732;Kodėlčiukas;DRUGELIAI;5577154148;Taip;6;0;0;6
3733;Kodėlčiukas;DRUGELIAI;8547039654;Taip;8;0;0;8
3734;Kodėlčiukas;DRUGELIAI;4202423480;Taip;0;3;1;4
3735;Kodėlčiukas;DRUGELIAI;9979034031;Taip;0;0;1;1
3736;Kodėlčiukas;DRUGELIAI;3240221130;Taip;0;0;1;1
3737;Kodėlčiukas;DRUGELIAI;7714816675;Taip;4;0;0;4
3738;Kodėlčiukas;DRUGELIAI;9664432781;Taip;0;0;4;4
3739;Kodėlčiukas;DRUGELIAI;5197946954;Taip;9;0;4;13
3740;Kodėlčiukas;"NAUJA (LOPŠELIS)";1289342844;Taip;0;5;0;5
3741;Kodėlčiukas;"NAUJA (LOPŠELIS)";8208448849;Taip;0;0;1;1
3742;Kodėlčiukas;"NAUJA (LOPŠELIS)";1683506414;Taip;0;0;2;2
3743;Kodėlčiukas;"NAUJA (LOPŠELIS)";3315862631;Taip;0;17;0;17
3744;Kodėlčiukas;"NAUJA (LOPŠELIS)";5896726125;Taip;0;0;2;2
3745;Kodėlčiukas;"NAUJA (LOPŠELIS)";3168418461;Taip;0;0;1;1
3746;Kodėlčiukas;"NAUJA (LOPŠELIS)";9645987751;Taip;14;0;4;18
3747;Kodėlčiukas;"NAUJA (LOPŠELIS)";5860975805;Taip;4;0;0;4
3748;Kodėlčiukas;"NAUJA (LOPŠELIS)";8782155591;Taip;0;0;1;1
3749;Kodėlčiukas;"NAUJA (LOPŠELIS)";8104220950;Taip;0;10;0;10
3750;Kodėlčiukas;"NAUJA (LOPŠELIS)";2005453189;Taip;2;0;2;4
3751;Kodėlčiukas;"NAUJA (LOPŠELIS)";1180399735;Taip;12;0;0;12
3752;Kodėlčiukas;"NAUJA (LOPŠELIS)";5173730926;Taip;10;0;7;17
3753;Kodėlčiukas;"NAUJA (LOPŠELIS)";7946010973;Taip;0;9;0;9
3754;Kodėlčiukas;"NAUJA (LOPŠELIS)";3068084704;Taip;13;1;2;16
3755;Kodėlčiukas;"NAUJA (LOPŠELIS)";5342852235;Taip;11;0;1;12
3756;Kodėlčiukas;"NAUJA (LOPŠELIS)";7318196860;Taip;0;1;0;1
3757;Klevelis;Gėlytės;1953918266;Taip;0;10;0;10
3758;Klevelis;Gėlytės;1942666372;Taip;0;19;0;19
3759;Klevelis;Gėlytės;50441219517;Taip;0;2;0;2
3760;Klevelis;Gėlytės;8584120396;Taip;8;1;0;9
3761;Klevelis;Gėlytės;23520576240;Taip;0;3;0;3
3762;Klevelis;Gėlytės;5024289280;Taip;3;1;1;5
3763;Klevelis;Gėlytės;1685710938;Taip;0;2;0;2
3764;Klevelis;Gėlytės;5354831337;Ne;0;12;0;12
3765;Klevelis;Gėlytės;2744433344;Taip;0;5;0;5
3766;Klevelis;Gėlytės;7506522045;Taip;0;0;1;1
3767;Klevelis;Gėlytės;2043650571;Ne;0;1;0;1
3768;Klevelis;Gėlytės;7426544243;Ne;5;1;0;6
3769;Klevelis;Gėlytės;8815534200;Ne;0;0;1;1
3770;Klevelis;Gėlytės;7387250891;Taip;9;0;0;9
3771;Klevelis;Gėlytės;6172016747;Taip;15;0;0;15
3772;Klevelis;Gėlytės;5518309115;Taip;15;3;0;18
3773;Klevelis;Gėlytės;4930308435;Taip;0;15;0;15
3774;Klevelis;Gėlytės;6621769160;Taip;7;5;0;12
3775;Klevelis;Gėlytės;4733970252;Taip;1;0;3;4
3776;Klevelis;Paukšteliai;4424095457;Taip;0;2;0;2
3777;Klevelis;Paukšteliai;7855598075;Taip;0;10;0;10
3778;Klevelis;Paukšteliai;1749117711;Taip;5;0;0;5
3779;Klevelis;Paukšteliai;3873345138;Ne;20;0;0;20
3780;Klevelis;Paukšteliai;9291855374;Taip;5;6;0;11
3781;Klevelis;Paukšteliai;4832348492;Taip;10;0;2;12
3782;Klevelis;Paukšteliai;8777858708;Ne;11;0;2;13
3783;Klevelis;Paukšteliai;9183582003;Ne;10;2;0;12
3784;Klevelis;Paukšteliai;3490370918;Ne;10;2;0;12
3785;Klevelis;Paukšteliai;4347007911;Taip;4;0;0;4
3786;Klevelis;Paukšteliai;2031118410;Taip;0;4;0;4
3787;Klevelis;Paukšteliai;5966215998;Taip;12;0;1;13
3788;Klevelis;Paukšteliai;7463376031;Taip;1;13;0;14
3789;Klevelis;Paukšteliai;1751440418;Taip;0;0;3;3
3790;Klevelis;Paukšteliai;3567687304;Taip;5;1;0;6
3791;Klevelis;Paukšteliai;6488139414;Taip;5;0;3;8
3792;Klevelis;Spindulėliai;1299222411;Taip;0;21;0;21
3793;Klevelis;Spindulėliai;2041814549;Taip;0;1;3;4
3794;Klevelis;Spindulėliai;30473769754;Taip;0;0;2;2
3795;Klevelis;Spindulėliai;32063805512;Ne;0;10;0;10
3796;Klevelis;Spindulėliai;5786557195;Taip;5;0;2;7
3797;Klevelis;Spindulėliai;1980755137;Taip;8;3;0;11
3798;Klevelis;Spindulėliai;88565114332;Ne;5;2;2;9
3799;Klevelis;Spindulėliai;2207041148;Taip;0;10;0;10
3800;Klevelis;Spindulėliai;58302265771;Ne;7;6;0;13
3801;Klevelis;Spindulėliai;9125827523;Ne;0;3;0;3
3802;Klevelis;Spindulėliai;3397741232;Ne;5;1;0;6
3803;Klevelis;Spindulėliai;1520846063;Taip;0;1;1;2
3804;Klevelis;Spindulėliai;4558350854;Ne;0;15;0;15
3805;Klevelis;Spindulėliai;1020095914;Taip;2;1;0;3
3806;Klevelis;Spindulėliai;5705915729;Taip;3;1;0;4
3807;Klevelis;Spindulėliai;4508176017;Taip;6;0;2;8
3808;Klevelis;Spindulėliai;5028027797;Taip;2;0;0;2
3809;Klevelis;Spindulėliai;3306549764;Taip;0;2;0;2
3810;Klevelis;Spindulėliai;6241611652;Taip;10;6;0;16
3811;Klevelis;Spindulėliai;9865628172;Ne;5;2;2;9
3812;Klevelis;Spindulėliai;8154620920;Ne;12;4;0;16
3813;Klevelis;Spindulėliai;9486892110;Taip;10;0;0;10
3814;Klevelis;BORUŽĖLĖS;6822089289;Taip;0;0;1;1
3815;Klevelis;BORUŽĖLĖS;4920107818;Taip;0;5;0;5
3816;Klevelis;BORUŽĖLĖS;7419432731;Taip;5;0;0;5
3817;Klevelis;BORUŽĖLĖS;9777308731;Taip;6;0;0;6
3818;Klevelis;BORUŽĖLĖS;8472436632;Taip;4;0;0;4
3819;Klevelis;BORUŽĖLĖS;4588890423;Taip;0;6;0;6
3820;Kurpaitė;Viščiukų;4426311033;Taip;4;0;0;4
3821;Kurpaitė;Viščiukų;6466518987;Taip;0;14;0;14
3822;Kurpaitė;Viščiukų;2757100599;Taip;5;0;0;5
3823;Kurpaitė;Viščiukų;3481813493;Ne;6;0;0;6
3824;Kurpaitė;Viščiukų;1927773278;Taip;9;0;0;9
3825;Kurpaitė;Viščiukų;4607835570;Taip;7;0;0;7
3826;Kurpaitė;Viščiukų;1964193512;Taip;0;2;0;2
3827;Kurpaitė;Viščiukų;9221882007;Ne;0;6;0;6
3828;Kurpaitė;Viščiukų;3456815576;Taip;0;6;0;6
3829;Kurpaitė;Viščiukų;8361612709;Taip;5;0;0;5
3830;Kurpaitė;Viščiukų;4754807319;Taip;14;0;0;14
3831;Kurpaitė;Viščiukų;3139272175;Taip;0;4;0;4
3832;Kurpaitė;Gėlyčių;3003517700;Taip;1;0;0;1
3833;Kurpaitė;Gėlyčių;3502355847;Taip;10;0;0;10
3834;Kurpaitė;Gėlyčių;5609161523;Ne;3;0;0;3
3835;Kurpaitė;Gėlyčių;9480290430;Taip;0;1;0;1
3836;Kurpaitė;Gėlyčių;3634641300;Taip;0;1;0;1
3837;Kurpaitė;Gėlyčių;9915241987;Taip;0;4;0;4
3838;Kurpaitė;Gėlyčių;4602268315;Taip;16;0;0;16
3839;Kurpaitė;Gėlyčių;4592795281;Taip;0;8;0;8
3840;Kurpaitė;Gėlyčių;8868415451;Taip;0;1;0;1
3841;Kurpaitė;Gėlyčių;2290343066;Taip;0;4;0;4
3842;Kurpaitė;Gėlyčių;4188925256;Taip;0;1;0;1
3843;Kurpaitė;Gėlyčių;1273426668;Taip;0;3;0;3
3844;Kurpaitė;Gėlyčių;4684525618;Taip;0;10;0;10
3845;Kurpaitė;Drugelių;2359555461;Taip;0;1;0;1
3846;Kurpaitė;Drugelių;65434834152;Taip;0;14;0;14
3847;Kurpaitė;Drugelių;1218040871;Taip;0;9;0;9
3848;Kurpaitė;Drugelių;1505783589;Taip;0;11;0;11
3849;Kurpaitė;Drugelių;7249931704;Taip;0;4;0;4
3850;Kurpaitė;Drugelių;3102257512;Taip;0;7;0;7
3851;Kurpaitė;Drugelių;1660650556;Taip;0;14;0;14
3852;Kurpaitė;Drugelių;4964063637;Taip;2;0;0;2
3853;Kurpaitė;Drugelių;7546409044;Taip;0;13;0;13
3854;Kurpaitė;Drugelių;1209441106;Taip;0;0;8;8
3855;Kurpaitė;Drugelių;8669676262;Ne;0;0;1;1
3856;Kurpaitė;Drugelių;9063294667;Ne;0;1;0;1
3857;Kurpaitė;Drugelių;2827617670;Taip;10;0;0;10
3858;Kurpaitė;Drugelių;1457318954;Taip;8;1;0;9
3859;Kurpaitė;Drugelių;7897713994;Taip;0;3;0;3
3860;Kurpaitė;Drugelių;4312062240;Taip;3;1;0;4
3861;Kurpaitė;Pelyčių;8141884164;Ne;0;8;0;8
3862;Kurpaitė;Pelyčių;54840686231;Taip;0;9;0;9
3863;Kurpaitė;Pelyčių;48526842780;Taip;0;10;0;10
3864;Kurpaitė;Pelyčių;48538300542;Taip;0;0;4;4
3865;Kurpaitė;Pelyčių;1730735673;Taip;3;9;0;12
3866;Kurpaitė;Pelyčių;43247754405;Taip;0;5;0;5
3867;Kurpaitė;Pelyčių;5394176979;Taip;17;0;0;17
3868;Kurpaitė;Pelyčių;4557629310;Ne;5;0;0;5
3869;Kurpaitė;Pelyčių;72710210157;Taip;0;6;0;6
3870;Kurpaitė;Pelyčių;1094620507;Taip;21;0;0;21
3871;Kurpaitė;Pelyčių;1202869338;Taip;5;0;0;5
3872;Kurpaitė;Pelyčių;58127430940;Taip;0;10;0;10
3873;Kurpaitė;Pelyčių;2116580903;Taip;0;4;0;4
3874;Kurpaitė;Pelyčių;2200676656;Taip;0;2;0;2
3875;Kurpaitė;Pelyčių;7431793716;Taip;10;11;0;21
3876;Kurpaitė;Pelyčių;24410351286;Ne;0;10;0;10
3877;Kurpaitė;Pelyčių;6826856088;Taip;2;6;0;8
3878;Kūlverstukas;Saulutės;8853848991;Taip;0;0;7;7
3879;Kūlverstukas;Saulutės;6287636806;Taip;9;0;1;10
3880;Kūlverstukas;Saulutės;4285624305;Ne;5;0;1;6
3881;Kūlverstukas;Saulutės;8092104136;Taip;0;9;6;15
3882;Kūlverstukas;Saulutės;3238807604;Ne;0;1;0;1
3883;Kūlverstukas;Saulutės;1932066021;Ne;7;0;2;9
3884;Kūlverstukas;Saulutės;9655585527;Ne;5;0;4;9
3885;Kūlverstukas;Saulutės;5488852698;Ne;7;0;1;8
3886;Kūlverstukas;Saulutės;3069047204;Taip;0;0;16;16
3887;Kūlverstukas;Saulutės;5345423038;Ne;0;9;0;9
3888;Kūlverstukas;Saulutės;3270176280;Taip;0;6;1;7
3889;Kūlverstukas;Saulutės;7449993309;Ne;0;0;4;4
3890;Kūlverstukas;Saulutės;5319938519;Ne;2;0;0;2
3891;Kūlverstukas;Peledžiukai;8362459952;Ne;5;0;1;6
3892;Kūlverstukas;Peledžiukai;6577897961;Ne;6;5;1;12
3893;Kūlverstukas;Peledžiukai;74829986958;Ne;13;0;0;13
3894;Kūlverstukas;Peledžiukai;8891671739;Taip;0;0;1;1
3895;Kūlverstukas;Peledžiukai;5488011852;Ne;6;0;6;12
3896;Kūlverstukas;Peledžiukai;2072009099;Taip;4;0;2;6
3897;Kūlverstukas;Peledžiukai;1226883894;Ne;0;0;3;3
3898;Kūlverstukas;Peledžiukai;37991935289;Ne;9;0;0;9
3899;Kūlverstukas;Peledžiukai;1617844709;Ne;10;0;6;16
3900;Kūlverstukas;Peledžiukai;3937419139;Ne;0;0;1;1
3901;Kūlverstukas;Peledžiukai;7440474403;Taip;0;6;0;6
3902;Kūlverstukas;Peledžiukai;1699783763;Taip;0;2;0;2
3903;Kūlverstukas;Peledžiukai;3162189859;Ne;0;0;16;16
3904;Kūlverstukas;Peledžiukai;2130099456;Ne;0;8;1;9
3905;Kūlverstukas;Peledžiukai;9396183748;Ne;0;6;1;7
3906;Kūlverstukas;Peledžiukai;1452422691;Ne;0;0;1;1
3907;Kūlverstukas;Peledžiukai;5372936730;Taip;5;0;0;5
3908;Kūlverstukas;Peledžiukai;4396230034;Ne;0;0;2;2
3909;Kūlverstukas;Gelytės;2101490038;Taip;4;0;0;4
3910;Kūlverstukas;Gelytės;2450625415;Taip;4;0;0;4
3911;Kūlverstukas;Gelytės;4173514390;Taip;9;0;2;11
3912;Kūlverstukas;Gelytės;1795306946;Ne;2;0;0;2
3913;Kūlverstukas;Gelytės;4846324136;Ne;0;0;1;1
3914;Kūlverstukas;Gelytės;8294873714;Ne;2;0;0;2
3915;Kūlverstukas;Gelytės;8353856412;Ne;8;0;0;8
3916;Kūlverstukas;Gelytės;2762230590;Ne;4;0;0;4
3917;Kūlverstukas;Gelytės;9096819614;Ne;3;0;3;6
3918;Kūlverstukas;Gelytės;5103259175;Taip;0;0;3;3
3919;Kūlverstukas;Gelytės;9167460438;Taip;0;0;2;2
3920;Kūlverstukas;Gelytės;8319255735;Taip;8;0;3;11
3921;Kūlverstukas;Gelytės;7505926208;Ne;4;10;0;14
3922;Kūlverstukas;Gelytės;1014630718;Taip;4;10;0;14
3923;Kūlverstukas;Gelytės;1898905623;Taip;1;16;0;17
3924;Kūlverstukas;Gelytės;4532151103;Ne;0;13;1;14
3925;Kūlverstukas;Bitutės;6598688551;Taip;5;0;2;7
3926;Kūlverstukas;Bitutės;3162808486;Ne;1;8;0;9
3927;Kūlverstukas;Bitutės;1067182820;Taip;5;0;0;5
3928;Kūlverstukas;Bitutės;2389231051;Ne;5;0;4;9
3929;Kūlverstukas;Bitutės;8964753108;Ne;5;0;4;9
3930;Kūlverstukas;Bitutės;4111966910;Ne;0;0;1;1
3931;Kūlverstukas;Bitutės;8346712630;Ne;0;0;1;1
3932;Kūlverstukas;Bitutės;8333084277;Ne;3;0;0;3
3933;Kūlverstukas;Bitutės;7112217569;Taip;4;0;1;5
3934;Kūlverstukas;Bitutės;5391554530;Taip;0;0;1;1
3935;Lakštingala;Saulutės;2156571482;Taip;0;0;1;1
3936;Lakštingala;Saulutės;4651600682;Taip;1;0;0;1
3937;Lakštingala;Saulutės;2084960114;Taip;0;6;5;11
3938;Lakštingala;Saulutės;3911509979;Taip;0;0;1;1
3939;Lakštingala;Saulutės;8775608339;Taip;12;0;3;15
3940;Lakštingala;Saulutės;3858771190;Ne;0;0;15;15
3941;Lakštingala;Saulutės;3723986383;Ne;10;0;0;10
3942;Lakštingala;Saulutės;2742489026;Taip;3;10;0;13
3943;Lakštingala;Saulutės;1243254166;Ne;13;0;2;15
3944;Lakštingala;Saulutės;9628476764;Ne;0;4;0;4
3945;Lakštingala;Saulutės;4344553248;Ne;8;0;2;10
3946;Lakštingala;Saulutės;6567480562;Taip;0;0;1;1
3947;Lakštingala;Saulutės;9495341480;Taip;0;5;0;5
3948;Lakštingala;Saulutės;2543779273;Taip;8;0;2;10
3949;Lakštingala;Saulutės;2093953744;Ne;0;0;3;3
3950;Lakštingala;Saulutės;2536998296;Taip;0;0;16;16
3951;Lakštingala;Nykštukai;7931292601;Taip;0;0;21;21
3952;Lakštingala;Nykštukai;1863034132;Taip;0;0;8;8
3953;Lakštingala;Nykštukai;2941128360;Taip;6;0;0;6
3954;Lakštingala;Nykštukai;9912622093;Taip;0;0;8;8
3955;Lakštingala;Nykštukai;9489982241;Ne;0;0;1;1
3956;Lakštingala;Nykštukai;4032030375;Ne;0;6;0;6
3957;Lakštingala;Nykštukai;3993759015;Taip;2;0;0;2
3958;Lakštingala;Nykštukai;2652305131;Taip;0;6;1;7
3959;Lakštingala;Nykštukai;9725851433;Taip;0;8;0;8
3960;Lakštingala;Nykštukai;6332498461;Taip;0;0;1;1
3961;Lakštingala;Nykštukai;1655202909;Taip;0;5;1;6
3962;Lakštingala;Nykštukai;9375002191;Taip;0;8;0;8
3963;Lakštingala;Nykštukai;4857448665;Taip;0;0;1;1
3964;Lakštingala;Nykštukai;2304340938;Taip;0;0;1;1
3965;Lakštingala;Nykštukai;8217315818;Taip;0;8;2;10
3966;Lakštingala;Nykštukai;7994475429;Taip;6;0;0;6
3967;Lakštingala;Nykštukai;7963839249;Ne;4;0;2;6
3968;Lakštingala;Bitutės;6150013105;Taip;0;2;1;3
3969;Lakštingala;Bitutės;1271455798;Taip;3;1;0;4
3970;Lakštingala;Bitutės;21094902562;Taip;0;1;0;1
3971;Lakštingala;Bitutės;98609129644;Taip;0;2;0;2
3972;Lakštingala;Bitutės;2635399411;Taip;0;0;1;1
3973;Lakštingala;Bitutės;7325183642;Ne;21;0;0;21
3974;Lakštingala;Bitutės;2013216779;Taip;0;12;0;12
3975;Lakštingala;Bitutės;25449089230;Taip;0;5;0;5
3976;Lakštingala;Bitutės;1676655778;Taip;0;10;5;15
3977;Lakštingala;Bitutės;36367286465;Taip;0;2;0;2
3978;Lakštingala;Bitutės;1310400524;Taip;0;2;1;3
3979;Lakštingala;Bitutės;58056130761;Ne;0;2;2;4
3980;Lakštingala;Bitutės;14410791110;Taip;0;1;0;1
3981;Lakštingala;Bitutės;1297637335;Ne;0;1;0;1
3982;Lakštingala;Bitutės;88947243829;Taip;3;0;0;3
3983;Lakštingala;Bitutės;6329787217;Taip;1;0;1;2
3984;Lakštingala;Bitutės;8890852891;Taip;0;1;0;1
3985;Lakštingala;Bitutės;91671174585;Taip;0;4;0;4
3986;Lakštingala;Bitutės;9381815353;Ne;0;12;0;12
3987;Lakštingala;Bitutės;30840899725;Taip;0;1;0;1
3988;Lakštingala;Bitutės;7139669240;Taip;1;2;0;3
3989;Lakštingala;Bitutės;89747320378;Taip;1;0;0;1
3990;Lakštingala;Pūkeliai;8171357606;Taip;0;9;0;9
3991;Lakštingala;Pūkeliai;9774836470;Taip;7;0;0;7
3992;Lakštingala;Pūkeliai;1958696382;Taip;0;2;1;3
3993;Lakštingala;Pūkeliai;4542992319;Taip;5;15;1;21
3994;Lakštingala;Pūkeliai;9346986726;Taip;7;0;0;7
3995;Lakštingala;Pūkeliai;2593030897;Taip;7;0;1;8
3996;Lakštingala;Pūkeliai;6908873466;Taip;1;0;0;1
3997;Lakštingala;Pūkeliai;7929034243;Taip;0;12;4;16
3998;Lakštingala;Pūkeliai;5854794141;Taip;5;0;0;5
3999;Lakštingala;Pūkeliai;8165998647;Taip;0;6;0;6
4000;Lakštingala;Pūkeliai;1458348357;Taip;0;0;1;1
4001;Lakštingala;Pūkeliai;4465752871;Taip;2;1;4;7
4002;Lakštingala;Pūkeliai;2430891944;Taip;7;0;1;8
4003;Lakštingala;Pūkeliai;5379344261;Taip;3;0;2;5
4004;Lakštingala;Pūkeliai;4722328994;Ne;0;0;1;1
4005;Lakštingala;Pūkeliai;7272454093;Taip;0;0;2;2
4006;Lakštingala;Pūkeliai;1587899391;Ne;9;0;0;9
4007;Lakštingala;Pūkeliai;6234559044;Ne;0;1;0;1
4008;Lakštingala;Aitvariukai;3872205876;Taip;2;0;2;4
4009;Lakštingala;Aitvariukai;5851957031;Taip;0;1;0;1
4010;Lakštingala;Aitvariukai;4996777116;Taip;2;0;1;3
4011;Lakštingala;Aitvariukai;9390342572;Taip;5;2;0;7
4012;Lakštingala;Aitvariukai;7918688955;Ne;4;2;1;7
4013;Lakštingala;Aitvariukai;3509165175;Taip;6;1;0;7
4014;Lakštingala;Aitvariukai;9694524137;Taip;0;0;1;1
4015;Lakštingala;Aitvariukai;4179366572;Taip;9;1;2;12
4016;Lakštingala;Aitvariukai;5949665703;Taip;0;0;1;1
4017;Lakštingala;Aitvariukai;8679582358;Taip;0;8;0;8
4018;Lakštingala;Aitvariukai;9147821017;Taip;0;0;21;21
4019;Lakštingala;Aitvariukai;5445945319;Taip;3;0;0;3
4020;Lakštingala;Aitvariukai;6597540627;Taip;4;0;9;13
4021;Lakštingala;Aitvariukai;2266870318;Taip;11;1;0;12
4022;Lakštingala;Aitvariukai;6565318145;Taip;10;1;0;11
4023;Lakštingala;Aitvariukai;4384468922;Ne;0;11;0;11
4024;Lakštingala;Aitvariukai;5162605666;Taip;9;1;0;10
4025;Lakštingala;Aitvariukai;2073818724;Taip;10;0;1;11
4026;Lakštingala;Aitvariukai;2423761155;Taip;7;2;0;9
4027;Lakštingala;Boružiukai;9795993812;Taip;0;0;1;1
4028;Lakštingala;Boružiukai;9004336424;Taip;0;5;4;9
4029;Lakštingala;Boružiukai;87470014156;Taip;0;0;3;3
4030;Lakštingala;Boružiukai;8820053026;Taip;0;2;0;2
4031;Lakštingala;Boružiukai;2072883878;Taip;0;2;1;3
4032;Lakštingala;Boružiukai;4811759034;Taip;9;2;0;11
4033;Lakštingala;Boružiukai;1898853302;Ne;2;2;0;4
4034;Lakštingala;Boružiukai;7443563000;Taip;3;0;1;4
4035;Lakštingala;Boružiukai;2792618575;Taip;0;0;21;21
4036;Lakštingala;Boružiukai;55720630870;Taip;0;0;6;6
4037;Lakštingala;Boružiukai;4818524423;Ne;5;0;2;7
4038;Lakštingala;Boružiukai;1444534032;Taip;0;2;1;3
4039;Lakštingala;Boružiukai;9724531753;Taip;3;2;0;5
4040;Lakštingala;Boružiukai;3602820204;Ne;16;5;0;21
4041;Lakštingala;Boružiukai;1783776913;Taip;0;2;2;4
4042;Lakštingala;Boružiukai;1106475925;Ne;0;0;1;1
4043;Lakštingala;Boružiukai;1667277983;Ne;0;2;2;4
4044;Lakštingala;Boružiukai;6947565845;Ne;0;6;0;6
4045;Lakštingala;Boružiukai;3009692491;Taip;0;0;2;2
4046;Lakštingala;Boružiukai;1800927281;Ne;0;2;0;2
4047;Lakštingala;Boružiukai;9998322501;Taip;0;1;3;4
4048;Lakštingala;Žiogeliai;2104150466;Taip;2;0;1;3
4049;Lakštingala;Žiogeliai;9689911725;Taip;0;1;0;1
4050;Lakštingala;Žiogeliai;9958821769;Ne;0;0;2;2
4051;Lakštingala;Žiogeliai;7953724873;Taip;0;1;1;2
4052;Lakštingala;Žiogeliai;9800992468;Taip;0;0;2;2
4053;Lakštingala;Žiogeliai;1411121466;Taip;5;0;0;5
4054;Lakštingala;Žiogeliai;8944088082;Taip;0;0;4;4
4055;Lakštingala;Žiogeliai;9897713625;Taip;3;1;1;5
4056;Lakštingala;Žiogeliai;70798601578;Taip;5;9;0;14
4057;Lakštingala;Žiogeliai;1736130324;Taip;7;0;1;8
4058;Lakštingala;Žiogeliai;2039579203;Taip;7;0;1;8
4059;Lakštingala;Žiogeliai;6576202365;Taip;1;0;11;12
4060;Lakštingala;Žiogeliai;7900597697;Ne;21;0;0;21
4061;Lakštingala;Žiogeliai;9497327995;Taip;0;0;1;1
4062;Lakštingala;Žiogeliai;1265027238;Taip;5;0;0;5
4063;Lakštingala;SPINDULIUKAI;4365413054;Taip;2;0;6;8
4064;Lakštingala;SPINDULIUKAI;9762500668;Taip;4;3;1;8
4065;Lakštingala;SPINDULIUKAI;7640007392;Taip;4;1;4;9
4066;Lakštingala;SPINDULIUKAI;4784677514;Taip;0;0;1;1
4067;Lakštingala;SPINDULIUKAI;2022621678;Taip;0;0;3;3
4068;Lakštingala;SPINDULIUKAI;8429523368;Taip;0;2;2;4
4069;Lakštingala;SPINDULIUKAI;1767414096;Taip;0;0;1;1
4070;Lakštingala;SPINDULIUKAI;6668075753;Taip;10;0;0;10
4071;Lakštingala;SPINDULIUKAI;9081653166;Taip;0;1;2;3
4072;Lakštingala;SPINDULIUKAI;6780591792;Taip;0;0;1;1
4073;Lakštingala;SPINDULIUKAI;8422745100;Taip;8;0;1;9
4074;Lakštingala;SPINDULIUKAI;4698879435;Taip;3;0;1;4
4075;Lakštingala;SPINDULIUKAI;1220858944;Taip;0;2;0;2
4076;Lakštingala;SPINDULIUKAI;3823860988;Ne;0;0;2;2
4077;Lakštingala;SPINDULIUKAI;7141840160;Ne;0;6;3;9
4078;Lakštingala;SPINDULIUKAI;3282771613;Taip;0;2;3;5
4079;Lakštingala;SPINDULIUKAI;5815240975;Taip;2;0;1;3
4080;Lakštingala;Pėledžiukai;1347480198;Taip;8;0;2;10
4081;Lakštingala;Pėledžiukai;3520592784;Taip;0;0;1;1
4082;Lakštingala;Pėledžiukai;5258588961;Taip;4;0;2;6
4083;Lakštingala;Pėledžiukai;6135103377;Taip;0;0;1;1
4084;Lakštingala;Pėledžiukai;4774354751;Taip;0;0;6;6
4085;Lakštingala;Pėledžiukai;3369263112;Taip;10;0;2;12
4086;Lakštingala;Pėledžiukai;2663268027;Taip;21;0;0;21
4087;Lakštingala;Pėledžiukai;8375506323;Taip;0;0;10;10
4088;Lakštingala;Pėledžiukai;2738882466;Taip;9;0;0;9
4089;Lakštingala;Pėledžiukai;8717764626;Taip;0;4;1;5
4090;Lakštingala;Pėledžiukai;8075192528;Taip;0;0;4;4
4091;Lakštingala;Pėledžiukai;3050655193;Taip;0;0;15;15
4092;Lakštingala;Pėledžiukai;3766779594;Taip;0;0;2;2
4093;Lakštingala;Pėledžiukai;4270513515;Ne;7;0;3;10
4094;Lakštingala;Pėledžiukai;2514377385;Ne;14;0;0;14
4095;Lakštingala;Pėledžiukai;6161860331;Taip;11;6;0;17
4096;Lakštingala;Pėledžiukai;6992134252;Taip;0;9;1;10
4097;Lakštingala;Pėledžiukai;6866935290;Ne;8;0;1;9
4098;Lakštingala;Pėledžiukai;8787118512;Taip;14;0;0;14
4099;Lakštingala;Pėledžiukai;2395109471;Taip;11;0;2;13
4100;Lakštingala;Katinėliai;4546036762;Taip;0;0;5;5
4101;Lakštingala;Katinėliai;2982968605;Ne;15;0;0;15
4102;Lakštingala;Katinėliai;2332727504;Taip;0;0;5;5
4103;Lakštingala;Katinėliai;3908175786;Ne;0;0;4;4
4104;Lakštingala;Katinėliai;9860169528;Ne;0;0;2;2
4105;Lakštingala;Katinėliai;4935753482;Taip;13;0;0;13
4106;Lakštingala;Katinėliai;5008933316;Ne;0;0;3;3
4107;Lakštingala;Katinėliai;1248909711;Ne;1;0;5;6
4108;Lakštingala;Katinėliai;3766986041;Taip;0;0;6;6
4109;Lakštingala;Katinėliai;1059002689;Taip;0;16;1;17
4110;Lakštingala;Katinėliai;3951057865;Taip;1;0;0;1
4111;Lakštingala;Katinėliai;7361353346;Taip;0;2;1;3
4112;Lakštingala;Katinėliai;7661973162;Taip;0;0;7;7
4113;Lakštingala;Deimantėliai;9297542026;Taip;0;5;0;5
4114;Lakštingala;Deimantėliai;3618452008;Taip;5;0;2;7
4115;Lakštingala;Deimantėliai;2723364075;Taip;0;0;19;19
4116;Lakštingala;Deimantėliai;1474796466;Taip;0;0;1;1
4117;Lakštingala;Deimantėliai;6369696598;Ne;0;0;2;2
4118;Lakštingala;Deimantėliai;9629855134;Taip;0;0;9;9
4119;Lakštingala;Deimantėliai;9441296489;Ne;8;0;0;8
4120;Lakštingala;Deimantėliai;8130468345;Ne;2;1;3;6
4121;Lakštingala;Deimantėliai;3817687845;Taip;0;7;3;10
4122;Lakštingala;Deimantėliai;7240426529;Ne;7;0;1;8
4123;Lakštingala;Deimantėliai;8558000223;Taip;10;0;2;12
4124;Lakštingala;Deimantėliai;5244646855;Taip;2;0;1;3
4125;Lakštingala;Deimantėliai;3166474163;Taip;0;1;1;2
4126;Lakštingala;Deimantėliai;8609822839;Ne;0;6;4;10
4127;Lakštingala;Deimantėliai;7404386777;Ne;0;0;2;2
4128;Lakštingala;KIŠKUČIAI;42012300013;Taip;0;2;0;2
4129;Lakštingala;KIŠKUČIAI;7448175606;Taip;0;2;0;2
4130;Lakštingala;KIŠKUČIAI;2002196654;Taip;0;1;0;1
4131;Lakštingala;KIŠKUČIAI;5033145687;Taip;5;4;0;9
4132;Lakštingala;KIŠKUČIAI;95832669291;Taip;1;3;0;4
4133;Lakštingala;KIŠKUČIAI;70748679017;Taip;0;1;0;1
4134;Lakštingala;KIŠKUČIAI;58847206918;Taip;0;1;0;1
4135;Lakštingala;KIŠKUČIAI;19003276281;Taip;0;1;0;1
4136;Lakštingala;KIŠKUČIAI;31911078405;Taip;0;1;0;1
4137;Lakštingala;KIŠKUČIAI;8838078447;Ne;0;1;0;1
4138;Lakštingala;KIŠKUČIAI;65408046990;Taip;0;1;0;1
4139;Lakštingala;KIŠKUČIAI;11399672681;Taip;3;2;0;5
4140;Lakštingala;KIŠKUČIAI;1263184555;Taip;0;1;0;1
4141;Lakštingala;KIŠKUČIAI;26288159700;Taip;0;3;0;3
4142;Lakštingala;KIŠKUČIAI;48160996499;Ne;9;1;0;10
4143;Lakštingala;KIŠKUČIAI;601001178;Taip;0;12;3;15
4144;Lakštingala;KIŠKUČIAI;4261431738;Ne;0;2;0;2
4145;Lakštingala;KIŠKUČIAI;73039119839;Taip;0;1;0;1
4146;Lakštingala;KIŠKUČIAI;53914093216;Taip;10;0;0;10
4147;Lakštingala;KIŠKUČIAI;77528823822;Taip;0;1;0;1
4148;Lakštingala;KIŠKUČIAI;3426133948;Taip;0;8;0;8
4149;Lašelis;VIŠČIUKAI;3069506904;Taip;2;0;0;2
4150;Lašelis;VIŠČIUKAI;1279052767;Ne;2;0;0;2
4151;Lašelis;VIŠČIUKAI;1042560186;Taip;5;0;0;5
4152;Lašelis;VIŠČIUKAI;7844422594;Taip;8;2;0;10
4153;Lašelis;VIŠČIUKAI;4832223461;Ne;7;0;0;7
4154;Lašelis;VIŠČIUKAI;5416590600;Taip;15;0;1;16
4155;Lašelis;VIŠČIUKAI;6836452490;Taip;7;0;0;7
4156;Lašelis;VIŠČIUKAI;1983312896;Taip;0;4;0;4
4157;Lašelis;VIŠČIUKAI;8814796010;Taip;6;3;0;9
4158;Lašelis;VIŠČIUKAI;2593126568;Ne;8;0;2;10
4159;Lašelis;VIŠČIUKAI;2509469243;Taip;0;0;4;4
4160;Lašelis;VIŠČIUKAI;2223293390;Taip;5;1;0;6
4161;Lašelis;ŠYPSENA;1926439959;Ne;0;0;1;1
4162;Lašelis;ŠYPSENA;5731394231;Ne;0;2;2;4
4163;Lašelis;ŠYPSENA;4566547120;Taip;0;1;0;1
4164;Lašelis;ŠYPSENA;3805049682;Taip;8;0;0;8
4165;Lašelis;ŠYPSENA;1175045927;Taip;11;0;0;11
4166;Lašelis;ŠYPSENA;8132517365;Taip;4;0;1;5
4167;Lašelis;ŠYPSENA;1244168190;Taip;0;5;0;5
4168;Lašelis;ŠYPSENA;2034007263;Ne;12;0;0;12
4169;Lašelis;ŠYPSENA;8318512396;Taip;3;12;0;15
4170;Lašelis;ŠYPSENA;7657786815;Ne;5;1;0;6
4171;Lašelis;ŠYPSENA;3495676199;Taip;5;0;0;5
4172;Lašelis;ŠYPSENA;2886967297;Taip;0;3;0;3
4173;Lašelis;ŠYPSENA;2401058384;Ne;3;0;1;4
4174;Lašelis;ŠYPSENA;6041192600;Taip;0;4;0;4
4175;Lašelis;ŠYPSENA;1816377082;Ne;0;2;0;2
4176;Lašelis;NYKŠTUKAI;3144718477;Taip;18;0;3;21
4177;Lašelis;NYKŠTUKAI;7998812497;Taip;0;9;0;9
4178;Lašelis;NYKŠTUKAI;6669130831;Taip;4;0;0;4
4179;Lašelis;NYKŠTUKAI;7351939034;Taip;5;4;0;9
4180;Lašelis;NYKŠTUKAI;3239288878;Taip;9;0;0;9
4181;Lašelis;NYKŠTUKAI;6829438486;Taip;5;0;3;8
4182;Lašelis;NYKŠTUKAI;5679093300;Ne;0;16;0;16
4183;Lašelis;NYKŠTUKAI;6080664872;Taip;6;0;3;9
4184;Lašelis;NYKŠTUKAI;7802622810;Taip;0;1;0;1
4185;Lašelis;NYKŠTUKAI;2204859014;Taip;5;1;0;6
4186;Lašelis;NYKŠTUKAI;6553762186;Taip;0;9;0;9
4187;Lašelis;NYKŠTUKAI;1085400709;Taip;0;6;0;6
4188;Lašelis;NYKŠTUKAI;8889959782;Taip;15;0;1;16
4189;Lašelis;NYKŠTUKAI;4151582358;Taip;0;8;0;8
4190;Lašelis;NYKŠTUKAI;1646912457;Taip;0;5;1;6
4191;Lašelis;SAULUTĖ;6136792125;Taip;5;0;0;5
4192;Lašelis;SAULUTĖ;8324581018;Ne;0;8;8;16
4193;Lašelis;SAULUTĖ;3982877012;Ne;14;5;0;19
4194;Lašelis;SAULUTĖ;1108744283;Taip;3;0;2;5
4195;Lašelis;SAULUTĖ;1224648193;Taip;0;10;0;10
4196;Lašelis;SAULUTĖ;6090290046;Taip;0;2;0;2
4197;Lašelis;SAULUTĖ;1578956182;Taip;5;0;0;5
4198;Lašelis;SAULUTĖ;1739797553;Taip;0;2;0;2
4199;Lašelis;SAULUTĖ;5046619730;Ne;5;2;0;7
4200;Lašelis;SAULUTĖ;1193336600;Taip;0;6;0;6
4201;Lašelis;SAULUTĖ;3741905080;Ne;0;21;0;21
4202;Lašelis;SAULUTĖ;6492909546;Taip;0;3;0;3
4203;Lašelis;SAULUTĖ;7471332824;Taip;0;7;0;7
4204;Lašelis;SAULUTĖ;4599789649;Ne;0;2;0;2
4205;Lašelis;SAULUTĖ;9391594216;Taip;0;4;0;4
4206;Lašelis;SAULUTĖ;60394164372;Taip;1;6;0;7
4207;Lašelis;BORUŽĖLĖS;6137626795;Taip;0;0;2;2
4208;Lašelis;BORUŽĖLĖS;3995905195;Taip;9;0;0;9
4209;Lašelis;BORUŽĖLĖS;1635921119;Ne;0;6;0;6
4210;Lašelis;BORUŽĖLĖS;3564781987;Ne;0;3;0;3
4211;Lašelis;BORUŽĖLĖS;9664015801;Taip;0;10;0;10
4212;Lašelis;BORUŽĖLĖS;2306501498;Taip;10;0;3;13
4213;Lašelis;BORUŽĖLĖS;9434932943;Ne;11;3;0;14
4214;Lašelis;BORUŽĖLĖS;1690011834;Ne;0;2;0;2
4215;Lašelis;BORUŽĖLĖS;1367955273;Ne;7;0;0;7
4216;Lašelis;BORUŽĖLĖS;9341950439;Ne;9;0;0;9
4217;Lašelis;BORUŽĖLĖS;2824852871;Ne;7;0;0;7
4218;Lašelis;BORUŽĖLĖS;2210915728;Ne;3;0;0;3
4219;Lašelis;SKRUZDELIUKAI;4893073148;Ne;0;2;0;2
4220;Lašelis;SKRUZDELIUKAI;8394290574;Taip;0;5;0;5
4221;Lašelis;SKRUZDELIUKAI;1511922965;Taip;0;6;0;6
4222;Lašelis;SKRUZDELIUKAI;1294930990;Ne;5;0;0;5
4223;Lašelis;SKRUZDELIUKAI;2121080776;Taip;5;0;0;5
4224;Lašelis;SKRUZDELIUKAI;9440665009;Ne;7;0;0;7
4225;Lazdynėlis;BITUTĖS;4881322530;Taip;5;6;0;11
4226;Lazdynėlis;BITUTĖS;5182241318;Ne;1;0;0;1
4227;Lazdynėlis;BITUTĖS;8008332680;Taip;0;0;1;1
4228;Lazdynėlis;BITUTĖS;1748260780;Taip;5;0;4;9
4229;Lazdynėlis;BITUTĖS;4462819848;Taip;0;0;1;1
4230;Lazdynėlis;BITUTĖS;5030400578;Taip;1;0;1;2
4231;Lazdynėlis;BITUTĖS;8159928299;Taip;11;0;0;11
4232;Lazdynėlis;BITUTĖS;9761942869;Taip;3;0;0;3
4233;Lazdynėlis;BITUTĖS;7911328294;Taip;0;1;0;1
4234;Lazdynėlis;BITUTĖS;1450181711;Taip;5;0;0;5
4235;Lazdynėlis;BITUTĖS;2044188250;Taip;0;1;0;1
4236;Lazdynėlis;BITUTĖS;4142277927;Taip;0;5;2;7
4237;Lazdynėlis;BITUTĖS;6038907328;Ne;0;1;0;1
4238;Lazdynėlis;BITUTĖS;2586187455;Taip;13;1;1;15
4239;Lazdynėlis;BITUTĖS;2013752858;Taip;0;0;3;3
4240;Lazdynėlis;BITUTĖS;4545757725;Taip;0;1;0;1
4241;Lazdynėlis;BITUTĖS;7719697394;Taip;0;21;0;21
4242;Lazdynėlis;BITUTĖS;5562900372;Taip;13;0;4;17
4243;Lazdynėlis;EŽIUKAI;6559543013;Taip;20;0;0;20
4244;Lazdynėlis;EŽIUKAI;5256157552;Taip;6;0;1;7
4245;Lazdynėlis;EŽIUKAI;9477491360;Ne;0;0;5;5
4246;Lazdynėlis;EŽIUKAI;2514035189;Taip;0;10;3;13
4247;Lazdynėlis;EŽIUKAI;3365726271;Taip;0;0;6;6
4248;Lazdynėlis;EŽIUKAI;3779983775;Taip;5;0;1;6
4249;Lazdynėlis;EŽIUKAI;4550819172;Ne;7;5;0;12
4250;Lazdynėlis;EŽIUKAI;4771173060;Taip;0;0;8;8
4251;Lazdynėlis;EŽIUKAI;1335000592;Taip;3;0;0;3
4252;Lazdynėlis;EŽIUKAI;9231049001;Taip;0;0;3;3
4253;Lazdynėlis;EŽIUKAI;9886856760;Taip;6;1;0;7
4254;Lazdynėlis;EŽIUKAI;2998606948;Taip;6;1;0;7
4255;Lazdynėlis;EŽIUKAI;3062408541;Ne;0;6;0;6
4256;Lazdynėlis;EŽIUKAI;5557752248;Taip;0;0;1;1
4257;Lazdynėlis;EŽIUKAI;8314002741;Taip;2;0;4;6
4258;Lazdynėlis;EŽIUKAI;7941793866;Taip;0;5;8;13
4259;Lazdynėlis;EŽIUKAI;6415858184;Taip;0;0;7;7
4260;Lazdynėlis;EŽIUKAI;7910561870;Taip;0;20;0;20
4261;Lazdynėlis;EŽIUKAI;1355954767;Taip;6;0;2;8
4262;Lazdynėlis;BORUŽIUKAI;4961149717;Taip;0;3;0;3
4263;Lazdynėlis;BORUŽIUKAI;6156638726;Taip;0;21;0;21
4264;Lazdynėlis;BORUŽIUKAI;1321841783;Taip;0;1;0;1
4265;Lazdynėlis;BORUŽIUKAI;9570299877;Taip;0;21;0;21
4266;Lazdynėlis;BORUŽIUKAI;2112064241;Taip;0;9;0;9
4267;Lazdynėlis;BORUŽIUKAI;57448939020;Taip;0;5;0;5
4268;Lazdynėlis;BORUŽIUKAI;1789237348;Taip;0;7;0;7
4269;Lazdynėlis;BORUŽIUKAI;2105998927;Taip;0;1;0;1
4270;Lazdynėlis;BORUŽIUKAI;29288665418;Taip;10;0;0;10
4271;Lazdynėlis;BORUŽIUKAI;11379612306;Taip;0;4;0;4
4272;Lazdynėlis;BORUŽIUKAI;7237629135;Taip;15;0;0;15
4273;Lazdynėlis;BORUŽIUKAI;3863927885;Taip;0;0;1;1
4274;Lazdynėlis;BORUŽIUKAI;8945282683;Taip;2;0;0;2
4275;Lazdynėlis;BORUŽIUKAI;5838945434;Taip;0;11;0;11
4276;Lazdynėlis;BORUŽIUKAI;6230420677;Taip;0;7;0;7
4277;Lazdynėlis;BORUŽIUKAI;8325320616;Ne;0;0;4;4
4278;Lazdynėlis;KAČIUKAI;5068598385;Taip;0;1;0;1
4279;Lazdynėlis;KAČIUKAI;2491872016;Taip;0;1;0;1
4280;Lazdynėlis;KAČIUKAI;2740122426;Taip;0;1;3;4
4281;Lazdynėlis;KAČIUKAI;9881554733;Taip;5;1;1;7
4282;Lazdynėlis;KAČIUKAI;79583491543;Taip;0;1;1;2
4283;Lazdynėlis;KAČIUKAI;1878157118;Taip;0;0;3;3
4284;Lazdynėlis;KAČIUKAI;7242681767;Taip;0;1;3;4
4285;Lazdynėlis;KAČIUKAI;7737877729;Taip;0;1;0;1
4286;Lazdynėlis;KAČIUKAI;5888646355;Taip;0;12;1;13
4287;Lazdynėlis;KAČIUKAI;3678422730;Taip;1;0;0;1
4288;Lazdynėlis;KAČIUKAI;5708643953;Taip;0;0;4;4
4289;Lazdynėlis;KAČIUKAI;8295967906;Taip;0;1;2;3
4290;Lazdynėlis;KAČIUKAI;7076664657;Taip;0;0;2;2
4291;Lazdynėlis;KAČIUKAI;7864896721;Taip;0;3;1;4
4292;Lazdynėlis;KAČIUKAI;1424382629;Ne;3;2;2;7
4293;Lazdynėlis;KAČIUKAI;6787228086;Taip;0;0;1;1
4294;Lazdynėlis;KAČIUKAI;4842228703;Taip;0;16;0;16
4295;Lazdynėlis;KAČIUKAI;1265404063;Taip;2;8;0;10
4296;Lazdynėlis;KAČIUKAI;6086766393;Taip;0;10;0;10
4297;Lazdynėlis;KAČIUKAI;5301460250;Taip;0;4;1;5
4298;Lazdynėlis;KAČIUKAI;3091067158;Taip;0;0;7;7
4299;Lazdynėlis;KAČIUKAI;9186165264;Taip;11;0;1;12
4300;Lazdynėlis;VOVERIUKAI;4425724586;Taip;4;0;0;4
4301;Lazdynėlis;VOVERIUKAI;4928593615;Taip;0;0;1;1
4302;Lazdynėlis;VOVERIUKAI;6684940385;Taip;10;0;1;11
4303;Lazdynėlis;VOVERIUKAI;9187681789;Taip;0;0;1;1
4304;Lazdynėlis;VOVERIUKAI;6307407620;Taip;0;0;7;7
4305;Lazdynėlis;VOVERIUKAI;1107441074;Taip;0;0;1;1
4306;Lazdynėlis;VOVERIUKAI;25596458181;Taip;0;21;0;21
4307;Lazdynėlis;VOVERIUKAI;24978945607;Taip;4;0;0;4
4308;Lazdynėlis;VOVERIUKAI;1852865534;Taip;4;0;1;5
4309;Lazdynėlis;VOVERIUKAI;7789345652;Taip;8;0;0;8
4310;Lazdynėlis;VOVERIUKAI;3902772678;Taip;2;0;1;3
4311;Lazdynėlis;VOVERIUKAI;8822378464;Taip;7;0;1;8
4312;Lazdynėlis;VOVERIUKAI;6863715428;Taip;3;0;0;3
4313;Lazdynėlis;VOVERIUKAI;1386686123;Taip;10;0;0;10
4314;Lazdynėlis;VOVERIUKAI;2587142646;Taip;0;6;1;7
4315;Lazdynėlis;VOVERIUKAI;2603427970;Taip;15;0;0;15
4316;Lazdynėlis;VOVERIUKAI;3043350186;Taip;0;0;1;1
4317;Lazdynėlis;VOVERIUKAI;44510351979;Taip;0;0;6;6
4318;Lazdynėlis;VOVERIUKAI;6762216509;Taip;0;14;5;19
4319;Lazdynėlis;VOVERIUKAI;4779025603;Taip;7;0;2;9
4320;Lazdynėlis;RIEŠUTĖLIAI;9693153118;Taip;14;1;0;15
4321;Lazdynėlis;RIEŠUTĖLIAI;5031826548;Ne;2;1;0;3
4322;Lazdynėlis;RIEŠUTĖLIAI;6056618348;Ne;0;21;0;21
4323;Lazdynėlis;RIEŠUTĖLIAI;5987500024;Taip;0;1;5;6
4324;Lazdynėlis;RIEŠUTĖLIAI;2453740823;Taip;6;3;0;9
4325;Lazdynėlis;RIEŠUTĖLIAI;4552505857;Ne;3;1;0;4
4326;Lazdynėlis;RIEŠUTĖLIAI;6276697479;Taip;0;13;2;15
4327;Lazdynėlis;RIEŠUTĖLIAI;7545621720;Taip;0;1;0;1
4328;Lazdynėlis;RIEŠUTĖLIAI;8179584161;Taip;0;0;4;4
4329;Lazdynėlis;RIEŠUTĖLIAI;3239107488;Ne;0;5;0;5
4330;Lazdynėlis;RIEŠUTĖLIAI;4055450300;Ne;0;1;5;6
4331;Lazdynėlis;RIEŠUTĖLIAI;3604282352;Taip;0;7;4;11
4332;Lazdynėlis;RIEŠUTĖLIAI;8942906327;Taip;9;0;4;13
4333;Lazdynėlis;RIEŠUTĖLIAI;3362193379;Taip;0;1;0;1
4334;Lazdynėlis;RIEŠUTĖLIAI;9582702244;Taip;2;7;0;9
4335;Lazdynėlis;RIEŠUTĖLIAI;3667994076;Taip;7;1;2;10
4336;Lazdynėlis;RIEŠUTĖLIAI;8248185061;Taip;12;1;0;13
4337;Lazdynėlis;ANČIUKAI;9519409694;Ne;9;0;0;9
4338;Lazdynėlis;ANČIUKAI;2526260625;Ne;7;0;0;7
4339;Lazdynėlis;ANČIUKAI;8340712398;Taip;5;0;0;5
4340;Lazdynėlis;ANČIUKAI;6031442797;Ne;0;20;0;20
4341;Lazdynėlis;ANČIUKAI;7552873109;Taip;0;20;0;20
4342;Lazdynėlis;ANČIUKAI;7655218276;Taip;0;20;0;20
4343;Lazdynėlis;ANČIUKAI;6817162699;Taip;0;0;1;1
4344;Lazdynėlis;ANČIUKAI;2294873565;Taip;7;0;3;10
4345;Lazdynėlis;ANČIUKAI;1499729462;Taip;0;1;3;4
4346;Lazdynėlis;ANČIUKAI;7282041196;Taip;5;11;0;16
4347;Lazdynėlis;ANČIUKAI;7692056055;Taip;0;10;0;10
4348;Lazdynėlis;ANČIUKAI;4745610579;Taip;0;20;0;20
4349;Lazdynėlis;ANČIUKAI;8530159773;Taip;0;19;0;19
4350;Lazdynėlis;ANČIUKAI;3036055537;Ne;0;20;0;20
4351;Lazdynėlis;ANČIUKAI;2911152510;Taip;0;10;0;10
4352;Lazdynėlis;ANČIUKAI;8229454863;Taip;0;11;0;11
4353;Lazdynėlis;ANČIUKAI;2933025284;Taip;0;20;0;20
4354;Lazdynėlis;GUDRUČIAI;23295374356;Taip;2;0;0;2
4355;Lazdynėlis;GUDRUČIAI;3589841658;Taip;6;0;5;11
4356;Lazdynėlis;GUDRUČIAI;80789407020;Taip;7;0;1;8
4357;Lazdynėlis;GUDRUČIAI;9668839027;Ne;0;0;1;1
4358;Lazdynėlis;GUDRUČIAI;8975341347;Taip;1;0;2;3
4359;Lazdynėlis;GUDRUČIAI;91720096560;Taip;13;0;1;14
4360;Lazdynėlis;GUDRUČIAI;10727984477;Taip;0;0;1;1
4361;Lazdynėlis;GUDRUČIAI;48860174942;Taip;0;0;4;4
4362;Lazdynėlis;GUDRUČIAI;83586382037;Taip;0;1;2;3
4363;Lazdynėlis;GUDRUČIAI;7499322078;Taip;0;0;1;1
4364;Lazdynėlis;GUDRUČIAI;1479568714;Taip;10;5;0;15
4365;Lazdynėlis;GUDRUČIAI;9081770664;Taip;0;12;0;12
4366;Lazdynėlis;GUDRUČIAI;1593314326;Taip;0;0;1;1
4367;Lazdynėlis;GUDRUČIAI;8271766964;Ne;0;8;1;9
4368;Lazdynėlis;GUDRUČIAI;2041709821;Taip;5;10;0;15
4369;Lazdynėlis;GUDRUČIAI;92889991874;Taip;0;1;0;1
4370;Lazdynėlis;GUDRUČIAI;1257093165;Taip;7;0;0;7
4371;Lazdynėlis;GUDRUČIAI;1169424024;Taip;0;0;1;1
4372;Lazdynėlis;GUDRUČIAI;90528749634;Ne;1;1;1;3
4373;Lazdynėlis;MEŠKIUKAI;8627994583;Taip;7;5;0;12
4374;Lazdynėlis;MEŠKIUKAI;9548653584;Taip;0;14;1;15
4375;Lazdynėlis;MEŠKIUKAI;8337458289;Taip;0;0;2;2
4376;Lazdynėlis;MEŠKIUKAI;3040417651;Taip;0;0;3;3
4377;Lazdynėlis;MEŠKIUKAI;2723284353;Ne;0;2;1;3
4378;Lazdynėlis;MEŠKIUKAI;2354549025;Taip;3;0;0;3
4379;Lazdynėlis;MEŠKIUKAI;7208223612;Taip;0;0;10;10
4380;Lazdynėlis;MEŠKIUKAI;4031719765;Taip;0;3;0;3
4381;Lazdynėlis;MEŠKIUKAI;5407785006;Ne;0;0;4;4
4382;Lazdynėlis;MEŠKIUKAI;4747688220;Taip;0;0;1;1
4383;Lazdynėlis;MEŠKIUKAI;3879017767;Taip;9;0;0;9
4384;Lazdynėlis;MEŠKIUKAI;5935345506;Taip;0;0;1;1
4385;Lazdynėlis;MEŠKIUKAI;2592852361;Taip;4;0;0;4
4386;Linelis;Giliukai;6979471009;Taip;8;0;0;8
4387;Linelis;Giliukai;71647031404;Ne;2;3;0;5
4388;Linelis;Giliukai;1148540808;Taip;0;19;0;19
4389;Linelis;Giliukai;8339073780;Taip;0;0;1;1
4390;Linelis;Giliukai;7530950218;Ne;0;0;1;1
4391;Linelis;Giliukai;8837847094;Taip;6;0;5;11
4392;Linelis;Giliukai;1194624252;Taip;0;0;5;5
4393;Linelis;Giliukai;4738909947;Taip;0;0;1;1
4394;Linelis;Giliukai;3189188757;Taip;12;0;0;12
4395;Linelis;Giliukai;1351957198;Taip;4;0;1;5
4396;Linelis;Giliukai;3682550072;Taip;6;0;0;6
4397;Linelis;Giliukai;6130634131;Taip;0;0;3;3
4398;Linelis;Giliukai;2391319590;Taip;0;7;1;8
4399;Linelis;Giliukai;6160295507;Taip;8;0;3;11
4400;Linelis;Giliukai;9666785036;Ne;8;1;0;9
4401;Linelis;Giliukai;8095635609;Ne;8;1;0;9
4402;Linelis;Giliukai;6374352500;Taip;4;10;0;14
4403;Linelis;Giliukai;5148531999;Taip;0;0;1;1
4404;Linelis;Saulutė;1623356368;Ne;0;0;1;1
4405;Linelis;Saulutė;32821891070;Taip;0;8;0;8
4406;Linelis;Saulutė;4443285231;Taip;0;3;0;3
4407;Linelis;Saulutė;58467930454;Taip;0;4;0;4
4408;Linelis;Saulutė;5075219728;Taip;0;1;0;1
4409;Linelis;Saulutė;5903547677;Taip;0;1;0;1
4410;Linelis;Saulutė;3300710386;Taip;0;1;0;1
4411;Linelis;Saulutė;1505058152;Ne;0;6;1;7
4412;Linelis;Saulutė;1891722948;Ne;0;11;0;11
4413;Linelis;Saulutė;4644771654;Taip;0;7;0;7
4414;Linelis;Saulutė;94514045159;Taip;0;1;0;1
4415;Linelis;Saulutė;46788785414;Taip;0;1;0;1
4416;Linelis;Saulutė;1270931913;Taip;0;1;0;1
4417;Linelis;Saulutė;3483401448;Ne;0;2;2;4
4418;Linelis;Saulutė;1237521453;Taip;0;1;0;1
4419;Linelis;Saulutė;61862257310;Taip;0;0;3;3
4420;Linelis;Saulutė;1526473615;Ne;9;0;2;11
4421;Linelis;Saulutė;1270843542;Taip;1;1;0;2
4422;Linelis;Saulutė;1159267747;Taip;5;0;0;5
4423;Linelis;Saulutė;1310088394;Ne;0;0;1;1
4424;Linelis;Nykštukai;9401101407;Ne;0;2;1;3
4425;Linelis;Nykštukai;3158789663;Taip;0;0;1;1
4426;Linelis;Nykštukai;5668765825;Taip;4;0;1;5
4427;Linelis;Nykštukai;3954867816;Taip;0;6;0;6
4428;Linelis;Nykštukai;7011836009;Taip;0;0;1;1
4429;Linelis;Nykštukai;6735037523;Taip;0;0;6;6
4430;Linelis;Nykštukai;4456549120;Ne;5;0;3;8
4431;Linelis;Nykštukai;9147558926;Taip;0;8;0;8
4432;Linelis;Nykštukai;7881263225;Taip;0;9;0;9
4433;Linelis;Nykštukai;1612049897;Taip;0;0;5;5
4434;Linelis;Nykštukai;9920959446;Taip;0;8;0;8
4435;Linelis;Nykštukai;8609248429;Taip;0;13;2;15
4436;Linelis;Nykštukai;2228682366;Taip;0;10;0;10
4437;Linelis;Nykštukai;7685809238;Ne;0;3;1;4
4438;Linelis;Nykštukai;4898147530;Taip;5;0;2;7
4439;Linelis;Daigiukai;6460217912;Taip;0;21;0;21
4440;Linelis;Daigiukai;2222790161;Taip;1;0;1;2
4441;Linelis;Daigiukai;7596876368;Taip;5;0;0;5
4442;Linelis;Daigiukai;9517319856;Ne;0;1;0;1
4443;Linelis;Daigiukai;9028515427;Taip;10;0;0;10
4444;Linelis;Daigiukai;2825756894;Ne;0;0;1;1
4445;Linelis;Daigiukai;8464672994;Taip;8;0;4;12
4446;Linelis;Daigiukai;3362971538;Taip;0;3;1;4
4447;Linelis;Daigiukai;7429853563;Ne;5;4;0;9
4448;Markučiai;Žirniukų;3525681034;Taip;0;1;1;2
4449;Markučiai;Žirniukų;7312533881;Taip;6;0;1;7
4450;Markučiai;Žirniukų;5269411010;Ne;10;0;0;10
4451;Markučiai;Žirniukų;5250815223;Ne;10;0;1;11
4452;Markučiai;Žirniukų;8934965409;Taip;0;2;0;2
4453;Markučiai;Žirniukų;8055783293;Ne;11;0;0;11
4454;Markučiai;Žirniukų;8360526946;Ne;13;2;0;15
4455;Markučiai;Žirniukų;5006880916;Ne;11;0;1;12
4456;Markučiai;Žirniukų;7244815252;Ne;10;0;0;10
4457;Markučiai;Žirniukų;2096169972;Ne;0;0;1;1
4458;Markučiai;Žirniukų;3073404128;Ne;4;1;0;5
4459;Markučiai;Žirniukų;6674351628;Ne;7;0;0;7
4460;Markučiai;Žirniukų;6029692121;Ne;6;0;0;6
4461;Markučiai;Žirniukų;5614488534;Ne;9;0;0;9
4462;Markučiai;Nykštukų;7507551844;Ne;0;0;3;3
4463;Markučiai;Nykštukų;9545967631;Ne;6;0;13;19
4464;Markučiai;Nykštukų;6121911851;Ne;0;0;12;12
4465;Markučiai;Nykštukų;6898055631;Ne;0;0;5;5
4466;Markučiai;Nykštukų;3378749042;Ne;16;0;0;16
4467;Markučiai;Nykštukų;1884388847;Ne;0;0;2;2
4468;Markučiai;Nykštukų;6849890197;Ne;0;0;3;3
4469;Markučiai;Nykštukų;2170380827;Ne;0;0;2;2
4470;Markučiai;Nykštukų;4485929800;Taip;14;0;0;14
4471;Markučiai;Nykštukų;5183244346;Ne;5;0;0;5
4472;Markučiai;Nykštukų;7624913025;Ne;0;0;7;7
4473;Markučiai;Nykštukų;4679710493;Ne;6;0;5;11
4474;Markučiai;Nykštukų;2994895532;Ne;9;0;0;9
4475;Markučiai;Nykštukų;4846899377;Ne;0;6;0;6
4476;Markučiai;Pelėdžiukų;3386071459;Taip;2;0;5;7
4477;Markučiai;Pelėdžiukų;4653663237;Ne;5;0;3;8
4478;Markučiai;Pelėdžiukų;6260010822;Taip;0;0;5;5
4479;Markučiai;Pelėdžiukų;5727655114;Taip;4;0;1;5
4480;Markučiai;Pelėdžiukų;6740434675;Taip;0;5;2;7
4481;Markučiai;Pelėdžiukų;6707310242;Taip;7;0;3;10
4482;Markučiai;Pelėdžiukų;2256262371;Taip;21;0;0;21
4483;Markučiai;Pelėdžiukų;7947287013;Taip;9;0;1;10
4484;Markučiai;Pelėdžiukų;4418580273;Taip;10;0;1;11
4485;Markučiai;Pelėdžiukų;5522654429;Taip;12;0;0;12
4486;Markučiai;Pelėdžiukų;4860961508;Taip;9;1;0;10
4487;Markučiai;Pelėdžiukų;9219710045;Taip;10;0;0;10
4488;Markučiai;Pelėdžiukų;7539605426;Taip;5;0;0;5
4489;Markučiai;Pelėdžiukų;8888538915;Ne;12;0;0;12
4490;Markučiai;Pelėdžiukų;1623728091;Taip;5;0;0;5
4491;Markučiai;Pelėdžiukų;1799946177;Ne;6;0;1;7
4492;Markučiai;Pelėdžiukų;7809719827;Taip;0;0;3;3
4493;Markučiai;Boružėlių;9059302464;Taip;4;0;2;6
4494;Markučiai;Boružėlių;9220749889;Taip;0;6;0;6
4495;Markučiai;Boružėlių;2962530721;Taip;5;2;0;7
4496;Markučiai;Boružėlių;6574037877;Taip;0;1;0;1
4497;Markučiai;Boružėlių;5752762229;Ne;0;1;0;1
4498;Markučiai;Boružėlių;4383421917;Taip;0;0;4;4
4499;Markučiai;Boružėlių;9789274040;Taip;6;2;0;8
4500;Markučiai;Boružėlių;1171899107;Taip;0;4;0;4
4501;Markučiai;Boružėlių;8078777204;Taip;15;0;0;15
4502;Markučiai;Boružėlių;8605357678;Taip;5;10;0;15
4503;Markučiai;Boružėlių;3755794133;Taip;7;0;3;10
4504;Markučiai;Boružėlių;5902165968;Taip;0;1;0;1
4505;Markučiai;Boružėlių;6055058096;Taip;10;0;2;12
4506;Markučiai;Boružėlių;5981692282;Taip;0;4;0;4
4507;Markučiai;Boružėlių;3739566642;Taip;13;0;0;13
4508;Markučiai;Boružėlių;6868394315;Taip;0;0;1;1
4509;Markučiai;Boružėlių;7634475536;Ne;0;0;2;2
4510;Markučiai;Boružėlių;8271830626;Taip;6;0;0;6
4511;Markučiai;Bitučių;1720541082;Ne;0;5;2;7
4512;Markučiai;Bitučių;8792524832;Taip;0;9;0;9
4513;Markučiai;Bitučių;1717624510;Taip;10;0;0;10
4514;Markučiai;Bitučių;9518247571;Taip;0;0;1;1
4515;Markučiai;Bitučių;4836298058;Taip;0;0;1;1
4516;Markučiai;Bitučių;9027071539;Taip;0;1;1;2
4517;Markučiai;Bitučių;8748794886;Taip;0;0;6;6
4518;Markučiai;Bitučių;8950442843;Taip;11;10;0;21
4519;Markučiai;Bitučių;2840564082;Ne;0;10;1;11
4520;Markučiai;Bitučių;3926993383;Taip;5;0;3;8
4521;Markučiai;Bitučių;6530101961;Taip;11;0;2;13
4522;Markučiai;Bitučių;1908302738;Taip;0;0;4;4
4523;Markučiai;Bitučių;7056367646;Taip;16;0;1;17
4524;Markučiai;Bitučių;8195584468;Taip;1;0;0;1
4525;Markučiai;Bitučių;2049497686;Taip;0;4;2;6
4526;Markučiai;Bitučių;9303448709;Taip;0;0;10;10
4527;Markučiai;Bitučių;8541042547;Taip;12;0;5;17
4528;Markučiai;Bitučių;1447116821;Taip;0;0;4;4
4529;Markučiai;Bitučių;6600535396;Taip;0;0;5;5
4530;Markučiai;Drugelių;1411292558;Taip;3;0;0;3
4531;Markučiai;Drugelių;63211076619;Taip;0;0;1;1
4532;Markučiai;Drugelių;2608111078;Taip;0;5;1;6
4533;Markučiai;Drugelių;9428254633;Taip;0;0;1;1
4534;Markučiai;Drugelių;61666612833;Taip;0;0;3;3
4535;Markučiai;Drugelių;20261053601;Taip;0;0;3;3
4536;Markučiai;Drugelių;4573605085;Ne;0;0;2;2
4537;Markučiai;Drugelių;19415636420;Taip;0;0;1;1
4538;Markučiai;Drugelių;24315961901;Taip;0;0;14;14
4539;Markučiai;Drugelių;45698891062;Taip;0;11;4;15
4540;Markučiai;Drugelių;22197471483;Taip;0;1;1;2
4541;Markučiai;Drugelių;9028932081;Taip;5;0;0;5
4542;Markučiai;Drugelių;11203825718;Taip;0;0;2;2
4543;Markučiai;Drugelių;7194049189;Taip;0;1;2;3
4544;Markučiai;Drugelių;1964223995;Taip;0;0;6;6
4545;Markučiai;Drugelių;23081602011;Ne;7;10;0;17
4546;Markučiai;Drugelių;9295954145;Ne;5;0;0;5
4547;Markučiai;Drugelių;1989923269;Taip;0;0;2;2
4548;Markučiai;Skruzdėliukų;1471334430;Taip;0;0;5;5
4549;Markučiai;Skruzdėliukų;9825799013;Ne;0;0;2;2
4550;Markučiai;Skruzdėliukų;8803226424;Taip;0;6;0;6
4551;Markučiai;Skruzdėliukų;55093673733;Taip;2;0;1;3
4552;Markučiai;Skruzdėliukų;39971140989;Taip;0;0;3;3
4553;Markučiai;Skruzdėliukų;54732351634;Taip;0;0;2;2
4554;Markučiai;Skruzdėliukų;1631270056;Ne;0;1;0;1
4555;Markučiai;Skruzdėliukų;2939795063;Taip;0;0;1;1
4556;Markučiai;Skruzdėliukų;9285037135;Taip;5;0;2;7
4557;Markučiai;Skruzdėliukų;1699369138;Taip;0;0;2;2
4558;Markučiai;Skruzdėliukų;1881218133;Taip;5;10;0;15
4559;Markučiai;Skruzdėliukų;8863238710;Ne;0;0;6;6
4560;Markučiai;Skruzdėliukų;68193563408;Taip;4;0;4;8
4561;Markučiai;Skruzdėliukų;92854605649;Taip;3;1;0;4
4562;Markučiai;Skruzdėliukų;7114409929;Taip;0;0;2;2
4563;Markučiai;Skruzdėliukų;1529531638;Taip;0;18;0;18
4564;Markučiai;Skruzdėliukų;4186684938;Taip;11;0;1;12
4565;Markučiai;ZUIKUČIŲ;82320812575;Taip;0;2;0;2
4566;Markučiai;ZUIKUČIŲ;4861535057;Taip;1;1;0;2
4567;Markučiai;ZUIKUČIŲ;1482203905;Ne;0;6;0;6
4568;Markučiai;ZUIKUČIŲ;2045207175;Taip;4;2;0;6
4569;Markučiai;ZUIKUČIŲ;11751635395;Taip;0;1;0;1
4570;Markučiai;ZUIKUČIŲ;7729045227;Taip;11;0;0;11
4571;Markučiai;ZUIKUČIŲ;8061880631;Taip;1;0;1;2
4572;Markučiai;ZUIKUČIŲ;1392582514;Taip;0;2;0;2
4573;Markučiai;ZUIKUČIŲ;7691410556;Taip;0;2;0;2
4574;Markučiai;ZUIKUČIŲ;6453095915;Taip;2;0;0;2
4575;Markučiai;ZUIKUČIŲ;6808291628;Taip;15;0;1;16
4576;Markučiai;ZUIKUČIŲ;5387571295;Taip;0;0;1;1
4577;Markučiai;ZUIKUČIŲ;91228262895;Taip;3;0;1;4
4578;Markučiai;ZUIKUČIŲ;1025406111;Taip;0;10;0;10
4579;Markučiai;ZUIKUČIŲ;5749873170;Taip;0;0;1;1
4580;Markučiai;ŽIOGELIŲ;3163226803;Taip;11;0;0;11
4581;Markučiai;ŽIOGELIŲ;1244026489;Taip;10;0;0;10
4582;Markučiai;ŽIOGELIŲ;76025616287;Taip;0;0;1;1
4583;Markučiai;ŽIOGELIŲ;1323922187;Taip;0;2;1;3
4584;Markučiai;ŽIOGELIŲ;54892037118;Taip;0;6;0;6
4585;Markučiai;ŽIOGELIŲ;1054802708;Taip;12;0;0;12
4586;Markučiai;ŽIOGELIŲ;67074776419;Taip;0;0;2;2
4587;Markučiai;ŽIOGELIŲ;1007919702;Taip;0;7;0;7
4588;Markučiai;ŽIOGELIŲ;1923521405;Taip;0;0;1;1
4589;Markučiai;ŽIOGELIŲ;1164386108;Taip;0;0;1;1
4590;Markučiai;ŽIOGELIŲ;7850311496;Taip;0;3;0;3
4591;Markučiai;ŽIOGELIŲ;2169583290;Taip;0;9;0;9
4592;Markučiai;ŽIOGELIŲ;3340385503;Taip;5;0;0;5
4593;Markučiai;ŽIOGELIŲ;4152184290;Taip;0;0;3;3
4594;Markučiai;ŽIOGELIŲ;1742944578;Taip;0;0;1;1
4595;Markučiai;ŽIOGELIŲ;23267867195;Taip;9;0;1;10
4596;Markučiai;Ežiukių;1827829954;Taip;0;3;0;3
4597;Markučiai;Ežiukių;4925856706;Taip;0;18;0;18
4598;Markučiai;Ežiukių;6570638672;Taip;0;4;0;4
4599;Markučiai;Ežiukių;1648283497;Taip;0;0;1;1
4600;Markučiai;Ežiukių;2687320408;Taip;5;1;6;12
4601;Markučiai;Ežiukių;1309122110;Taip;0;1;1;2
4602;Markučiai;Ežiukių;8990923872;Taip;12;3;0;15
4603;Markučiai;Ežiukių;2738553283;Taip;11;1;1;13
4604;Markučiai;Ežiukių;5246980173;Ne;0;1;2;3
4605;Markučiai;Ežiukių;6308368050;Ne;9;1;0;10
4606;Markučiai;Ežiukių;4249158803;Taip;10;0;11;21
4607;Markučiai;Ežiukių;5958705106;Taip;0;1;4;5
4608;Markučiai;Ežiukių;7791500322;Ne;0;1;1;2
4609;Markučiai;Ežiukių;3315824027;Ne;0;0;8;8
4610;Mažylis;"4 PRIEŠMOKYKLINĖ GR.";1023886258;Taip;0;0;10;10
4611;Mažylis;"4 PRIEŠMOKYKLINĖ GR.";5570166468;Taip;0;0;1;1
4612;Mažylis;"4 PRIEŠMOKYKLINĖ GR.";45148418456;Taip;5;0;1;6
4613;Mažylis;"4 PRIEŠMOKYKLINĖ GR.";1021183555;Taip;0;0;5;5
4614;Mažylis;"4 PRIEŠMOKYKLINĖ GR.";1643460270;Taip;0;0;1;1
4615;Mažylis;"4 PRIEŠMOKYKLINĖ GR.";69238700097;Taip;0;0;1;1
4616;Mažylis;"4 PRIEŠMOKYKLINĖ GR.";1999937720;Taip;0;0;1;1
4617;Mažylis;"4 PRIEŠMOKYKLINĖ GR.";2070067356;Ne;0;0;1;1
4618;Mažylis;"4 PRIEŠMOKYKLINĖ GR.";24303144913;Taip;0;0;1;1
4619;Mažylis;"4 PRIEŠMOKYKLINĖ GR.";9042228492;Ne;0;0;5;5
4620;Mažylis;"2 LOPŠELIO GR.";1219174313;Ne;4;0;0;4
4621;Mažylis;"2 LOPŠELIO GR.";7414398772;Taip;0;0;6;6
4622;Mažylis;"2 LOPŠELIO GR.";1058725505;Ne;0;4;0;4
4623;Mažylis;"2 LOPŠELIO GR.";6920171051;Ne;0;0;1;1
4624;Mažylis;"2 LOPŠELIO GR.";5658868407;Ne;0;0;5;5
4625;Mažylis;"2 LOPŠELIO GR.";7255856938;Taip;8;0;0;8
4626;Mažylis;"2 LOPŠELIO GR.";4987487972;Taip;0;0;1;1
4627;Mažylis;"2 LOPŠELIO GR.";9555408203;Taip;0;0;1;1
4628;Mažylis;"2 LOPŠELIO GR.";5165268747;Taip;0;8;0;8
4629;Mažylis;"2 LOPŠELIO GR.";2425437724;Taip;5;0;6;11
4630;Mažylis;"2 LOPŠELIO GR.";2723677422;Taip;14;0;1;15
4631;Mažylis;"3 DARŽELIO GR.";3081814579;Taip;0;0;2;2
4632;Mažylis;"3 DARŽELIO GR.";6100650710;Taip;0;0;2;2
4633;Mažylis;"3 DARŽELIO GR.";6009637985;Taip;0;0;3;3
4634;Mažylis;"3 DARŽELIO GR.";9401388775;Taip;0;0;6;6
4635;Mažylis;"3 DARŽELIO GR.";4817146074;Taip;0;0;4;4
4636;Mažylis;"3 DARŽELIO GR.";7106648054;Taip;0;6;0;6
4637;Mažylis;"3 DARŽELIO GR.";6809320247;Taip;0;0;6;6
4638;Mažylis;"3 DARŽELIO GR.";2006289999;Taip;4;0;0;4
4639;Mažylis;"3 DARŽELIO GR.";7652390515;Ne;0;0;3;3
4640;Mažylis;"3 DARŽELIO GR.";8639480781;Taip;0;0;2;2
4641;Mažylis;"3 DARŽELIO GR.";2656290898;Taip;3;0;3;6
4642;Mažylis;"3 DARŽELIO GR.";5685988186;Taip;0;0;1;1
4643;Mažylis;"3 DARŽELIO GR.";9341935211;Taip;0;0;4;4
4644;Mažylis;"3 DARŽELIO GR.";2989562406;Taip;7;0;0;7
4645;Mažylis;"3 DARŽELIO GR.";1151737098;Taip;5;0;8;13
4646;Mažylis;"3 DARŽELIO GR.";7642914458;Taip;0;0;1;1
4647;Mažylis;"3 DARŽELIO GR.";3081814579;Taip;0;0;2;2
4648;Mažylis;"3 DARŽELIO GR.";5938312001;Ne;0;0;3;3
4649;Mažylis;"3 DARŽELIO GR.";2119733659;Taip;0;0;5;5
4650;Mažylis;"3 DARŽELIO GR.";3126627913;Ne;0;0;12;12
4651;Mažylis;"3 DARŽELIO GR.";9362249595;Taip;0;0;3;3
4652;Mažylis;"6 DARŽELIO GR.";9411559447;Taip;13;0;4;17
4653;Mažylis;"6 DARŽELIO GR.";79181926145;Taip;4;0;0;4
4654;Mažylis;"6 DARŽELIO GR.";38277640135;Taip;0;0;6;6
4655;Mažylis;"6 DARŽELIO GR.";1663347167;Ne;9;0;0;9
4656;Mažylis;"6 DARŽELIO GR.";6920129837;Taip;0;0;4;4
4657;Mažylis;"6 DARŽELIO GR.";3860760654;Taip;0;0;3;3
4658;Mažylis;"6 DARŽELIO GR.";6851169340;Taip;0;0;1;1
4659;Mažylis;"6 DARŽELIO GR.";4486742281;Taip;0;0;3;3
4660;Mažylis;"6 DARŽELIO GR.";4252408251;Taip;0;0;1;1
4661;Mažylis;"6 DARŽELIO GR.";6134051712;Taip;0;0;2;2
4662;Mažylis;"6 DARŽELIO GR.";7416381505;Ne;0;15;0;15
4663;Mažylis;"6 DARŽELIO GR.";1514640197;Taip;0;0;2;2
4664;Mažylis;"6 DARŽELIO GR.";9608529135;Taip;0;0;8;8
4665;Mažylis;"6 DARŽELIO GR.";4645411379;Taip;0;7;0;7
4666;Mažylis;"6 DARŽELIO GR.";3344476309;Ne;6;0;2;8
4667;Mažylis;"1 NAUJA (LOPŠELIS)";7754956214;Taip;0;0;2;2
4668;Mažylis;"1 NAUJA (LOPŠELIS)";8589124394;Taip;7;0;0;7
4669;Mažylis;"1 NAUJA (LOPŠELIS)";1420913875;Taip;0;0;2;2
4670;Mažylis;"1 NAUJA (LOPŠELIS)";7725286603;Taip;6;0;1;7
4671;Mažylis;"1 NAUJA (LOPŠELIS)";9894955253;Taip;0;0;1;1
4672;Mažylis;"1 NAUJA (LOPŠELIS)";5388105083;Taip;0;0;7;7
4673;Mažylis;"1 NAUJA (LOPŠELIS)";4100492642;Taip;9;0;2;11
4674;Mažylis;"1 NAUJA (LOPŠELIS)";1642514752;Taip;13;0;3;16
4675;Mažylis;"1 NAUJA (LOPŠELIS)";9981751097;Taip;2;0;8;10
4676;Mažylis;"1 NAUJA (LOPŠELIS)";3615636349;Taip;5;0;0;5
4677;Mažylis;"1 NAUJA (LOPŠELIS)";9479398581;Ne;0;0;2;2
4678;Mažylis;"5 DARŽELIO GR.";2979849055;Ne;4;0;1;5
4679;Mažylis;"5 DARŽELIO GR.";4503734408;Taip;6;0;11;17
4680;Mažylis;"5 DARŽELIO GR.";6162880220;Taip;0;0;2;2
4681;Mažylis;"5 DARŽELIO GR.";2672500259;Taip;0;0;3;3
4682;Mažylis;"5 DARŽELIO GR.";8135596731;Taip;0;0;9;9
4683;Mažylis;"5 DARŽELIO GR.";8866980930;Taip;7;2;0;9
4684;Mažylis;"5 DARŽELIO GR.";6854350717;Taip;0;0;3;3
4685;Mažylis;"5 DARŽELIO GR.";1663216529;Ne;0;0;1;1
4686;Mažylis;"5 DARŽELIO GR.";3365026025;Taip;0;0;3;3
4687;Mažylis;"5 DARŽELIO GR.";7185347381;Taip;0;0;1;1
4688;Mažylis;"5 DARŽELIO GR.";9447747294;Taip;0;0;2;2
4689;Mažylis;"5 DARŽELIO GR.";4542742002;Taip;0;0;4;4
4690;Mažylis;"5 DARŽELIO GR.";2126108232;Taip;0;0;8;8
4691;Mažylis;"5 DARŽELIO GR.";4375683234;Taip;0;0;1;1
4692;Mažylis;"5 DARŽELIO GR.";8297427176;Taip;0;0;2;2
4693;Medynėlis;BITUTĖS;6107849795;Taip;10;0;1;11
4694;Medynėlis;BITUTĖS;4937709087;Taip;1;0;3;4
4695;Medynėlis;BITUTĖS;3674134340;Ne;0;0;4;4
4696;Medynėlis;BITUTĖS;6826790492;Ne;0;7;1;8
4697;Medynėlis;BITUTĖS;2627655353;Ne;3;0;4;7
4698;Medynėlis;BITUTĖS;5267128750;Ne;0;1;0;1
4699;Medynėlis;BITUTĖS;7638618099;Taip;0;0;7;7
4700;Medynėlis;BITUTĖS;4488439037;Ne;0;0;1;1
4701;Medynėlis;BITUTĖS;4100792567;Taip;0;0;2;2
4702;Medynėlis;BITUTĖS;6101613567;Ne;0;0;1;1
4703;Medynėlis;BITUTĖS;1056744101;Taip;0;0;8;8
4704;Medynėlis;BITUTĖS;6485314750;Ne;1;0;0;1
4705;Medynėlis;BITUTĖS;7455041214;Taip;7;1;0;8
4706;Medynėlis;BITUTĖS;2234994999;Taip;0;7;0;7
4707;Medynėlis;BITUTĖS;3761845905;Taip;0;1;8;9
4708;Medynėlis;BITUTĖS;4217263449;Ne;0;0;3;3
4709;Medynėlis;BITUTĖS;9825580191;Ne;2;0;0;2
4710;Medynėlis;BITUTĖS;3554823424;Ne;2;0;0;2
4711;Medynėlis;BITUTĖS;7272017225;Ne;0;9;0;9
4712;Medynėlis;BITUTĖS;4092824377;Taip;5;7;2;14
4713;Medynėlis;BITUTĖS;1475701065;Taip;0;7;0;7
4714;Medynėlis;DRUGELIAI;3165639252;Taip;6;1;0;7
4715;Medynėlis;DRUGELIAI;1437000615;Taip;10;0;0;10
4716;Medynėlis;DRUGELIAI;2406561273;Taip;0;2;0;2
4717;Medynėlis;DRUGELIAI;1080058205;Taip;6;1;0;7
4718;Medynėlis;DRUGELIAI;76668029492;Taip;0;14;0;14
4719;Medynėlis;DRUGELIAI;1829338208;Taip;7;1;0;8
4720;Medynėlis;DRUGELIAI;37435525923;Taip;0;6;0;6
4721;Medynėlis;DRUGELIAI;88240380945;Ne;7;3;0;10
4722;Medynėlis;DRUGELIAI;1129265551;Taip;1;0;0;1
4723;Medynėlis;DRUGELIAI;7804751416;Taip;3;5;0;8
4724;Medynėlis;DRUGELIAI;6182500688;Taip;0;12;0;12
4725;Medynėlis;DRUGELIAI;1898004894;Taip;9;1;0;10
4726;Medynėlis;DRUGELIAI;7886801955;Taip;11;1;0;12
4727;Medynėlis;DRUGELIAI;1192592678;Taip;5;2;0;7
4728;Medynėlis;DRUGELIAI;1338287524;Ne;0;2;0;2
4729;Medynėlis;DRUGELIAI;88550635466;Taip;0;2;0;2
4730;Medynėlis;SKRUZDĖLIUKAI;4024866819;Ne;7;0;0;7
4731;Medynėlis;SKRUZDĖLIUKAI;5186367833;Taip;5;3;0;8
4732;Medynėlis;SKRUZDĖLIUKAI;1827495325;Taip;0;0;3;3
4733;Medynėlis;SKRUZDĖLIUKAI;9413309043;Taip;0;0;3;3
4734;Medynėlis;SKRUZDĖLIUKAI;4581683292;Taip;0;1;2;3
4735;Medynėlis;SKRUZDĖLIUKAI;9009316740;Taip;0;0;2;2
4736;Medynėlis;SKRUZDĖLIUKAI;1795479738;Taip;4;14;0;18
4737;Medynėlis;SKRUZDĖLIUKAI;5269927048;Taip;5;0;2;7
4738;Medynėlis;SKRUZDĖLIUKAI;2427349194;Taip;0;0;1;1
4739;Medynėlis;SKRUZDĖLIUKAI;8948133343;Taip;0;6;0;6
4740;Medynėlis;SKRUZDĖLIUKAI;7633674694;Taip;0;0;2;2
4741;Medynėlis;SKRUZDĖLIUKAI;7244497661;Ne;3;0;2;5
4742;Medynėlis;SKRUZDĖLIUKAI;5995034919;Taip;0;4;3;7
4743;Medynėlis;SKRUZDĖLIUKAI;8775219704;Taip;3;2;0;5
4744;Medynėlis;SKRUZDĖLIUKAI;1658457155;Taip;0;0;3;3
4745;Medynėlis;SKRUZDĖLIUKAI;33981260502;Taip;3;0;4;7
4746;Medynėlis;SKRUZDĖLIUKAI;3773215372;Taip;11;1;0;12
4747;Medynėlis;SKRUZDĖLIUKAI;6343851636;Ne;0;0;3;3
4748;Medynėlis;SKRUZDĖLIUKAI;5551121950;Taip;3;0;0;3
4749;Medynėlis;SKRUZDĖLIUKAI;9670396828;Ne;12;0;1;13
4750;Medynėlis;SKRUZDĖLIUKAI;2540325264;Taip;5;0;1;6
4751;Medynėlis;VOVERIUKAI;2310200034;Ne;6;2;0;8
4752;Medynėlis;VOVERIUKAI;90556319090;Taip;9;1;0;10
4753;Medynėlis;VOVERIUKAI;6999562417;Taip;15;0;1;16
4754;Medynėlis;VOVERIUKAI;5586407412;Taip;0;0;6;6
4755;Medynėlis;VOVERIUKAI;7108619017;Taip;0;10;0;10
4756;Medynėlis;VOVERIUKAI;8441104709;Taip;0;0;2;2
4757;Medynėlis;VOVERIUKAI;1820113382;Taip;0;4;0;4
4758;Medynėlis;VOVERIUKAI;9304002459;Taip;0;10;6;16
4759;Medynėlis;VOVERIUKAI;1173510831;Taip;1;0;0;1
4760;Medynėlis;VOVERIUKAI;6406459222;Taip;5;1;0;6
4761;Medynėlis;VOVERIUKAI;4985243068;Taip;13;0;1;14
4762;Medynėlis;VOVERIUKAI;9073514151;Taip;2;0;4;6
4763;Medynėlis;VOVERIUKAI;4238860287;Ne;0;0;2;2
4764;Medynėlis;VOVERIUKAI;9800678364;Taip;12;0;3;15
4765;Medynėlis;VOVERIUKAI;1237589979;Taip;0;0;7;7
4766;Medynėlis;VOVERIUKAI;7140184593;Taip;2;0;4;6
4767;Medynėlis;VOVERIUKAI;5028189785;Ne;11;0;0;11
4768;Medynėlis;MEŠKIUKAI;1434648803;Ne;1;7;0;8
4769;Medynėlis;MEŠKIUKAI;1975763240;Taip;0;2;6;8
4770;Medynėlis;MEŠKIUKAI;1781906016;Taip;0;11;0;11
4771;Medynėlis;MEŠKIUKAI;46445461622;Taip;7;2;0;9
4772;Medynėlis;MEŠKIUKAI;5007624930;Taip;0;5;0;5
4773;Medynėlis;MEŠKIUKAI;8629622922;Taip;0;1;4;5
4774;Medynėlis;MEŠKIUKAI;1635649525;Taip;0;1;1;2
4775;Medynėlis;MEŠKIUKAI;2326848026;Taip;0;0;2;2
4776;Medynėlis;MEŠKIUKAI;5924711043;Taip;14;0;0;14
4777;Medynėlis;MEŠKIUKAI;8143370943;Taip;0;0;5;5
4778;Medynėlis;MEŠKIUKAI;1657676226;Taip;0;0;3;3
4779;Medynėlis;MEŠKIUKAI;7628899696;Taip;21;0;0;21
4780;Medynėlis;MEŠKIUKAI;96544597673;Taip;5;0;0;5
4781;Medynėlis;MEŠKIUKAI;1563329598;Taip;0;12;0;12
4782;Medynėlis;MEŠKIUKAI;48636516521;Taip;0;0;3;3
4783;Medynėlis;MEŠKIUKAI;1314163134;Taip;2;0;1;3
4784;Medynėlis;PELĖDŽIUKAI;5544663829;Taip;0;4;0;4
4785;Medynėlis;PELĖDŽIUKAI;2932544910;Taip;5;0;0;5
4786;Medynėlis;PELĖDŽIUKAI;9079900803;Taip;5;1;4;10
4787;Medynėlis;PELĖDŽIUKAI;5571641847;Taip;0;1;0;1
4788;Medynėlis;PELĖDŽIUKAI;8074251036;Taip;5;1;6;12
4789;Medynėlis;PELĖDŽIUKAI;9520409342;Taip;3;0;0;3
4790;Medynėlis;PELĖDŽIUKAI;6706028300;Taip;2;0;0;2
4791;Medynėlis;PELĖDŽIUKAI;8276864168;Taip;0;1;4;5
4792;Medynėlis;PELĖDŽIUKAI;6955467123;Taip;0;1;1;2
4793;Medynėlis;PELĖDŽIUKAI;5785463517;Taip;5;0;0;5
4794;Medynėlis;PELĖDŽIUKAI;1621499650;Taip;0;0;1;1
4795;Medynėlis;PELĖDŽIUKAI;6681155625;Taip;0;1;0;1
4796;Medynėlis;PELĖDŽIUKAI;9438854582;Taip;0;0;1;1
4797;Medynėlis;PELĖDŽIUKAI;1901805808;Taip;0;1;4;5
4798;Medynėlis;PELĖDŽIUKAI;5784691118;Taip;0;1;8;9
4799;Medynėlis;PELĖDŽIUKAI;3856908872;Ne;5;0;0;5
4800;Medynėlis;PELĖDŽIUKAI;4468967036;Ne;0;1;0;1
4801;Medynėlis;BORUŽIUKAI;7232396755;Taip;4;0;0;4
4802;Medynėlis;BORUŽIUKAI;7651663404;Taip;0;0;1;1
4803;Medynėlis;BORUŽIUKAI;5446430319;Taip;0;0;1;1
4804;Medynėlis;BORUŽIUKAI;1463263793;Taip;0;5;0;5
4805;Medynėlis;BORUŽIUKAI;1406029765;Taip;2;0;1;3
4806;Medynėlis;BORUŽIUKAI;9764215406;Taip;2;0;0;2
4807;Medynėlis;BORUŽIUKAI;6218943275;Taip;0;2;0;2
4808;Medynėlis;BORUŽIUKAI;8271170887;Ne;0;0;1;1
4809;Medynėlis;BORUŽIUKAI;5532880670;Taip;0;5;3;8
4810;Medynėlis;BORUŽIUKAI;1525185037;Ne;0;1;0;1
4811;Medynėlis;BORUŽIUKAI;1333848517;Taip;0;11;0;11
4812;Medynėlis;BORUŽIUKAI;9919108302;Taip;5;4;0;9
4813;Medynėlis;BORUŽIUKAI;1162859552;Taip;0;13;0;13
4814;Medynėlis;BORUŽIUKAI;1344240019;Taip;2;0;4;6
4815;Medynėlis;BORUŽIUKAI;9314893329;Taip;0;0;1;1
4816;Medynėlis;BORUŽIUKAI;4315717555;Taip;2;0;1;3
4817;Medynėlis;BORUŽIUKAI;5158507933;Taip;5;1;0;6
4818;Medynėlis;BORUŽIUKAI;4267654911;Ne;0;0;2;2
4819;Medynėlis;BORUŽIUKAI;2282754345;Ne;0;2;0;2
4820;Medynėlis;BORUŽIUKAI;2176438968;Taip;0;0;3;3
4821;Medynėlis;EŽIUKAI;9729505759;Taip;7;0;0;7
4822;Medynėlis;EŽIUKAI;8125271445;Taip;7;0;0;7
4823;Medynėlis;EŽIUKAI;9847006679;Taip;6;0;1;7
4824;Medynėlis;EŽIUKAI;7317307957;Taip;0;1;1;2
4825;Medynėlis;EŽIUKAI;7860869675;Taip;7;0;0;7
4826;Medynėlis;EŽIUKAI;1062269215;Taip;0;7;3;10
4827;Medynėlis;EŽIUKAI;5333502849;Taip;0;0;5;5
4828;Medynėlis;EŽIUKAI;6536626390;Taip;8;0;0;8
4829;Medynėlis;EŽIUKAI;3230747109;Ne;6;0;0;6
4830;Medynėlis;EŽIUKAI;9175884049;Taip;7;0;0;7
4831;Medynėlis;EŽIUKAI;8609650186;Taip;11;0;0;11
4832;Medynėlis;EŽIUKAI;6826409129;Taip;10;0;0;10
4833;Medynėlis;EŽIUKAI;2929100410;Taip;14;0;0;14
4834;Medynėlis;EŽIUKAI;6359536923;Taip;0;0;1;1
4835;Medynėlis;EŽIUKAI;2676262920;Taip;0;0;1;1
4836;Medynėlis;EŽIUKAI;5339084041;Taip;0;0;1;1
4837;Medynėlis;EŽIUKAI;6349817783;Taip;11;0;1;12
4838;Medynėlis;ZUIKUČIAI;6622963662;Taip;4;0;2;6
4839;Medynėlis;ZUIKUČIAI;4655266106;Taip;5;0;0;5
4840;Medynėlis;ZUIKUČIAI;3638155321;Taip;6;0;0;6
4841;Medynėlis;ZUIKUČIAI;9290099536;Ne;0;0;2;2
4842;Medynėlis;ZUIKUČIAI;6924524346;Taip;5;0;0;5
4843;Medynėlis;ZUIKUČIAI;4106792355;Taip;0;2;0;2
4844;Medynėlis;ZUIKUČIAI;6926408544;Taip;5;0;1;6
4845;Medynėlis;ZUIKUČIAI;6095795724;Taip;7;2;0;9
4846;Medynėlis;ZUIKUČIAI;7914358405;Ne;0;0;1;1
4847;Medynėlis;ZUIKUČIAI;8469157385;Taip;10;0;0;10
4848;Medynėlis;ZUIKUČIAI;9182653290;Taip;4;0;0;4
4849;Medynėlis;ZUIKUČIAI;3538656650;Ne;6;0;0;6
4850;Medynėlis;ZUIKUČIAI;6993176904;Taip;0;0;1;1
4851;Medynėlis;ZUIKUČIAI;4153545500;Taip;13;0;0;13
4852;Medynėlis;KAČIUKAI;3709984586;Taip;8;0;0;8
4853;Medynėlis;KAČIUKAI;6880069738;Taip;0;0;1;1
4854;Medynėlis;KAČIUKAI;4204366008;Taip;0;10;0;10
4855;Medynėlis;KAČIUKAI;6462589513;Taip;0;0;1;1
4856;Medynėlis;KAČIUKAI;7129951535;Taip;0;0;2;2
4857;Medynėlis;KAČIUKAI;7730737705;Taip;0;4;0;4
4858;Medynėlis;KAČIUKAI;7170801214;Taip;0;9;3;12
4859;Medynėlis;KAČIUKAI;6989524053;Taip;8;0;0;8
4860;Medynėlis;KAČIUKAI;5389909872;Taip;0;8;0;8
4861;Medynėlis;KAČIUKAI;4303234827;Taip;15;0;0;15
4862;Medynėlis;KAČIUKAI;9373849916;Taip;10;0;0;10
4863;Medynėlis;PELIUKAI;2993705115;Taip;0;0;1;1
4864;Medynėlis;PELIUKAI;1504612730;Taip;0;0;2;2
4865;Medynėlis;PELIUKAI;6576401514;Taip;3;0;4;7
4866;Medynėlis;PELIUKAI;7296044569;Taip;5;0;0;5
4867;Medynėlis;PELIUKAI;4418330478;Taip;6;0;0;6
4868;Medynėlis;PELIUKAI;6074296305;Taip;0;0;2;2
4869;Medynėlis;PELIUKAI;6815521895;Taip;0;0;2;2
4870;Medynėlis;PELIUKAI;4374464298;Taip;5;0;0;5
4871;Medynėlis;PELIUKAI;8877104963;Taip;7;0;3;10
4872;Medynėlis;PELIUKAI;4545707752;Taip;15;0;0;15
4873;Medynėlis;PELIUKAI;6466874318;Taip;4;0;1;5
4874;Medynėlis;PELIUKAI;5145195661;Taip;0;2;0;2
4875;Medynėlis;PELIUKAI;4598267411;Taip;11;0;0;11
4876;Medynėlis;PELIUKAI;5194220650;Taip;1;0;0;1
4877;Molinukas;NYKŠTUKAI;6353165459;Taip;0;0;1;1
4878;Molinukas;NYKŠTUKAI;5876669121;Taip;4;0;0;4
4879;Molinukas;NYKŠTUKAI;6087698882;Taip;0;0;2;2
4880;Molinukas;NYKŠTUKAI;2211909678;Taip;8;1;0;9
4881;Molinukas;NYKŠTUKAI;2348120316;Taip;0;1;19;20
4882;Molinukas;NYKŠTUKAI;8053608348;Taip;7;0;2;9
4883;Molinukas;NYKŠTUKAI;6014990150;Ne;11;0;0;11
4884;Molinukas;NYKŠTUKAI;7623051674;Taip;4;1;0;5
4885;Molinukas;NYKŠTUKAI;9448910819;Taip;0;1;0;1
4886;Molinukas;NYKŠTUKAI;1651650182;Taip;0;10;1;11
4887;Molinukas;NYKŠTUKAI;5580968328;Ne;5;0;16;21
4888;Molinukas;NYKŠTUKAI;8536615996;Ne;0;0;1;1
4889;Molinukas;NYKŠTUKAI;1849018608;Taip;0;1;0;1
4890;Molinukas;NYKŠTUKAI;4171978721;Ne;0;6;0;6
4891;Molinukas;NYKŠTUKAI;7134802574;Taip;0;0;1;1
4892;Molinukas;NYKŠTUKAI;8260101075;Taip;0;0;1;1
4893;Molinukas;NYKŠTUKAI;9293819449;Taip;0;7;0;7
4894;Molinukas;NYKŠTUKAI;5525772579;Taip;0;0;5;5
4895;Molinukas;NYKŠTUKAI;7248705010;Taip;0;0;2;2
4896;Molinukas;ZUIKUČIŲ;5387818175;Ne;0;0;3;3
4897;Molinukas;ZUIKUČIŲ;6326031969;Taip;4;0;5;9
4898;Molinukas;ZUIKUČIŲ;7398075402;Taip;0;0;3;3
4899;Molinukas;ZUIKUČIŲ;7377137582;Taip;5;0;4;9
4900;Molinukas;ZUIKUČIŲ;4534279257;Ne;7;0;0;7
4901;Molinukas;ZUIKUČIŲ;8688180482;Taip;15;6;0;21
4902;Molinukas;ZUIKUČIŲ;3917187380;Taip;0;0;3;3
4903;Molinukas;ZUIKUČIŲ;1686122652;Taip;15;1;0;16
4904;Molinukas;ZUIKUČIŲ;4918181437;Taip;11;0;2;13
4905;Molinukas;ZUIKUČIŲ;8604288346;Ne;0;5;1;6
4906;Molinukas;ZUIKUČIŲ;1856269656;Taip;10;0;2;12
4907;Molinukas;ZUIKUČIŲ;6636118069;Taip;0;5;0;5
4908;Molinukas;ZUIKUČIŲ;2774371800;Taip;0;0;18;18
4909;Molinukas;ZUIKUČIŲ;8913137310;Ne;0;5;0;5
4910;Molinukas;ZUIKUČIŲ;8416644024;Ne;0;0;2;2
4911;Molinukas;ZUIKUČIŲ;8393217418;Taip;0;0;1;1
4912;Molinukas;ZUIKUČIŲ;4766547534;Taip;9;0;0;9
4913;Molinukas;ZUIKUČIŲ;6681397435;Ne;0;0;2;2
4914;Molinukas;SRAIGIUKŲ;13856993048;Taip;0;0;15;15
4915;Molinukas;SRAIGIUKŲ;93528667925;Taip;3;0;0;3
4916;Molinukas;SRAIGIUKŲ;10482714545;Taip;7;0;0;7
4917;Molinukas;SRAIGIUKŲ;99537506556;Taip;10;0;0;10
4918;Molinukas;SRAIGIUKŲ;1151672597;Taip;5;0;1;6
4919;Molinukas;SRAIGIUKŲ;1293862946;Taip;0;0;1;1
4920;Molinukas;SRAIGIUKŲ;7987658567;Ne;0;5;0;5
4921;Molinukas;SRAIGIUKŲ;8674220663;Taip;5;0;0;5
4922;Molinukas;SRAIGIUKŲ;12208955611;Taip;0;3;0;3
4923;Molinukas;SRAIGIUKŲ;7991320348;Taip;0;3;0;3
4924;Molinukas;SRAIGIUKŲ;1241069188;Taip;4;1;0;5
4925;Molinukas;SRAIGIUKŲ;45801826827;Taip;0;0;1;1
4926;Molinukas;VOVERIUKAI;3469196411;Taip;10;0;0;10
4927;Molinukas;VOVERIUKAI;8541456847;Taip;12;0;0;12
4928;Molinukas;VOVERIUKAI;2286586693;Taip;0;10;10;20
4929;Molinukas;VOVERIUKAI;9413396859;Taip;8;5;2;15
4930;Molinukas;VOVERIUKAI;6898958282;Taip;5;0;3;8
4931;Molinukas;VOVERIUKAI;5685582215;Taip;3;6;4;13
4932;Molinukas;VOVERIUKAI;2356814145;Taip;0;0;5;5
4933;Molinukas;VOVERIUKAI;7446607510;Taip;10;0;0;10
4934;Molinukas;VOVERIUKAI;9667704959;Taip;0;0;17;17
4935;Molinukas;VOVERIUKAI;8516451290;Taip;0;0;1;1
4936;Molinukas;VOVERIUKAI;3030169626;Taip;10;0;0;10
4937;Molinukas;VOVERIUKAI;3207373459;Taip;0;0;3;3
4938;Molinukas;VOVERIUKAI;1865748733;Ne;7;5;0;12
4939;Molinukas;VOVERIUKAI;4209143136;Taip;12;5;0;17
4940;Molinukas;VOVERIUKAI;5648861702;Taip;12;5;0;17
4941;Molinukas;VOVERIUKAI;8865966572;Taip;14;0;1;15
4942;Molinukas;VOVERIUKAI;4950808381;Taip;1;10;0;11
4943;Molinukas;VOVERIUKAI;7378643086;Taip;7;0;1;8
4944;Molinukas;VOVERIUKAI;2779700726;Taip;0;17;4;21
4945;Molinukas;VOVERIUKAI;6832647220;Taip;2;15;2;19
4946;Molinukas;VOVERIUKAI;9318837973;Taip;11;0;0;11
4947;Molinukas;VOVERIUKAI;8247270556;Taip;0;1;5;6
4948;Molinukas;ŽVIRBLIUKŲ;8490020853;Ne;5;0;0;5
4949;Molinukas;ŽVIRBLIUKŲ;8582985479;Ne;5;0;0;5
4950;Molinukas;ŽVIRBLIUKŲ;6804127471;Ne;4;0;0;4
4951;Molinukas;ŽVIRBLIUKŲ;1605039166;Ne;4;0;0;4
4952;Molinukas;ŽVIRBLIUKŲ;9203375647;Taip;3;0;0;3
4953;Molinukas;ŽVIRBLIUKŲ;5302191209;Ne;3;0;1;4
4954;Molinukas;ŽVIRBLIUKŲ;7441251480;Taip;3;0;0;3
4955;Molinukas;ŽVIRBLIUKŲ;8988478990;Taip;0;0;1;1
4956;Molinukas;ŽVIRBLIUKŲ;8479427729;Taip;2;0;0;2
4957;Molinukas;ŽVIRBLIUKŲ;5597119459;Taip;6;0;4;10
4958;Molinukas;KAČIUKŲ;6638634402;Ne;5;0;0;5
4959;Molinukas;KAČIUKŲ;4992887072;Taip;0;0;2;2
4960;Molinukas;KAČIUKŲ;9972204424;Taip;3;0;0;3
4961;Molinukas;KAČIUKŲ;2789279432;Taip;4;0;0;4
4962;Molinukas;KAČIUKŲ;4733315902;Taip;0;0;2;2
4963;Molinukas;KAČIUKŲ;2595941277;Taip;6;0;0;6
4964;Naminukas;Drugeliai;2395070574;Taip;0;6;0;6
4965;Naminukas;Drugeliai;5534073614;Taip;5;0;0;5
4966;Naminukas;Drugeliai;7347998152;Taip;0;3;0;3
4967;Naminukas;Drugeliai;1302119260;Taip;0;1;0;1
4968;Naminukas;Drugeliai;2864905392;Taip;0;1;0;1
4969;Naminukas;Drugeliai;7406775925;Taip;4;1;0;5
4970;Naminukas;Drugeliai;1333462200;Taip;1;0;6;7
4971;Naminukas;Drugeliai;5468218968;Taip;5;1;0;6
4972;Naminukas;Drugeliai;5713661641;Ne;5;1;0;6
4973;Naminukas;Drugeliai;6581925461;Taip;0;0;2;2
4974;Naminukas;Drugeliai;9312058190;Taip;10;0;1;11
4975;Naminukas;Drugeliai;3320805432;Taip;0;7;0;7
4976;Naminukas;Drugeliai;9689866363;Taip;0;0;2;2
4977;Naminukas;Drugeliai;2675777359;Ne;0;0;3;3
4978;Naminukas;Drugeliai;8141324449;Ne;13;1;0;14
4979;Naminukas;Drugeliai;4599700492;Taip;11;0;0;11
4980;Naminukas;Drugeliai;8564586014;Ne;0;4;0;4
4981;Naminukas;Bitutės;4419568254;Taip;0;1;0;1
4982;Naminukas;Bitutės;1956749138;Taip;0;15;0;15
4983;Naminukas;Bitutės;6503569633;Taip;5;10;2;17
4984;Naminukas;Bitutės;3192885665;Taip;7;0;6;13
4985;Naminukas;Bitutės;9530232649;Taip;3;0;6;9
4986;Naminukas;Bitutės;8131328042;Ne;0;8;0;8
4987;Naminukas;Bitutės;7176287699;Taip;0;0;7;7
4988;Naminukas;Bitutės;7888950723;Taip;0;0;12;12
4989;Naminukas;Bitutės;1710002948;Taip;17;0;0;17
4990;Naminukas;Bitutės;3994190066;Taip;0;3;0;3
4991;Naminukas;Bitutės;9600303816;Taip;0;1;0;1
4992;Naminukas;Bitutės;5195078101;Taip;0;3;0;3
4993;Naminukas;Bitutės;9541388086;Taip;0;1;0;1
4994;Naminukas;Bitutės;2424412518;Taip;4;11;0;15
4995;Naminukas;Bitutės;41538301616;Taip;0;1;0;1
4996;Naminukas;Bitutės;5493709688;Ne;0;0;9;9
4997;Naminukas;Bitutės;2769848640;Ne;0;7;0;7
4998;Naminukas;Bitutės;9501202207;Taip;0;8;0;8
4999;Naminukas;Bitutės;9821244713;Ne;8;0;0;8
5000;Naminukas;Bitutės;7847923107;Ne;4;0;0;4
5001;Naminukas;Bitutės;1480152104;Ne;5;0;1;6
5002;Naminukas;Paukšteliai;8168444253;Ne;0;0;5;5
5003;Naminukas;Paukšteliai;3501921619;Taip;4;0;0;4
5004;Naminukas;Paukšteliai;7297661383;Ne;1;0;0;1
5005;Naminukas;Paukšteliai;2064182165;Taip;13;0;0;13
5006;Naminukas;Paukšteliai;5056487802;Taip;7;1;0;8
5007;Naminukas;Paukšteliai;3438010199;Taip;2;0;0;2
5008;Naminukas;Paukšteliai;4998565160;Taip;0;6;0;6
5009;Naminukas;Paukšteliai;9405784626;Ne;5;0;5;10
5010;Naminukas;Paukšteliai;2583886896;Taip;12;0;0;12
5011;Naminukas;Paukšteliai;4778385421;Ne;0;0;1;1
5012;Naminukas;Paukšteliai;2652538212;Taip;10;0;0;10
5013;Naminukas;Paukšteliai;9440685520;Taip;1;0;0;1
5014;Naminukas;Paukšteliai;6415383097;Taip;0;0;2;2
5015;Naminukas;"NYKŠTUKAI ";59020433000;Taip;0;3;0;3
5016;Naminukas;"NYKŠTUKAI ";46665774314;Taip;0;2;0;2
5017;Naminukas;"NYKŠTUKAI ";1490712871;Taip;0;0;2;2
5018;Naminukas;"NYKŠTUKAI ";5918430817;Taip;0;0;3;3
5019;Naminukas;"NYKŠTUKAI ";1499464511;Ne;4;0;0;4
5020;Naminukas;"NYKŠTUKAI ";6501046678;Ne;0;0;4;4
5021;Naminukas;"NYKŠTUKAI ";70281612245;Taip;12;0;1;13
5022;Naminukas;"NYKŠTUKAI ";74291965804;Taip;3;0;1;4
5023;Naminukas;"NYKŠTUKAI ";10563508139;Taip;0;2;0;2
5024;Naminukas;"NYKŠTUKAI ";90045007984;Taip;0;7;0;7
5025;Naminukas;"NYKŠTUKAI ";6029194403;Taip;2;6;0;8
5026;Naminukas;"NYKŠTUKAI ";16946991001;Taip;0;5;0;5
5027;Naminukas;"NYKŠTUKAI ";3826149605;Ne;0;6;0;6
5028;Naminukas;"NYKŠTUKAI ";1581477416;Taip;0;1;0;1
5029;Naminukas;"NYKŠTUKAI ";38347825944;Taip;11;0;0;11
5030;Naminukas;"NYKŠTUKAI ";20358771509;Taip;6;3;0;9
5031;Naminukas;"NYKŠTUKAI ";3595932330;Taip;9;0;3;12
5032;Naminukas;"NYKŠTUKAI ";19471902337;Ne;0;3;0;3
5033;Nykštukas;SMAGURIAI;8120626738;Taip;16;0;0;16
5034;Nykštukas;SMAGURIAI;9842748132;Taip;4;1;5;10
5035;Nykštukas;SMAGURIAI;4830484167;Taip;5;1;2;8
5036;Nykštukas;SMAGURIAI;1902253981;Taip;5;1;0;6
5037;Nykštukas;SMAGURIAI;4949895196;Taip;0;1;2;3
5038;Nykštukas;SMAGURIAI;9713859038;Taip;6;1;0;7
5039;Nykštukas;SMAGURIAI;7954996421;Taip;7;7;0;14
5040;Nykštukas;SMAGURIAI;4771072061;Taip;19;0;0;19
5041;Nykštukas;SMAGURIAI;6139988523;Taip;0;1;0;1
5042;Nykštukas;SMAGURIAI;5190754451;Taip;5;11;0;16
5043;Nykštukas;SMAGURIAI;1707956308;Ne;0;1;2;3
5044;Nykštukas;SMAGURIAI;8635571067;Taip;0;1;0;1
5045;Nykštukas;SMAGURIAI;9326131725;Taip;0;1;0;1
5046;Nykštukas;SMAGURIAI;2000207070;Taip;13;0;0;13
5047;Nykštukas;SMAGURIAI;5421090978;Taip;20;1;0;21
5048;Nykštukas;SMAGURIAI;2826079911;Taip;6;0;0;6
5049;Nykštukas;SMAGURIAI;7911842707;Taip;10;2;2;14
5050;Nykštukas;SMAGURIAI;6102907953;Taip;16;0;0;16
5051;Nykštukas;SMAGURIAI;7529677915;Taip;0;0;3;3
5052;Nykštukas;SMAGURIAI;4994727422;Taip;0;2;0;2
5053;Nykštukas;SMAGURIAI;2669525989;Taip;6;0;0;6
5054;Nykštukas;SMAGURIAI;3007541327;Taip;10;1;2;13
5055;Nykštukas;SMALSIUKAI;5121027981;Taip;10;1;0;11
5056;Nykštukas;SMALSIUKAI;6958596223;Ne;5;0;3;8
5057;Nykštukas;SMALSIUKAI;4612171029;Ne;0;1;0;1
5058;Nykštukas;SMALSIUKAI;3120577264;Taip;10;1;0;11
5059;Nykštukas;SMALSIUKAI;3852057722;Ne;12;1;0;13
5060;Nykštukas;SMALSIUKAI;2696384135;Taip;5;1;0;6
5061;Nykštukas;SMALSIUKAI;9532956150;Taip;0;1;0;1
5062;Nykštukas;SMALSIUKAI;3273579005;Taip;13;1;0;14
5063;Nykštukas;SMALSIUKAI;3985610575;Taip;0;2;0;2
5064;Nykštukas;SMALSIUKAI;8948554271;Taip;9;0;0;9
5065;Nykštukas;SMALSIUKAI;4331906712;Taip;5;0;0;5
5066;Nykštukas;SMALSIUKAI;6112448299;Ne;0;1;3;4
5067;Nykštukas;SMALSIUKAI;9100510105;Taip;0;3;0;3
5068;Nykštukas;SMALSIUKAI;2143857296;Ne;13;0;0;13
5069;Nykštukas;SMALSIUKAI;9779645295;Taip;0;1;0;1
5070;Nykštukas;AITVARIUKAI;6787279403;Taip;0;5;0;5
5071;Nykštukas;AITVARIUKAI;3808695428;Taip;0;2;0;2
5072;Nykštukas;AITVARIUKAI;2002197530;Taip;18;0;0;18
5073;Nykštukas;AITVARIUKAI;2113361929;Taip;10;0;0;10
5074;Nykštukas;AITVARIUKAI;1555891900;Taip;0;1;0;1
5075;Nykštukas;AITVARIUKAI;4256675710;Taip;2;1;0;3
5076;Nykštukas;AITVARIUKAI;1209871301;Taip;0;4;0;4
5077;Nykštukas;AITVARIUKAI;93527297465;Ne;2;0;0;2
5078;Nykštukas;AITVARIUKAI;1642172676;Taip;0;4;0;4
5079;Nykštukas;AITVARIUKAI;4487291454;Taip;2;0;0;2
5080;Nykštukas;AITVARIUKAI;1760718866;Taip;0;0;3;3
5081;Nykštukas;AITVARIUKAI;5772758127;Taip;6;0;0;6
5082;Nykštukas;AITVARIUKAI;9229795383;Ne;0;3;0;3
5083;Nykštukas;AITVARIUKAI;3479582264;Taip;0;4;0;4
5084;Nykštukas;AITVARIUKAI;1643843455;Taip;0;7;0;7
5085;Nykštukas;AITVARIUKAI;1965559069;Taip;7;4;0;11
5086;Nykštukas;AITVARIUKAI;92898851752;Ne;0;16;0;16
5087;Nykštukas;AITVARIUKAI;368045639;Taip;0;4;0;4
5088;Nykštukas;DAINORĖLIAI;1505896987;Ne;13;0;0;13
5089;Nykštukas;DAINORĖLIAI;1070086244;Taip;0;2;6;8
5090;Nykštukas;DAINORĖLIAI;6105521992;Taip;2;0;0;2
5091;Nykštukas;DAINORĖLIAI;67968815055;Taip;0;4;0;4
5092;Nykštukas;DAINORĖLIAI;23638266708;Taip;5;0;1;6
5093;Nykštukas;DAINORĖLIAI;8027860617;Taip;0;16;0;16
5094;Nykštukas;DAINORĖLIAI;7498721887;Taip;0;0;1;1
5095;Nykštukas;DAINORĖLIAI;7660848578;Taip;0;1;0;1
5096;Nykštukas;DAINORĖLIAI;2284266953;Taip;9;0;2;11
5097;Nykštukas;DAINORĖLIAI;4720226790;Taip;0;12;2;14
5098;Nykštukas;DAINORĖLIAI;7546263542;Taip;5;0;0;5
5099;Nykštukas;DAINORĖLIAI;9778271272;Taip;6;6;0;12
5100;Nykštukas;DAINORĖLIAI;7150793310;Taip;10;2;0;12
5101;Nykštukas;DAINORĖLIAI;8323439041;Ne;10;0;0;10
5102;Nykštukas;DAINORĖLIAI;7615678714;Taip;0;9;0;9
5103;Nykštukas;DAINORĖLIAI;9567571526;Taip;9;1;0;10
5104;Nykštukas;DAINORĖLIAI;3970413055;Taip;5;0;0;5
5105;Nykštukas;DAINORĖLIAI;2657373608;Taip;0;3;0;3
5106;Nykštukas;DAINORĖLIAI;1755944368;Taip;6;2;0;8
5107;Nykštukas;DAINORĖLIAI;8781148130;Taip;0;0;1;1
5108;Nykštukas;DAINORĖLIAI;3904901392;Taip;7;6;0;13
5109;Nykštukas;POKŠTUKAI;7382271765;Taip;5;0;0;5
5110;Nykštukas;POKŠTUKAI;1655428422;Taip;5;0;0;5
5111;Nykštukas;POKŠTUKAI;2649916049;Taip;12;0;0;12
5112;Nykštukas;POKŠTUKAI;1796016501;Taip;6;0;0;6
5113;Nykštukas;POKŠTUKAI;5958711585;Taip;10;0;0;10
5114;Nykštukas;POKŠTUKAI;8371081106;Taip;9;0;1;10
5115;Nykštukas;POKŠTUKAI;9218154624;Ne;18;0;0;18
5116;Nykštukas;POKŠTUKAI;3999004312;Taip;5;0;0;5
5117;Nykštukas;POKŠTUKAI;6719999304;Taip;9;0;0;9
5118;Nykštukas;POKŠTUKAI;4877996067;Taip;6;0;0;6
5119;Nykštukas;POKŠTUKAI;8148163137;Taip;13;0;0;13
5120;Nykštukas;POKŠTUKAI;4332729441;Ne;10;0;0;10
5121;Nykštukas;POKŠTUKAI;5388581137;Taip;3;0;0;3
5122;Nykštukas;POKŠTUKAI;8708184278;Ne;8;0;0;8
5123;Nykštukas;POKŠTUKAI;5699671696;Taip;10;0;0;10
5124;Nykštukas;POKŠTUKAI;3843163586;Ne;7;0;0;7
5125;Nykštukas;KODĖLČIUKAI;5337728911;Taip;7;0;0;7
5126;Nykštukas;KODĖLČIUKAI;3507649457;Taip;5;0;0;5
5127;Nykštukas;KODĖLČIUKAI;3428031037;Ne;11;0;0;11
5128;Nykštukas;KODĖLČIUKAI;5088668786;Ne;15;0;1;16
5129;Nykštukas;KODĖLČIUKAI;8484617555;Taip;0;0;1;1
5130;Nykštukas;KODĖLČIUKAI;4508625009;Taip;5;0;0;5
5131;Nykštukas;KODĖLČIUKAI;9509051946;Taip;0;0;2;2
5132;Nykštukas;KODĖLČIUKAI;6698622575;Taip;4;0;0;4
5133;Nykštukas;KODĖLČIUKAI;8874850019;Taip;5;0;1;6
5134;Nykštukas;KODĖLČIUKAI;2231375994;Taip;6;8;6;20
5135;Nykštukas;KODĖLČIUKAI;1752916582;Ne;0;0;2;2
5136;Nykštukas;KODĖLČIUKAI;1510338621;Ne;8;0;1;9
5137;Nykštukas;PASAKORIAI;2661110617;Taip;11;0;0;11
5138;Nykštukas;PASAKORIAI;3040001373;Taip;6;1;0;7
5139;Nykštukas;PASAKORIAI;1855278809;Taip;0;8;0;8
5140;Nykštukas;PASAKORIAI;8640715657;Taip;8;0;1;9
5141;Nykštukas;PASAKORIAI;5504584349;Taip;0;1;0;1
5142;Nykštukas;PASAKORIAI;7990462246;Taip;0;1;2;3
5143;Nykštukas;PASAKORIAI;1379378120;Taip;0;10;1;11
5144;Nykštukas;PASAKORIAI;2518342041;Taip;0;1;0;1
5145;Nykštukas;PASAKORIAI;7828733135;Taip;9;0;0;9
5146;Nykštukas;PASAKORIAI;4480184458;Taip;5;0;0;5
5147;Nykštukas;PASAKORIAI;4090494707;Taip;0;4;1;5
5148;Nykštukas;PASAKORIAI;3026598985;Ne;8;0;1;9
5149;Nykštukas;PASAKORIAI;9714310539;Taip;0;1;0;1
5150;Nykštukas;PASAKORIAI;4795301170;Taip;9;0;1;10
5151;Nykštukas;PASAKORIAI;6039661153;Ne;12;0;0;12
5152;Nykštukas;PASAKORIAI;1579064341;Taip;0;0;1;1
5153;Nykštukas;PASAKORIAI;4992654449;Taip;5;0;1;6
5154;Nykštukas;GUDRUČIAI;9871410323;Taip;6;7;0;13
5155;Nykštukas;GUDRUČIAI;4559818614;Taip;4;1;0;5
5156;Nykštukas;GUDRUČIAI;7447202642;Taip;10;0;3;13
5157;Nykštukas;GUDRUČIAI;1714708754;Taip;10;0;0;10
5158;Nykštukas;GUDRUČIAI;5157799354;Taip;14;0;0;14
5159;Nykštukas;GUDRUČIAI;4325369395;Taip;9;5;0;14
5160;Nykštukas;GUDRUČIAI;6630804505;Taip;9;4;0;13
5161;Nykštukas;GUDRUČIAI;8363202198;Ne;7;0;0;7
5162;Nykštukas;GUDRUČIAI;7326535810;Taip;7;0;0;7
5163;Nykštukas;GUDRUČIAI;9712596180;Taip;5;0;0;5
5164;Nykštukas;GUDRUČIAI;9941937734;Taip;8;0;0;8
5165;Nykštukas;GUDRUČIAI;2494482185;Taip;7;0;0;7
5166;Nykštukas;GUDRUČIAI;3619459404;Taip;10;0;0;10
5167;Nykštukas;GUDRUČIAI;9389736360;Taip;7;0;4;11
5168;Nykštukas;NAMINUKAI;7456007276;Taip;0;0;4;4
5169;Nykštukas;NAMINUKAI;7176519994;Taip;0;11;0;11
5170;Nykštukas;NAMINUKAI;2440574056;Taip;0;6;0;6
5171;Nykštukas;NAMINUKAI;4064016871;Taip;0;0;1;1
5172;Nykštukas;NAMINUKAI;6519078450;Taip;0;5;0;5
5173;Nykštukas;NAMINUKAI;6106373554;Taip;3;0;3;6
5174;Nykštukas;NAMINUKAI;4925214655;Taip;0;2;0;2
5175;Nykštukas;NAMINUKAI;6338717583;Taip;0;0;2;2
5176;Nykštukas;NAMINUKAI;7976689381;Ne;6;1;0;7
5177;Nykštukas;NAMINUKAI;9686815141;Taip;15;1;0;16
5178;Nykštukas;NAMINUKAI;4503830456;Taip;0;0;4;4
5179;Nykštukas;NAMINUKAI;4040123876;Taip;0;7;0;7
5180;Nykštukas;KŪLVERSTUKAI;9776630115;Taip;0;3;0;3
5181;Nykštukas;KŪLVERSTUKAI;1167614164;Taip;9;0;1;10
5182;Nykštukas;KŪLVERSTUKAI;1174618721;Taip;0;5;0;5
5183;Nykštukas;KŪLVERSTUKAI;9524639831;Taip;7;0;3;10
5184;Nykštukas;KŪLVERSTUKAI;1283453188;Taip;10;0;0;10
5185;Nykštukas;KŪLVERSTUKAI;3367348573;Taip;0;6;0;6
5186;Nykštukas;KŪLVERSTUKAI;1122600949;Taip;11;1;0;12
5187;Nykštukas;KŪLVERSTUKAI;7473124310;Taip;2;0;0;2
5188;Nykštukas;KŪLVERSTUKAI;9216544103;Taip;17;0;0;17
5189;Nykštukas;TREPSIUKAI;2270989478;Taip;17;0;0;17
5190;Nykštukas;TREPSIUKAI;3853935568;Taip;0;6;0;6
5191;Nykštukas;TREPSIUKAI;6655819980;Taip;2;0;4;6
5192;Nykštukas;TREPSIUKAI;9319066179;Taip;12;1;0;13
5193;Nykštukas;TREPSIUKAI;6750714866;Taip;6;0;0;6
5194;Nykštukas;TREPSIUKAI;2177539882;Taip;1;0;0;1
5195;Nykštukas;TREPSIUKAI;2232317366;Taip;2;0;0;2
5196;Nykštukas;TREPSIUKAI;7332769878;Ne;0;0;2;2
5197;Nykštukas;TREPSIUKAI;7896338372;Taip;11;0;1;12
5198;Nykštukas;TREPSIUKAI;8681884252;Taip;7;0;0;7
5199;Ozas;Smalsučiai;2641398988;Taip;0;4;0;4
5200;Ozas;Smalsučiai;9227939420;Taip;0;0;1;1
5201;Ozas;Smalsučiai;7917100888;Taip;0;11;1;12
5202;Ozas;Smalsučiai;87218067796;Taip;15;0;1;16
5203;Ozas;Smalsučiai;4397034031;Taip;0;10;2;12
5204;Ozas;Smalsučiai;1974320330;Taip;0;1;1;2
5205;Ozas;Smalsučiai;1173284700;Ne;0;1;0;1
5206;Ozas;Smalsučiai;67987032400;Taip;0;0;3;3
5207;Ozas;Smalsučiai;71695973592;Taip;0;0;3;3
5208;Ozas;Smalsučiai;57069047630;Taip;0;0;3;3
5209;Ozas;Smalsučiai;5150746885;Taip;0;3;0;3
5210;Ozas;Smalsučiai;1893257809;Taip;0;0;1;1
5211;Ozas;Smalsučiai;6540803077;Taip;7;0;1;8
5212;Ozas;Smalsučiai;8072802467;Taip;0;0;5;5
5213;Ozas;Smalsučiai;1248092034;Ne;0;0;1;1
5214;Ozas;Smalsučiai;43381497677;Ne;0;0;7;7
5215;Ozas;Smalsučiai;7351651916;Ne;10;0;0;10
5216;Ozas;Smalsučiai;9521048381;Taip;16;0;0;16
5217;Ozas;Smalsučiai;2053832360;Taip;8;0;0;8
5218;Ozas;Smalsučiai;9905575489;Taip;0;3;3;6
5219;Ozas;Drugeliai;1655808777;Taip;0;10;0;10
5220;Ozas;Drugeliai;8176840834;Taip;5;2;0;7
5221;Ozas;Drugeliai;6668470892;Taip;0;10;1;11
5222;Ozas;Drugeliai;2302999759;Taip;0;1;0;1
5223;Ozas;Drugeliai;8088330187;Taip;0;7;0;7
5224;Ozas;Drugeliai;9073973849;Taip;0;0;7;7
5225;Ozas;Drugeliai;9322806566;Taip;0;8;0;8
5226;Ozas;Drugeliai;2676747542;Taip;15;0;5;20
5227;Ozas;Drugeliai;8289643065;Taip;2;0;0;2
5228;Ozas;Drugeliai;4726019355;Taip;0;0;1;1
5229;Ozas;Drugeliai;9987863302;Ne;0;10;2;12
5230;Ozas;Drugeliai;2980799420;Taip;14;0;1;15
5231;Ozas;Drugeliai;8318380547;Taip;0;10;0;10
5232;Ozas;Drugeliai;4884054504;Taip;5;0;1;6
5233;Ozas;Drugeliai;2825614921;Taip;15;1;0;16
5234;Ozas;Drugeliai;43660054250;Taip;0;15;0;15
5235;Ozas;Drugeliai;7565002863;Taip;0;4;0;4
5236;Ozas;Drugeliai;1871542885;Taip;0;0;1;1
5237;Ozas;Drugeliai;15262583232;Taip;5;1;0;6
5238;Ozas;Boružėlės;1348960421;Taip;0;0;4;4
5239;Ozas;Boružėlės;1375643969;Ne;0;0;9;9
5240;Ozas;Boružėlės;63852147122;Taip;12;0;0;12
5241;Ozas;Boružėlės;8190314087;Taip;4;0;4;8
5242;Ozas;Boružėlės;3803998816;Taip;12;2;0;14
5243;Ozas;Boružėlės;1212358423;Taip;12;8;1;21
5244;Ozas;Boružėlės;7615907271;Ne;0;0;3;3
5245;Ozas;Boružėlės;1560342499;Taip;5;1;0;6
5246;Ozas;Boružėlės;8529654920;Taip;0;0;1;1
5247;Ozas;Boružėlės;2527574646;Ne;5;3;0;8
5248;Ozas;Boružėlės;9773251894;Taip;6;0;5;11
5249;Ozas;Boružėlės;36523514229;Taip;0;0;5;5
5250;Ozas;Boružėlės;1367050160;Taip;9;0;3;12
5251;Ozas;Boružėlės;68364031736;Taip;12;0;4;16
5252;Ozas;Boružėlės;2678629892;Taip;0;0;4;4
5253;Ozas;Boružėlės;1109113859;Ne;0;0;1;1
5254;Ozas;Boružėlės;1826499734;Taip;8;0;1;9
5255;Ozas;Boružėlės;6432357144;Taip;15;0;1;16
5256;Ozas;Boružėlės;1498656201;Taip;9;0;2;11
5257;Ozas;Boružėlės;1217496635;Taip;15;0;1;16
5258;Ozas;Boružėlės;1682529482;Taip;0;0;1;1
5259;Ozas;Boružėlės;9130645878;Taip;0;0;10;10
5260;Ozas;Žiogeliai;3631049449;Taip;0;0;1;1
5261;Ozas;Žiogeliai;6257625501;Taip;0;1;0;1
5262;Ozas;Žiogeliai;7402290524;Taip;0;0;5;5
5263;Ozas;Žiogeliai;1562277866;Taip;0;0;2;2
5264;Ozas;Žiogeliai;4571583671;Taip;0;4;1;5
5265;Ozas;Žiogeliai;1837947633;Taip;0;2;0;2
5266;Ozas;Žiogeliai;5682027094;Taip;15;0;6;21
5267;Ozas;Žiogeliai;3770045761;Taip;0;0;6;6
5268;Ozas;Žiogeliai;9324647606;Taip;0;0;3;3
5269;Ozas;Žiogeliai;9392526836;Taip;0;1;0;1
5270;Ozas;Žiogeliai;4942550213;Taip;17;0;1;18
5271;Ozas;Žiogeliai;8676986286;Taip;0;0;10;10
5272;Ozas;Žiogeliai;2345112767;Taip;12;2;0;14
5273;Ozas;Žiogeliai;5420952391;Taip;0;9;3;12
5274;Ozas;Žiogeliai;5156383727;Taip;0;7;0;7
5275;Ozas;Žiogeliai;9929822317;Taip;0;0;2;2
5276;Ozas;Žiogeliai;6108049183;Ne;0;5;0;5
5277;Ozas;Žiogeliai;2837228320;Taip;6;3;0;9
5278;Ozas;Žiogeliai;7264789334;Taip;0;1;0;1
5279;Ozas;Žiogeliai;2617258206;Ne;4;0;1;5
5280;Ozas;Bitutės;4220780257;Taip;0;0;1;1
5281;Ozas;Bitutės;1161776624;Taip;0;0;3;3
5282;Ozas;Bitutės;4227555342;Taip;0;4;1;5
5283;Ozas;Bitutės;7499756171;Taip;0;6;0;6
5284;Ozas;Bitutės;7494307084;Taip;0;1;1;2
5285;Ozas;Bitutės;1475005204;Taip;0;2;0;2
5286;Ozas;Bitutės;2705294874;Taip;0;0;1;1
5287;Ozas;Bitutės;2369544599;Taip;1;1;0;2
5288;Ozas;Bitutės;3329391600;Taip;0;0;1;1
5289;Ozas;Bitutės;4207160323;Taip;0;1;0;1
5290;Ozas;Bitutės;4254601638;Taip;0;0;2;2
5291;Ozas;Bitutės;4699369567;Taip;0;5;0;5
5292;Ozas;Bitutės;8304671844;Ne;0;0;2;2
5293;Ozas;Bitutės;5968428143;Taip;5;0;1;6
5294;Ozas;Bitutės;5381187291;Taip;20;0;1;21
5295;Ozas;Bitutės;1895519949;Taip;0;0;2;2
5296;Ozas;Bitutės;9772085405;Taip;6;0;4;10
5297;Ozas;Bitutės;7051699003;Taip;16;0;1;17
5298;Ozas;Bitutės;5383877034;Ne;0;0;4;4
5299;Ozas;Bitutės;1117208248;Taip;0;1;1;2
5300;Ozas;Bitutės;6811181735;Taip;1;15;1;17
5301;Ozas;Aitvarėliai;1144679735;Taip;12;0;1;13
5302;Ozas;Aitvarėliai;2773182934;Taip;5;2;2;9
5303;Ozas;Aitvarėliai;4357737538;Taip;0;7;1;8
5304;Ozas;Aitvarėliai;5642468671;Taip;3;0;0;3
5305;Ozas;Aitvarėliai;1045890394;Taip;13;0;0;13
5306;Ozas;Aitvarėliai;8987796218;Taip;0;16;0;16
5307;Ozas;Aitvarėliai;7686706482;Taip;11;1;1;13
5308;Ozas;Aitvarėliai;2395567376;Taip;0;2;2;4
5309;Ozas;Aitvarėliai;5383739203;Taip;11;1;0;12
5310;Ozas;Aitvarėliai;5769870711;Taip;16;0;0;16
5311;Ozas;Aitvarėliai;2544858937;Ne;0;0;1;1
5312;Ozas;Aitvarėliai;5102704846;Taip;0;1;1;2
5313;Ozas;Aitvarėliai;1543683077;Taip;1;0;0;1
5314;Ozas;Aitvarėliai;2165291778;Taip;5;6;2;13
5315;Ozas;Aitvarėliai;8286877320;Ne;9;0;2;11
5316;Ozas;Aitvarėliai;8754244281;Taip;11;0;2;13
5317;Ozas;Aitvarėliai;6646671212;Taip;8;0;2;10
5318;Ozas;Aitvarėliai;3238019756;Taip;14;0;0;14
5319;Ozas;Voveraitės;8178298861;Taip;0;0;1;1
5320;Ozas;Voveraitės;6263062055;Taip;0;0;3;3
5321;Ozas;Voveraitės;9195536968;Taip;0;11;2;13
5322;Ozas;Voveraitės;2991511872;Taip;0;1;0;1
5323;Ozas;Voveraitės;1997125531;Taip;0;1;1;2
5324;Ozas;Voveraitės;6053885086;Taip;5;0;1;6
5325;Ozas;Voveraitės;5016547315;Ne;6;0;2;8
5326;Ozas;Voveraitės;1564826076;Taip;8;0;2;10
5327;Ozas;Voveraitės;2511477658;Taip;0;2;0;2
5328;Ozas;Voveraitės;1240233169;Taip;11;0;1;12
5329;Ozas;Voveraitės;6088757991;Taip;2;2;0;4
5330;Ozas;Voveraitės;5822871838;Taip;0;11;1;12
5331;Ozas;Voveraitės;2635045515;Taip;0;1;1;2
5332;Ozas;Voveraitės;6499549095;Taip;4;1;1;6
5333;Ozas;Voveraitės;6666591428;Taip;5;3;0;8
5334;Ozas;Voveraitės;7978092840;Taip;0;6;0;6
5335;Ozas;Voveraitės;9762737217;Ne;5;0;1;6
5336;Ozas;Voveraitės;7421484648;Taip;0;0;16;16
5337;Ozas;Kodelčiukai;2808066733;Taip;0;14;0;14
5338;Ozas;Kodelčiukai;71351371644;Taip;0;3;0;3
5339;Ozas;Kodelčiukai;13077342836;Taip;0;2;0;2
5340;Ozas;Kodelčiukai;1110232715;Taip;0;1;0;1
5341;Ozas;Kodelčiukai;28273919775;Taip;0;1;0;1
5342;Ozas;Kodelčiukai;88618151766;Taip;0;1;0;1
5343;Ozas;Kodelčiukai;3637786952;Taip;5;1;0;6
5344;Ozas;Kodelčiukai;39003781970;Taip;0;3;0;3
5345;Ozas;Kodelčiukai;1235925750;Ne;0;1;0;1
5346;Ozas;Kodelčiukai;69756875821;Taip;0;4;0;4
5347;Ozas;Kodelčiukai;19065860134;Taip;0;4;0;4
5348;Ozas;Kodelčiukai;1230455881;Taip;0;2;0;2
5349;Ozas;Kodelčiukai;1288477637;Taip;0;2;0;2
5350;Ozas;Kodelčiukai;82373453244;Taip;0;2;0;2
5351;Ozas;Kodelčiukai;94673981368;Taip;0;3;0;3
5352;Ozas;Kodelčiukai;19284606277;Taip;6;4;0;10
5353;Ozas;Kodelčiukai;59125596894;Taip;0;4;0;4
5354;Ozas;Pelėdžiukai;1462541264;Ne;0;2;0;2
5355;Ozas;Pelėdžiukai;3439351594;Taip;11;0;6;17
5356;Ozas;Pelėdžiukai;41795363180;Taip;4;0;4;8
5357;Ozas;Pelėdžiukai;60743195418;Ne;0;7;0;7
5358;Ozas;Pelėdžiukai;64778552590;Taip;0;0;1;1
5359;Ozas;Pelėdžiukai;1755283948;Taip;0;5;0;5
5360;Ozas;Pelėdžiukai;13375413701;Taip;0;2;0;2
5361;Ozas;Pelėdžiukai;16523707810;Taip;10;0;1;11
5362;Ozas;Pelėdžiukai;47291376629;Taip;0;1;0;1
5363;Ozas;Pelėdžiukai;2140385280;Taip;0;1;1;2
5364;Ozas;Pelėdžiukai;1450257399;Taip;0;1;1;2
5365;Ozas;Pelėdžiukai;4765249675;Taip;5;0;2;7
5366;Ozas;Pelėdžiukai;1814400303;Taip;6;0;1;7
5367;Ozas;Pelėdžiukai;1889249743;Taip;0;1;0;1
5368;Ozas;Pelėdžiukai;1099026003;Taip;7;0;1;8
5369;Ozas;Pelėdžiukai;15885510365;Taip;0;6;0;6
5370;Ozas;Pelėdžiukai;2058548464;Taip;6;0;0;6
5371;Ozas;Pelėdžiukai;1910114048;Taip;0;0;1;1
5372;Ozas;Pelėdžiukai;1862121693;Ne;7;2;0;9
5373;Ozas;"Kačiukai ";95179927759;Taip;0;2;3;5
5374;Ozas;"Kačiukai ";6618249243;Taip;0;0;3;3
5375;Ozas;"Kačiukai ";1151213934;Taip;0;0;1;1
5376;Ozas;"Kačiukai ";2114612776;Taip;6;3;4;13
5377;Ozas;"Kačiukai ";60155732637;Taip;0;2;0;2
5378;Ozas;"Kačiukai ";37159754070;Taip;0;0;3;3
5379;Ozas;"Kačiukai ";61398533877;Taip;0;0;1;1
5380;Ozas;"Kačiukai ";1580501935;Ne;3;2;0;5
5381;Ozas;"Kačiukai ";1316758924;Ne;14;0;1;15
5382;Ozas;"Kačiukai ";34196440412;Taip;0;0;1;1
5383;Ozas;"Kačiukai ";84277015523;Taip;0;0;2;2
5384;Ozas;"Kačiukai ";1822377180;Taip;8;0;0;8
5385;Ozas;"Kačiukai ";1551028882;Taip;9;0;0;9
5386;Ozas;"Kačiukai ";14760258125;Taip;10;0;1;11
5387;Ozas;"Kačiukai ";1681367373;Taip;0;0;8;8
5388;Ozas;"Kačiukai ";8248732706;Taip;0;0;2;2
5389;Ozas;"Kačiukai ";84845624912;Ne;14;1;0;15
5390;Ozas;Ančiukų;2824133388;Taip;11;10;0;21
5391;Ozas;Ančiukų;2637531106;Taip;0;1;1;2
5392;Ozas;Ančiukų;4886045470;Ne;0;0;1;1
5393;Ozas;Ančiukų;2039920706;Taip;9;1;1;11
5394;Ozas;Ančiukų;4601869799;Taip;15;0;0;15
5395;Ozas;Ančiukų;5950860889;Taip;0;0;1;1
5396;Ozas;Ančiukų;3212050416;Taip;0;0;2;2
5397;Ozas;Ančiukų;9277208213;Taip;4;0;1;5
5398;Ozas;Ančiukų;7287989663;Taip;0;0;1;1
5399;Ozas;Ančiukų;7125754645;Taip;0;0;1;1
5400;Ozas;Ančiukų;2281337233;Taip;0;0;7;7
5401;Ozas;Ančiukų;1856258542;Ne;6;0;0;6
5402;Ozas;Ančiukų;5922569280;Ne;4;0;1;5
5403;Ozas;Ančiukų;7640409923;Ne;10;0;4;14
5404;Ozas;Ančiukų;3725141591;Taip;7;0;0;7
5405;Ozas;Nykškukų;5216695220;Taip;10;2;0;12
5406;Ozas;Nykškukų;6783755555;Taip;10;1;0;11
5407;Ozas;Nykškukų;8779047802;Taip;12;0;0;12
5408;Ozas;Nykškukų;8008237092;Taip;8;0;6;14
5409;Ozas;Nykškukų;7305274617;Taip;4;0;0;4
5410;Ozas;Nykškukų;4516291572;Taip;8;0;0;8
5411;Ozas;Nykškukų;1348751454;Taip;17;0;0;17
5412;Ozas;Nykškukų;9084187344;Taip;5;0;0;5
5413;Ozas;Nykškukų;9620747099;Taip;5;0;0;5
5414;Ozas;Nykškukų;4287719751;Ne;0;0;1;1
5415;Pabiručiai;Voveriukų;2349337471;Taip;0;2;0;2
5416;Pabiručiai;Voveriukų;4069564285;Taip;0;10;0;10
5417;Pabiručiai;Voveriukų;7278334800;Ne;3;2;0;5
5418;Pabiručiai;Voveriukų;9468698553;Taip;1;0;0;1
5419;Pabiručiai;Voveriukų;5232678556;Taip;0;2;1;3
5420;Pabiručiai;Voveriukų;4040533883;Taip;0;5;0;5
5421;Pabiručiai;Voveriukų;2514312233;Taip;4;2;0;6
5422;Pabiručiai;Voveriukų;7606274875;Taip;4;2;0;6
5423;Pabiručiai;Voveriukų;7846758352;Taip;0;2;0;2
5424;Pabiručiai;Voveriukų;1498738549;Taip;0;4;0;4
5425;Pabiručiai;Voveriukų;4312364951;Taip;16;0;1;17
5426;Pabiručiai;Voveriukų;4813206044;Taip;5;5;0;10
5427;Pabiručiai;Voveriukų;3936426174;Taip;0;0;2;2
5428;Pabiručiai;Voveriukų;7985360502;Taip;7;0;0;7
5429;Pabiručiai;Voveriukų;7403996266;Taip;1;1;0;2
5430;Pabiručiai;Voveriukų;6251432968;Taip;0;0;3;3
5431;Pabiručiai;Voveriukų;5549851164;Ne;3;0;1;4
5432;Pabiručiai;Voveriukų;8206979332;Taip;0;0;3;3
5433;Pabiručiai;Voveriukų;9564303781;Ne;0;0;3;3
5434;Pabiručiai;Boružiukų;6401188653;Taip;0;0;7;7
5435;Pabiručiai;Boružiukų;1673473814;Taip;0;10;0;10
5436;Pabiručiai;Boružiukų;5686769648;Ne;0;7;0;7
5437;Pabiručiai;Boružiukų;7524993271;Ne;0;3;0;3
5438;Pabiručiai;Boružiukų;5708597471;Taip;0;1;0;1
5439;Pabiručiai;Boružiukų;7046122545;Taip;0;0;5;5
5440;Pabiručiai;Boružiukų;3096466200;Taip;0;7;0;7
5441;Pabiručiai;Boružiukų;4301904533;Taip;0;2;1;3
5442;Pabiručiai;Boružiukų;8106446562;Taip;0;5;0;5
5443;Pabiručiai;Boružiukų;8236964683;Taip;0;14;0;14
5444;Pabiručiai;Boružiukų;1240057541;Taip;0;1;0;1
5445;Pabiručiai;Boružiukų;1671027282;Taip;0;0;2;2
5446;Pabiručiai;Boružiukų;3759350345;Taip;2;3;0;5
5447;Pabiručiai;Boružiukų;3151360288;Taip;0;3;0;3
5448;Pabiručiai;Boružiukų;9299393363;Ne;0;3;0;3
5449;Pabiručiai;Boružiukų;1484291546;Ne;0;0;2;2
5450;Pabiručiai;Boružiukų;2771769336;Taip;0;4;0;4
5451;Pabiručiai;Boružiukų;2607840684;Taip;2;0;0;2
5452;Pabiručiai;Boružiukų;4681771534;Taip;12;0;0;12
5453;Pabiručiai;Boružiukų;7050339198;Taip;8;2;0;10
5454;Pabiručiai;Boružiukų;4798503931;Ne;4;0;1;5
5455;Pabiručiai;Katinėlių;1670938208;Taip;8;0;0;8
5456;Pabiručiai;Katinėlių;3756365293;Taip;4;0;0;4
5457;Pabiručiai;Katinėlių;1749155319;Ne;4;1;2;7
5458;Pabiručiai;Katinėlių;34883375155;Taip;3;2;0;5
5459;Pabiručiai;Katinėlių;1705085006;Taip;0;10;0;10
5460;Pabiručiai;Katinėlių;58112415466;Taip;15;0;1;16
5461;Pabiručiai;Katinėlių;42877891797;Taip;0;1;0;1
5462;Pabiručiai;Katinėlių;8710389714;Taip;9;0;0;9
5463;Pabiručiai;Katinėlių;4501176225;Taip;0;6;0;6
5464;Pabiručiai;Katinėlių;4339607826;Taip;0;13;0;13
5465;Pabiručiai;Katinėlių;8306688649;Taip;0;6;0;6
5466;Pabiručiai;Katinėlių;2572570925;Taip;6;0;1;7
5467;Pabiručiai;Katinėlių;6994301415;Taip;0;0;21;21
5468;Pabiručiai;Katinėlių;4205107384;Taip;0;0;1;1
5469;Pabiručiai;Katinėlių;5513311280;Taip;0;0;5;5
5470;Pabiručiai;Katinėlių;1122183123;Taip;1;0;1;2
5471;Pabiručiai;Žiogelių;3272576627;Taip;0;0;1;1
5472;Pabiručiai;Žiogelių;5522447437;Taip;0;0;3;3
5473;Pabiručiai;Žiogelių;7974345478;Taip;0;1;0;1
5474;Pabiručiai;Žiogelių;8367889753;Taip;0;2;0;2
5475;Pabiručiai;Žiogelių;8421025940;Taip;0;1;0;1
5476;Pabiručiai;Žiogelių;1642658060;Taip;0;0;5;5
5477;Pabiručiai;Žiogelių;3206962828;Ne;0;0;3;3
5478;Pabiručiai;Žiogelių;3355875364;Taip;0;2;0;2
5479;Pabiručiai;Žiogelių;7085036701;Taip;0;4;0;4
5480;Pabiručiai;Žiogelių;8736658575;Taip;0;0;5;5
5481;Pabiručiai;Žiogelių;1311650644;Taip;0;1;0;1
5482;Pabiručiai;Žiogelių;5480714322;Taip;6;3;0;9
5483;Pabiručiai;Žiogelių;3585198013;Taip;0;1;0;1
5484;Pabiručiai;Žiogelių;2356833740;Taip;0;0;5;5
5485;Pabiručiai;Žiogelių;5311762824;Taip;5;0;2;7
5486;Pabiručiai;Žiogelių;1587905929;Taip;6;15;0;21
5487;Pabiručiai;Žiogelių;5761888906;Taip;2;7;0;9
5488;Pabiručiai;Žiogelių;4667769378;Taip;0;7;0;7
5489;Pabiručiai;Žiogelių;8025611655;Taip;0;0;3;3
5490;Pabiručiai;Smalsiukai;7677235214;Taip;0;0;5;5
5491;Pabiručiai;Smalsiukai;9676561758;Taip;0;2;0;2
5492;Pabiručiai;Smalsiukai;7632969321;Ne;16;0;1;17
5493;Pabiručiai;Smalsiukai;7090116276;Taip;0;0;5;5
5494;Pabiručiai;Smalsiukai;3700401383;Taip;10;11;0;21
5495;Pabiručiai;Smalsiukai;4408666547;Taip;11;0;1;12
5496;Pabiručiai;Smalsiukai;6935913132;Ne;10;4;0;14
5497;Pabiručiai;Smalsiukai;1344711015;Ne;0;9;0;9
5498;Pabiručiai;Smalsiukai;7663581089;Taip;5;0;5;10
5499;Pabiručiai;Smalsiukai;7248314871;Taip;0;0;2;2
5500;Pabiručiai;Smalsiukai;9610623364;Taip;0;4;0;4
5501;Pabiručiai;Smalsiukai;2332338995;Taip;11;0;0;11
5502;Pabiručiai;Smalsiukai;4258226042;Taip;4;7;0;11
5503;Pabiručiai;Smalsiukai;3511851810;Taip;6;0;3;9
5504;Pabiručiai;Smalsiukai;6686039601;Taip;12;0;0;12
5505;Pabiručiai;Smalsiukai;8840885039;Taip;8;0;0;8
5506;Pabiručiai;Smalsiukai;9779260044;Taip;9;1;0;10
5507;Pabiručiai;Smalsiukai;2771891999;Taip;3;0;0;3
5508;Pabiručiai;Kiškučiai;4080298620;Taip;5;12;0;17
5509;Pabiručiai;Kiškučiai;3368607302;Taip;0;1;0;1
5510;Pabiručiai;Kiškučiai;9589005897;Taip;5;16;0;21
5511;Pabiručiai;Kiškučiai;6648966721;Taip;0;1;0;1
5512;Pabiručiai;Kiškučiai;9353062804;Taip;11;0;0;11
5513;Pabiručiai;Kiškučiai;1582754284;Taip;6;2;0;8
5514;Pabiručiai;Kiškučiai;4462744848;Taip;0;15;0;15
5515;Pabiručiai;Kiškučiai;7572077461;Taip;0;3;0;3
5516;Pabiručiai;Kiškučiai;9417138573;Taip;1;1;0;2
5517;Pabiručiai;Kiškučiai;2688728915;Taip;0;6;0;6
5518;Pabiručiai;Kiškučiai;5166525832;Taip;21;0;0;21
5519;Pabiručiai;Kiškučiai;8409455566;Taip;0;12;0;12
5520;Pabiručiai;Kiškučiai;1028312285;Taip;5;0;0;5
5521;Pabiručiai;Kiškučiai;5346249456;Taip;2;0;0;2
5522;Pabiručiai;Kiškučiai;5717534175;Taip;1;0;0;1
5523;Pabiručiai;Kiškučiai;3408518493;Taip;1;7;0;8
5524;Pabiručiai;Kiškučiai;7653129291;Taip;11;0;0;11
5525;Pabiručiai;Kiškučiai;7073230645;Taip;5;3;0;8
5526;Pabiručiai;Kiškučiai;7572077461;Taip;0;3;0;3
5527;Pabiručiai;"Pėledžiukai ";7457099536;Taip;0;4;0;4
5528;Pabiručiai;"Pėledžiukai ";77273870334;Taip;0;1;0;1
5529;Pabiručiai;"Pėledžiukai ";80756439543;Taip;0;0;5;5
5530;Pabiručiai;"Pėledžiukai ";75098378597;Taip;0;6;1;7
5531;Pabiručiai;"Pėledžiukai ";90849312010;Taip;3;3;0;6
5532;Pabiručiai;"Pėledžiukai ";6112244077;Taip;3;1;0;4
5533;Pabiručiai;"Pėledžiukai ";18356992277;Taip;11;3;0;14
5534;Pabiručiai;"Pėledžiukai ";28121667845;Taip;0;3;0;3
5535;Pabiručiai;"Pėledžiukai ";1474411801;Taip;5;0;0;5
5536;Pabiručiai;"Pėledžiukai ";1591342751;Taip;0;13;0;13
5537;Pabiručiai;"Pėledžiukai ";1701727758;Taip;0;2;0;2
5538;Pabiručiai;"Pėledžiukai ";1078387167;Taip;0;2;1;3
5539;Pabiručiai;"Pėledžiukai ";3733576400;Taip;0;5;0;5
5540;Pabiručiai;"Pėledžiukai ";34215100257;Taip;0;2;0;2
5541;Pabiručiai;"Pėledžiukai ";2944433375;Ne;0;4;0;4
5542;Pabiručiai;"Kodelčiūkai ";1819457592;Ne;0;1;0;1
5543;Pabiručiai;"Kodelčiūkai ";62923769489;Taip;0;12;0;12
5544;Pabiručiai;"Kodelčiūkai ";65267728282;Taip;0;8;0;8
5545;Pabiručiai;"Kodelčiūkai ";81307674221;Taip;3;0;0;3
5546;Pabiručiai;"Kodelčiūkai ";15948930587;Taip;15;0;1;16
5547;Pabiručiai;"Kodelčiūkai ";78798062773;Taip;5;12;0;17
5548;Pabiručiai;"Kodelčiūkai ";1901455947;Taip;0;0;3;3
5549;Pabiručiai;"Kodelčiūkai ";1718014001;Taip;0;4;0;4
5550;Pabiručiai;"Kodelčiūkai ";2143676810;Taip;2;2;0;4
5551;Pabiručiai;"Kodelčiūkai ";46251218463;Taip;0;2;0;2
5552;Pabiručiai;"Kodelčiūkai ";1236499374;Taip;7;2;0;9
5553;Pabiručiai;"Kodelčiūkai ";8344476830;Taip;0;8;0;8
5554;Pabiručiai;"Kodelčiūkai ";8359296058;Taip;0;0;5;5
5555;Pabiručiai;"Kodelčiūkai ";4634305371;Taip;5;0;3;8
5556;Pabiručiai;"Kodelčiūkai ";4901977623;Taip;4;0;0;4
5557;Pabiručiai;"Peliukų ";8775727677;Taip;0;1;0;1
5558;Pabiručiai;"Peliukų ";4317656984;Taip;5;0;0;5
5559;Pabiručiai;"Peliukų ";5209535192;Taip;15;1;0;16
5560;Pabiručiai;"Peliukų ";2147165934;Taip;15;0;2;17
5561;Pabiručiai;"Peliukų ";1971996148;Taip;11;0;0;11
5562;Pabiručiai;"Peliukų ";2633676360;Taip;0;0;5;5
5563;Pabiručiai;"Viščiukų ";5913022147;Taip;9;0;0;9
5564;Pabiručiai;"Viščiukų ";4595458527;Taip;1;0;0;1
5565;Pabiručiai;"Viščiukų ";1234230729;Taip;4;0;0;4
5566;Pabiručiai;"Viščiukų ";8716879106;Taip;4;0;0;4
5567;Pabiručiai;"Viščiukų ";8149732126;Taip;0;0;2;2
5568;Pabiručiai;"Viščiukų ";9538339883;Taip;0;1;0;1
5569;Pabiručiai;"Viščiukų ";3748657353;Taip;10;0;2;12
5570;Pabiručiai;"Viščiukų ";2295503584;Taip;15;0;0;15
5571;Pabiručiai;"Viščiukų ";6209553290;Taip;12;0;0;12
5572;Pabiručiai;"Viščiukų ";9067653417;Taip;5;0;0;5
5573;Pabiručiai;"Viščiukų ";5247780866;Taip;5;0;1;6
5574;Pabiručiai;"Viščiukų ";3433419710;Ne;12;0;2;14
5575;Pabiručiai;"Viščiukų ";7289131864;Taip;0;1;0;1
5576;Pabiručiai;"Viščiukų ";9437700329;Taip;8;0;1;9
5577;Pabiručiai;"Viščiukų ";5010271037;Taip;5;1;0;6
5578;Pabiručiai;"Drugelių ";8179285338;Taip;0;8;0;8
5579;Pabiručiai;"Drugelių ";6697518151;Taip;7;1;0;8
5580;Pabiručiai;"Drugelių ";3497466298;Taip;0;10;0;10
5581;Pabiručiai;"Drugelių ";3224195892;Taip;8;0;0;8
5582;Pabiručiai;"Drugelių ";1049154287;Taip;9;0;0;9
5583;Pabiručiai;"Drugelių ";9878655387;Taip;5;0;0;5
5584;Pabiručiai;"Drugelių ";2596301235;Taip;0;0;2;2
5585;Pabiručiai;"Drugelių ";8668524776;Ne;0;1;0;1
5586;Pabiručiai;"Drugelių ";5704073222;Taip;0;2;0;2
5587;Pagrandukas;Saulytės;6915087488;Taip;5;3;0;8
5588;Pagrandukas;Saulytės;7605508460;Taip;10;0;0;10
5589;Pagrandukas;Saulytės;2488262035;Taip;4;0;4;8
5590;Pagrandukas;Saulytės;6349387692;Taip;4;0;5;9
5591;Pagrandukas;Saulytės;8186092469;Taip;4;0;0;4
5592;Pagrandukas;Saulytės;2934300533;Taip;6;3;0;9
5593;Pagrandukas;Saulytės;1548697124;Taip;5;1;0;6
5594;Pagrandukas;Saulytės;7146697128;Taip;0;1;0;1
5595;Pagrandukas;Saulytės;5560372136;Taip;8;0;0;8
5596;Pagrandukas;Saulytės;3709131197;Taip;5;2;0;7
5597;Pagrandukas;Saulytės;9849054467;Taip;8;0;0;8
5598;Pagrandukas;Zuikučiai;7435609306;Taip;3;0;0;3
5599;Pagrandukas;Zuikučiai;5903416384;Taip;0;1;0;1
5600;Pagrandukas;Zuikučiai;2439891231;Taip;0;1;2;3
5601;Pagrandukas;Zuikučiai;6710887776;Taip;0;1;2;3
5602;Pagrandukas;Zuikučiai;7665811353;Taip;6;0;0;6
5603;Pagrandukas;Zuikučiai;2212787835;Taip;0;2;0;2
5604;Pagrandukas;Zuikučiai;2711590019;Taip;0;0;5;5
5605;Pagrandukas;Zuikučiai;6449029299;Taip;5;5;0;10
5606;Pagrandukas;Zuikučiai;1405820070;Taip;9;0;2;11
5607;Pagrandukas;Zuikučiai;1054107640;Ne;0;5;1;6
5608;Pagrandukas;Zuikučiai;1885539883;Ne;0;3;0;3
5609;Pagrandukas;Zuikučiai;2822538227;Taip;5;0;0;5
5610;Pagrandukas;Zuikučiai;2101505576;Taip;11;0;0;11
5611;Pagrandukas;Zuikučiai;6765346578;Taip;6;0;0;6
5612;Pagrandukas;Zuikučiai;5922595170;Taip;2;0;0;2
5613;Pagrandukas;Zuikučiai;5030928303;Taip;0;0;1;1
5614;Pagrandukas;Zuikučiai;9139212151;Taip;0;0;1;1
5615;Pagrandukas;Zuikučiai;8643993939;Taip;0;0;7;7
5616;Pagrandukas;Boružėlių;3888408459;Taip;0;1;0;1
5617;Pagrandukas;Boružėlių;3398225200;Taip;0;6;0;6
5618;Pagrandukas;Boružėlių;5752454925;Ne;0;1;9;10
5619;Pagrandukas;Boružėlių;3587941684;Taip;12;0;0;12
5620;Pagrandukas;Boružėlių;3953844737;Taip;0;3;0;3
5621;Pagrandukas;Boružėlių;5640182548;Taip;0;1;0;1
5622;Pagrandukas;Boružėlių;1403569615;Taip;6;1;3;10
5623;Pagrandukas;Boružėlių;1998073387;Taip;0;1;0;1
5624;Pagrandukas;Boružėlių;5511396314;Taip;9;7;0;16
5625;Pagrandukas;Boružėlių;5648658237;Taip;12;1;0;13
5626;Pagrandukas;Boružėlių;9651789217;Taip;0;9;0;9
5627;Pagrandukas;Boružėlių;6911951786;Taip;0;10;1;11
5628;Pagrandukas;Boružėlių;2926077771;Taip;0;8;0;8
5629;Pagrandukas;Boružėlių;5741021524;Taip;5;0;1;6
5630;Pagrandukas;Boružėlių;2361829423;Taip;8;6;0;14
5631;Pagrandukas;Boružėlių;2549704540;Taip;0;2;0;2
5632;Pagrandukas;Bitutės;1707429884;Taip;0;2;1;3
5633;Pagrandukas;Bitutės;9313380552;Ne;4;1;0;5
5634;Pagrandukas;Bitutės;6044667668;Taip;0;7;3;10
5635;Pagrandukas;Bitutės;1813676320;Taip;0;1;0;1
5636;Pagrandukas;Bitutės;57471531440;Taip;8;5;0;13
5637;Pagrandukas;Bitutės;8529974367;Taip;7;2;0;9
5638;Pagrandukas;Bitutės;4079711515;Ne;10;0;0;10
5639;Pagrandukas;Bitutės;8625382465;Ne;12;0;0;12
5640;Pagrandukas;Bitutės;9188382746;Taip;0;0;2;2
5641;Pagrandukas;Bitutės;5613442667;Taip;0;0;1;1
5642;Pagrandukas;Bitutės;1451503127;Taip;14;0;0;14
5643;Pagrandukas;Bitutės;2923517578;Taip;0;2;0;2
5644;Pagrandukas;Bitutės;3875062228;Ne;0;8;0;8
5645;Pagrandukas;Bitutės;4405567649;Taip;7;5;0;12
5646;Pagrandukas;Bitutės;1583104760;Ne;0;1;0;1
5647;Pagrandukas;Bitutės;5649084353;Taip;3;0;0;3
5648;Pagrandukas;Pelėdžiukai;1590309916;Taip;0;2;0;2
5649;Pagrandukas;Pelėdžiukai;1964310988;Taip;0;2;0;2
5650;Pagrandukas;Pelėdžiukai;44044284874;Taip;0;5;0;5
5651;Pagrandukas;Pelėdžiukai;33750135077;Taip;0;1;0;1
5652;Pagrandukas;Pelėdžiukai;2066377478;Taip;5;0;0;5
5653;Pagrandukas;Pelėdžiukai;4391887554;Taip;1;0;1;2
5654;Pagrandukas;Pelėdžiukai;33909593470;Taip;0;1;0;1
5655;Pagrandukas;Pelėdžiukai;2068155037;Taip;0;0;2;2
5656;Pagrandukas;Pelėdžiukai;5818020587;Taip;7;0;0;7
5657;Pagrandukas;Pelėdžiukai;93036151205;Taip;0;2;0;2
5658;Pagrandukas;Pelėdžiukai;1232460221;Taip;14;0;0;14
5659;Pagrandukas;Pelėdžiukai;7611916563;Taip;0;1;0;1
5660;Pagrandukas;Pelėdžiukai;61332904191;Taip;0;1;0;1
5661;Pagrandukas;Pelėdžiukai;2461803626;Taip;0;1;0;1
5662;Pagrandukas;Pelėdžiukai;51692261484;Ne;0;3;0;3
5663;Pagrandukas;Pelėdžiukai;4224512979;Taip;3;1;0;4
5664;Pagrandukas;Žvaigždutė;75080308291;Taip;0;8;0;8
5665;Pagrandukas;Žvaigždutė;7876029445;Taip;0;3;0;3
5666;Pagrandukas;Žvaigždutė;14043704729;Taip;5;1;0;6
5667;Pagrandukas;Žvaigždutė;35830862363;Ne;0;2;0;2
5668;Pagrandukas;Žvaigždutė;4724383814;Taip;0;3;0;3
5669;Pagrandukas;Žvaigždutė;7782678159;Taip;5;1;1;7
5670;Pagrandukas;Žvaigždutė;8879549409;Taip;0;12;0;12
5671;Pagrandukas;Žvaigždutė;6299298199;Taip;0;2;0;2
5672;Pagrandukas;Žvaigždutė;3860781857;Taip;0;11;0;11
5673;Pagrandukas;Žvaigždutė;1376514473;Taip;0;3;0;3
5674;Pagrandukas;Žvaigždutė;1781442182;Taip;3;1;1;5
5675;Pagrandukas;Žvaigždutė;1505918280;Taip;0;1;5;6
5676;Pakalnutė;Pagrandukai;7475119623;Taip;0;13;0;13
5677;Pakalnutė;Pagrandukai;9677810607;Taip;0;0;2;2
5678;Pakalnutė;Pagrandukai;5275833872;Taip;18;0;0;18
5679;Pakalnutė;Pagrandukai;7243104877;Taip;7;0;2;9
5680;Pakalnutė;Pagrandukai;5943686565;Taip;7;0;1;8
5681;Pakalnutė;Pagrandukai;2296079246;Taip;17;0;0;17
5682;Pakalnutė;Pagrandukai;9313588621;Taip;8;0;0;8
5683;Pakalnutė;Pagrandukai;7962849592;Taip;5;10;0;15
5684;Pakalnutė;Pagrandukai;5180015882;Taip;8;0;0;8
5685;Pakalnutė;Pagrandukai;3794283102;Taip;11;0;0;11
5686;Pakalnutė;Pagrandukai;3070652992;Ne;13;0;0;13
5687;Pakalnutė;Pagrandukai;7477188659;Taip;11;0;1;12
5688;Pakalnutė;Pagrandukai;8522585063;Taip;8;0;1;9
5689;Pakalnutė;Pagrandukai;2642359967;Taip;3;0;0;3
5690;Pakalnutė;Pagrandukai;1614993691;Taip;0;5;0;5
5691;Pakalnutė;"Pelėdžiukų ";7110858765;Taip;13;0;0;13
5692;Pakalnutė;"Pelėdžiukų ";3840499737;Taip;0;0;1;1
5693;Pakalnutė;"Pelėdžiukų ";4523766424;Taip;10;0;0;10
5694;Pakalnutė;"Pelėdžiukų ";6577255841;Ne;0;0;1;1
5695;Pakalnutė;"Pelėdžiukų ";7151877991;Taip;10;0;4;14
5696;Pakalnutė;"Pelėdžiukų ";2992768162;Taip;10;4;0;14
5697;Pakalnutė;"Pelėdžiukų ";3792697409;Taip;11;0;10;21
5698;Pakalnutė;"Pelėdžiukų ";8823232039;Taip;12;0;0;12
5699;Pakalnutė;"Pelėdžiukų ";8900756351;Taip;11;0;0;11
5700;Pakalnutė;"Pelėdžiukų ";4220368864;Ne;5;0;0;5
5701;Pakalnutė;"Pelėdžiukų ";1330092247;Taip;10;7;0;17
5702;Pakalnutė;"Pelėdžiukų ";3267680599;Ne;5;2;0;7
5703;Pakalnutė;"Pelėdžiukų ";4452372238;Taip;0;0;1;1
5704;Pakalnutė;Ežiukai;5058727058;Ne;6;0;0;6
5705;Pakalnutė;Ežiukai;4052166895;Taip;0;0;2;2
5706;Pakalnutė;Ežiukai;1070172991;Taip;5;0;3;8
5707;Pakalnutė;Ežiukai;9323200833;Taip;9;1;0;10
5708;Pakalnutė;Ežiukai;4153294595;Taip;0;0;1;1
5709;Pakalnutė;Ežiukai;9781993614;Taip;15;0;0;15
5710;Pakalnutė;Ežiukai;9256219647;Taip;3;0;0;3
5711;Pakalnutė;Ežiukai;7853479591;Ne;0;0;2;2
5712;Pakalnutė;Ežiukai;4317305712;Taip;3;0;1;4
5713;Pakalnutė;Ežiukai;6194464236;Taip;0;0;4;4
5714;Pakalnutė;Ežiukai;6029905101;Taip;2;0;0;2
5715;Pakalnutė;Ežiukai;7734657452;Taip;10;0;1;11
5716;Pakalnutė;Ežiukai;8081932074;Taip;11;0;0;11
5717;Pakalnutė;Ežiukai;9706455707;Taip;2;0;1;3
5718;Pakalnutė;Ežiukai;6352480127;Taip;10;0;2;12
5719;Pakalnutė;Ežiukai;1032629478;Ne;11;0;0;11
5720;Pakalnutė;Ežiukai;7881545979;Ne;0;0;5;5
5721;Pakalnutė;Ežiukai;8080989574;Taip;15;0;0;15
5722;Pakalnutė;Ežiukai;5911381706;Taip;7;0;0;7
5723;Pakalnutė;Skruzdėliukų;3583094831;Taip;0;1;0;1
5724;Pakalnutė;Skruzdėliukų;4033813807;Taip;11;0;0;11
5725;Pakalnutė;Skruzdėliukų;9382160515;Taip;0;5;0;5
5726;Pakalnutė;Skruzdėliukų;7503936754;Taip;10;0;0;10
5727;Pakalnutė;Skruzdėliukų;5409476517;Taip;21;0;0;21
5728;Pakalnutė;Skruzdėliukų;7105369111;Taip;4;0;0;4
5729;Pakalnutė;Skruzdėliukų;6944726166;Ne;8;0;0;8
5730;Pakalnutė;Skruzdėliukų;1195872320;Taip;7;0;0;7
5731;Pakalnutė;Skruzdėliukų;3211633472;Taip;5;0;0;5
5732;Pakalnutė;Skruzdėliukų;4423348418;Taip;9;2;0;11
5733;Pakalnutė;Skruzdėliukų;6055727963;Taip;7;0;0;7
5734;Pakalnutė;Skruzdėliukų;5619262190;Taip;4;0;0;4
5735;Pakalnutė;Skruzdėliukų;3215438452;Taip;5;0;0;5
5736;Pakalnutė;Skruzdėliukų;9681515221;Taip;3;0;0;3
5737;Pakalnutė;Skruzdėliukų;8496839980;Ne;7;0;0;7
5738;Pakalnutė;Bitučių;2993145079;Taip;0;0;3;3
5739;Pakalnutė;Bitučių;8461220770;Taip;0;0;1;1
5740;Pakalnutė;Bitučių;2765220889;Ne;0;0;5;5
5741;Pakalnutė;Bitučių;9445909071;Ne;3;0;2;5
5742;Pakalnutė;Bitučių;5532458706;Taip;0;11;0;11
5743;Pakalnutė;Bitučių;7526989580;Taip;0;3;0;3
5744;Pakalnutė;Bitučių;5941955322;Taip;4;2;0;6
5745;Pakalnutė;Bitučių;3306334576;Taip;5;0;0;5
5746;Pakalnutė;Bitučių;2095540372;Ne;0;2;0;2
5747;Pakalnutė;Bitučių;5342592825;Taip;0;2;0;2
5748;Pakalnutė;Bitučių;2932205226;Taip;0;0;1;1
5749;Pakalnutė;Bitučių;6117542654;Ne;20;0;0;20
5750;Pakalnutė;Bitučių;5464143742;Taip;15;0;1;16
5751;Pakalnutė;Bitučių;6351193702;Ne;0;0;1;1
5752;Pakalnutė;Bitučių;3965390135;Taip;0;0;1;1
5753;Pakalnutė;Bitučių;5355198213;Taip;5;0;0;5
5754;Pakalnutė;Boružiukų;5120176374;Taip;0;2;0;2
5755;Pakalnutė;Boružiukų;6798939288;Taip;0;0;1;1
5756;Pakalnutė;Boružiukų;7357431226;Taip;0;3;2;5
5757;Pakalnutė;Boružiukų;4934095931;Taip;2;0;1;3
5758;Pakalnutė;Boružiukų;5039000154;Taip;0;2;0;2
5759;Pakalnutė;Boružiukų;6575909478;Taip;5;0;1;6
5760;Pakalnutė;Boružiukų;2835611316;Taip;0;12;0;12
5761;Pakalnutė;Boružiukų;5134342817;Taip;4;0;0;4
5762;Pakalnutė;Boružiukų;7439220341;Taip;9;0;0;9
5763;Pakalnutė;Boružiukų;4950195858;Taip;4;0;0;4
5764;Pakalnutė;Boružiukų;4927086034;Taip;5;0;0;5
5765;Pakalnutė;Boružiukų;6557165567;Ne;12;0;1;13
5766;Pakalnutė;Boružiukų;3677709759;Taip;0;0;1;1
5767;Pakalnutė;Boružiukų;2597900983;Taip;10;0;1;11
5768;Pakalnutė;Boružiukų;2062721289;Taip;10;6;0;16
5769;Pakalnutė;Boružiukų;1340022702;Ne;16;0;1;17
5770;Pakalnutė;Boružiukų;6228196996;Taip;12;0;0;12
5771;Pakalnutė;Meškiukų;7180617984;Ne;0;0;1;1
5772;Pakalnutė;Meškiukų;7324846434;Taip;0;8;0;8
5773;Pakalnutė;Meškiukų;1396367371;Ne;5;0;3;8
5774;Pakalnutė;Meškiukų;2666441234;Taip;13;0;0;13
5775;Pakalnutė;Meškiukų;4256222944;Taip;5;14;0;19
5776;Pakalnutė;Meškiukų;7659209862;Taip;16;0;1;17
5777;Pakalnutė;Meškiukų;2101821362;Taip;0;14;0;14
5778;Pakalnutė;Meškiukų;1532248269;Taip;2;0;1;3
5779;Pakalnutė;Meškiukų;3675401775;Taip;3;0;2;5
5780;Pakalnutė;Meškiukų;2755412687;Taip;17;0;1;18
5781;Pakalnutė;Meškiukų;4533467194;Ne;0;3;0;3
5782;Pakalnutė;Meškiukų;4069910346;Ne;0;0;2;2
5783;Pakalnutė;Meškiukų;4313652059;Ne;0;5;0;5
5784;Pakalnutė;Meškiukų;7084798190;Ne;0;5;0;5
5785;Pakalnutė;Meškiukų;6133481935;Taip;4;0;1;5
5786;Pakalnutė;Meškiukų;8866490265;Taip;5;0;0;5
5787;Pakalnutė;Meškiukų;5441477374;Ne;6;0;0;6
5788;Pakalnutė;Nykštukai;6769352325;Taip;0;0;1;1
5789;Pakalnutė;Nykštukai;1202301707;Taip;5;0;0;5
5790;Pakalnutė;Nykštukai;11183301096;Taip;1;1;0;2
5791;Pakalnutė;Nykštukai;85900847069;Taip;0;1;0;1
5792;Pakalnutė;Nykštukai;16651154416;Taip;0;1;0;1
5793;Pakalnutė;Nykštukai;7389600659;Taip;0;1;1;2
5794;Pakalnutė;Nykštukai;5309195407;Taip;5;2;0;7
5795;Pakalnutė;Nykštukai;1849396954;Taip;2;0;1;3
5796;Pakalnutė;Nykštukai;81963663668;Taip;0;2;0;2
5797;Pakalnutė;Nykštukai;76382908561;Taip;0;0;1;1
5798;Pakalnutė;Nykštukai;99344331316;Taip;0;0;1;1
5799;Pakalnutė;Nykštukai;33667858388;Taip;4;6;0;10
5800;Pakalnutė;Nykštukai;2815093249;Ne;0;2;0;2
5801;Pakalnutė;Nykštukai;1372722843;Taip;6;2;0;8
5802;Pakalnutė;Nykštukai;61712002384;Taip;5;13;0;18
5803;Pakalnutė;Nykštukai;9647325689;Taip;0;1;0;1
5804;Pakalnutė;Nykštukai;2051737273;Taip;5;0;0;5
5805;Pakalnutė;Nykštukai;6771510589;Taip;0;7;0;7
5806;Pakalnutė;Nykštukai;58670351468;Ne;5;0;0;5
5807;Pakalnutė;Nykštukai;4046820545;Taip;0;2;0;2
5808;Pakalnutė;Nykštukai;5102345686;Taip;0;0;1;1
5809;Pakalnutė;"Zuikučių ";1198230323;Taip;0;0;4;4
5810;Pakalnutė;"Zuikučių ";6016791282;Taip;0;0;1;1
5811;Pakalnutė;"Zuikučių ";3609982613;Ne;1;1;0;2
5812;Pakalnutė;"Zuikučių ";5958653847;Taip;0;1;1;2
5813;Pakalnutė;"Zuikučių ";8513260520;Taip;0;2;1;3
5814;Pakalnutė;"Zuikučių ";1147843795;Taip;0;0;1;1
5815;Pakalnutė;"Zuikučių ";3555822605;Taip;5;11;0;16
5816;Pakalnutė;"Zuikučių ";1583462733;Taip;0;0;2;2
5817;Pakalnutė;"Zuikučių ";6377564215;Taip;0;6;0;6
5818;Pakalnutė;"Zuikučių ";1610847242;Taip;0;0;7;7
5819;Pakalnutė;"Zuikučių ";8813262660;Ne;6;0;1;7
5820;Pakalnutė;"Zuikučių ";7949588551;Ne;5;5;0;10
5821;Pakalnutė;"Zuikučių ";81578522887;Taip;0;1;0;1
5822;Pakalnutė;"Zuikučių ";2002555659;Taip;0;0;5;5
5823;Pakalnutė;"Zuikučių ";4681267749;Taip;10;0;0;10
5824;Pakalnutė;"Zuikučių ";6884488772;Ne;7;0;0;7
5825;Pakalnutė;"NAUJA (LOPŠELIS)";7766653114;Taip;10;0;0;10
5826;Pakalnutė;"NAUJA (LOPŠELIS)";1824418095;Taip;4;0;0;4
5827;Pakalnutė;"NAUJA (LOPŠELIS)";5502444590;Taip;5;0;1;6
5828;Pakalnutė;"NAUJA (LOPŠELIS)";5069038636;Taip;11;0;0;11
5829;Pakalnutė;"NAUJA (LOPŠELIS)";4220406978;Taip;0;0;2;2
5830;Pakalnutė;"NAUJA (LOPŠELIS)";7047587606;Taip;12;0;2;14
5831;Pakalnutė;"NAUJA (LOPŠELIS)";9685227636;Taip;4;0;0;4
5832;Pakalnutė;"NAUJA (LOPŠELIS)";7369661890;Taip;2;0;0;2
5833;Pakalnutė;"NAUJA (LOPŠELIS)";9620000116;Taip;6;0;2;8
5834;Pakalnutė;"NAUJA (LOPŠELIS)";2653667596;Taip;0;0;5;5
5835;Pakalnutė;"NAUJA (LOPŠELIS)";3730712580;Taip;7;0;0;7
5836;Pakalnutė;"NAUJA (LOPŠELIS)";7709684372;Taip;10;0;0;10
5837;Pakalnutė;"NAUJA (LOPŠELIS)";9461133636;Taip;9;0;0;9
5838;Pakalnutė;"NAUJA (LOPŠELIS)";7805758264;Taip;5;0;0;5
5839;Pakalnutė;"NAUJA (LOPŠELIS)";4961361687;Taip;0;1;0;1
5840;Pakalnutė;"NAUJA (LOPŠELIS)";3342793992;Taip;0;0;1;1
5841;Pakalnutė;"NAUJA (LOPŠELIS)";5531209454;Taip;10;0;0;10
5842;Pakalnutė;"NAUJA (LOPŠELIS)";8329725085;Taip;4;0;1;5
5843;Pakalnutė;"NAUJA (LOPŠELIS)";5878352514;Taip;6;0;2;8
5844;Pakalnutė;"NAUJA (LOPŠELIS)";8010667913;Taip;7;0;2;9
5845;Pakalnutė;"NAUJA (LOPŠELIS)";7421275778;Taip;0;0;2;2
5846;Pakalnutė;"NAUJA (LOPŠELIS)";8743616270;Taip;8;0;0;8
5847;Pakalnutė;"NAUJA (LOPŠELIS)";1662773049;Taip;0;0;4;4
5848;Pakalnutė;"NAUJA (LOPŠELIS)";5685361033;Taip;0;0;3;3
5849;Pakalnutė;"NAUJA (LOPŠELIS)";7782295402;Taip;6;0;1;7
5850;Panerių;Rūtelė;6227583229;Ne;0;0;1;1
5851;Panerių;Rūtelė;2786775879;Ne;0;8;0;8
5852;Panerių;Rūtelė;3438863665;Ne;0;6;0;6
5853;Panerių;Rūtelė;4023257875;Ne;0;0;2;2
5854;Panerių;Rūtelė;4689913361;Ne;0;5;6;11
5855;Panerių;Rūtelė;2195332401;Ne;0;0;1;1
5856;Panerių;Rūtelė;9604335101;Ne;6;0;5;11
5857;Panerių;Rūtelė;2571561865;Ne;0;6;0;6
5858;Panerių;Rūtelė;6908487075;Ne;0;0;4;4
5859;Panerių;Rūtelė;3843500717;Ne;4;0;2;6
5860;Panerių;Rūtelė;9639587601;Ne;0;2;0;2
5861;Panerių;Rūtelė;2608386063;Taip;6;6;0;12
5862;Panerių;Rūtelė;1066011221;Taip;6;6;0;12
5863;Panerių;Rūtelė;2643410976;Ne;0;0;1;1
5864;Panerių;Rūtelė;2189532651;Ne;0;0;2;2
5865;Panerių;Rūtelė;3346395516;Ne;0;0;2;2
5866;Panerių;Rūtelė;7805429137;Ne;0;0;1;1
5867;Panerių;Rūtelė;9268618414;Ne;1;0;0;1
5868;Panerių;Rūtelė;6411372006;Taip;12;0;2;14
5869;Panerių;Rūtelė;1419817211;Ne;0;2;0;2
5870;Panerių;Rūtelė;5001921323;Taip;2;0;1;3
5871;Panerių;Gėlytės;3913395809;Ne;7;0;3;10
5872;Panerių;Gėlytės;9631684972;Ne;0;0;2;2
5873;Panerių;Gėlytės;3190117304;Taip;0;3;0;3
5874;Panerių;Gėlytės;8693113275;Taip;19;0;0;19
5875;Panerių;Gėlytės;3550194241;Ne;0;1;0;1
5876;Panerių;Gėlytės;6468190149;Ne;5;0;2;7
5877;Panerių;Gėlytės;9506008651;Taip;21;0;0;21
5878;Panerių;Gėlytės;9630302749;Ne;16;0;1;17
5879;Panerių;Gėlytės;1339256258;Taip;0;0;2;2
5880;Panerių;Gėlytės;2235123048;Ne;9;0;0;9
5881;Panerių;Gėlytės;1234369953;Ne;0;6;0;6
5882;Panerių;Gėlytės;5861312413;Ne;11;0;1;12
5883;Panerių;Boružė;6583134855;Ne;0;0;1;1
5884;Panerių;Boružė;9729731866;Ne;0;0;3;3
5885;Panerių;Boružė;9732352141;Ne;20;0;0;20
5886;Panerių;Boružė;8447920373;Ne;10;0;8;18
5887;Panerių;Boružė;8964194121;Taip;0;0;7;7
5888;Panerių;Boružė;6304387432;Ne;0;0;8;8
5889;Panerių;Boružė;2035822976;Ne;0;0;9;9
5890;Panerių;Boružė;3948776877;Ne;7;0;0;7
5891;Panerių;Boružė;2751334281;Ne;0;0;1;1
5892;Panerių;Boružė;4950143153;Ne;4;0;0;4
5893;Papartis;ZUIKUČIAI;1065234123;Taip;13;0;0;13
5894;Papartis;ZUIKUČIAI;27900855758;Taip;0;0;1;1
5895;Papartis;ZUIKUČIAI;1219140467;Taip;4;0;0;4
5896;Papartis;ZUIKUČIAI;1554777403;Taip;3;0;3;6
5897;Papartis;ZUIKUČIAI;7703070601;Taip;0;6;1;7
5898;Papartis;ZUIKUČIAI;7902130389;Taip;0;8;2;10
5899;Papartis;ZUIKUČIAI;4992305227;Taip;14;1;0;15
5900;Papartis;ZUIKUČIAI;4346817695;Taip;4;0;1;5
5901;Papartis;ZUIKUČIAI;2447926422;Taip;0;6;0;6
5902;Papartis;ZUIKUČIAI;3182457453;Taip;10;2;0;12
5903;Papartis;ZUIKUČIAI;3275123842;Taip;0;9;0;9
5904;Papartis;ZUIKUČIAI;8190458132;Taip;3;0;1;4
5905;Papartis;ZUIKUČIAI;8952917454;Taip;5;0;2;7
5906;Papartis;ZUIKUČIAI;5410369044;Taip;6;6;0;12
5907;Papartis;ZUIKUČIAI;6126912448;Taip;0;0;5;5
5908;Papartis;ZUIKUČIAI;1065128993;Ne;0;7;0;7
5909;Papartis;ZUIKUČIAI;3895487270;Taip;0;9;0;9
5910;Papartis;ZUIKUČIAI;1527263538;Taip;0;0;3;3
5911;Papartis;ZUIKUČIAI;74734443304;Taip;0;1;0;1
5912;Papartis;DRUGELIAI;4508053349;Taip;0;0;1;1
5913;Papartis;DRUGELIAI;7387281720;Taip;0;2;0;2
5914;Papartis;DRUGELIAI;2778629398;Taip;0;0;5;5
5915;Papartis;DRUGELIAI;3475745012;Ne;0;1;6;7
5916;Papartis;DRUGELIAI;2535412635;Taip;0;0;2;2
5917;Papartis;DRUGELIAI;6797687614;Taip;10;0;2;12
5918;Papartis;DRUGELIAI;9719465384;Taip;0;3;0;3
5919;Papartis;DRUGELIAI;8148483438;Taip;0;1;0;1
5920;Papartis;DRUGELIAI;5265293240;Taip;6;2;3;11
5921;Papartis;DRUGELIAI;9134335737;Taip;6;2;2;10
5922;Papartis;DRUGELIAI;1836914270;Taip;0;1;4;5
5923;Papartis;DRUGELIAI;4935694347;Taip;0;0;1;1
5924;Papartis;DRUGELIAI;1672028156;Taip;0;1;1;2
5925;Papartis;DRUGELIAI;4634683589;Taip;0;1;1;2
5926;Papartis;DRUGELIAI;3107106078;Taip;8;0;5;13
5927;Papartis;DRUGELIAI;1205854439;Ne;6;5;0;11
5928;Papartis;DRUGELIAI;7067369268;Taip;11;0;3;14
5929;Papartis;DRUGELIAI;42803013754;Taip;0;1;0;1
5930;Papartis;DRUGELIAI;3408756311;Taip;0;0;2;2
5931;Papartis;DRUGELIAI;3295731801;Ne;0;2;0;2
5932;Papartis;ŽVIRBLIUKAI;50090482473;Taip;0;0;1;1
5933;Papartis;ŽVIRBLIUKAI;1246604915;Taip;0;2;0;2
5934;Papartis;ŽVIRBLIUKAI;67966766974;Taip;0;1;0;1
5935;Papartis;ŽVIRBLIUKAI;95139517078;Taip;0;3;0;3
5936;Papartis;ŽVIRBLIUKAI;50658624766;Ne;12;0;1;13
5937;Papartis;ŽVIRBLIUKAI;30982681803;Taip;0;2;0;2
5938;Papartis;ŽVIRBLIUKAI;48182233276;Taip;0;1;1;2
5939;Papartis;ŽVIRBLIUKAI;23218268605;Ne;0;10;0;10
5940;Papartis;ŽVIRBLIUKAI;22443998204;Taip;0;1;0;1
5941;Papartis;ŽVIRBLIUKAI;10078570352;Taip;0;0;1;1
5942;Papartis;ŽVIRBLIUKAI;15207322802;Taip;18;0;0;18
5943;Papartis;ŽVIRBLIUKAI;29789530287;Ne;0;0;5;5
5944;Papartis;ŽVIRBLIUKAI;38896771062;Taip;5;0;0;5
5945;Papartis;ŽVIRBLIUKAI;1703232380;Taip;10;1;0;11
5946;Papartis;ŽVIRBLIUKAI;44833872631;Ne;0;1;1;2
5947;Papartis;ŽVIRBLIUKAI;7590170146;Taip;0;16;0;16
5948;Papartis;ŽVIRBLIUKAI;2412700197;Taip;3;0;1;4
5949;Papartis;PELĖDŽIUKAI;2067304804;Taip;0;1;1;2
5950;Papartis;PELĖDŽIUKAI;3287617252;Taip;0;1;0;1
5951;Papartis;PELĖDŽIUKAI;68478260102;Ne;0;6;0;6
5952;Papartis;PELĖDŽIUKAI;89525856173;Taip;0;1;1;2
5953;Papartis;PELĖDŽIUKAI;10659508171;Taip;0;1;1;2
5954;Papartis;PELĖDŽIUKAI;88418552221;Taip;0;2;0;2
5955;Papartis;PELĖDŽIUKAI;63087155760;Taip;0;1;1;2
5956;Papartis;PELĖDŽIUKAI;74972133115;Taip;0;1;0;1
5957;Papartis;PELĖDŽIUKAI;7845277151;Taip;0;9;1;10
5958;Papartis;PELĖDŽIUKAI;53040207725;Taip;0;6;0;6
5959;Papartis;PELĖDŽIUKAI;12406782910;Taip;0;1;0;1
5960;Papartis;PELĖDŽIUKAI;3630377970;Taip;4;1;1;6
5961;Papartis;PELĖDŽIUKAI;7606939822;Taip;0;16;0;16
5962;Papartis;PELĖDŽIUKAI;22570313128;Ne;5;0;0;5
5963;Papartis;SAULUTĖS;2669085057;Taip;18;0;0;18
5964;Papartis;SAULUTĖS;3209491491;Taip;7;2;0;9
5965;Papartis;SAULUTĖS;6931780900;Taip;0;6;3;9
5966;Papartis;SAULUTĖS;6585372451;Taip;12;1;5;18
5967;Papartis;SAULUTĖS;6734567714;Taip;2;0;1;3
5968;Papartis;SAULUTĖS;4570512336;Taip;5;7;0;12
5969;Papartis;SAULUTĖS;1231594320;Taip;6;0;2;8
5970;Papartis;SAULUTĖS;3539507686;Taip;8;0;0;8
5971;Papartis;SAULUTĖS;3595627659;Taip;0;1;1;2
5972;Papartis;SAULUTĖS;6977513472;Ne;0;1;2;3
5973;Papartis;SAULUTĖS;5070767260;Taip;0;0;1;1
5974;Papartis;SAULUTĖS;9380951144;Ne;7;0;0;7
5975;Papartis;SAULUTĖS;4016297254;Ne;13;0;0;13
5976;Papartis;SAULUTĖS;5323875279;Ne;14;0;0;14
5977;Papartis;SAULUTĖS;5465955537;Ne;0;1;0;1
5978;Papartis;SAULUTĖS;2812347963;Taip;3;0;0;3
5979;Papartis;SAULUTĖS;3685642787;Ne;9;0;0;9
5980;Papartis;SAULUTĖS;4597039190;Ne;10;0;0;10
5981;Papartis;GANDRIUKAI;4878190663;Taip;9;1;0;10
5982;Papartis;GANDRIUKAI;9900023788;Taip;0;1;2;3
5983;Papartis;GANDRIUKAI;8946678515;Taip;10;0;0;10
5984;Papartis;GANDRIUKAI;6883101103;Taip;10;0;0;10
5985;Papartis;GANDRIUKAI;2868899342;Taip;0;0;1;1
5986;Papartis;GANDRIUKAI;7768672610;Ne;4;2;0;6
5987;Papartis;GANDRIUKAI;9384670351;Taip;0;3;0;3
5988;Papartis;GANDRIUKAI;9968072478;Ne;2;1;0;3
5989;Papartis;GANDRIUKAI;2215846642;Taip;0;0;1;1
5990;Papartis;GANDRIUKAI;3320524073;Taip;1;2;0;3
5991;Papartis;GANDRIUKAI;9704930584;Taip;5;0;0;5
5992;Papartis;GANDRIUKAI;9804863902;Taip;0;0;2;2
5993;Papartis;GANDRIUKAI;9072635586;Taip;9;0;0;9
5994;Papartis;GANDRIUKAI;1974159967;Taip;0;1;0;1
5995;Papartis;GANDRIUKAI;5732853976;Taip;14;0;0;14
5996;Papartis;GANDRIUKAI;7859096984;Taip;5;10;0;15
5997;Papartis;GANDRIUKAI;7252265838;Taip;0;10;0;10
5998;Papartis;GANDRIUKAI;4279580382;Taip;8;0;0;8
5999;Papartis;GANDRIUKAI;9978625382;Taip;18;1;0;19
6000;Papartis;AITVARELIAI;5736456872;Taip;0;2;1;3
6001;Papartis;AITVARELIAI;3040269026;Taip;0;2;1;3
6002;Papartis;AITVARELIAI;8532558577;Taip;0;2;2;4
6003;Papartis;AITVARELIAI;4918854899;Taip;0;6;0;6
6004;Papartis;AITVARELIAI;5252947502;Taip;5;6;0;11
6005;Papartis;AITVARELIAI;1916222143;Ne;5;0;0;5
6006;Papartis;AITVARELIAI;7803854703;Taip;0;3;0;3
6007;Papartis;AITVARELIAI;4261270064;Taip;11;2;0;13
6008;Papartis;AITVARELIAI;3100013570;Taip;0;0;18;18
6009;Papartis;AITVARELIAI;6416605464;Taip;6;0;0;6
6010;Papartis;AITVARELIAI;1266338760;Taip;13;0;0;13
6011;Papartis;AITVARELIAI;7504793827;Taip;6;0;1;7
6012;Papartis;AITVARELIAI;7156767639;Ne;7;0;1;8
6013;Papartis;AITVARELIAI;2343726641;Taip;15;0;0;15
6014;Papartis;AITVARELIAI;2116140075;Ne;10;1;0;11
6015;Papartis;SMALSUČIAI;6266095782;Taip;0;7;0;7
6016;Papartis;SMALSUČIAI;3054883426;Taip;0;6;0;6
6017;Papartis;SMALSUČIAI;1191546794;Ne;0;3;5;8
6018;Papartis;SMALSUČIAI;1919362027;Taip;13;0;0;13
6019;Papartis;SMALSUČIAI;9375751990;Taip;0;9;0;9
6020;Papartis;SMALSUČIAI;5786648402;Taip;0;2;0;2
6021;Papartis;SMALSUČIAI;8808902528;Taip;4;0;0;4
6022;Papartis;SMALSUČIAI;9358310527;Taip;10;2;0;12
6023;Papartis;SMALSUČIAI;5361925390;Taip;0;0;1;1
6024;Papartis;SMALSUČIAI;4906248064;Ne;0;1;1;2
6025;Papartis;SMALSUČIAI;4640068595;Taip;8;1;0;9
6026;Papartis;SMALSUČIAI;5579899922;Taip;0;8;0;8
6027;Papartis;SMALSUČIAI;8874222586;Taip;0;0;1;1
6028;Papartis;SMALSUČIAI;8958880558;Taip;10;0;0;10
6029;Papartis;SMALSUČIAI;5796928317;Taip;7;0;0;7
6030;Papartis;SMALSUČIAI;5363926529;Ne;0;1;0;1
6031;Papartis;"ŽIRNIUKAI ";8897061283;Ne;1;0;0;1
6032;Papartis;"ŽIRNIUKAI ";3310893254;Ne;6;0;0;6
6033;Papartis;"ŽIRNIUKAI ";1073755384;Taip;0;11;0;11
6034;Papartis;"ŽIRNIUKAI ";7647225316;Taip;15;0;0;15
6035;Papartis;"ŽIRNIUKAI ";8768526171;Taip;17;0;0;17
6036;Papartis;"ŽIRNIUKAI ";5241974494;Taip;7;0;0;7
6037;Papartis;"ŽIRNIUKAI ";1210592579;Ne;0;0;1;1
6038;Papartis;"ŽIRNIUKAI ";1519815331;Taip;8;0;0;8
6039;Papartis;"ŽIRNIUKAI ";4158525314;Taip;0;2;4;6
6040;Papartis;"ŽIRNIUKAI ";4978398085;Taip;0;8;0;8
6041;Papartis;"ŽIRNIUKAI ";9480364901;Ne;6;0;0;6
6042;Papartis;"ŽIRNIUKAI ";1150772988;Ne;0;4;0;4
6043;Papartis;"ŽIRNIUKAI ";5276806556;Taip;10;0;1;11
6044;Papartis;"ŽIRNIUKAI ";2521609574;Taip;0;0;3;3
6045;Papartis;"ŽIRNIUKAI ";7617558492;Ne;5;0;2;7
6046;Papartis;"ŽIRNIUKAI ";7080578299;Taip;10;0;0;10
6047;Papartis;"ŽIRNIUKAI ";5883751305;Ne;0;4;0;4
6048;Papartis;BORUŽĖLĖS;6136213985;Taip;6;0;1;7
6049;Papartis;BORUŽĖLĖS;7107692314;Taip;6;0;1;7
6050;Papartis;BORUŽĖLĖS;6615368741;Ne;14;0;1;15
6051;Papartis;BORUŽĖLĖS;5430993785;Ne;10;0;0;10
6052;Papartis;BORUŽĖLĖS;1722192450;Ne;4;1;0;5
6053;Papartis;BORUŽĖLĖS;8277830926;Ne;5;0;0;5
6054;Papartis;BORUŽĖLĖS;8989172483;Ne;5;0;3;8
6055;Papartis;BORUŽĖLĖS;1352401881;Taip;5;0;0;5
6056;Papartis;BORUŽĖLĖS;9518392031;Ne;12;0;1;13
6057;Papartis;BORUŽĖLĖS;9384475270;Ne;8;11;0;19
6058;Papartis;BORUŽĖLĖS;1759982543;Taip;0;1;0;1
6059;Papartis;BORUŽĖLĖS;7619963429;Ne;0;2;0;2
6060;Papartis;BORUŽĖLĖS;4380030213;Taip;2;0;1;3
6061;Papartis;BORUŽĖLĖS;8420752169;Taip;6;0;2;8
6062;Papartis;BORUŽĖLĖS;6346776139;Taip;3;5;0;8
6063;Papartis;VARPELIAI;8782882575;Ne;0;6;0;6
6064;Papartis;VARPELIAI;2824078830;Ne;7;0;0;7
6065;Papartis;VARPELIAI;4778327620;Ne;7;0;0;7
6066;Papartis;VARPELIAI;8005876431;Ne;6;0;0;6
6067;Papartis;VARPELIAI;7486667034;Ne;0;0;4;4
6068;Papartis;VARPELIAI;7742769931;Ne;5;0;0;5
6069;Papartis;VARPELIAI;2432516496;Ne;12;0;2;14
6070;Papartis;VARPELIAI;7384518191;Taip;7;0;0;7
6071;Papartis;VARPELIAI;7952705729;Taip;9;1;0;10
6072;Papartis;VARPELIAI;1405767603;Taip;1;2;0;3
6073;Papartis;VARPELIAI;7331682622;Ne;7;1;0;8
6074;Papartis;VARPELIAI;1874865061;Ne;10;0;0;10
6075;Papartis;VARPELIAI;3411472740;Ne;0;10;0;10
6076;Papartis;VARPELIAI;8305560946;Ne;5;0;0;5
6077;Papartis;NYKŠTUKAI;1566011843;Taip;6;0;0;6
6078;Papartis;NYKŠTUKAI;5652769035;Ne;0;0;1;1
6079;Papartis;NYKŠTUKAI;5942160584;Taip;0;0;2;2
6080;Papartis;NYKŠTUKAI;9922091482;Ne;10;1;0;11
6081;Papartis;NYKŠTUKAI;9285319899;Taip;10;0;0;10
6082;Papartis;NYKŠTUKAI;6949120693;Taip;0;10;0;10
6083;Papartis;NYKŠTUKAI;6794076631;Taip;3;1;1;5
6084;Papartis;NYKŠTUKAI;5608868738;Ne;0;6;0;6
6085;Papartis;NYKŠTUKAI;4203241118;Taip;0;1;1;2
6086;Papartis;NYKŠTUKAI;4806652727;Taip;0;2;0;2
6087;Papartis;NYKŠTUKAI;3324647852;Taip;0;5;2;7
6088;Papartis;NYKŠTUKAI;6423401656;Taip;11;0;1;12
6089;Papartis;NYKŠTUKAI;8932290803;Taip;10;0;0;10
6090;Papartis;NYKŠTUKAI;5652560002;Taip;0;1;0;1
6091;Papartis;NYKŠTUKAI;6360881137;Ne;11;0;1;12
6092;Pasaka;Drugelių;2332865106;Taip;0;1;6;7
6093;Pasaka;Drugelių;6794437566;Ne;0;1;1;2
6094;Pasaka;Drugelių;4071643754;Ne;0;1;0;1
6095;Pasaka;Drugelių;6893044575;Ne;0;1;0;1
6096;Pasaka;Drugelių;94514447596;Ne;0;1;0;1
6097;Pasaka;Drugelių;12951124853;Ne;0;1;0;1
6098;Pasaka;Drugelių;71316589358;Ne;0;1;0;1
6099;Pasaka;Drugelių;52135673503;Ne;0;2;1;3
6100;Pasaka;Drugelių;1188769609;Ne;0;1;0;1
6101;Pasaka;Drugelių;50319234551;Ne;0;1;4;5
6102;Pasaka;Drugelių;15051078156;Ne;0;1;0;1
6103;Pasaka;Drugelių;59491538033;Ne;0;1;2;3
6104;Pasaka;Drugelių;1268530885;Ne;10;0;0;10
6105;Pasaka;Drugelių;35718732394;Ne;0;1;0;1
6106;Pasaka;Drugelių;7694779970;Ne;0;5;0;5
6107;Pasaka;Nykštukų;5665758011;Taip;0;1;0;1
6108;Pasaka;Nykštukų;8166051272;Taip;0;1;0;1
6109;Pasaka;Nykštukų;91546084785;Taip;0;2;4;6
6110;Pasaka;Nykštukų;7040953491;Ne;0;2;0;2
6111;Pasaka;Nykštukų;7546205285;Ne;0;8;0;8
6112;Pasaka;Nykštukų;5687494160;Taip;0;4;0;4
6113;Pasaka;Nykštukų;3088081091;Ne;0;1;0;1
6114;Pasaka;Nykštukų;3151916774;Taip;0;1;0;1
6115;Pasaka;Nykštukų;4773893970;Taip;10;0;0;10
6116;Pasaka;Nykštukų;1300996831;Ne;0;3;0;3
6117;Pasaka;Nykštukų;1313576071;Taip;2;0;0;2
6118;Pasaka;Nykštukų;7455544922;Taip;4;3;5;12
6119;Pasaka;Nykštukų;5027755073;Taip;0;5;0;5
6120;Pasaka;Nykštukų;4082752808;Taip;10;0;0;10
6121;Pasaka;Nykštukų;9418332784;Taip;0;0;9;9
6122;Pasaka;Nykštukų;6788771605;Ne;0;1;0;1
6123;Pasaka;Nykštukų;5412931969;Ne;0;0;3;3
6124;Pasaka;Nykštukų;8963465320;Ne;0;2;1;3
6125;Pasaka;Nykštukų;2621046003;Ne;0;0;3;3
6126;Pasaka;Nykštukų;3092993659;Ne;5;0;0;5
6127;Pasaka;Nykštukų;2797217440;Ne;0;2;0;2
6128;Pasaka;Montesori;69250064506;Taip;0;0;1;1
6129;Pasaka;Montesori;81598865451;Ne;5;0;1;6
6130;Pasaka;Montesori;1564467627;Taip;0;0;1;1
6131;Pasaka;Montesori;8996941733;Taip;5;0;0;5
6132;Pasaka;Montesori;4608655313;Taip;6;0;0;6
6133;Pasaka;Montesori;4305485747;Taip;0;0;1;1
6134;Pasaka;Montesori;79460661793;Taip;0;0;4;4
6135;Pasaka;Montesori;8635400672;Ne;3;0;0;3
6136;Pasaka;Montesori;47140322803;Ne;0;0;5;5
6137;Pasaka;Montesori;7837662446;Taip;1;0;0;1
6138;Pasaka;Montesori;3047931231;Ne;5;0;1;6
6139;Pasaka;Montesori;3718774263;Ne;0;0;1;1
6140;Pasaka;Montesori;6625690696;Taip;5;0;0;5
6141;Pasaka;Montesori;4548601585;Taip;0;0;1;1
6142;Pasaka;Montesori;2995831258;Ne;0;0;1;1
6143;Pasaka;Žirniukų;17931259433;Ne;0;1;0;1
6144;Pasaka;Žirniukų;9722435751;Taip;0;2;0;2
6145;Pasaka;Žirniukų;7648503006;Ne;0;12;1;13
6146;Pasaka;Žirniukų;2697014098;Taip;0;1;0;1
6147;Pasaka;Žirniukų;73703706115;Taip;0;2;0;2
6148;Pasaka;Žirniukų;6441884677;Ne;4;0;0;4
6149;Pasaka;Žirniukų;5651452381;Taip;13;0;0;13
6150;Pasaka;Žirniukų;1836826810;Ne;0;2;0;2
6151;Pasaka;Žirniukų;2788679885;Taip;0;1;0;1
6152;Pasaka;Žirniukų;1565873178;Ne;0;1;0;1
6153;Pasaka;Žirniukų;7445696309;Taip;0;1;0;1
6154;Pasaka;Žirniukų;2400455036;Ne;4;0;0;4
6155;Pasaka;Žirniukų;79170702319;Taip;16;0;2;18
6156;Pasaka;Žirniukų;5965121999;Taip;2;0;0;2
6157;Pasaka;Žirniukų;5973028582;Taip;0;0;2;2
6158;Pasaka;"Voveriukų ";3606141216;Ne;0;2;0;2
6159;Pasaka;"Voveriukų ";5217688848;Ne;0;2;0;2
6160;Pasaka;"Voveriukų ";4171004263;Ne;0;1;0;1
6161;Pasaka;"Voveriukų ";8504575043;Ne;0;0;3;3
6162;Pasaka;"Voveriukų ";1488711275;Ne;0;1;0;1
6163;Pasaka;"Voveriukų ";2854919649;Ne;0;0;1;1
6164;Pasaka;"Voveriukų ";4466963221;Ne;10;1;0;11
6165;Pasaka;"Voveriukų ";9588247759;Ne;0;1;1;2
6166;Pasaka;"Voveriukų ";3536862796;Ne;3;0;0;3
6167;Pasaka;"Voveriukų ";8899289832;Ne;0;0;3;3
6168;Pasaka;"Voveriukų ";4915357646;Ne;0;0;2;2
6169;Pasaka;"Voveriukų ";7176272684;Ne;0;8;0;8
6170;Pasaka;"Voveriukų ";9687385445;Taip;0;0;1;1
6171;Pasaka;"Voveriukų ";4799036184;Ne;0;0;1;1
6172;Pasaka;"Voveriukų ";6684234474;Ne;0;0;4;4
6173;Pasaka;"Voveriukų ";9003508760;Ne;0;0;2;2
6174;Pasaka;"VALDOFRO 12";2141354232;Taip;0;0;1;1
6175;Pasaka;"VALDOFRO 12";8042135600;Ne;0;0;1;1
6176;Pasaka;"VALDOFRO 12";3367120837;Ne;0;3;2;5
6177;Pasaka;"VALDOFRO 12";7010681103;Taip;0;2;1;3
6178;Pasaka;"VALDOFRO 12";56766427323;Ne;3;0;0;3
6179;Pasaka;"VALDOFRO 12";5141156728;Taip;0;0;1;1
6180;Pasaka;"VALDOFRO 12";2268625523;Ne;0;0;3;3
6181;Pasaka;"VALDOFRO 12";3195380938;Ne;1;0;1;2
6182;Pasaka;"VALDOFRO 12";8976424908;Ne;3;0;0;3
6183;Pasaka;"VALDOFRO 12";8701112181;Taip;5;0;0;5
6184;Pasaka;"VALDOFRO 12";1305541319;Ne;0;4;2;6
6185;Pasaka;"VALDOFRO 12";7682903999;Ne;6;0;0;6
6186;Pasaka;"VALDOFRO 12";6448940090;Ne;2;0;0;2
6187;Pasaka;"VALDOFRO 12";8411025450;Ne;4;1;0;5
6188;Pasaka;"VALDOFRO 12";9943625201;Ne;6;0;0;6
6189;Pasaka;"VALDOFRO 12";8995205555;Taip;2;0;0;2
6190;Pasaka;"VALDOFRO 12";4548945364;Ne;0;0;1;1
6191;Pasaka;"VALDOFRO 12";8912822936;Ne;0;0;1;1
6192;Pasaka;"VALDORFO 2";61077353229;Taip;0;0;3;3
6193;Pasaka;"VALDORFO 2";71365777764;Taip;0;0;2;2
6194;Pasaka;"VALDORFO 2";77904202630;Taip;0;0;1;1
6195;Pasaka;"VALDORFO 2";4752117533;Ne;0;2;1;3
6196;Pasaka;"VALDORFO 2";10616073718;Ne;0;5;0;5
6197;Pasaka;"VALDORFO 2";7950962252;Taip;0;0;3;3
6198;Pasaka;"VALDORFO 2";8590385693;Taip;0;0;4;4
6199;Pasaka;"VALDORFO 2";4620573687;Ne;0;1;2;3
6200;Pasaka;"VALDORFO 2";4825373152;Taip;3;0;2;5
6201;Pasaka;"VALDORFO 2";9462745431;Taip;0;0;3;3
6202;Pasaka;"VALDORFO 2";5399148997;Taip;7;0;3;10
6203;Pasaka;"VALDORFO 2";1799326151;Ne;0;0;1;1
6204;Pasaka;"VALDORFO 2";2273629510;Taip;0;0;1;1
6205;Pasaka;"VALDORFO 2";3778182691;Taip;0;1;1;2
6206;Pasaka;"VALDORFO 2";8947139321;Ne;0;4;0;4
6207;Pasaka;"VALDORFO 2";3049361712;Ne;0;1;0;1
6208;Pasaka;Gudručiai;1920564803;Ne;14;0;0;14
6209;Pasaka;Gudručiai;49520139946;Ne;4;1;0;5
6210;Pasaka;Gudručiai;62303770229;Taip;0;0;2;2
6211;Pasaka;Gudručiai;9973758979;Taip;0;0;1;1
6212;Pasaka;Gudručiai;5021568651;Ne;7;0;0;7
6213;Pasaka;Gudručiai;1693530160;Ne;9;1;0;10
6214;Pasaka;Gudručiai;8615661704;Ne;0;2;1;3
6215;Pasaka;Gudručiai;4178679491;Ne;0;2;1;3
6216;Pasaka;Gudručiai;31896116591;Ne;8;0;2;10
6217;Pasaka;Gudručiai;23132755276;Ne;0;2;1;3
6218;Pasaka;Gudručiai;49626651411;Taip;0;0;8;8
6219;Pasaka;Gudručiai;7082166681;Taip;0;2;0;2
6220;Pasaka;Gudručiai;51500606207;Ne;0;7;0;7
6221;Pasaka;Gudručiai;56983167265;Taip;0;1;0;1
6222;Pasaka;Gudručiai;9549799936;Ne;0;3;0;3
6223;Pasaka;Gudručiai;1630083619;Ne;7;1;0;8
6224;Pasaka;Gudručiai;2874308781;Ne;13;0;0;13
6225;Pasaka;Bitelių;8651165520;Taip;14;0;0;14
6226;Pasaka;Bitelių;8132829016;Taip;13;0;0;13
6227;Pasaka;Bitelių;5351364328;Ne;4;0;0;4
6228;Pasaka;Bitelių;4635912654;Taip;4;0;0;4
6229;Pasaka;Bitelių;4137222204;Ne;0;0;1;1
6230;Pasaka;Bitelių;7248640367;Taip;0;0;5;5
6231;Pasaka;Bitelių;8277245475;Taip;0;0;7;7
6232;Pasaka;Bitelių;6868519179;Ne;0;0;3;3
6233;Pasaka;Bitelių;6759415053;Taip;0;0;3;3
6234;Pasaka;Bitelių;5723970763;Taip;0;0;8;8
6235;Pasaka;Bitelių;9136521759;Taip;0;0;1;1
6236;Pasaka;Bitelių;9737445077;Taip;1;0;0;1
6237;Pasaka;Bitelių;2638182985;Ne;0;0;5;5
6238;Pasaka;Bitelių;2293613528;Taip;2;0;1;3
6239;Pasaka;Bitelių;3351338617;Taip;0;0;1;1
6240;Pasaka;Bitelių;5371046207;Taip;0;0;1;1
6241;Pasaka;Bitelių;6139825302;Ne;0;0;1;1
6242;Pasaka;Bitelių;4970812899;Ne;2;0;0;2
6243;Pasaka;"Pabiručių ";4846146925;Taip;1;0;5;6
6244;Pasaka;"Pabiručių ";9770811826;Taip;1;0;5;6
6245;Pasaka;"Pabiručių ";5651025350;Ne;0;0;2;2
6246;Pasaka;"Pabiručių ";6248810027;Ne;0;0;3;3
6247;Pasaka;"Pabiručių ";9136524816;Ne;0;0;3;3
6248;Pasaka;"Pabiručių ";2815348652;Ne;0;0;3;3
6249;Pasaka;"Pabiručių ";2422958320;Ne;2;0;1;3
6250;Pasaka;"Pabiručių ";9867183480;Ne;3;0;0;3
6251;Pasaka;"Pabiručių ";5230621839;Ne;9;0;1;10
6252;Pasaka;"Pabiručių ";9087220607;Ne;2;0;0;2
6253;Pasaka;"Pabiručių ";9471447977;Taip;0;0;1;1
6254;Pasaka;"Pabiručių ";9438006825;Taip;0;0;3;3
6255;Pasaka;Šnekučių;1512874567;Ne;3;1;2;6
6256;Pasaka;Šnekučių;4296539838;Ne;0;2;3;5
6257;Pasaka;Šnekučių;1590306118;Ne;0;0;6;6
6258;Pasaka;Šnekučių;1156401434;Ne;0;0;2;2
6259;Pasaka;Šnekučių;6795580569;Ne;0;0;1;1
6260;Pasaka;Šnekučių;4215568107;Ne;4;0;0;4
6261;Pasaka;Šnekučių;4816441219;Ne;9;0;2;11
6262;Pasaka;Šnekučių;1795497567;Ne;10;0;4;14
6263;Pasaka;Šnekučių;8347051587;Ne;10;0;0;10
6264;Pasaka;Šnekučių;3854678845;Ne;0;0;5;5
6265;Pasaka;Šnekučių;4975045894;Ne;4;0;0;4
6266;Pasaka;Šnekučių;3588073618;Ne;5;0;0;5
6267;Pasaka;Šnekučių;1749821746;Ne;5;0;0;5
6268;Pasaka;Šnekučių;1723076060;Ne;0;0;2;2
6269;Pasaka;Šnekučių;8475365713;Ne;0;0;6;6
6270;Paslaptis;Priešmokyklinė;1950287365;Ne;0;0;2;2
6271;Paslaptis;Priešmokyklinė;1094068061;Taip;0;1;0;1
6272;Paslaptis;Priešmokyklinė;8522925854;Ne;13;0;0;13
6273;Paslaptis;Priešmokyklinė;1868248793;Ne;6;1;1;8
6274;Paslaptis;Priešmokyklinė;4731417201;Ne;0;1;0;1
6275;Paslaptis;Priešmokyklinė;3798754778;Ne;0;0;8;8
6276;Paslaptis;Priešmokyklinė;3093280943;Ne;0;1;0;1
6277;Paslaptis;Priešmokyklinė;8280740387;Ne;0;9;0;9
6278;Paslaptis;Priešmokyklinė;2891547963;Ne;0;2;0;2
6279;Paslaptis;Priešmokyklinė;3415869190;Ne;0;1;1;2
6280;Paslaptis;Priešmokyklinė;1983773762;Ne;0;1;0;1
6281;Paslaptis;Priešmokyklinė;1782398974;Ne;18;0;0;18
6282;Paslaptis;Priešmokyklinė;6375966771;Taip;0;7;0;7
6283;Paslaptis;Priešmokyklinė;8083478190;Ne;0;17;0;17
6284;Paslaptis;Priešmokyklinė;2089780119;Ne;0;1;8;9
6285;Paslaptis;Priešmokyklinė;1029321312;Taip;0;1;0;1
6286;Paslaptis;Priešmokyklinė;2879752620;Ne;21;0;0;21
6287;Paslaptis;Priešmokyklinė;3243226933;Taip;14;3;0;17
6288;Paslaptis;Priešmokyklinė;1033910097;Ne;0;0;1;1
6289;Paslaptis;"Darželio mišraus amžiaus grupė";6131831325;Ne;14;1;0;15
6290;Paslaptis;"Darželio mišraus amžiaus grupė";3104525540;Taip;15;0;0;15
6291;Paslaptis;"Darželio mišraus amžiaus grupė";5206529350;Ne;5;3;0;8
6292;Paslaptis;"Darželio mišraus amžiaus grupė";3398729758;Ne;11;0;0;11
6293;Paslaptis;"Darželio mišraus amžiaus grupė";8296575784;Ne;0;6;0;6
6294;Paslaptis;"Darželio mišraus amžiaus grupė";9100003209;Ne;5;1;6;12
6295;Paslaptis;"Darželio mišraus amžiaus grupė";3984799090;Taip;0;1;0;1
6296;Paslaptis;"Darželio mišraus amžiaus grupė";5886364670;Ne;0;0;2;2
6297;Paslaptis;"Darželio mišraus amžiaus grupė";9066462355;Ne;2;0;0;2
6298;Paslaptis;"Darželio mišraus amžiaus grupė";5406800599;Ne;11;0;0;11
6299;Paslaptis;"Darželio mišraus amžiaus grupė";2675089401;Taip;0;1;2;3
6300;Paslaptis;"Darželio mišraus amžiaus grupė";1557783684;Taip;0;1;1;2
6301;Paslaptis;"Darželio mišraus amžiaus grupė";5456011928;Taip;0;7;0;7
6302;Paslaptis;"Darželio mišraus amžiaus grupė";8717111488;Taip;0;3;0;3
6303;Paslaptis;"Darželio mišraus amžiaus grupė";5756338103;Taip;10;0;0;10
6304;Paslaptis;"Darželio mišraus amžiaus grupė";5646806136;Ne;0;1;4;5
6305;Paslaptis;"Darželio mišraus amžiaus grupė";6098345982;Ne;6;0;0;6
6306;Paslaptis;"Darželio mišraus amžiaus grupė";1754621741;Ne;17;1;0;18
6307;Paslaptis;"Darželio mišraus amžiaus grupė";7638521198;Taip;5;0;0;5
6308;Paslaptis;"Darželio mišraus amžiaus grupė";4591318991;Taip;12;1;0;13
6309;Paslaptis;"NAUJA (LOPŠELIS)";6686352764;Ne;5;0;1;6
6310;Paslaptis;"NAUJA (LOPŠELIS)";4130010071;Ne;9;0;0;9
6311;Paslaptis;"NAUJA (LOPŠELIS)";8909545951;Taip;0;1;0;1
6312;Paslaptis;"NAUJA (LOPŠELIS)";2105441745;Ne;8;0;0;8
6313;Paslaptis;"NAUJA (LOPŠELIS)";7235005234;Ne;5;0;1;6
6314;Paslaptis;"NAUJA (LOPŠELIS)";6513238386;Ne;8;0;1;9
6315;Paslaptis;"NAUJA (LOPŠELIS)";3963816472;Ne;5;0;1;6
6316;Paslaptis;"NAUJA (LOPŠELIS)";9497654214;Taip;6;0;1;7
6317;Paslaptis;"NAUJA (LOPŠELIS)";8848627513;Taip;0;5;0;5
6318;Paslaptis;"NAUJA (LOPŠELIS)";1934900185;Ne;0;5;0;5
6319;Paslaptis;"NAUJA (LOPŠELIS)";3241323665;Taip;5;1;0;6
6320;Paslaptis;"NAUJA (LOPŠELIS)";5809630456;Ne;5;0;0;5
6321;Pasakaitė;Vieversėlių;7685647972;Taip;0;7;0;7
6322;Pasakaitė;Vieversėlių;6459145539;Taip;0;0;6;6
6323;Pasakaitė;Vieversėlių;2194313054;Taip;0;1;1;2
6324;Pasakaitė;Vieversėlių;9587489514;Taip;0;0;3;3
6325;Pasakaitė;Vieversėlių;3444442287;Taip;2;0;2;4
6326;Pasakaitė;Vieversėlių;5485965486;Taip;5;1;0;6
6327;Pasakaitė;Vieversėlių;2563725297;Taip;0;5;0;5
6328;Pasakaitė;Vieversėlių;2849753418;Taip;5;0;0;5
6329;Pasakaitė;Vieversėlių;9543991684;Taip;0;2;0;2
6330;Pasakaitė;Vieversėlių;3680596008;Taip;0;0;2;2
6331;Pasakaitė;Vieversėlių;4882856664;Taip;0;0;5;5
6332;Pasakaitė;Vieversėlių;5953162958;Taip;0;0;1;1
6333;Pasakaitė;Vieversėlių;1060914693;Taip;6;1;0;7
6334;Pasakaitė;Vieversėlių;7761162338;Taip;15;1;0;16
6335;Pasakaitė;Vieversėlių;8463220257;Taip;0;11;0;11
6336;Pasakaitė;Vieversėlių;9018830962;Taip;18;0;0;18
6337;Pasakaitė;Vieversėlių;6736879757;Taip;10;0;1;11
6338;Pasakaitė;Vieversėlių;4191875802;Taip;4;0;0;4
6339;Pasakaitė;Vieversėlių;5020801150;Taip;0;6;0;6
6340;Pasakaitė;Spindulėlių;4680949976;Taip;4;5;0;9
6341;Pasakaitė;Spindulėlių;3734935229;Ne;10;11;0;21
6342;Pasakaitė;Spindulėlių;4267488049;Taip;8;0;2;10
6343;Pasakaitė;Spindulėlių;7152349570;Taip;0;12;0;12
6344;Pasakaitė;Spindulėlių;1220619991;Taip;0;0;1;1
6345;Pasakaitė;Spindulėlių;7526264241;Taip;0;0;3;3
6346;Pasakaitė;Spindulėlių;3606601644;Taip;0;4;0;4
6347;Pasakaitė;Spindulėlių;3541877287;Taip;11;0;2;13
6348;Pasakaitė;Spindulėlių;5628746801;Taip;0;0;1;1
6349;Pasakaitė;Spindulėlių;3579498202;Taip;0;7;0;7
6350;Pasakaitė;Spindulėlių;7790937149;Taip;19;0;0;19
6351;Pasakaitė;Spindulėlių;3400305768;Taip;19;0;0;19
6352;Pasakaitė;Spindulėlių;6568538767;Taip;9;6;0;15
6353;Pasakaitė;Spindulėlių;1962693480;Taip;0;8;1;9
6354;Pasakaitė;Spindulėlių;4758073190;Taip;0;0;1;1
6355;Pasakaitė;Spindulėlių;6714500298;Taip;5;6;0;11
6356;Pasakaitė;Spindulėlių;4974486850;Ne;5;0;1;6
6357;Pasakaitė;Spindulėlių;1697755753;Ne;0;4;0;4
6358;Pasakaitė;Spindulėlių;1056358241;Taip;0;1;0;1
6359;Pasakaitė;Spindulėlių;7607522887;Taip;10;0;0;10
6360;Pasakaitė;Pasagėlių;3165658822;Taip;0;5;0;5
6361;Pasakaitė;Pasagėlių;61230317080;Ne;0;5;0;5
6362;Pasakaitė;Pasagėlių;1740419218;Taip;7;5;0;12
6363;Pasakaitė;Pasagėlių;5378855541;Ne;10;0;1;11
6364;Pasakaitė;Pasagėlių;9680682204;Taip;7;1;0;8
6365;Pasakaitė;Pasagėlių;4703375416;Taip;0;8;0;8
6366;Pasakaitė;Pasagėlių;8466086339;Taip;5;0;0;5
6367;Pasakaitė;Pasagėlių;4959175420;Taip;0;9;0;9
6368;Pasakaitė;Pasagėlių;3259688782;Taip;0;0;1;1
6369;Pasakaitė;Pasagėlių;1144813356;Taip;4;0;0;4
6370;Pasakaitė;Pasagėlių;83018133588;Taip;6;0;1;7
6371;Pasakaitė;Pasagėlių;4013900094;Taip;6;0;0;6
6372;Pasakaitė;Pasagėlių;5605619860;Ne;0;7;1;8
6373;Pasakaitė;Pasagėlių;1791015854;Taip;5;0;0;5
6374;Pasakaitė;Pasagėlių;39853246609;Taip;0;0;1;1
6375;Pasakaitė;Pasagėlių;1707428977;Taip;4;0;1;5
6376;Pasakaitė;Pasagėlių;5467179333;Taip;8;3;0;11
6377;Pasakaitė;Švyturėlių;7702359586;Taip;0;0;8;8
6378;Pasakaitė;Švyturėlių;2331486690;Taip;11;0;2;13
6379;Pasakaitė;Švyturėlių;8469043564;Taip;7;0;7;14
6380;Pasakaitė;Švyturėlių;2721048424;Taip;14;0;1;15
6381;Pasakaitė;Švyturėlių;1513903341;Taip;21;0;0;21
6382;Pasakaitė;Švyturėlių;8578521969;Taip;7;0;7;14
6383;Pasakaitė;Švyturėlių;8390366303;Ne;14;0;0;14
6384;Pasakaitė;Švyturėlių;3778906698;Taip;0;0;7;7
6385;Pasakaitė;Švyturėlių;1278198989;Taip;14;0;1;15
6386;Pasakaitė;Švyturėlių;5993542722;Ne;13;0;0;13
6387;Pasakaitė;Švyturėlių;6847782430;Taip;0;10;0;10
6388;Pasakaitė;Švyturėlių;1533259056;Taip;0;0;13;13
6389;Pasakaitė;Švyturėlių;4728731352;Taip;12;0;0;12
6390;Pasakaitė;Švyturėlių;2404448954;Taip;0;0;1;1
6391;Pasakaitė;Švyturėlių;9821617981;Taip;10;0;3;13
6392;Pasakaitė;Švyturėlių;1184513606;Taip;0;0;6;6
6393;Pasakaitė;Švyturėlių;2751828639;Taip;10;0;1;11
6394;Pasakaitė;Švyturėlių;4864779439;Taip;0;0;3;3
6395;Pasakaitė;Švyturėlių;8223662339;Taip;0;0;1;1
6396;Pasakaitė;Švyturėlių;3710143250;Taip;0;0;4;4
6397;Pasakaitė;Kodėlčiukų;9746401498;Ne;4;0;1;5
6398;Pasakaitė;Kodėlčiukų;6839399035;Ne;5;1;1;7
6399;Pasakaitė;Kodėlčiukų;1809383469;Taip;6;1;0;7
6400;Pasakaitė;Kodėlčiukų;2742595829;Taip;0;0;2;2
6401;Pasakaitė;Kodėlčiukų;1592521766;Taip;0;0;2;2
6402;Pasakaitė;Kodėlčiukų;6983619733;Taip;5;0;0;5
6403;Pasakaitė;Kodėlčiukų;9506178305;Taip;7;0;0;7
6404;Pasakaitė;Kodėlčiukų;24096031951;Taip;6;0;1;7
6405;Pasakaitė;Kodėlčiukų;11001677712;Taip;0;0;7;7
6406;Pasakaitė;Kodėlčiukų;9914689534;Taip;0;0;6;6
6407;Pasakaitė;Kodėlčiukų;8225188274;Taip;0;8;0;8
6408;Pasakaitė;Kodėlčiukų;1940545723;Taip;0;0;4;4
6409;Pasakaitė;Kodėlčiukų;73957497029;Taip;4;0;0;4
6410;Pasakaitė;Kodėlčiukų;4008826950;Taip;0;0;9;9
6411;Pasakaitė;Kodėlčiukų;4648014383;Taip;0;1;1;2
6412;Pasakaitė;Gudručių;18105216772;Taip;0;4;0;4
6413;Pasakaitė;Gudručių;45157801238;Taip;0;0;1;1
6414;Pasakaitė;Gudručių;88885227604;Taip;0;0;1;1
6415;Pasakaitė;Gudručių;17218793370;Taip;0;0;4;4
6416;Pasakaitė;Gudručių;33418184802;Taip;5;0;0;5
6417;Pasakaitė;Gudručių;2210519019;Taip;5;0;1;6
6418;Pasakaitė;Gudručių;82475369612;Taip;0;1;0;1
6419;Pasakaitė;Gudručių;96648719544;Taip;0;11;0;11
6420;Pasakaitė;Gudručių;5954676615;Taip;0;0;3;3
6421;Pasakaitė;Gudručių;88077831193;Taip;5;0;7;12
6422;Pasakaitė;Čiulbonėlių;27702516199;Taip;0;0;1;1
6423;Pasakaitė;Čiulbonėlių;46891856500;Taip;5;0;1;6
6424;Pasakaitė;Čiulbonėlių;1827070201;Taip;0;0;2;2
6425;Pasakaitė;Čiulbonėlių;1320898756;Ne;0;0;3;3
6426;Pasakaitė;Čiulbonėlių;26714845001;Taip;9;0;2;11
6427;Pasakaitė;Čiulbonėlių;1673576868;Taip;0;10;0;10
6428;Pasakaitė;Čiulbonėlių;3397132786;Ne;0;12;0;12
6429;Pasakaitė;Čiulbonėlių;1032113089;Taip;0;0;7;7
6430;Pasakaitė;Čiulbonėlių;6346678827;Ne;8;0;6;14
6431;Pasakaitė;Čiulbonėlių;1027136050;Taip;0;0;1;1
6432;Pasakaitė;Čiulbonėlių;22071058323;Taip;18;0;3;21
6433;Pasakaitė;Čiulbonėlių;9175612991;Taip;16;0;0;16
6434;Pasakaitė;Čiulbonėlių;1769070351;Taip;0;5;0;5
6435;Pasakaitė;Čiulbonėlių;1198248619;Taip;0;3;0;3
6436;Pasakaitė;Čiulbonėlių;8638071584;Ne;0;0;4;4
6437;Pasakaitė;Čiulbonėlių;29699532850;Taip;4;0;1;5
6438;Pasakaitė;"Verpstelių ";7621306769;Taip;0;10;0;10
6439;Pasakaitė;"Verpstelių ";4946855684;Taip;8;4;0;12
6440;Pasakaitė;"Verpstelių ";5556362727;Taip;0;0;3;3
6441;Pasakaitė;"Verpstelių ";7451624229;Taip;0;0;2;2
6442;Pasakaitė;"Verpstelių ";7759051761;Taip;3;0;0;3
6443;Pasakaitė;"Verpstelių ";8315840473;Taip;0;0;5;5
6444;Pasakaitė;"Verpstelių ";1744216870;Taip;0;0;8;8
6445;Pasakaitė;"Verpstelių ";1425166722;Taip;0;0;10;10
6446;Pasakaitė;"Verpstelių ";7813221735;Taip;0;0;2;2
6447;Pasakaitė;"Verpstelių ";9166649594;Taip;5;0;0;5
6448;Pasakaitė;"Verpstelių ";4246461594;Taip;0;0;15;15
6449;Pasakaitė;"Verpstelių ";8267725352;Taip;7;0;0;7
6450;Pasakaitė;"Verpstelių ";5866092980;Taip;5;0;5;10
6451;Pasakaitė;"Verpstelių ";8562284745;Taip;0;1;0;1
6452;Pasakaitė;"Verpstelių ";1041405418;Taip;8;2;0;10
6453;Pasakaitė;"Verpstelių ";7976921380;Taip;0;11;1;12
6454;Pasakaitė;"Verpstelių ";2505815026;Taip;5;0;4;9
6455;Pasakaitė;"Verpstelių ";5413457806;Taip;10;0;1;11
6456;Pasakaitė;Smalsučiai;5732009054;Taip;5;0;2;7
6457;Pasakaitė;Smalsučiai;5540251866;Taip;5;0;0;5
6458;Pasakaitė;Smalsučiai;7539851375;Taip;10;0;0;10
6459;Pasakaitė;Smalsučiai;6755983130;Taip;9;0;0;9
6460;Pasakaitė;Smalsučiai;7666033916;Taip;13;0;0;13
6461;Pasakaitė;Smalsučiai;7219080600;Taip;0;3;0;3
6462;Pasakaitė;Smalsučiai;8264189678;Taip;5;0;0;5
6463;Pasakaitė;"Čiauškučiai ";5617173998;Taip;5;0;1;6
6464;Pasakaitė;"Čiauškučiai ";2303884875;Taip;5;0;0;5
6465;Pasakaitė;"Čiauškučiai ";7360801624;Taip;5;0;0;5
6466;Pasakaitė;"Čiauškučiai ";9543262464;Taip;7;0;0;7
6467;Pasakaitė;"Čiauškučiai ";2933474317;Taip;8;0;0;8
6468;Pasakaitė;"Čiauškučiai ";3283593388;Taip;3;0;0;3
6469;Pasakaitė;Pabiručiai;9303146842;Taip;5;0;1;6
6470;Pasakaitė;Pabiručiai;2389832646;Taip;0;5;0;5
6471;Pasakaitė;Linksmučiai;2733800758;Taip;2;0;0;2
6472;Pasakaitė;Linksmučiai;3355268509;Taip;9;0;0;9
6473;Pasakaitė;Linksmučiai;3417077517;Taip;0;0;4;4
6474;Pasakaitė;Linksmučiai;9238905834;Taip;0;0;1;1
6475;Pasakaitė;Linksmučiai;3381303531;Taip;0;0;1;1
6476;Pelenė;Varpelis;120966603;Taip;0;2;0;2
6477;Pelenė;Varpelis;3465518545;Taip;0;0;2;2
6478;Pelenė;Varpelis;6289619123;Taip;0;0;6;6
6479;Pelenė;Varpelis;3299454566;Taip;0;6;0;6
6480;Pelenė;Varpelis;1038583766;Taip;0;0;1;1
6481;Pelenė;Varpelis;1483843416;Taip;0;10;0;10
6482;Pelenė;Varpelis;2400806788;Taip;0;0;3;3
6483;Pelenė;Varpelis;42431378466;Taip;0;0;2;2
6484;Pelenė;Varpelis;17572291941;Taip;0;1;0;1
6485;Pelenė;Varpelis;9019827941;Taip;0;0;3;3
6486;Pelenė;Varpelis;2677995903;Ne;8;0;0;8
6487;Pelenė;Varpelis;2072863178;Taip;0;1;0;1
6488;Pelenė;Varpelis;1050272821;Taip;0;3;0;3
6489;Pelenė;Varpelis;51979406888;Taip;0;0;2;2
6490;Pelenė;Varpelis;26010775076;Taip;0;0;4;4
6491;Pelenė;Saulutės;7880284433;Ne;3;0;0;3
6492;Pelenė;Saulutės;2737277656;Taip;5;0;1;6
6493;Pelenė;Saulutės;9186679454;Taip;0;0;1;1
6494;Pelenė;Saulutės;1775717256;Ne;11;0;1;12
6495;Pelenė;Saulutės;4315677064;Taip;5;0;4;9
6496;Pelenė;Saulutės;7587887488;Taip;0;6;0;6
6497;Pelenė;Saulutės;5389865440;Ne;0;0;1;1
6498;Pelenė;Saulutės;8716395810;Taip;0;1;0;1
6499;Pelenė;Saulutės;6191899254;Taip;3;3;1;7
6500;Pelenė;Saulutės;1902314385;Taip;0;3;0;3
6501;Pelenė;Saulutės;6707167720;Taip;0;0;3;3
6502;Pelenė;Saulutės;8466974910;Taip;4;0;1;5
6503;Pelenė;Saulutės;9621197758;Taip;21;0;0;21
6504;Pelenė;Saulutės;5780697554;Taip;7;0;2;9
6505;Pelenė;Saulutės;4989239822;Taip;0;0;1;1
6506;Pelenė;Raktelis;9195113444;Taip;7;8;0;15
6507;Pelenė;Raktelis;9075193730;Ne;0;0;1;1
6508;Pelenė;Raktelis;7114993398;Ne;13;0;0;13
6509;Pelenė;Raktelis;4591637887;Ne;8;0;1;9
6510;Pelenė;Raktelis;7088493729;Taip;0;0;1;1
6511;Pelenė;Raktelis;4090532624;Ne;0;12;0;12
6512;Pelenė;Raktelis;8123162647;Taip;0;2;0;2
6513;Pelenė;Raktelis;9063588699;Taip;0;0;14;14
6514;Pelenė;Raktelis;3573543545;Taip;5;10;0;15
6515;Pelenė;Raktelis;7659625628;Taip;0;0;3;3
6516;Pelenė;Raktelis;6375060159;Taip;0;13;0;13
6517;Pelenė;Raktelis;2210314952;Taip;4;0;1;5
6518;Pelenė;Raktelis;6419661741;Taip;0;7;0;7
6519;Pelenė;Raktelis;4089199552;Taip;6;0;0;6
6520;Pelenė;Raktelis;6038229659;Taip;0;1;0;1
6521;Pelenė;Raktelis;1067737206;Ne;0;1;0;1
6522;Pelenė;Raktelis;4448592497;Ne;7;0;0;7
6523;Pelenė;Raktelis;5333802902;Taip;8;2;0;10
6524;Pelenė;Žvaigždutės;8404317146;Taip;0;0;2;2
6525;Pelenė;Žvaigždutės;3497915398;Taip;0;12;0;12
6526;Pelenė;Žvaigždutės;2154553741;Taip;0;7;0;7
6527;Pelenė;Žvaigždutės;8598498275;Taip;0;6;0;6
6528;Pelenė;Žvaigždutės;3131930907;Taip;0;0;4;4
6529;Pelenė;Žvaigždutės;1710249888;Taip;5;0;0;5
6530;Pelenė;Žvaigždutės;45410683361;Ne;6;0;1;7
6531;Pelenė;Žvaigždutės;5081903157;Taip;0;6;0;6
6532;Pelenė;Žvaigždutės;1781704945;Taip;0;0;3;3
6533;Pelenė;Žvaigždutės;39705461573;Ne;0;3;0;3
6534;Pelenė;Žvaigždutės;6632188229;Taip;0;4;0;4
6535;Pelenė;Žvaigždutės;5356756237;Ne;0;0;1;1
6536;Pelenė;Žvaigždutės;9009271610;Taip;0;9;0;9
6537;Pelenė;Žvaigždutės;5325176433;Taip;0;11;0;11
6538;Pelenė;Žvaigždutės;4624325473;Taip;0;1;0;1
6539;Pelenė;Nykštukas;4541391191;Taip;0;0;2;2
6540;Pelenė;Nykštukas;3296147024;Taip;0;5;0;5
6541;Pelenė;Nykštukas;8607110629;Taip;4;5;0;9
6542;Pelenė;Nykštukas;9584503078;Taip;5;0;0;5
6543;Pelenė;Nykštukas;10457480694;Taip;0;0;9;9
6544;Pelenė;Nykštukas;6181604926;Taip;0;0;1;1
6545;Pelenė;Nykštukas;7254981715;Ne;0;2;0;2
6546;Pelenė;Nykštukas;8721423900;Taip;11;0;1;12
6547;Pelenė;Nykštukas;6579504852;Taip;0;0;6;6
6548;Pelenė;Nykštukas;1978481168;Taip;0;0;1;1
6549;Pelenė;Nykštukas;3385568839;Taip;0;12;0;12
6550;Pelenė;Nykštukas;3189305906;Taip;5;0;3;8
6551;Pelenė;Nykštukas;1750366978;Taip;10;0;0;10
6552;Pelenė;Nykštukas;2092775878;Taip;0;6;0;6
6553;Pelenė;Nykštukas;8675348688;Taip;0;0;1;1
6554;Pelenė;Nykštukas;7836778389;Taip;0;3;0;3
6555;Pelenė;Žirniukai;7714061272;Taip;0;5;0;5
6556;Pelenė;Žirniukai;9547823986;Taip;0;0;7;7
6557;Pelenė;Žirniukai;8529178313;Taip;3;0;0;3
6558;Pelenė;Žirniukai;6046921077;Ne;3;0;0;3
6559;Pelenė;Žirniukai;7057752202;Ne;0;0;4;4
6560;Pelenė;Žirniukai;2578580626;Taip;7;0;0;7
6561;Pelenė;Žirniukai;7399112026;Ne;5;0;0;5
6562;Pelenė;Žirniukai;3500358886;Taip;0;0;1;1
6563;Pelenė;Žirniukai;2443906444;Taip;0;0;3;3
6564;Pelenė;Žirniukai;5922348478;Ne;5;0;0;5
6565;Pelenė;Žirniukai;1313425695;Ne;10;0;0;10
6566;Pelenė;Žirniukai;5801430256;Taip;10;0;0;10
6567;Pelenė;Žirniukai;1595627222;Ne;3;3;0;6
6568;Pelenė;Lašeliai;8807342148;Ne;0;0;1;1
6569;Pelenė;Lašeliai;2487632125;Taip;0;0;1;1
6570;Pelenė;Lašeliai;4777496709;Ne;0;0;1;1
6571;Pelenė;Lašeliai;4373886054;Taip;3;1;0;4
6572;Pelenė;Lašeliai;2647876561;Taip;0;3;0;3
6573;Pelenė;Lašeliai;8194354176;Taip;0;4;0;4
6574;Pelenė;Lašeliai;4004975235;Taip;9;0;0;9
6575;Pelenė;Lašeliai;8790613872;Taip;9;0;0;9
6576;Pelenė;Lašeliai;5228983908;Taip;0;0;2;2
6577;Pelenė;Lašeliai;3174009848;Taip;10;0;0;10
6578;Pelenė;Lašeliai;8038559319;Taip;0;0;2;2
6579;Pelenė;Lašeliai;4376033711;Taip;0;1;0;1
6580;Pelenė;Lašeliai;9447223913;Taip;5;0;0;5
6581;Pelenė;Lašeliai;6894978459;Taip;11;0;0;11
6582;Pelenė;Lašeliai;2103177773;Taip;3;0;0;3
6583;Pelenė;Lašeliai;6864263698;Taip;17;0;1;18
6584;Pelenė;Lašeliai;7578318198;Taip;7;2;0;9
6585;Pelenė;Lašeliai;1080017906;Taip;9;0;0;9
6586;Pelenė;Grūdelis;311074533;Ne;10;0;0;10
6587;Pelenė;Grūdelis;71274664713;Taip;0;13;0;13
6588;Pelenė;Grūdelis;78648474464;Ne;0;0;4;4
6589;Pelenė;Grūdelis;52690820;Taip;0;0;1;1
6590;Pelenė;Grūdelis;4178071578;Ne;0;3;0;3
6591;Pelenė;Grūdelis;6937587856;Taip;0;2;0;2
6592;Pelenė;Grūdelis;1289416312;Taip;0;0;1;1
6593;Pelenė;Grūdelis;8813044848;Taip;0;0;1;1
6594;Pelenė;Grūdelis;96840961754;Taip;1;4;0;5
6595;Pelenė;Grūdelis;61012202440;Taip;0;0;6;6
6596;Pelenė;Grūdelis;5804848640;Taip;0;0;5;5
6597;Pelenė;Grūdelis;34765342495;Taip;0;5;0;5
6598;Pelenė;Grūdelis;62484999314;Taip;3;0;0;3
6599;Pelenė;Grūdelis;4386060612;Ne;0;0;2;2
6600;Pelenė;Grūdelis;1183026351;Taip;0;5;0;5
6601;Pelenė;Braškytė;3663288138;Ne;0;0;2;2
6602;Pelenė;Braškytė;7602432318;Ne;1;0;0;1
6603;Pelenė;Braškytė;9162252512;Taip;0;0;6;6
6604;Pelenė;Braškytė;1944933777;Ne;0;2;0;2
6605;Pelenė;Braškytė;9638268554;Taip;3;0;0;3
6606;Pelenė;Braškytė;4431474395;Ne;5;0;0;5
6607;Pelenė;Braškytė;9097123374;Ne;8;0;0;8
6608;Pelenė;Braškytė;6167965418;Ne;6;0;0;6
6609;Pelenė;Braškytė;4695104609;Ne;0;3;0;3
6610;Pelenė;Braškytė;2765650058;Taip;8;0;2;10
6611;Pelenė;Braškytė;8841183816;Taip;0;0;2;2
6612;Pelenė;Braškytė;7383544475;Taip;1;0;0;1
6613;Pelenė;Boružėlės;5587759166;Ne;0;0;1;1
6614;Pelenė;Boružėlės;7565331966;Taip;5;0;1;6
6615;Pelenė;Boružėlės;4056676361;Taip;0;0;2;2
6616;Pelenė;Boružėlės;4870187198;Taip;9;0;1;10
6617;Pelenė;Boružėlės;2476080951;Taip;0;6;0;6
6618;Pelenė;Boružėlės;5894429453;Ne;0;0;1;1
6619;Pelenė;Boružėlės;7614130590;Taip;0;0;1;1
6620;Pelenė;Boružėlės;2555464779;Ne;10;0;0;10
6621;Pelenė;Boružėlės;4737217659;Ne;0;0;1;1
6622;Pelenė;Boružėlės;5548367924;Ne;7;0;1;8
6623;Pelenė;Boružėlės;7640768043;Taip;9;0;0;9
6624;Pelenė;Boružėlės;8623480143;Ne;0;0;2;2
6625;Pelenė;Boružėlės;2040256240;Taip;7;0;1;8
6626;Pelenė;Boružėlės;4856039707;Taip;4;0;2;6
6627;Pelenė;Boružėlės;6014571367;Taip;3;0;0;3
6628;Pelenė;Saldainiukai;5028095861;Taip;2;0;0;2
6629;Pelenė;Saldainiukai;9505945890;Ne;7;0;0;7
6630;Pelenė;Saldainiukai;2986690431;Ne;5;0;1;6
6631;Pelenė;Saldainiukai;2734891342;Taip;1;0;0;1
6632;Pelenė;Saldainiukai;4051874126;Taip;0;1;0;1
6633;Pelenė;Saldainiukai;1804898751;Taip;3;0;0;3
6634;Pelenė;Drugeliai;2540405047;Taip;0;0;3;3
6635;Pelenė;Drugeliai;6221703608;Taip;14;0;0;14
6636;Pelenė;Drugeliai;3603352172;Taip;0;5;0;5
6637;Pelenė;Drugeliai;5084452088;Taip;0;4;0;4
6638;Pelenė;Drugeliai;9218868317;Taip;5;0;1;6
6639;Pelenė;Drugeliai;2628676128;Taip;5;0;2;7
6640;Pelenė;Drugeliai;9810123679;Taip;0;12;0;12
6641;Pelenė;Drugeliai;2322908067;Taip;3;0;6;9
6642;Pelenė;Drugeliai;1048899958;Taip;5;0;6;11
6643;Pelenė;Drugeliai;5786052354;Ne;2;0;0;2
6644;Pelenė;Drugeliai;3327213856;Taip;6;0;1;7
6645;Pelenė;Drugeliai;7865562941;Ne;0;0;2;2
6646;Pelenė;Drugeliai;7977133699;Taip;5;0;0;5
6647;Pelenė;Drugeliai;6252972353;Taip;5;0;1;6
6648;Pelenė;Drugeliai;1584256570;Taip;1;0;0;1
6649;Pelenė;Drugeliai;3205331614;Taip;0;0;1;1
6650;Pelenė;Drugeliai;8414727016;Taip;2;0;3;5
6651;Pelenė;Drugeliai;5631629419;Ne;13;0;0;13
6652;Pelenė;Drugeliai;2163737781;Taip;0;2;0;2
6653;Pipiras;EŽIUKAI;1485565125;Ne;0;2;0;2
6654;Pipiras;EŽIUKAI;3652741639;Taip;2;1;0;3
6655;Pipiras;EŽIUKAI;2637950013;Taip;12;0;0;12
6656;Pipiras;EŽIUKAI;1751427121;Taip;4;7;0;11
6657;Pipiras;EŽIUKAI;1293250996;Taip;0;9;0;9
6658;Pipiras;EŽIUKAI;2061168407;Taip;0;2;0;2
6659;Pipiras;EŽIUKAI;8088285579;Taip;0;1;0;1
6660;Pipiras;EŽIUKAI;1082396096;Taip;0;8;0;8
6661;Pipiras;EŽIUKAI;71283505646;Taip;0;6;0;6
6662;Pipiras;EŽIUKAI;1324680675;Taip;0;2;0;2
6663;Pipiras;EŽIUKAI;1876870081;Taip;0;11;0;11
6664;Pipiras;EŽIUKAI;2030170020;Taip;0;16;0;16
6665;Pipiras;EŽIUKAI;1114377378;Taip;0;3;0;3
6666;Pipiras;EŽIUKAI;1371141047;Taip;20;0;0;20
6667;Pipiras;EŽIUKAI;2096009051;Ne;0;20;0;20
6668;Pipiras;EŽIUKAI;1305696178;Taip;3;0;0;3
6669;Pipiras;EŽIUKAI;23600769349;Taip;0;3;0;3
6670;Pipiras;BITUTĖS;3554786173;Taip;0;5;0;5
6671;Pipiras;BITUTĖS;5725956659;Taip;8;0;0;8
6672;Pipiras;BITUTĖS;7934365114;Ne;0;1;0;1
6673;Pipiras;BITUTĖS;2075041950;Taip;12;5;0;17
6674;Pipiras;BITUTĖS;9840040112;Taip;0;21;0;21
6675;Pipiras;BITUTĖS;3852848863;Taip;0;1;0;1
6676;Pipiras;BITUTĖS;5235868332;Taip;0;8;0;8
6677;Pipiras;BITUTĖS;7350131214;Taip;6;1;0;7
6678;Pipiras;BITUTĖS;7161727352;Taip;0;14;0;14
6679;Pipiras;BITUTĖS;5225533488;Taip;3;0;0;3
6680;Pipiras;BITUTĖS;6792777396;Taip;0;2;0;2
6681;Pipiras;BITUTĖS;1784839485;Taip;0;15;0;15
6682;Pipiras;BITUTĖS;3775916247;Taip;1;1;0;2
6683;Pipiras;BITUTĖS;5845498558;Taip;0;4;0;4
6684;Pipiras;BITUTĖS;3882437376;Taip;2;2;0;4
6685;Pipiras;BITUTĖS;9770780973;Taip;16;0;0;16
6686;Pipiras;BITUTĖS;6523189501;Taip;0;21;0;21
6687;Pipiras;BITUTĖS;6342044341;Ne;3;6;0;9
6688;Pipiras;BITUTĖS;6780333972;Taip;0;8;0;8
6689;Pipiras;BITUTĖS;1034182352;Taip;0;7;0;7
6690;Pipiras;NYKŠTUKAI;1045583136;Taip;0;21;0;21
6691;Pipiras;NYKŠTUKAI;4811029230;Taip;0;11;0;11
6692;Pipiras;NYKŠTUKAI;6791495556;Taip;0;1;0;1
6693;Pipiras;NYKŠTUKAI;5422547144;Taip;7;4;0;11
6694;Pipiras;NYKŠTUKAI;6363349541;Taip;0;1;0;1
6695;Pipiras;NYKŠTUKAI;4266424785;Taip;0;8;0;8
6696;Pipiras;NYKŠTUKAI;6748400056;Taip;0;21;0;21
6697;Pipiras;NYKŠTUKAI;1242260242;Taip;0;1;0;1
6698;Pipiras;NYKŠTUKAI;6685567970;Taip;0;5;0;5
6699;Pipiras;NYKŠTUKAI;8520454289;Taip;0;8;0;8
6700;Pipiras;NYKŠTUKAI;4426479971;Taip;0;3;0;3
6701;Pipiras;NYKŠTUKAI;2267192782;Taip;0;8;0;8
6702;Pipiras;NYKŠTUKAI;5445858240;Taip;0;10;0;10
6703;Pipiras;NYKŠTUKAI;4725221169;Taip;0;2;0;2
6704;Pipiras;NYKŠTUKAI;5059203266;Taip;7;0;0;7
6705;Pipiras;NYKŠTUKAI;5856735452;Ne;7;0;0;7
6706;Pipiras;PELĖDŽIUKAI;4428216634;Taip;0;11;0;11
6707;Pipiras;PELĖDŽIUKAI;6694920607;Taip;0;2;0;2
6708;Pipiras;PELĖDŽIUKAI;3325511140;Taip;5;1;0;6
6709;Pipiras;PELĖDŽIUKAI;7870521230;Taip;0;6;0;6
6710;Pipiras;PELĖDŽIUKAI;5778300856;Taip;5;0;0;5
6711;Pipiras;PELĖDŽIUKAI;3888552150;Taip;0;16;0;16
6712;Pipiras;PELĖDŽIUKAI;7026118693;Taip;0;3;0;3
6713;Pipiras;PELĖDŽIUKAI;1391682850;Taip;0;2;0;2
6714;Pipiras;PELĖDŽIUKAI;87924002679;Taip;0;5;0;5
6715;Pipiras;PELĖDŽIUKAI;6136423200;Taip;9;0;0;9
6716;Pipiras;PELĖDŽIUKAI;7912217889;Ne;0;1;0;1
6717;Pipiras;PELĖDŽIUKAI;5502001191;Taip;15;0;0;15
6718;Pipiras;PELĖDŽIUKAI;9275905384;Taip;0;3;0;3
6719;Pipiras;PELĖDŽIUKAI;4496076326;Taip;0;4;0;4
6720;Pipiras;PELĖDŽIUKAI;3141822820;Taip;0;8;0;8
6721;Pipiras;PELĖDŽIUKAI;4456861303;Taip;0;9;0;9
6722;Pipiras;PELĖDŽIUKAI;3357866319;Taip;0;4;0;4
6723;Pipiras;PELĖDŽIUKAI;1144813356;Taip;0;5;0;5
6724;Pipiras;DRUGELIAI;41585818819;Taip;3;7;0;10
6725;Pipiras;DRUGELIAI;5577759167;Taip;1;11;0;12
6726;Pipiras;DRUGELIAI;7799786844;Ne;3;4;0;7
6727;Pipiras;DRUGELIAI;5014457985;Ne;0;2;0;2
6728;Pipiras;DRUGELIAI;4927845000;Ne;0;9;0;9
6729;Pipiras;DRUGELIAI;1904376366;Taip;0;7;0;7
6730;Pipiras;DRUGELIAI;1128674099;Taip;0;5;0;5
6731;Pipiras;DRUGELIAI;3422170541;Taip;0;2;0;2
6732;Pipiras;DRUGELIAI;1391958633;Taip;0;7;0;7
6733;Pipiras;DRUGELIAI;7784343130;Taip;5;8;0;13
6734;Pipiras;DRUGELIAI;3622164823;Taip;0;9;0;9
6735;Pipiras;DRUGELIAI;3008358842;Ne;2;3;0;5
6736;Pipiras;DRUGELIAI;2024777430;Taip;6;5;0;11
6737;Pipiras;DRUGELIAI;4959823035;Taip;0;3;0;3
6738;Pipiras;DRUGELIAI;6339186940;Taip;0;6;0;6
6739;Pipiras;DRUGELIAI;3314276870;Ne;0;5;0;5
6740;Pipiras;DRUGELIAI;5637557921;Taip;0;6;0;6
6741;Pipiras;DRUGELIAI;1050430252;Ne;0;6;0;6
6742;Pipiras;DRUGELIAI;2255644686;Taip;0;6;0;6
6743;Pipiras;DRUGELIAI;7736031786;Taip;0;5;0;5
6744;Pipiras;DRUGELIAI;9479697733;Taip;10;3;0;13
6745;Pipiras;DRUGELIAI;6153579332;Taip;1;4;0;5
6746;Pipiras;DRUGELIAI;2402351134;Taip;0;2;0;2
6747;Pipiras;GĖLYTĖS;56325056631;Taip;0;7;0;7
6748;Pipiras;GĖLYTĖS;81335131932;Taip;0;10;0;10
6749;Pipiras;GĖLYTĖS;23377947863;Taip;0;7;0;7
6750;Pipiras;GĖLYTĖS;87831792882;Taip;0;12;0;12
6751;Pipiras;GĖLYTĖS;1417855241;Taip;0;2;0;2
6752;Pipiras;GĖLYTĖS;1791226869;Taip;0;3;0;3
6753;Pipiras;GĖLYTĖS;60652954862;Taip;0;2;0;2
6754;Pipiras;GĖLYTĖS;27808576289;Taip;0;3;0;3
6755;Pipiras;GĖLYTĖS;5114553619;Taip;0;8;0;8
6756;Pipiras;GĖLYTĖS;1780531222;Taip;0;14;0;14
6757;Pipiras;GĖLYTĖS;18211174874;Taip;0;1;0;1
6758;Pipiras;GĖLYTĖS;4246712256;Taip;0;4;0;4
6759;Pipiras;GĖLYTĖS;25000181631;Taip;0;9;0;9
6760;Pipiras;GĖLYTĖS;56822466210;Taip;0;7;0;7
6761;Pipiras;GĖLYTĖS;23663823688;Taip;5;3;0;8
6762;Pipiras;BORUŽĖLĖS;54633757340;Taip;0;8;0;8
6763;Pipiras;BORUŽĖLĖS;68636458010;Taip;0;4;0;4
6764;Pipiras;BORUŽĖLĖS;57459408180;Taip;0;14;0;14
6765;Pipiras;BORUŽĖLĖS;7354253729;Taip;0;8;0;8
6766;Pipiras;BORUŽĖLĖS;99551392640;Taip;0;1;0;1
6767;Pipiras;BORUŽĖLĖS;9423015002;Taip;0;1;0;1
6768;Pipiras;BORUŽĖLĖS;68235713574;Taip;0;4;0;4
6769;Pipiras;BORUŽĖLĖS;63605758339;Taip;0;1;0;1
6770;Pipiras;BORUŽĖLĖS;23794561369;Taip;0;13;0;13
6771;Pipiras;BORUŽĖLĖS;46165404909;Taip;0;19;0;19
6772;Pipiras;BORUŽĖLĖS;92764472620;Taip;0;1;0;1
6773;Pipiras;BORUŽĖLĖS;6804964469;Taip;0;7;0;7
6774;Pipiras;BORUŽĖLĖS;81817710888;Taip;0;10;0;10
6775;Pipiras;BORUŽĖLĖS;7448924569;Taip;0;10;0;10
6776;Pipiras;BORUŽĖLĖS;1676986127;Taip;0;1;0;1
6777;Pipiras;BORUŽĖLĖS;1334584865;Taip;0;10;0;10
6778;Pipiras;BORUŽĖLĖS;1657721144;Taip;0;18;0;18
6779;Pipiras;BORUŽĖLĖS;6766596656;Taip;0;6;0;6
6780;Pipiras;SKRUZDĖLIUKAI;7969837759;Taip;11;4;0;15
6781;Pipiras;SKRUZDĖLIUKAI;2483867901;Taip;10;0;0;10
6782;Pipiras;SKRUZDĖLIUKAI;1315372873;Taip;0;8;0;8
6783;Pipiras;SKRUZDĖLIUKAI;1711168196;Taip;3;5;0;8
6784;Pipiras;SKRUZDĖLIUKAI;9372109848;Taip;0;1;0;1
6785;Pipiras;SKRUZDĖLIUKAI;8296425777;Taip;0;1;0;1
6786;Pipiras;SKRUZDĖLIUKAI;9968182443;Taip;0;3;0;3
6787;Pipiras;SKRUZDĖLIUKAI;8819018248;Taip;0;4;0;4
6788;Pipiras;SKRUZDĖLIUKAI;3768825314;Taip;3;0;1;4
6789;Pipiras;SKRUZDĖLIUKAI;5888429623;Taip;0;8;0;8
6790;Pipiras;SKRUZDĖLIUKAI;4309096743;Taip;0;0;2;2
6791;Pipiras;SKRUZDĖLIUKAI;2399588759;Taip;0;3;0;3
6792;Pipiras;SKRUZDĖLIUKAI;7212820879;Taip;0;2;0;2
6793;Pipiras;SKRUZDĖLIUKAI;3935474148;Taip;0;2;0;2
6794;Pipiras;SKRUZDĖLIUKAI;8081343184;Taip;0;2;0;2
6795;Pipiras;SKRUZDĖLIUKAI;9852475056;Taip;5;0;0;5
6796;Pipiras;SKRUZDĖLIUKAI;6176818802;Taip;13;0;0;13
6797;Pipiras;SKRUZDĖLIUKAI;6570068615;Taip;0;1;0;1
6798;Pipiras;ŽVIRBLIUKŲ;70940029154;Taip;0;14;0;14
6799;Pipiras;ŽVIRBLIUKŲ;1232620336;Taip;7;8;0;15
6800;Pipiras;ŽVIRBLIUKŲ;37087220885;Taip;0;1;0;1
6801;Pipiras;ŽVIRBLIUKŲ;1700856741;Taip;0;9;0;9
6802;Pipiras;ŽVIRBLIUKŲ;1757192919;Taip;0;2;0;2
6803;Pipiras;ŽVIRBLIUKŲ;1417086043;Taip;0;2;0;2
6804;Pipiras;ŽVIRBLIUKŲ;1008228932;Ne;0;4;0;4
6805;Pipiras;ŽVIRBLIUKŲ;1182415963;Taip;0;7;0;7
6806;Pipiras;ŽVIRBLIUKŲ;8657924258;Taip;0;2;0;2
6807;Pipiras;ŽVIRBLIUKŲ;66816368717;Ne;0;2;0;2
6808;Pipiras;ZUIKUČIŲ;6310054093;Taip;0;15;0;15
6809;Pipiras;ZUIKUČIŲ;5137132420;Ne;0;1;0;1
6810;Pipiras;ZUIKUČIŲ;6034298583;Taip;11;6;0;17
6811;Pipiras;ZUIKUČIŲ;9976869100;Taip;0;1;0;1
6812;Pipiras;ZUIKUČIŲ;8508292428;Taip;0;1;1;2
6813;Pipiras;ZUIKUČIŲ;1210940213;Taip;7;2;0;9
6814;Pipiras;ZUIKUČIŲ;9730269905;Taip;6;0;0;6
6815;Pipiras;ZUIKUČIŲ;9248925267;Taip;0;4;0;4
6816;Pipiras;ZUIKUČIŲ;3531862496;Taip;5;2;0;7
6817;Pipiras;ZUIKUČIŲ;9970587185;Taip;0;1;0;1
6818;Pipiras;ZUIKUČIŲ;8959946514;Taip;0;4;0;4
6819;Pipiras;ZUIKUČIŲ;9391811395;Taip;0;5;0;5
6820;Pipiras;VARLIUKŲ;9625933545;Taip;0;1;0;1
6821;Pipiras;VARLIUKŲ;4945164161;Ne;0;1;0;1
6822;Pipiras;VARLIUKŲ;7362002646;Taip;0;4;0;4
6823;Pipiras;VARLIUKŲ;6453274205;Taip;0;10;0;10
6824;Pipiras;VARLIUKŲ;7157187063;Taip;0;13;0;13
6825;Pipiras;VARLIUKŲ;9097987789;Taip;1;0;0;1
6826;Pipiras;VARLIUKŲ;4021613243;Taip;0;1;0;1
6827;Pipiras;VARLIUKŲ;1611488078;Taip;2;0;0;2
6828;Pipiras;VARLIUKŲ;4236597883;Taip;0;6;0;6
6829;Pipiras;VARLIUKŲ;2474548836;Taip;0;4;0;4
6830;Pipiras;VARLIUKŲ;5738334591;Taip;0;1;0;1
6831;Pipiras;VARLIUKŲ;6428525902;Taip;0;1;0;1
6832;Pipiras;ŽIOGELIŲ;6696824728;Taip;0;3;0;3
6833;Pipiras;ŽIOGELIŲ;2016718354;Taip;5;10;0;15
6834;Pipiras;ŽIOGELIŲ;4510888337;Taip;0;2;0;2
6835;Pipiras;ŽIOGELIŲ;3980950261;Taip;0;2;0;2
6836;Pipiras;ŽIOGELIŲ;5908707752;Taip;0;7;0;7
6837;Pipiras;ŽIOGELIŲ;6775489564;Taip;4;1;0;5
6838;Pipiras;ŽIOGELIŲ;4017042461;Taip;5;2;0;7
6839;Pipiras;ŽIOGELIŲ;9892201598;Taip;0;3;0;3
6840;Pipiras;ŽIOGELIŲ;8422419380;Taip;0;2;0;2
6841;Pipiras;ŽIOGELIŲ;1019753152;Ne;5;6;0;11
6842;Pipiras;ŽIOGELIŲ;5141447649;Taip;0;2;0;2
6843;Pipiras;ŽIOGELIŲ;3329510128;Taip;11;1;0;12
6844;Pipiras;ŽIOGELIŲ;7371386368;Taip;0;2;0;2
6845;Pipiras;ŽIOGELIŲ;9877682150;Taip;0;7;0;7
6846;Pipiras;ŽIOGELIŲ;7425654504;Taip;0;8;0;8
6847;"Prie pasakų parko";ZUIKUČIAI;7776961789;Taip;0;0;1;1
6848;"Prie pasakų parko";ZUIKUČIAI;6963058612;Taip;7;2;0;9
6849;"Prie pasakų parko";ZUIKUČIAI;5030871828;Taip;0;0;8;8
6850;"Prie pasakų parko";ZUIKUČIAI;6280870972;Ne;0;0;2;2
6851;"Prie pasakų parko";ZUIKUČIAI;1738732866;Taip;11;0;1;12
6852;"Prie pasakų parko";ZUIKUČIAI;6606867989;Taip;16;0;0;16
6853;"Prie pasakų parko";ZUIKUČIAI;5901884512;Taip;12;0;0;12
6854;"Prie pasakų parko";ZUIKUČIAI;2217627240;Taip;6;0;5;11
6855;"Prie pasakų parko";ZUIKUČIAI;1734916661;Ne;5;0;0;5
6856;"Prie pasakų parko";ZUIKUČIAI;2206221105;Taip;10;0;2;12
6857;"Prie pasakų parko";ZUIKUČIAI;3464990457;Taip;0;0;1;1
6858;"Prie pasakų parko";ZUIKUČIAI;6423712775;Ne;4;0;0;4
6859;"Prie pasakų parko";ZUIKUČIAI;4183640714;Taip;18;0;0;18
6860;"Prie pasakų parko";ZUIKUČIAI;5222603743;Taip;5;0;0;5
6861;"Prie pasakų parko";ZUIKUČIAI;4380468764;Taip;10;0;0;10
6862;"Prie pasakų parko";PAUKŠČIUKŲ;1316127369;Ne;10;0;0;10
6863;"Prie pasakų parko";PAUKŠČIUKŲ;4037594669;Taip;6;0;1;7
6864;"Prie pasakų parko";PAUKŠČIUKŲ;4457827262;Taip;16;0;0;16
6865;"Prie pasakų parko";PAUKŠČIUKŲ;6700916147;Taip;6;0;1;7
6866;"Prie pasakų parko";PAUKŠČIUKŲ;9225775914;Taip;4;0;0;4
6867;"Prie pasakų parko";PAUKŠČIUKŲ;4868465692;Taip;10;0;0;10
6868;"Prie pasakų parko";PAUKŠČIUKŲ;3381053227;Taip;5;0;0;5
6869;"Prie pasakų parko";PAUKŠČIUKŲ;9799198904;Taip;15;0;0;15
6870;"Prie pasakų parko";PAUKŠČIUKŲ;4726737519;Taip;11;0;0;11
6871;"Prie pasakų parko";PAUKŠČIUKŲ;2515928623;Taip;5;0;3;8
6872;"Prie pasakų parko";PAUKŠČIUKŲ;2661900328;Taip;0;0;2;2
6873;"Prie pasakų parko";PAUKŠČIUKŲ;2654978735;Taip;8;0;7;15
6874;"Prie pasakų parko";PAUKŠČIUKŲ;3202292611;Ne;3;0;0;3
6875;"Prie pasakų parko";PAUKŠČIUKŲ;4674683653;Taip;0;0;3;3
6876;"Prie pasakų parko";PAUKŠČIUKŲ;7739970115;Taip;16;0;1;17
6877;"Prie pasakų parko";"LINKSMOJI ŠEIMYNĖLĖ (SPEC)";3825101647;Ne;21;0;0;21
6878;"Prie pasakų parko";"LINKSMOJI ŠEIMYNĖLĖ (SPEC)";9847622676;Ne;5;0;1;6
6879;"Prie pasakų parko";"LINKSMOJI ŠEIMYNĖLĖ (SPEC)";7710346116;Ne;5;0;2;7
6880;"Prie pasakų parko";"LINKSMOJI ŠEIMYNĖLĖ (SPEC)";9327121033;Ne;5;0;0;5
6881;"Prie pasakų parko";"LINKSMOJI ŠEIMYNĖLĖ (SPEC)";2133790263;Ne;5;0;0;5
6882;"Prie pasakų parko";NYKŠTUKŲ;6992830082;Taip;7;0;0;7
6883;"Prie pasakų parko";NYKŠTUKŲ;1588062393;Taip;0;0;10;10
6884;"Prie pasakų parko";NYKŠTUKŲ;1278065349;Taip;9;0;0;9
6885;"Prie pasakų parko";NYKŠTUKŲ;2781262009;Taip;9;0;0;9
6886;"Prie pasakų parko";NYKŠTUKŲ;3356307067;Ne;4;0;6;10
6887;"Prie pasakų parko";NYKŠTUKŲ;8574432191;Taip;0;0;2;2
6888;"Prie pasakų parko";NYKŠTUKŲ;4181676762;Taip;0;7;0;7
6889;"Prie pasakų parko";NYKŠTUKŲ;8318567916;Taip;0;9;0;9
6890;"Prie pasakų parko";NYKŠTUKŲ;2160440145;Taip;9;0;0;9
6891;"Prie pasakų parko";NYKŠTUKŲ;8189217660;Ne;0;8;0;8
6892;"Prie pasakų parko";NYKŠTUKŲ;8215830508;Ne;10;2;0;12
6893;"Prie pasakų parko";NYKŠTUKŲ;2216634402;Taip;15;0;3;18
6894;"Prie pasakų parko";NYKŠTUKŲ;5862570666;Taip;6;0;2;8
6895;"Prie pasakų parko";NYKŠTUKŲ;4548803933;Taip;0;0;9;9
6896;"Prie pasakų parko";NYKŠTUKŲ;9926991259;Taip;7;4;0;11
6897;"Prie pasakų parko";NYKŠTUKŲ;5304082676;Taip;12;0;5;17
6898;"Prie pasakų parko";NYKŠTUKŲ;6250610187;Taip;7;10;0;17
6899;"Prie pasakų parko";NYKŠTUKŲ;3504938510;Taip;6;0;1;7
6900;"Prie pasakų parko";NYKŠTUKŲ;9190379838;Taip;3;0;6;9
6901;"Prie pasakų parko";LAŠELIŲ;1182188784;Taip;0;0;1;1
6902;"Prie pasakų parko";LAŠELIŲ;8205731591;Taip;10;0;6;16
6903;"Prie pasakų parko";LAŠELIŲ;34800098950;Taip;5;0;0;5
6904;"Prie pasakų parko";LAŠELIŲ;8618280811;Ne;0;0;6;6
6905;"Prie pasakų parko";LAŠELIŲ;1204812495;Taip;0;7;0;7
6906;"Prie pasakų parko";LAŠELIŲ;7844351275;Taip;2;0;1;3
6907;"Prie pasakų parko";LAŠELIŲ;6273733995;Ne;0;1;2;3
6908;"Prie pasakų parko";LAŠELIŲ;1369637618;Taip;5;0;1;6
6909;"Prie pasakų parko";LAŠELIŲ;4900757614;Taip;0;0;2;2
6910;"Prie pasakų parko";"KAČIUKAI (SPEC)";6772736175;Taip;6;0;0;6
6911;"Prie pasakų parko";"KAČIUKAI (SPEC)";9715586563;Ne;0;0;9;9
6912;"Prie pasakų parko";"KAČIUKAI (SPEC)";7000191099;Ne;0;0;1;1
6913;"Prie pasakų parko";"KAČIUKAI (SPEC)";6937555692;Taip;0;4;0;4
6914;"Prie pasakų parko";"KAČIUKAI (SPEC)";28574450739;Taip;7;0;0;7
6915;"Prie pasakų parko";"KAČIUKAI (SPEC)";3579974049;Taip;0;3;0;3
6916;"Prie pasakų parko";"ANČIUKAI (SPEC)";9469871636;Ne;11;0;3;14
6917;"Prie pasakų parko";"ANČIUKAI (SPEC)";6245610875;Taip;14;0;2;16
6918;"Prie pasakų parko";"ANČIUKAI (SPEC)";8339335908;Ne;7;0;0;7
6919;"Prie pasakų parko";"ANČIUKAI (SPEC)";5518041213;Taip;0;0;2;2
6920;"Prie pasakų parko";"ANČIUKAI (SPEC)";8738488104;Taip;0;0;2;2
6921;"Prie pasakų parko";TIGRIUKAI;7858530013;Taip;15;0;0;15
6922;"Prie pasakų parko";TIGRIUKAI;4521556853;Taip;20;0;0;20
6923;"Prie pasakų parko";TIGRIUKAI;2641473764;Taip;8;0;0;8
6924;"Prie pasakų parko";TIGRIUKAI;3918269702;Taip;0;0;6;6
6925;"Prie pasakų parko";TIGRIUKAI;5026203678;Taip;10;0;3;13
6926;"Prie pasakų parko";TIGRIUKAI;2516448580;Taip;5;0;1;6
6927;"Prie pasakų parko";TIGRIUKAI;6446562388;Taip;12;0;0;12
6928;"Prie pasakų parko";TIGRIUKAI;2168919559;Taip;8;1;0;9
6929;"Prie pasakų parko";TIGRIUKAI;5186675623;Taip;12;0;1;13
6930;"Prie pasakų parko";TIGRIUKAI;8899375521;Ne;14;0;0;14
6931;"Prie pasakų parko";TIGRIUKAI;6710735721;Taip;6;0;1;7
6932;"Prie pasakų parko";TIGRIUKAI;2898016639;Taip;3;0;2;5
6933;"Prie pasakų parko";TIGRIUKAI;6561145380;Taip;14;0;0;14
6934;"Prie pasakų parko";TIGRIUKAI;9476448601;Taip;6;0;1;7
6935;"Prie pasakų parko";TIGRIUKAI;8029428034;Taip;11;0;1;12
6936;"Prie pasakų parko";TIGRIUKAI;3795705735;Taip;11;1;0;12
6937;"Prie pasakų parko";TIGRIUKAI;8715851643;Taip;10;0;2;12
6938;"Prie pasakų parko";TIGRIUKAI;3617673265;Taip;0;0;3;3
6939;"Prie pasakų parko";"EŽIUKŲ (SPEC)";7851357992;Taip;0;0;21;21
6940;"Prie pasakų parko";"EŽIUKŲ (SPEC)";2820889357;Ne;7;1;0;8
6941;"Prie pasakų parko";"EŽIUKŲ (SPEC)";1549137154;Taip;7;0;1;8
6942;"Prie pasakų parko";"EŽIUKŲ (SPEC)";7545372781;Ne;0;0;2;2
6943;"Prie pasakų parko";"EŽIUKŲ (SPEC)";29445903073;Taip;5;12;0;17
6944;"Prie pasakų parko";"EŽIUKŲ (SPEC)";8849417734;Taip;0;0;6;6
6945;"Prie pasakų parko";"EŽIUKŲ (SPEC)";7327208141;Ne;19;0;0;19
6946;"Prie pasakų parko";"EŽIUKŲ (SPEC)";7115825217;Taip;11;0;1;12
6947;"Prie pasakų parko";"EŽIUKŲ (SPEC)";2952868428;Taip;5;10;0;15
6948;"Prie pasakų parko";"BORUŽIUKŲ (SPEC)";2080597774;Taip;0;0;3;3
6949;"Prie pasakų parko";"BORUŽIUKŲ (SPEC)";8817950372;Taip;0;7;0;7
6950;"Prie pasakų parko";"BORUŽIUKŲ (SPEC)";4203385836;Ne;1;1;0;2
6951;"Prie pasakų parko";"BORUŽIUKŲ (SPEC)";92307951922;Taip;3;7;0;10
6952;Pumpurėlis;RAMUNĖLIŲ;6977710645;Ne;10;0;0;10
6953;Pumpurėlis;RAMUNĖLIŲ;9431295796;Taip;0;10;4;14
6954;Pumpurėlis;RAMUNĖLIŲ;1395380236;Taip;4;0;6;10
6955;Pumpurėlis;RAMUNĖLIŲ;9424449290;Taip;0;16;0;16
6956;Pumpurėlis;RAMUNĖLIŲ;5171198109;Taip;0;6;1;7
6957;Pumpurėlis;RAMUNĖLIŲ;9726028397;Taip;17;0;0;17
6958;Pumpurėlis;RAMUNĖLIŲ;7229289985;Taip;15;0;0;15
6959;Pumpurėlis;RAMUNĖLIŲ;2969734731;Ne;0;0;2;2
6960;Pumpurėlis;RAMUNĖLIŲ;7559071945;Taip;6;2;1;9
6961;Pumpurėlis;RAMUNĖLIŲ;6511527480;Taip;0;0;2;2
6962;Pumpurėlis;RAMUNĖLIŲ;3838705973;Taip;11;0;1;12
6963;Pumpurėlis;RAMUNĖLIŲ;6726875853;Taip;0;0;1;1
6964;Pumpurėlis;RAMUNĖLIŲ;7996736781;Taip;0;8;1;9
6965;Pumpurėlis;RAMUNĖLIŲ;8667762689;Ne;5;2;0;7
6966;Pumpurėlis;RAMUNĖLIŲ;3874188848;Ne;10;0;1;11
6967;Pumpurėlis;VARPELIŲ;3101133244;Ne;4;0;0;4
6968;Pumpurėlis;VARPELIŲ;3893768713;Ne;0;14;0;14
6969;Pumpurėlis;VARPELIŲ;5023658988;Ne;0;8;0;8
6970;Pumpurėlis;VARPELIŲ;2668855786;Taip;0;4;8;12
6971;Pumpurėlis;VARPELIŲ;8258560345;Taip;10;1;0;11
6972;Pumpurėlis;VARPELIŲ;9612924972;Taip;0;1;0;1
6973;Pumpurėlis;VARPELIŲ;9884099545;Taip;5;0;6;11
6974;Pumpurėlis;VARPELIŲ;1687770779;Taip;0;0;21;21
6975;Pumpurėlis;VARPELIŲ;3733509497;Taip;0;6;0;6
6976;Pumpurėlis;VARPELIŲ;4508966729;Taip;0;0;3;3
6977;Pumpurėlis;VARPELIŲ;9552913910;Taip;9;2;1;12
6978;Pumpurėlis;VARPELIŲ;5196733185;Taip;4;0;0;4
6979;Pumpurėlis;VARPELIŲ;4928495108;Taip;0;1;0;1
6980;Pumpurėlis;VARPELIŲ;8886730333;Taip;21;0;0;21
6981;Pumpurėlis;VARPELIŲ;2247300456;Taip;0;0;3;3
6982;Pumpurėlis;VARPELIŲ;5564680653;Taip;0;0;6;6
6983;Pumpurėlis;VARPELIŲ;1411232443;Taip;0;0;1;1
6984;Pumpurėlis;VARPELIŲ;6780042929;Ne;0;11;0;11
6985;Pumpurėlis;VARPELIŲ;7182107790;Taip;6;0;0;6
6986;Pumpurėlis;DRUGELIŲ;25029630023;Taip;0;1;0;1
6987;Pumpurėlis;DRUGELIŲ;1230058211;Taip;0;15;0;15
6988;Pumpurėlis;DRUGELIŲ;1053338730;Taip;0;0;4;4
6989;Pumpurėlis;DRUGELIŲ;1261919194;Taip;0;0;1;1
6990;Pumpurėlis;DRUGELIŲ;1397924008;Taip;0;10;11;21
6991;Pumpurėlis;DRUGELIŲ;6230500803;Ne;0;0;4;4
6992;Pumpurėlis;DRUGELIŲ;2129779614;Taip;0;4;0;4
6993;Pumpurėlis;DRUGELIŲ;2102427499;Taip;0;1;0;1
6994;Pumpurėlis;DRUGELIŲ;9724549899;Taip;9;0;6;15
6995;Pumpurėlis;DRUGELIŲ;9317495169;Taip;0;4;0;4
6996;Pumpurėlis;DRUGELIŲ;6535398274;Taip;0;2;0;2
6997;Pumpurėlis;DRUGELIŲ;9733380187;Taip;0;0;1;1
6998;Pumpurėlis;DRUGELIŲ;83388662869;Ne;0;0;1;1
6999;Pumpurėlis;DRUGELIŲ;1248017244;Taip;1;0;1;2
7000;Pumpurėlis;DRUGELIŲ;1306102772;Ne;21;0;0;21
7001;Pumpurėlis;DRUGELIŲ;7666345002;Ne;0;0;1;1
7002;Pumpurėlis;KODĖLČIUKŲ;9224879966;Taip;13;0;1;14
7003;Pumpurėlis;KODĖLČIUKŲ;8830261792;Taip;0;0;1;1
7004;Pumpurėlis;KODĖLČIUKŲ;9583257172;Taip;0;5;0;5
7005;Pumpurėlis;KODĖLČIUKŲ;9138883172;Taip;0;5;0;5
7006;Pumpurėlis;KODĖLČIUKŲ;7533555059;Taip;5;2;1;8
7007;Pumpurėlis;KODĖLČIUKŲ;6669327226;Taip;0;5;1;6
7008;Pumpurėlis;KODĖLČIUKŲ;87061817106;Taip;0;1;1;2
7009;Pumpurėlis;KODĖLČIUKŲ;1835168438;Taip;0;21;0;21
7010;Pumpurėlis;KODĖLČIUKŲ;5615260965;Taip;0;0;2;2
7011;Pumpurėlis;KODĖLČIUKŲ;4344595328;Ne;0;13;0;13
7012;Pumpurėlis;KODĖLČIUKŲ;3298821054;Ne;0;0;2;2
7013;Pumpurėlis;KODĖLČIUKŲ;8806961007;Taip;7;0;1;8
7014;Pumpurėlis;KODĖLČIUKŲ;9439363363;Ne;0;0;1;1
7015;Pumpurėlis;KODĖLČIUKŲ;5964953923;Taip;5;0;2;7
7016;Pumpurėlis;KODĖLČIUKŲ;1492810528;Taip;0;4;0;4
7017;Pumpurėlis;KODĖLČIUKŲ;8747439652;Ne;0;0;2;2
7018;Pumpurėlis;KODĖLČIUKŲ;2629702959;Ne;0;4;0;4
7019;Pumpurėlis;LINELIS;98061041685;Taip;0;1;0;1
7020;Pumpurėlis;LINELIS;1921332565;Taip;0;1;0;1
7021;Pumpurėlis;LINELIS;40267078306;Ne;5;1;0;6
7022;Pumpurėlis;LINELIS;1439043505;Taip;0;1;1;2
7023;Pumpurėlis;LINELIS;94636926281;Ne;0;2;0;2
7024;Pumpurėlis;LINELIS;1287902351;Taip;3;5;0;8
7025;Pumpurėlis;LINELIS;1027125361;Taip;0;2;0;2
7026;Pumpurėlis;LINELIS;1264017142;Ne;5;1;0;6
7027;Pumpurėlis;LINELIS;1620037477;Taip;3;1;0;4
7028;Pumpurėlis;LINELIS;1867989314;Taip;3;0;0;3
7029;Pumpurėlis;LINELIS;13358453137;Taip;5;0;0;5
7030;Pumpurėlis;LINELIS;1209654095;Taip;0;4;0;4
7031;Pumpurėlis;LINELIS;88732170322;Taip;0;2;0;2
7032;Pumpurėlis;LINELIS;1346602122;Taip;0;1;0;1
7033;Pumpurėlis;SAULUTĖS;14529305564;Ne;3;0;0;3
7034;Pumpurėlis;SAULUTĖS;1400057487;Ne;0;1;1;2
7035;Pumpurėlis;SAULUTĖS;1274293175;Ne;0;8;0;8
7036;Pumpurėlis;SAULUTĖS;1298302188;Taip;0;1;0;1
7037;Pumpurėlis;SAULUTĖS;3231167303;Taip;4;0;0;4
7038;Pumpurėlis;SAULUTĖS;1333429949;Taip;0;1;0;1
7039;Pumpurėlis;SAULUTĖS;71979455611;Ne;0;1;0;1
7040;Pumpurėlis;SAULUTĖS;1527144198;Taip;4;6;0;10
7041;Pumpurėlis;SAULUTĖS;2028515310;Taip;0;6;0;6
7042;Pumpurėlis;SAULUTĖS;74144468541;Taip;0;1;0;1
7043;Pumpurėlis;SAULUTĖS;72719147901;Ne;0;2;0;2
7044;Pumpurėlis;SAULUTĖS;26859673794;Taip;15;1;0;16
7045;Pumpurėlis;SAULUTĖS;57949968899;Taip;4;0;3;7
7046;Pumpurėlis;BITUTĖS;4985045047;Taip;0;0;4;4
7047;Pumpurėlis;BITUTĖS;2651037375;Taip;5;0;4;9
7048;Pumpurėlis;BITUTĖS;1768239820;Taip;0;0;2;2
7049;Pumpurėlis;BITUTĖS;2566557351;Ne;0;0;3;3
7050;Pumpurėlis;BITUTĖS;4426697956;Taip;0;0;5;5
7051;Pumpurėlis;BITUTĖS;7363814444;Taip;0;0;6;6
7052;Pumpurėlis;BITUTĖS;3405169131;Taip;5;0;2;7
7053;Pumpurėlis;BITUTĖS;3951445693;Taip;0;0;7;7
7054;Pumpurėlis;BITUTĖS;8505655534;Taip;7;0;0;7
7055;Pumpurėlis;BITUTĖS;9612924316;Taip;0;0;6;6
7056;Pumpurėlis;BITUTĖS;5194285627;Ne;0;6;0;6
7057;Pumpurėlis;BITUTĖS;8655389224;Taip;8;1;0;9
7058;Pumpurėlis;BITUTĖS;1674341906;Taip;4;0;0;4
7059;Pumpurėlis;BITUTĖS;1130280140;Ne;12;0;1;13
7060;Pumpurėlis;BITUTĖS;1933502038;Ne;0;0;1;1
7061;Pumpurėlis;BITUTĖS;2230191718;Ne;4;0;0;4
7062;Pumpurėlis;DOBILIUKAI;1839505206;Ne;0;5;0;5
7063;Pumpurėlis;DOBILIUKAI;3970253545;Ne;5;0;0;5
7064;Pumpurėlis;DOBILIUKAI;1808734330;Ne;7;0;0;7
7065;Pumpurėlis;DOBILIUKAI;6968264923;Ne;7;0;1;8
7066;Pumpurėlis;DOBILIUKAI;7038597556;Ne;14;0;0;14
7067;Pumpurėlis;DOBILIUKAI;4130539703;Ne;11;1;0;12
7068;Pumpurėlis;DOBILIUKAI;6307988067;Taip;0;2;0;2
7069;Pumpurėlis;DOBILIUKAI;3374174445;Ne;9;2;0;11
7070;Pumpurėlis;DOBILIUKAI;3398517047;Taip;0;2;0;2
7071;Pumpurėlis;DOBILIUKAI;1961282282;Ne;6;0;0;6
7072;Pumpurėlis;DOBILIUKAI;5438584331;Taip;2;0;0;2
7073;Pumpurėlis;DOBILIUKAI;7276322999;Taip;3;0;0;3
7074;Pumpurėlis;DOBILIUKAI;9058493247;Ne;0;0;1;1
7075;Pumpurėlis;DOBILIUKAI;3214652626;Taip;0;10;0;10
7076;Pumpurėlis;DOBILIUKAI;5444879430;Ne;0;5;0;5
7077;Pumpurėlis;DOBILIUKAI;7825190756;Ne;5;0;1;6
7078;Pumpurėlis;DOBILIUKAI;1438740562;Taip;3;0;0;3
7079;Pumpurėlis;PUPYČIŲ;2368226822;Ne;6;0;0;6
7080;Pumpurėlis;PUPYČIŲ;7078621340;Ne;4;0;0;4
7081;Pumpurėlis;PUPYČIŲ;9417688597;Ne;0;0;3;3
7082;Pumpurėlis;PUPYČIŲ;5835115428;Ne;3;0;2;5
7083;Pumpurėlis;PUPYČIŲ;5897036076;Ne;0;0;6;6
7084;Pumpurėlis;PUPYČIŲ;5468796954;Ne;4;0;3;7
7085;Pumpurėlis;PUPYČIŲ;1538548768;Ne;0;0;15;15
7086;Pumpurėlis;PUPYČIŲ;7832408524;Ne;5;0;3;8
7087;Pumpurėlis;PUPYČIŲ;8644853849;Ne;15;0;1;16
7088;Pumpurėlis;PUPYČIŲ;9996789041;Taip;2;0;0;2
7089;Pumpurėlis;PUPYČIŲ;8320987208;Ne;0;0;2;2
7090;Pumpurėlis;PUPYČIŲ;9640790401;Ne;5;0;5;10
7091;Pumpurėlis;PUPYČIŲ;9032255874;Ne;15;0;0;15
7092;Pumpurėlis;PUPYČIŲ;7055989095;Ne;14;0;2;16
7093;Pumpurėlis;PUPYČIŲ;3088476130;Ne;5;0;4;9
7094;Pumpurėlis;PUPYČIŲ;2684592319;Ne;0;1;1;2
7095;Pumpurėlis;ŽIRNIUKŲ;6004234378;Ne;7;0;0;7
7096;Pumpurėlis;ŽIRNIUKŲ;3748601124;Ne;4;3;0;7
7097;Pumpurėlis;ŽIRNIUKŲ;6978091765;Ne;5;0;10;15
7098;Pumpurėlis;ŽIRNIUKŲ;8070486897;Ne;15;0;0;15
7099;Pumpurėlis;ŽIRNIUKŲ;9839285886;Ne;3;1;0;4
7100;Pumpurėlis;ŽIRNIUKŲ;6433757421;Ne;0;0;3;3
7101;Pumpurėlis;ŽIRNIUKŲ;8697451319;Ne;5;0;0;5
7102;Pumpurėlis;ŽIRNIUKŲ;6702744879;Ne;5;0;5;10
7103;Pumpurėlis;ŽIRNIUKŲ;6117720533;Ne;4;0;0;4
7104;Pumpurėlis;ŽIRNIUKŲ;2890596967;Ne;7;0;0;7
7105;Pumpurėlis;ŽIRNIUKŲ;7685203905;Ne;5;0;2;7
7106;Pumpurėlis;ŽIRNIUKŲ;3328647987;Ne;9;0;3;12
7107;Pumpurėlis;ŽIRNIUKŲ;2611141763;Ne;0;0;2;2
7108;Pumpurėlis;ŽIRNIUKŲ;9650395309;Ne;5;1;0;6
7109;Pumpurėlis;ŽIRNIUKŲ;4196409137;Ne;0;2;3;5
7110;Pumpurėlis;BORUŽĖLIŲ;49767198843;Taip;0;0;1;1
7111;Pumpurėlis;BORUŽĖLIŲ;42611228425;Ne;0;1;0;1
7112;Pumpurėlis;BORUŽĖLIŲ;68035717481;Taip;0;0;1;1
7113;Pumpurėlis;BORUŽĖLIŲ;1568701327;Ne;0;0;1;1
7114;Pumpurėlis;BORUŽĖLIŲ;1842097360;Ne;0;0;2;2
7115;Pumpurėlis;BORUŽĖLIŲ;82659096039;Taip;0;2;0;2
7116;Pumpurėlis;BORUŽĖLIŲ;1098875585;Taip;0;20;0;20
7117;Pumpurėlis;BORUŽĖLIŲ;1034745510;Taip;2;0;3;5
7118;Pumpurėlis;BORUŽĖLIŲ;5364345261;Taip;0;0;1;1
7119;Pumpurėlis;BORUŽĖLIŲ;1617303626;Taip;0;1;0;1
7120;Pumpurėlis;BORUŽĖLIŲ;1257222112;Ne;0;0;1;1
7121;Pumpurėlis;BORUŽĖLIŲ;81595634697;Taip;7;0;0;7
7122;Pumpurėlis;BORUŽĖLIŲ;1061975374;Taip;0;10;0;10
7123;Pumpurėlis;BORUŽĖLIŲ;5013491568;Ne;0;6;1;7
7124;Pumpurėlis;BORUŽĖLIŲ;7488342792;Ne;0;0;2;2
7125;Pumpurėlis;BORUŽĖLIŲ;6412442729;Ne;7;0;1;8
7126;Pumpurėlis;BORUŽĖLIŲ;3751769136;Ne;3;0;0;3
7127;Pumpurėlis;"NAUJA DARŽELIS";9363610488;Ne;0;3;0;3
7128;Pumpurėlis;"NAUJA DARŽELIS";6959214331;Ne;0;2;1;3
7129;Pumpurėlis;"NAUJA DARŽELIS";2905797053;Taip;0;1;0;1
7130;Puriena;Ančiukų;1758690169;Taip;0;7;1;8
7131;Puriena;Ančiukų;1240190350;Taip;0;2;0;2
7132;Puriena;Ančiukų;19157486407;Taip;0;1;0;1
7133;Puriena;Ančiukų;1557814435;Taip;0;2;0;2
7134;Puriena;Ančiukų;87523460146;Taip;0;6;0;6
7135;Puriena;Ančiukų;61241768982;Taip;6;6;0;12
7136;Puriena;Ančiukų;26980342372;Taip;0;1;0;1
7137;Puriena;Ančiukų;4260334053;Taip;0;3;0;3
7138;Puriena;Ančiukų;71778035373;Taip;10;5;0;15
7139;Puriena;Ančiukų;1184946421;Taip;5;0;3;8
7140;Puriena;Ančiukų;59193676476;Taip;6;7;0;13
7141;Puriena;Ančiukų;61117212576;Taip;0;0;2;2
7142;Puriena;Ančiukų;91069175088;Taip;9;0;0;9
7143;Puriena;Ančiukų;1418776789;Ne;3;0;1;4
7144;Puriena;Ančiukų;3327714361;Taip;5;0;1;6
7145;Puriena;Ančiukų;41863686552;Taip;0;4;0;4
7146;Puriena;Ančiukų;9684727228;Taip;11;0;1;12
7147;Puriena;Ančiukų;1318752282;Ne;11;0;1;12
7148;Puriena;Drugeliai;1658720269;Taip;0;0;1;1
7149;Puriena;Drugeliai;1150538358;Taip;6;2;0;8
7150;Puriena;Drugeliai;2966464432;Taip;5;0;2;7
7151;Puriena;Drugeliai;1521955898;Taip;10;0;0;10
7152;Puriena;Drugeliai;8881337164;Ne;5;1;0;6
7153;Puriena;Drugeliai;6914613438;Taip;3;0;0;3
7154;Puriena;Drugeliai;8159342676;Taip;10;0;0;10
7155;Puriena;Drugeliai;2321753665;Taip;14;0;0;14
7156;Puriena;Drugeliai;7021756459;Taip;5;2;0;7
7157;Puriena;Drugeliai;1564155036;Taip;4;0;3;7
7158;Puriena;Drugeliai;9098291788;Taip;0;1;2;3
7159;Puriena;Drugeliai;6613654824;Taip;0;1;0;1
7160;Puriena;Drugeliai;3738277048;Ne;5;4;0;9
7161;Puriena;Drugeliai;7562458336;Taip;7;0;1;8
7162;Puriena;Drugeliai;3579008577;Taip;14;0;2;16
7163;Puriena;Drugeliai;4248701232;Taip;9;0;2;11
7164;Puriena;Drugeliai;7477278612;Taip;0;5;0;5
7165;Puriena;Drugeliai;9847768390;Taip;2;8;2;12
7166;Puriena;Drugeliai;1449037968;Taip;0;4;0;4
7167;Puriena;Pelėdžiukai;2013783668;Taip;0;2;0;2
7168;Puriena;Pelėdžiukai;8874823029;Ne;0;0;1;1
7169;Puriena;Pelėdžiukai;3149718901;Taip;6;0;3;9
7170;Puriena;Pelėdžiukai;9041388275;Ne;0;2;0;2
7171;Puriena;Pelėdžiukai;3175917649;Taip;6;0;0;6
7172;Puriena;Pelėdžiukai;8061605125;Taip;5;0;1;6
7173;Puriena;Pelėdžiukai;2579402981;Taip;0;0;5;5
7174;Puriena;Pelėdžiukai;3671297035;Taip;5;5;0;10
7175;Puriena;Pelėdžiukai;2701942325;Taip;0;8;0;8
7176;Puriena;Pelėdžiukai;2267225709;Taip;0;0;3;3
7177;Puriena;Pelėdžiukai;6413337915;Taip;5;1;0;6
7178;Puriena;Pelėdžiukai;6197840105;Taip;2;0;19;21
7179;Puriena;Pelėdžiukai;4858971990;Taip;0;2;5;7
7180;Puriena;Pelėdžiukai;1417566073;Taip;5;2;0;7
7181;Puriena;Pelėdžiukai;6463129806;Taip;0;0;3;3
7182;Puriena;Pelėdžiukai;4501239330;Taip;0;2;0;2
7183;Puriena;Pelėdžiukai;5341228269;Taip;5;13;0;18
7184;Puriena;Pelėdžiukai;6352605894;Ne;0;0;1;1
7185;Puriena;Pelėdžiukai;6786694796;Taip;0;0;4;4
7186;Puriena;Pelėdžiukai;8952508230;Taip;0;0;3;3
7187;Puriena;Voveriukai;3826282438;Taip;3;0;1;4
7188;Puriena;Voveriukai;9453994213;Taip;17;0;0;17
7189;Puriena;Voveriukai;8497070167;Taip;5;13;0;18
7190;Puriena;Voveriukai;4517020977;Taip;10;2;0;12
7191;Puriena;Voveriukai;7811667336;Taip;10;0;5;15
7192;Puriena;Voveriukai;4283608124;Taip;5;1;0;6
7193;Puriena;Voveriukai;8144488922;Taip;0;0;2;2
7194;Puriena;Voveriukai;8476986855;Taip;8;2;0;10
7195;Puriena;Voveriukai;3627403517;Ne;0;0;1;1
7196;Puriena;Voveriukai;4070825932;Taip;0;0;1;1
7197;Puriena;Voveriukai;8130975863;Taip;0;1;0;1
7198;Puriena;Voveriukai;2813562677;Ne;0;1;0;1
7199;Puriena;Voveriukai;7120683581;Taip;0;6;0;6
7200;Puriena;Voveriukai;4653085762;Taip;10;1;0;11
7201;Puriena;Voveriukai;3542374463;Taip;0;1;0;1
7202;Puriena;Voveriukai;6883573289;Taip;10;1;7;18
7203;Puriena;Voveriukai;1933733714;Taip;0;2;0;2
7204;Puriena;Voveriukai;6150437624;Taip;0;11;0;11
7205;Puriena;Voveriukai;7169054113;Taip;5;2;0;7
7206;Puriena;Voveriukai;2717325252;Ne;0;0;4;4
7207;Puriena;Bitučių;71773966341;Taip;0;0;8;8
7208;Puriena;Bitučių;1945542034;Taip;0;6;0;6
7209;Puriena;Bitučių;79194353091;Taip;0;0;1;1
7210;Puriena;Bitučių;1629458651;Taip;0;0;1;1
7211;Puriena;Bitučių;91735621242;Ne;8;1;0;9
7212;Puriena;Bitučių;1116529845;Taip;0;0;4;4
7213;Puriena;Bitučių;98967026878;Taip;8;1;2;11
7214;Puriena;Bitučių;5284316470;Taip;0;3;0;3
7215;Puriena;Bitučių;84527348236;Ne;10;0;1;11
7216;Puriena;Bitučių;8719239663;Taip;0;3;0;3
7217;Puriena;Bitučių;63944407195;Taip;0;0;1;1
7218;Puriena;Bitučių;95153406240;Ne;0;0;2;2
7219;Puriena;Bitučių;1125102675;Ne;2;0;0;2
7220;Puriena;Bitučių;9666714143;Taip;0;0;2;2
7221;Puriena;Bitučių;1376708741;Taip;0;0;3;3
7222;Puriena;Bitučių;1507059980;Ne;0;0;4;4
7223;Puriena;Bitučių;5807510456;Taip;6;0;0;6
7224;Puriena;Bitučių;85334594528;Taip;0;7;1;8
7225;Puriena;Bitučių;1206969296;Ne;0;0;7;7
7226;Puriena;Bitučių;22643920380;Taip;0;0;1;1
7227;Puriena;Zylutės;7337038503;Taip;5;1;0;6
7228;Puriena;Zylutės;5891404983;Ne;9;0;0;9
7229;Puriena;Zylutės;63196502622;Taip;5;0;0;5
7230;Puriena;Zylutės;9239618299;Taip;0;11;0;11
7231;Puriena;Zylutės;2083071198;Taip;0;7;0;7
7232;Puriena;Zylutės;1443945321;Taip;8;1;1;10
7233;Puriena;Zylutės;20286870431;Ne;5;0;0;5
7234;Puriena;Zylutės;8618298134;Taip;0;11;0;11
7235;Puriena;Zylutės;1748337587;Taip;0;3;0;3
7236;Puriena;Zylutės;1820719083;Taip;11;2;0;13
7237;Puriena;Zylutės;2089174669;Taip;0;1;0;1
7238;Puriena;Zylutės;11497629767;Taip;5;2;0;7
7239;Puriena;Zylutės;47316276655;Ne;1;2;1;4
7240;Puriena;Zylutės;2146036332;Taip;0;1;0;1
7241;Puriena;Zylutės;2378865002;Taip;0;11;0;11
7242;Puriena;Zylutės;2131343339;Taip;0;3;0;3
7243;Puriena;Zylutės;8213725698;Ne;10;3;0;13
7244;Puriena;Zylutės;8707076857;Taip;3;0;0;3
7245;Puriena;Zylutės;48468411549;Taip;3;5;0;8
7246;Puriena;Zylutės;1703078658;Taip;11;2;0;13
7247;Puriena;Zylutės;6416145396;Ne;10;0;1;11
7248;Puriena;Zylutės;3031725530;Ne;5;1;0;6
7249;Puriena;Meškučių;9251058353;Ne;7;2;0;9
7250;Puriena;Meškučių;1030958414;Taip;0;0;1;1
7251;Puriena;Meškučių;7967288875;Ne;0;0;2;2
7252;Puriena;Meškučių;6158842119;Taip;6;12;3;21
7253;Puriena;Meškučių;3557013127;Taip;0;0;1;1
7254;Puriena;Meškučių;3681811493;Taip;3;0;0;3
7255;Puriena;Meškučių;4060087185;Taip;0;0;1;1
7256;Puriena;Meškučių;3033562627;Taip;5;3;0;8
7257;Puriena;Meškučių;5777076971;Taip;5;3;0;8
7258;Puriena;Meškučių;8310231540;Taip;11;0;0;11
7259;Puriena;Meškučių;4460575818;Taip;0;5;0;5
7260;Puriena;Meškučių;8120597514;Taip;0;0;3;3
7261;Puriena;Meškučių;5336923102;Taip;0;0;1;1
7262;Puriena;Meškučių;4605662701;Taip;0;11;0;11
7263;Puriena;Meškučių;1819876614;Taip;0;0;4;4
7264;Puriena;Meškučių;4776745276;Ne;0;0;7;7
7265;Puriena;Meškučių;7769252165;Taip;3;0;0;3
7266;Puriena;Meškučių;4100466337;Taip;0;0;3;3
7267;Puriena;Meškučių;6280465748;Taip;0;0;1;1
7268;Puriena;Meškučių;1907429094;Taip;3;0;1;4
7269;Puriena;Meškučių;6496291933;Ne;0;0;2;2
7270;Puriena;Nykštukų;2624283930;Taip;6;0;1;7
7271;Puriena;Nykštukų;3698868934;Taip;0;2;0;2
7272;Puriena;Nykštukų;6001659356;Taip;0;0;1;1
7273;Puriena;Nykštukų;3204824116;Taip;5;1;0;6
7274;Puriena;Nykštukų;7720549981;Taip;10;0;0;10
7275;Puriena;Nykštukų;6372465987;Taip;5;0;1;6
7276;Puriena;Nykštukų;5555076926;Taip;13;0;0;13
7277;Puriena;Nykštukų;2312297583;Taip;0;0;5;5
7278;Puriena;Nykštukų;5374864513;Taip;5;0;5;10
7279;Puriena;Nykštukų;1737249860;Taip;8;0;1;9
7280;Puriena;Ežiukai;9413672989;Ne;0;0;8;8
7281;Puriena;Ežiukai;5224135638;Ne;10;0;2;12
7282;Puriena;Ežiukai;6853706997;Taip;0;1;0;1
7283;Puriena;Ežiukai;1398572100;Taip;0;9;0;9
7284;Puriena;Ežiukai;9962011647;Taip;0;21;0;21
7285;Puriena;Ežiukai;1339162214;Taip;7;0;1;8
7286;Puriena;Ežiukai;9543884311;Taip;0;4;0;4
7287;Puriena;Ežiukai;8022809059;Taip;2;0;1;3
7288;Puriena;Ežiukai;4498919764;Taip;5;0;1;6
7289;Puriena;Ežiukai;5395382717;Taip;4;8;0;12
7290;Puriena;Ežiukai;8237149969;Taip;5;1;0;6
7291;Puriena;Ežiukai;4444523140;Ne;0;4;0;4
7292;Puriena;Ežiukai;8512814466;Taip;0;5;0;5
7293;Puriena;Ežiukai;7622407056;Taip;7;1;0;8
7294;Puriena;Ežiukai;6813480086;Taip;9;0;1;10
7295;Puriena;Ežiukai;4017644414;Ne;0;2;4;6
7296;Puriena;Ežiukai;8416003733;Taip;0;1;1;2
7297;Puriena;Ežiukai;8199607793;Ne;8;0;0;8
7298;Puriena;Ežiukai;9854244405;Ne;15;5;0;20
7299;Puriena;Ežiukai;6780164845;Taip;16;0;4;20
7300;Puriena;"Boružiukų ";5080805225;Taip;15;0;0;15
7301;Puriena;"Boružiukų ";6234132927;Taip;7;1;0;8
7302;Puriena;"Boružiukų ";9500729561;Taip;6;1;0;7
7303;Puriena;"Boružiukų ";1238475246;Taip;15;0;0;15
7304;Puriena;"Boružiukų ";5591189546;Taip;5;0;0;5
7305;Puriena;"Boružiukų ";7466163131;Taip;0;0;4;4
7306;Puriena;"Boružiukų ";8359978283;Taip;16;0;1;17
7307;Puriena;"Boružiukų ";2466609635;Ne;0;2;2;4
7308;Puriena;"Boružiukų ";9509041179;Taip;5;0;3;8
7309;Puriena;"Boružiukų ";5176663365;Taip;4;0;1;5
7310;Puriena;"Boružiukų ";2029981617;Taip;0;2;2;4
7311;Puriena;"Boružiukų ";6185080390;Taip;9;0;0;9
7312;Puriena;"Boružiukų ";3309219271;Taip;0;2;0;2
7313;Puriena;"Boružiukų ";3011629747;Taip;0;6;0;6
7314;Puriena;"Boružiukų ";9748726934;Taip;4;0;3;7
7315;Puriena;"Boružiukų ";3153330970;Taip;13;0;1;14
7316;Puriena;"Zuikučių ";6451492815;Taip;12;0;0;12
7317;Puriena;"Zuikučių ";4563681164;Taip;0;2;0;2
7318;Puriena;"Zuikučių ";3526684967;Taip;10;0;0;10
7319;Puriena;"Zuikučių ";7913847170;Taip;13;1;0;14
7320;Puriena;"Zuikučių ";8089081251;Taip;0;9;0;9
7321;Puriena;"Zuikučių ";9294208012;Ne;14;0;0;14
7322;Puriena;"Zuikučių ";6991740430;Taip;0;0;1;1
7323;Puriena;"Zuikučių ";9961074983;Taip;0;0;2;2
7324;Puriena;"Zuikučių ";2830409862;Ne;5;0;2;7
7325;Puriena;"Zuikučių ";8038573068;Taip;0;0;5;5
7326;Puriena;"Zuikučių ";4165800035;Taip;0;0;2;2
7327;Puriena;"Zuikučių ";9423229931;Taip;0;2;0;2
7328;Puriena;Skruzdėliukai;2203259310;Taip;0;0;1;1
7329;Puriena;Skruzdėliukai;7429832136;Taip;5;2;1;8
7330;Puriena;Skruzdėliukai;8478901457;Taip;0;5;0;5
7331;Puriena;Skruzdėliukai;9106525954;Taip;0;1;0;1
7332;Puriena;Skruzdėliukai;11242620566;Ne;8;2;0;10
7333;Puriena;Skruzdėliukai;6285846517;Taip;0;1;0;1
7334;Puriena;Skruzdėliukai;5999564879;Ne;0;6;0;6
7335;Puriena;Skruzdėliukai;9139110598;Ne;0;3;0;3
7336;Puriena;Skruzdėliukai;5501308683;Taip;4;2;0;6
7337;Puriena;Skruzdėliukai;2663832596;Taip;0;1;5;6
7338;Puriena;Skruzdėliukai;40573980976;Taip;0;12;0;12
7339;Puriena;Skruzdėliukai;6057477307;Taip;0;0;2;2
7340;Puriena;Skruzdėliukai;9146447088;Taip;0;21;0;21
7341;Puriena;Skruzdėliukai;1381379515;Taip;0;2;0;2
7342;Puriena;Skruzdėliukai;1290962809;Taip;0;1;0;1
7343;Puriena;Skruzdėliukai;1263637124;Taip;0;3;0;3
7344;Puriena;Skruzdėliukai;1290933817;Taip;0;1;0;1
7345;Puriena;Skruzdėliukai;8112003551;Taip;1;0;0;1
7346;Pušaitė;Kodėlčiukai;8702361596;Taip;5;1;3;9
7347;Pušaitė;Kodėlčiukai;3832434608;Taip;0;0;5;5
7348;Pušaitė;Kodėlčiukai;4838345510;Taip;3;1;3;7
7349;Pušaitė;Kodėlčiukai;2253477550;Taip;5;5;0;10
7350;Pušaitė;Kodėlčiukai;6275090953;Taip;0;1;0;1
7351;Pušaitė;Kodėlčiukai;8750774616;Taip;0;2;1;3
7352;Pušaitė;Kodėlčiukai;2004615252;Taip;0;1;0;1
7353;Pušaitė;Kodėlčiukai;4743105731;Taip;5;0;3;8
7354;Pušaitė;Kodėlčiukai;9391350218;Taip;0;6;0;6
7355;Pušaitė;Kodėlčiukai;7945713337;Taip;0;4;0;4
7356;Pušaitė;Kodėlčiukai;1935059739;Taip;0;2;14;16
7357;Pušaitė;Kodėlčiukai;3698808100;Taip;12;0;1;13
7358;Pušaitė;Kodėlčiukai;2793941689;Taip;8;7;0;15
7359;Pušaitė;Kodėlčiukai;4326967247;Taip;0;7;1;8
7360;Pušaitė;Kodėlčiukai;9527253696;Taip;0;1;0;1
7361;Pušaitė;Kodėlčiukai;4473930703;Ne;0;2;2;4
7362;Pušaitė;Kodėlčiukai;1996544496;Taip;18;0;0;18
7363;Pušaitė;Saulutės;1395577340;Taip;0;0;1;1
7364;Pušaitė;Saulutės;3959838346;Taip;5;0;1;6
7365;Pušaitė;Saulutės;5563772495;Ne;5;0;0;5
7366;Pušaitė;Saulutės;1534764228;Taip;5;0;0;5
7367;Pušaitė;Saulutės;4570064071;Taip;0;1;0;1
7368;Pušaitė;Saulutės;5839824399;Taip;0;1;0;1
7369;Pušaitė;Saulutės;2914302247;Taip;0;1;0;1
7370;Pušaitė;Saulutės;4511258460;Taip;4;0;0;4
7371;Pušaitė;Saulutės;5949199046;Taip;0;0;1;1
7372;Pušaitė;Saulutės;5328083339;Taip;6;0;0;6
7373;Pušaitė;Zuikučiai;2115591523;Taip;0;8;0;8
7374;Pušaitė;Zuikučiai;8738827821;Taip;5;0;1;6
7375;Pušaitė;Zuikučiai;2181510181;Taip;0;5;1;6
7376;Pušaitė;Zuikučiai;7477429922;Taip;5;2;0;7
7377;Pušaitė;Zuikučiai;6306133416;Taip;0;1;0;1
7378;Pušaitė;Zuikučiai;2099169654;Taip;0;0;1;1
7379;Pušaitė;Zuikučiai;6355379926;Ne;0;2;4;6
7380;Pušaitė;Zuikučiai;9389544351;Taip;0;21;0;21
7381;Pušaitė;Zuikučiai;1296700534;Taip;0;0;3;3
7382;Pušaitė;Zuikučiai;51500717235;Taip;0;21;0;21
7383;Pušaitė;Zuikučiai;2125574493;Ne;0;2;1;3
7384;Pušaitė;Zuikučiai;5398532705;Taip;0;9;1;10
7385;Pušaitė;Zuikučiai;8309000712;Taip;5;0;1;6
7386;Pušaitė;Zuikučiai;4881689337;Taip;0;0;1;1
7387;Pušaitė;Zuikučiai;3718196299;Taip;0;0;1;1
7388;Pušaitė;Zuikučiai;1295203136;Taip;0;1;11;12
7389;Pušaitė;Zuikučiai;6259961070;Taip;0;3;0;3
7390;Pušaitė;Zuikučiai;2944418714;Ne;15;6;0;21
7391;Pušaitė;Zuikučiai;3813761666;Ne;9;0;4;13
7392;Pušaitė;Zuikučiai;4762094720;Taip;5;0;1;6
7393;Pušaitė;Zuikučiai;6600314608;Taip;5;0;3;8
7394;Pušaitė;Zuikučiai;2130767942;Taip;12;5;0;17
7395;Pušaitė;Zuikučiai;6684979914;Taip;10;0;1;11
7396;Pušaitė;Vėžliukai;8412276797;Taip;0;1;0;1
7397;Pušaitė;Vėžliukai;1326581025;Taip;0;9;0;9
7398;Pušaitė;Vėžliukai;8135552679;Taip;4;4;0;8
7399;Pušaitė;Vėžliukai;5161142520;Taip;8;0;1;9
7400;Pušaitė;Vėžliukai;3485234259;Taip;11;1;0;12
7401;Pušaitė;Vėžliukai;3014867515;Taip;8;0;0;8
7402;Pušaitė;Vėžliukai;9470667227;Taip;6;1;0;7
7403;Pušaitė;Vėžliukai;1978339054;Taip;7;4;0;11
7404;Pušaitė;Vėžliukai;6739253961;Taip;8;0;1;9
7405;Pušaitė;Vėžliukai;7117784038;Taip;10;8;1;19
7406;Pušaitė;Vėžliukai;3014180020;Taip;0;0;1;1
7407;Pušaitė;Vėžliukai;7890577174;Taip;11;1;0;12
7408;Pušaitė;Vėžliukai;7652706756;Taip;2;2;0;4
7409;Pušaitė;Vėžliukai;5318602924;Taip;3;2;0;5
7410;Pušaitė;Vėžliukai;6794867560;Taip;0;0;1;1
7411;Pušaitė;Vėžliukai;6180888008;Taip;0;2;0;2
7412;Pušaitė;Vėžliukai;5296435012;Taip;2;5;0;7
7413;Pušaitė;Vėžliukai;6833083982;Taip;0;0;3;3
7414;Pušaitė;Vėžliukai;5512786073;Taip;12;6;0;18
7415;Pušaitė;Vėžliukai;8399589954;Taip;6;0;0;6
7416;Pušaitė;"Linksmieji nykštukai";9265357004;Ne;0;7;0;7
7417;Pušaitė;"Linksmieji nykštukai";3150144924;Taip;0;2;1;3
7418;Pušaitė;"Linksmieji nykštukai";7520393710;Taip;0;2;0;2
7419;Pušaitė;"Linksmieji nykštukai";4517181474;Ne;0;2;0;2
7420;Pušaitė;"Linksmieji nykštukai";9033615485;Taip;2;0;0;2
7421;Pušaitė;"Linksmieji nykštukai";3130824742;Taip;0;1;0;1
7422;Pušaitė;"Linksmieji nykštukai";4605161267;Taip;4;12;0;16
7423;Pušaitė;"Linksmieji nykštukai";6160825713;Taip;1;2;0;3
7424;Pušaitė;"Linksmieji nykštukai";1781601521;Taip;4;0;0;4
7425;Pušaitė;"Linksmieji nykštukai";1024996364;Taip;4;0;0;4
7426;Pušaitė;"Linksmieji nykštukai";4662871524;Taip;7;4;0;11
7427;Pušaitė;"Linksmieji nykštukai";8438652029;Taip;0;0;2;2
7428;Pušaitė;"Linksmieji nykštukai";6578483902;Taip;0;0;7;7
7429;Pušaitė;"Linksmieji nykštukai";4175909754;Taip;7;0;0;7
7430;Pušaitė;"Linksmieji nykštukai";3788392895;Taip;11;0;0;11
7431;Pušaitė;"Linksmieji nykštukai";3195191374;Taip;5;2;0;7
7432;Pušaitė;"Linksmieji nykštukai";9127444013;Taip;10;0;0;10
7433;Pušaitė;"Linksmieji nykštukai";5422784898;Ne;0;0;5;5
7434;Pušaitė;"Linksmieji nykštukai";5104111840;Taip;5;0;1;6
7435;Pušaitė;"Linksmieji nykštukai";9866431097;Taip;7;1;0;8
7436;Pušaitė;"Linksmieji nykštukai";4374232593;Ne;6;0;3;9
7437;Pušaitė;"Kačiukų trobelė";3695016765;Taip;5;0;11;16
7438;Pušaitė;"Kačiukų trobelė";5415680731;Taip;0;1;0;1
7439;Pušaitė;"Kačiukų trobelė";1122112207;Taip;0;1;4;5
7440;Pušaitė;"Kačiukų trobelė";1635528919;Taip;6;7;0;13
7441;Pušaitė;"Kačiukų trobelė";7014914682;Ne;0;2;0;2
7442;Pušaitė;"Kačiukų trobelė";8793102437;Ne;5;10;0;15
7443;Pušaitė;"Kačiukų trobelė";9056933586;Taip;11;1;0;12
7444;Pušaitė;"Kačiukų trobelė";7898355721;Taip;7;0;0;7
7445;Pušaitė;"Kačiukų trobelė";6323180798;Taip;0;0;2;2
7446;Pušaitė;"Kačiukų trobelė";5191894075;Taip;8;2;3;13
7447;Pušaitė;"Kačiukų trobelė";1161519408;Taip;0;21;0;21
7448;Pušaitė;"Kačiukų trobelė";8822285103;Taip;9;1;0;10
7449;Pušaitė;"Kačiukų trobelė";9313564235;Taip;11;2;0;13
7450;Pušaitė;"Kačiukų trobelė";5564338170;Taip;2;2;0;4
7451;Pušaitė;"Kačiukų trobelė";2865062081;Taip;0;0;1;1
7452;Pušaitė;"Kačiukų trobelė";8155746120;Taip;8;0;0;8
7453;Pušaitė;"Kačiukų trobelė";8470059012;Ne;0;0;11;11
7454;Pušaitė;Ežiukai;2090143259;Taip;0;1;3;4
7455;Pušaitė;Ežiukai;2951618391;Taip;0;1;1;2
7456;Pušaitė;Ežiukai;9524002395;Taip;0;1;2;3
7457;Pušaitė;Ežiukai;7305350540;Taip;7;1;0;8
7458;Pušaitė;Ežiukai;1111143593;Taip;0;0;2;2
7459;Pušaitė;Ežiukai;5394378197;Taip;0;1;2;3
7460;Pušaitė;Ežiukai;69869396094;Taip;0;1;0;1
7461;Pušaitė;Ežiukai;3359574190;Taip;0;1;0;1
7462;Pušaitė;Ežiukai;1143122778;Ne;0;1;1;2
7463;Pušaitė;Ežiukai;9461292576;Taip;5;1;0;6
7464;Pušaitė;Ežiukai;5185787803;Taip;0;6;0;6
7465;Pušaitė;Ežiukai;4671293211;Taip;0;11;0;11
7466;Pušaitė;Ežiukai;4101326122;Taip;0;1;0;1
7467;Pušaitė;Ežiukai;8958364766;Taip;7;0;0;7
7468;Pušaitė;Ežiukai;2983890410;Taip;0;1;0;1
7469;Pušaitė;Ežiukai;7575143890;Taip;0;4;1;5
7470;Pušaitė;Ežiukai;7808186865;Taip;0;2;0;2
7471;Pušaitė;Ežiukai;4842783897;Taip;0;1;0;1
7472;Pušaitė;Ežiukai;6472169278;Ne;0;2;0;2
7473;Pušaitė;Ežiukai;8021494509;Taip;0;21;0;21
7474;Pušaitė;Ežiukai;2172342063;Taip;3;4;0;7
7475;Pušaitė;"Gudručių šalis";24768657107;Taip;5;1;2;8
7476;Pušaitė;"Gudručių šalis";55304000825;Taip;3;7;1;11
7477;Pušaitė;"Gudručių šalis";15550007793;Taip;0;1;1;2
7478;Pušaitė;"Gudručių šalis";4386242143;Taip;6;0;1;7
7479;Pušaitė;"Gudručių šalis";9997642887;Taip;0;1;0;1
7480;Pušaitė;"Gudručių šalis";15546035138;Taip;5;1;0;6
7481;Pušaitė;"Gudručių šalis";1275885492;Taip;0;0;1;1
7482;Pušaitė;"Gudručių šalis";90178990466;Taip;0;0;5;5
7483;Pušaitė;"Gudručių šalis";89985930634;Taip;12;1;0;13
7484;Pušaitė;"Gudručių šalis";4266368627;Taip;0;5;0;5
7485;Pušaitė;"Gudručių šalis";49973513385;Taip;5;2;0;7
7486;Pušaitė;"Gudručių šalis";66238819356;Taip;0;0;1;1
7487;Pušaitė;"Gudručių šalis";89212112638;Taip;0;1;4;5
7488;Pušaitė;"Gudručių šalis";11297426946;Taip;0;10;0;10
7489;Pušaitė;"Gudručių šalis";67365323950;Taip;0;1;2;3
7490;Pušaitė;"Gudručių šalis";35947321028;Taip;0;21;0;21
7491;Pušaitė;"Gudručių šalis";87504481892;Taip;3;7;0;10
7492;Pušaitė;"Gudručių šalis";6915619931;Ne;0;2;1;3
7493;Pušaitė;"Gudručių šalis";41026183089;Taip;0;2;1;3
7494;Pušaitė;"Gudručių šalis";3577616212;Taip;3;0;0;3
7495;Pušaitė;"Lapučių mokyklėlė";1102988768;Taip;0;2;1;3
7496;Pušaitė;"Lapučių mokyklėlė";53211427399;Taip;0;11;0;11
7497;Pušaitė;"Lapučių mokyklėlė";40417586835;Taip;0;1;1;2
7498;Pušaitė;"Lapučių mokyklėlė";91960884985;Taip;0;1;0;1
7499;Pušaitė;"Lapučių mokyklėlė";60394388920;Taip;0;6;0;6
7500;Pušaitė;"Lapučių mokyklėlė";85343380637;Taip;0;1;0;1
7501;Pušaitė;"Lapučių mokyklėlė";2044213583;Taip;8;1;2;11
7502;Pušaitė;"Lapučių mokyklėlė";7408224942;Taip;0;1;0;1
7503;Pušaitė;"Lapučių mokyklėlė";1394847204;Ne;0;2;0;2
7504;Pušaitė;"Lapučių mokyklėlė";21992678312;Taip;5;0;0;5
7505;Pušaitė;"Lapučių mokyklėlė";6667124375;Taip;2;0;0;2
7506;Pušaitė;"Lapučių mokyklėlė";77082825248;Taip;5;1;0;6
7507;Pušaitė;"Lapučių mokyklėlė";1487637695;Taip;0;0;2;2
7508;Pušaitė;"Lapučių mokyklėlė";53766202712;Taip;12;0;0;12
7509;Pušaitė;"Lapučių mokyklėlė";3231637165;Taip;0;3;1;4
7510;Pušaitė;"Lapučių mokyklėlė";6542917863;Taip;0;21;0;21
7511;Pušaitė;"Lapučių mokyklėlė";9179757395;Taip;5;0;1;6
7512;Pušaitė;"Lapučių mokyklėlė";1798044901;Ne;0;0;2;2
7513;Pušaitė;"Lapučių mokyklėlė";54748538980;Ne;5;1;3;9
7514;Pušaitė;"Lapučių mokyklėlė";1878172874;Ne;0;5;0;5
7515;Pušaitė;"Lapučių mokyklėlė";1569413876;Taip;1;0;0;1
7516;Pušaitė;"Lapučių mokyklėlė";8592426606;Taip;0;0;1;1
7517;Pušaitė;"Lapučių mokyklėlė";2892138891;Taip;0;0;3;3
7518;Pušaitė;"Lapučių mokyklėlė";3745881982;Taip;0;2;0;2
7519;Pušaitė;"VOVERIUKAI ";8763667682;Taip;0;1;0;1
7520;Pušaitė;"VOVERIUKAI ";7891007708;Taip;0;1;0;1
7521;Pušaitė;"VOVERIUKAI ";6767281906;Taip;0;1;0;1
7522;Pušaitė;"VOVERIUKAI ";2078734161;Taip;3;0;1;4
7523;Pušaitė;"VOVERIUKAI ";6805882038;Taip;0;1;0;1
7524;Pušaitė;"VOVERIUKAI ";5488507646;Taip;3;0;0;3
7525;Pušaitė;"VOVERIUKAI ";8790959900;Taip;0;4;0;4
7526;Pušaitė;"VOVERIUKAI ";4076030383;Taip;2;0;0;2
7527;Pušaitė;"VOVERIUKAI ";5211104903;Taip;6;0;0;6
7528;Pušaitė;"VOVERIUKAI ";3380836598;Taip;6;0;0;6
7529;Pušaitė;"VOVERIUKAI ";3732377309;Taip;6;0;4;10
7530;Pušaitė;"VOVERIUKAI ";1807432967;Taip;5;0;0;5
7531;Pušaitė;"VOVERIUKAI ";8459530338;Taip;5;0;2;7
7532;Pušaitė;MEŠKUČIAI;6186545163;Taip;3;2;0;5
7533;Pušaitė;MEŠKUČIAI;6576647982;Taip;6;1;0;7
7534;Pušaitė;MEŠKUČIAI;7992567219;Taip;0;1;0;1
7535;Pušaitė;MEŠKUČIAI;4918124423;Taip;8;0;0;8
7536;Pušaitė;MEŠKUČIAI;4626055123;Ne;4;0;0;4
7537;Pušaitė;MEŠKUČIAI;2333176054;Ne;4;0;0;4
7538;Pušaitė;MEŠKUČIAI;7066207306;Ne;0;1;0;1
7539;Pušaitė;MEŠKUČIAI;6734504906;Taip;4;0;0;4
7540;Pušaitė;MEŠKUČIAI;5339878948;Taip;5;4;0;9
7541;Pušaitė;MEŠKUČIAI;3610256789;Taip;8;1;1;10
7542;Pušaitė;MEŠKUČIAI;4281125486;Taip;0;0;8;8
7543;Pušaitė;MEŠKUČIAI;2777222076;Taip;0;0;2;2
7544;Pušaitė;PELIUKAI;6445790780;Taip;0;21;0;21
7545;Pušaitė;PELIUKAI;4615270419;Taip;0;2;0;2
7546;Pušaitė;PELIUKAI;2969514918;Taip;0;1;0;1
7547;Pušaitė;PELIUKAI;6851908671;Taip;2;0;6;8
7548;Pušaitė;PELIUKAI;4227738913;Taip;4;0;0;4
7549;Pušaitė;PELIUKAI;2666541612;Taip;3;0;0;3
7550;Pušaitė;PELIUKAI;4857214952;Taip;0;1;1;2
7551;Pušaitė;PELIUKAI;9337726482;Ne;0;3;0;3
7552;Pušaitė;PELIUKAI;8343225451;Taip;4;1;0;5
7553;Pušaitė;PELIUKAI;8551426938;Ne;0;1;0;1
7554;Pušaitė;PELIUKAI;4444972517;Taip;7;1;0;8
7555;Pušaitė;PELIUKAI;7615253880;Ne;0;1;0;1
7556;Pušaitė;PELIUKAI;4508356130;Taip;0;1;0;1
7557;Pušaitė;PELIUKAI;4138386134;Taip;0;7;0;7
7558;Pušynėlis;PUMPURĖLIAI;3100230874;Taip;0;13;0;13
7559;Pušynėlis;PUMPURĖLIAI;8451160808;Taip;0;1;0;1
7560;Pušynėlis;PUMPURĖLIAI;6036296660;Taip;0;1;0;1
7561;Pušynėlis;PUMPURĖLIAI;7177725663;Taip;0;10;0;10
7562;Pušynėlis;PUMPURĖLIAI;2718421498;Taip;5;3;0;8
7563;Pušynėlis;PUMPURĖLIAI;9483417104;Taip;5;0;2;7
7564;Pušynėlis;PUMPURĖLIAI;4052365035;Taip;0;0;2;2
7565;Pušynėlis;PUMPURĖLIAI;7401066252;Taip;3;0;0;3
7566;Pušynėlis;PUMPURĖLIAI;1164201286;Taip;1;1;0;2
7567;Pušynėlis;PUMPURĖLIAI;3882064516;Taip;5;0;0;5
7568;Pušynėlis;PUMPURĖLIAI;9081582524;Taip;5;0;0;5
7569;Pušynėlis;PUMPURĖLIAI;1251787066;Taip;5;0;2;7
7570;Pušynėlis;PUMPURĖLIAI;4526807309;Taip;8;1;0;9
7571;Pušynėlis;PUMPURĖLIAI;6709692748;Taip;3;0;0;3
7572;Pušynėlis;PUMPURĖLIAI;8799095053;Taip;0;6;0;6
7573;Pušynėlis;PUMPURĖLIAI;5318223378;Taip;8;0;3;11
7574;Pušynėlis;PUMPURĖLIAI;7787646910;Taip;2;0;0;2
7575;Pušynėlis;PUMPURĖLIAI;5897839636;Taip;0;1;0;1
7576;Pušynėlis;PUMPURĖLIAI;1034336110;Taip;0;8;0;8
7577;Pušynėlis;PUMPURĖLIAI;8218331977;Taip;0;4;0;4
7578;Pušynėlis;SAULUTĖS;9192206804;Taip;0;1;0;1
7579;Pušynėlis;SAULUTĖS;1573574250;Taip;0;1;0;1
7580;Pušynėlis;SAULUTĖS;3510202379;Taip;0;8;6;14
7581;Pušynėlis;SAULUTĖS;2765869141;Taip;0;1;1;2
7582;Pušynėlis;SAULUTĖS;3483007385;Taip;0;0;1;1
7583;Pušynėlis;SAULUTĖS;9154108688;Taip;3;0;4;7
7584;Pušynėlis;SAULUTĖS;6077698697;Taip;0;0;1;1
7585;Pušynėlis;SAULUTĖS;4668634909;Taip;0;1;0;1
7586;Pušynėlis;SAULUTĖS;1891728904;Ne;0;1;1;2
7587;Pušynėlis;SAULUTĖS;6560054869;Taip;5;1;7;13
7588;Pušynėlis;SAULUTĖS;4030500100;Taip;5;0;3;8
7589;Pušynėlis;SAULUTĖS;8172450090;Taip;5;0;3;8
7590;Pušynėlis;SAULUTĖS;2019210609;Ne;0;1;0;1
7591;Pušynėlis;SAULUTĖS;2793982816;Ne;0;0;8;8
7592;Pušynėlis;SAULUTĖS;4920818548;Taip;20;0;1;21
7593;Pušynėlis;SAULUTĖS;2508640229;Taip;11;0;0;11
7594;Pušynėlis;SAULUTĖS;7046421581;Taip;5;0;0;5
7595;Pušynėlis;SAULUTĖS;5236219294;Taip;0;0;8;8
7596;Pušynėlis;SAULUTĖS;4052132379;Taip;7;0;0;7
7597;Pušynėlis;SAULUTĖS;2141785580;Taip;0;17;0;17
7598;Pušynėlis;SAULUTĖS;1102029570;Taip;0;0;4;4
7599;Pušynėlis;PRIEŠMOKYKLINĖ;79386112020;Ne;0;0;1;1
7600;Pušynėlis;PRIEŠMOKYKLINĖ;1415916851;Taip;3;0;0;3
7601;Pušynėlis;PRIEŠMOKYKLINĖ;1585572669;Taip;0;3;0;3
7602;Pušynėlis;PRIEŠMOKYKLINĖ;68068847689;Taip;0;0;1;1
7603;Pušynėlis;PRIEŠMOKYKLINĖ;40407279179;Taip;0;9;0;9
7604;Pušynėlis;PRIEŠMOKYKLINĖ;1610449906;Taip;0;0;1;1
7605;Pušynėlis;PRIEŠMOKYKLINĖ;8742287326;Taip;21;0;0;21
7606;Pušynėlis;PRIEŠMOKYKLINĖ;6549217377;Taip;0;0;1;1
7607;Pušynėlis;PRIEŠMOKYKLINĖ;1118012248;Taip;0;0;1;1
7608;Pušynėlis;PRIEŠMOKYKLINĖ;23816147491;Ne;1;0;1;2
7609;Pušynėlis;PRIEŠMOKYKLINĖ;2012089695;Taip;0;9;0;9
7610;Pušynėlis;PRIEŠMOKYKLINĖ;1284674882;Taip;5;3;0;8
7611;Pušynėlis;PRIEŠMOKYKLINĖ;35538053975;Taip;0;1;0;1
7612;Pušynėlis;PRIEŠMOKYKLINĖ;1817179601;Taip;0;5;0;5
7613;Pušynėlis;PRIEŠMOKYKLINĖ;74952593070;Taip;0;0;2;2
7614;Pušynėlis;PRIEŠMOKYKLINĖ;6716726918;Ne;0;0;1;1
7615;Pušynėlis;PRIEŠMOKYKLINĖ;9665845150;Taip;0;5;0;5
7616;Pušynėlis;PRIEŠMOKYKLINĖ;1811758590;Taip;0;0;4;4
7617;Pušynėlis;LOPŠELIS;8803766149;Ne;0;0;7;7
7618;Pušynėlis;LOPŠELIS;9465619945;Taip;7;0;8;15
7619;Pušynėlis;LOPŠELIS;5802582694;Taip;0;1;1;2
7620;Pušynėlis;LOPŠELIS;8462742834;Taip;3;1;0;4
7621;Pušynėlis;LOPŠELIS;2861000826;Taip;0;0;2;2
7622;Pušynėlis;LOPŠELIS;6962705842;Taip;5;0;0;5
7623;Pušynėlis;LOPŠELIS;7438923710;Taip;10;0;3;13
7624;Pušynėlis;LOPŠELIS;8902047615;Taip;0;1;0;1
7625;Pušynėlis;LOPŠELIS;2744665477;Taip;5;0;2;7
7626;Pušynėlis;LOPŠELIS;8845728723;Taip;0;0;1;1
7627;Pušynėlis;LOPŠELIS;3483639540;Taip;4;0;0;4
7628;Pušynėlis;LOPŠELIS;9883505094;Taip;4;0;0;4
7629;Raktelis;PELIUKAI;8146076115;Ne;0;9;0;9
7630;Raktelis;PELIUKAI;2731096860;Taip;2;0;0;2
7631;Raktelis;PELIUKAI;1604357851;Taip;6;0;0;6
7632;Raktelis;PELIUKAI;6393143566;Taip;5;0;0;5
7633;Raktelis;PELIUKAI;4353473162;Taip;7;0;0;7
7634;Raktelis;PELIUKAI;4014822452;Taip;0;0;1;1
7635;Raktelis;PELIUKAI;5688795147;Taip;9;0;0;9
7636;Raktelis;PELIUKAI;9497620710;Ne;10;0;0;10
7637;Raktelis;PELIUKAI;4502236264;Taip;3;0;1;4
7638;Raktelis;PELIUKAI;6822021176;Ne;15;0;0;15
7639;Raktelis;PELIUKAI;3517484891;Taip;0;0;1;1
7640;Raktelis;PELIUKAI;8035618134;Taip;15;0;0;15
7641;Raktelis;PELIUKAI;3821663597;Taip;0;2;1;3
7642;Raktelis;PELIUKAI;1445359221;Taip;5;1;0;6
7643;Raktelis;AGUONOS;6102196040;Taip;5;0;0;5
7644;Raktelis;AGUONOS;6199212999;Taip;7;4;0;11
7645;Raktelis;AGUONOS;7334310944;Taip;0;6;0;6
7646;Raktelis;AGUONOS;6281687751;Taip;1;1;0;2
7647;Raktelis;AGUONOS;1975411457;Ne;17;0;0;17
7648;Raktelis;AGUONOS;6367875352;Taip;0;2;0;2
7649;Raktelis;AGUONOS;7170546710;Taip;10;3;0;13
7650;Raktelis;AGUONOS;4905982507;Taip;0;1;0;1
7651;Raktelis;AGUONOS;9779789133;Taip;5;0;0;5
7652;Raktelis;AGUONOS;9593639791;Taip;0;4;0;4
7653;Raktelis;AGUONOS;1392036584;Taip;11;1;0;12
7654;Raktelis;AGUONOS;6608224825;Taip;13;1;0;14
7655;Raktelis;AGUONOS;4658530212;Taip;0;21;0;21
7656;Raktelis;AGUONOS;4335378625;Ne;15;0;0;15
7657;Raktelis;AGUONOS;8873203690;Taip;0;4;0;4
7658;Raktelis;AGUONOS;9357757604;Taip;7;5;0;12
7659;Raktelis;AGUONOS;8459980712;Taip;0;8;0;8
7660;Raktelis;AGUONOS;7973137015;Taip;7;7;0;14
7661;Raktelis;AGUONOS;9591285702;Taip;0;3;0;3
7662;Raktelis;AGUONOS;9210856228;Taip;0;1;1;2
7663;Raktelis;AGUONOS;8767785444;Ne;0;8;0;8
7664;Raktelis;AGUONOS;9355380341;Ne;0;4;0;4
7665;Raktelis;LAPIUKŲ;8869030487;Taip;12;0;0;12
7666;Raktelis;LAPIUKŲ;9130613710;Taip;2;2;2;6
7667;Raktelis;LAPIUKŲ;6385127914;Taip;4;5;0;9
7668;Raktelis;LAPIUKŲ;5925441742;Taip;10;0;0;10
7669;Raktelis;LAPIUKŲ;8207675881;Taip;0;5;0;5
7670;Raktelis;LAPIUKŲ;6894769625;Taip;13;2;0;15
7671;Raktelis;LAPIUKŲ;3380295375;Ne;5;0;0;5
7672;Raktelis;LAPIUKŲ;7142823740;Ne;0;1;0;1
7673;Raktelis;LAPIUKŲ;3395720463;Taip;8;3;0;11
7674;Raktelis;LAPIUKŲ;1322912585;Taip;0;21;0;21
7675;Raktelis;LAPIUKŲ;2809458453;Taip;13;3;0;16
7676;Raktelis;LAPIUKŲ;9151796053;Taip;12;0;0;12
7677;Raktelis;LAPIUKŲ;5487606214;Taip;0;0;1;1
7678;Raktelis;LAPIUKŲ;6892006495;Taip;6;4;0;10
7679;Raktelis;LAPIUKŲ;4228614834;Taip;18;0;0;18
7680;Raktelis;LAPIUKŲ;3884068578;Ne;0;1;0;1
7681;Raktelis;LAPIUKŲ;4755892641;Taip;10;1;0;11
7682;Raktelis;LAPIUKŲ;7440866459;Taip;0;2;0;2
7683;Rasa;Nykštukai;3664125930;Ne;3;6;0;9
7684;Rasa;Nykštukai;5176175108;Taip;0;1;9;10
7685;Rasa;Nykštukai;3979273111;Taip;9;2;0;11
7686;Rasa;Nykštukai;4847544355;Taip;5;0;0;5
7687;Rasa;Nykštukai;9723040721;Taip;0;16;0;16
7688;Rasa;Nykštukai;7004232909;Taip;0;1;1;2
7689;Rasa;Nykštukai;1223962374;Taip;0;3;0;3
7690;Rasa;Nykštukai;3200377629;Ne;2;11;0;13
7691;Rasa;Nykštukai;1336291828;Taip;0;4;0;4
7692;Rasa;Nykštukai;5861229664;Taip;13;1;0;14
7693;Rasa;Nykštukai;1386880644;Taip;0;6;4;10
7694;Rasa;Nykštukai;7228037580;Taip;6;0;0;6
7695;Rasa;Nykštukai;2093263887;Taip;0;0;2;2
7696;Rasa;Nykštukai;2540124793;Taip;0;1;3;4
7697;Rasa;Nykštukai;5363748728;Taip;0;1;0;1
7698;Rasa;Nykštukai;2977737634;Taip;5;1;0;6
7699;Rasa;Nykštukai;7520665472;Taip;0;5;0;5
7700;Rasa;Nykštukai;7534306402;Ne;2;0;0;2
7701;Rasa;Nykštukai;1991693486;Ne;4;0;1;5
7702;Rasa;Meškiukai;8052120247;Taip;5;6;0;11
7703;Rasa;Meškiukai;72772661373;Taip;4;0;3;7
7704;Rasa;Meškiukai;63673920646;Taip;3;0;2;5
7705;Rasa;Meškiukai;5932187584;Ne;5;1;0;6
7706;Rasa;Meškiukai;5145978804;Taip;11;6;0;17
7707;Rasa;Meškiukai;8438563545;Taip;7;0;0;7
7708;Rasa;Meškiukai;6356448094;Taip;14;0;0;14
7709;Rasa;Meškiukai;2683897055;Taip;17;1;0;18
7710;Rasa;Meškiukai;4790859112;Taip;0;0;5;5
7711;Rasa;Meškiukai;7534548604;Taip;15;1;0;16
7712;Rasa;Meškiukai;5606722133;Taip;0;0;1;1
7713;Rasa;Meškiukai;7565880116;Taip;15;0;0;15
7714;Rasa;Meškiukai;7544963724;Taip;4;3;0;7
7715;Rasa;Meškiukai;3567565920;Ne;10;3;1;14
7716;Rasa;Meškiukai;6734478649;Taip;0;0;1;1
7717;Rasa;Meškiukai;4837280374;Ne;0;0;1;1
7718;Rasa;Meškiukai;6879558965;Ne;0;0;1;1
7719;Rasa;Meškiukai;4121168136;Taip;15;0;0;15
7720;Rasa;Meškiukai;4260142706;Taip;0;2;0;2
7721;Rasa;Sauliukai;2233964230;Ne;15;2;0;17
7722;Rasa;Sauliukai;2662945227;Ne;0;0;2;2
7723;Rasa;Sauliukai;6154208507;Ne;4;0;0;4
7724;Rasa;Sauliukai;7413825519;Ne;0;1;0;1
7725;Rasa;Sauliukai;7575833127;Taip;0;2;1;3
7726;Rasa;Sauliukai;9438727789;Taip;0;2;5;7
7727;Rasa;Sauliukai;1049242346;Taip;0;0;3;3
7728;Rasa;Sauliukai;34934099958;Taip;0;3;0;3
7729;Rasa;Sauliukai;27131705540;Taip;0;6;0;6
7730;Rasa;Sauliukai;73115061371;Ne;0;7;0;7
7731;Rasa;Sauliukai;71420694152;Ne;0;13;0;13
7732;Rasa;Sauliukai;83227920971;Ne;0;1;0;1
7733;Rasa;Sauliukai;1214055260;Taip;0;3;0;3
7734;Rasa;Sauliukai;1210203141;Taip;0;2;0;2
7735;Rasa;Sauliukai;84161884493;Ne;0;0;2;2
7736;Rasa;Sauliukai;66103644564;Taip;0;1;0;1
7737;Rasa;Sauliukai;5072204356;Taip;0;1;0;1
7738;Rasa;Smalsučiai;3884105235;Taip;0;0;1;1
7739;Rasa;Smalsučiai;1726266997;Ne;0;0;10;10
7740;Rasa;Smalsučiai;2041098301;Taip;0;0;6;6
7741;Rasa;Smalsučiai;6344169010;Taip;0;0;2;2
7742;Rasa;Smalsučiai;2158444381;Taip;0;0;2;2
7743;Rasa;Smalsučiai;2980868154;Ne;0;5;0;5
7744;Rasa;Smalsučiai;1728275988;Taip;0;9;3;12
7745;Rasa;Smalsučiai;4065614217;Taip;10;0;0;10
7746;Rasa;Smalsučiai;2349860704;Taip;8;0;1;9
7747;Rasa;Smalsučiai;5589971159;Taip;0;0;7;7
7748;Rasa;Smalsučiai;15257986685;Taip;3;5;0;8
7749;Rasa;Smalsučiai;6198612392;Taip;0;0;2;2
7750;Rasa;Smalsučiai;1093723298;Ne;0;0;1;1
7751;Rasa;Smalsučiai;8983800071;Ne;0;0;1;1
7752;Rasa;Smalsučiai;1900027524;Ne;5;0;1;6
7753;Rasa;Smalsučiai;74744565967;Taip;5;0;1;6
7754;Rasa;"Pelėdžiukai ";6345614521;Taip;0;0;1;1
7755;Rasa;"Pelėdžiukai ";2121070882;Taip;0;11;7;18
7756;Rasa;"Pelėdžiukai ";1457384318;Taip;0;1;1;2
7757;Rasa;"Pelėdžiukai ";6704162447;Taip;0;1;2;3
7758;Rasa;"Pelėdžiukai ";7558966891;Taip;7;6;0;13
7759;Rasa;"Pelėdžiukai ";6773004268;Taip;8;0;3;11
7760;Rasa;"Pelėdžiukai ";3023088027;Taip;4;3;0;7
7761;Rasa;"Pelėdžiukai ";8953448462;Ne;13;1;6;20
7762;Rasa;"Pelėdžiukai ";5325275053;Taip;0;16;0;16
7763;Rasa;"Pelėdžiukai ";4758605343;Taip;15;0;2;17
7764;Rasa;"Pelėdžiukai ";3848448401;Taip;0;0;3;3
7765;Rasa;"Pelėdžiukai ";4542122478;Taip;0;21;0;21
7766;Rasa;"Pelėdžiukai ";4084236196;Taip;0;0;5;5
7767;Rasa;"Pelėdžiukai ";3091012313;Ne;0;1;1;2
7768;Rasa;"Pelėdžiukai ";4995388517;Ne;0;0;4;4
7769;Rasa;"Pelėdžiukai ";7427702848;Taip;13;4;0;17
7770;Rasa;"Pelėdžiukai ";1823276800;Taip;0;1;0;1
7771;Rasa;"Pelėdžiukai ";4603188598;Taip;8;0;0;8
7772;Rasa;"Pelėdžiukai ";6108187043;Taip;0;7;1;8
7773;Rasa;"Pelėdžiukai ";1651905746;Taip;0;7;0;7
7774;Rasa;Katinėliai;5652936425;Taip;0;0;1;1
7775;Rasa;Katinėliai;5885520521;Ne;10;1;0;11
7776;Rasa;Katinėliai;5426981046;Taip;0;2;0;2
7777;Rasa;Katinėliai;7730322729;Taip;0;6;0;6
7778;Rasa;Katinėliai;2170134084;Taip;2;1;2;5
7779;Rasa;Katinėliai;3657956842;Ne;16;0;1;17
7780;Rasa;Katinėliai;6891623055;Taip;5;0;1;6
7781;Rasa;Katinėliai;9010812748;Taip;8;2;0;10
7782;Rasa;Katinėliai;7220007488;Taip;9;1;0;10
7783;Rasa;Katinėliai;8235869241;Taip;6;0;1;7
7784;Rasa;Katinėliai;3135828190;Ne;10;6;0;16
7785;Rasa;Katinėliai;2984661168;Taip;0;0;1;1
7786;Rasa;Katinėliai;4734775151;Taip;11;0;1;12
7787;Rasa;Katinėliai;4758138905;Taip;2;0;0;2
7788;Rasa;Katinėliai;9447346901;Taip;2;2;0;4
7789;Rasa;Katinėliai;3631124501;Taip;3;6;0;9
7790;Rasa;Katinėliai;9343039995;Ne;0;1;0;1
7791;Rasa;Ančiukai;7637404588;Ne;2;0;8;10
7792;Rasa;Ančiukai;8712141140;Ne;6;0;0;6
7793;Rasa;Ančiukai;6853285570;Taip;0;0;3;3
7794;Rasa;Ančiukai;7265752821;Ne;0;0;4;4
7795;Rasa;Ančiukai;1477018184;Taip;0;0;13;13
7796;Rasa;Ančiukai;4018241056;Ne;2;0;0;2
7797;Rasa;Ančiukai;4427263877;Taip;13;0;4;17
7798;Rasa;Ančiukai;1570975863;Ne;0;0;5;5
7799;Rasa;Ančiukai;8027532547;Taip;0;0;3;3
7800;Rasa;"Vyturiukai ";7185331699;Taip;4;4;0;8
7801;Rasa;"Vyturiukai ";1060810039;Taip;4;4;0;8
7802;Rasa;"Vyturiukai ";7028605422;Taip;13;1;0;14
7803;Rasa;"Vyturiukai ";9599510902;Taip;5;6;0;11
7804;Rasa;"Vyturiukai ";2800420481;Taip;14;2;0;16
7805;Rasa;"Vyturiukai ";5869253167;Taip;7;1;1;9
7806;Rasa;"Vyturiukai ";7037958994;Taip;11;1;0;12
7807;Rasa;"Vyturiukai ";8236785255;Taip;7;11;1;19
7808;Rasa;"Vyturiukai ";6887471189;Taip;16;0;0;16
7809;Rasa;"Vyturiukai ";9668538340;Taip;4;5;0;9
7810;Rasa;"Vyturiukai ";4694111253;Taip;3;0;0;3
7811;Rasa;"Vyturiukai ";6011243039;Taip;0;14;0;14
7812;Rasa;"Vyturiukai ";3737265597;Taip;12;0;0;12
7813;Rasa;"Vyturiukai ";4785494419;Taip;8;0;0;8
7814;Rasa;"Vyturiukai ";2347639286;Taip;5;0;2;7
7815;Rasa;"Vyturiukai ";1206005039;Taip;10;0;4;14
7816;Rasa;"Vyturiukai ";9788282861;Taip;9;0;1;10
7817;Rasa;"Vyturiukai ";2711923397;Taip;6;11;0;17
7818;Rasa;Voveriukai;4111850024;Ne;0;0;4;4
7819;Rasa;Voveriukai;2190948879;Taip;0;1;0;1
7820;Rasa;Voveriukai;1978999728;Ne;4;0;5;9
7821;Rasa;Voveriukai;3546684695;Taip;3;0;3;6
7822;Rasa;Voveriukai;4010262461;Taip;3;0;3;6
7823;Rasa;Voveriukai;5740754301;Ne;0;11;4;15
7824;Rasa;Voveriukai;2446379598;Ne;0;0;2;2
7825;Rasa;Voveriukai;2830296197;Taip;0;0;1;1
7826;Rasa;Voveriukai;1355729894;Taip;7;0;1;8
7827;Rasa;Voveriukai;5977524939;Ne;0;0;3;3
7828;Rasa;Voveriukai;1592174114;Taip;8;0;4;12
7829;Rasa;Voveriukai;1564194649;Ne;0;0;1;1
7830;Rasa;Voveriukai;1764959761;Ne;0;0;5;5
7831;Rasa;Voveriukai;7226105624;Ne;0;0;3;3
7832;Rasa;Voveriukai;8232576658;Ne;3;0;4;7
7833;Rasa;Voveriukai;1733179752;Ne;0;11;0;11
7834;Rasa;Voveriukai;2895124729;Ne;0;6;0;6
7835;Rasa;Voveriukai;1627996663;Taip;0;0;1;1
7836;Rasa;Voveriukai;8469342353;Taip;0;0;3;3
7837;Rasa;"DRUGELIAI ";3073804713;Taip;0;6;0;6
7838;Rasa;"DRUGELIAI ";1466616814;Taip;0;0;6;6
7839;Rasa;"DRUGELIAI ";5165588335;Taip;10;0;0;10
7840;Rasa;"DRUGELIAI ";6691161322;Taip;0;0;15;15
7841;Rasa;"DRUGELIAI ";6874601830;Taip;11;0;0;11
7842;Rasa;"DRUGELIAI ";4127921417;Ne;0;5;1;6
7843;Rasa;"DRUGELIAI ";3773600344;Taip;10;0;4;14
7844;Rasa;"DRUGELIAI ";2371282781;Taip;10;0;4;14
7845;Rasa;"DRUGELIAI ";2555108465;Taip;0;0;16;16
7846;Rasa;"DRUGELIAI ";1992726664;Ne;0;0;3;3
7847;Rasa;"DRUGELIAI ";7843789214;Ne;0;0;6;6
7848;Rasa;"DRUGELIAI ";8314522373;Taip;4;0;2;6
7849;Rasa;Zuikučiai;4554377449;Taip;0;7;0;7
7850;Rasa;Zuikučiai;2137321989;Taip;0;5;0;5
7851;Rasa;Zuikučiai;1993471951;Taip;9;1;3;13
7852;Rasa;Zuikučiai;1860462451;Ne;21;0;0;21
7853;Rasa;Zuikučiai;42609897431;Taip;0;4;1;5
7854;Rasa;Zuikučiai;55374082940;Taip;0;10;0;10
7855;Rasa;Zuikučiai;2114613635;Taip;0;1;0;1
7856;Rasa;Zuikučiai;7397794681;Taip;0;0;4;4
7857;Rasa;Zuikučiai;13297122928;Taip;0;17;0;17
7858;Rasa;Zuikučiai;1131418692;Taip;0;1;0;1
7859;Rasa;Zuikučiai;9432880035;Taip;12;1;2;15
7860;Rasa;Zuikučiai;33479419656;Taip;5;2;0;7
7861;Rasa;Zuikučiai;2840872613;Taip;2;1;0;3
7862;Rasa;Zuikučiai;91931863004;Taip;4;3;1;8
7863;Rasa;Zuikučiai;58858081077;Taip;0;2;6;8
7864;Rasa;Zuikučiai;1210340955;Taip;0;5;0;5
7865;Rasa;Zuikučiai;8909888927;Taip;0;3;0;3
7866;Rasa;Širdelė;8424049317;Taip;9;1;0;10
7867;Rasa;Širdelė;5599182715;Taip;0;9;0;9
7868;Rasa;Širdelė;9648034081;Taip;8;1;0;9
7869;Rasa;Širdelė;8236464670;Ne;0;3;0;3
7870;Rasa;Širdelė;1271820053;Ne;8;1;0;9
7871;Rasa;Širdelė;2626361958;Taip;0;4;0;4
7872;Rasa;Širdelė;6976298054;Taip;0;3;0;3
7873;Rasa;Širdelė;3668598028;Taip;5;4;0;9
7874;Rasa;Širdelė;2132535297;Taip;7;1;0;8
7875;Rasa;Širdelė;8866896989;Taip;0;22;0;22
7876;Rasa;Širdelė;9938280570;Taip;0;2;0;2
7877;Rasa;Širdelė;2333938367;Taip;0;10;0;10
7878;Rasa;Širdelė;9560289781;Ne;4;0;0;4
7879;Rasa;Širdelė;5719253028;Taip;9;1;0;10
7880;Rasa;Širdelė;9140875020;Ne;11;9;0;20
7881;Rasa;Širdelė;5710220699;Taip;5;0;0;5
7882;Rasa;Širdelė;4694382836;Ne;5;0;0;5
7883;Rasa;Širdelė;7065597550;Ne;6;3;0;9
7884;Rasa;Širdelė;1796573723;Taip;0;3;0;3
7885;Rasa;Širdelė;3535655117;Taip;0;2;0;2
7886;Ramunėlė;SAULUTĖS;1192743154;Taip;0;8;0;8
7887;Ramunėlė;SAULUTĖS;5562960498;Taip;0;16;0;16
7888;Ramunėlė;SAULUTĖS;5714771643;Taip;0;2;0;2
7889;Ramunėlė;SAULUTĖS;1483391590;Taip;0;2;1;3
7890;Ramunėlė;SAULUTĖS;4209191105;Taip;0;2;3;5
7891;Ramunėlė;SAULUTĖS;9927068798;Taip;0;2;0;2
7892;Ramunėlė;SAULUTĖS;3779769727;Taip;0;10;0;10
7893;Ramunėlė;SAULUTĖS;5465647281;Taip;0;21;0;21
7894;Ramunėlė;SAULUTĖS;5420360864;Taip;0;2;1;3
7895;Ramunėlė;SAULUTĖS;7902931560;Taip;5;1;0;6
7896;Ramunėlė;SAULUTĖS;9568886284;Ne;3;0;1;4
7897;Ramunėlė;ŽIBUTĖ;2127262855;Taip;0;15;0;15
7898;Ramunėlė;ŽIBUTĖ;8943746426;Taip;0;4;0;4
7899;Ramunėlė;ŽIBUTĖ;57697488265;Taip;0;3;0;3
7900;Ramunėlė;ŽIBUTĖ;4103951942;Taip;0;6;0;6
7901;Ramunėlė;ŽIBUTĖ;37227575121;Taip;0;6;0;6
7902;Ramunėlė;ŽIBUTĖ;9615607625;Taip;0;3;0;3
7903;Ramunėlė;ŽIBUTĖ;24395304267;Ne;4;1;0;5
7904;Ramunėlė;ŽIBUTĖ;41210974793;Taip;3;2;2;7
7905;Ramunėlė;ŽIBUTĖ;78632810141;Taip;0;10;0;10
7906;Ramunėlė;ŽIBUTĖ;8826277893;Ne;0;1;0;1
7907;Ramunėlė;ŽIBUTĖ;573414969;Taip;0;2;0;2
7908;Ramunėlė;ŽIBUTĖ;1383896021;Taip;0;2;4;6
7909;Ramunėlė;ŽIBUTĖ;1898089064;Taip;11;5;0;16
7910;Ramunėlė;ŽIBUTĖ;6126971384;Taip;0;2;0;2
7911;Ramunėlė;ŽIBUTĖ;21178777924;Taip;0;2;1;3
7912;Ramunėlė;ŽIBUTĖ;1845973626;Taip;0;17;0;17
7913;Ramunėlė;ŽIBUTĖ;1575204445;Taip;0;2;4;6
7914;Ramunėlė;ŽIBUTĖ;2069380818;Taip;5;0;0;5
7915;Ramunėlė;ŽIBUTĖ;1077068878;Taip;4;1;0;5
7916;Ramunėlė;ŽIBUTĖ;1891454355;Ne;0;11;0;11
7917;Ramunėlė;ŽIBUTĖ;1690268842;Ne;0;1;0;1
7918;Ramunėlė;ŽIRNIUKAI;11512621396;Taip;0;5;2;7
7919;Ramunėlė;ŽIRNIUKAI;53748116108;Taip;0;4;0;4
7920;Ramunėlė;ŽIRNIUKAI;1028730863;Taip;0;1;0;1
7921;Ramunėlė;ŽIRNIUKAI;1085668968;Taip;0;4;0;4
7922;Ramunėlė;ŽIRNIUKAI;2036562086;Taip;0;1;0;1
7923;Ramunėlė;ŽIRNIUKAI;1386186515;Taip;0;0;6;6
7924;Ramunėlė;ŽIRNIUKAI;1364997950;Taip;0;2;0;2
7925;Ramunėlė;ŽIRNIUKAI;10677635919;Taip;0;10;0;10
7926;Ramunėlė;ŽIRNIUKAI;17292085814;Taip;0;8;0;8
7927;Ramunėlė;ŽIRNIUKAI;1500685962;Ne;0;12;0;12
7928;Ramunėlė;ŽIRNIUKAI;4814208279;Ne;0;1;0;1
7929;Ramunėlė;ŽIRNIUKAI;9448369796;Taip;0;0;3;3
7930;Ramunėlė;BITUTĖS;1343249939;Ne;0;10;2;12
7931;Ramunėlė;BITUTĖS;8098492540;Taip;9;5;0;14
7932;Ramunėlė;BITUTĖS;17201639406;Taip;20;0;0;20
7933;Ramunėlė;BITUTĖS;19420482998;Taip;10;1;0;11
7934;Ramunėlė;BITUTĖS;9130637883;Taip;0;15;0;15
7935;Ramunėlė;BITUTĖS;6217540064;Taip;4;2;3;9
7936;Ramunėlė;BITUTĖS;4990982790;Taip;7;1;0;8
7937;Ramunėlė;BITUTĖS;9171690612;Taip;9;1;0;10
7938;Ramunėlė;BITUTĖS;3271832822;Ne;7;0;0;7
7939;Ramunėlė;BITUTĖS;6329943991;Taip;0;21;0;21
7940;Ramunėlė;BITUTĖS;7307307882;Taip;0;5;0;5
7941;Ramunėlė;BITUTĖS;2225787182;Taip;5;0;0;5
7942;Ramunėlė;BITUTĖS;6166192468;Taip;5;0;0;5
7943;Ramunėlė;BITUTĖS;5865482869;Taip;0;10;0;10
7944;Ramunėlė;BITUTĖS;8940763540;Taip;15;6;0;21
7945;Ramunėlė;BITUTĖS;6843262303;Taip;0;0;1;1
7946;Ramunėlė;BITUTĖS;7692958269;Taip;10;0;1;11
7947;Ramunėlė;BITUTĖS;8086994543;Taip;0;19;0;19
7948;Ramunėlė;BITUTĖS;5822045625;Taip;0;0;1;1
7949;Ramunėlė;DRUGELIAI;67836032797;Taip;0;4;0;4
7950;Ramunėlė;DRUGELIAI;1376538015;Ne;0;14;0;14
7951;Ramunėlė;DRUGELIAI;30907738272;Ne;0;2;0;2
7952;Ramunėlė;DRUGELIAI;1814199950;Taip;0;2;0;2
7953;Ramunėlė;DRUGELIAI;1988109236;Taip;1;7;0;8
7954;Ramunėlė;DRUGELIAI;52168460247;Taip;5;0;2;7
7955;Ramunėlė;DRUGELIAI;66630134164;Taip;3;0;0;3
7956;Ramunėlė;DRUGELIAI;2567264851;Taip;5;0;0;5
7957;Ramunėlė;DRUGELIAI;6930505887;Taip;0;2;0;2
7958;Ramunėlė;DRUGELIAI;8402889872;Taip;0;1;0;1
7959;Ramunėlė;DRUGELIAI;1745170057;Taip;0;2;1;3
7960;Ramunėlė;DRUGELIAI;7228065409;Taip;0;8;0;8
7961;Ramunėlė;DRUGELIAI;5170325023;Taip;0;0;1;1
7962;Ramunėlė;DRUGELIAI;3617897977;Taip;0;6;0;6
7963;Ramunėlė;DRUGELIAI;8768539595;Taip;0;17;0;17
7964;Ramunėlė;DRUGELIAI;2055332353;Taip;0;3;0;3
7965;Ramunėlė;DRUGELIAI;1078618047;Taip;0;9;0;9
7966;Ramunėlė;NEUŽMIRŠTUOLĖS;1797997937;Taip;0;0;1;1
7967;Ramunėlė;NEUŽMIRŠTUOLĖS;9326288662;Taip;3;0;0;3
7968;Ramunėlė;NEUŽMIRŠTUOLĖS;6892481929;Taip;0;6;0;6
7969;Ramunėlė;NEUŽMIRŠTUOLĖS;9928703066;Taip;0;2;0;2
7970;Ramunėlė;NEUŽMIRŠTUOLĖS;9327730190;Taip;5;0;2;7
7971;Ramunėlė;NEUŽMIRŠTUOLĖS;4756689520;Taip;10;0;0;10
7972;Ramunėlė;NEUŽMIRŠTUOLĖS;2070729684;Taip;11;0;0;11
7973;Ramunėlė;NEUŽMIRŠTUOLĖS;7220407572;Taip;0;6;0;6
7974;Ramunėlė;NEUŽMIRŠTUOLĖS;6342801407;Taip;21;0;0;21
7975;Ramunėlė;NEUŽMIRŠTUOLĖS;1916520056;Taip;10;0;0;10
7976;Ramunėlė;NEUŽMIRŠTUOLĖS;8942483792;Taip;10;0;1;11
7977;Ramunėlė;NEUŽMIRŠTUOLĖS;6870110390;Taip;5;2;1;8
7978;Ramunėlė;NEUŽMIRŠTUOLĖS;2245564567;Taip;5;2;1;8
7979;Ramunėlė;NEUŽMIRŠTUOLĖS;6881228078;Taip;6;1;0;7
7980;Ramunėlė;NEUŽMIRŠTUOLĖS;1182350830;Taip;6;0;0;6
7981;Ramunėlė;NEUŽMIRŠTUOLĖS;9014726465;Taip;2;0;0;2
7982;Ramunėlė;NEUŽMIRŠTUOLĖS;6613469006;Ne;10;0;0;10
7983;Ramunėlė;NEUŽMIRŠTUOLĖS;3742982547;Taip;5;0;0;5
7984;Ramunėlė;NEUŽMIRŠTUOLĖS;3106987206;Taip;10;0;0;10
7985;Ramunėlė;OBUOLIUKAI;2555810841;Taip;0;0;4;4
7986;Ramunėlė;OBUOLIUKAI;1199673371;Taip;0;0;1;1
7987;Ramunėlė;OBUOLIUKAI;6348171102;Ne;0;10;0;10
7988;Ramunėlė;OBUOLIUKAI;4392309015;Taip;0;0;2;2
7989;Ramunėlė;OBUOLIUKAI;5049415445;Taip;0;0;16;16
7990;Ramunėlė;OBUOLIUKAI;8205893352;Taip;6;0;0;6
7991;Ramunėlė;OBUOLIUKAI;3683181174;Taip;10;3;0;13
7992;Ramunėlė;OBUOLIUKAI;7364976547;Taip;0;0;1;1
7993;Ramunėlė;OBUOLIUKAI;6156792400;Taip;5;10;0;15
7994;Ramunėlė;OBUOLIUKAI;4233978236;Taip;6;0;0;6
7995;Ramunėlė;OBUOLIUKAI;9984243153;Taip;10;0;0;10
7996;Ramunėlė;OBUOLIUKAI;2983986428;Taip;0;1;0;1
7997;Ramunėlė;OBUOLIUKAI;5548358138;Taip;1;3;0;4
7998;Ramunėlė;OBUOLIUKAI;7622952406;Taip;0;0;9;9
7999;Ramunėlė;OBUOLIUKAI;2427399083;Taip;0;2;1;3
8000;Ramunėlė;OBUOLIUKAI;6184872126;Taip;5;6;1;12
8001;Ramunėlė;OBUOLIUKAI;2422656007;Taip;0;0;2;2
8002;Ramunėlė;OBUOLIUKAI;6809164145;Taip;5;1;0;6
8003;Ramunėlė;OBUOLIUKAI;7829765488;Taip;0;1;0;1
8004;Ramunėlė;OBUOLIUKAI;8460527225;Taip;0;12;0;12
8005;Ramunėlė;SAULĖGRĄŽA;7593855877;Taip;0;2;4;6
8006;Ramunėlė;SAULĖGRĄŽA;2177200537;Taip;6;1;0;7
8007;Ramunėlė;SAULĖGRĄŽA;5581693652;Taip;0;2;5;7
8008;Ramunėlė;SAULĖGRĄŽA;4269170508;Taip;11;0;2;13
8009;Ramunėlė;SAULĖGRĄŽA;7263195574;Taip;10;0;0;10
8010;Ramunėlė;SAULĖGRĄŽA;4076525701;Ne;0;0;1;1
8011;Ramunėlė;SAULĖGRĄŽA;4139935502;Taip;5;0;0;5
8012;Ramunėlė;SAULĖGRĄŽA;1833069020;Ne;5;0;2;7
8013;Ramunėlė;SAULĖGRĄŽA;4237681607;Taip;4;0;0;4
8014;Ramunėlė;SAULĖGRĄŽA;4875011312;Taip;0;0;1;1
8015;Ramunėlė;SAULĖGRĄŽA;4084046207;Taip;10;0;0;10
8016;Ramunėlė;SAULĖGRĄŽA;5017020616;Taip;0;1;0;1
8017;Ramunėlė;SAULĖGRĄŽA;4805808663;Ne;5;0;0;5
8018;Ramunėlė;SAULĖGRĄŽA;7026935746;Taip;1;0;0;1
8019;Ramunėlė;SAULĖGRĄŽA;6225605784;Taip;6;0;0;6
8020;Ramunėlė;SAULĖGRĄŽA;6674467484;Ne;0;3;0;3
8021;Ramunėlė;BORUŽĖLĖS;7825538259;Taip;0;15;0;15
8022;Ramunėlė;BORUŽĖLĖS;8496322672;Taip;5;0;0;5
8023;Ramunėlė;BORUŽĖLĖS;7295041630;Taip;0;1;0;1
8024;Ramunėlė;BORUŽĖLĖS;58028743912;Ne;5;0;0;5
8025;Ramunėlė;BORUŽĖLĖS;7750405604;Taip;0;2;0;2
8026;Ramunėlė;BORUŽĖLĖS;1216101539;Taip;18;0;0;18
8027;Ramunėlė;BORUŽĖLĖS;2499280049;Taip;0;1;0;1
8028;Ramunėlė;BORUŽĖLĖS;4677819736;Taip;0;0;2;2
8029;Ramunėlė;BORUŽĖLĖS;4349250416;Taip;0;1;0;1
8030;Ramunėlė;BORUŽĖLĖS;1303053333;Taip;0;1;0;1
8031;Ramunėlė;BORUŽĖLĖS;3554787356;Taip;12;0;1;13
8032;Ramunėlė;BORUŽĖLĖS;3685786758;Taip;0;3;0;3
8033;Ramunėlė;BORUŽĖLĖS;3566074517;Taip;0;0;1;1
8034;Ramunėlė;BORUŽĖLĖS;6837072361;Taip;0;3;0;3
8035;Ramunėlė;BORUŽĖLĖS;7638038269;Taip;0;2;3;5
8036;Ramunėlė;BORUŽĖLĖS;1534723406;Taip;0;0;1;1
8037;Ramunėlė;BORUŽĖLĖS;8323020864;Taip;0;0;4;4
8038;Ramunėlė;BORUŽĖLĖS;10704826206;Ne;0;2;1;3
8039;Ramunėlė;BORUŽĖLĖS;3065727741;Taip;5;0;4;9
8040;Ramunėlė;NYKŠTUKAS;6135381472;Ne;5;1;0;6
8041;Ramunėlė;NYKŠTUKAS;3239532336;Ne;5;1;0;6
8042;Ramunėlė;NYKŠTUKAS;8617271247;Taip;0;4;0;4
8043;Ramunėlė;NYKŠTUKAS;1811931985;Ne;6;3;0;9
8044;Ramunėlė;NYKŠTUKAS;9012749913;Taip;9;0;0;9
8045;Ramunėlė;NYKŠTUKAS;6604244856;Taip;0;1;0;1
8046;Ramunėlė;NYKŠTUKAS;2523377321;Taip;0;2;0;2
8047;Ramunėlė;NYKŠTUKAS;6413888803;Taip;0;1;0;1
8048;Ramunėlė;NYKŠTUKAS;5610672420;Taip;8;0;1;9
8049;Ramunėlė;NYKŠTUKAS;4400154355;Taip;5;0;0;5
8050;Ramunėlė;NYKŠTUKAS;9217815657;Taip;5;5;0;10
8051;Ramunėlė;UOGELĖ;1818513881;Taip;0;0;1;1
8052;Ramunėlė;UOGELĖ;8310875815;Taip;10;0;0;10
8053;Ramunėlė;UOGELĖ;6347893013;Taip;5;0;1;6
8054;Ramunėlė;UOGELĖ;3735308599;Taip;0;2;0;2
8055;Ramunėlė;UOGELĖ;9934852622;Taip;0;2;0;2
8056;Ramunėlė;UOGELĖ;4968998913;Taip;5;0;2;7
8057;Ramunėlė;UOGELĖ;3272747656;Taip;12;0;0;12
8058;Ramunėlė;UOGELĖ;3996453947;Taip;0;4;0;4
8059;Ramunėlė;UOGELĖ;1491688322;Taip;7;1;0;8
8060;Ramunėlė;UOGELĖ;3474578046;Taip;0;2;1;3
8061;Ramunėlė;UOGELĖ;3461269451;Taip;0;1;0;1
8062;Ramunėlė;UOGELĖ;4022818032;Taip;5;0;0;5
8063;Ramunėlė;UOGELĖ;2383861394;Taip;6;0;0;6
8064;Ramunėlė;UOGELĖ;7544671346;Taip;3;2;0;5
8065;Ramunėlė;VARPELIAI;8726443989;Taip;6;4;2;12
8066;Ramunėlė;VARPELIAI;4715809064;Taip;0;7;0;7
8067;Ramunėlė;VARPELIAI;5315953299;Taip;5;1;0;6
8068;Ramunėlė;VARPELIAI;5650659504;Taip;0;1;0;1
8069;Ramunėlė;VARPELIAI;6627399830;Taip;4;0;1;5
8070;Ramunėlė;VARPELIAI;5801760033;Taip;7;2;4;13
8071;Ramunėlė;VARPELIAI;6389008823;Taip;5;2;0;7
8072;Ramunėlė;VARPELIAI;9136437288;Taip;5;6;0;11
8073;Ramunėlė;VARPELIAI;2605941371;Taip;0;1;0;1
8074;Ramunėlė;VARPELIAI;2591052434;Ne;4;1;0;5
8075;Ramunėlė;VARPELIAI;2446375037;Taip;5;2;6;13
8076;Ramunėlė;VARPELIAI;1671759939;Taip;0;2;0;2
8077;Ramunėlė;VARPELIAI;5304803880;Taip;0;3;0;3
8078;Ramunėlė;VARPELIAI;6347164708;Taip;4;0;1;5
8079;Ramunėlė;VARPELIAI;3525444906;Taip;0;2;0;2
8080;Ramunėlė;VARPELIAI;8055844166;Taip;8;6;0;14
8081;Ramunėlė;VARPELIAI;7010828978;Taip;5;0;0;5
8082;Ramunėlė;VARPELIAI;6606802660;Taip;9;2;0;11
8083;Ramunėlė;VARPELIAI;6040461460;Taip;0;1;0;1
8084;Rūta;SMALSUČIAI;7649756034;Taip;6;0;0;6
8085;Rūta;SMALSUČIAI;1543099858;Taip;10;0;11;21
8086;Rūta;SMALSUČIAI;1346124133;Taip;0;0;6;6
8087;Rūta;SMALSUČIAI;9791861646;Taip;0;0;1;1
8088;Rūta;SMALSUČIAI;1951202550;Taip;14;0;0;14
8089;Rūta;SMALSUČIAI;3875136625;Taip;0;1;0;1
8090;Rūta;SMALSUČIAI;4962272621;Taip;0;0;1;1
8091;Rūta;SMALSUČIAI;9603105651;Taip;7;0;4;11
8092;Rūta;SMALSUČIAI;9911151238;Taip;0;5;4;9
8093;Rūta;SMALSUČIAI;7434152435;Taip;0;0;2;2
8094;Rūta;SMALSUČIAI;3843325181;Taip;5;0;0;5
8095;Rūta;SMALSUČIAI;6316768460;Taip;10;0;0;10
8096;Rūta;SMALSUČIAI;8182243701;Taip;0;1;2;3
8097;Rūta;KŪLVERSTUKAI;7222494215;Taip;0;0;1;1
8098;Rūta;KŪLVERSTUKAI;4880804625;Ne;0;0;3;3
8099;Rūta;KŪLVERSTUKAI;3055345528;Taip;0;0;6;6
8100;Rūta;KŪLVERSTUKAI;3499727608;Taip;5;0;5;10
8101;Rūta;KŪLVERSTUKAI;9765301038;Taip;5;0;6;11
8102;Rūta;KŪLVERSTUKAI;9638495757;Taip;0;0;1;1
8103;Rūta;KŪLVERSTUKAI;1962172243;Taip;8;0;1;9
8104;Rūta;KŪLVERSTUKAI;8605070655;Taip;0;0;7;7
8105;Rūta;KŪLVERSTUKAI;7553844890;Taip;0;0;13;13
8106;Rūta;KŪLVERSTUKAI;3964922552;Taip;0;7;2;9
8107;Rūta;KŪLVERSTUKAI;8395765508;Taip;0;5;0;5
8108;Rūta;KŪLVERSTUKAI;9400586178;Taip;0;0;1;1
8109;Rūta;KŪLVERSTUKAI;3956912957;Ne;0;1;0;1
8110;Rūta;KŪLVERSTUKAI;2890569107;Taip;0;0;3;3
8111;Rūta;KŪLVERSTUKAI;2474991135;Taip;0;0;4;4
8112;Rūta;KODĖLČIUKAI;2546023973;Taip;0;0;8;8
8113;Rūta;KODĖLČIUKAI;6814051598;Taip;0;0;1;1
8114;Rūta;KODĖLČIUKAI;5109138407;Taip;14;0;1;15
8115;Rūta;KODĖLČIUKAI;6186413364;Taip;6;0;0;6
8116;Rūta;KODĖLČIUKAI;6585842434;Taip;1;0;2;3
8117;Rūta;KODĖLČIUKAI;4473591998;Taip;6;0;1;7
8118;Rūta;KODĖLČIUKAI;9589117921;Taip;0;0;1;1
8119;Rūta;KODĖLČIUKAI;6620957022;Taip;2;0;0;2
8120;Rūta;KODĖLČIUKAI;5512946296;Taip;11;0;0;11
8121;Rūta;KODĖLČIUKAI;7422059414;Taip;11;0;4;15
8122;Rūta;KODĖLČIUKAI;9014433476;Taip;6;0;0;6
8123;Rūta;KODĖLČIUKAI;9322322737;Taip;8;0;2;10
8124;Rūta;BORUŽĖLĖS;1623968580;Taip;0;5;1;6
8125;Rūta;BORUŽĖLĖS;3043164521;Taip;0;1;0;1
8126;Rūta;BORUŽĖLĖS;8273644943;Taip;5;0;0;5
8127;Rūta;BORUŽĖLĖS;3454881685;Taip;0;0;2;2
8128;Rūta;BORUŽĖLĖS;1811055786;Taip;0;0;9;9
8129;Rūta;BORUŽĖLĖS;1510268514;Taip;0;15;0;15
8130;Rūta;BORUŽĖLĖS;2702537976;Taip;0;2;3;5
8131;Rūta;BORUŽĖLĖS;4044349935;Taip;0;0;1;1
8132;Rūta;BORUŽĖLĖS;7936198171;Taip;15;0;2;17
8133;Rūta;BORUŽĖLĖS;8963959004;Taip;0;0;2;2
8134;Rūta;BORUŽĖLĖS;2772130413;Taip;4;0;0;4
8135;Rūta;BORUŽĖLĖS;3462986405;Taip;0;0;4;4
8136;Rūta;BORUŽĖLĖS;8548089843;Taip;7;0;0;7
8137;Rūta;BORUŽĖLĖS;1781198136;Taip;0;0;3;3
8138;Rūta;BORUŽĖLĖS;7476034831;Taip;0;0;2;2
8139;Rūta;BORUŽĖLĖS;1182222976;Taip;3;0;5;8
8140;Rūta;VYTURĖLIAI;2084379688;Taip;0;1;0;1
8141;Rūta;VYTURĖLIAI;1363296753;Taip;0;1;0;1
8142;Rūta;VYTURĖLIAI;1703148668;Taip;7;0;0;7
8143;Rūta;VYTURĖLIAI;2079429418;Taip;0;5;0;5
8144;Rūta;VYTURĖLIAI;1043614414;Taip;0;7;0;7
8145;Rūta;VYTURĖLIAI;1150292834;Taip;0;1;0;1
8146;Rūta;VYTURĖLIAI;56470874552;Taip;4;14;0;18
8147;Rūta;VYTURĖLIAI;1177226887;Ne;0;1;0;1
8148;Rūta;VYTURĖLIAI;99777522247;Taip;4;1;0;5
8149;Rūta;VYTURĖLIAI;3247709788;Taip;0;0;10;10
8150;Rūta;"PABIRUČIAI (LOGOPEDINĖ)";1035527190;Taip;0;0;1;1
8151;Rūta;"PABIRUČIAI (LOGOPEDINĖ)";6221528830;Taip;0;1;0;1
8152;Rūta;"PABIRUČIAI (LOGOPEDINĖ)";4911219947;Taip;5;0;0;5
8153;Rūta;"PABIRUČIAI (LOGOPEDINĖ)";4858914868;Taip;18;0;0;18
8154;Rūta;"PABIRUČIAI (LOGOPEDINĖ)";2584812163;Taip;0;0;1;1
8155;Rūta;GUDRUČIAI;1967141665;Taip;0;4;0;4
8156;Rūta;GUDRUČIAI;8851591109;Taip;7;0;2;9
8157;Rūta;GUDRUČIAI;1180144866;Taip;10;0;3;13
8158;Rūta;GUDRUČIAI;3478456813;Taip;0;1;0;1
8159;Rūta;GUDRUČIAI;8889388348;Taip;1;0;1;2
8160;Rūta;GUDRUČIAI;1346367896;Taip;0;6;0;6
8161;Rūta;GUDRUČIAI;2116581815;Taip;0;0;3;3
8162;Rūta;GUDRUČIAI;6006094035;Taip;0;0;9;9
8163;Rūta;GUDRUČIAI;1521231573;Ne;0;0;1;1
8164;Rūta;GUDRUČIAI;7552644990;Taip;1;0;6;7
8165;Rūta;GUDRUČIAI;1092908255;Taip;0;0;1;1
8166;Rūta;GUDRUČIAI;8673942478;Taip;0;0;4;4
8167;Rūta;GUDRUČIAI;4078957924;Ne;5;0;1;6
8168;Rūta;GUDRUČIAI;4754142240;Taip;0;2;1;3
8169;Rūta;GUDRUČIAI;1565896222;Ne;0;0;2;2
8170;Rūta;GUDRUČIAI;8704594038;Taip;0;0;1;1
8171;Rūta;GUDRUČIAI;9386595365;Taip;0;0;9;9
8172;Rūta;SEKLYTĖLĖ;1301573542;Taip;0;1;0;1
8173;Rūta;SEKLYTĖLĖ;4823677957;Taip;5;0;0;5
8174;Rūta;SEKLYTĖLĖ;77285178781;Taip;0;1;0;1
8175;Rūta;SEKLYTĖLĖ;1364470800;Taip;0;2;1;3
8176;Rūta;SEKLYTĖLĖ;1937805277;Taip;0;0;1;1
8177;Rūta;SEKLYTĖLĖ;8604212304;Taip;0;1;0;1
8178;Rūta;SEKLYTĖLĖ;1323253379;Taip;0;1;0;1
8179;Rūta;SEKLYTĖLĖ;26152518052;Taip;0;0;10;10
8180;Rūta;SEKLYTĖLĖ;87692898919;Taip;0;2;0;2
8181;Rūta;SEKLYTĖLĖ;38837808144;Taip;5;0;0;5
8182;Rūta;SEKLYTĖLĖ;3874247966;Taip;0;1;0;1
8183;Rūta;SEKLYTĖLĖ;6032985748;Ne;6;0;0;6
8184;Rūta;"VARPELIAI (LOGOPEDINĖ)";3055294324;Ne;12;0;2;14
8185;Rūta;"VARPELIAI (LOGOPEDINĖ)";3810636967;Taip;0;1;0;1
8186;Rūta;"VARPELIAI (LOGOPEDINĖ)";8992775168;Taip;5;5;0;10
8187;Rūta;"VARPELIAI (LOGOPEDINĖ)";8026402652;Ne;0;0;1;1
8188;Rūta;KIŠKUČIŲ;2601011765;Taip;3;0;3;6
8189;Rūta;KIŠKUČIŲ;2798676079;Taip;0;0;16;16
8190;Rūta;KIŠKUČIŲ;4165080541;Taip;10;0;2;12
8191;Rūta;KIŠKUČIŲ;3877807687;Taip;5;0;5;10
8192;Rūta;KIŠKUČIŲ;9429856388;Taip;2;0;1;3
8193;Rūta;KIŠKUČIŲ;8483916287;Taip;19;0;0;19
8194;Rūta;KIŠKUČIŲ;7724451685;Taip;7;0;4;11
8195;Rūta;KIŠKUČIŲ;5703060401;Ne;0;0;2;2
8196;Rūta;KIŠKUČIŲ;7573269886;Taip;0;0;6;6
8197;Rūta;KIŠKUČIŲ;8138816581;Taip;10;0;6;16
8198;Rūta;KIŠKUČIŲ;2733932207;Taip;3;0;3;6
8199;Rūta;KIŠKUČIŲ;8012225409;Taip;0;0;1;1
8200;Rūta;KIŠKUČIŲ;1290867375;Taip;0;0;11;11
8201;Rūta;KIŠKUČIŲ;4780828296;Taip;0;0;1;1
8202;Rūta;KIŠKUČIŲ;2084935094;Taip;0;0;13;13
8203;Rūta;ŽVIRBLIUKAI;8320521011;Taip;0;0;3;3
8204;Rūta;ŽVIRBLIUKAI;3352007694;Taip;0;0;4;4
8205;Rūta;ŽVIRBLIUKAI;3765741047;Taip;0;0;2;2
8206;Rūta;ŽVIRBLIUKAI;9308127402;Taip;0;0;5;5
8207;Rūta;ŽVIRBLIUKAI;9243332756;Taip;0;2;0;2
8208;Rūta;ŽVIRBLIUKAI;6417693659;Taip;0;0;2;2
8209;Rūta;ŽVIRBLIUKAI;4090915728;Taip;0;1;3;4
8210;Rūta;ŽVIRBLIUKAI;1260386759;Taip;6;0;0;6
8211;Rūta;ŽVIRBLIUKAI;8935780480;Taip;9;0;2;11
8212;Rūta;ŽVIRBLIUKAI;6044060646;Taip;6;0;2;8
8213;Rūta;ŽVIRBLIUKAI;9220661972;Taip;0;0;9;9
8214;Rūta;ŽVIRBLIUKAI;5109026000;Taip;0;0;9;9
8215;Rūta;SAULUTĖS;1671913833;Taip;0;0;1;1
8216;Rūta;SAULUTĖS;9675482322;Ne;0;0;1;1
8217;Rūta;SAULUTĖS;1415664888;Taip;0;0;7;7
8218;Rūta;SAULUTĖS;4426456302;Taip;0;6;3;9
8219;Rūta;SAULUTĖS;1579573872;Taip;0;0;3;3
8220;Rūta;SAULUTĖS;2677062861;Ne;0;0;11;11
8221;Rūta;SAULUTĖS;1390207547;Taip;0;1;0;1
8222;Rūta;SAULUTĖS;32004750783;Taip;0;0;1;1
8223;Rūta;SAULUTĖS;3567273206;Ne;0;0;4;4
8224;Rūta;SAULUTĖS;1368317570;Ne;0;0;1;1
8225;Sadutė;Kiškučiai;38918375280;Taip;0;0;4;4
8226;Sadutė;Kiškučiai;42447771280;Taip;0;1;0;1
8227;Sadutė;Kiškučiai;3253659165;Taip;0;1;0;1
8228;Sadutė;Kiškučiai;67439547513;Taip;0;0;2;2
8229;Sadutė;Kiškučiai;98527988102;Taip;0;1;0;1
8230;Sadutė;Kiškučiai;62077575922;Taip;0;2;0;2
8231;Sadutė;Kiškučiai;75149739907;Taip;3;0;0;3
8232;Sadutė;Kiškučiai;48298497;Taip;0;2;1;3
8233;Sadutė;Kiškučiai;69988140413;Taip;0;0;9;9
8234;Sadutė;Kiškučiai;61357382189;Taip;0;2;0;2
8235;Sadutė;Kiškučiai;1433422421;Taip;0;2;2;4
8236;Sadutė;Kiškučiai;73649870571;Taip;0;1;0;1
8237;Sadutė;Kiškučiai;1092421263;Taip;0;2;0;2
8238;Sadutė;Kiškučiai;1291782232;Taip;0;0;1;1
8239;Sadutė;Kiškučiai;5586949339;Taip;0;0;2;2
8240;Sadutė;Kiškučiai;9883685724;Taip;4;6;0;10
8241;Sadutė;Kiškučiai;4525909977;Taip;6;2;0;8
8242;Sadutė;Kiškučiai;1533081218;Taip;0;0;1;1
8243;Sadutė;Kiškučiai;1084400276;Taip;3;1;2;6
8244;Sadutė;Kiškučiai;1946228564;Taip;0;0;2;2
8245;Sadutė;Boružėlės;1273355194;Ne;10;0;0;10
8246;Sadutė;Boružėlės;3119547420;Ne;10;0;0;10
8247;Sadutė;Boružėlės;7504712544;Taip;0;19;0;19
8248;Sadutė;Boružėlės;8987528237;Taip;0;0;1;1
8249;Sadutė;Boružėlės;8914509685;Taip;0;0;1;1
8250;Sadutė;Boružėlės;5682745869;Taip;10;0;0;10
8251;Sadutė;Boružėlės;7072437339;Taip;3;0;0;3
8252;Sadutė;Bitutės;1759479328;Taip;0;1;0;1
8253;Sadutė;Bitutės;1975767401;Taip;4;0;0;4
8254;Sadutė;Bitutės;4245873513;Taip;4;0;2;6
8255;Sadutė;Bitutės;1873928395;Taip;4;0;1;5
8256;Sadutė;Bitutės;5866461096;Taip;9;0;0;9
8257;Sadutė;Bitutės;4883934480;Taip;11;1;0;12
8258;Sadutė;Bitutės;4479315578;Taip;0;1;0;1
8259;Sadutė;Bitutės;2020766695;Taip;0;21;0;21
8260;Sadutė;Bitutės;5011320850;Taip;0;0;5;5
8261;Sadutė;Bitutės;4161502667;Taip;15;0;0;15
8262;Sadutė;Bitutės;5973513916;Taip;5;6;0;11
8263;Sadutė;Bitutės;5169694660;Taip;0;1;0;1
8264;Sadutė;Bitutės;3361904803;Taip;11;0;1;12
8265;Sadutė;Bitutės;1231048342;Taip;0;1;0;1
8266;Sadutė;Bitutės;2355177889;Taip;3;0;1;4
8267;Sadutė;Drugeliai;9090754149;Taip;2;0;0;2
8268;Sadutė;Drugeliai;1552350084;Taip;0;4;1;5
8269;Sadutė;Drugeliai;7910380894;Taip;0;0;1;1
8270;Sadutė;Drugeliai;2467800545;Taip;0;0;3;3
8271;Sadutė;Drugeliai;4402558234;Taip;0;3;0;3
8272;Sadutė;Drugeliai;6994547344;Taip;0;0;1;1
8273;Sadutė;Drugeliai;1782594187;Taip;0;4;0;4
8274;Sadutė;Drugeliai;5816844295;Taip;0;4;0;4
8275;Sadutė;Drugeliai;8803249656;Taip;3;1;5;9
8276;Sadutė;Drugeliai;6196282159;Taip;9;0;3;12
8277;Sadutė;Drugeliai;8953107298;Taip;2;0;7;9
8278;Sadutė;Drugeliai;5139219626;Taip;0;0;1;1
8279;Sadutė;Drugeliai;1735450955;Taip;0;2;0;2
8280;Sadutė;Drugeliai;2064784580;Taip;0;2;0;2
8281;Sadutė;Drugeliai;7731164484;Taip;3;4;0;7
8282;Sadutė;Drugeliai;2014660237;Taip;21;0;0;21
8283;Sadutė;Drugeliai;6124376554;Taip;3;0;2;5
8284;Sadutė;Drugeliai;36769610742;Ne;0;0;1;1
8285;Sadutė;Drugeliai;1956224017;Taip;0;0;4;4
8286;Sadutė;Pėledžiukai;50662732693;Taip;0;0;5;5
8287;Sadutė;Pėledžiukai;1885941594;Taip;0;0;1;1
8288;Sadutė;Pėledžiukai;4933574100;Taip;0;0;3;3
8289;Sadutė;Pėledžiukai;6105924871;Taip;6;0;0;6
8290;Sadutė;Pėledžiukai;8870465478;Taip;0;10;2;12
8291;Sadutė;Pėledžiukai;64835095908;Taip;0;0;1;1
8292;Sadutė;Pėledžiukai;14962142857;Taip;0;2;0;2
8293;Sadutė;Pėledžiukai;92111253012;Taip;0;0;2;2
8294;Sadutė;Pėledžiukai;1594844154;Taip;0;0;3;3
8295;Sadutė;Pėledžiukai;1005751811;Taip;0;0;3;3
8296;Sadutė;Pėledžiukai;45981672295;Taip;0;1;1;2
8297;Sadutė;Pėledžiukai;9946417453;Taip;0;0;4;4
8298;Sadutė;Pėledžiukai;48818906299;Taip;0;8;2;10
8299;Sadutė;Pėledžiukai;1190667513;Taip;0;7;3;10
8300;Sadutė;Pėledžiukai;1985946393;Taip;0;5;1;6
8301;Sadutė;Pėledžiukai;6301749078;Taip;11;0;1;12
8302;Sadutė;Pėledžiukai;21138396996;Ne;0;0;3;3
8303;Sadutė;Pėledžiukai;8943620706;Taip;10;0;0;10
8304;Sadutė;Kačiukų;1507052440;Taip;6;0;6;12
8305;Sadutė;Kačiukų;1903961488;Taip;0;0;3;3
8306;Sadutė;Kačiukų;2890916313;Taip;0;0;2;2
8307;Sadutė;Kačiukų;8835627470;Taip;1;1;1;3
8308;Sadutė;Kačiukų;2466024649;Taip;0;1;1;2
8309;Sadutė;Kačiukų;2426974464;Taip;5;0;0;5
8310;Sadutė;Kačiukų;8974374101;Taip;0;0;4;4
8311;Sadutė;Kačiukų;4401870028;Taip;0;0;1;1
8312;Sadutė;Kačiukų;8714168144;Taip;5;0;0;5
8313;Sadutė;Kačiukų;8974225608;Taip;5;0;0;5
8314;Sadutė;Kačiukų;8770727233;Taip;21;0;0;21
8315;Sadutė;Kačiukų;8556218971;Taip;10;0;1;11
8316;Sadutė;Kačiukų;6538356822;Taip;4;0;1;5
8317;Sakalėlis;GIRINUKŲ;9566176151;Taip;21;0;0;21
8318;Sakalėlis;GIRINUKŲ;5405669698;Ne;0;1;0;1
8319;Sakalėlis;GIRINUKŲ;2474164013;Taip;4;1;0;5
8320;Sakalėlis;GIRINUKŲ;9493905856;Taip;11;0;5;16
8321;Sakalėlis;GIRINUKŲ;5496044442;Taip;0;0;3;3
8322;Sakalėlis;GIRINUKŲ;3165387995;Taip;0;0;2;2
8323;Sakalėlis;GIRINUKŲ;3748865437;Taip;0;0;2;2
8324;Sakalėlis;GIRINUKŲ;6700169944;Ne;7;0;0;7
8325;Sakalėlis;GIRINUKŲ;3333037807;Taip;1;2;0;3
8326;Sakalėlis;GIRINUKŲ;8667155756;Taip;5;0;1;6
8327;Sakalėlis;GIRINUKŲ;6706466627;Taip;0;8;0;8
8328;Sakalėlis;GIRINUKŲ;8790189865;Taip;0;0;1;1
8329;Sakalėlis;GIRINUKŲ;4458071075;Taip;6;0;7;13
8330;Sakalėlis;GIRINUKŲ;4209146744;Taip;3;0;1;4
8331;Sakalėlis;GIRINUKŲ;2780141413;Taip;0;2;0;2
8332;Sakalėlis;GIRINUKŲ;1347171934;Taip;5;1;0;6
8333;Sakalėlis;GIRINUKŲ;9250470549;Taip;0;0;1;1
8334;Sakalėlis;VYTURIUKŲ;9976735354;Taip;0;0;5;5
8335;Sakalėlis;VYTURIUKŲ;3927487265;Taip;0;0;1;1
8336;Sakalėlis;VYTURIUKŲ;2352118061;Ne;0;5;0;5
8337;Sakalėlis;VYTURIUKŲ;3680732318;Ne;0;8;1;9
8338;Sakalėlis;VYTURIUKŲ;4862004373;Ne;0;5;0;5
8339;Sakalėlis;VYTURIUKŲ;8422299669;Taip;0;0;2;2
8340;Sakalėlis;VYTURIUKŲ;6579827280;Taip;0;6;3;9
8341;Sakalėlis;VYTURIUKŲ;8381310908;Taip;0;0;2;2
8342;Sakalėlis;VYTURIUKŲ;6840368824;Taip;10;0;1;11
8343;Sakalėlis;VYTURIUKŲ;7285833058;Taip;13;0;0;13
8344;Sakalėlis;VYTURIUKŲ;5795250727;Taip;6;0;5;11
8345;Sakalėlis;VYTURIUKŲ;2985239904;Taip;0;6;0;6
8346;Sakalėlis;VYTURIUKŲ;3351218789;Ne;0;0;3;3
8347;Sakalėlis;VYTURIUKŲ;9120873899;Ne;12;0;0;12
8348;Sakalėlis;VYTURIUKŲ;5991029760;Taip;0;0;5;5
8349;Sakalėlis;VYTURIUKŲ;6378711142;Taip;2;0;2;4
8350;Sakalėlis;DRUGELIŲ;8095359035;Taip;6;0;6;12
8351;Sakalėlis;DRUGELIŲ;6515519140;Taip;6;0;0;6
8352;Sakalėlis;DRUGELIŲ;7706606275;Taip;0;0;1;1
8353;Sakalėlis;DRUGELIŲ;5911341542;Taip;0;0;1;1
8354;Sakalėlis;DRUGELIŲ;9416737436;Taip;0;0;4;4
8355;Sakalėlis;DRUGELIŲ;2898006208;Taip;6;0;0;6
8356;Sakalėlis;DRUGELIŲ;7542322748;Taip;12;0;1;13
8357;Sakalėlis;DRUGELIŲ;4918228191;Taip;0;0;1;1
8358;Sakalėlis;DRUGELIŲ;1201086815;Taip;4;0;5;9
8359;Sakalėlis;DRUGELIŲ;3934295338;Taip;12;0;0;12
8360;Sakalėlis;DRUGELIŲ;6586215199;Taip;0;7;0;7
8361;Sakalėlis;DRUGELIŲ;1117800518;Taip;16;0;0;16
8362;Sakalėlis;DRUGELIŲ;2515169899;Taip;5;0;0;5
8363;Sakalėlis;DRUGELIŲ;8160589611;Taip;0;1;0;1
8364;Sakalėlis;DRUGELIŲ;1833573491;Taip;5;0;2;7
8365;Sakalėlis;DRUGELIŲ;8713298648;Taip;5;0;1;6
8366;Sakalėlis;DRUGELIŲ;2889638745;Taip;0;0;1;1
8367;Sakalėlis;GENIUKŲ;4763858893;Taip;0;10;3;13
8368;Sakalėlis;GENIUKŲ;43677485606;Taip;0;3;0;3
8369;Sakalėlis;GENIUKŲ;8649226611;Taip;0;0;2;2
8370;Sakalėlis;GENIUKŲ;5717022080;Taip;5;0;0;5
8371;Sakalėlis;GENIUKŲ;4515180509;Taip;0;0;5;5
8372;Sakalėlis;GENIUKŲ;1027765680;Taip;0;2;0;2
8373;Sakalėlis;GENIUKŲ;81681433432;Taip;0;0;2;2
8374;Sakalėlis;GENIUKŲ;96053733139;Taip;0;0;3;3
8375;Sakalėlis;GENIUKŲ;4612388683;Taip;0;9;0;9
8376;Sakalėlis;GENIUKŲ;7159705304;Taip;0;1;0;1
8377;Sakalėlis;GENIUKŲ;4775685174;Taip;0;0;1;1
8378;Sakalėlis;GENIUKŲ;69916351348;Taip;14;0;1;15
8379;Sakalėlis;GENIUKŲ;1552929452;Taip;0;3;0;3
8380;Sakalėlis;GENIUKŲ;8936933971;Taip;5;0;6;11
8381;Sakalėlis;GENIUKŲ;2829386777;Taip;7;0;2;9
8382;Sakalėlis;GENIUKŲ;3371763993;Taip;4;0;0;4
8383;Sakalėlis;GENIUKŲ;7085108710;Taip;19;0;1;20
8384;Sakalėlis;GENIUKŲ;6301366135;Taip;0;1;0;1
8385;Sakalėlis;GENIUKŲ;4364341933;Taip;7;0;1;8
8386;Sakalėlis;VOVERIUKŲ;4430763418;Taip;0;14;0;14
8387;Sakalėlis;VOVERIUKŲ;6190741162;Ne;0;0;1;1
8388;Sakalėlis;VOVERIUKŲ;1702964714;Taip;0;5;0;5
8389;Sakalėlis;VOVERIUKŲ;1839096675;Ne;0;0;1;1
8390;Sakalėlis;VOVERIUKŲ;3962436122;Taip;4;3;0;7
8391;Sakalėlis;VOVERIUKŲ;1946531018;Taip;4;0;1;5
8392;Sakalėlis;VOVERIUKŲ;2796230671;Taip;2;0;1;3
8393;Sakalėlis;VOVERIUKŲ;1210451022;Taip;0;8;1;9
8394;Sakalėlis;VOVERIUKŲ;1912068116;Taip;7;0;1;8
8395;Sakalėlis;VOVERIUKŲ;8662137531;Taip;2;0;2;4
8396;Sakalėlis;VOVERIUKŲ;1104881142;Taip;0;1;0;1
8397;Sakalėlis;VOVERIUKŲ;46629941288;Taip;0;0;1;1
8398;Sakalėlis;VOVERIUKŲ;3678172501;Taip;4;1;0;5
8399;Sakalėlis;VOVERIUKŲ;1133377117;Taip;10;0;1;11
8400;Sakalėlis;VOVERIUKŲ;5782214279;Taip;0;0;3;3
8401;Sakalėlis;VOVERIUKŲ;34464485043;Ne;5;0;2;7
8402;Sakalėlis;VOVERIUKŲ;7567476424;Taip;10;0;2;12
8403;Sakalėlis;VOVERIUKŲ;6180987643;Taip;11;0;1;12
8404;Sakalėlis;VOVERIUKŲ;8852001037;Taip;0;0;10;10
8405;Sakalėlis;VOVERIUKŲ;2055710873;Taip;0;0;1;1
8406;Sakalėlis;PĖLEDŽIUKŲ;1974955778;Taip;8;0;0;8
8407;Sakalėlis;PĖLEDŽIUKŲ;4573623341;Taip;0;0;10;10
8408;Sakalėlis;PĖLEDŽIUKŲ;3781188811;Taip;10;0;0;10
8409;Sakalėlis;PĖLEDŽIUKŲ;32890764904;Taip;0;0;1;1
8410;Sakalėlis;PĖLEDŽIUKŲ;58113060986;Taip;2;0;0;2
8411;Sakalėlis;PĖLEDŽIUKŲ;89579043958;Taip;0;3;0;3
8412;Sakalėlis;PĖLEDŽIUKŲ;54902207576;Taip;0;2;0;2
8413;Sakalėlis;PĖLEDŽIUKŲ;81593611262;Taip;4;0;0;4
8414;Sakalėlis;PĖLEDŽIUKŲ;33825546706;Taip;6;1;0;7
8415;Sakalėlis;PĖLEDŽIUKŲ;1790571847;Taip;0;10;0;10
8416;Sakalėlis;PĖLEDŽIUKŲ;81361557297;Taip;0;0;1;1
8417;Sakalėlis;PĖLEDŽIUKŲ;39504139934;Taip;0;0;3;3
8418;Sakalėlis;PĖLEDŽIUKŲ;67193921335;Taip;0;0;2;2
8419;Sakalėlis;PĖLEDŽIUKŲ;37201848270;Taip;6;0;0;6
8420;Sakalėlis;PĖLEDŽIUKŲ;79413947806;Taip;0;5;1;6
8421;Sakalėlis;PĖLEDŽIUKŲ;77801416034;Taip;0;0;1;1
8422;Sakalėlis;PĖLEDŽIUKŲ;1359444361;Taip;0;0;1;1
8423;Sakalėlis;"BITUČIŲ (LOGOPEDINĖ)";7241416465;Ne;0;0;1;1
8424;Sakalėlis;"BITUČIŲ (LOGOPEDINĖ)";6321575268;Taip;15;0;0;15
8425;Sakalėlis;"BITUČIŲ (LOGOPEDINĖ)";4857211754;Taip;0;0;2;2
8426;Sakalėlis;"BITUČIŲ (LOGOPEDINĖ)";8610668395;Taip;13;0;4;17
8427;Sakalėlis;"BITUČIŲ (LOGOPEDINĖ)";5377250664;Ne;1;0;0;1
8428;Sakalėlis;"BITUČIŲ (LOGOPEDINĖ)";1384225025;Ne;5;0;1;6
8429;Sakalėlis;"BITUČIŲ (LOGOPEDINĖ)";46481555688;Taip;10;0;5;15
8430;Sakalėlis;"BITUČIŲ (LOGOPEDINĖ)";5018151097;Taip;5;0;1;6
8431;Sakalėlis;"BITUČIŲ (LOGOPEDINĖ)";6259640492;Taip;11;0;3;14
8432;Sakalėlis;"BITUČIŲ (LOGOPEDINĖ)";1723436498;Ne;0;0;1;1
8433;Sakalėlis;"BORUŽIUKŲ (LOGOPEDINĖ)";4514546151;Taip;0;2;0;2
8434;Sakalėlis;"BORUŽIUKŲ (LOGOPEDINĖ)";2074868084;Taip;10;0;1;11
8435;Sakalėlis;"BORUŽIUKŲ (LOGOPEDINĖ)";4495453007;Taip;4;0;0;4
8436;Sakalėlis;"BORUŽIUKŲ (LOGOPEDINĖ)";8668671325;Ne;0;1;0;1
8437;Sakalėlis;"BORUŽIUKŲ (LOGOPEDINĖ)";3972897839;Ne;0;10;4;14
8438;Sakalėlis;"BORUŽIUKŲ (LOGOPEDINĖ)";2124857941;Ne;0;1;0;1
8439;Sakalėlis;"BORUŽIUKŲ (LOGOPEDINĖ)";1806698668;Ne;0;0;1;1
8440;Sakalėlis;"BORUŽIUKŲ (LOGOPEDINĖ)";9823633774;Taip;5;0;1;6
8441;Sakalėlis;"BORUŽIUKŲ (LOGOPEDINĖ)";6727251397;Taip;0;13;0;13
8442;Sakalėlis;"BORUŽIUKŲ (LOGOPEDINĖ)";6250400609;Taip;10;0;0;10
8443;Sakalėlis;MEŠKUČIŲ;3927363997;Taip;5;3;0;8
8444;Sakalėlis;MEŠKUČIŲ;9592852011;Taip;0;0;1;1
8445;Sakalėlis;MEŠKUČIŲ;7165739418;Ne;0;0;6;6
8446;Sakalėlis;MEŠKUČIŲ;6414564366;Taip;7;0;3;10
8447;Sakalėlis;MEŠKUČIŲ;1736303381;Ne;5;9;1;15
8448;Sakalėlis;MEŠKUČIŲ;1953356983;Taip;14;0;6;20
8449;Sakalėlis;MEŠKUČIŲ;1200252225;Taip;5;0;0;5
8450;Sakalėlis;MEŠKUČIŲ;4358313171;Taip;5;0;1;6
8451;Sakalėlis;MEŠKUČIŲ;2531146677;Taip;16;0;0;16
8452;Sakalėlis;MEŠKUČIŲ;8133985842;Taip;2;0;1;3
8453;Sakalėlis;MEŠKUČIŲ;3574956316;Taip;0;0;3;3
8454;Sakalėlis;MEŠKUČIŲ;7280513854;Taip;0;0;1;1
8455;Sakalėlis;MEŠKUČIŲ;2575873447;Taip;0;5;0;5
8456;Sakalėlis;MEŠKUČIŲ;1403384561;Taip;0;0;2;2
8457;Sakalėlis;MEŠKUČIŲ;6778987483;Taip;6;2;6;14
8458;Sakalėlis;MEŠKUČIŲ;7602249339;Taip;9;0;0;9
8459;Sakalėlis;MEŠKUČIŲ;2699844937;Taip;9;0;1;10
8460;Sakalėlis;MEŠKUČIŲ;2557089391;Taip;15;0;0;15
8461;Sakalėlis;MEŠKUČIŲ;6293226507;Taip;0;5;0;5
8462;Sakalėlis;KIŠKUČIŲ;2672429406;Ne;15;0;5;20
8463;Sakalėlis;KIŠKUČIŲ;2250828607;Ne;15;0;5;20
8464;Sakalėlis;KIŠKUČIŲ;9776767584;Taip;16;0;0;16
8465;Sakalėlis;KIŠKUČIŲ;2537030533;Taip;0;0;6;6
8466;Sakalėlis;KIŠKUČIŲ;5500248048;Ne;0;1;0;1
8467;Sakalėlis;KIŠKUČIŲ;1253452975;Taip;8;0;0;8
8468;Sakalėlis;KIŠKUČIŲ;8328069876;Taip;0;0;1;1
8469;Sakalėlis;KIŠKUČIŲ;8501785305;Taip;0;0;1;1
8470;Sakalėlis;KIŠKUČIŲ;3719351129;Taip;0;7;0;7
8471;Sakalėlis;KIŠKUČIŲ;5165684803;Taip;0;0;2;2
8472;Sakalėlis;KIŠKUČIŲ;6597274376;Taip;15;0;0;15
8473;Sakalėlis;KIŠKUČIŲ;8562164673;Taip;0;0;3;3
8474;Sakalėlis;KIŠKUČIŲ;7852255204;Taip;0;15;0;15
8475;Sakalėlis;KIŠKUČIŲ;9926328835;Ne;0;0;1;1
8476;Sakalėlis;KIŠKUČIŲ;6889888573;Taip;0;0;6;6
8477;Sakalėlis;SVIRPLIUKŲ;3092760315;Taip;0;8;0;8
8478;Sakalėlis;SVIRPLIUKŲ;8506013777;Taip;13;0;0;13
8479;Sakalėlis;SVIRPLIUKŲ;5189603013;Taip;4;0;1;5
8480;Sakalėlis;SVIRPLIUKŲ;5201020765;Taip;10;1;0;11
8481;Sakalėlis;SVIRPLIUKŲ;7154383856;Taip;20;0;0;20
8482;Sakalėlis;SVIRPLIUKŲ;5961861760;Taip;5;0;0;5
8483;Sakalėlis;SVIRPLIUKŲ;7285230768;Taip;3;0;2;5
8484;Sakalėlis;SVIRPLIUKŲ;5677280944;Taip;9;0;0;9
8485;Sakalėlis;SVIRPLIUKŲ;4063074948;Ne;5;0;2;7
8486;Sakalėlis;SVIRPLIUKŲ;2945027875;Ne;8;0;2;10
8487;Sakalėlis;SVIRPLIUKŲ;8535457018;Taip;0;8;0;8
8488;Sakalėlis;SVIRPLIUKŲ;8108456923;Taip;5;0;0;5
8489;Salininkų;BORUŽIUKAI;6885580632;Taip;10;0;1;11
8490;Salininkų;BORUŽIUKAI;8095820690;Taip;6;0;1;7
8491;Salininkų;BORUŽIUKAI;6482437251;Taip;14;0;1;15
8492;Salininkų;BORUŽIUKAI;9896357816;Taip;10;0;1;11
8493;Salininkų;BORUŽIUKAI;8552427446;Taip;0;0;2;2
8494;Salininkų;BORUŽIUKAI;7643665643;Taip;5;0;1;6
8495;Salininkų;BORUŽIUKAI;9198411540;Taip;8;0;1;9
8496;Salininkų;BORUŽIUKAI;7409604480;Taip;10;0;0;10
8497;Salininkų;BORUŽIUKAI;3677558828;Taip;0;6;0;6
8498;Salininkų;BORUŽIUKAI;4529253958;Taip;5;0;4;9
8499;Salininkų;BORUŽIUKAI;1380797788;Ne;5;4;0;9
8500;Salininkų;BORUŽIUKAI;1111197633;Taip;0;0;3;3
8501;Salininkų;BORUŽIUKAI;2495782496;Ne;0;0;10;10
8502;Salininkų;BORUŽIUKAI;4568462071;Ne;13;0;0;13
8503;Salininkų;BORUŽIUKAI;6143967744;Ne;6;0;0;6
8504;Salininkų;BORUŽIUKAI;7463713798;Taip;11;0;2;13
8505;Salininkų;GĖLYTĖS;4971070998;Taip;0;0;1;1
8506;Salininkų;GĖLYTĖS;9893985732;Taip;4;0;0;4
8507;Salininkų;GĖLYTĖS;3686372180;Taip;6;0;0;6
8508;Salininkų;GĖLYTĖS;3703729963;Taip;12;0;0;12
8509;Salininkų;GĖLYTĖS;3338213592;Taip;0;3;0;3
8510;Salininkų;GĖLYTĖS;9482632726;Taip;8;2;0;10
8511;Salininkų;GĖLYTĖS;3464228778;Taip;6;0;0;6
8512;Salininkų;GĖLYTĖS;1453214735;Taip;0;1;0;1
8513;Salininkų;GĖLYTĖS;2440831687;Taip;5;6;0;11
8514;Salininkų;GĖLYTĖS;1284909139;Taip;0;5;0;5
8515;Salininkų;GĖLYTĖS;5164367382;Ne;5;0;2;7
8516;Salininkų;DRUGELIAI;9018366347;Taip;1;0;0;1
8517;Salininkų;DRUGELIAI;2684868661;Taip;15;0;0;15
8518;Salininkų;DRUGELIAI;8063397588;Taip;10;0;0;10
8519;Salininkų;DRUGELIAI;3115232507;Taip;3;0;2;5
8520;Salininkų;DRUGELIAI;8602489420;Taip;0;9;0;9
8521;Salininkų;DRUGELIAI;3420217477;Taip;9;0;0;9
8522;Salininkų;DRUGELIAI;3890914603;Taip;0;0;1;1
8523;Salininkų;DRUGELIAI;3181932118;Taip;6;0;0;6
8524;Salininkų;DRUGELIAI;5017068344;Taip;6;0;1;7
8525;Salininkų;DRUGELIAI;3761217912;Taip;8;0;0;8
8526;Salininkų;DRUGELIAI;9853754621;Taip;10;0;0;10
8527;Salininkų;DRUGELIAI;3963410827;Taip;17;0;0;17
8528;Salininkų;DRUGELIAI;5539560359;Ne;0;0;4;4
8529;Salininkų;DRUGELIAI;5587577036;Taip;15;0;0;15
8530;Salininkų;ŽIRNIUKAI;5063792784;Taip;5;0;1;6
8531;Salininkų;ŽIRNIUKAI;73016259669;Ne;0;1;0;1
8532;Salininkų;ŽIRNIUKAI;1355032282;Taip;5;1;0;6
8533;Salininkų;ŽIRNIUKAI;1180792335;Taip;0;2;0;2
8534;Salininkų;ŽIRNIUKAI;22167560908;Taip;0;2;0;2
8535;Salininkų;ŽIRNIUKAI;9513785510;Taip;0;1;0;1
8536;Salininkų;ŽIRNIUKAI;5689344488;Taip;7;0;0;7
8537;Salininkų;ŽIRNIUKAI;2292919406;Taip;11;7;0;18
8538;Salininkų;ŽIRNIUKAI;8683841956;Taip;0;2;0;2
8539;Salininkų;ŽIRNIUKAI;8488127476;Taip;4;0;0;4
8540;Salininkų;ŽIRNIUKAI;1723241116;Taip;10;0;0;10
8541;Salininkų;ŽIRNIUKAI;46867660097;Taip;9;4;0;13
8542;Salininkų;ŽIRNIUKAI;4269202761;Taip;15;0;3;18
8543;Salininkų;ŽIRNIUKAI;3692008687;Taip;7;3;0;10
8544;Salininkų;ŽIRNIUKAI;91859774311;Taip;0;1;0;1
8545;Salininkų;ŽIRNIUKAI;1065549119;Taip;0;1;0;1
8546;Salininkų;ŽIRNIUKAI;1460694577;Taip;5;1;0;6
8547;Salininkų;ŽIRNIUKAI;10335028421;Taip;2;7;0;9
8548;Salininkų;ŽIRNIUKAI;8410624264;Taip;0;6;0;6
8549;Salininkų;ŽIRNIUKAI;7918995181;Taip;4;3;0;7
8550;Salininkų;ŽIRNIUKAI;1544346282;Ne;0;1;0;1
8551;Salininkų;ŽIRNIUKAI;16967442608;Taip;0;1;0;1
8552;Salininkų;PAUKŠČIUKAI;5427013789;Taip;0;3;0;3
8553;Salininkų;PAUKŠČIUKAI;3100499807;Taip;0;3;0;3
8554;Salininkų;PAUKŠČIUKAI;6850925495;Taip;0;4;0;4
8555;Salininkų;PAUKŠČIUKAI;3015863723;Taip;13;1;0;14
8556;Salininkų;PAUKŠČIUKAI;3323233525;Taip;13;1;0;14
8557;Salininkų;PAUKŠČIUKAI;5867676844;Taip;0;0;3;3
8558;Salininkų;PAUKŠČIUKAI;3585435095;Taip;5;0;0;5
8559;Salininkų;PAUKŠČIUKAI;2760231414;Taip;5;7;0;12
8560;Salininkų;PAUKŠČIUKAI;7665409499;Taip;8;0;1;9
8561;Salininkų;PAUKŠČIUKAI;9724367035;Taip;0;2;0;2
8562;Salininkų;PAUKŠČIUKAI;1658695150;Taip;0;0;5;5
8563;Salininkų;PAUKŠČIUKAI;7383557807;Taip;4;7;0;11
8564;Salininkų;PAUKŠČIUKAI;9344614003;Ne;0;1;0;1
8565;Salininkų;PAUKŠČIUKAI;2808778763;Taip;0;9;0;9
8566;Salininkų;PAUKŠČIUKAI;6656578271;Ne;0;1;0;1
8567;Salininkų;PAUKŠČIUKAI;7737045952;Taip;2;0;2;4
8568;Salininkų;PAUKŠČIUKAI;9890660815;Ne;0;0;1;1
8569;Salininkų;PAUKŠČIUKAI;8995565864;Taip;0;3;0;3
8570;Salininkų;PAUKŠČIUKAI;7782972361;Taip;0;3;0;3
8571;Salininkų;PAUKŠČIUKAI;8394582546;Taip;0;5;0;5
8572;Salininkų;PAUKŠČIUKAI;6327046935;Ne;0;2;1;3
8573;Salininkų;PAUKŠČIUKAI;4425748908;Ne;6;3;0;9
8574;Salininkų;BITUTĖS;3252151974;Taip;8;5;0;13
8575;Salininkų;BITUTĖS;6845471044;Ne;9;0;2;11
8576;Salininkų;BITUTĖS;2467926286;Taip;0;0;2;2
8577;Salininkų;BITUTĖS;8774984357;Taip;0;0;1;1
8578;Salininkų;BITUTĖS;9902751686;Taip;6;0;0;6
8579;Salininkų;BITUTĖS;6551489987;Taip;9;0;0;9
8580;Salininkų;BITUTĖS;7639362434;Taip;5;11;0;16
8581;Salininkų;BITUTĖS;9996809930;Taip;0;0;3;3
8582;Salininkų;BITUTĖS;2370778977;Taip;8;0;5;13
8583;Salininkų;BITUTĖS;1020073382;Taip;8;0;5;13
8584;Salininkų;BITUTĖS;4480303856;Taip;7;0;0;7
8585;Salininkų;BITUTĖS;3915336062;Ne;14;0;0;14
8586;Salvija;Daigelis(šatil);3856351749;Taip;5;1;0;6
8587;Salvija;Daigelis(šatil);1791922219;Taip;6;1;0;7
8588;Salvija;Daigelis(šatil);8158680641;Taip;0;2;0;2
8589;Salvija;Daigelis(šatil);1062662192;Taip;0;0;15;15
8590;Salvija;Daigelis(šatil);6706565915;Taip;8;0;0;8
8591;Salvija;Daigelis(šatil);7477171133;Taip;7;5;0;12
8592;Salvija;Daigelis(šatil);8853389268;Taip;0;5;0;5
8593;Salvija;Daigelis(šatil);4577248630;Ne;0;2;12;14
8594;Salvija;Daigelis(šatil);9978634888;Taip;16;0;0;16
8595;Salvija;Daigelis(šatil);1676795179;Ne;10;0;0;10
8596;Salvija;Daigelis(šatil);6584491394;Taip;12;0;0;12
8597;Salvija;Daigelis(šatil);1509182157;Taip;0;0;15;15
8598;Salvija;Daigelis(šatil);1511271658;Taip;6;0;1;7
8599;Salvija;Daigelis(šatil);3345231579;Taip;12;0;0;12
8600;Salvija;Daigelis(šatil);3640213912;Ne;0;0;2;2
8601;Salvija;"Pienė (savjon)";5494438837;Taip;9;0;2;11
8602;Salvija;"Pienė (savjon)";1103379012;Taip;0;0;1;1
8603;Salvija;"Pienė (savjon)";1777783229;Taip;0;10;0;10
8604;Salvija;"Pienė (savjon)";1478775998;Taip;6;0;3;9
8605;Salvija;"Pienė (savjon)";24038366791;Taip;0;0;1;1
8606;Salvija;"Pienė (savjon)";5784594015;Taip;3;0;0;3
8607;Salvija;"Pienė (savjon)";8725965215;Taip;0;0;1;1
8608;Salvija;"Pienė (savjon)";9908473681;Taip;0;0;3;3
8609;Salvija;"Pienė (savjon)";1910653135;Ne;0;0;8;8
8610;Salvija;"Pienė (savjon)";1038604477;Taip;0;0;4;4
8611;Salvija;"Pienė (savjon)";8023422294;Taip;21;0;0;21
8612;Salvija;"Pienė (savjon)";4152602039;Taip;6;0;0;6
8613;Salvija;"Pienė (savjon)";8981331532;Taip;0;0;14;14
8614;Salvija;"Pienė (savjon)";8306404275;Taip;0;0;3;3
8615;Salvija;"Pienė (savjon)";8013023311;Taip;4;0;0;4
8616;Salvija;"Pienė (savjon)";1653831148;Taip;0;2;0;2
8617;Saulėtekis;BERŽELIS;8023603198;Taip;5;0;0;5
8618;Saulėtekis;BERŽELIS;8869169590;Taip;18;0;1;19
8619;Saulėtekis;BERŽELIS;8086451893;Taip;5;0;2;7
8620;Saulėtekis;BERŽELIS;2935641362;Taip;5;0;2;7
8621;Saulėtekis;BERŽELIS;4676218435;Taip;0;0;1;1
8622;Saulėtekis;BERŽELIS;7598254324;Taip;12;0;0;12
8623;Saulėtekis;BERŽELIS;9351122147;Taip;17;0;0;17
8624;Saulėtekis;BERŽELIS;5468364505;Taip;0;0;6;6
8625;Saulėtekis;BERŽELIS;4704426104;Taip;0;0;2;2
8626;Saulėtekis;BERŽELIS;8468491266;Taip;7;0;0;7
8627;Saulėtekis;BERŽELIS;7407540257;Taip;1;0;1;2
8628;Saulėtekis;BERŽELIS;7436158953;Ne;5;0;1;6
8629;Saulėtekis;BERŽELIS;6920619390;Taip;0;0;2;2
8630;Saulėtekis;BERŽELIS;9417959173;Taip;0;0;1;1
8631;Saulėtekis;BERŽELIS;7698241758;Taip;9;0;0;9
8632;Saulėtekis;BERŽELIS;5194925689;Taip;0;1;0;1
8633;Saulėtekis;BERŽELIS;2177470008;Taip;12;2;0;14
8634;Saulėtekis;ŠYPSENA;1720125332;Taip;5;0;0;5
8635;Saulėtekis;ŠYPSENA;9972687066;Taip;12;0;0;12
8636;Saulėtekis;ŠYPSENA;7346852524;Ne;8;0;0;8
8637;Saulėtekis;ŠYPSENA;1902333363;Taip;11;0;1;12
8638;Saulėtekis;ŠYPSENA;7893982893;Ne;3;0;1;4
8639;Saulėtekis;ŠYPSENA;7505040675;Taip;12;1;0;13
8640;Saulėtekis;ŠYPSENA;6501250875;Taip;7;0;0;7
8641;Saulėtekis;ŠYPSENA;9791926936;Taip;16;0;0;16
8642;Saulėtekis;ŠYPSENA;8620689981;Taip;0;0;2;2
8643;Saulėtekis;ŠYPSENA;8143793642;Taip;0;1;1;2
8644;Saulėtekis;ŠYPSENA;7673965242;Taip;15;0;0;15
8645;Saulėtekis;ŠYPSENA;3166959569;Taip;5;0;3;8
8646;Saulėtekis;ŠYPSENA;9661075465;Taip;4;1;0;5
8647;Saulėtekis;ŠYPSENA;9383567339;Ne;4;2;0;6
8648;Saulėtekis;ŠYPSENA;6608831217;Taip;2;0;0;2
8649;Saulėtekis;ŠYPSENA;8239855620;Taip;0;0;1;1
8650;Saulėtekis;ŠYPSENA;7730889108;Ne;7;0;0;7
8651;Saulėtekis;ŠYPSENA;7435424899;Taip;4;0;3;7
8652;Saulėtekis;ŠYPSENA;8231869593;Taip;3;1;0;4
8653;Saulėtekis;ŠYPSENA;7803735686;Taip;5;0;0;5
8654;Saulėtekis;NYKŠTUKAI;8881524909;Ne;10;0;1;11
8655;Saulėtekis;NYKŠTUKAI;8061477303;Taip;5;0;0;5
8656;Saulėtekis;NYKŠTUKAI;1896847801;Taip;5;0;1;6
8657;Saulėtekis;NYKŠTUKAI;2686041419;Taip;0;5;0;5
8658;Saulėtekis;NYKŠTUKAI;1060784180;Taip;3;0;0;3
8659;Saulėtekis;NYKŠTUKAI;7849181976;Taip;8;0;0;8
8660;Saulėtekis;NYKŠTUKAI;5748816813;Taip;5;0;0;5
8661;Saulėtekis;NYKŠTUKAI;4758423356;Taip;3;0;0;3
8662;Saulėtekis;NYKŠTUKAI;9270109327;Taip;0;2;0;2
8663;Saulėtekis;NYKŠTUKAI;8273890475;Ne;5;0;0;5
8664;Saulėtekis;NYKŠTUKAI;5183297420;Ne;0;4;0;4
8665;Saulėtekis;NYKŠTUKAI;5518726567;Taip;9;0;0;9
8666;Saulėtekis;NYKŠTUKAI;8683571534;Taip;8;0;0;8
8667;Saulėtekis;PAGRANDUKAS;2209156661;Taip;0;0;4;4
8668;Saulėtekis;PAGRANDUKAS;3220993253;Taip;0;0;1;1
8669;Saulėtekis;PAGRANDUKAS;9497129509;Ne;0;0;3;3
8670;Saulėtekis;PAGRANDUKAS;9918219913;Taip;0;0;6;6
8671;Saulėtekis;PAGRANDUKAS;8517049464;Taip;0;0;1;1
8672;Saulėtekis;PAGRANDUKAS;7186085219;Taip;6;7;1;14
8673;Saulėtekis;PAGRANDUKAS;1020209414;Taip;0;0;2;2
8674;Saulėtekis;PAGRANDUKAS;8745921541;Taip;15;0;0;15
8675;Saulėtekis;PAGRANDUKAS;2728836108;Taip;0;0;2;2
8676;Saulėtekis;PAGRANDUKAS;8390615573;Taip;0;10;0;10
8677;Saulėtekis;PAGRANDUKAS;2698535938;Taip;0;0;2;2
8678;Saulėtekis;PAGRANDUKAS;2656659133;Taip;10;5;0;15
8679;Saulėtekis;PAGRANDUKAS;7164579375;Ne;9;7;1;17
8680;Saulėtekis;PAGRANDUKAS;3366064429;Taip;7;0;0;7
8681;Saulėtekis;PAGRANDUKAS;8574702901;Ne;7;0;0;7
8682;Saulėtekis;PAGRANDUKAS;9941731250;Ne;4;0;0;4
8683;Saulėtekis;PAGRANDUKAS;4038684284;Ne;15;0;2;17
8684;Saulėtekis;RAMUNĖLIŲ;6711773127;Taip;2;0;0;2
8685;Saulėtekis;RAMUNĖLIŲ;2316817605;Taip;10;0;0;10
8686;Saulėtekis;RAMUNĖLIŲ;3987535802;Taip;11;1;0;12
8687;Saulėtekis;RAMUNĖLIŲ;6979741482;Taip;0;10;0;10
8688;Saulėtekis;RAMUNĖLIŲ;8348456528;Ne;12;0;1;13
8689;Saulėtekis;RAMUNĖLIŲ;1866452425;Ne;17;0;0;17
8690;Saulėtekis;RAMUNĖLIŲ;5980690239;Ne;12;0;0;12
8691;Saulėtekis;RAMUNĖLIŲ;2786112846;Ne;11;0;0;11
8692;Saulėtekis;RAMUNĖLIŲ;8876580678;Ne;11;0;0;11
8693;Saulėtekis;RAMUNĖLIŲ;3224110585;Taip;12;2;0;14
8694;Saulėtekis;RAMUNĖLIŲ;2002180753;Taip;4;0;3;7
8695;Saulėtekis;RAMUNĖLIŲ;5685176596;Taip;0;0;1;1
8696;Saulėtekis;RAMUNĖLIŲ;3555868198;Taip;5;0;1;6
8697;Saulėtekis;PASAKAITĖ;8033763960;Ne;4;0;1;5
8698;Saulėtekis;PASAKAITĖ;5086871001;Taip;3;8;0;11
8699;Saulėtekis;PASAKAITĖ;2446282019;Taip;13;0;0;13
8700;Saulėtekis;PASAKAITĖ;8572701238;Taip;13;0;0;13
8701;Saulėtekis;PASAKAITĖ;6063956790;Taip;0;0;4;4
8702;Saulėtekis;PASAKAITĖ;4437540996;Taip;3;0;1;4
8703;Saulėtekis;PASAKAITĖ;9226317303;Taip;0;0;2;2
8704;Saulėtekis;PASAKAITĖ;9267790598;Taip;10;0;2;12
8705;Saulėtekis;PASAKAITĖ;6670590135;Ne;0;0;1;1
8706;Saulėtekis;PASAKAITĖ;3224883243;Ne;5;0;1;6
8707;Saulėtekis;PASAKAITĖ;1809105604;Taip;0;0;3;3
8708;Saulėtekis;PASAKAITĖ;9382031144;Ne;8;0;1;9
8709;Saulėtekis;PASAKAITĖ;3371914339;Ne;5;0;2;7
8710;Saulėtekis;PASAKAITĖ;6214539956;Taip;11;0;1;12
8711;Saulėtekis;PASAKAITĖ;9584556476;Taip;5;0;0;5
8712;Saulėtekis;PASAKAITĖ;9799880235;Taip;0;1;0;1
8713;Saulėtekis;PASAKAITĖ;2469458604;Taip;9;0;0;9
8714;Saulėtekis;VARPELIAI;94326821425;Taip;6;7;0;13
8715;Saulėtekis;VARPELIAI;1069782559;Taip;4;0;0;4
8716;Saulėtekis;VARPELIAI;68563453302;Taip;0;2;0;2
8717;Saulėtekis;VARPELIAI;77901730057;Taip;0;1;0;1
8718;Saulėtekis;VARPELIAI;74713390994;Taip;11;0;0;11
8719;Saulėtekis;VARPELIAI;43127755042;Taip;5;0;0;5
8720;Saulėtekis;VARPELIAI;1335149249;Taip;0;0;1;1
8721;Saulėtekis;VARPELIAI;1108321396;Taip;0;0;1;1
8722;Saulėtekis;VARPELIAI;891603633;Taip;4;0;1;5
8723;Saulėtekis;VARPELIAI;2075281680;Ne;6;0;1;7
8724;Saulėtekis;VARPELIAI;1213567219;Ne;10;0;0;10
8725;Saulėtekis;VARPELIAI;7464965841;Taip;21;0;0;21
8726;Saulėtekis;VARPELIAI;49053923177;Taip;1;0;0;1
8727;Saulėtekis;VARPELIAI;1456140823;Ne;0;2;1;3
8728;Saulėtekis;VARPELIAI;21376960952;Ne;0;0;1;1
8729;Saulėtekis;VARPELIAI;2641849320;Ne;0;21;0;21
8730;Saulėtekis;VARPELIAI;3337160930;Taip;3;7;1;11
8731;Saulėtekis;GRŪDELIS;3706398395;Ne;2;0;2;4
8732;Saulėtekis;GRŪDELIS;1864236745;Taip;5;0;1;6
8733;Saulėtekis;GRŪDELIS;7494641077;Taip;0;2;1;3
8734;Saulėtekis;GRŪDELIS;3434815790;Taip;9;0;0;9
8735;Saulėtekis;GRŪDELIS;2672108464;Taip;4;0;0;4
8736;Saulėtekis;GRŪDELIS;6779891385;Taip;11;0;0;11
8737;Saulėtekis;GRŪDELIS;9579088485;Taip;0;0;2;2
8738;Saulėtekis;GRŪDELIS;2568544418;Taip;0;0;3;3
8739;Saulėtekis;GRŪDELIS;7171048750;Taip;7;0;0;7
8740;Saulėtekis;GRŪDELIS;9734188792;Taip;0;0;1;1
8741;Saulėtekis;GRŪDELIS;8252953405;Ne;0;0;2;2
8742;Saulėtekis;GRŪDELIS;8219644557;Taip;5;0;0;5
8743;Saulėtekis;GRŪDELIS;5161940030;Taip;0;0;2;2
8744;Saulėtekis;GRŪDELIS;6983324115;Taip;8;0;0;8
8745;Saulėtekis;GRŪDELIS;5218345414;Ne;5;0;0;5
8746;Saulėtekis;JONVABALIS;5003645081;Taip;4;0;1;5
8747;Saulėtekis;JONVABALIS;1715634399;Ne;0;4;0;4
8748;Saulėtekis;JONVABALIS;1897872021;Taip;0;2;0;2
8749;Saulėtekis;JONVABALIS;1010906684;Taip;10;0;0;10
8750;Saulėtekis;JONVABALIS;97037457833;Taip;0;0;2;2
8751;Saulėtekis;JONVABALIS;7227802003;Taip;0;0;1;1
8752;Saulėtekis;JONVABALIS;84492261206;Taip;0;10;0;10
8753;Saulėtekis;JONVABALIS;72559769416;Taip;0;0;2;2
8754;Saulėtekis;JONVABALIS;1611009868;Ne;16;0;0;16
8755;Saulėtekis;JONVABALIS;4613040294;Taip;8;0;0;8
8756;Saulėtekis;JONVABALIS;1655720839;Taip;0;0;2;2
8757;Saulėtekis;JONVABALIS;5249014111;Taip;16;1;0;17
8758;Saulėtekis;JONVABALIS;2101902207;Taip;5;4;0;9
8759;Saulėtekis;JONVABALIS;3166181835;Taip;0;2;0;2
8760;Saulėtekis;JONVABALIS;6599452886;Taip;5;4;0;9
8761;Saulėtekis;JONVABALIS;8896065807;Taip;5;0;0;5
8762;Saulėtekis;JONVABALIS;1702638461;Taip;7;4;0;11
8763;Saulėtekis;JONVABALIS;3207128776;Taip;11;0;0;11
8764;Saulėtekis;JONVABALIS;2311184444;Taip;4;3;0;7
8765;Saulėtekis;JONVABALIS;1267706132;Ne;7;0;0;7
8766;Saulėtekis;JONVABALIS;98936544904;Taip;6;0;0;6
8767;Saulėtekis;JONVABALIS;22570044589;Taip;0;9;0;9
8768;Saulėtekis;JONVABALIS;97771948184;Taip;2;11;0;13
8769;Saulėtekis;JONVABALIS;8752857993;Ne;7;1;0;8
8770;Saulėtekis;SMALSUČIAI;40877542045;Taip;0;0;4;4
8771;Saulėtekis;SMALSUČIAI;9095968376;Taip;0;0;4;4
8772;Saulėtekis;SMALSUČIAI;86524549051;Taip;0;0;1;1
8773;Saulėtekis;SMALSUČIAI;7030227903;Taip;0;0;1;1
8774;Saulėtekis;SMALSUČIAI;32771808648;Taip;0;4;0;4
8775;Saulėtekis;SMALSUČIAI;1808644850;Taip;15;3;0;18
8776;Saulėtekis;SMALSUČIAI;1642031589;Taip;0;3;1;4
8777;Saulėtekis;SMALSUČIAI;1568300232;Ne;1;0;0;1
8778;Saulėtekis;SMALSUČIAI;7621094096;Taip;0;0;4;4
8779;Saulėtekis;SMALSUČIAI;13451381485;Taip;0;0;1;1
8780;Saulėtekis;SMALSUČIAI;19605249139;Taip;8;0;0;8
8781;Saulėtekis;SMALSUČIAI;1619134034;Taip;3;0;0;3
8782;Saulėtekis;SMALSUČIAI;8673024996;Taip;9;0;1;10
8783;Saulėtekis;SMALSUČIAI;1456865685;Taip;5;5;1;11
8784;Saulėtekis;SMALSUČIAI;92060861583;Taip;0;0;2;2
8785;Saulėtekis;SMALSUČIAI;4180984076;Taip;0;0;1;1
8786;Saulėtekis;SMALSUČIAI;1865278537;Taip;0;0;1;1
8787;Saulėtekis;SMALSUČIAI;4027823257;Taip;0;1;1;2
8788;Saulėtekis;SMALSUČIAI;53906058088;Taip;0;0;6;6
8789;Saulėtekis;BITUTĖS;60462712074;Taip;8;0;0;8
8790;Saulėtekis;BITUTĖS;1699576940;Taip;0;5;0;5
8791;Saulėtekis;BITUTĖS;9945647968;Taip;5;1;0;6
8792;Saulėtekis;BITUTĖS;1962914764;Taip;0;0;8;8
8793;Saulėtekis;BITUTĖS;1481503733;Taip;7;0;1;8
8794;Saulėtekis;BITUTĖS;8302260087;Taip;0;0;2;2
8795;Saulėtekis;BITUTĖS;2593106154;Taip;0;13;2;15
8796;Saulėtekis;BITUTĖS;2813949848;Taip;5;4;0;9
8797;Saulėtekis;BITUTĖS;9983577817;Taip;0;0;5;5
8798;Saulėtekis;BITUTĖS;7986712728;Taip;0;9;0;9
8799;Saulėtekis;BITUTĖS;6087170055;Taip;7;0;3;10
8800;Saulėtekis;BITUTĖS;7027103276;Taip;6;3;0;9
8801;Saulėtekis;BITUTĖS;9605052795;Taip;15;0;0;15
8802;Saulėtekis;BITUTĖS;7075757274;Taip;0;0;8;8
8803;Saulėtekis;BITUTĖS;2639872637;Taip;0;7;0;7
8804;Saulėtekis;RIEŠUTĖLIAI;2021901593;Taip;0;1;0;1
8805;Saulėtekis;RIEŠUTĖLIAI;7842280836;Taip;3;0;0;3
8806;Saulėtekis;RIEŠUTĖLIAI;2407911405;Taip;0;0;5;5
8807;Saulėtekis;RIEŠUTĖLIAI;3541535891;Taip;0;0;3;3
8808;Saulėtekis;RIEŠUTĖLIAI;36003078842;Taip;5;0;0;5
8809;Saulėtekis;RIEŠUTĖLIAI;25199011812;Taip;0;1;0;1
8810;Saulėtekis;RIEŠUTĖLIAI;81153273188;Taip;0;4;0;4
8811;Saulėtekis;RIEŠUTĖLIAI;7051608858;Taip;4;8;0;12
8812;Saulėtekis;RIEŠUTĖLIAI;9634949452;Taip;10;0;1;11
8813;Saulėtekis;RIEŠUTĖLIAI;9657195627;Taip;3;0;0;3
8814;Saulėtekis;RIEŠUTĖLIAI;2474900044;Ne;4;10;0;14
8815;Saulėtekis;RIEŠUTĖLIAI;2546789906;Ne;0;1;0;1
8816;Saulėtekis;RIEŠUTĖLIAI;5678858566;Taip;0;0;2;2
8817;Skroblinukas;SVIRPLIUKŲ;2195112297;Taip;0;0;3;3
8818;Skroblinukas;SVIRPLIUKŲ;4198512202;Taip;13;0;6;19
8819;Skroblinukas;SVIRPLIUKŲ;7750501815;Taip;0;10;10;20
8820;Skroblinukas;SVIRPLIUKŲ;4960825597;Taip;0;12;0;12
8821;Skroblinukas;SVIRPLIUKŲ;1544598440;Taip;13;1;0;14
8822;Skroblinukas;SVIRPLIUKŲ;5566457656;Ne;5;0;0;5
8823;Skroblinukas;SVIRPLIUKŲ;6574558658;Taip;3;0;0;3
8824;Skroblinukas;SVIRPLIUKŲ;1669610397;Taip;0;6;1;7
8825;Skroblinukas;SVIRPLIUKŲ;4861971439;Taip;3;0;6;9
8826;Skroblinukas;SVIRPLIUKŲ;7817632987;Taip;7;0;1;8
8827;Skroblinukas;SVIRPLIUKŲ;7675772872;Taip;0;0;1;1
8828;Skroblinukas;SVIRPLIUKŲ;8283516422;Taip;7;0;1;8
8829;Skroblinukas;SVIRPLIUKŲ;4266945644;Taip;7;0;0;7
8830;Skroblinukas;SVIRPLIUKŲ;9003855190;Taip;0;10;0;10
8831;Skroblinukas;SVIRPLIUKŲ;7216760382;Taip;8;0;3;11
8832;Skroblinukas;SVIRPLIUKŲ;5154111867;Taip;0;1;0;1
8833;Skroblinukas;SVIRPLIUKŲ;8622930871;Taip;5;7;0;12
8834;Skroblinukas;GANDRIUKŲ;2097758483;Taip;5;6;0;11
8835;Skroblinukas;GANDRIUKŲ;9045708140;Taip;14;2;0;16
8836;Skroblinukas;GANDRIUKŲ;2406619611;Taip;5;6;0;11
8837;Skroblinukas;GANDRIUKŲ;9572912046;Taip;0;7;1;8
8838;Skroblinukas;GANDRIUKŲ;5646847921;Taip;0;0;1;1
8839;Skroblinukas;GANDRIUKŲ;9377215921;Taip;10;0;0;10
8840;Skroblinukas;GANDRIUKŲ;6266609965;Ne;0;8;0;8
8841;Skroblinukas;GANDRIUKŲ;6489976163;Taip;8;0;1;9
8842;Skroblinukas;GANDRIUKŲ;1159546580;Taip;0;7;1;8
8843;Skroblinukas;GANDRIUKŲ;4571530482;Taip;4;5;0;9
8844;Skroblinukas;GANDRIUKŲ;2310750833;Ne;0;4;0;4
8845;Skroblinukas;GANDRIUKŲ;9888115079;Taip;0;9;0;9
8846;Skroblinukas;GANDRIUKŲ;9475514959;Ne;5;2;3;10
8847;Skroblinukas;GANDRIUKŲ;9031598603;Taip;0;0;11;11
8848;Skroblinukas;VYTURIUKŲ;3954228349;Taip;0;0;2;2
8849;Skroblinukas;VYTURIUKŲ;6879979868;Taip;5;0;2;7
8850;Skroblinukas;VYTURIUKŲ;4560580022;Taip;5;0;0;5
8851;Skroblinukas;VYTURIUKŲ;3271736540;Taip;16;0;1;17
8852;Skroblinukas;VYTURIUKŲ;3065235192;Taip;0;7;1;8
8853;Skroblinukas;VYTURIUKŲ;5902713448;Taip;16;0;0;16
8854;Skroblinukas;VYTURIUKŲ;3594000419;Taip;10;0;1;11
8855;Skroblinukas;VYTURIUKŲ;3512297435;Taip;10;0;1;11
8856;Skroblinukas;VYTURIUKŲ;9985033530;Taip;0;0;1;1
8857;Skroblinukas;VYTURIUKŲ;2481980627;Taip;0;0;1;1
8858;Skroblinukas;VYTURIUKŲ;6293879765;Taip;5;0;3;8
8859;Skroblinukas;VYTURIUKŲ;9725125130;Taip;2;0;0;2
8860;Skroblinukas;VYTURIUKŲ;2978284436;Taip;0;0;3;3
8861;Skroblinukas;VYTURIUKŲ;7068452970;Taip;0;0;2;2
8862;Skroblinukas;VYTURIUKŲ;3292517112;Taip;0;0;1;1
8863;Skroblinukas;VYTURIUKŲ;3461165182;Taip;0;0;7;7
8864;Skroblinukas;GENIUKŲ;48655837755;Taip;0;0;1;1
8865;Skroblinukas;GENIUKŲ;4393041946;Taip;0;0;2;2
8866;Skroblinukas;GENIUKŲ;2323980730;Taip;10;0;0;10
8867;Skroblinukas;GENIUKŲ;1325903217;Taip;0;0;4;4
8868;Skroblinukas;GENIUKŲ;8380073853;Taip;14;0;2;16
8869;Skroblinukas;GENIUKŲ;4436698905;Taip;0;5;2;7
8870;Skroblinukas;GENIUKŲ;1905085978;Taip;10;0;0;10
8871;Skroblinukas;GENIUKŲ;1557733803;Taip;0;2;0;2
8872;Skroblinukas;GENIUKŲ;9433465007;Taip;0;13;0;13
8873;Skroblinukas;GENIUKŲ;3746278003;Taip;20;0;0;20
8874;Skroblinukas;GENIUKŲ;4773576465;Ne;0;0;5;5
8875;Skroblinukas;GENIUKŲ;2704157855;Taip;0;0;1;1
8876;Skroblinukas;GENIUKŲ;6129591146;Taip;0;3;0;3
8877;Skroblinukas;GENIUKŲ;3128337104;Taip;0;0;1;1
8878;Skroblinukas;GENIUKŲ;4272941994;Taip;0;0;10;10
8879;Skroblinukas;GENIUKŲ;3864043251;Taip;4;0;0;4
8880;Skroblinukas;GENIUKŲ;1064449916;Ne;0;2;1;3
8881;Skroblinukas;BITUČIŲ;1934804499;Ne;0;2;1;3
8882;Skroblinukas;BITUČIŲ;2134821488;Taip;14;0;0;14
8883;Skroblinukas;BITUČIŲ;2071447940;Taip;6;0;2;8
8884;Skroblinukas;BITUČIŲ;6604496585;Ne;0;3;0;3
8885;Skroblinukas;BITUČIŲ;3736883850;Taip;0;1;0;1
8886;Skroblinukas;BITUČIŲ;7191689856;Taip;8;6;0;14
8887;Skroblinukas;BITUČIŲ;8778072326;Taip;4;0;0;4
8888;Skroblinukas;BITUČIŲ;2032621707;Taip;5;8;0;13
8889;Skroblinukas;BITUČIŲ;8277152812;Taip;0;10;0;10
8890;Skroblinukas;BITUČIŲ;8374103872;Taip;0;1;0;1
8891;Skroblinukas;BITUČIŲ;8618587013;Taip;0;1;0;1
8892;Skroblinukas;BITUČIŲ;4945107862;Ne;0;0;1;1
8893;Skroblinukas;BITUČIŲ;9594078223;Ne;0;3;0;3
8894;Skroblinukas;BITUČIŲ;9075266818;Ne;15;1;0;16
8895;Skroblinukas;BITUČIŲ;1432694920;Taip;0;4;0;4
8896;Skroblinukas;BITUČIŲ;1688990637;Taip;12;0;1;13
8897;Skroblinukas;BITUČIŲ;1957488412;Taip;0;1;4;5
8898;Skroblinukas;BITUČIŲ;1711568129;Taip;5;2;1;8
8899;Skroblinukas;BORUŽĖLIŲ;2887161771;Taip;12;0;0;12
8900;Skroblinukas;BORUŽĖLIŲ;5152056691;Taip;16;0;0;16
8901;Skroblinukas;BORUŽĖLIŲ;4831370981;Taip;0;2;0;2
8902;Skroblinukas;BORUŽĖLIŲ;3226115050;Taip;9;0;0;9
8903;Skroblinukas;BORUŽĖLIŲ;3624518310;Taip;5;1;0;6
8904;Skroblinukas;BORUŽĖLIŲ;8305867345;Taip;20;0;0;20
8905;Skroblinukas;BORUŽĖLIŲ;8715188878;Taip;5;3;0;8
8906;Skroblinukas;BORUŽĖLIŲ;2772360168;Taip;3;2;0;5
8907;Skroblinukas;BORUŽĖLIŲ;5957417413;Taip;5;2;0;7
8908;Skroblinukas;BORUŽĖLIŲ;3889890374;Taip;0;5;0;5
8909;Skroblinukas;BORUŽĖLIŲ;6680003214;Taip;10;0;3;13
8910;Skroblinukas;BORUŽĖLIŲ;9481718833;Taip;7;0;0;7
8911;Skroblinukas;BORUŽĖLIŲ;2215428081;Ne;3;0;0;3
8912;Skroblinukas;BORUŽĖLIŲ;8864594520;Taip;4;0;1;5
8913;Skroblinukas;SKRUZDĖLIUKŲ;5688453546;Taip;0;2;5;7
8914;Skroblinukas;SKRUZDĖLIUKŲ;6890306112;Taip;5;2;0;7
8915;Skroblinukas;SKRUZDĖLIUKŲ;6445065388;Taip;0;6;0;6
8916;Skroblinukas;SKRUZDĖLIUKŲ;9448253468;Taip;4;0;0;4
8917;Skroblinukas;SKRUZDĖLIUKŲ;3771045336;Ne;0;8;0;8
8918;Skroblinukas;SKRUZDĖLIUKŲ;4424763028;Taip;4;1;0;5
8919;Skroblinukas;SKRUZDĖLIUKŲ;9353353289;Taip;5;1;0;6
8920;Skroblinukas;SKRUZDĖLIUKŲ;5252389111;Taip;0;3;0;3
8921;Skroblinukas;SKRUZDĖLIUKŲ;2883593274;Taip;0;2;0;2
8922;Skroblinukas;SKRUZDĖLIUKŲ;7493915017;Taip;0;1;0;1
8923;Skroblinukas;SKRUZDĖLIUKŲ;5157913924;Taip;10;3;0;13
8924;Skroblinukas;SKRUZDĖLIUKŲ;9368764758;Taip;5;0;0;5
8925;Skroblinukas;SKRUZDĖLIUKŲ;9958188318;Taip;4;2;0;6
8926;Skroblinukas;SKRUZDĖLIUKŲ;8576448571;Taip;16;0;1;17
8927;Skroblinukas;SKRUZDĖLIUKŲ;1002570367;Taip;4;2;2;8
8928;Skroblinukas;SKRUZDĖLIUKŲ;3290115134;Taip;10;0;2;12
8929;Skroblinukas;SKRUZDĖLIUKŲ;9813249677;Taip;0;0;1;1
8930;Skroblinukas;SKRUZDĖLIUKŲ;2101748012;Taip;0;0;1;1
8931;Skroblinukas;SKRUZDĖLIUKŲ;2706526326;Taip;0;0;1;1
8932;Skroblinukas;SKRUZDĖLIUKŲ;5915278745;Taip;7;3;0;10
8933;Skroblinukas;SKRUZDĖLIUKŲ;6640062847;Taip;10;0;0;10
8934;Skroblinukas;ŽVIRBLIUKŲ;7480611069;Taip;7;0;0;7
8935;Skroblinukas;ŽVIRBLIUKŲ;2071093890;Taip;0;1;1;2
8936;Skroblinukas;ŽVIRBLIUKŲ;8206063106;Taip;9;0;2;11
8937;Skroblinukas;ŽVIRBLIUKŲ;9553242594;Taip;5;0;0;5
8938;Skroblinukas;ŽVIRBLIUKŲ;2948231687;Taip;0;0;21;21
8939;Skroblinukas;ŽVIRBLIUKŲ;1453029732;Taip;0;1;0;1
8940;Skroblinukas;ŽVIRBLIUKŲ;8465074037;Taip;4;0;0;4
8941;Skroblinukas;ŽVIRBLIUKŲ;9162582460;Taip;3;0;0;3
8942;Skroblinukas;ŽVIRBLIUKŲ;7955574061;Taip;10;0;0;10
8943;Skroblinukas;ŽVIRBLIUKŲ;7489143683;Taip;0;0;6;6
8944;Skroblinukas;ŽVIRBLIUKŲ;4802801867;Taip;5;0;1;6
8945;Skroblinukas;ŽIOGELIŲ;9629502585;Taip;4;2;0;6
8946;Skroblinukas;ŽIOGELIŲ;9828486832;Taip;0;0;3;3
8947;Skroblinukas;ŽIOGELIŲ;1924714755;Taip;0;0;1;1
8948;Skroblinukas;ŽIOGELIŲ;8064713969;Taip;9;0;0;9
8949;Skroblinukas;ŽIOGELIŲ;8286842648;Taip;17;0;0;17
8950;Skroblinukas;ŽIOGELIŲ;6461678336;Taip;10;0;0;10
8951;Skroblinukas;ŽIOGELIŲ;3046542264;Taip;0;10;0;10
8952;Skroblinukas;ŽIOGELIŲ;7528824951;Taip;2;0;0;2
8953;Skroblinukas;ŽIOGELIŲ;7474100735;Taip;8;0;0;8
8954;Skroblinukas;ŽIOGELIŲ;2987938909;Taip;10;0;0;10
8955;Skroblinukas;STRAZDELIŲ;8312341293;Taip;0;9;1;10
8956;Skroblinukas;STRAZDELIŲ;8958893525;Taip;11;0;0;11
8957;Skroblinukas;STRAZDELIŲ;4168542339;Taip;8;0;0;8
8958;Skroblinukas;STRAZDELIŲ;5813075721;Taip;10;0;1;11
8959;Skroblinukas;STRAZDELIŲ;8815319607;Taip;9;0;4;13
8960;Skroblinukas;STRAZDELIŲ;5418212729;Taip;0;3;1;4
8961;Skroblinukas;STRAZDELIŲ;3658815079;Taip;0;0;8;8
8962;Skroblinukas;STRAZDELIŲ;9699407871;Taip;6;0;1;7
8963;Skroblinukas;STRAZDELIŲ;8202855376;Taip;6;0;0;6
8964;Skroblinukas;STRAZDELIŲ;6675716937;Taip;6;0;0;6
8965;Skroblinukas;STRAZDELIŲ;9292990596;Taip;0;0;4;4
8966;Skroblinukas;DRUGELIŲ;1792672886;Taip;0;1;7;8
8967;Skroblinukas;DRUGELIŲ;1979723351;Ne;1;1;0;2
8968;Skroblinukas;DRUGELIŲ;1964529755;Taip;0;8;0;8
8969;Skroblinukas;DRUGELIŲ;86231564690;Taip;0;0;1;1
8970;Skroblinukas;DRUGELIŲ;23687553212;Taip;6;4;0;10
8971;Skroblinukas;DRUGELIŲ;86542450905;Ne;5;0;0;5
8972;Skroblinukas;DRUGELIŲ;54750454175;Taip;0;0;2;2
8973;Skroblinukas;DRUGELIŲ;2019575002;Ne;1;0;0;1
8974;Skroblinukas;DRUGELIŲ;3636028890;Taip;8;0;0;8
8975;Skroblinukas;DRUGELIŲ;2079452635;Taip;0;0;1;1
8976;Skroblinukas;DRUGELIŲ;1510927547;Taip;0;0;1;1
8977;Skroblinukas;DRUGELIŲ;2325940694;Taip;0;9;0;9
8978;Skroblinukas;DRUGELIŲ;15977832913;Taip;6;0;1;7
8979;Skroblinukas;DRUGELIŲ;5068339590;Taip;0;5;0;5
8980;Skroblinukas;DRUGELIŲ;3580045988;Taip;5;4;0;9
8981;Skroblinukas;DRUGELIŲ;1005726705;Taip;1;0;0;1
8982;Skroblinukas;DRUGELIŲ;1388763405;Taip;5;5;3;13
8983;Skroblinukas;DRUGELIŲ;1791669956;Taip;0;0;3;3
8984;Skroblinukas;DRUGELIŲ;7184817010;Taip;0;7;0;7
8985;Skroblinukas;DRUGELIŲ;1109895463;Ne;0;4;0;4
8986;Skroblinukas;DRUGELIŲ;2116630768;Taip;0;9;0;9
8987;Skroblinukas;DRUGELIŲ;18955401411;Taip;7;0;4;11
8988;Skroblinukas;PELĖDŽIUKŲ;5975039463;Taip;8;0;1;9
8989;Skroblinukas;PELĖDŽIUKŲ;63514584063;Taip;0;14;0;14
8990;Skroblinukas;PELĖDŽIUKŲ;1000422430;Taip;4;3;0;7
8991;Skroblinukas;PELĖDŽIUKŲ;7666122737;Taip;0;0;1;1
8992;Skroblinukas;PELĖDŽIUKŲ;1759830058;Taip;5;0;0;5
8993;Skroblinukas;PELĖDŽIUKŲ;1382981497;Taip;2;3;0;5
8994;Skroblinukas;PELĖDŽIUKŲ;29908502973;Taip;0;0;1;1
8995;Skroblinukas;PELĖDŽIUKŲ;1220311458;Taip;0;3;0;3
8996;Skroblinukas;PELĖDŽIUKŲ;95946607624;Ne;4;1;0;5
8997;Skroblinukas;PELĖDŽIUKŲ;8150037173;Taip;0;3;0;3
8998;Skroblinukas;PELĖDŽIUKŲ;1898486832;Taip;5;4;0;9
8999;Skroblinukas;PELĖDŽIUKŲ;1515227489;Ne;0;0;2;2
9000;Skroblinukas;PELĖDŽIUKŲ;76523308405;Ne;0;5;0;5
9001;Skroblinukas;PELĖDŽIUKŲ;1602978649;Taip;0;0;1;1
9002;Skroblinukas;PELĖDŽIUKŲ;1258044022;Taip;0;0;1;1
9003;Skroblinukas;PELĖDŽIUKŲ;1847074960;Taip;8;0;3;11
9004;Skroblinukas;PELĖDŽIUKŲ;9777300890;Taip;4;0;0;4
9005;Skroblinukas;PELĖDŽIUKŲ;6002038732;Taip;0;1;0;1
9006;Smalsučiai;Žibuoklės;7794541741;Taip;0;0;4;4
9007;Smalsučiai;Žibuoklės;1181574676;Taip;0;7;0;7
9008;Smalsučiai;Žibuoklės;1599488035;Ne;0;5;0;5
9009;Smalsučiai;Žibuoklės;4727475042;Taip;3;0;11;14
9010;Smalsučiai;Žibuoklės;8520753848;Ne;0;8;0;8
9011;Smalsučiai;Žibuoklės;3607226859;Taip;0;4;0;4
9012;Smalsučiai;Žibuoklės;1467603676;Taip;0;1;0;1
9013;Smalsučiai;Žibuoklės;19592364606;Taip;0;15;0;15
9014;Smalsučiai;Žibuoklės;1824321380;Taip;0;0;1;1
9015;Smalsučiai;Žibuoklės;6207026048;Taip;0;3;0;3
9016;Smalsučiai;Žibuoklės;4145769042;Taip;0;3;0;3
9017;Smalsučiai;Žibuoklės;6529889121;Taip;0;3;0;3
9018;Smalsučiai;Žibuoklės;2618753095;Taip;0;0;6;6
9019;Smalsučiai;Žibuoklės;3627324317;Taip;0;2;0;2
9020;Smalsučiai;Žibuoklės;5611487967;Taip;2;0;0;2
9021;Smalsučiai;Aitvarų;2638709634;Taip;0;1;0;1
9022;Smalsučiai;Aitvarų;5441966713;Taip;0;1;0;1
9023;Smalsučiai;Aitvarų;9632022271;Taip;0;0;2;2
9024;Smalsučiai;Aitvarų;8306946163;Taip;0;3;0;3
9025;Smalsučiai;Aitvarų;6469044880;Taip;5;5;0;10
9026;Smalsučiai;Aitvarų;8193410963;Ne;2;0;1;3
9027;Smalsučiai;Aitvarų;99467576480;Ne;0;0;1;1
9028;Smalsučiai;Aitvarų;2136420967;Taip;0;0;3;3
9029;Smalsučiai;Aitvarų;2059832436;Ne;0;0;1;1
9030;Smalsučiai;Aitvarų;1316590100;Taip;0;2;0;2
9031;Smalsučiai;Aitvarų;1997966082;Taip;0;3;0;3
9032;Smalsučiai;Aitvarų;1372591510;Taip;0;9;0;9
9033;Smalsučiai;Aitvarų;4585930202;Taip;0;0;2;2
9034;Smalsučiai;Aitvarų;8810690546;Taip;0;6;0;6
9035;Smalsučiai;Aitvarų;4909226602;Taip;0;10;1;11
9036;Smalsučiai;Aitvarų;6536165801;Ne;0;5;2;7
9037;Smalsučiai;Aitvarų;3644256220;Taip;0;0;1;1
9038;Smalsučiai;Aitvarų;9481692900;Taip;8;2;0;10
9039;Smalsučiai;Sraigiukų;9155011285;Taip;0;1;0;1
9040;Smalsučiai;Sraigiukų;7933302912;Taip;0;7;0;7
9041;Smalsučiai;Sraigiukų;1471941426;Taip;0;4;3;7
9042;Smalsučiai;Sraigiukų;1458544456;Taip;0;4;0;4
9043;Smalsučiai;Sraigiukų;5406430393;Taip;6;3;0;9
9044;Smalsučiai;Sraigiukų;9582225178;Ne;5;0;3;8
9045;Smalsučiai;Sraigiukų;9604182559;Taip;0;3;0;3
9046;Smalsučiai;Sraigiukų;6469604093;Taip;0;6;0;6
9047;Smalsučiai;Sraigiukų;4364810458;Taip;5;0;0;5
9048;Smalsučiai;Sraigiukų;4566816316;Taip;0;3;0;3
9049;Smalsučiai;Sraigiukų;5184903287;Taip;5;0;0;5
9050;Smalsučiai;Sraigiukų;4629526320;Taip;5;5;0;10
9051;Smalsučiai;Sraigiukų;4134975456;Taip;4;0;0;4
9052;Smalsučiai;Sraigiukų;6899040199;Taip;5;1;0;6
9053;Smalsučiai;Sraigiukų;7396172351;Taip;0;2;0;2
9054;Smalsučiai;Sraigiukų;6358800570;Taip;10;4;0;14
9055;Smalsučiai;Sraigiukų;2327930850;Taip;0;8;0;8
9056;Smalsučiai;Sraigiukų;3787937467;Taip;0;14;0;14
9057;Smalsučiai;Sraigiukų;4824786207;Taip;0;0;1;1
9058;Smalsučiai;Sraigiukų;2953239027;Taip;5;4;0;9
9059;Smalsučiai;Sraigiukų;3399798448;Taip;2;0;2;4
9060;Smalsučiai;Sraigiukų;3825610986;Taip;0;0;1;1
9061;Smalsučiai;Saulučių;2259361924;Taip;6;0;1;7
9062;Smalsučiai;Saulučių;1162964613;Taip;12;0;0;12
9063;Smalsučiai;Saulučių;9934952886;Taip;15;0;1;16
9064;Smalsučiai;Saulučių;9556433086;Taip;7;3;0;10
9065;Smalsučiai;Saulučių;1904973393;Taip;3;5;0;8
9066;Smalsučiai;Saulučių;9153589128;Taip;6;0;1;7
9067;Smalsučiai;Saulučių;2392217952;Taip;10;0;1;11
9068;Smalsučiai;Saulučių;1447512509;Taip;3;0;3;6
9069;Smalsučiai;Saulučių;2034284973;Taip;5;0;0;5
9070;Smalsučiai;Saulučių;7423419934;Taip;10;0;0;10
9071;Smalsučiai;Saulučių;7049101015;Taip;0;0;1;1
9072;Smalsučiai;Saulučių;9183519167;Taip;5;0;2;7
9073;Smalsučiai;Saulučių;5708986552;Taip;5;0;1;6
9074;Smalsučiai;Saulučių;4889923629;Ne;0;2;0;2
9075;Smalsučiai;Saulučių;8630411244;Taip;5;0;6;11
9076;Smalsučiai;Viščiukų;6006832443;Ne;5;1;0;6
9077;Smalsučiai;Viščiukų;9864518144;Taip;0;6;0;6
9078;Smalsučiai;Viščiukų;8128348060;Taip;5;14;0;19
9079;Smalsučiai;Viščiukų;4847584492;Taip;0;0;2;2
9080;Smalsučiai;Viščiukų;6415906523;Taip;3;0;0;3
9081;Smalsučiai;Viščiukų;8763382361;Taip;0;16;0;16
9082;Smalsučiai;Viščiukų;4425714802;Taip;0;0;1;1
9083;Smalsučiai;Viščiukų;9732075162;Taip;0;0;1;1
9084;Smalsučiai;Viščiukų;6090391818;Taip;5;1;1;7
9085;Smalsučiai;Viščiukų;2034528872;Taip;4;0;2;6
9086;Smalsučiai;Viščiukų;8259056296;Taip;0;0;3;3
9087;Smalsučiai;Viščiukų;7137550663;Taip;1;0;0;1
9088;Smalsučiai;Viščiukų;2958335372;Taip;0;0;1;1
9089;Smalsučiai;Viščiukų;3582805599;Taip;0;1;0;1
9090;Smalsučiai;Viščiukų;3757955200;Taip;3;0;0;3
9091;Smalsučiai;Boružėlių;1703679877;Taip;2;0;0;2
9092;Smalsučiai;Boružėlių;2208462326;Taip;0;8;0;8
9093;Smalsučiai;Boružėlių;6643253926;Taip;0;5;0;5
9094;Smalsučiai;Boružėlių;1473016908;Ne;5;0;0;5
9095;Smalsučiai;Boružėlių;7226242747;Taip;0;2;3;5
9096;Smalsučiai;Boružėlių;6085020049;Taip;0;1;0;1
9097;Smalsučiai;Boružėlių;8340768848;Ne;0;2;0;2
9098;Smalsučiai;Boružėlių;6578328053;Taip;5;0;0;5
9099;Smalsučiai;Boružėlių;69450514879;Ne;0;6;0;6
9100;Smalsučiai;Boružėlių;4740303929;Taip;0;2;0;2
9101;Smalsučiai;Boružėlių;2694575252;Ne;3;0;0;3
9102;Smalsučiai;Boružėlių;2671403814;Taip;0;0;1;1
9103;Smalsučiai;Boružėlių;3063127699;Taip;0;7;0;7
9104;Smalsučiai;Boružėlių;2737886714;Taip;0;3;0;3
9105;Smalsučiai;Boružėlių;8523742213;Taip;6;0;2;8
9106;Smalsučiai;Boružėlių;2034790691;Taip;0;0;1;1
9107;Smalsučiai;Boružėlių;9314811354;Taip;0;1;0;1
9108;Smalsučiai;Boružėlių;6288086420;Taip;0;0;1;1
9109;Smalsučiai;Zuikių;78496301809;Taip;0;1;0;1
9110;Smalsučiai;Zuikių;13763655324;Ne;0;5;0;5
9111;Smalsučiai;Zuikių;63575906792;Taip;0;1;0;1
9112;Smalsučiai;Zuikių;66603023493;Taip;0;0;1;1
9113;Smalsučiai;Zuikių;27727844778;Taip;0;2;0;2
9114;Smalsučiai;Zuikių;30592434971;Taip;3;0;0;3
9115;Smalsučiai;Zuikių;92961881271;Taip;0;3;0;3
9116;Smalsučiai;Zuikių;37702522563;Taip;0;0;1;1
9117;Smalsučiai;Zuikių;1893910089;Taip;0;4;0;4
9118;Smalsučiai;Zuikių;30464130912;Taip;5;0;1;6
9119;Smalsučiai;Zuikių;4041918712;Taip;5;0;2;7
9120;Smalsučiai;Nykštukų;2820642097;Ne;0;1;0;1
9121;Smalsučiai;Nykštukų;9181601713;Taip;3;1;0;4
9122;Smalsučiai;Nykštukų;7637630200;Taip;7;0;0;7
9123;Smalsučiai;Nykštukų;1247774684;Taip;7;0;0;7
9124;Smalsučiai;Nykštukų;2375360937;Taip;5;0;1;6
9125;Smalsučiai;Nykštukų;2015172985;Taip;0;4;0;4
9126;Smalsučiai;Nykštukų;6739302636;Taip;8;3;0;11
9127;Smalsučiai;Nykštukų;1672312422;Taip;0;5;0;5
9128;Smalsučiai;Nykštukų;8893480054;Taip;3;0;0;3
9129;Smalsučiai;Nykštukų;6996192450;Taip;0;1;0;1
9130;Smalsučiai;Nykštukų;9378696084;Taip;15;0;2;17
9131;Smalsučiai;Nykštukų;9340292977;Taip;7;0;0;7
9132;Smalsučiai;Nykštukų;7267389695;Taip;6;6;0;12
9133;Smalsučiai;Nykštukų;6996901033;Taip;4;0;0;4
9134;Smalsučiai;Nykštukų;4847212069;Taip;10;0;0;10
9135;Smalsučiai;Nykštukų;1344461213;Taip;0;5;1;6
9136;Smalsučiai;Nykštukų;1224857159;Taip;0;3;0;3
9137;Smalsučiai;Katinėlių;4760366724;Taip;8;3;0;11
9138;Smalsučiai;Katinėlių;2045283348;Taip;7;0;0;7
9139;Smalsučiai;Katinėlių;4847029162;Taip;0;1;0;1
9140;Smalsučiai;Katinėlių;9710944054;Taip;14;0;0;14
9141;Smalsučiai;Katinėlių;5213319192;Taip;5;0;0;5
9142;Smalsučiai;Katinėlių;3782502443;Taip;7;0;0;7
9143;Smalsučiai;Katinėlių;6358968221;Taip;5;0;0;5
9144;Smalsučiai;Katinėlių;9984878984;Taip;3;2;1;6
9145;Smalsučiai;Katinėlių;2369569130;Taip;0;2;0;2
9146;Smalsučiai;Katinėlių;5535858303;Taip;10;0;0;10
9147;Smalsučiai;Katinėlių;8724759192;Taip;0;0;2;2
9148;Smalsučiai;Katinėlių;2662588310;Taip;16;0;1;17
9149;Smalsučiai;Katinėlių;2668720481;Taip;0;6;0;6
9150;Smalsučiai;Katinėlių;3888503023;Taip;0;0;1;1
9151;Smalsučiai;Katinėlių;4030955447;Taip;9;0;1;10
9152;Smalsučiai;Katinėlių;4075656060;Taip;5;0;0;5
9153;Smalsučiai;PELĖDŽIUKAI;3809523690;Taip;3;0;6;9
9154;Smalsučiai;PELĖDŽIUKAI;1567576834;Ne;10;0;0;10
9155;Smalsučiai;PELĖDŽIUKAI;8542926346;Taip;0;6;0;6
9156;Smalsučiai;PELĖDŽIUKAI;28055409190;Taip;0;1;0;1
9157;Smalsučiai;PELĖDŽIUKAI;1760728524;Taip;0;6;0;6
9158;Smalsučiai;PELĖDŽIUKAI;4042979105;Taip;0;4;0;4
9159;Smalsučiai;PELĖDŽIUKAI;1673246147;Taip;0;0;2;2
9160;Smalsučiai;PELĖDŽIUKAI;2112871055;Taip;3;0;0;3
9161;Smalsučiai;PELĖDŽIUKAI;4903800388;Taip;5;0;3;8
9162;Smalsučiai;PELĖDŽIUKAI;52829213579;Taip;5;0;4;9
9163;Smalsučiai;PELĖDŽIUKAI;62387945180;Taip;3;0;1;4
9164;Smalsučiai;PELĖDŽIUKAI;1594035039;Taip;0;0;1;1
9165;Smalsučiai;PELĖDŽIUKAI;1965194010;Taip;0;0;2;2
9166;Smalsučiai;Pingvinukai;4288788194;Taip;4;0;6;10
9167;Smalsučiai;Pingvinukai;3309134310;Taip;0;8;0;8
9168;Smalsučiai;Pingvinukai;5402027714;Taip;10;5;0;15
9169;Smalsučiai;Pingvinukai;5893045664;Taip;0;0;1;1
9170;Smalsučiai;Pingvinukai;5482692473;Taip;0;4;0;4
9171;Smalsučiai;Pingvinukai;7070240693;Taip;5;2;0;7
9172;Smalsučiai;Pingvinukai;7726086066;Taip;0;0;2;2
9173;Smalsučiai;Pingvinukai;8644849194;Taip;0;0;3;3
9174;Smalsučiai;Pingvinukai;3877274360;Taip;10;1;0;11
9175;Smalsučiai;Pingvinukai;5536697307;Taip;0;0;1;1
9176;Smalsučiai;Pingvinukai;9988599126;Taip;0;0;4;4
9177;Smalsučiai;Pingvinukai;4506058735;Taip;10;0;0;10
9178;Smalsučiai;Pingvinukai;6299355505;Taip;0;0;1;1
9179;Smalsučiai;Voverikų;3888093640;Taip;5;0;0;5
9180;Smalsučiai;Voverikų;8284740122;Taip;6;0;0;6
9181;Smalsučiai;Voverikų;1309254661;Taip;7;0;0;7
9182;Smalsučiai;Voverikų;9274289812;Taip;6;0;0;6
9183;Smalsučiai;Voverikų;8985656809;Taip;10;0;1;11
9184;Smalsučiai;Voverikų;9821259659;Taip;5;0;0;5
9185;Smalsučiai;Voverikų;4054278651;Taip;6;0;0;6
9186;Smalsučiai;Voverikų;6232068532;Taip;12;0;0;12
9187;Smalsučiai;Voverikų;3157534923;Taip;2;0;0;2
9188;Smalsučiai;Voverikų;6825499095;Taip;5;10;1;16
9189;Smalsučiai;Voverikų;2610753472;Taip;7;0;4;11
9190;Smalsučiai;Voverikų;8345632807;Taip;4;0;4;8
9191;Smalsučiai;Voverikų;6090244401;Taip;5;0;1;6
9192;Smalsučiai;Voverikų;2835117069;Taip;0;0;2;2
9193;Spindulėlis;SAULUTĖS;7463647806;Ne;0;0;4;4
9194;Spindulėlis;SAULUTĖS;3276656641;Taip;0;0;21;21
9195;Spindulėlis;SAULUTĖS;6633031473;Taip;0;0;4;4
9196;Spindulėlis;SAULUTĖS;4116151797;Taip;7;0;4;11
9197;Spindulėlis;SAULUTĖS;2511267939;Ne;0;15;0;15
9198;Spindulėlis;SAULUTĖS;1454039572;Taip;11;0;0;11
9199;Spindulėlis;SAULUTĖS;6949857110;Taip;0;0;5;5
9200;Spindulėlis;SAULUTĖS;8039086094;Taip;0;0;6;6
9201;Spindulėlis;SAULUTĖS;4171789569;Taip;17;0;0;17
9202;Spindulėlis;SAULUTĖS;4308169582;Taip;16;0;2;18
9203;Spindulėlis;SAULUTĖS;6880075874;Taip;0;0;2;2
9204;Spindulėlis;SAULUTĖS;8793327541;Taip;0;0;1;1
9205;Spindulėlis;SAULUTĖS;2339599448;Ne;3;3;0;6
9206;Spindulėlis;SAULUTĖS;3791118736;Ne;4;0;5;9
9207;Spindulėlis;SAULUTĖS;8432194383;Taip;0;1;1;2
9208;Spindulėlis;DRUGELIAI;6449284856;Taip;0;0;1;1
9209;Spindulėlis;DRUGELIAI;1424288192;Taip;0;0;2;2
9210;Spindulėlis;DRUGELIAI;1180176295;Ne;0;1;4;5
9211;Spindulėlis;DRUGELIAI;9903990297;Taip;0;0;2;2
9212;Spindulėlis;DRUGELIAI;6592057292;Taip;8;0;3;11
9213;Spindulėlis;DRUGELIAI;2890377876;Taip;0;0;3;3
9214;Spindulėlis;DRUGELIAI;4353031174;Ne;12;0;6;18
9215;Spindulėlis;DRUGELIAI;9244494109;Taip;11;0;0;11
9216;Spindulėlis;DRUGELIAI;8923393066;Taip;0;0;5;5
9217;Spindulėlis;DRUGELIAI;5288557629;Taip;0;2;0;2
9218;Spindulėlis;DRUGELIAI;7099787230;Taip;0;0;5;5
9219;Spindulėlis;DRUGELIAI;4929866385;Taip;0;0;6;6
9220;Spindulėlis;DRUGELIAI;5233044803;Ne;0;0;3;3
9221;Spindulėlis;DRUGELIAI;1346035733;Taip;5;7;0;12
9222;Spindulėlis;DRUGELIAI;1730248631;Ne;0;0;19;19
9223;Spindulėlis;DRUGELIAI;3088386659;Taip;5;0;1;6
9224;Spindulėlis;DRUGELIAI;1394918021;Taip;0;0;1;1
9225;Spindulėlis;BITUTĖS;1391226466;Taip;8;0;0;8
9226;Spindulėlis;BITUTĖS;72997461686;Taip;8;0;0;8
9227;Spindulėlis;BITUTĖS;72997461686;Taip;8;0;0;8
9228;Spindulėlis;BITUTĖS;1694423628;Ne;0;3;0;3
9229;Spindulėlis;BITUTĖS;96365393879;Taip;0;1;2;3
9230;Spindulėlis;BITUTĖS;2988630379;Taip;0;1;2;3
9231;Spindulėlis;BITUTĖS;72997461686;Taip;8;0;0;8
9232;Spindulėlis;BITUTĖS;27408123487;Taip;11;4;0;15
9233;Spindulėlis;BITUTĖS;9145337789;Taip;6;0;0;6
9234;Spindulėlis;BITUTĖS;55250330957;Taip;0;0;4;4
9235;Spindulėlis;BITUTĖS;80331157814;Ne;0;1;0;1
9236;Spindulėlis;BITUTĖS;60956380679;Taip;2;1;0;3
9237;Spindulėlis;BITUTĖS;4194714698;Taip;0;0;2;2
9238;Spindulėlis;BITUTĖS;1514479696;Taip;0;1;5;6
9239;Spindulėlis;BITUTĖS;6435045068;Taip;0;0;2;2
9240;Spindulėlis;BITUTĖS;1391226466;Taip;8;1;0;9
9241;Spindulėlis;BITUTĖS;1821231102;Taip;0;8;0;8
9242;Spindulėlis;BITUTĖS;92417802345;Taip;5;1;0;6
9243;Spindulėlis;BITUTĖS;2131409282;Taip;0;0;2;2
9244;Spindulėlis;BITUTĖS;9977569249;Taip;0;0;2;2
9245;Spindulėlis;BITUTĖS;1528496272;Taip;2;1;0;3
9246;Spindulėlis;BITUTĖS;9348576749;Taip;0;1;1;2
9247;Spindulėlis;BITUTĖS;63344816879;Taip;0;0;7;7
9248;Spindulėlis;BITUTĖS;21152690883;Taip;0;0;1;1
9249;Spindulėlis;BITUTĖS;1679106754;Taip;0;2;0;2
9250;Spindulėlis;VARPELIAI;7107337857;Taip;5;0;15;20
9251;Spindulėlis;VARPELIAI;6471277755;Ne;0;0;15;15
9252;Spindulėlis;VARPELIAI;2336627398;Taip;12;0;1;13
9253;Spindulėlis;VARPELIAI;7646186458;Taip;6;0;0;6
9254;Spindulėlis;VARPELIAI;2881576194;Taip;8;0;3;11
9255;Spindulėlis;VARPELIAI;1563213488;Taip;0;0;2;2
9256;Spindulėlis;VARPELIAI;5912771080;Taip;10;0;3;13
9257;Spindulėlis;VARPELIAI;2516513740;Taip;0;0;1;1
9258;Spindulėlis;VARPELIAI;8595804874;Ne;0;0;1;1
9259;Spindulėlis;VARPELIAI;4836599508;Taip;0;0;3;3
9260;Spindulėlis;VARPELIAI;4709625816;Taip;0;0;3;3
9261;Spindulėlis;VARPELIAI;3911352454;Taip;5;0;3;8
9262;Spindulėlis;VARPELIAI;7947598191;Taip;7;0;0;7
9263;Spindulėlis;VARPELIAI;9205911152;Taip;5;0;0;5
9264;Spragtukas;NYKŠTUKAI;8551195766;Taip;4;0;0;4
9265;Spragtukas;NYKŠTUKAI;8623311748;Taip;3;12;0;15
9266;Spragtukas;NYKŠTUKAI;2943832694;Taip;0;2;0;2
9267;Spragtukas;NYKŠTUKAI;9595221494;Ne;5;2;0;7
9268;Spragtukas;NYKŠTUKAI;6185016824;Taip;9;5;0;14
9269;Spragtukas;NYKŠTUKAI;6162830167;Taip;5;2;0;7
9270;Spragtukas;NYKŠTUKAI;2076126173;Taip;0;2;0;2
9271;Spragtukas;NYKŠTUKAI;3012345413;Taip;11;0;0;11
9272;Spragtukas;NYKŠTUKAI;8698492694;Taip;0;1;0;1
9273;Spragtukas;NYKŠTUKAI;1150002524;Taip;0;3;0;3
9274;Spragtukas;NYKŠTUKAI;4493810276;Taip;0;3;0;3
9275;Spragtukas;NYKŠTUKAI;8288793522;Taip;7;0;0;7
9276;Spragtukas;NYKŠTUKAI;6986034864;Ne;0;5;0;5
9277;Spragtukas;NYKŠTUKAI;9665371858;Ne;0;3;0;3
9278;Spragtukas;SAULUTĖ;4669257062;Taip;0;1;0;1
9279;Spragtukas;SAULUTĖ;3692960591;Taip;0;1;1;2
9280;Spragtukas;SAULUTĖ;6192381779;Taip;0;0;2;2
9281;Spragtukas;SAULUTĖ;4586034709;Taip;0;1;0;1
9282;Spragtukas;SAULUTĖ;2305568596;Taip;0;2;0;2
9283;Spragtukas;SAULUTĖ;1150727381;Taip;0;0;2;2
9284;Spragtukas;SAULUTĖ;3948232692;Taip;0;1;2;3
9285;Spragtukas;SAULUTĖ;9149954373;Taip;0;6;0;6
9286;Spragtukas;SAULUTĖ;7511680722;Taip;0;2;0;2
9287;Spragtukas;SAULUTĖ;8235791891;Taip;3;16;0;19
9288;Spragtukas;SAULUTĖ;2987638580;Taip;0;6;0;6
9289;Spragtukas;SAULUTĖ;3189741449;Taip;0;4;0;4
9290;Spragtukas;SAULUTĖ;5687853390;Taip;0;1;0;1
9291;Spragtukas;SAULUTĖ;6679886985;Taip;0;0;4;4
9292;Spragtukas;SAULUTĖ;4344537391;Taip;0;7;1;8
9293;Spragtukas;SAULUTĖ;2879077913;Ne;0;3;0;3
9294;Spragtukas;SAULUTĖ;1998148708;Ne;0;2;1;3
9295;Spragtukas;SAULUTĖ;8227086854;Ne;0;9;0;9
9296;Spragtukas;SAULUTĖ;5697451914;Taip;0;1;0;1
9297;Spragtukas;SAULUTĖ;3086399458;Taip;5;1;0;6
9298;Spragtukas;SPINDULĖLIAI;4675031453;Taip;0;0;2;2
9299;Spragtukas;SPINDULĖLIAI;9781727236;Taip;14;0;0;14
9300;Spragtukas;SPINDULĖLIAI;1029392579;Taip;0;0;1;1
9301;Spragtukas;SPINDULĖLIAI;6417098461;Taip;2;1;0;3
9302;Spragtukas;SPINDULĖLIAI;1336973131;Taip;0;0;1;1
9303;Spragtukas;SPINDULĖLIAI;70413855110;Taip;0;0;3;3
9304;Spragtukas;SPINDULĖLIAI;65692358082;Taip;3;0;0;3
9305;Spragtukas;SPINDULĖLIAI;6052538605;Taip;0;10;0;10
9306;Spragtukas;SPINDULĖLIAI;2138152514;Taip;0;1;2;3
9307;Spragtukas;SPINDULĖLIAI;1305123801;Taip;0;12;0;12
9308;Spragtukas;SPINDULĖLIAI;4485715299;Taip;0;4;0;4
9309;Spragtukas;SPINDULĖLIAI;4224693184;Taip;0;5;0;5
9310;Spragtukas;SPINDULĖLIAI;2493749424;Taip;0;0;2;2
9311;Spragtukas;SPINDULĖLIAI;3411349574;Ne;4;0;0;4
9312;Spragtukas;SPINDULĖLIAI;1306663967;Taip;4;7;0;11
9313;Spragtukas;SPINDULĖLIAI;3798118695;Taip;15;0;1;16
9314;Spragtukas;SPINDULĖLIAI;2909322678;Taip;0;10;0;10
9315;Spragtukas;GINTARĖLIAI;8339926929;Taip;0;0;2;2
9316;Spragtukas;GINTARĖLIAI;5724874569;Taip;0;10;0;10
9317;Spragtukas;GINTARĖLIAI;1430632638;Taip;9;0;1;10
9318;Spragtukas;GINTARĖLIAI;8625143071;Taip;16;0;1;17
9319;Spragtukas;GINTARĖLIAI;2255007161;Ne;5;0;3;8
9320;Spragtukas;GINTARĖLIAI;6493380877;Taip;0;1;0;1
9321;Spragtukas;GINTARĖLIAI;5427116799;Taip;2;0;6;8
9322;Spragtukas;GINTARĖLIAI;9664130733;Taip;3;10;0;13
9323;Spragtukas;GINTARĖLIAI;8698469979;Taip;7;8;0;15
9324;Spragtukas;GINTARĖLIAI;1747417905;Taip;0;15;1;16
9325;Spragtukas;GINTARĖLIAI;6388163866;Ne;13;0;0;13
9326;Spragtukas;GINTARĖLIAI;8191270443;Taip;7;0;0;7
9327;Spragtukas;GINTARĖLIAI;8893190073;Ne;0;0;1;1
9328;Spragtukas;GINTARĖLIAI;3684183344;Ne;3;0;1;4
9329;Spragtukas;GINTARĖLIAI;9930330487;Ne;5;0;0;5
9330;Spragtukas;GINTARĖLIAI;7806145224;Taip;3;0;2;5
9331;Spragtukas;GINTARĖLIAI;3170388518;Ne;5;0;0;5
9332;Spragtukas;ČIPOLINO;2371848091;Taip;0;6;0;6
9333;Spragtukas;ČIPOLINO;6582680700;Taip;6;2;0;8
9334;Spragtukas;ČIPOLINO;1599958343;Taip;0;1;0;1
9335;Spragtukas;ČIPOLINO;1547670082;Taip;0;4;0;4
9336;Spragtukas;ČIPOLINO;7504632314;Taip;0;1;0;1
9337;Spragtukas;ČIPOLINO;1597988501;Taip;0;14;0;14
9338;Spragtukas;ČIPOLINO;6526633051;Taip;0;1;0;1
9339;Spragtukas;ČIPOLINO;1058970799;Taip;6;1;0;7
9340;Spragtukas;ČIPOLINO;45661532130;Taip;0;1;0;1
9341;Spragtukas;ČIPOLINO;3045382299;Taip;0;4;0;4
9342;Spragtukas;ČIPOLINO;7640805299;Taip;0;13;0;13
9343;Spragtukas;ČIPOLINO;1365907314;Taip;0;2;0;2
9344;Spragtukas;ČIPOLINO;3566797064;Taip;0;1;0;1
9345;Spragtukas;ČIPOLINO;2902550587;Taip;7;1;0;8
9346;Spragtukas;ČIPOLINO;1827458781;Ne;3;4;0;7
9347;Spragtukas;ČIPOLINO;69114720307;Taip;11;1;0;12
9348;Spragtukas;ČIPOLINO;9789977863;Taip;5;6;0;11
9349;Spragtukas;ČIPOLINO;1044112039;Ne;9;1;0;10
9350;Spragtukas;ČIPOLINO;5707084920;Taip;0;20;0;20
9351;Spragtukas;ČIPOLINO;1482803930;Taip;0;8;0;8
9352;Spragtukas;BORUŽĖLĖS;8614890958;Taip;6;3;0;9
9353;Spragtukas;BORUŽĖLĖS;6548270099;Ne;11;0;0;11
9354;Spragtukas;BORUŽĖLĖS;1046613540;Ne;0;2;0;2
9355;Spragtukas;BORUŽĖLĖS;2356476212;Taip;13;0;0;13
9356;Spragtukas;BORUŽĖLĖS;8429135626;Taip;7;11;0;18
9357;Spragtukas;BORUŽĖLĖS;8287102733;Taip;4;8;0;12
9358;Spragtukas;BORUŽĖLĖS;5844437769;Ne;11;1;0;12
9359;Spragtukas;BORUŽĖLĖS;6584145176;Taip;5;1;0;6
9360;Spragtukas;BORUŽĖLĖS;2946297529;Ne;5;0;0;5
9361;Spragtukas;BORUŽĖLĖS;9860876807;Taip;0;2;0;2
9362;Spragtukas;BORUŽĖLĖS;9965087132;Taip;0;6;0;6
9363;Spragtukas;BORUŽĖLĖS;4069044269;Taip;7;9;0;16
9364;Spragtukas;BORUŽĖLĖS;5150028968;Taip;7;1;0;8
9365;Spragtukas;BORUŽĖLĖS;9754594384;Ne;0;8;0;8
9366;Spragtukas;BORUŽĖLĖS;1756340613;Taip;7;1;0;8
9367;Spragtukas;BORUŽĖLĖS;6824861247;Ne;10;0;0;10
9368;Spragtukas;BORUŽĖLĖS;5556920140;Taip;5;0;0;5
9369;Spragtukas;DRUGELIAI;1138975383;Taip;3;2;0;5
9370;Spragtukas;DRUGELIAI;2118272247;Taip;0;7;0;7
9371;Spragtukas;DRUGELIAI;46794033116;Taip;0;1;0;1
9372;Spragtukas;DRUGELIAI;1418494757;Taip;0;1;0;1
9373;Spragtukas;DRUGELIAI;60980580078;Taip;3;0;1;4
9374;Spragtukas;DRUGELIAI;56384144331;Taip;0;1;1;2
9375;Spragtukas;DRUGELIAI;19580966465;Taip;0;0;1;1
9376;Spragtukas;DRUGELIAI;1731215395;Taip;0;1;0;1
9377;Spragtukas;DRUGELIAI;67679737675;Taip;0;1;0;1
9378;Spragtukas;DRUGELIAI;1953368351;Taip;5;1;1;7
9379;Spragtukas;DRUGELIAI;1030688447;Taip;1;5;1;7
9380;Spragtukas;DRUGELIAI;22025568463;Ne;0;0;2;2
9381;Spragtukas;DRUGELIAI;1491147348;Taip;1;10;0;11
9382;Spragtukas;DRUGELIAI;38120721944;Taip;0;1;0;1
9383;Spragtukas;DRUGELIAI;20279570129;Ne;0;1;0;1
9384;Spragtukas;DRUGELIAI;9545021401;Ne;0;0;3;3
9385;Spragtukas;GAIDELIAI;71081903240;Taip;10;0;0;10
9386;Spragtukas;GAIDELIAI;79237309377;Taip;0;0;1;1
9387;Spragtukas;GAIDELIAI;54099559107;Taip;0;4;0;4
9388;Spragtukas;GAIDELIAI;19453957982;Taip;0;5;1;6
9389;Spragtukas;GAIDELIAI;1203266608;Taip;4;0;1;5
9390;Spragtukas;GAIDELIAI;11849369985;Taip;0;1;2;3
9391;Spragtukas;GAIDELIAI;2042294168;Taip;7;0;0;7
9392;Spragtukas;GAIDELIAI;1030566027;Taip;2;6;0;8
9393;Spragtukas;GAIDELIAI;8150653485;Taip;3;0;0;3
9394;Spragtukas;GAIDELIAI;1247838976;Taip;0;0;6;6
9395;Spragtukas;GAIDELIAI;2061441977;Taip;0;3;0;3
9396;Spragtukas;GAIDELIAI;9644808747;Ne;0;0;12;12
9397;Spragtukas;GAIDELIAI;4209118353;Taip;0;6;0;6
9398;Spragtukas;GAIDELIAI;6501930436;Ne;0;18;0;18
9399;Spragtukas;GAIDELIAI;1210698072;Taip;0;0;1;1
9400;Spragtukas;GAIDELIAI;1070119148;Taip;4;6;0;10
9401;Spragtukas;GAIDELIAI;2277960395;Taip;6;0;0;6
9402;Spragtukas;GAIDELIAI;5692820402;Ne;3;0;0;3
9403;Spragtukas;ŽUVELĖS;9078163633;Ne;5;0;0;5
9404;Spragtukas;ŽUVELĖS;8652973900;Taip;0;4;0;4
9405;Spragtukas;ŽUVELĖS;3261213140;Taip;0;4;0;4
9406;Spragtukas;ŽUVELĖS;5689392663;Taip;0;1;3;4
9407;Spragtukas;ŽUVELĖS;9592271053;Taip;0;1;0;1
9408;Spragtukas;ŽUVELĖS;6465991136;Taip;2;1;0;3
9409;Spragtukas;ŽUVELĖS;6503842956;Taip;0;1;0;1
9410;Spragtukas;ŽUVELĖS;2578400770;Taip;0;1;0;1
9411;Spragtukas;ŽUVELĖS;6757604305;Taip;5;0;1;6
9412;Spragtukas;ŽUVELĖS;3139748724;Taip;9;0;0;9
9413;Spragtukas;ŽUVELĖS;8640877497;Taip;0;11;0;11
9414;Spragtukas;ŽUVELĖS;2025314314;Taip;0;11;2;13
9415;Spragtukas;ŽUVELĖS;4848647219;Taip;5;1;0;6
9416;Spragtukas;ŽUVELĖS;3491418162;Taip;0;1;3;4
9417;Spragtukas;ŽUVELĖS;5836788916;Taip;0;2;0;2
9418;Spragtukas;ŽUVELĖS;5704941595;Taip;4;9;0;13
9419;Spragtukas;ŽUVELĖS;3286456855;Taip;0;1;0;1
9420;Spragtukas;ŽUVELĖS;9662188102;Taip;2;1;0;3
9421;Spragtukas;ŽUVELĖS;2539660577;Ne;2;2;0;4
9422;Spragtukas;ŽUVELĖS;6836232179;Ne;0;0;3;3
9423;Spragtukas;RIEŠUTĖLIAI;8463747761;Taip;2;1;0;3
9424;Spragtukas;RIEŠUTĖLIAI;6800727630;Taip;0;10;0;10
9425;Spragtukas;RIEŠUTĖLIAI;4131998934;Taip;0;1;0;1
9426;Spragtukas;RIEŠUTĖLIAI;1690400583;Taip;0;6;0;6
9427;Spragtukas;RIEŠUTĖLIAI;6419503965;Taip;0;9;0;9
9428;Spragtukas;RIEŠUTĖLIAI;8246512283;Ne;0;2;0;2
9429;Spragtukas;RIEŠUTĖLIAI;1627243902;Taip;3;1;0;4
9430;Spragtukas;RIEŠUTĖLIAI;1326603216;Taip;21;0;0;21
9431;Spragtukas;RIEŠUTĖLIAI;72636559695;Taip;0;1;1;2
9432;Spragtukas;RIEŠUTĖLIAI;6573750143;Taip;0;1;0;1
9433;Spragtukas;RIEŠUTĖLIAI;5306883933;Taip;0;3;0;3
9434;Spragtukas;RIEŠUTĖLIAI;3654640843;Taip;0;3;0;3
9435;Spragtukas;RIEŠUTĖLIAI;9045185920;Taip;0;3;0;3
9436;Spragtukas;RIEŠUTĖLIAI;1514277186;Taip;0;10;0;10
9437;Spragtukas;RIEŠUTĖLIAI;4427123314;Taip;4;3;0;7
9438;Spragtukas;RIEŠUTĖLIAI;6322121173;Taip;0;2;0;2
9439;Spragtukas;VIŠČIUKAI;7911124524;Ne;5;0;0;5
9440;Spragtukas;VIŠČIUKAI;3216796441;Ne;0;1;0;1
9441;Spragtukas;VIŠČIUKAI;3349726106;Taip;6;0;0;6
9442;Spragtukas;VIŠČIUKAI;4535021524;Ne;0;0;1;1
9443;Spragtukas;VIŠČIUKAI;7108640957;Ne;0;1;0;1
9444;Spragtukas;VIŠČIUKAI;8957903306;Ne;2;2;0;4
9445;Spragtukas;VIŠČIUKAI;6685524805;Taip;4;5;0;9
9446;Spragtukas;VIŠČIUKAI;2679834328;Taip;0;0;1;1
9447;Spragtukas;VIŠČIUKAI;6370760287;Ne;4;0;0;4
9448;Spragtukas;VIŠČIUKAI;9509296936;Ne;0;0;2;2
9449;Spragtukas;MEŠKIUKAI;8684246143;Ne;0;0;3;3
9450;Spragtukas;MEŠKIUKAI;1407611561;Ne;0;0;1;1
9451;Spragtukas;MEŠKIUKAI;7615522850;Taip;5;0;0;5
9452;Spragtukas;MEŠKIUKAI;6797841737;Ne;6;0;0;6
9453;Spragtukas;MEŠKIUKAI;9204569123;Ne;0;0;2;2
9454;Spragtukas;MEŠKIUKAI;6158327941;Ne;5;0;0;5
9455;Spragtukas;MEŠKIUKAI;1946493379;Ne;0;0;7;7
9456;Spragtukas;MEŠKIUKAI;3009567338;Ne;7;0;0;7
9457;Spragtukas;MEŠKIUKAI;2648358901;Ne;5;0;0;5
9458;Spragtukas;MEŠKIUKAI;7767940027;Ne;5;1;0;6
9459;Spragtukas;MEŠKIUKAI;4625065223;Ne;0;0;3;3
9460;Spragtukas;MEŠKIUKAI;6963190259;Ne;9;0;0;9
9461;Spragtukas;MEŠKIUKAI;8732886749;Ne;0;1;5;6
9462;Spragtukas;MEŠKIUKAI;4134127256;Taip;0;0;1;1
9463;Strazdelis;Žiogelių;5346485534;Taip;5;1;0;6
9464;Strazdelis;Žiogelių;8686828982;Taip;6;5;0;11
9465;Strazdelis;Žiogelių;9933042249;Taip;5;8;0;13
9466;Strazdelis;Žiogelių;8111541739;Taip;0;0;1;1
9467;Strazdelis;Žiogelių;7913526787;Taip;0;21;0;21
9468;Strazdelis;Žiogelių;8581533423;Taip;6;1;0;7
9469;Strazdelis;Žiogelių;8209625399;Taip;0;3;0;3
9470;Strazdelis;Žiogelių;1141752802;Taip;17;0;1;18
9471;Strazdelis;Žiogelių;7425818775;Taip;4;0;0;4
9472;Strazdelis;Žiogelių;9567476872;Taip;9;1;3;13
9473;Strazdelis;Žiogelių;2753635198;Taip;0;0;1;1
9474;Strazdelis;Žiogelių;6651360492;Taip;0;6;0;6
9475;Strazdelis;Žiogelių;1194918926;Taip;0;11;0;11
9476;Strazdelis;Žiogelių;3596394112;Taip;4;5;0;9
9477;Strazdelis;Žiogelių;1900086424;Taip;0;12;0;12
9478;Strazdelis;Žiogelių;8035603341;Taip;0;1;0;1
9479;Strazdelis;Žiogelių;8493572399;Taip;12;0;1;13
9480;Strazdelis;Šeimynėlės;3662217925;Taip;4;4;0;8
9481;Strazdelis;Šeimynėlės;8274897977;Taip;7;3;0;10
9482;Strazdelis;Šeimynėlės;43314069648;Taip;0;1;0;1
9483;Strazdelis;Šeimynėlės;4697537943;Taip;0;11;0;11
9484;Strazdelis;Šeimynėlės;3943578036;Ne;0;15;0;15
9485;Strazdelis;Šeimynėlės;2802486859;Ne;0;3;0;3
9486;Strazdelis;Šeimynėlės;4791752179;Taip;5;1;0;6
9487;Strazdelis;Šeimynėlės;7215063033;Taip;5;10;0;15
9488;Strazdelis;Šeimynėlės;1665134387;Taip;0;8;0;8
9489;Strazdelis;Šeimynėlės;1481671624;Taip;5;1;0;6
9490;Strazdelis;Šeimynėlės;45083023033;Taip;0;3;0;3
9491;Strazdelis;Šeimynėlės;4454199703;Ne;15;0;0;15
9492;Strazdelis;Šeimynėlės;4698566091;Ne;0;2;0;2
9493;Strazdelis;Šeimynėlės;5698472204;Taip;0;3;0;3
9494;Strazdelis;Šeimynėlės;6528024720;Taip;9;2;0;11
9495;Strazdelis;Šeimynėlės;9835716116;Ne;0;1;0;1
9496;Strazdelis;Šeimynėlės;7149827850;Taip;5;1;0;6
9497;Strazdelis;Šeimynėlės;8938997208;Taip;5;0;0;5
9498;Strazdelis;Šeimynėlės;5749300013;Taip;7;0;0;7
9499;Strazdelis;Šeimynėlės;4929828091;Taip;0;6;0;6
9500;Strazdelis;Genelio;8038163444;Taip;0;1;0;1
9501;Strazdelis;Genelio;8754275576;Taip;0;1;0;1
9502;Strazdelis;Genelio;7120717682;Taip;0;2;0;2
9503;Strazdelis;Genelio;50350281905;Taip;0;2;0;2
9504;Strazdelis;Genelio;9198429790;Taip;0;2;0;2
9505;Strazdelis;Genelio;2871673641;Taip;0;6;0;6
9506;Strazdelis;Genelio;6147183190;Taip;20;0;0;20
9507;Strazdelis;Genelio;2078150337;Taip;0;3;0;3
9508;Strazdelis;Genelio;18461074207;Ne;0;4;0;4
9509;Strazdelis;Genelio;9904719582;Taip;12;1;0;13
9510;Strazdelis;Genelio;7308925265;Taip;0;2;0;2
9511;Strazdelis;Genelio;4655931716;Taip;0;11;0;11
9512;Strazdelis;Genelio;8182994112;Taip;12;0;0;12
9513;Strazdelis;Genelio;1362428967;Taip;0;3;0;3
9514;Strazdelis;Genelio;4990421186;Ne;0;0;2;2
9515;Strazdelis;Genelio;1847733888;Taip;5;3;1;9
9516;Strazdelis;Vikruolių;3729497908;Ne;2;8;0;10
9517;Strazdelis;Vikruolių;60128913543;Taip;0;2;0;2
9518;Strazdelis;Vikruolių;24669852216;Taip;0;2;0;2
9519;Strazdelis;Vikruolių;51702469375;Taip;1;1;0;2
9520;Strazdelis;Vikruolių;59837435595;Ne;5;8;0;13
9521;Strazdelis;Vikruolių;34644143572;Taip;0;1;0;1
9522;Strazdelis;Vikruolių;90089166514;Taip;0;1;0;1
9523;Strazdelis;Vikruolių;1847755442;Taip;0;6;0;6
9524;Strazdelis;Vikruolių;1785962711;Taip;8;6;0;14
9525;Strazdelis;Vikruolių;2090154632;Taip;0;10;0;10
9526;Strazdelis;Vikruolių;1073814440;Taip;6;0;0;6
9527;Strazdelis;Vikruolių;68605763183;Taip;15;6;0;21
9528;Strazdelis;Vikruolių;7812253305;Taip;0;2;0;2
9529;Strazdelis;Vikruolių;1257686463;Taip;0;0;4;4
9530;Strazdelis;Vikruolių;1728059994;Taip;0;2;0;2
9531;Strazdelis;Vyturėlių;12739940649;Ne;7;2;0;9
9532;Strazdelis;Vyturėlių;1858519255;Taip;0;3;0;3
9533;Strazdelis;Vyturėlių;20510560289;Taip;13;0;0;13
9534;Strazdelis;Vyturėlių;84548133061;Taip;0;3;0;3
9535;Strazdelis;Vyturėlių;48052363003;Taip;0;1;0;1
9536;Strazdelis;Vyturėlių;81910819903;Taip;0;1;0;1
9537;Strazdelis;Vyturėlių;20845810823;Taip;0;2;0;2
9538;Strazdelis;Vyturėlių;64076729200;Taip;0;1;0;1
9539;Strazdelis;Vyturėlių;57514782479;Taip;0;3;0;3
9540;Strazdelis;Vyturėlių;50984917126;Taip;1;1;0;2
9541;Strazdelis;Vyturėlių;79443961061;Taip;0;1;0;1
9542;Strazdelis;Vyturėlių;59969322783;Taip;0;5;0;5
9543;Strazdelis;Vyturėlių;43128715501;Taip;7;0;0;7
9544;Strazdelis;Vyturėlių;2110092578;Taip;0;5;0;5
9545;Strazdelis;Vyturėlių;14459771394;Taip;0;1;0;1
9546;Strazdelis;Vyturėlių;96077591556;Taip;0;1;0;1
9547;Strazdelis;Varpelio;4159072583;Taip;0;2;0;2
9548;Strazdelis;Varpelio;9621022918;Ne;0;1;0;1
9549;Strazdelis;Varpelio;8415383526;Taip;0;4;0;4
9550;Strazdelis;Varpelio;2662549392;Taip;0;1;0;1
9551;Strazdelis;Varpelio;9502341478;Taip;7;6;0;13
9552;Strazdelis;Varpelio;6311710825;Taip;6;2;0;8
9553;Strazdelis;Varpelio;1955166372;Taip;2;3;0;5
9554;Strazdelis;Varpelio;4873707286;Ne;0;1;0;1
9555;Strazdelis;Varpelio;6527855940;Taip;0;3;0;3
9556;Strazdelis;Varpelio;4076266466;Taip;0;21;0;21
9557;Strazdelis;Varpelio;2824416350;Taip;5;2;0;7
9558;Strazdelis;Varpelio;3610250359;Taip;0;3;0;3
9559;Strazdelis;Varpelio;2766970956;Taip;0;1;0;1
9560;Strazdelis;Varpelio;1173067724;Taip;3;2;0;5
9561;Strazdelis;Varpelio;1021364759;Taip;10;2;0;12
9562;Strazdelis;Varpelio;1706026100;Ne;3;1;0;4
9563;Strazdelis;Pelėdžiukų;5892430004;Taip;0;12;0;12
9564;Strazdelis;Pelėdžiukų;1901641517;Taip;0;3;0;3
9565;Strazdelis;Pelėdžiukų;8637386316;Taip;0;1;0;1
9566;Strazdelis;Pelėdžiukų;1704292727;Taip;10;2;0;12
9567;Strazdelis;Pelėdžiukų;4617237063;Taip;0;5;0;5
9568;Strazdelis;Pelėdžiukų;3036380561;Taip;0;5;0;5
9569;Strazdelis;Pelėdžiukų;8371999002;Taip;5;3;0;8
9570;Strazdelis;Pelėdžiukų;8287554571;Taip;0;1;0;1
9571;Strazdelis;Pelėdžiukų;5580738386;Taip;0;6;0;6
9572;Strazdelis;Pelėdžiukų;4448556404;Taip;12;1;0;13
9573;Strazdelis;Pelėdžiukų;8854150040;Taip;0;6;0;6
9574;Strazdelis;Pelėdžiukų;2238875354;Taip;3;5;0;8
9575;Strazdelis;Pelėdžiukų;4004930488;Taip;0;10;0;10
9576;Strazdelis;Pelėdžiukų;5768674837;Taip;2;4;0;6
9577;Strazdelis;Pelėdžiukų;7349106795;Taip;8;0;0;8
9578;Strazdelis;Pelėdžiukų;9761595867;Taip;8;0;0;8
9579;Strazdelis;Pelėdžiukų;7876385010;Taip;0;3;0;3
9580;Strazdelis;Pelėdžiukų;2848984531;Taip;14;0;0;14
9581;Strazdelis;Pelėdžiukų;7471890377;Taip;0;1;0;1
9582;Strazdelis;Saulutės;1474503932;Taip;6;1;0;7
9583;Strazdelis;Saulutės;27177757900;Taip;0;1;0;1
9584;Strazdelis;Saulutės;1523471662;Taip;10;2;0;12
9585;Strazdelis;Saulutės;2854642875;Taip;12;0;0;12
9586;Strazdelis;Saulutės;7578229276;Taip;0;6;0;6
9587;Strazdelis;Saulutės;8710848483;Taip;0;1;0;1
9588;Strazdelis;Saulutės;6614184499;Taip;10;0;0;10
9589;Strazdelis;Saulutės;3425430317;Taip;0;1;0;1
9590;Strazdelis;Saulutės;7081517417;Taip;0;2;1;3
9591;Strazdelis;Saulutės;67641340859;Taip;0;1;0;1
9592;Strazdelis;Saulutės;15298412755;Ne;0;2;0;2
9593;Strazdelis;Saulutės;1802092125;Taip;3;0;0;3
9594;Strazdelis;Saulutės;1391009140;Taip;12;3;0;15
9595;Strazdelis;Saulutės;6779352728;Taip;0;5;0;5
9596;Strazdelis;Saulutės;12713270671;Taip;0;1;0;1
9597;Strazdelis;Saulutės;1886601605;Taip;0;0;6;6
9598;Strazdelis;Saulutės;1693309238;Taip;0;3;0;3
9599;Strazdelis;Saulutės;3753612757;Taip;7;1;0;8
9600;Strazdelis;Bitutės;8485509145;Taip;0;2;0;2
9601;Strazdelis;Bitutės;6508933324;Taip;5;0;0;5
9602;Strazdelis;Bitutės;1005082012;Ne;0;0;5;5
9603;Strazdelis;Bitutės;2963535523;Taip;0;1;0;1
9604;Strazdelis;Bitutės;2589303722;Taip;0;0;5;5
9605;Strazdelis;Bitutės;4020547762;Taip;3;2;0;5
9606;Strazdelis;Bitutės;8753316532;Taip;5;0;0;5
9607;Strazdelis;Bitutės;3149930355;Taip;0;4;0;4
9608;Strazdelis;Bitutės;5232064496;Taip;5;2;0;7
9609;Strazdelis;Bitutės;9555240419;Taip;8;0;2;10
9610;Strazdelis;Bitutės;2081538505;Taip;0;6;0;6
9611;Strazdelis;Bitutės;3043580835;Taip;5;0;0;5
9612;Strazdelis;Bitutės;1539984888;Taip;4;2;0;6
9613;Strazdelis;Bitutės;4784401449;Ne;10;0;0;10
9614;Strazdelis;Bitutės;4400849922;Taip;2;1;0;3
9615;Strazdelis;Bitutės;7890064837;Taip;5;0;0;5
9616;Strazdelis;Bitutės;1881071425;Taip;14;0;0;14
9617;Strazdelis;Bitutės;2908567982;Taip;12;0;1;13
9618;Strazdelis;Bitutės;9548465554;Taip;18;0;2;20
9619;Strazdelis;Bitutės;7466648222;Taip;8;2;0;10
9620;Strazdelis;Bitutės;4463378251;Taip;10;1;0;11
9621;Strazdelis;Bitutės;4369569609;Taip;0;0;10;10
9622;Strazdelis;Bitutės;8443837176;Taip;5;0;0;5
9623;Strazdelis;Mažylių;6271193831;Taip;4;8;0;12
9624;Strazdelis;Mažylių;9586256979;Taip;7;0;0;7
9625;Strazdelis;Mažylių;3084249678;Taip;0;2;0;2
9626;Strazdelis;Mažylių;5499310072;Taip;0;2;8;10
9627;Strazdelis;Mažylių;8333151969;Taip;0;2;1;3
9628;Strazdelis;Mažylių;7083940713;Taip;0;2;1;3
9629;Strazdelis;Mažylių;6480803618;Taip;5;2;5;12
9630;Strazdelis;Mažylių;6071502600;Ne;17;1;0;18
9631;Strazdelis;Mažylių;3713797440;Ne;17;1;0;18
9632;Strazdelis;Mažylių;3456287323;Taip;8;0;0;8
9633;Strazdelis;Mažylių;1034497200;Taip;2;0;0;2
9634;Strazdelis;Mažylių;2459718449;Taip;7;2;0;9
9635;Strazdelis;Mažylių;8956634754;Taip;4;2;0;6
9636;Strazdelis;Mažylių;7680242840;Taip;5;1;0;6
9637;Strazdelis;Mažylių;4545538133;Taip;5;2;2;9
9638;Strazdelis;Pabiručių;1683900907;Taip;0;7;0;7
9639;Strazdelis;Pabiručių;9806107189;Taip;3;0;0;3
9640;Strazdelis;Pabiručių;6570504154;Taip;1;0;2;3
9641;Strazdelis;Pabiručių;3848288765;Taip;7;2;0;9
9642;Strazdelis;Pabiručių;5033799225;Ne;7;2;0;9
9643;Strazdelis;Pabiručių;2990771887;Taip;5;1;0;6
9644;Strazdelis;Pabiručių;4501391298;Taip;12;0;0;12
9645;Strazdelis;Pabiručių;9057914477;Taip;1;0;0;1
9646;Strazdelis;Pabiručių;1012692326;Ne;4;0;0;4
9647;Strazdelis;Pabiručių;8899530711;Ne;4;0;0;4
9648;Strazdelis;Pabiručių;1017838338;Taip;8;0;0;8
9649;Strazdelis;Pabiručių;2068793184;Taip;0;1;1;2
9650;Strazdelis;Pabiručių;5784406335;Taip;0;1;0;1
9651;Strazdelis;Pabiručių;3897248010;Taip;6;0;0;6
9652;Šermukšnėlė;MOLINUKAI;61809452162;Taip;0;7;0;7
9653;Šermukšnėlė;MOLINUKAI;39534021804;Taip;5;1;0;6
9654;Šermukšnėlė;MOLINUKAI;3873114056;Taip;3;0;1;4
9655;Šermukšnėlė;MOLINUKAI;1561527473;Ne;0;0;2;2
9656;Šermukšnėlė;MOLINUKAI;841268127;Ne;3;0;0;3
9657;Šermukšnėlė;MOLINUKAI;83487643143;Taip;4;0;1;5
9658;Šermukšnėlė;MOLINUKAI;1411650732;Ne;9;0;1;10
9659;Šermukšnėlė;MOLINUKAI;7830792252;Taip;0;0;4;4
9660;Šermukšnėlė;MOLINUKAI;1756161106;Taip;0;0;1;1
9661;Šermukšnėlė;MOLINUKAI;2050855662;Ne;2;0;1;3
9662;Šermukšnėlė;MOLINUKAI;2561033248;Taip;0;8;0;8
9663;Šermukšnėlė;MOLINUKAI;26715691626;Taip;5;0;0;5
9664;Šermukšnėlė;MOLINUKAI;1573326752;Taip;9;0;0;9
9665;Šermukšnėlė;MOLINUKAI;2555177886;Ne;0;0;1;1
9666;Šermukšnėlė;MOLINUKAI;3713203910;Taip;16;0;0;16
9667;Šermukšnėlė;ŠIAUDINUKAI;7002917737;Taip;6;0;0;6
9668;Šermukšnėlė;ŠIAUDINUKAI;3637882900;Taip;7;0;2;9
9669;Šermukšnėlė;ŠIAUDINUKAI;1159472154;Taip;0;0;1;1
9670;Šermukšnėlė;ŠIAUDINUKAI;4956414941;Taip;10;0;0;10
9671;Šermukšnėlė;ŠIAUDINUKAI;3499394539;Taip;15;0;0;15
9672;Šermukšnėlė;ŠIAUDINUKAI;1157979179;Taip;0;0;5;5
9673;Šermukšnėlė;ŠIAUDINUKAI;3701053997;Taip;11;0;1;12
9674;Šermukšnėlė;ŠIAUDINUKAI;8048598135;Taip;5;0;0;5
9675;Šermukšnėlė;ŠIAUDINUKAI;7917101921;Taip;8;0;0;8
9676;Šermukšnėlė;ŠIAUDINUKAI;3082272196;Taip;9;0;1;10
9677;Šermukšnėlė;ŠIAUDINUKAI;9903310024;Taip;5;0;0;5
9678;Šermukšnėlė;ŠIAUDINUKAI;9012757607;Taip;0;0;3;3
9679;Šermukšnėlė;ŠIAUDINUKAI;5627334876;Taip;8;0;0;8
9680;Šermukšnėlė;ŠIAUDINUKAI;3550736579;Taip;14;0;1;15
9681;Šermukšnėlė;ŠIAUDINUKAI;4913415466;Taip;9;0;1;10
9682;Šermukšnėlė;TOŠINUKAI;2160616078;Taip;6;0;1;7
9683;Šermukšnėlė;TOŠINUKAI;1661977128;Ne;6;0;7;13
9684;Šermukšnėlė;TOŠINUKAI;3994316729;Taip;0;10;1;11
9685;Šermukšnėlė;TOŠINUKAI;1459253197;Taip;1;0;0;1
9686;Šermukšnėlė;TOŠINUKAI;78341448188;Taip;11;0;1;12
9687;Šermukšnėlė;TOŠINUKAI;8279692394;Taip;6;0;1;7
9688;Šermukšnėlė;TOŠINUKAI;5096946133;Taip;5;0;5;10
9689;Šermukšnėlė;TOŠINUKAI;2380988728;Ne;2;0;1;3
9690;Šermukšnėlė;TOŠINUKAI;8956573129;Taip;12;5;0;17
9691;Šermukšnėlė;TOŠINUKAI;4981204674;Taip;0;0;11;11
9692;Šermukšnėlė;TOŠINUKAI;7229632099;Taip;12;0;1;13
9693;Šermukšnėlė;TOŠINUKAI;2529526401;Taip;0;0;2;2
9694;Šermukšnėlė;TOŠINUKAI;7038705221;Ne;0;5;0;5
9695;Šermukšnėlė;TOŠINUKAI;6413821285;Taip;0;5;0;5
9696;Šermukšnėlė;TOŠINUKAI;9035625467;Taip;7;0;3;10
9697;Šermukšnėlė;TOŠINUKAI;3081548524;Ne;4;0;1;5
9698;Šermukšnėlė;TOŠINUKAI;5832072195;Taip;6;6;0;12
9699;Šermukšnėlė;TOŠINUKAI;3222466449;Taip;0;0;4;4
9700;Šermukšnėlė;TOŠINUKAI;1753169856;Ne;0;0;1;1
9701;Šermukšnėlė;TOŠINUKAI;6430627501;Taip;5;0;0;5
9702;Šermukšnėlė;TOŠINUKAI;9442514813;Taip;3;0;0;3
9703;Šermukšnėlė;TOŠINUKAI;1569084597;Taip;0;0;5;5
9704;Šermukšnėlė;ODINUKAI;5545018656;Taip;0;0;4;4
9705;Šermukšnėlė;ODINUKAI;2176788727;Taip;4;0;0;4
9706;Šermukšnėlė;ODINUKAI;3148857617;Taip;3;10;0;13
9707;Šermukšnėlė;ODINUKAI;5575518612;Taip;11;0;1;12
9708;Šermukšnėlė;ODINUKAI;5733540837;Taip;4;4;2;10
9709;Šermukšnėlė;ODINUKAI;7262199284;Taip;5;1;0;6
9710;Šermukšnėlė;ODINUKAI;5159461963;Taip;5;3;0;8
9711;Šermukšnėlė;ODINUKAI;5354978646;Taip;0;0;5;5
9712;Šermukšnėlė;ODINUKAI;1882432812;Taip;0;0;5;5
9713;Šermukšnėlė;ODINUKAI;5151843494;Taip;8;0;1;9
9714;Šermukšnėlė;ODINUKAI;3949629658;Taip;0;0;3;3
9715;Šermukšnėlė;ODINUKAI;4201283154;Ne;3;0;0;3
9716;Šermukšnėlė;ODINUKAI;6105915822;Taip;7;0;1;8
9717;Šermukšnėlė;ODINUKAI;9742208172;Taip;10;0;0;10
9718;Šermukšnėlė;ODINUKAI;7667114310;Taip;0;0;4;4
9719;Šermukšnėlė;ODINUKAI;7245206247;Taip;0;0;6;6
9720;Šermukšnėlė;ODINUKAI;5397385093;Taip;5;0;2;7
9721;Šermukšnėlė;ODINUKAI;4331948700;Taip;0;0;1;1
9722;Šermukšnėlė;ODINUKAI;6718242890;Taip;9;0;2;11
9723;Šermukšnėlė;ODINUKAI;9664249364;Taip;5;0;0;5
9724;Šermukšnėlė;ODINUKAI;1064222922;Taip;5;0;2;7
9725;Šermukšnėlė;KRIAUKLELĖS;3639954786;Taip;7;0;7;14
9726;Šermukšnėlė;KRIAUKLELĖS;5678559268;Taip;4;0;2;6
9727;Šermukšnėlė;KRIAUKLELĖS;7843128263;Ne;14;0;0;14
9728;Šermukšnėlė;KRIAUKLELĖS;6067298318;Taip;10;0;1;11
9729;Šermukšnėlė;KRIAUKLELĖS;5159105661;Taip;5;0;6;11
9730;Šermukšnėlė;KRIAUKLELĖS;4809829190;Taip;6;0;0;6
9731;Šermukšnėlė;KRIAUKLELĖS;8479230675;Ne;13;0;1;14
9732;Šermukšnėlė;KRIAUKLELĖS;1626495661;Ne;0;0;10;10
9733;Šermukšnėlė;KRIAUKLELĖS;8541743148;Taip;0;5;0;5
9734;Šermukšnėlė;KRIAUKLELĖS;8709426669;Taip;0;5;0;5
9735;Šermukšnėlė;KRIAUKLELĖS;6585484701;Taip;7;0;0;7
9736;Šermukšnėlė;KRIAUKLELĖS;6599779539;Taip;0;6;0;6
9737;Šermukšnėlė;KRIAUKLELĖS;9876533442;Taip;0;0;2;2
9738;Šermukšnėlė;KRIAUKLELĖS;3653792683;Taip;0;0;4;4
9739;Šermukšnėlė;KRIAUKLELĖS;3170388518;Ne;0;0;7;7
9740;Šermukšnėlė;KRIAUKLELĖS;9805841777;Taip;0;1;0;1
9741;Šermukšnėlė;VYTINUKAI;97906920174;Ne;10;0;2;12
9742;Šermukšnėlė;VYTINUKAI;1523361932;Taip;0;0;3;3
9743;Šermukšnėlė;VYTINUKAI;8531953934;Ne;0;0;2;2
9744;Šermukšnėlė;VYTINUKAI;25189813939;Taip;4;1;0;5
9745;Šermukšnėlė;VYTINUKAI;83123267733;Taip;0;3;0;3
9746;Šermukšnėlė;VYTINUKAI;20028832329;Taip;0;2;0;2
9747;Šermukšnėlė;VYTINUKAI;3959795064;Taip;10;1;1;12
9748;Šermukšnėlė;VYTINUKAI;8498288021;Taip;0;0;6;6
9749;Šermukšnėlė;VYTINUKAI;5905000902;Taip;4;0;0;4
9750;Šermukšnėlė;VYTINUKAI;1244964311;Ne;3;5;1;9
9751;Šermukšnėlė;VYTINUKAI;83882579952;Taip;0;4;0;4
9752;Šermukšnėlė;VYTINUKAI;60840526220;Taip;5;0;0;5
9753;Šermukšnėlė;VYTINUKAI;1025787925;Taip;0;0;3;3
9754;Šermukšnėlė;VYTINUKAI;1519623099;Taip;0;11;0;11
9755;Šermukšnėlė;VYTINUKAI;5757405893;Taip;1;0;1;2
9756;Šermukšnėlė;VYTINUKAI;7106405983;Ne;0;0;3;3
9757;Šermukšnėlė;VYTINUKAI;9654198217;Ne;0;0;3;3
9758;Šermukšnėlė;VYTINUKAI;1670047548;Taip;5;0;2;7
9759;Šermukšnėlė;VYTINUKAI;5281637612;Ne;4;0;0;4
9760;Šermukšnėlė;VYTINUKAI;1685592290;Ne;5;0;0;5
9761;Šermukšnėlė;VYTINUKAI;4569484117;Taip;7;5;0;12
9762;Šermukšnėlė;GINTARĖLIAI;3147809450;Taip;10;0;1;11
9763;Šermukšnėlė;GINTARĖLIAI;1167696952;Ne;0;0;2;2
9764;Šermukšnėlė;GINTARĖLIAI;85062380771;Taip;0;0;5;5
9765;Šermukšnėlė;GINTARĖLIAI;35389950541;Taip;0;0;1;1
9766;Šermukšnėlė;GINTARĖLIAI;1944687724;Taip;5;0;0;5
9767;Šermukšnėlė;GINTARĖLIAI;1013698297;Taip;6;0;1;7
9768;Šermukšnėlė;GINTARĖLIAI;1521544270;Taip;0;0;1;1
9769;Šermukšnėlė;GINTARĖLIAI;3697936074;Taip;8;0;0;8
9770;Šermukšnėlė;GINTARĖLIAI;27183547828;Ne;0;0;2;2
9771;Šermukšnėlė;GINTARĖLIAI;10728235594;Taip;0;0;4;4
9772;Šermukšnėlė;GINTARĖLIAI;42477406335;Taip;10;0;2;12
9773;Šermukšnėlė;GINTARĖLIAI;61300763004;Taip;0;0;2;2
9774;Šermukšnėlė;GINTARĖLIAI;1425285365;Taip;5;0;3;8
9775;Šermukšnėlė;GINTARĖLIAI;6279210465;Taip;6;0;3;9
9776;Šermukšnėlė;GINTARĖLIAI;4601810772;Taip;7;0;0;7
9777;Šermukšnėlė;GINTARĖLIAI;1562494176;Taip;0;0;5;5
9778;Šermukšnėlė;AKMENUKAI;9658469152;Taip;1;0;2;3
9779;Šermukšnėlė;AKMENUKAI;98850511500;Taip;0;1;0;1
9780;Šermukšnėlė;AKMENUKAI;26775257484;Taip;5;4;0;9
9781;Šermukšnėlė;AKMENUKAI;82028252228;Taip;6;0;1;7
9782;Šermukšnėlė;AKMENUKAI;23434568160;Taip;0;1;0;1
9783;Šermukšnėlė;AKMENUKAI;6255671190;Taip;0;6;0;6
9784;Šermukšnėlė;AKMENUKAI;7564745299;Taip;0;10;0;10
9785;Šermukšnėlė;AKMENUKAI;9617044855;Ne;0;4;0;4
9786;Šermukšnėlė;AKMENUKAI;1856012121;Taip;7;0;1;8
9787;Šermukšnėlė;AKMENUKAI;1499061139;Taip;10;0;0;10
9788;Šermukšnėlė;AKMENUKAI;8407947566;Ne;11;0;0;11
9789;Šermukšnėlė;AKMENUKAI;1492328724;Taip;0;0;1;1
9790;Šermukšnėlė;AKMENUKAI;8123096990;Taip;11;0;1;12
9791;Šermukšnėlė;AKMENUKAI;8859731179;Taip;4;1;0;5
9792;Šermukšnėlė;AKMENUKAI;1902848560;Taip;0;0;3;3
9793;Šermukšnėlė;AKMENUKAI;7548637091;Ne;0;11;1;12
9794;Šermukšnėlė;AKMENUKAI;3513568460;Taip;0;0;2;2
9795;Šermukšnėlė;AKMENUKAI;6896990721;Taip;6;1;0;7
9796;Šermukšnėlė;AKMENUKAI;8064473083;Taip;0;0;3;3
9797;Šermukšnėlė;AKMENUKAI;8511421692;Taip;0;0;2;2
9798;Šermukšnėlė;SIŪLINUKAI;32417473492;Taip;1;2;0;3
9799;Šermukšnėlė;SIŪLINUKAI;35508499818;Taip;0;2;0;2
9800;Šermukšnėlė;SIŪLINUKAI;30853722796;Taip;0;1;2;3
9801;Šermukšnėlė;SIŪLINUKAI;25663713043;Taip;0;0;2;2
9802;Šermukšnėlė;SIŪLINUKAI;88123535614;Ne;5;0;1;6
9803;Šermukšnėlė;SIŪLINUKAI;20160146304;Taip;5;0;0;5
9804;Šermukšnėlė;SIŪLINUKAI;18799838453;Taip;0;0;1;1
9805;Šermukšnėlė;SIŪLINUKAI;1891818706;Taip;0;0;1;1
9806;Šermukšnėlė;SIŪLINUKAI;78916223877;Taip;8;0;2;10
9807;Šermukšnėlė;SIŪLINUKAI;1946948445;Taip;2;0;4;6
9808;Šermukšnėlė;SIŪLINUKAI;2397776116;Taip;0;0;5;5
9809;Šermukšnėlė;SIŪLINUKAI;3883861823;Taip;2;0;3;5
9810;Šermukšnėlė;MEDINUKAi;1996859146;Taip;0;0;5;5
9811;Šermukšnėlė;MEDINUKAi;5172187141;Taip;0;6;0;6
9812;Šermukšnėlė;MEDINUKAi;5886893562;Taip;12;0;0;12
9813;Šermukšnėlė;MEDINUKAi;8249749948;Taip;4;0;2;6
9814;Šermukšnėlė;MEDINUKAi;3688946505;Taip;11;0;0;11
9815;Šermukšnėlė;MEDINUKAi;5069572637;Taip;6;0;0;6
9816;Šermukšnėlė;MEDINUKAi;2989011150;Taip;9;0;1;10
9817;Šermukšnėlė;MEDINUKAi;3747531232;Taip;4;0;0;4
9818;Šermukšnėlė;MEDINUKAi;1994737857;Taip;7;0;0;7
9819;Šermukšnėlė;MEDINUKAi;4619811264;Taip;1;0;0;1
9820;Šermukšnėlė;MEDINUKAi;4783726095;Taip;5;6;0;11
9821;Šermukšnėlė;MEDINUKAi;1636944853;Taip;0;4;0;4
9822;Šermukšnėlė;MEDINUKAi;1437314920;Taip;0;4;0;4
9823;Šermukšnėlė;MEDINUKAi;7053319091;Taip;3;0;1;4
9824;Šermukšnėlė;MEDINUKAi;6351841889;Taip;15;0;0;15
9825;Šermukšnėlė;MEDINUKAi;7305013368;Taip;10;0;0;10
9826;Šermukšnėlė;MEDINUKAi;6194188831;Taip;0;0;1;1
9827;Šermukšnėlė;MEDINUKAi;6249700552;Taip;17;0;0;17
9828;Šermukšnėlė;MEDINUKAi;4805637096;Taip;17;0;0;17
9829;Šermukšnėlė;SKUDURINUKAI;2985284699;Ne;5;0;0;5
9830;Šermukšnėlė;SKUDURINUKAI;5835100042;Taip;5;0;0;5
9831;Šermukšnėlė;SKUDURINUKAI;4983510683;Ne;5;0;0;5
9832;Šermukšnėlė;SKUDURINUKAI;9337047371;Ne;2;0;0;2
9833;Šermukšnėlė;SKUDURINUKAI;2714018690;Taip;5;0;1;6
9834;Šermukšnėlė;SKUDURINUKAI;3342919832;Taip;4;0;0;4
9835;Šermukšnėlė;SKUDURINUKAI;7661182825;Taip;0;1;0;1
9836;Šermukšnėlė;SKUDURINUKAI;4861799571;Taip;3;0;0;3
9837;Šermukšnėlė;SKUDURINUKAI;8000479161;Taip;2;0;0;2
9838;Šermukšnėlė;SKUDURINUKAI;5064892417;Ne;5;0;0;5
9839;Šermukšnėlė;SKUDURINUKAI;5733048755;Taip;4;0;1;5
9840;Šermukšnėlė;SKUDURINUKAI;6608458145;Taip;5;0;0;5
9841;Šermukšnėlė;SKUDURINUKAI;4952285322;Taip;0;3;0;3
9842;Šermukšnėlė;PAGRANDUKAI;6946711443;Taip;1;0;0;1
9843;Šermukšnėlė;PAGRANDUKAI;6797936390;Taip;0;0;1;1
9844;Šermukšnėlė;PAGRANDUKAI;9783673534;Taip;5;0;0;5
9845;Šermukšnėlė;PAGRANDUKAI;8201447350;Taip;7;0;0;7
9846;Šermukšnėlė;PAGRANDUKAI;8117261716;Taip;7;0;0;7
9847;Šermukšnėlė;PAGRANDUKAI;9243932017;Taip;6;0;1;7
9848;Šermukšnėlė;PAGRANDUKAI;5408843906;Taip;12;0;0;12
9849;Šermukšnėlė;PAGRANDUKAI;6342714998;Taip;6;0;0;6
9850;Šermukšnėlė;PAGRANDUKAI;3245643086;Taip;0;1;0;1
9851;Šermukšnėlė;PAGRANDUKAI;7458930634;Taip;10;0;0;10
9852;Šermukšnėlė;PAGRANDUKAI;8748166398;Taip;5;0;0;5
9853;Šermukšnėlė;PAGRANDUKAI;9908568127;Taip;6;0;1;7
9854;Šermukšnėlė;PAGRANDUKAI;3959066963;Taip;0;0;2;2
9855;Šypsena;NYKŠTUKAI;3429836513;Ne;0;0;5;5
9856;Šypsena;NYKŠTUKAI;3065472026;Ne;0;0;2;2
9857;Šypsena;NYKŠTUKAI;7160466766;Ne;10;0;1;11
9858;Šypsena;NYKŠTUKAI;3823623458;Ne;0;6;0;6
9859;Šypsena;NYKŠTUKAI;6713182218;Ne;0;5;0;5
9860;Šypsena;NYKŠTUKAI;1287205292;Ne;7;0;2;9
9861;Šypsena;NYKŠTUKAI;7537442618;Ne;5;0;1;6
9862;Šypsena;NYKŠTUKAI;3968514430;Ne;0;2;0;2
9863;Šypsena;NYKŠTUKAI;7877396588;Ne;0;1;0;1
9864;Šypsena;NYKŠTUKAI;7898387398;Ne;0;0;7;7
9865;Šypsena;NYKŠTUKAI;7120597034;Ne;9;0;2;11
9866;Šypsena;NYKŠTUKAI;5879506651;Ne;3;0;7;10
9867;Šypsena;NYKŠTUKAI;8215278033;Ne;4;0;2;6
9868;Šypsena;NYKŠTUKAI;2584574423;Ne;13;0;0;13
9869;Šypsena;NYKŠTUKAI;5906001927;Ne;19;0;1;20
9870;Šypsena;NYKŠTUKAI;6951845385;Ne;5;0;1;6
9871;Šypsena;NYKŠTUKAI;4520148322;Ne;0;11;0;11
9872;Šypsena;NYKŠTUKAI;1324902555;Ne;5;1;0;6
9873;Šypsena;SPINDULIUKAI;1114341518;Ne;0;0;5;5
9874;Šypsena;SPINDULIUKAI;1558614852;Ne;2;1;0;3
9875;Šypsena;SPINDULIUKAI;1897176871;Ne;5;0;5;10
9876;Šypsena;SPINDULIUKAI;8715718525;Ne;0;0;6;6
9877;Šypsena;SPINDULIUKAI;1181590127;Ne;0;7;1;8
9878;Šypsena;SPINDULIUKAI;4808041625;Ne;0;0;1;1
9879;Šypsena;SPINDULIUKAI;4038279267;Ne;0;0;6;6
9880;Šypsena;SPINDULIUKAI;1515803985;Ne;0;7;0;7
9881;Šypsena;SPINDULIUKAI;8950694484;Ne;0;0;7;7
9882;Šypsena;SPINDULIUKAI;3809171499;Ne;0;1;0;1
9883;Šypsena;SPINDULIUKAI;4344780723;Ne;0;0;6;6
9884;Šypsena;SPINDULIUKAI;5504570516;Ne;4;0;7;11
9885;Šypsena;SPINDULIUKAI;1893123775;Taip;0;1;0;1
9886;Šypsena;SPINDULIUKAI;3506046076;Ne;1;1;2;4
9887;Šypsena;SPINDULIUKAI;7519967594;Ne;5;0;0;5
9888;Šypsena;SPINDULIUKAI;5369445077;Taip;4;0;7;11
9889;Šypsena;SKRUZDELIUKAI;5073378325;Ne;0;0;3;3
9890;Šypsena;SKRUZDELIUKAI;1599633295;Ne;0;7;0;7
9891;Šypsena;SKRUZDELIUKAI;3387625466;Ne;0;0;1;1
9892;Šypsena;SKRUZDELIUKAI;4766170132;Ne;0;0;1;1
9893;Šypsena;SKRUZDELIUKAI;7569495879;Ne;12;1;0;13
9894;Šypsena;SKRUZDELIUKAI;6832433711;Ne;0;5;0;5
9895;Šypsena;SKRUZDELIUKAI;2248628927;Ne;0;21;0;21
9896;Šypsena;SKRUZDELIUKAI;1796837022;Ne;0;0;3;3
9897;Šypsena;SKRUZDELIUKAI;3063226692;Ne;0;0;2;2
9898;Šypsena;SKRUZDELIUKAI;5985974927;Ne;0;7;0;7
9899;Šypsena;SKRUZDELIUKAI;1795366502;Ne;0;13;0;13
9900;Šypsena;SKRUZDELIUKAI;1669768648;Ne;1;0;2;3
9901;Šypsena;SKRUZDELIUKAI;1575413188;Ne;0;3;0;3
9902;Šypsena;SKRUZDELIUKAI;2005543016;Ne;4;0;2;6
9903;Šypsena;SKRUZDELIUKAI;5568502083;Ne;0;8;0;8
9904;Šypsena;Bitutės;5642959574;Ne;0;2;0;2
9905;Šypsena;Bitutės;46569341613;Taip;5;0;0;5
9906;Šypsena;Bitutės;7538681006;Taip;6;0;0;6
9907;Šypsena;Bitutės;42130115068;Taip;7;0;0;7
9908;Šypsena;Bitutės;1712017606;Ne;0;6;0;6
9909;Šypsena;Bitutės;76332370575;Taip;1;0;0;1
9910;Šypsena;Bitutės;1906529989;Taip;0;3;0;3
9911;Šypsena;Bitutės;2099216049;Taip;0;2;0;2
9912;Šypsena;Bitutės;89503728819;Ne;0;5;0;5
9913;Šypsena;Bitutės;1387130727;Taip;7;0;2;9
9914;Šypsena;Bitutės;3025437080;Ne;0;0;1;1
9915;Šypsena;Bitutės;1133113196;Ne;4;1;0;5
9916;Šypsena;MEŠKIUKAI;1369906621;Taip;0;0;3;3
9917;Šypsena;MEŠKIUKAI;9363618080;Ne;2;0;0;2
9918;Šypsena;MEŠKIUKAI;1431850136;Ne;0;3;0;3
9919;Šypsena;MEŠKIUKAI;3724645162;Ne;5;0;0;5
9920;Šypsena;MEŠKIUKAI;5455997139;Taip;5;0;6;11
9921;Šypsena;MEŠKIUKAI;2900195046;Ne;5;0;0;5
9922;Šypsena;MEŠKIUKAI;3663446767;Ne;10;4;0;14
9923;Šypsena;MEŠKIUKAI;2182189246;Ne;10;0;1;11
9924;Šypsena;MEŠKIUKAI;5142969776;Ne;14;0;0;14
9925;Šypsena;MEŠKIUKAI;7332307199;Taip;0;7;0;7
9926;Šypsena;MEŠKIUKAI;8439694239;Ne;5;3;0;8
9927;Šypsena;MEŠKIUKAI;3733757483;Ne;6;0;0;6
9928;Šypsena;MEŠKIUKAI;3003901966;Ne;4;0;0;4
9929;Šypsena;MEŠKIUKAI;6377979434;Ne;15;1;0;16
9930;Šypsena;MEŠKIUKAI;9862387726;Ne;10;0;1;11
9931;Šypsena;BORUŽĖLĖS;4496704989;Ne;5;0;0;5
9932;Šypsena;BORUŽĖLĖS;8913058656;Taip;0;0;1;1
9933;Šypsena;BORUŽĖLĖS;9465174636;Ne;0;1;0;1
9934;Šypsena;BORUŽĖLĖS;3752358694;Taip;3;0;2;5
9935;Šypsena;BORUŽĖLĖS;4154737541;Ne;15;0;1;16
9936;Šypsena;BORUŽĖLĖS;6724776618;Ne;9;0;2;11
9937;Šypsena;BORUŽĖLĖS;5818211923;Ne;0;0;3;3
9938;Šypsena;BORUŽĖLĖS;4159654434;Taip;4;0;0;4
9939;Šypsena;BORUŽĖLĖS;2332065937;Ne;7;0;0;7
9940;Šypsena;BORUŽĖLĖS;7876871684;Taip;0;0;1;1
9941;Šypsena;BORUŽĖLĖS;1716274053;Ne;1;0;0;1
9942;Šypsena;BORUŽĖLĖS;2790906806;Ne;7;0;0;7
9943;Šypsena;BORUŽĖLĖS;7071209465;Taip;3;1;0;4
9944;Šnekutis;DRUGELIŲ;1159232792;Taip;13;0;0;13
9945;Šnekutis;DRUGELIŲ;2092637040;Taip;0;0;7;7
9946;Šnekutis;DRUGELIŲ;5029631107;Taip;0;0;1;1
9947;Šnekutis;DRUGELIŲ;9051956302;Ne;0;0;10;10
9948;Šnekutis;DRUGELIŲ;4498965991;Ne;5;0;1;6
9949;Šnekutis;DRUGELIŲ;7307895397;Ne;0;0;1;1
9950;Šnekutis;DRUGELIŲ;9131937590;Taip;17;0;0;17
9951;Šnekutis;DRUGELIŲ;2779793970;Taip;8;0;0;8
9952;Šnekutis;DRUGELIŲ;6093788163;Taip;0;0;8;8
9953;Šnekutis;DRUGELIŲ;7514753023;Taip;12;0;0;12
9954;Šnekutis;DRUGELIŲ;54532738133;Taip;21;0;0;21
9955;Šnekutis;DRUGELIŲ;79174984189;Taip;6;0;0;6
9956;Šnekutis;DRUGELIŲ;2876837284;Ne;0;0;2;2
9957;Šnekutis;DRUGELIŲ;8458769051;Ne;0;4;0;4
9958;Šnekutis;Kačiukų;3281475303;Taip;1;0;0;1
9959;Šnekutis;Kačiukų;8531521901;Taip;0;21;0;21
9960;Šnekutis;Kačiukų;9670205249;Ne;1;0;3;4
9961;Šnekutis;Kačiukų;7615716438;Taip;0;7;0;7
9962;Šnekutis;Kačiukų;3271262071;Taip;15;0;0;15
9963;Šnekutis;Kačiukų;3166309530;Taip;0;1;3;4
9964;Šnekutis;Kačiukų;5049964996;Taip;8;2;0;10
9965;Šnekutis;Kačiukų;9312935803;Taip;5;0;11;16
9966;Šnekutis;Kačiukų;7236658561;Taip;0;0;2;2
9967;Šnekutis;Kačiukų;4992188525;Ne;20;0;0;20
9968;Šnekutis;Kačiukų;7638626055;Taip;0;0;5;5
9969;Šnekutis;Kačiukų;9157136735;Taip;9;0;0;9
9970;Šnekutis;Kačiukų;4920263429;Taip;5;6;0;11
9971;Šnekutis;Kačiukų;5909584565;Taip;10;0;0;10
9972;Šnekutis;Kačiukų;6234943180;Taip;10;0;0;10
9973;Šnekutis;Kačiukų;2914145045;Ne;13;0;0;13
9974;Šnekutis;Kačiukų;8340697546;Taip;5;0;1;6
9975;Šnekutis;Kačiukų;9896249776;Taip;6;0;0;6
9976;Šnekutis;Pėlėdžiukų;5188035949;Taip;0;1;0;1
9977;Šnekutis;Pėlėdžiukų;77534335117;Taip;0;16;2;18
9978;Šnekutis;Pėlėdžiukų;3312928478;Taip;6;0;0;6
9979;Šnekutis;Pėlėdžiukų;8866360301;Taip;0;0;1;1
9980;Šnekutis;Pėlėdžiukų;8745465796;Ne;0;0;20;20
9981;Šnekutis;Pėlėdžiukų;3170928052;Taip;0;0;2;2
9982;Šnekutis;Pėlėdžiukų;3578045341;Taip;4;1;1;6
9983;Šnekutis;Pėlėdžiukų;5117544317;Taip;0;0;2;2
9984;Šnekutis;Pėlėdžiukų;1507200600;Taip;0;0;1;1
9985;Šnekutis;Pėlėdžiukų;5615869149;Ne;10;3;0;13
9986;Šnekutis;Pėlėdžiukų;1329958641;Taip;0;0;6;6
9987;Šnekutis;Pėlėdžiukų;9511116249;Taip;6;0;2;8
9988;Šnekutis;Pėlėdžiukų;1369660223;Taip;0;0;2;2
9989;Šnekutis;Pėlėdžiukų;1682748852;Ne;15;0;1;16
9990;Šnekutis;Boružėlių;4835202527;Ne;0;3;0;3
9991;Šnekutis;Boružėlių;9326455786;Ne;6;0;0;6
9992;Šnekutis;Boružėlių;6081100604;Ne;1;0;1;2
9993;Šnekutis;Boružėlių;7089000987;Ne;9;0;0;9
9994;Šnekutis;Boružėlių;2843483435;Ne;8;0;0;8
9995;Šnekutis;Boružėlių;5906320006;Ne;2;0;0;2
9996;Šnekutis;Boružėlių;6405894763;Ne;0;5;0;5
9997;Šnekutis;Boružėlių;3889176018;Ne;0;0;1;1
9998;Šnekutis;Boružėlių;6749848086;Ne;4;0;0;4
9999;Šnekutis;Boružėlių;6544973632;Ne;0;6;0;6
10000;Šnekutis;Boružėlių;6146988521;Taip;0;7;0;7
10001;Šnekutis;Boružėlių;3628210526;Ne;3;0;0;3
10002;Šnekutis;Boružėlių;7344776758;Ne;5;0;1;6
10003;Šnekutis;Boružėlių;9956077693;Ne;3;0;0;3
10004;Šnekutis;Boružėlių;5970951526;Ne;2;0;0;2
10005;Šnekutis;Boružėlių;3344425033;Ne;6;0;3;9
10006;Šnekutis;Meškučių;3136349573;Taip;0;21;0;21
10007;Šnekutis;Meškučių;7680962037;Taip;4;0;3;7
10008;Šnekutis;Meškučių;3096125224;Taip;0;11;0;11
10009;Šnekutis;Meškučių;7089148766;Taip;17;0;0;17
10010;Šnekutis;Meškučių;6306269165;Taip;2;5;0;7
10011;Šnekutis;Meškučių;2626247219;Taip;12;0;0;12
10012;Šnekutis;Meškučių;9543014297;Taip;5;0;1;6
10013;Šnekutis;Meškučių;3386995244;Taip;4;0;0;4
10014;Šnekutis;Meškučių;2131948397;Taip;0;12;0;12
10015;Šnekutis;Meškučių;8984597121;Taip;14;0;0;14
10016;Šnekutis;Meškučių;8810371475;Taip;0;0;3;3
10017;Šnekutis;Meškučių;9004568476;Taip;17;0;0;17
10018;Šnekutis;Viščiukų;8219465079;Taip;12;0;2;14
10019;Šnekutis;Viščiukų;1504945841;Taip;0;10;0;10
10020;Šnekutis;Viščiukų;6071004512;Taip;12;0;0;12
10021;Šnekutis;Viščiukų;4204642378;Taip;0;0;2;2
10022;Šnekutis;Viščiukų;8209686459;Taip;7;0;2;9
10023;Šnekutis;Viščiukų;4380966487;Taip;5;0;1;6
10024;Šnekutis;Viščiukų;8570372260;Taip;0;3;2;5
10025;Šnekutis;Viščiukų;3611064172;Taip;8;0;0;8
10026;Šnekutis;Viščiukų;9790241725;Taip;9;0;5;14
10027;Šnekutis;Viščiukų;2179736991;Taip;10;0;0;10
10028;Šnekutis;Viščiukų;1556960616;Taip;0;0;1;1
10029;Šnekutis;Viščiukų;8076487157;Taip;0;0;3;3
10030;Šnekutis;Viščiukų;6330033887;Taip;15;0;0;15
10031;Užupiukas;VYTURĖLIŲ;2922487622;Ne;11;0;0;11
10032;Užupiukas;VYTURĖLIŲ;5116564840;Taip;0;0;1;1
10033;Užupiukas;VYTURĖLIŲ;3861173268;Taip;0;6;10;16
10034;Užupiukas;VYTURĖLIŲ;7443013255;Ne;0;0;3;3
10035;Užupiukas;VYTURĖLIŲ;3656400244;Taip;0;7;3;10
10036;Užupiukas;VYTURĖLIŲ;3829013911;Taip;0;0;12;12
10037;Užupiukas;VYTURĖLIŲ;9212428150;Taip;0;0;3;3
10038;Užupiukas;VYTURĖLIŲ;8549733697;Taip;8;0;0;8
10039;Užupiukas;VYTURĖLIŲ;8001099421;Ne;16;0;0;16
10040;Užupiukas;VYTURĖLIŲ;1391826582;Ne;3;0;2;5
10041;Užupiukas;VYTURĖLIŲ;5021163099;Taip;0;0;7;7
10042;Užupiukas;VYTURĖLIŲ;6699322898;Taip;12;5;1;18
10043;Užupiukas;VYTURĖLIŲ;8960813016;Ne;0;5;2;7
10044;Užupiukas;VYTURĖLIŲ;9132605734;Taip;8;0;0;8
10045;Užupiukas;VYTURĖLIŲ;8245876832;Ne;5;0;1;6
10046;Užupiukas;VYTURĖLIŲ;6406285034;Taip;0;6;15;21
10047;Užupiukas;VYTURĖLIŲ;7532497390;Taip;1;10;0;11
10048;Užupiukas;VYTURĖLIŲ;5168946019;Taip;0;0;3;3
10049;Užupiukas;VYTURĖLIŲ;5718382826;Ne;0;0;7;7
10050;Užupiukas;VYTURĖLIŲ;9209209113;Ne;0;0;3;3
10051;Užupiukas;VYTURĖLIŲ;9070732925;Taip;0;1;0;1
10052;Užupiukas;KAČIUKŲ;3905448176;Ne;0;0;1;1
10053;Užupiukas;KAČIUKŲ;3567963511;Ne;0;0;2;2
10054;Užupiukas;KAČIUKŲ;9991552624;Ne;0;0;1;1
10055;Užupiukas;KAČIUKŲ;3080668107;Taip;0;7;1;8
10056;Užupiukas;KAČIUKŲ;1809036046;Ne;0;5;3;8
10057;Užupiukas;KAČIUKŲ;1102468034;Ne;0;0;2;2
10058;Užupiukas;KAČIUKŲ;1464016943;Taip;0;0;1;1
10059;Užupiukas;KAČIUKŲ;4485435274;Ne;10;0;0;10
10060;Užupiukas;KAČIUKŲ;2931958829;Taip;0;0;2;2
10061;Užupiukas;KAČIUKŲ;1102293237;Taip;0;0;4;4
10062;Užupiukas;KAČIUKŲ;9386211193;Ne;0;0;1;1
10063;Užupiukas;KAČIUKŲ;1388346927;Ne;0;2;0;2
10064;Užupiukas;KAČIUKŲ;7574528186;Taip;0;11;0;11
10065;Užupiukas;KAČIUKŲ;7092857844;Taip;0;0;1;1
10066;Užupiukas;KAČIUKŲ;2606742144;Ne;0;0;4;4
10067;Užupiukas;DRUGELIŲ;3579499796;Ne;0;0;2;2
10068;Užupiukas;DRUGELIŲ;5406866873;Taip;11;1;0;12
10069;Užupiukas;DRUGELIŲ;9655636851;Ne;0;0;2;2
10070;Užupiukas;DRUGELIŲ;9863097416;Ne;6;0;0;6
10071;Užupiukas;DRUGELIŲ;7298322865;Taip;19;0;0;19
10072;Užupiukas;DRUGELIŲ;8734960045;Ne;5;0;1;6
10073;Užupiukas;DRUGELIŲ;8724566014;Ne;5;0;6;11
10074;Užupiukas;DRUGELIŲ;3298267311;Ne;0;4;0;4
10075;Užupiukas;DRUGELIŲ;8341598147;Ne;6;5;2;13
10076;Užupiukas;DRUGELIŲ;9782972949;Ne;0;0;2;2
10077;Užupiukas;DRUGELIŲ;2348243399;Ne;4;0;1;5
10078;Užupiukas;DRUGELIŲ;8870229834;Ne;7;2;0;9
10079;Užupiukas;DRUGELIŲ;1679324943;Ne;0;4;0;4
10080;Užupiukas;DRUGELIŲ;1772019951;Ne;6;0;3;9
10081;Užupiukas;DRUGELIŲ;9617597828;Ne;4;0;3;7
10082;Užupiukas;DRUGELIŲ;1554333137;Ne;0;0;20;20
10083;Užupiukas;DRUGELIŲ;3231001225;Ne;11;1;0;12
10084;Užupiukas;DRUGELIŲ;3958071677;Ne;10;0;6;16
10085;Užupiukas;DRUGELIŲ;9723966502;Ne;0;0;6;6
10086;Užupiukas;DRUGELIŲ;8915159672;Taip;0;1;0;1
10087;Užupiukas;EŽIUKŲ;1526296386;Ne;10;0;3;13
10088;Užupiukas;EŽIUKŲ;9774124589;Ne;5;6;0;11
10089;Užupiukas;EŽIUKŲ;1718518621;Taip;0;0;2;2
10090;Užupiukas;EŽIUKŲ;2724216446;Taip;0;10;0;10
10091;Užupiukas;EŽIUKŲ;9446562736;Ne;0;0;6;6
10092;Užupiukas;EŽIUKŲ;5072363435;Taip;0;0;6;6
10093;Užupiukas;EŽIUKŲ;1651249962;Ne;0;0;2;2
10094;Užupiukas;EŽIUKŲ;1100574872;Ne;3;4;2;9
10095;Užupiukas;EŽIUKŲ;6531734067;Ne;10;1;0;11
10096;Užupiukas;EŽIUKŲ;5204808398;Taip;0;0;1;1
10097;Užupiukas;EŽIUKŲ;3171528288;Ne;3;0;4;7
10098;Užupiukas;EŽIUKŲ;7860601571;Taip;0;0;6;6
10099;Užupiukas;EŽIUKŲ;3611922301;Ne;7;0;0;7
10100;Užupiukas;EŽIUKŲ;8020138690;Ne;7;0;0;7
10101;Užupiukas;EŽIUKŲ;1624805701;Ne;17;0;1;18
10102;Užupiukas;EŽIUKŲ;6823724962;Taip;17;0;0;17
10103;Užupiukas;EŽIUKŲ;6370918943;Ne;0;0;2;2
10104;Užupiukas;EŽIUKŲ;9357101972;Ne;0;0;1;1
10105;Užupiukas;BORUŽĖLIŲ;4781598862;Ne;0;0;1;1
10106;Užupiukas;BORUŽĖLIŲ;7861121290;Ne;0;0;2;2
10107;Užupiukas;BORUŽĖLIŲ;6526550727;Ne;5;0;4;9
10108;Užupiukas;BORUŽĖLIŲ;9735462228;Ne;3;0;1;4
10109;Užupiukas;BORUŽĖLIŲ;1582921323;Taip;0;0;1;1
10110;Užupiukas;BORUŽĖLIŲ;6828175620;Ne;0;4;1;5
10111;Užupiukas;BORUŽĖLIŲ;9791681813;Ne;4;0;4;8
10112;Užupiukas;BORUŽĖLIŲ;1503714343;Ne;3;0;1;4
10113;Užupiukas;BORUŽĖLIŲ;8313812681;Ne;7;0;0;7
10114;Užupiukas;BORUŽĖLIŲ;9906475253;Ne;10;0;4;14
10115;Užupiukas;BORUŽĖLIŲ;9677572224;Ne;6;0;0;6
10116;Užupiukas;BORUŽĖLIŲ;2445335267;Ne;0;0;1;1
10117;Užupiukas;BORUŽĖLIŲ;1514268763;Ne;0;0;1;1
10118;Užupiukas;BORUŽĖLIŲ;7555702944;Ne;0;0;2;2
10119;Užupiukas;BORUŽĖLIŲ;2307600884;Ne;0;0;2;2
10120;Užupiukas;BORUŽĖLIŲ;6073039842;Ne;0;0;9;9
10121;Užupiukas;BORUŽĖLIŲ;6601099182;Ne;0;0;21;21
10122;Užupiukas;BORUŽĖLIŲ;3940264504;Ne;0;10;0;10
10123;Užupiukas;BORUŽĖLIŲ;2704243085;Ne;3;0;1;4
10124;Užupiukas;SPINDULIUKŲ;87017671664;Ne;0;0;13;13
10125;Užupiukas;SPINDULIUKŲ;55683021710;Ne;0;0;3;3
10126;Užupiukas;SPINDULIUKŲ;10681040398;Ne;0;0;2;2
10127;Užupiukas;SPINDULIUKŲ;1158250810;Ne;0;0;3;3
10128;Užupiukas;SPINDULIUKŲ;1577630991;Ne;0;0;17;17
10129;Užupiukas;SPINDULIUKŲ;36820708170;Ne;0;0;7;7
10130;Užupiukas;SPINDULIUKŲ;64774033504;Ne;0;0;6;6
10131;Užupiukas;SPINDULIUKŲ;1656658765;Ne;0;0;2;2
10132;Užupiukas;SPINDULIUKŲ;10522364665;Ne;0;0;2;2
10133;Užupiukas;SPINDULIUKŲ;2499414724;Ne;0;0;2;2
10134;Užupiukas;SPINDULIUKŲ;89338828452;Ne;0;0;2;2
10135;Užupiukas;SPINDULIUKŲ;48886679788;Ne;5;0;1;6
10136;Užupiukas;SPINDULIUKŲ;1592276956;Ne;0;0;2;2
10137;Užupiukas;SPINDULIUKŲ;2574149268;Ne;0;0;4;4
10138;Užupiukas;SPINDULIUKŲ;1307564992;Ne;0;0;5;5
10139;Užupiukas;SPINDULIUKŲ;15815468617;Ne;6;0;1;7
10140;Užupiukas;SPINDULIUKŲ;52600923918;Ne;0;0;2;2
10141;Užupiukas;SPINDULIUKŲ;2740412091;Ne;10;0;0;10
10142;Užupiukas;SPINDULIUKŲ;6169887781;Ne;8;0;0;8
10143;Užupiukas;ŽVIRBLIUKŲ;8519118225;Ne;13;0;1;14
10144;Užupiukas;ŽVIRBLIUKŲ;7549628277;Taip;14;0;0;14
10145;Užupiukas;ŽVIRBLIUKŲ;5085660507;Taip;0;5;3;8
10146;Užupiukas;ŽVIRBLIUKŲ;3528581949;Ne;0;0;14;14
10147;Užupiukas;ŽVIRBLIUKŲ;2273766308;Ne;0;0;3;3
10148;Užupiukas;ŽVIRBLIUKŲ;7530856195;Taip;8;0;1;9
10149;Užupiukas;ŽVIRBLIUKŲ;9925592494;Taip;21;0;0;21
10150;Užupiukas;ŽVIRBLIUKŲ;7345579721;Taip;0;5;5;10
10151;Užupiukas;ŽVIRBLIUKŲ;4710910251;Taip;0;5;2;7
10152;Užupiukas;ŽVIRBLIUKŲ;9428884149;Taip;0;0;12;12
10153;Užupiukas;ŽVIRBLIUKŲ;4054724625;Ne;0;0;6;6
10154;Užupiukas;ŽVIRBLIUKŲ;2210437775;Ne;6;0;1;7
10155;Užupiukas;ŽVIRBLIUKŲ;1995228207;Taip;3;0;5;8
10156;Užupiukas;ŽVIRBLIUKŲ;1496541880;Taip;9;0;9;18
10157;Užupiukas;ŽVIRBLIUKŲ;1684901495;Taip;5;0;4;9
10158;Užupiukas;ŽVIRBLIUKŲ;2390955083;Taip;0;0;1;1
10159;Užupiukas;ŽVIRBLIUKŲ;6001766518;Taip;8;0;6;14
10160;Užupiukas;ŽVIRBLIUKŲ;3768945773;Ne;3;0;0;3
10161;Užupiukas;ŽVIRBLIUKŲ;3224193396;Ne;0;0;1;1
10162;Užupiukas;ŽVIRBLIUKŲ;1843171673;Ne;5;0;6;11
10163;Užupiukas;ŽVIRBLIUKŲ;6308141378;Ne;3;1;0;4
10164;Užupiukas;PELĖDŽIUKŲ;2938276316;Ne;0;0;2;2
10165;Užupiukas;PELĖDŽIUKŲ;5320544400;Ne;0;4;2;6
10166;Užupiukas;PELĖDŽIUKŲ;40704768956;Ne;0;0;1;1
10167;Užupiukas;PELĖDŽIUKŲ;5665323444;Ne;11;0;10;21
10168;Užupiukas;PELĖDŽIUKŲ;4880828482;Ne;3;0;0;3
10169;Užupiukas;PELĖDŽIUKŲ;6478702476;Ne;0;0;5;5
10170;Užupiukas;PELĖDŽIUKŲ;6110869303;Ne;0;0;6;6
10171;Užupiukas;PELĖDŽIUKŲ;3205769002;Taip;7;0;0;7
10172;Užupiukas;PELĖDŽIUKŲ;4247280316;Ne;0;0;1;1
10173;Užupiukas;PELĖDŽIUKŲ;4608233152;Ne;9;0;0;9
10174;Užupiukas;PELĖDŽIUKŲ;5498369850;Ne;3;0;5;8
10175;Užupiukas;PELĖDŽIUKŲ;2821350355;Ne;0;0;5;5
10176;Užupiukas;PELĖDŽIUKŲ;7563497568;Ne;0;0;2;2
10177;Užupiukas;PELĖDŽIUKŲ;3309195572;Ne;13;0;1;14
10178;Užupiukas;PELĖDŽIUKŲ;4132760111;Ne;8;0;1;9
10179;Užupiukas;PELĖDŽIUKŲ;22401995674;Ne;0;0;1;1
10180;Užupiukas;PELĖDŽIUKŲ;53412835151;Ne;0;3;0;3
10181;Užupiukas;PELĖDŽIUKŲ;3774364829;Ne;5;0;1;6
10182;Užupiukas;PELĖDŽIUKŲ;9197242545;Ne;5;0;1;6
10183;Užupiukas;PELĖDŽIUKŲ;5357731534;Ne;0;0;4;4
10184;Užupiukas;PELĖDŽIUKŲ;5046355276;Ne;0;4;2;6
10185;Užupiukas;VARPELIŲ;6790700398;Ne;0;1;0;1
10186;Užupiukas;VARPELIŲ;23723147269;Ne;0;0;3;3
10187;Užupiukas;VARPELIŲ;7874627355;Ne;0;0;10;10
10188;Užupiukas;VARPELIŲ;51243697666;Ne;4;0;0;4
10189;Užupiukas;VARPELIŲ;17651645880;Ne;2;0;1;3
10190;Užupiukas;VARPELIŲ;98428714407;Ne;0;0;2;2
10191;Užupiukas;VARPELIŲ;5079596604;Ne;0;0;3;3
10192;Užupiukas;VARPELIŲ;2031306814;Ne;3;0;1;4
10193;Užupiukas;VARPELIŲ;79092366287;Ne;0;0;4;4
10194;Užupiukas;VARPELIŲ;8358242714;Ne;0;0;7;7
10195;Užupiukas;VARPELIŲ;81986379983;Ne;0;0;4;4
10196;Užupiukas;VARPELIŲ;77950386276;Ne;0;0;9;9
10197;Užupiukas;VARPELIŲ;6274937037;Ne;0;8;1;9
10198;Užupiukas;VARPELIŲ;54626391009;Ne;0;0;1;1
10199;Užupiukas;VARPELIŲ;3079228156;Ne;6;0;2;8
10200;Užupiukas;VARPELIŲ;8454703111;Taip;4;0;3;7
10201;Užupiukas;SAULUČIŲ;5704945892;Ne;2;0;1;3
10202;Užupiukas;SAULUČIŲ;1406418130;Taip;0;0;1;1
10203;Užupiukas;SAULUČIŲ;2681679016;Ne;13;0;1;14
10204;Užupiukas;SAULUČIŲ;3684774901;Ne;7;0;0;7
10205;Užupiukas;SAULUČIŲ;8163092636;Ne;0;0;7;7
10206;Užupiukas;SAULUČIŲ;1976775494;Ne;7;0;1;8
10207;Užupiukas;SAULUČIŲ;5874450724;Ne;0;0;4;4
10208;Užupiukas;SAULUČIŲ;3341292382;Taip;0;0;3;3
10209;Užupiukas;SAULUČIŲ;2211595125;Ne;4;0;0;4
10210;Užupiukas;SAULUČIŲ;7450368045;Ne;15;0;0;15
10211;Užupiukas;SAULUČIŲ;5570569874;Ne;0;0;5;5
10212;Užupiukas;SAULUČIŲ;7643286183;Ne;0;0;4;4
10213;Užupiukas;SAULUČIŲ;2814556305;Ne;7;0;0;7
10214;Užupiukas;SAULUČIŲ;7209853233;Ne;0;15;6;21
10215;Užupiukas;SAULUČIŲ;9953994943;Ne;16;0;0;16
10216;Užupiukas;SAULUČIŲ;7956550754;Ne;0;0;3;3
10217;Užupiukas;SAULUČIŲ;5469735455;Ne;0;0;3;3
10218;Užupiukas;SAULUČIŲ;8489545569;Ne;0;0;5;5
10219;Užupiukas;LAPIUKŲ;9833934299;Ne;0;0;2;2
10220;Užupiukas;LAPIUKŲ;4963679583;Ne;10;5;4;19
10221;Užupiukas;LAPIUKŲ;2679915982;Ne;12;0;1;13
10222;Užupiukas;LAPIUKŲ;6004467875;Ne;0;0;6;6
10223;Užupiukas;LAPIUKŲ;1718048938;Ne;0;0;4;4
10224;Užupiukas;LAPIUKŲ;7986962850;Ne;6;2;0;8
10225;Užupiukas;LAPIUKŲ;7487174943;Ne;0;3;1;4
10226;Užupiukas;LAPIUKŲ;5680350014;Taip;0;2;0;2
10227;Užupiukas;LAPIUKŲ;7161001771;Ne;0;0;1;1
10228;Užupiukas;LAPIUKŲ;1886792898;Ne;0;0;1;1
10229;Užupiukas;LAPIUKŲ;6967184410;Ne;0;0;2;2
10230;Užupiukas;LAPIUKŲ;4900699267;Ne;4;0;0;4
10231;Užupiukas;LAPIUKŲ;1178152392;Ne;7;0;0;7
10232;Užupiukas;LAPIUKŲ;7029091978;Ne;0;1;2;3
10233;Užupiukas;LAPIUKŲ;3311694266;Ne;4;0;0;4
10234;Užupiukas;NYKŠTUKŲ;1041972540;Ne;0;0;8;8
10235;Užupiukas;NYKŠTUKŲ;4467470795;Ne;0;0;8;8
10236;Užupiukas;NYKŠTUKŲ;4521227949;Ne;10;0;0;10
10237;Užupiukas;NYKŠTUKŲ;4811619739;Ne;0;1;2;3
10238;Užupiukas;NYKŠTUKŲ;3575209839;Ne;3;0;3;6
10239;Užupiukas;NYKŠTUKŲ;9216626936;Taip;0;0;1;1
10240;Užupiukas;NYKŠTUKŲ;5941280824;Ne;20;0;0;20
10241;Užupiukas;NYKŠTUKŲ;7919242126;Ne;0;0;1;1
10242;Užupiukas;NYKŠTUKŲ;2767523129;Ne;0;0;3;3
10243;Užupiukas;NYKŠTUKŲ;9310238442;Ne;0;0;7;7
10244;Užupiukas;NYKŠTUKŲ;2485426055;Taip;13;0;0;13
10245;Užupiukas;NYKŠTUKŲ;4106614478;Taip;0;5;2;7
10246;Užupiukas;NYKŠTUKŲ;1407429980;Taip;5;0;0;5
10247;Užupiukas;NYKŠTUKŲ;7837545732;Taip;3;0;1;4
10248;Užupiukas;NYKŠTUKŲ;7314085267;Taip;0;0;3;3
10249;Užupiukas;NYKŠTUKŲ;8252575784;Taip;0;0;9;9
10250;Užupiukas;NYKŠTUKŲ;7105857162;Ne;0;0;5;5
10251;Vaidilutė;Žiogelis;3220471656;Taip;0;1;1;2
10252;Vaidilutė;Žiogelis;17497609539;Taip;0;5;0;5
10253;Vaidilutė;Žiogelis;44867291232;Taip;0;0;1;1
10254;Vaidilutė;Žiogelis;1405802722;Taip;3;0;0;3
10255;Vaidilutė;Žiogelis;8543285470;Taip;16;0;3;19
10256;Vaidilutė;Žiogelis;76613866916;Taip;4;0;0;4
10257;Vaidilutė;Žiogelis;38698526742;Ne;0;0;1;1
10258;Vaidilutė;Žiogelis;3243266869;Taip;0;0;5;5
10259;Vaidilutė;Žiogelis;8715414719;Ne;0;0;2;2
10260;Vaidilutė;Žiogelis;83887347923;Taip;10;0;6;16
10261;Vaidilutė;Žiogelis;3962268551;Taip;0;0;11;11
10262;Vaidilutė;Žiogelis;1942402815;Ne;2;1;2;5
10263;Vaidilutė;Žiogelis;69452750985;Taip;0;0;1;1
10264;Vaidilutė;Žiogelis;67830476121;Taip;6;0;2;8
10265;Vaidilutė;Žiogelis;87621682081;Taip;0;1;2;3
10266;Vaidilutė;Žiogelis;1608286003;Taip;0;0;3;3
10267;Vaidilutė;Žiogelis;1664595920;Taip;7;0;0;7
10268;Vaidilutė;Žiogelis;19413698194;Taip;0;0;1;1
10269;Vaidilutė;Žiogelis;1083096707;Ne;2;0;0;2
10270;Vaidilutė;Rūtelė;8789527552;Taip;0;5;0;5
10271;Vaidilutė;Rūtelė;7319037375;Taip;0;0;3;3
10272;Vaidilutė;Rūtelė;7494818866;Taip;0;0;1;1
10273;Vaidilutė;Rūtelė;5500950179;Taip;12;0;0;12
10274;Vaidilutė;Rūtelė;9563257771;Taip;0;0;1;1
10275;Vaidilutė;Rūtelė;9652684068;Taip;0;0;6;6
10276;Vaidilutė;Rūtelė;2024078532;Taip;4;0;0;4
10277;Vaidilutė;Rūtelė;5482030284;Taip;0;0;2;2
10278;Vaidilutė;Rūtelė;8505156287;Taip;0;0;1;1
10279;Vaidilutė;Rūtelė;9568450630;Taip;6;4;0;10
10280;Vaidilutė;Rūtelė;7306768961;Taip;0;0;2;2
10281;Vaidilutė;Rūtelė;7532115462;Taip;0;5;6;11
10282;Vaidilutė;Rūtelė;6896047075;Taip;6;0;0;6
10283;Vaidilutė;Rūtelė;3059654988;Taip;0;0;8;8
10284;Vaidilutė;Rūtelė;1341696594;Taip;0;0;2;2
10285;Vaidilutė;Rūtelė;1141947715;Taip;1;0;0;1
10286;Vaidilutė;Voveraitė;1993403692;Taip;0;0;3;3
10287;Vaidilutė;Voveraitė;9948685221;Taip;0;0;6;6
10288;Vaidilutė;Voveraitė;9869134464;Taip;0;2;2;4
10289;Vaidilutė;Voveraitė;29153363263;Taip;5;0;0;5
10290;Vaidilutė;Voveraitė;3069613102;Ne;0;0;1;1
10291;Vaidilutė;Voveraitė;5177060346;Ne;5;0;2;7
10292;Vaidilutė;Voveraitė;19402768340;Taip;0;8;0;8
10293;Vaidilutė;Voveraitė;4671287016;Ne;0;0;5;5
10294;Vaidilutė;Voveraitė;3600181974;Taip;0;0;2;2
10295;Vaidilutė;Voveraitė;7419525100;Taip;0;0;4;4
10296;Vaidilutė;Voveraitė;1363913645;Ne;0;1;0;1
10297;Vaidilutė;Voveraitė;5252637701;Taip;0;1;0;1
10298;Vaidilutė;Voveraitė;1320999237;Taip;0;10;0;10
10299;Vaidilutė;Voveraitė;1704155743;Taip;5;0;0;5
10300;Vaidilutė;Voveraitė;1139332221;Taip;0;0;1;1
10301;Vaidilutė;Voveraitė;1297817018;Taip;0;0;2;2
10302;Vaidilutė;Voveraitė;9124975928;Taip;0;3;2;5
10303;Vaidilutė;Voveraitė;3202508790;Taip;7;0;4;11
10304;Vaidilutė;Voveraitė;1315347184;Taip;5;0;0;5
10305;Vaidilutė;Voveraitė;2346018814;Taip;2;0;0;2
10306;Vaidilutė;Saulutė;8492055287;Taip;5;0;3;8
10307;Vaidilutė;Saulutė;6844372910;Taip;15;0;0;15
10308;Vaidilutė;Saulutė;4972645715;Taip;0;0;15;15
10309;Vaidilutė;Saulutė;1355005114;Ne;0;0;9;9
10310;Vaidilutė;Saulutė;4680645841;Taip;1;0;2;3
10311;Vaidilutė;Saulutė;2662468804;Taip;6;0;3;9
10312;Vaidilutė;Saulutė;5217609332;Taip;0;1;2;3
10313;Vaidilutė;Saulutė;2864731541;Ne;7;1;1;9
10314;Vaidilutė;Saulutė;1998872078;Taip;0;0;6;6
10315;Vaidilutė;Saulutė;2468220275;Taip;0;0;8;8
10316;Vaidilutė;Saulutė;1610262589;Taip;6;0;3;9
10317;Vaidilutė;Saulutė;2356037175;Taip;5;6;1;12
10318;Vaidilutė;Saulutė;5054640268;Taip;0;0;1;1
10319;Vaidilutė;Saulutė;7826111890;Taip;5;0;1;6
10320;Vaidilutė;Saulutė;9870763434;Taip;0;2;3;5
10321;Vaidilutė;Saulutė;5945744595;Taip;10;10;0;20
10322;Vaidilutė;Saulutė;6674238265;Taip;5;0;1;6
10323;Vaidilutė;Saulutė;2495112045;Taip;13;0;0;13
10324;Vaidilutė;Žibutė;5686463470;Taip;0;1;3;4
10325;Vaidilutė;Žibutė;1430802591;Taip;0;1;1;2
10326;Vaidilutė;Žibutė;7843388119;Taip;0;2;0;2
10327;Vaidilutė;Žibutė;2041126370;Taip;0;1;0;1
10328;Vaidilutė;Žibutė;45949026707;Taip;5;1;0;6
10329;Vaidilutė;Žibutė;4259585225;Taip;0;1;2;3
10330;Vaidilutė;Žibutė;4334934114;Taip;5;1;0;6
10331;Vaidilutė;Žibutė;3152118407;Taip;6;0;0;6
10332;Vaidilutė;Žibutė;5203062837;Taip;0;0;2;2
10333;Vaidilutė;Žibutė;1266927367;Taip;0;1;0;1
10334;Vaidilutė;Žibutė;2941550026;Taip;0;1;0;1
10335;Vaidilutė;Žibutė;4362797606;Taip;4;0;0;4
10336;Vaidilutė;Žibutė;5620009051;Taip;5;0;0;5
10337;Vaidilutė;Žibutė;1853463568;Taip;0;0;1;1
10338;Vaidilutė;Žibutė;9556632708;Taip;0;11;0;11
10339;Vaidilutė;Žibutė;7779630805;Taip;0;1;0;1
10340;Vaidilutė;Žibutė;5991149222;Taip;10;0;2;12
10341;Vaidilutė;Žibutė;3112025222;Taip;10;0;0;10
10342;Vaidilutė;Žibutė;1786022030;Taip;15;0;0;15
10343;Vaidilutė;Žibutė;1667275889;Taip;6;0;2;8
10344;Vaidilutė;Žibutė;9876388990;Taip;0;6;0;6
10345;Vaidilutė;"Ąžuoliukas ";3463112472;Taip;8;0;1;9
10346;Vaidilutė;"Ąžuoliukas ";7028992022;Taip;5;0;8;13
10347;Vaidilutė;"Ąžuoliukas ";3730573432;Taip;0;0;3;3
10348;Vaidilutė;"Ąžuoliukas ";6586072228;Taip;0;0;1;1
10349;Vaidilutė;"Ąžuoliukas ";5988376676;Taip;4;0;4;8
10350;Vaidilutė;"Ąžuoliukas ";1305478052;Taip;10;0;1;11
10351;Vaidilutė;"Ąžuoliukas ";4954285515;Taip;8;0;1;9
10352;Vaidilutė;"Ąžuoliukas ";5439973183;Taip;9;0;0;9
10353;Vaidilutė;"Ąžuoliukas ";4761992071;Taip;6;0;1;7
10354;Vaidilutė;"Ąžuoliukas ";3381544575;Taip;5;0;1;6
10355;Vaidilutė;"Ąžuoliukas ";5307486959;Taip;0;0;6;6
10356;Vaidilutė;"Ąžuoliukas ";1653497170;Taip;0;0;6;6
10357;Vaidilutė;"Ąžuoliukas ";1440819171;Taip;10;0;1;11
10358;Vaidilutė;"Ąžuoliukas ";2668758195;Taip;0;0;1;1
10359;Vaidilutė;"Ąžuoliukas ";4901387311;Taip;8;0;3;11
10360;Vaidilutė;"Ąžuoliukas ";2997948252;Taip;0;10;1;11
10361;Vaidilutė;"Žemuogėlė ";96794583279;Taip;0;0;2;2
10362;Vaidilutė;"Žemuogėlė ";6758078068;Taip;0;5;0;5
10363;Vaidilutė;"Žemuogėlė ";48928174623;Taip;0;1;0;1
10364;Vaidilutė;"Žemuogėlė ";25071409492;Taip;11;0;4;15
10365;Vaidilutė;"Žemuogėlė ";94210720777;Taip;0;5;0;5
10366;Vaidilutė;"Žemuogėlė ";77020716708;Taip;0;1;0;1
10367;Vaidilutė;"Žemuogėlė ";5821467408;Taip;0;0;1;1
10368;Vaidilutė;"Žemuogėlė ";79694144428;Taip;0;0;3;3
10369;Vaidilutė;"Žemuogėlė ";70384916008;Taip;0;1;0;1
10370;Vaidilutė;"Žemuogėlė ";10737417556;Taip;0;1;0;1
10371;Vaidilutė;"Žemuogėlė ";83944413409;Ne;0;1;0;1
10372;Vaidilutė;"Žemuogėlė ";24445906930;Taip;0;0;1;1
10373;Vaidilutė;"Žemuogėlė ";79964507480;Taip;0;0;4;4
10374;Vaidilutė;"Žemuogėlė ";5116482125;Taip;0;1;0;1
10375;Vaidilutė;"Žemuogėlė ";34492341585;Taip;0;2;0;2
10376;Vaidilutė;"Žemuogėlė ";25654419755;Taip;0;6;6;12
10377;Vaidilutė;"Žemuogėlė ";79061542327;Taip;0;1;0;1
10378;Vaidilutė;"Žemuogėlė ";2067604305;Taip;0;0;16;16
10379;Vaidilutė;"Vyturėlis ";3121914268;Taip;12;0;0;12
10380;Vaidilutė;"Vyturėlis ";5050251048;Taip;11;0;0;11
10381;Vaidilutė;"Vyturėlis ";9558983004;Taip;2;0;0;2
10382;Vaidilutė;"Vyturėlis ";5326935037;Taip;5;1;2;8
10383;Vaidilutė;"Vyturėlis ";2189753894;Taip;0;5;0;5
10384;Vaidilutė;"Vyturėlis ";9689388330;Taip;0;4;0;4
10385;Vaidilutė;"Vyturėlis ";9584702487;Taip;0;1;1;2
10386;Vaidilutė;"Vyturėlis ";8882402632;Taip;0;2;0;2
10387;Vaidilutė;"Vyturėlis ";1539700521;Taip;0;5;1;6
10388;Vaidilutė;"Vyturėlis ";4230076320;Taip;2;0;0;2
10389;Vaidilutė;"Vyturėlis ";8628545847;Taip;0;0;10;10
10390;Vaidilutė;"Vyturėlis ";2058071219;Taip;6;0;3;9
10391;Vaidilutė;"Vyturėlis ";4388069915;Taip;0;2;1;3
10392;Vaidilutė;"Vyturėlis ";9577869269;Taip;0;0;1;1
10393;Vaidilutė;"Vyturėlis ";1401180999;Taip;0;0;3;3
10394;Vaidilutė;"Vyturėlis ";5651628204;Taip;10;0;1;11
10395;Vaidilutė;"Varpelis ";6250831269;Taip;6;0;2;8
10396;Vaidilutė;"Varpelis ";5276088687;Taip;0;0;2;2
10397;Vaidilutė;"Varpelis ";2763266518;Taip;0;0;1;1
10398;Vaidilutė;"Varpelis ";6037349527;Ne;6;0;2;8
10399;Vaidilutė;"Varpelis ";5867501558;Taip;0;5;3;8
10400;Vaidilutė;"Varpelis ";3832349858;Taip;5;0;1;6
10401;Vaidilutė;"Varpelis ";5448014291;Taip;0;0;1;1
10402;Vaidilutė;"Varpelis ";4280822951;Taip;0;0;5;5
10403;Vaidilutė;"Varpelis ";1385914020;Taip;0;0;3;3
10404;Vaidilutė;"Varpelis ";6107554047;Taip;0;0;1;1
10405;Vaidilutė;"Varpelis ";6022130248;Taip;0;1;2;3
10406;Vaidilutė;"Varpelis ";5101104226;Ne;0;3;1;4
10407;Vaidilutė;"Varpelis ";5594121340;Taip;0;7;0;7
10408;Vaidilutė;"Varpelis ";1882829340;Taip;0;0;1;1
10409;Vaidilutė;"Varpelis ";6097229427;Taip;0;0;1;1
10410;Vaidilutė;"Boružėlių ";9322080266;Taip;5;13;0;18
10411;Vaidilutė;"Boružėlių ";3087959868;Taip;9;0;0;9
10412;Vaidilutė;"Boružėlių ";7940581813;Taip;5;0;0;5
10413;Vaidilutė;"Boružėlių ";5236154349;Taip;4;0;0;4
10414;Vaidilutė;"Boružėlių ";4124217264;Taip;8;0;0;8
10415;Vaidilutė;"Boružėlių ";1362256314;Taip;6;0;0;6
10416;Vaidilutė;"Boružėlių ";5415279154;Taip;7;0;0;7
10417;Vaidilutė;"Boružėlių ";7429825620;Taip;9;0;0;9
10418;Vaidilutė;"Malūnelis ";8177787790;Taip;0;0;4;4
10419;Vaidilutė;"Malūnelis ";5855762068;Taip;5;1;0;6
10420;Vaidilutė;"Malūnelis ";7604740418;Taip;0;0;11;11
10421;Vaidilutė;"Malūnelis ";9429544108;Taip;11;0;0;11
10422;Vaidilutė;"Malūnelis ";2318578603;Taip;0;0;5;5
10423;Vaidilutė;"Malūnelis ";3634285869;Taip;12;0;0;12
10424;Vaidilutė;"Malūnelis ";3150642420;Taip;5;0;0;5
10425;Vaidilutė;"Malūnelis ";5652381296;Taip;0;0;2;2
10426;Vaidilutė;"Malūnelis ";3248203941;Taip;0;0;5;5
10427;Vaidilutė;"Malūnelis ";1608646909;Taip;0;1;0;1
10428;Vaidilutė;"Malūnelis ";9602005956;Taip;0;0;11;11
10429;Vaidilutė;"Riešutėlis ";3605988018;Taip;0;0;1;1
10430;Vaidilutė;"Riešutėlis ";1161455376;Taip;5;0;1;6
10431;Vaidilutė;"Riešutėlis ";4518002596;Taip;0;0;2;2
10432;Vaidilutė;"Riešutėlis ";4657952465;Taip;0;0;7;7
10433;Vaidilutė;"Riešutėlis ";8756807918;Taip;0;0;9;9
10434;Vaidilutė;"Riešutėlis ";9782176726;Taip;10;0;0;10
10435;Vaidilutė;"Riešutėlis ";1206696843;Taip;5;0;2;7
10436;Vaidilutė;"Riešutėlis ";9872915544;Taip;1;0;3;4
10437;Vaidilutė;"Riešutėlis ";9955285630;Taip;0;0;5;5
10438;Vaidilutė;"Riešutėlis ";2976615414;Ne;10;0;3;13
10439;Vaidilutė;"Riešutėlis ";4709977896;Taip;3;0;5;8
10440;Vaidilutė;"Riešutėlis ";2409760986;Taip;5;0;4;9
10441;Vaidilutė;"Riešutėlis ";4051575845;Taip;0;0;4;4
10442;Vaidilutė;"Riešutėlis ";9025469107;Taip;6;0;4;10
10443;Vaidilutė;"Riešutėlis ";3862444839;Taip;11;0;0;11
10444;Vaidilutė;"Riešutėlis ";9567786222;Taip;0;0;8;8
10445;Vaidilutė;"Riešutėlis ";3321127541;Taip;0;0;1;1
10446;Vaidilutė;"Riešutėlis ";7713772984;Taip;8;0;9;17
10447;Vandenis;ŽUVĖDRŲ;5362078687;Ne;0;2;0;2
10448;Vandenis;ŽUVĖDRŲ;2238926097;Taip;0;1;0;1
10449;Vandenis;ŽUVĖDRŲ;9334958945;Taip;10;0;0;10
10450;Vandenis;ŽUVĖDRŲ;7646133208;Taip;1;0;0;1
10451;Vandenis;ŽUVĖDRŲ;4303303483;Taip;5;0;0;5
10452;Vandenis;ŽUVĖDRŲ;2325465812;Taip;5;0;0;5
10453;Vandenis;ŽUVĖDRŲ;2649542586;Taip;0;3;0;3
10454;Vandenis;ŽUVĖDRŲ;1144490168;Taip;0;1;0;1
10455;Vandenis;ŽUVĖDRŲ;7948161881;Taip;0;0;1;1
10456;Vandenis;ŽUVĖDRŲ;9335319713;Taip;0;4;1;5
10457;Vandenis;ŽUVĖDRŲ;6068154206;Ne;9;2;1;12
10458;Vandenis;ŽUVĖDRŲ;7296608892;Taip;0;4;0;4
10459;Vandenis;ŽUVĖDRŲ;6063181697;Taip;7;0;0;7
10460;Vandenis;RUONIUKŲ;2422642232;Taip;5;4;2;11
10461;Vandenis;RUONIUKŲ;1051281257;Taip;5;4;2;11
10462;Vandenis;RUONIUKŲ;7565308536;Taip;7;4;0;11
10463;Vandenis;RUONIUKŲ;9518434896;Taip;7;1;0;8
10464;Vandenis;RUONIUKŲ;1120907086;Taip;5;0;3;8
10465;Vandenis;RUONIUKŲ;1563710105;Taip;6;0;1;7
10466;Vandenis;RUONIUKŲ;7702272913;Taip;10;2;0;12
10467;Vandenis;RUONIUKŲ;6476051751;Taip;8;1;0;9
10468;Vandenis;RUONIUKŲ;9162936403;Ne;0;11;0;11
10469;Vandenis;RUONIUKŲ;4713395766;Taip;7;1;0;8
10470;Vandenis;RUONIUKŲ;6986724058;Taip;7;0;0;7
10471;Vandenis;RUONIUKŲ;7754158588;Taip;6;0;0;6
10472;Vandenis;RUONIUKŲ;9731729915;Taip;12;0;0;12
10473;Vandenis;RUONIUKŲ;9527253920;Taip;0;12;0;12
10474;Vandenis;RUONIUKŲ;8971291182;Taip;7;0;0;7
10475;Vandenis;RUONIUKŲ;6330187732;Ne;0;5;0;5
10476;Vandenis;RUONIUKŲ;9688954631;Ne;9;3;0;12
10477;Vandenis;RUONIUKŲ;8729351613;Taip;9;0;0;9
10478;Vandenis;RUONIUKŲ;6158299885;Taip;0;3;0;3
10479;Vandenis;RUONIUKŲ;3664560833;Taip;15;0;0;15
10480;Vandenis;RUONIUKŲ;5535901447;Taip;8;0;0;8
10481;Vandenis;ŽUVYČIŲ;91774614891;Taip;4;0;1;5
10482;Vandenis;ŽUVYČIŲ;1944730492;Taip;4;1;1;6
10483;Vandenis;ŽUVYČIŲ;44800276421;Taip;0;3;0;3
10484;Vandenis;ŽUVYČIŲ;94273730058;Ne;4;4;0;8
10485;Vandenis;ŽUVYČIŲ;26193472997;Taip;0;2;0;2
10486;Vandenis;ŽUVYČIŲ;75077443996;Ne;0;1;0;1
10487;Vandenis;ŽUVYČIŲ;84636435681;Taip;0;0;1;1
10488;Vandenis;ŽUVYČIŲ;58997790744;Taip;3;1;0;4
10489;Vandenis;ŽUVYČIŲ;3740778932;Taip;0;8;0;8
10490;Vandenis;ŽUVYČIŲ;1245031666;Taip;0;2;0;2
10491;Vandenis;ŽUVYČIŲ;2073785910;Taip;2;1;0;3
10492;Vandenis;ŽUVYČIŲ;3823382249;Taip;2;2;0;4
10493;Vandenis;ŽUVYČIŲ;877974909;Taip;5;0;0;5
10494;Vandenis;ŽUVYČIŲ;2114436962;Taip;5;0;0;5
10495;Vandenis;ŽUVYČIŲ;1854498462;Taip;0;2;0;2
10496;Vandenis;ŽUVYČIŲ;81817138188;Taip;0;0;6;6
10497;Vandenis;ŽUVYČIŲ;7467699979;Taip;0;0;1;1
10498;Vandenis;ŽUVYČIŲ;1395272045;Taip;4;0;1;5
10499;Vandenis;ŽUVYČIŲ;1958929302;Taip;7;1;0;8
10500;Vandenis;PERLIUKŲ;8678508812;Taip;0;12;0;12
10501;Vandenis;PERLIUKŲ;2645775090;Taip;5;2;0;7
10502;Vandenis;PERLIUKŲ;5844576485;Taip;0;0;2;2
10503;Vandenis;PERLIUKŲ;6295009202;Taip;0;4;0;4
10504;Vandenis;PERLIUKŲ;7598257845;Taip;0;11;0;11
10505;Vandenis;PERLIUKŲ;5323428164;Taip;14;2;0;16
10506;Vandenis;PERLIUKŲ;6073002418;Taip;5;0;0;5
10507;Vandenis;PERLIUKŲ;5565147603;Taip;0;1;0;1
10508;Vandenis;PERLIUKŲ;1511740350;Taip;0;6;2;8
10509;Vandenis;PERLIUKŲ;2690536940;Ne;5;0;0;5
10510;Vandenis;PERLIUKŲ;2576575249;Taip;4;3;0;7
10511;Vandenis;PERLIUKŲ;7832674282;Ne;8;0;0;8
10512;Vandenis;PERLIUKŲ;1975385430;Taip;5;4;0;9
10513;Vandenis;PERLIUKŲ;3061606138;Taip;0;1;0;1
10514;Vandenis;PERLIUKŲ;8117385209;Taip;5;11;0;16
10515;Vandenis;PERLIUKŲ;5613067534;Taip;0;1;0;1
10516;Vandenis;PERLIUKŲ;2321919298;Taip;8;0;0;8
10517;Vandenis;PERLIUKŲ;5963181638;Ne;5;0;0;5
10518;Vandenis;PERLIUKŲ;5609737826;Taip;12;0;2;14
10519;Vandenis;PERLIUKŲ;3239754791;Taip;3;3;0;6
10520;Vandenis;ANČIUKŲ;8233407105;Taip;5;2;1;8
10521;Vandenis;ANČIUKŲ;1282499654;Taip;5;4;1;10
10522;Vandenis;ANČIUKŲ;3578947540;Ne;0;1;0;1
10523;Vandenis;ANČIUKŲ;5395847317;Taip;0;1;0;1
10524;Vandenis;ANČIUKŲ;3243079651;Taip;0;0;3;3
10525;Vandenis;ANČIUKŲ;3938359901;Taip;0;1;0;1
10526;Vandenis;ANČIUKŲ;1314724267;Taip;3;2;0;5
10527;Vandenis;ANČIUKŲ;8251169901;Ne;0;11;0;11
10528;Vandenis;ANČIUKŲ;4750141780;Taip;4;2;0;6
10529;Vandenis;ANČIUKŲ;6181866272;Taip;0;6;0;6
10530;Vandenis;ANČIUKŲ;7522472652;Taip;0;1;0;1
10531;Vandenis;ANČIUKŲ;3067868099;Taip;0;4;0;4
10532;Vandenis;ANČIUKŲ;8511948282;Ne;7;3;0;10
10533;Vandenis;ANČIUKŲ;33317650043;Ne;0;2;0;2
10534;Vandenis;ANČIUKŲ;1739780612;Taip;19;1;0;20
10535;Vandenis;ANČIUKŲ;2489776665;Taip;15;0;0;15
10536;Vandenis;ANČIUKŲ;71786730314;Taip;3;1;0;4
10537;Vandenis;ANČIUKŲ;1621481561;Taip;0;4;0;4
10538;Vandenis;ANČIUKŲ;33782837791;Taip;8;1;0;9
10539;Vandenis;ANČIUKŲ;2096950367;Taip;0;2;0;2
10540;Vandenis;ANČIUKŲ;1633589144;Taip;5;1;0;6
10541;Vandenis;ANČIUKŲ;61120985165;Taip;0;5;0;5
10542;Vandenis;ANČIUKŲ;7168910452;Taip;5;1;0;6
10543;Vandenis;VĖŽLIUKŲ;2309166304;Taip;4;0;1;5
10544;Vandenis;VĖŽLIUKŲ;2872343656;Taip;0;0;1;1
10545;Vandenis;VĖŽLIUKŲ;5454049563;Taip;8;1;0;9
10546;Vandenis;VĖŽLIUKŲ;9805578141;Taip;8;1;0;9
10547;Vandenis;VĖŽLIUKŲ;8921666108;Taip;0;6;0;6
10548;Vandenis;VĖŽLIUKŲ;8116532445;Taip;7;4;0;11
10549;Vandenis;VĖŽLIUKŲ;7069369080;Taip;7;4;0;11
10550;Vandenis;VĖŽLIUKŲ;7924399684;Taip;6;1;0;7
10551;Vandenis;VĖŽLIUKŲ;1187395353;Taip;0;6;0;6
10552;Vandenis;VĖŽLIUKŲ;1081385111;Taip;5;0;0;5
10553;Vandenis;VĖŽLIUKŲ;5126732658;Taip;0;1;0;1
10554;Vandenis;VĖŽLIUKŲ;7059385610;Taip;0;3;0;3
10555;Vandenis;VĖŽLIUKŲ;9158541919;Taip;0;2;1;3
10556;Vandenis;VĖŽLIUKŲ;5959181898;Taip;0;2;1;3
10557;Vandenis;VĖŽLIUKŲ;1707354287;Taip;5;0;0;5
10558;Vandenis;VĖŽLIUKŲ;4177166475;Taip;7;0;0;7
10559;Vandenis;VĖŽLIUKŲ;8416839037;Taip;0;2;0;2
10560;Vandenis;VĖŽLIUKŲ;2936885357;Taip;10;0;0;10
10561;Vandenis;VĖŽLIUKŲ;8879608849;Taip;0;1;0;1
10562;Vandenis;AŠTUNKOJŲ;1505353673;Ne;12;0;0;12
10563;Vandenis;AŠTUNKOJŲ;74138671368;Taip;0;1;0;1
10564;Vandenis;AŠTUNKOJŲ;1217508516;Taip;8;2;2;12
10565;Vandenis;AŠTUNKOJŲ;7801129545;Taip;0;2;0;2
10566;Vandenis;AŠTUNKOJŲ;53658866238;Taip;1;5;0;6
10567;Vandenis;AŠTUNKOJŲ;1286716632;Taip;0;1;0;1
10568;Vandenis;AŠTUNKOJŲ;2029167786;Taip;0;1;0;1
10569;Vandenis;AŠTUNKOJŲ;7333587583;Taip;7;1;0;8
10570;Vandenis;AŠTUNKOJŲ;25459674313;Taip;0;2;0;2
10571;Vandenis;AŠTUNKOJŲ;46916815441;Taip;0;1;0;1
10572;Vandenis;AŠTUNKOJŲ;25934798454;Taip;0;2;2;4
10573;Vandenis;AŠTUNKOJŲ;2812520834;Taip;0;1;0;1
10574;Vandenis;GANDRIUKŲ;4753416316;Taip;10;0;1;11
10575;Vandenis;GANDRIUKŲ;9936940067;Taip;0;0;1;1
10576;Vandenis;GANDRIUKŲ;7143062288;Taip;0;0;6;6
10577;Vandenis;GANDRIUKŲ;6153669587;Taip;12;0;0;12
10578;Vandenis;GANDRIUKŲ;6260893699;Taip;0;2;0;2
10579;Vandenis;GANDRIUKŲ;7019646962;Taip;0;0;4;4
10580;Vandenis;GANDRIUKŲ;2078767085;Taip;10;0;1;11
10581;Vandenis;GANDRIUKŲ;2976505868;Taip;8;0;3;11
10582;Vandenis;GANDRIUKŲ;6558155968;Taip;0;4;0;4
10583;Vandenis;GANDRIUKŲ;8144830789;Taip;0;0;4;4
10584;Vandenis;GANDRIUKŲ;2381566229;Taip;0;10;0;10
10585;Vandenis;GANDRIUKŲ;5899846599;Taip;5;0;0;5
10586;Vandenis;GANDRIUKŲ;1606103904;Ne;11;0;0;11
10587;Vandenis;GANDRIUKŲ;1753180703;Taip;0;0;2;2
10588;Vandenis;GANDRIUKŲ;7303512055;Taip;0;0;1;1
10589;Vandenis;GANDRIUKŲ;3231434944;Taip;0;0;1;1
10590;Vandenis;ŽĄSIUKAI;8034690071;Taip;5;0;0;5
10591;Vandenis;ŽĄSIUKAI;9937317687;Taip;3;0;2;5
10592;Vandenis;ŽĄSIUKAI;2004158593;Taip;2;0;0;2
10593;Vandenis;ŽĄSIUKAI;8014569725;Taip;6;0;1;7
10594;Vandenis;ŽĄSIUKAI;7070234429;Taip;0;0;1;1
10595;Vandenis;ŽĄSIUKAI;4072405890;Taip;5;0;1;6
10596;Vandenis;ŽĄSIUKAI;5684262347;Taip;11;0;0;11
10597;Vandenis;ŽĄSIUKAI;6876019354;Taip;0;1;0;1
10598;Vandenis;ŽĄSIUKAI;7525611399;Ne;9;0;0;9
10599;Vandenis;ŽĄSIUKAI;5641929490;Taip;0;3;0;3
10600;Vandenis;PURIENŲ;6851178154;Taip;0;3;2;5
10601;Vandenis;PURIENŲ;4455886780;Taip;7;0;0;7
10602;Vandenis;PURIENŲ;1031451445;Taip;4;1;0;5
10603;Vandenis;PURIENŲ;4815210197;Ne;11;1;0;12
10604;Vandenis;PURIENŲ;3337286021;Taip;16;0;0;16
10605;Vandenis;PURIENŲ;7020534318;Taip;5;0;0;5
10606;Vandenis;PURIENŲ;6027680514;Ne;0;1;0;1
10607;Vandenis;PURIENŲ;2960005490;Taip;8;2;1;11
10608;Vandenis;PURIENŲ;1180322026;Taip;8;2;1;11
10609;Vandenis;PURIENŲ;3633805607;Taip;9;0;0;9
10610;Vandenis;PURIENŲ;7959438279;Taip;8;0;0;8
10611;Vandenis;PURIENŲ;1788652447;Taip;3;2;0;5
10612;Vandenis;PURIENŲ;6332179750;Taip;0;2;0;2
10613;Vandenis;PURIENŲ;5540306590;Taip;8;0;0;8
10614;Vandenis;PURIENŲ;2719678617;Taip;3;2;0;5
10615;Vandenis;PURIENŲ;7171302906;Taip;5;5;0;10
10616;Vandenis;PURIENŲ;8085633453;Taip;5;5;0;10
10617;Vandenis;PURIENŲ;2614561762;Taip;0;1;0;1
10618;Vandenis;PURIENŲ;5764809162;Taip;5;0;0;5
10619;Vandenis;PURIENŲ;1244502945;Taip;5;4;0;9
10620;Vandenis;VARLIUKAI;6189862061;Taip;0;0;1;1
10621;Vandenis;VARLIUKAI;4345021061;Taip;0;0;1;1
10622;Vandenis;VARLIUKAI;9968877035;Taip;5;1;0;6
10623;Vandenis;VARLIUKAI;3639160500;Taip;3;0;2;5
10624;Vandenis;VARLIUKAI;9458613523;Taip;2;1;0;3
10625;Vandenis;VARLIUKAI;4607196473;Taip;8;0;0;8
10626;Vandenis;VARLIUKAI;4715198793;Taip;0;0;1;1
10627;Vandenis;VARLIUKAI;4954121871;Taip;2;0;0;2
10628;Vandenis;VARLIUKAI;8751355814;Taip;5;0;0;5
10629;Vandenis;VARLIUKAI;4983424940;Taip;5;0;0;5
10630;Vandenis;VARLIUKAI;4978712442;Taip;5;0;0;5
10631;Vandenis;VARLIUKAI;7581114286;Taip;0;2;0;2
10632;Vandenis;VARLIUKAI;9679010239;Taip;3;1;0;4
10633;Vandenis;VARLIUKAI;5610800263;Taip;0;0;1;1
10634;Vandenis;PINGVINAI;3544717790;Taip;8;2;0;10
10635;Vandenis;PINGVINAI;1568158992;Taip;2;0;0;2
10636;Vandenis;PINGVINAI;18336904438;Taip;6;0;0;6
10637;Vandenis;PINGVINAI;8689134931;Taip;9;0;0;9
10638;Vandenis;PINGVINAI;9608871155;Taip;1;0;0;1
10639;Vandenis;PINGVINAI;64711327503;Taip;0;6;0;6
10640;Vandenis;PINGVINAI;7381695975;Taip;0;1;0;1
10641;Vandenis;PINGVINAI;43933878402;Taip;8;1;0;9
10642;Vandenis;PINGVINAI;24217366528;Taip;12;0;0;12
10643;Vandenis;PINGVINAI;5549292096;Taip;13;2;0;15
10644;Vandenis;PINGVINAI;7408758565;Taip;7;0;0;7
10645;Vandenis;PINGVINAI;4643267945;Taip;0;1;0;1
10646;Vandenis;PINGVINAI;8430706407;Ne;8;0;0;8
10647;Vandenis;PINGVINAI;1535450614;Taip;13;0;0;13
10648;Vandenis;PINGVINAI;35673258175;Taip;8;0;1;9
10649;Vandenis;PINGVINAI;27409922803;Taip;5;0;1;6
10650;Vandenis;PINGVINAI;1598122777;Ne;7;1;0;8
10651;Vandenis;PINGVINAI;1815765498;Taip;6;0;8;14
10652;Vandenis;PINGVINAI;8705188652;Ne;0;0;1;1
10653;Vėjelis;Pumpurėliai;3125815427;Taip;7;0;0;7
10654;Vėjelis;Pumpurėliai;5516672613;Taip;0;2;0;2
10655;Vėjelis;Pumpurėliai;2866394056;Ne;8;0;0;8
10656;Vėjelis;Pumpurėliai;1084415930;Ne;5;0;2;7
10657;Vėjelis;Pumpurėliai;9071878406;Ne;5;0;2;7
10658;Vėjelis;Pumpurėliai;3206025676;Taip;7;0;1;8
10659;Vėjelis;Pumpurėliai;5611813359;Taip;7;0;0;7
10660;Vėjelis;Pumpurėliai;1057586168;Taip;0;6;0;6
10661;Vėjelis;Pumpurėliai;9583495324;Taip;5;0;0;5
10662;Vėjelis;Pumpurėliai;7539681314;Taip;0;1;0;1
10663;Vėjelis;Pumpurėliai;6168648640;Taip;0;0;2;2
10664;Vėjelis;Pumpurėliai;1876663813;Ne;10;1;0;11
10665;Vėjelis;Pumpurėliai;6840643273;Ne;0;3;0;3
10666;Vėjelis;Pumpurėliai;9824130744;Taip;0;0;8;8
10667;Vėjelis;Drugeliai;4746932126;Taip;0;4;0;4
10668;Vėjelis;Drugeliai;1978952781;Taip;6;0;3;9
10669;Vėjelis;Drugeliai;8353084814;Taip;0;0;2;2
10670;Vėjelis;Drugeliai;1115802837;Ne;4;0;7;11
10671;Vėjelis;Drugeliai;2416832899;Taip;0;0;1;1
10672;Vėjelis;Drugeliai;1494531065;Taip;3;0;0;3
10673;Vėjelis;Drugeliai;9298789434;Taip;5;0;1;6
10674;Vėjelis;Drugeliai;2734024890;Taip;15;0;3;18
10675;Vėjelis;Drugeliai;7981032872;Taip;10;0;7;17
10676;Vėjelis;Drugeliai;2000277444;Taip;0;0;1;1
10677;Vėjelis;Drugeliai;7752923796;Taip;9;0;0;9
10678;Vėjelis;Drugeliai;7594586198;Taip;4;0;1;5
10679;Vėjelis;Drugeliai;7697394469;Taip;4;0;3;7
10680;Vėjelis;Drugeliai;4066956765;Taip;8;0;8;16
10681;Vėjelis;Drugeliai;2788205363;Taip;7;1;6;14
10682;Vėjelis;Drugeliai;1331334220;Taip;9;0;4;13
10683;Vėjelis;Drugeliai;2151737048;Taip;0;12;0;12
10684;Vėjelis;Drugeliai;3276062426;Taip;0;0;3;3
10685;Vėjelis;Drugeliai;4988352741;Taip;0;2;0;2
10686;Vėjelis;Drugeliai;3982318250;Taip;5;0;4;9
10687;Vėjelis;Drugeliai;4132824111;Taip;10;0;0;10
10688;Vėjelis;Malūnėlis;44482585723;Taip;0;2;0;2
10689;Vėjelis;Malūnėlis;12087873516;Taip;0;5;0;5
10690;Vėjelis;Malūnėlis;2282796452;Taip;0;4;0;4
10691;Vėjelis;Malūnėlis;1551143643;Taip;0;4;0;4
10692;Vėjelis;Malūnėlis;41268510292;Taip;0;2;1;3
10693;Vėjelis;Malūnėlis;3910688753;Ne;0;0;4;4
10694;Vėjelis;Malūnėlis;8941647789;Taip;0;2;1;3
10695;Vėjelis;Malūnėlis;7794899167;Ne;0;5;1;6
10696;Vėjelis;Malūnėlis;1934426525;Taip;0;2;3;5
10697;Vėjelis;Malūnėlis;1988459596;Taip;11;1;1;13
10698;Vėjelis;Malūnėlis;77205958956;Taip;0;7;0;7
10699;Vėjelis;Malūnėlis;86128256406;Taip;7;0;3;10
10700;Vėjelis;Malūnėlis;44153389025;Taip;0;1;1;2
10701;Vėjelis;Malūnėlis;75596757609;Taip;0;0;2;2
10702;Vėjelis;Malūnėlis;90185075321;Taip;0;1;1;2
10703;Vėjelis;Malūnėlis;57285479257;Taip;0;1;0;1
10704;Vėjelis;Malūnėlis;64339770365;Taip;0;2;0;2
10705;Vėjelis;Malūnėlis;8198463045;Taip;5;0;0;5
10706;Vėjelis;Malūnėlis;1640356242;Taip;0;4;0;4
10707;Vėjelis;Žvaigždutės;98588113289;Taip;0;1;0;1
10708;Vėjelis;Žvaigždutės;2363974247;Taip;0;0;4;4
10709;Vėjelis;Žvaigždutės;8379298947;Taip;0;0;4;4
10710;Vėjelis;Žvaigždutės;73287916371;Taip;0;0;5;5
10711;Vėjelis;Žvaigždutės;5396347620;Taip;0;2;0;2
10712;Vėjelis;Žvaigždutės;50124109589;Ne;0;6;0;6
10713;Vėjelis;Žvaigždutės;9492690970;Ne;0;0;3;3
10714;Vėjelis;Žvaigždutės;1436893015;Ne;0;0;1;1
10715;Vėjelis;Žvaigždutės;1205392813;Taip;0;9;0;9
10716;Vėjelis;Žvaigždutės;2117924725;Taip;5;0;1;6
10717;Vėjelis;Žvaigždutės;8866974952;Taip;0;1;0;1
10718;Vėjelis;Žvaigždutės;5031781196;Taip;5;0;0;5
10719;Vėjelis;Žvaigždutės;4219672982;Taip;3;0;1;4
10720;Vėjelis;Žvaigždutės;4853650350;Taip;0;1;0;1
10721;Vėjelis;Žvaigždutės;60890519853;Taip;0;3;0;3
10722;Vėjelis;Žvaigždutės;1549518622;Taip;0;6;0;6
10723;Vėjelis;Žvaigždutės;6386092350;Taip;0;7;0;7
10724;Vėjelis;Žvaigždutės;8684461171;Taip;0;9;0;9
10725;Vėjelis;Žvaigždutės;8386409466;Taip;14;0;0;14
10726;Vėjelis;Žvaigždutės;7133454882;Taip;0;1;0;1
10727;Vėjelis;Žvaigždutės;4353239658;Ne;2;0;1;3
10728;Vėjelis;Žvaigždutės;4521161684;Ne;0;0;3;3
10729;Vėjelis;Varpeliai;8389094301;Taip;0;7;0;7
10730;Vėjelis;Varpeliai;90103717718;Taip;0;0;1;1
10731;Vėjelis;Varpeliai;90647333398;Taip;0;0;2;2
10732;Vėjelis;Varpeliai;47143492836;Taip;5;0;1;6
10733;Vėjelis;Varpeliai;56520156825;Taip;0;2;0;2
10734;Vėjelis;Varpeliai;47986392996;Taip;0;0;2;2
10735;Vėjelis;Varpeliai;1990674632;Taip;0;0;2;2
10736;Vėjelis;Varpeliai;4230144743;Taip;0;8;0;8
10737;Vėjelis;Varpeliai;6002719498;Taip;0;6;0;6
10738;Vėjelis;Varpeliai;1612878387;Taip;0;1;0;1
10739;Vėjelis;Varpeliai;8973530484;Taip;0;6;0;6
10740;Vėjelis;Varpeliai;3255066035;Taip;5;0;1;6
10741;Vėjelis;Varpeliai;76305473353;Taip;6;0;1;7
10742;Vėjelis;Varpeliai;3485366651;Taip;0;2;0;2
10743;Vėjelis;Varpeliai;69341469387;Ne;0;2;0;2
10744;Vėjelis;Varpeliai;8949760376;Taip;3;0;3;6
10745;Vėjelis;Varpeliai;9190085358;Taip;0;7;0;7
10746;Vėjelis;Varpeliai;5139323880;Taip;0;0;1;1
10747;Vėjelis;Varpeliai;9395929106;Ne;0;1;0;1
10748;Vėjelis;Pelėdžiukų;1454662113;Taip;0;0;1;1
10749;Vėjelis;Pelėdžiukų;1238171728;Taip;6;0;0;6
10750;Vėjelis;Pelėdžiukų;4024898537;Taip;5;0;1;6
10751;Vėjelis;Pelėdžiukų;24011371444;Taip;4;17;0;21
10752;Vėjelis;Pelėdžiukų;2819491961;Taip;0;0;1;1
10753;Vėjelis;Pelėdžiukų;1783878104;Taip;0;0;2;2
10754;Vėjelis;Pelėdžiukų;1510415602;Taip;10;0;10;20
10755;Vėjelis;Pelėdžiukų;2042863944;Taip;0;0;9;9
10756;Vėjelis;Pelėdžiukų;5992665537;Taip;4;0;6;10
10757;Vėjelis;Pelėdžiukų;1347855869;Taip;0;0;2;2
10758;Vėjelis;Pelėdžiukų;1467023330;Taip;5;0;0;5
10759;Vėjelis;Pelėdžiukų;1518855620;Taip;0;1;0;1
10760;Vėjelis;Pelėdžiukų;4930807661;Taip;3;0;1;4
10761;Vėjelis;Pelėdžiukų;2128818222;Taip;0;10;4;14
10762;Vėjelis;Pelėdžiukų;1603377234;Ne;0;1;1;2
10763;Vėjelis;Pelėdžiukų;1425008833;Taip;11;0;0;11
10764;Vėjelis;Pelėdžiukų;1359019646;Taip;0;0;2;2
10765;Vėjelis;Pelėdžiukų;2721810040;Taip;0;0;2;2
10766;Vėjelis;Skruzdeliukų;2167025998;Taip;0;0;1;1
10767;Vėjelis;Skruzdeliukų;7400967836;Taip;0;0;2;2
10768;Vėjelis;Skruzdeliukų;1952141664;Taip;3;1;0;4
10769;Vėjelis;Skruzdeliukų;3264153232;Taip;0;0;1;1
10770;Vėjelis;Skruzdeliukų;1534169381;Taip;0;3;0;3
10771;Vėjelis;Skruzdeliukų;4992783345;Taip;0;11;0;11
10772;Vėjelis;Skruzdeliukų;4997987762;Taip;11;0;0;11
10773;Vėjelis;Skruzdeliukų;8356715925;Taip;0;0;4;4
10774;Vėjelis;Skruzdeliukų;4946988585;Taip;0;2;0;2
10775;Vėjelis;Skruzdeliukų;7240155487;Taip;11;0;1;12
10776;Vėjelis;Skruzdeliukų;7695719991;Ne;0;0;2;2
10777;Vėjelis;Skruzdeliukų;6618114389;Taip;0;0;4;4
10778;Vėjelis;Skruzdeliukų;1381923971;Ne;0;3;0;3
10779;Vėjelis;Pieštukų;4868574574;Taip;0;1;0;1
10780;Vėjelis;Pieštukų;1956418258;Taip;0;3;0;3
10781;Vėjelis;Pieštukų;8995478684;Taip;2;0;0;2
10782;Vėjelis;Pieštukų;8300497094;Taip;0;0;2;2
10783;Vėjelis;Pieštukų;4884057836;Ne;0;0;1;1
10784;Vėjelis;Pieštukų;3898751303;Taip;0;8;0;8
10785;Vėjelis;Pieštukų;5662728912;Taip;0;12;0;12
10786;Vėjelis;Pieštukų;4101161670;Taip;0;6;0;6
10787;Vėjelis;Pieštukų;7417967853;Taip;0;0;4;4
10788;Vėjelis;Pieštukų;3495322620;Taip;6;0;0;6
10789;Vėjelis;Pieštukų;8281508498;Taip;0;0;5;5
10790;Vėjelis;Pieštukų;7046938604;Taip;3;0;0;3
10791;Vėjelis;Ramunėlių;8047799576;Ne;8;3;0;11
10792;Vėjelis;Ramunėlių;7178844364;Taip;5;5;0;10
10793;Vėjelis;Ramunėlių;2386927970;Taip;17;0;0;17
10794;Vėjelis;Ramunėlių;6455798848;Taip;0;0;1;1
10795;Vėjelis;Ramunėlių;6996900411;Taip;5;3;0;8
10796;Vėjelis;Ramunėlių;2289954824;Taip;5;6;0;11
10797;Vėjelis;Ramunėlių;4733227215;Taip;5;0;0;5
10798;Vėjelis;Ramunėlių;5909697341;Taip;0;2;0;2
10799;Vėjelis;Ramunėlių;6451722893;Taip;0;4;0;4
10800;Vėjelis;Ramunėlių;8721116918;Ne;6;0;0;6
10801;Vėjelis;Ramunėlių;1381191703;Taip;2;1;0;3
10802;Vėjelis;Ramunėlių;9042329808;Taip;2;1;0;3
10803;Vėjelis;Ramunėlių;9754373141;Taip;6;4;1;11
10804;Vėjelis;Ramunėlių;4906958328;Taip;11;0;0;11
10805;Vėjelis;Ramunėlių;6724813553;Taip;7;5;0;12
10806;Vėjelis;Ramunėlių;9672929606;Ne;13;1;2;16
10807;Vėjelis;Ramunėlių;8998452731;Ne;9;0;0;9
10808;Vėjelis;Ramunėlių;4831426440;Taip;5;2;1;8
10809;Vėjelis;Ramunėlių;5902455219;Taip;0;1;0;1
10810;Vėjelis;Nykštukai;1022888418;Taip;0;0;1;1
10811;Vėjelis;Nykštukai;6660799519;Taip;9;1;0;10
10812;Vėjelis;Nykštukai;2522750651;Taip;0;0;1;1
10813;Vėjelis;Nykštukai;4433799070;Taip;0;0;4;4
10814;Vėjelis;Nykštukai;1235788079;Ne;8;2;0;10
10815;Vėjelis;Nykštukai;2371667380;Taip;0;6;0;6
10816;Vėjelis;Nykštukai;9625857378;Taip;0;1;4;5
10817;Vėjelis;Nykštukai;8054114720;Taip;0;3;0;3
10818;Vėjelis;Nykštukai;7790713917;Taip;0;1;4;5
10819;Vėjelis;Nykštukai;2917197418;Taip;0;0;3;3
10820;Vėjelis;Nykštukai;4745262277;Taip;3;2;0;5
10821;Vėjelis;Nykštukai;6891260701;Taip;0;3;0;3
10822;Vėjelis;Nykštukai;6889825160;Taip;0;0;2;2
10823;Vėjelis;Nykštukai;4095860464;Ne;10;0;0;10
10824;Vėjelis;Nykštukai;8415686253;Taip;10;0;1;11
10825;Vėjelis;Nykštukai;8986581196;Taip;5;0;0;5
10826;Vėjelis;BITUTĖS;4276237884;Taip;3;0;0;3
10827;Vėjelis;BITUTĖS;3772706363;Taip;5;2;0;7
10828;Vėjelis;BITUTĖS;1834203833;Taip;0;1;2;3
10829;Vėjelis;BITUTĖS;9274287800;Taip;7;0;0;7
10830;Vėjelis;BITUTĖS;6283428333;Taip;5;0;0;5
10831;Vėjelis;BITUTĖS;6569848405;Taip;5;0;0;5
10832;Vėjelis;BITUTĖS;8994680698;Taip;5;1;0;6
10833;Vėjelis;BITUTĖS;7101585528;Taip;0;1;0;1
10834;Vėjelis;BITUTĖS;1457373815;Taip;11;0;0;11
10835;Vėjelis;BITUTĖS;2656895893;Taip;0;2;0;2
10836;Vėjelis;BITUTĖS;3935611907;Taip;0;1;2;3
10837;Vėjelis;Boruželės;5325081841;Taip;0;1;0;1
10838;Vėjelis;Boruželės;5381588565;Taip;0;4;0;4
10839;Vėjelis;Boruželės;1863210064;Taip;0;3;0;3
10840;Vėjelis;Boruželės;9037622738;Taip;5;6;0;11
10841;Vėjelis;Boruželės;8553966497;Taip;0;0;3;3
10842;Vėjelis;Boruželės;1588345134;Taip;0;2;11;13
10843;Vėjelis;Boruželės;1751533938;Ne;0;6;0;6
10844;Vėjelis;Boruželės;1931659200;Taip;16;0;0;16
10845;Vėjelis;Boruželės;6221257045;Ne;0;1;0;1
10846;Vėjelis;Boruželės;8666759391;Ne;0;1;0;1
10847;Vėjelis;Boruželės;3844131154;Taip;5;0;1;6
10848;Vėjelis;Boruželės;4747466651;Taip;0;16;0;16
10849;Vėjelis;Boruželės;3473416323;Taip;1;0;0;1
10850;Vėjelis;Boruželės;8141198449;Taip;10;2;1;13
10851;Vėjelis;Boruželės;8121537795;Ne;11;6;0;17
10852;Vėjelis;Boruželės;5517128872;Taip;5;1;0;6
10853;Vėjelis;Boruželės;8938491367;Taip;10;1;0;11
10854;Vėjelis;Boruželės;4506243333;Taip;0;1;0;1
10855;Vėjelis;Boruželės;6061966626;Taip;0;21;0;21
10856;Vėjelis;Boruželės;3524350131;Taip;0;2;0;2
10857;Vėtrungė;Debesėlių;1280823326;Taip;14;1;0;15
10858;Vėtrungė;Debesėlių;3655025938;Taip;10;0;1;11
10859;Vėtrungė;Debesėlių;2825732654;Taip;4;1;0;5
10860;Vėtrungė;Debesėlių;8956375453;Taip;11;0;1;12
10861;Vėtrungė;Debesėlių;4339450816;Taip;8;0;0;8
10862;Vėtrungė;Debesėlių;6439014588;Taip;10;1;2;13
10863;Vėtrungė;Debesėlių;9423361592;Taip;0;1;0;1
10864;Vėtrungė;Debesėlių;4269488000;Taip;3;0;0;3
10865;Vėtrungė;Debesėlių;1191007983;Taip;0;6;0;6
10866;Vėtrungė;Debesėlių;3745680607;Taip;17;1;2;20
10867;Vėtrungė;Debesėlių;9359012317;Taip;5;5;1;11
10868;Vėtrungė;Debesėlių;1807742144;Ne;7;0;0;7
10869;Vėtrungė;Debesėlių;9893842192;Taip;17;0;0;17
10870;Vėtrungė;Debesėlių;5508759323;Taip;5;0;1;6
10871;Vėtrungė;Debesėlių;3433811829;Taip;6;8;0;14
10872;Vėtrungė;Debesėlių;2447851565;Taip;5;4;0;9
10873;Vėtrungė;Debesėlių;1255147376;Ne;5;4;0;9
10874;Vėtrungė;Debesėlių;2136966687;Taip;9;0;3;12
10875;Vėtrungė;Debesėlių;5246813735;Taip;0;0;1;1
10876;Vėtrungė;Debesėlių;5836190044;Taip;0;8;0;8
10877;Vėtrungė;Debesėlių;8957071345;Taip;5;0;1;6
10878;Vėtrungė;Debesėlių;5545581078;Taip;0;5;0;5
10879;Vėtrungė;Zuikių;7585075881;Taip;20;0;2;22
10880;Vėtrungė;Zuikių;9332362038;Taip;0;5;1;6
10881;Vėtrungė;Zuikių;9407558097;Taip;0;10;0;10
10882;Vėtrungė;Zuikių;4121886031;Ne;0;5;0;5
10883;Vėtrungė;Zuikių;7573021445;Ne;0;0;1;1
10884;Vėtrungė;Zuikių;9742099165;Taip;3;1;1;5
10885;Vėtrungė;Zuikių;1215953192;Taip;5;0;2;7
10886;Vėtrungė;Zuikių;3908259010;Ne;0;0;2;2
10887;Vėtrungė;Zuikių;8421138967;Taip;9;0;16;25
10888;Vėtrungė;Zuikių;1729819557;Taip;12;0;5;17
10889;Vėtrungė;Zuikių;4916692634;Taip;0;3;4;7
10890;Vėtrungė;Zuikių;6416245099;Ne;0;1;0;1
10891;Vėtrungė;Zuikių;4197321604;Taip;5;1;1;7
10892;Vėtrungė;Zuikių;1007578933;Taip;9;1;0;10
10893;Vėtrungė;Zuikių;7558548846;Taip;9;1;0;10
10894;Vėtrungė;Zuikių;8742161467;Taip;5;1;5;11
10895;Vėtrungė;Zuikių;5089367351;Taip;0;0;1;1
10896;Vėtrungė;Zuikių;2537221101;Taip;0;21;0;21
10897;Vėtrungė;Zuikių;7342250921;Taip;17;0;0;17
10898;Vėtrungė;Zuikių;9248113268;Taip;10;0;0;10
10899;Vėtrungė;Zuikių;7435005821;Ne;0;7;2;9
10900;Vėtrungė;Drugelių;5366256528;Ne;10;5;2;17
10901;Vėtrungė;Drugelių;5622109033;Ne;0;2;0;2
10902;Vėtrungė;Drugelių;9444188699;Taip;0;0;1;1
10903;Vėtrungė;Drugelių;7476984763;Taip;4;11;0;15
10904;Vėtrungė;Drugelių;9090873546;Taip;13;0;0;13
10905;Vėtrungė;Drugelių;8441629302;Taip;9;0;0;9
10906;Vėtrungė;Drugelių;2124476787;Taip;9;1;0;10
10907;Vėtrungė;Drugelių;2970067995;Taip;12;0;4;16
10908;Vėtrungė;Drugelių;4578835070;Taip;7;0;3;10
10909;Vėtrungė;Drugelių;8729505032;Taip;0;0;1;1
10910;Vėtrungė;Drugelių;6807838878;Taip;20;0;1;21
10911;Vėtrungė;Drugelių;5939537473;Taip;18;0;0;18
10912;Vėtrungė;Drugelių;5251308945;Taip;14;0;0;14
10913;Vėtrungė;Drugelių;9812496068;Taip;9;0;1;10
10914;Vėtrungė;Do-re-mi;6449124019;Taip;0;5;3;8
10915;Vėtrungė;Do-re-mi;3278452234;Ne;6;2;0;8
10916;Vėtrungė;Do-re-mi;9324733839;Taip;0;0;4;4
10917;Vėtrungė;Do-re-mi;2287044278;Taip;0;7;0;7
10918;Vėtrungė;Do-re-mi;2928868412;Taip;2;1;3;6
10919;Vėtrungė;Do-re-mi;2883254822;Taip;3;0;1;4
10920;Vėtrungė;Do-re-mi;9518734260;Taip;12;1;1;14
10921;Vėtrungė;Do-re-mi;7496582551;Taip;5;0;0;5
10922;Vėtrungė;Do-re-mi;5430818470;Taip;11;0;5;16
10923;Vėtrungė;Do-re-mi;5832298824;Ne;0;1;0;1
10924;Vėtrungė;Do-re-mi;7895027909;Taip;0;2;0;2
10925;Vėtrungė;Do-re-mi;8538678373;Ne;0;0;2;2
10926;Vėtrungė;Do-re-mi;7483624989;Taip;10;5;1;16
10927;Vėtrungė;Do-re-mi;7807708310;Taip;7;0;6;13
10928;Vėtrungė;Do-re-mi;3200251047;Taip;3;6;0;9
10929;Vėtrungė;Do-re-mi;3369970611;Taip;0;11;0;11
10930;Vėtrungė;Do-re-mi;1808699695;Taip;0;7;11;18
10931;Vėtrungė;Do-re-mi;5217297849;Ne;10;5;0;15
10932;Vėtrungė;Do-re-mi;9079483362;Ne;5;0;0;5
10933;Vėtrungė;Do-re-mi;9271869305;Taip;6;0;1;7
10934;Vėtrungė;Smalsučių;5198153485;Ne;0;1;0;1
10935;Vėtrungė;Smalsučių;9606769599;Ne;10;0;1;11
10936;Vėtrungė;Smalsučių;1611274573;Taip;0;3;0;3
10937;Vėtrungė;Smalsučių;1744400765;Ne;0;3;0;3
10938;Vėtrungė;Smalsučių;68628872682;Taip;0;5;0;5
10939;Vėtrungė;Smalsučių;1630866223;Taip;0;6;1;7
10940;Vėtrungė;Smalsučių;78016704795;Taip;0;6;0;6
10941;Vėtrungė;Smalsučių;29699317546;Taip;0;0;4;4
10942;Vėtrungė;Smalsučių;1370336984;Taip;8;0;0;8
10943;Vėtrungė;Smalsučių;1754493671;Ne;0;0;2;2
10944;Vėtrungė;Smalsučių;1360031121;Taip;0;7;0;7
10945;Vėtrungė;Smalsučių;2145081325;Taip;0;0;6;6
10946;Vėtrungė;Smalsučių;1279678980;Taip;0;2;0;2
10947;Vėtrungė;Smalsučių;70610257897;Taip;0;12;0;12
10948;Vėtrungė;Smalsučių;1474010989;Ne;0;2;0;2
10949;Vėtrungė;Gudručių;1366458234;Taip;5;4;0;9
10950;Vėtrungė;Gudručių;18426639118;Ne;0;1;0;1
10951;Vėtrungė;Gudručių;49220186521;Taip;4;0;0;4
10952;Vėtrungė;Gudručių;8857763201;Taip;0;2;0;2
10953;Vėtrungė;Gudručių;1487142899;Taip;0;5;0;5
10954;Vėtrungė;Gudručių;1021458176;Taip;5;4;0;9
10955;Vėtrungė;Gudručių;1267104594;Taip;8;0;0;8
10956;Vėtrungė;Gudručių;6563805572;Taip;4;1;0;5
10957;Vėtrungė;Gudručių;41508942219;Taip;0;1;0;1
10958;Vėtrungė;Gudručių;1283685496;Ne;0;7;0;7
10959;Vėtrungė;Gudručių;1395153496;Taip;0;4;0;4
10960;Vėtrungė;Gudručių;9395706055;Taip;2;1;0;3
10961;Vėtrungė;Gudručių;1022530443;Taip;0;7;0;7
10962;Vėtrungė;Gudručių;8080668755;Taip;10;0;0;10
10963;Vėtrungė;Gudručių;1456877681;Taip;21;0;0;21
10964;Vėtrungė;Gudručių;63512524250;Ne;0;1;0;1
10965;Vėtrungė;Gudručių;2256130191;Taip;3;1;0;4
10966;Vėtrungė;Gudručių;1610171462;Taip;3;1;0;4
10967;Vėtrungė;Kodėlčių;9172488122;Taip;0;5;0;5
10968;Vėtrungė;Kodėlčių;2739382736;Taip;16;5;0;21
10969;Vėtrungė;Kodėlčių;3903604247;Taip;11;0;0;11
10970;Vėtrungė;Kodėlčių;3500551575;Taip;7;0;0;7
10971;Vėtrungė;Kodėlčių;7872043253;Taip;2;0;2;4
10972;Vėtrungė;Kodėlčių;9852609222;Ne;0;1;0;1
10973;Vėtrungė;Kodėlčių;8465132902;Taip;0;1;0;1
10974;Vėtrungė;Kodėlčių;8859592174;Taip;5;1;0;6
10975;Vėtrungė;Kodėlčių;7022011252;Taip;7;0;0;7
10976;Vėtrungė;Kodėlčių;7862615352;Taip;5;0;0;5
10977;Vėtrungė;Kodėlčių;1540045675;Taip;13;0;0;13
10978;Vėtrungė;Kodėlčių;5385880910;Taip;8;2;0;10
10979;Vėtrungė;Kodėlčių;9211406129;Taip;5;2;0;7
10980;Vėtrungė;Kodėlčių;1032730549;Taip;3;0;0;3
10981;Vėtrungė;Kodėlčių;7511121411;Taip;21;0;0;21
10982;Vėtrungė;Kodėlčių;9127735773;Taip;5;0;2;7
10983;Vėtrungė;Kodėlčių;5830221727;Taip;0;1;0;1
10984;Vėtrungė;Kodėlčių;4756863295;Ne;11;3;0;14
10985;Vėtrungė;Paukštelių;1769926207;Taip;0;1;0;1
10986;Vėtrungė;Paukštelių;2864217098;Taip;0;2;2;4
10987;Vėtrungė;Paukštelių;7921863675;Ne;0;10;0;10
10988;Vėtrungė;Paukštelių;4091719904;Taip;0;6;0;6
10989;Vėtrungė;Paukštelių;4347810256;Taip;3;1;1;5
10990;Vėtrungė;Paukštelių;2482436192;Ne;0;0;1;1
10991;Vėtrungė;Paukštelių;6732632515;Taip;2;0;0;2
10992;Vėtrungė;Paukštelių;3404120492;Taip;0;1;0;1
10993;Vėtrungė;Paukštelių;3721504364;Taip;0;6;1;7
10994;Vėtrungė;Paukštelių;4115995882;Taip;0;6;0;6
10995;Vėtrungė;Paukštelių;5994465833;Taip;4;1;0;5
10996;Vėtrungė;Paukštelių;8721035192;Taip;0;18;1;19
10997;Vėtrungė;Paukštelių;6964225210;Taip;0;1;7;8
10998;Vėtrungė;Paukštelių;1970034012;Ne;7;6;0;13
10999;Vėtrungė;Paukštelių;9962435598;Taip;0;21;0;21
11000;Vėtrungė;Paukštelių;4092242233;Ne;0;1;0;1
11001;Vėtrungė;Paukštelių;1522141057;Taip;5;0;10;15
11002;Vėtrungė;Paukštelių;8154023892;Ne;0;2;0;2
11003;Vėtrungė;Paukštelių;1551989977;Taip;0;5;0;5
11004;Vėtrungė;Viščiukų;3922749661;Taip;0;21;1;22
11005;Vėtrungė;Viščiukų;3744377479;Taip;0;0;4;4
11006;Vėtrungė;Viščiukų;3887230224;Taip;5;0;0;5
11007;Vėtrungė;Viščiukų;5950287989;Taip;2;0;1;3
11008;Vėtrungė;Viščiukų;5539872851;Taip;2;0;0;2
11009;Vėtrungė;Viščiukų;8985054558;Taip;8;1;0;9
11010;Vėtrungė;Viščiukų;2725607774;Taip;8;0;0;8
11011;Vėtrungė;Viščiukų;2933312366;Taip;0;11;0;11
11012;Vėtrungė;Viščiukų;8013249618;Taip;7;7;0;14
11013;Vėtrungė;Viščiukų;7740260264;Taip;0;6;2;8
11014;Vėtrungė;Viščiukų;2123410772;Ne;3;0;5;8
11015;Vėtrungė;Viščiukų;5745974119;Taip;19;2;0;21
11016;Vėtrungė;Viščiukų;8905533826;Taip;0;1;1;2
11017;Vėtrungė;Viščiukų;7186353024;Taip;11;0;2;13
11018;Vėtrungė;Viščiukų;2508501223;Taip;11;5;3;19
11019;Vėtrungė;Viščiukų;5021830780;Taip;9;0;2;11
11020;Vėtrungė;Viščiukų;7958767219;Taip;13;1;0;14
11021;Vėtrungė;Nykštukų;7819147751;Taip;14;7;0;21
11022;Vėtrungė;Nykštukų;6990506209;Taip;17;2;1;20
11023;Vėtrungė;Nykštukų;7306085848;Taip;19;0;4;23
11024;Vėtrungė;Nykštukų;7733472482;Taip;6;0;0;6
11025;Vėtrungė;Nykštukų;2309821873;Taip;17;0;0;17
11026;Vėtrungė;Nykštukų;2364156362;Taip;0;14;0;14
11027;Vėtrungė;Nykštukų;8059553343;Taip;8;5;0;13
11028;Vėtrungė;Nykštukų;4020987532;Taip;19;0;0;19
11029;Vėtrungė;Nykštukų;9569555731;Taip;18;0;0;18
11030;Vėtrungė;Nykštukų;7699392279;Taip;0;12;0;12
11031;Vėtrungė;Meškiukų;2510763357;Taip;10;0;0;10
11032;Vėtrungė;Meškiukų;4713420194;Taip;10;0;0;10
11033;Vėtrungė;Meškiukų;2226654309;Ne;3;4;0;7
11034;Vėtrungė;Meškiukų;7270370939;Taip;1;0;0;1
11035;Vėtrungė;Meškiukų;9543456295;Taip;3;0;0;3
11036;Vėtrungė;Meškiukų;9207846866;Taip;13;0;0;13
11037;Vėtrungė;Meškiukų;9065848425;Taip;5;12;0;17
11038;Vėtrungė;Meškiukų;9685389270;Ne;0;12;0;12
11039;Vėtrungė;Meškiukų;9313438768;Taip;0;7;0;7
11040;Vėtrungė;Meškiukų;3122948974;Taip;6;1;0;7
11041;Vėtrungė;Meškiukų;2880342138;Taip;0;0;1;1
11042;Vėtrungė;Meškiukų;2520926439;Taip;1;0;0;1
11043;Vėtrungė;Meškiukų;7143997258;Taip;0;1;4;5
11044;Vėtrungė;Meškiukų;5123894802;Taip;0;10;0;10
11045;Vėtrungė;Meškiukų;8961791293;Taip;0;8;0;8
11046;Vėtrungė;Meškiukų;2809555356;Taip;0;0;3;3
11047;Vėtrungė;Meškiukų;4624264759;Ne;0;0;2;2
11048;Vėtrungė;Meškiukų;1766599777;Taip;12;0;0;12
11049;Vėtrungė;Meškiukų;4394100006;Taip;5;5;3;13
11050;Vėtrungė;Ąžuoliukų;7813907852;Taip;12;5;1;18
11051;Vėtrungė;Ąžuoliukų;3249689008;Taip;11;4;0;15
11052;Vėtrungė;Ąžuoliukų;7295216791;Taip;0;1;0;1
11053;Vėtrungė;Ąžuoliukų;2440001662;Taip;0;11;0;11
11054;Vėtrungė;Ąžuoliukų;1636432189;Taip;5;0;0;5
11055;Vėtrungė;Ąžuoliukų;7803736567;Ne;0;4;0;4
11056;Vėtrungė;Ąžuoliukų;1042333710;Ne;0;8;0;8
11057;Vėtrungė;Ąžuoliukų;9795630131;Taip;0;0;2;2
11058;Vėtrungė;Ąžuoliukų;6356914122;Ne;0;16;0;16
11059;Vėtrungė;Ąžuoliukų;2636219826;Taip;0;1;0;1
11060;Vėtrungė;Ąžuoliukų;1934540281;Ne;0;0;1;1
11061;Vėtrungė;Ąžuoliukų;6479094819;Taip;8;0;0;8
11062;Vėtrungė;Ąžuoliukų;5367369908;Ne;9;7;0;16
11063;Vėtrungė;Ąžuoliukų;4000379945;Taip;2;2;0;4
11064;Vėtrungė;Ąžuoliukų;1789419548;Ne;0;11;0;11
11065;Vėtrungė;Ąžuoliukų;7363490503;Taip;0;1;0;1
11066;Vėtrungė;Ąžuoliukų;6599281163;Ne;0;10;0;10
11067;Vilnelė;Lakštutė;1720695615;Taip;0;9;0;9
11068;Vilnelė;Lakštutė;2121071276;Taip;0;11;0;11
11069;Vilnelė;Lakštutė;1607330769;Taip;0;10;0;10
11070;Vilnelė;Lakštutė;8820091584;Taip;11;0;0;11
11071;Vilnelė;Lakštutė;8270866998;Taip;0;8;0;8
11072;Vilnelė;Lakštutė;2990112955;Taip;6;1;0;7
11073;Vilnelė;Lakštutė;8593060923;Taip;0;0;8;8
11074;Vilnelė;Lakštutė;3454141069;Taip;0;6;0;6
11075;Vilnelė;Lakštutė;9618342480;Taip;0;7;0;7
11076;Vilnelė;Lakštutė;9369955153;Taip;0;6;0;6
11077;Vilnelė;Lakštutė;6898685834;Taip;0;0;4;4
11078;Vilnelė;Lakštutė;6318246517;Taip;0;16;0;16
11079;Vilnelė;Lakštutė;7387394504;Taip;0;8;0;8
11080;Vilnelė;Lakštutė;1882520335;Ne;0;6;0;6
11081;Vilnelė;Lakštutė;5558584030;Taip;0;1;0;1
11082;Vilnelė;Vyturėlis;5091272908;Taip;0;12;0;12
11083;Vilnelė;Vyturėlis;1133945467;Taip;0;0;3;3
11084;Vilnelė;Vyturėlis;6132739519;Ne;0;4;0;4
11085;Vilnelė;Vyturėlis;1674551092;Taip;0;1;0;1
11086;Vilnelė;Vyturėlis;2131599015;Taip;0;0;15;15
11087;Vilnelė;Vyturėlis;7057183482;Taip;10;0;2;12
11088;Vilnelė;Vyturėlis;8725191514;Taip;0;12;0;12
11089;Vilnelė;Vyturėlis;6308015852;Taip;7;2;0;9
11090;Vilnelė;Vyturėlis;7963783957;Taip;0;2;1;3
11091;Vilnelė;Vyturėlis;5540359276;Taip;0;15;0;15
11092;Vilnelė;Vyturėlis;1966090625;Taip;0;1;0;1
11093;Vilnelė;Vyturėlis;8740717061;Taip;13;0;0;13
11094;Vilnelė;Vyturėlis;3772263873;Taip;0;2;1;3
11095;Vilnelė;Vyturėlis;9183391434;Taip;0;14;0;14
11096;Vilnelė;Vyturėlis;2159103903;Taip;0;11;0;11
11097;Vilnelė;Pagrandukas;5508759323;Taip;0;0;2;2
11098;Vilnelė;Pagrandukas;4295816753;Taip;0;1;0;1
11099;Vilnelė;Pagrandukas;3844066232;Taip;0;8;0;8
11100;Vilnelė;Pagrandukas;6659537454;Taip;10;0;0;10
11101;Vilnelė;Pagrandukas;5953205533;Taip;5;3;0;8
11102;Vilnelė;Pagrandukas;4448413194;Taip;0;0;9;9
11103;Vilnelė;Pagrandukas;6830433856;Ne;0;0;2;2
11104;Vilnelė;Pagrandukas;6982847450;Taip;0;0;2;2
11105;Vilnelė;Pagrandukas;3069192413;Taip;0;6;0;6
11106;Vilnelė;Pagrandukas;3685294539;Taip;10;0;0;10
11107;Vilnelė;Pagrandukas;7882756938;Taip;0;10;0;10
11108;Vilnelė;Pagrandukas;7348404699;Taip;0;6;0;6
11109;Vilnelė;Pagrandukas;3323738649;Ne;0;7;0;7
11110;Vilnelė;Pagrandukas;8116613831;Taip;0;0;3;3
11111;Vilnelė;Pagrandukas;6466321228;Taip;8;0;4;12
11112;Vilnelė;Pagrandukas;4478847902;Taip;7;0;0;7
11113;Vilnelė;Bitutė;7442249956;Ne;5;3;0;8
11114;Vilnelė;Bitutė;5790420711;Taip;0;7;0;7
11115;Vilnelė;Bitutė;1321202650;Ne;11;0;0;11
11116;Vilnelė;Bitutė;8889469645;Taip;0;7;0;7
11117;Vilnelė;Bitutė;9331404812;Taip;0;5;0;5
11118;Vilnelė;Bitutė;2696565855;Taip;0;0;3;3
11119;Vilnelė;Bitutė;20639648308;Taip;0;0;2;2
11120;Vilnelė;Bitutė;1522056886;Taip;0;10;0;10
11121;Vilnelė;Bitutė;64066480740;Taip;0;2;1;3
11122;Vilnelė;Bitutė;71906228270;Taip;0;1;0;1
11123;Vilnelė;Bitutė;41536662155;Taip;3;0;2;5
11124;Vilnelė;Bitutė;7916632244;Taip;0;5;0;5
11125;Vilnelė;Bitutė;85568332595;Ne;0;7;0;7
11126;Vilnelė;Bitutė;16272480270;Taip;10;0;0;10
11127;Vilnelė;Bitutė;1450994872;Ne;0;2;5;7
11128;Vilnelė;Bitutė;67561845041;Taip;4;1;1;6
11129;Vilnelė;Bitutė;22516605873;Taip;0;1;0;1
11130;Vilnelė;Bitutė;73658263243;Ne;0;9;0;9
11131;Vilnelė;Šaltinėlis;1783854203;Taip;13;0;0;13
11132;Vilnelė;Šaltinėlis;5013418313;Taip;9;0;0;9
11133;Vilnelė;Šaltinėlis;42835212158;Taip;0;9;0;9
11134;Vilnelė;Šaltinėlis;98028664140;Taip;5;1;0;6
11135;Vilnelė;Šaltinėlis;7292043157;Taip;0;4;0;4
11136;Vilnelė;Šaltinėlis;6327531229;Taip;0;0;1;1
11137;Vilnelė;Šaltinėlis;2130482375;Taip;0;1;0;1
11138;Vilnelė;Šaltinėlis;9058632601;Taip;0;7;0;7
11139;Vilnelė;Šaltinėlis;1507865281;Taip;0;17;0;17
11140;Vilnelė;Šaltinėlis;39494954188;Taip;0;6;0;6
11141;Vilnelė;Šaltinėlis;8615257084;Taip;4;0;0;4
11142;Vilnelė;Šaltinėlis;6146514112;Taip;5;5;0;10
11143;Vilnelė;Šaltinėlis;9016832316;Taip;7;0;0;7
11144;Vilnelė;Šaltinėlis;1281521052;Taip;14;2;0;16
11145;Vilnelė;Šaltinėlis;8162191913;Ne;0;0;1;1
11146;Vilnelė;Šaltinėlis;3031790547;Taip;0;0;1;1
11147;Vilnelė;Šaltinėlis;4478847902;Taip;6;0;0;6
11148;Vilnelė;Riešutėllis;1027463000;Ne;6;0;0;6
11149;Vilnelė;Riešutėllis;3312254613;Ne;9;5;0;14
11150;Vilnelė;Riešutėllis;7020707723;Taip;0;9;0;9
11151;Vilnelė;Riešutėllis;1960860528;Taip;4;0;1;5
11152;Vilnelė;Riešutėllis;4203549404;Taip;5;0;0;5
11153;Vilnelė;Riešutėllis;3290952017;Taip;9;0;0;9
11154;Vilnelė;Riešutėllis;8588430578;Taip;7;1;0;8
11155;Vilnelė;Riešutėllis;4059247244;Taip;15;0;0;15
11156;Vilnelė;Riešutėllis;8750705826;Taip;4;0;0;4
11157;Vilnelė;Riešutėllis;4780827432;Taip;7;0;0;7
11158;Vilnelė;Riešutėllis;4455099179;Taip;0;6;0;6
11159;Vilnelė;Riešutėllis;2367127222;Taip;13;0;0;13
11160;Vilnelė;Riešutėllis;5306723959;Taip;10;0;0;10
11161;Vilnelė;Riešutėllis;3670613082;Taip;8;1;4;13
11162;Vilnelė;Riešutėllis;6417545510;Taip;11;0;0;11
11163;Vilnelė;Riešutėllis;7085972543;Taip;9;0;0;9
11164;Vilnelė;Riešutėllis;3211657057;Taip;0;7;0;7
11165;Vilnelė;Riešutėllis;9016866597;Ne;6;8;0;14
11166;Vilnelė;Riešutėllis;7087798406;Taip;0;2;11;13
11167;Vilnelė;Riešutėllis;4254744025;Ne;5;0;1;6
11168;Vilnelė;Nykštukas;1336497125;Taip;2;1;0;3
11169;Vilnelė;Nykštukas;32988468324;Taip;0;5;0;5
11170;Vilnelė;Nykštukas;13583637193;Taip;0;3;0;3
11171;Vilnelė;Nykštukas;23442711820;Taip;0;1;0;1
11172;Vilnelė;Nykštukas;47863474499;Taip;0;5;0;5
11173;Vilnelė;Nykštukas;13231410969;Taip;0;0;1;1
11174;Vilnelė;Nykštukas;62208863766;Taip;0;10;0;10
11175;Vilnelė;Nykštukas;36905818484;Taip;0;10;0;10
11176;Vilnelė;Nykštukas;1845336128;Taip;0;2;0;2
11177;Vilnelė;Nykštukas;87094375121;Ne;0;2;0;2
11178;Vilnelė;Nykštukas;15265621906;Taip;0;4;0;4
11179;Vilnelė;Nykštukas;5198859945;Taip;6;0;0;6
11180;Vilnelė;Nykštukas;2131603460;Taip;0;1;3;4
11181;Vilnelė;Nykštukas;2097945353;Ne;0;4;0;4
11182;Vilnelė;Nykštukas;1957418704;Taip;0;4;0;4
11183;Vilnelė;Nykštukas;1572818047;Ne;0;0;1;1
11184;Vilnelė;Nykštukas;9542826636;Ne;0;1;0;1
11185;Vilnelė;Pieštukas;9879688569;Taip;0;6;0;6
11186;Vilnelė;Pieštukas;5473379559;Taip;0;2;1;3
11187;Vilnelė;Pieštukas;1462397783;Taip;0;4;0;4
11188;Vilnelė;Pieštukas;1792586468;Taip;0;0;1;1
11189;Vilnelė;Pieštukas;3781595939;Taip;0;9;0;9
11190;Vilnelė;Pieštukas;3945921490;Taip;0;13;0;13
11191;Vilnelė;Pieštukas;2859160609;Taip;4;0;0;4
11192;Vilnelė;Pieštukas;1730149127;Taip;7;3;0;10
11193;Vilnelė;Pieštukas;6355912551;Taip;2;4;0;6
11194;Vilnelė;Pieštukas;7976798775;Taip;0;2;0;2
11195;Vilnelė;Pieštukas;3811289758;Taip;15;3;0;18
11196;Vilnelė;Pieštukas;5261402753;Taip;0;8;13;21
11197;Vilnelė;Pieštukas;3529718234;Taip;0;2;1;3
11198;Vilnelė;Pieštukas;1880318663;Ne;6;0;0;6
11199;Vilnelė;Pieštukas;9589410276;Ne;6;0;0;6
11200;Vilnelė;Pieštukas;4718994967;Ne;13;0;0;13
11201;Vilnelė;Pieštukas;8092642447;Taip;5;0;0;5
11202;Vilnelė;Voverytė;7536603663;Taip;0;7;0;7
11203;Vilnelė;Voverytė;3503461211;Ne;2;1;0;3
11204;Vilnelė;Voverytė;8667403338;Taip;16;0;0;16
11205;Vilnelė;Voverytė;7883724600;Taip;0;2;0;2
11206;Vilnelė;Voverytė;1351798589;Taip;0;2;0;2
11207;Vilnelė;Voverytė;9162681538;Taip;0;2;1;3
11208;Vilnelė;Voverytė;3075681823;Taip;0;2;0;2
11209;Vilnelė;Voverytė;6342242777;Taip;6;0;0;6
11210;Vilnelė;Voverytė;3843064564;Taip;0;2;0;2
11211;Vilnelė;Voverytė;3558073399;Taip;6;0;0;6
11212;Vilnelė;Voverytė;2923012145;Taip;0;0;2;2
11213;Vilnelė;Voverytė;9804772168;Taip;5;0;0;5
11214;Vilnelė;Voverytė;7338573817;Taip;4;0;6;10
11215;Vilnelė;Voverytė;8121075430;Ne;5;6;0;11
11216;Vilnelė;Voverytė;1574809879;Taip;11;0;0;11
11217;Vilnelė;Voverytė;6083082959;Taip;0;2;1;3
11218;Vilnelė;Kodėlčiukas;4642378600;Taip;11;0;2;13
11219;Vilnelė;Kodėlčiukas;8415801333;Taip;0;4;0;4
11220;Vilnelė;Kodėlčiukas;6618109352;Taip;0;16;0;16
11221;Vilnelė;Kodėlčiukas;6715997340;Taip;10;0;0;10
11222;Vilnelė;Kodėlčiukas;9482133396;Taip;10;0;1;11
11223;Vilnelė;Kodėlčiukas;8620789304;Taip;10;0;0;10
11224;Vilnelė;Kodėlčiukas;8439505238;Taip;0;0;4;4
11225;Vilnelė;Kodėlčiukas;1580287517;Ne;0;0;1;1
11226;Vilnelė;Kodėlčiukas;5558378376;Taip;0;14;0;14
11227;Vilnelė;Kodėlčiukas;4328263940;Taip;5;0;0;5
11228;Vilnelė;Kodėlčiukas;3056845279;Taip;9;4;0;13
11229;Vilnelė;Kodėlčiukas;9537740492;Taip;13;0;1;14
11230;Vilnelė;Kodėlčiukas;9640330864;Taip;0;0;7;7
11231;Vilnelė;Kodėlčiukas;3848720970;Taip;0;0;2;2
11232;Vilnelė;Kodėlčiukas;7833531435;Taip;0;0;2;2
11233;Vilnelė;Kodėlčiukas;5961910077;Taip;6;0;0;6
11234;Vilnelė;Kodėlčiukas;2879614195;Taip;0;5;0;5
11235;Vilnelė;Kodėlčiukas;3115242919;Taip;5;0;3;8
11236;Vilnelė;Kodėlčiukas;8543995029;Taip;0;0;1;1
11237;Vilnelė;Kodėlčiukas;1933660272;Taip;6;0;3;9
11238;Vilnelė;Kodėlčiukas;4986079102;Ne;0;0;3;3
11239;Vilnelė;Žirniukas;6448119003;Taip;0;1;0;1
11240;Vilnelė;Žirniukas;1547117566;Taip;0;11;0;11
11241;Vilnelė;Žirniukas;4427383755;Taip;0;11;0;11
11242;Vilnelė;Žirniukas;1554473199;Ne;6;1;0;7
11243;Vilnelė;Žirniukas;6249731759;Ne;0;17;0;17
11244;Vilnelė;Žirniukas;6837850601;Taip;3;1;0;4
11245;Vilnelė;Žirniukas;9635159885;Taip;7;2;1;10
11246;Vilnelė;Žirniukas;5554451335;Taip;10;1;0;11
11247;Vilnelė;Žirniukas;1819154122;Taip;15;0;1;16
11248;Vilnelė;Žirniukas;4060927733;Taip;10;0;0;10
11249;Vilnelė;Žirniukas;8625074554;Taip;10;5;0;15
11250;Vilnelė;Žirniukas;2299381653;Taip;0;9;0;9
11251;Vilnelė;Žirniukas;5041031750;Taip;10;0;1;11
11252;Vilnelė;Žirniukas;4516818999;Taip;6;0;1;7
11253;Vilnelė;Žirniukas;5786086401;Ne;2;1;0;3
11254;Vilnelė;Žirniukas;8579294202;Ne;0;18;0;18
11255;Vilnelė;Žirniukas;7702217893;Ne;7;0;0;7
11256;Vilnelė;Pipiras;6686896190;Taip;10;1;0;11
11257;Vilnelė;Pipiras;6054488692;Taip;8;1;0;9
11258;Vilnelė;Pipiras;6048991617;Ne;0;0;4;4
11259;Vilnelė;Pipiras;2872732978;Taip;0;4;0;4
11260;Vilnelė;Pipiras;7545281994;Taip;7;0;1;8
11261;Vilnelė;Pipiras;3900484348;Taip;0;2;3;5
11262;Vilnelė;Pipiras;3221157300;Taip;0;13;0;13
11263;Vilnelė;Pipiras;3231387543;Taip;9;0;0;9
11264;Vilnelė;Pipiras;7161529969;Taip;0;1;0;1
11265;Vilnelė;Pipiras;3720979747;Taip;4;0;0;4
11266;Vilnelė;Pipiras;8493390146;Taip;1;2;0;3
11267;Vilnelė;Pipiras;5173602064;Ne;6;0;0;6
11268;Vilnelė;Pipiras;3142594542;Ne;6;0;0;6
11269;Vilnelė;Pipiras;3032273912;Taip;0;10;0;10
11270;Vilnelė;Pipiras;1734277231;Ne;0;5;0;5
11271;Vilnelė;Pipiras;5498574366;Taip;0;6;0;6
11272;Vėrinėlis;GAIDELIAI;2529641529;Ne;0;19;0;19
11273;Vėrinėlis;GAIDELIAI;4390098560;Taip;0;0;1;1
11274;Vėrinėlis;GAIDELIAI;4666918175;Taip;10;6;0;16
11275;Vėrinėlis;GAIDELIAI;2774618380;Ne;2;1;0;3
11276;Vėrinėlis;GAIDELIAI;5429955166;Taip;0;9;0;9
11277;Vėrinėlis;GAIDELIAI;5209398043;Ne;0;12;0;12
11278;Vėrinėlis;GAIDELIAI;8213498951;Ne;2;0;0;2
11279;Vėrinėlis;GAIDELIAI;6136232912;Taip;11;8;0;19
11280;Vėrinėlis;GAIDELIAI;7092421890;Taip;0;3;0;3
11281;Vėrinėlis;GAIDELIAI;6058712578;Taip;6;0;1;7
11282;Vėrinėlis;GAIDELIAI;1164396960;Ne;0;0;1;1
11283;Vėrinėlis;GAIDELIAI;2857591912;Ne;0;0;6;6
11284;Vėrinėlis;GAIDELIAI;6413701823;Ne;4;0;0;4
11285;Vėrinėlis;GAIDELIAI;2467700639;Taip;20;0;0;20
11286;Vėrinėlis;GAIDELIAI;5720076968;Ne;15;0;0;15
11287;Vėrinėlis;GAIDELIAI;4183077476;Taip;0;5;0;5
11288;Vėrinėlis;GAIDELIAI;4925983616;Ne;0;0;3;3
11289;Vėrinėlis;SAULUTĖ;6866592245;Taip;5;2;1;8
11290;Vėrinėlis;SAULUTĖ;2732572235;Ne;5;0;3;8
11291;Vėrinėlis;SAULUTĖ;1386916991;Taip;15;0;0;15
11292;Vėrinėlis;SAULUTĖ;7224418233;Ne;0;13;0;13
11293;Vėrinėlis;SAULUTĖ;3130841241;Ne;8;0;1;9
11294;Vėrinėlis;SAULUTĖ;6435612222;Ne;0;9;2;11
11295;Vėrinėlis;SAULUTĖ;3316897176;Ne;0;7;0;7
11296;Vėrinėlis;SAULUTĖ;3810261864;Ne;2;0;10;12
11297;Vėrinėlis;SAULUTĖ;4191386053;Ne;0;1;0;1
11298;Vėrinėlis;SAULUTĖ;9798993200;Taip;0;2;0;2
11299;Vėrinėlis;SAULUTĖ;9612956692;Ne;5;2;0;7
11300;Vėrinėlis;SAULUTĖ;8238013636;Taip;14;0;0;14
11301;Vėrinėlis;SAULUTĖ;2337883071;Ne;10;0;0;10
11302;Vėrinėlis;SAULUTĖ;6913001318;Ne;5;2;0;7
11303;Vėrinėlis;SAULUTĖ;4728119881;Ne;4;0;0;4
11304;Vėrinėlis;SAULUTĖ;3349199472;Taip;8;0;2;10
11305;Vėrinėlis;SAULUTĖ;3882915774;Ne;0;6;0;6
11306;Vėrinėlis;NYKŠTUKAI;9604483237;Taip;5;0;6;11
11307;Vėrinėlis;NYKŠTUKAI;6220653152;Ne;0;0;1;1
11308;Vėrinėlis;NYKŠTUKAI;6869951613;Taip;0;0;1;1
11309;Vėrinėlis;NYKŠTUKAI;6644892686;Ne;9;0;1;10
11310;Vėrinėlis;NYKŠTUKAI;7981261038;Taip;0;0;3;3
11311;Vėrinėlis;NYKŠTUKAI;1513856520;Taip;0;0;8;8
11312;Vėrinėlis;NYKŠTUKAI;1395590011;Ne;0;0;5;5
11313;Vėrinėlis;NYKŠTUKAI;5960946826;Taip;7;0;3;10
11314;Vėrinėlis;NYKŠTUKAI;19865450007;Ne;0;0;2;2
11315;Vėrinėlis;NYKŠTUKAI;5496928903;Ne;12;0;1;13
11316;Vėrinėlis;NYKŠTUKAI;3975934329;Ne;0;0;1;1
11317;Vėrinėlis;NYKŠTUKAI;5511584499;Taip;5;10;0;15
11318;Vėrinėlis;NYKŠTUKAI;4958359640;Taip;0;0;1;1
11319;Vėrinėlis;NYKŠTUKAI;3562371502;Taip;21;0;0;21
11320;Vėrinėlis;NYKŠTUKAI;9751037428;Ne;0;5;0;5
11321;Vėrinėlis;NYKŠTUKAI;4089567420;Ne;0;0;1;1
11322;Vėrinėlis;NYKŠTUKAI;8579819581;Ne;5;3;0;8
11323;Vėrinėlis;NYKŠTUKAI;2087129236;Taip;0;0;1;1
11324;Vėrinėlis;NYKŠTUKAI;7371908331;Taip;0;0;5;5
11325;Vėrinėlis;BURATINAS;4067153819;Taip;0;0;12;12
11326;Vėrinėlis;BURATINAS;9266953028;Ne;0;1;0;1
11327;Vėrinėlis;BURATINAS;9119967823;Taip;0;0;3;3
11328;Vėrinėlis;BURATINAS;5712568063;Ne;0;0;2;2
11329;Vėrinėlis;BURATINAS;1467899937;Taip;0;12;0;12
11330;Vėrinėlis;BURATINAS;7634939364;Taip;0;5;0;5
11331;Vėrinėlis;BURATINAS;3049346950;Taip;0;0;17;17
11332;Vėrinėlis;BURATINAS;8652292752;Taip;0;5;0;5
11333;Vėrinėlis;BURATINAS;4039903678;Taip;0;0;4;4
11334;Vėrinėlis;BURATINAS;7167034587;Ne;0;0;1;1
11335;Vėrinėlis;BURATINAS;7093959212;Taip;0;0;1;1
11336;Vėrinėlis;BURATINAS;8885866108;Taip;0;0;3;3
11337;Vėrinėlis;BURATINAS;8100283579;Taip;0;1;0;1
11338;Vėrinėlis;BURATINAS;8728166391;Ne;7;0;3;10
11339;Vėrinėlis;BURATINAS;7078114492;Taip;0;7;0;7
11340;Vėrinėlis;BURATINAS;6280508974;Taip;0;7;0;7
11341;Vėrinėlis;GINTARĖLIAI;1465052758;Taip;16;1;0;17
11342;Vėrinėlis;GINTARĖLIAI;97559214584;Ne;3;0;0;3
11343;Vėrinėlis;GINTARĖLIAI;5238619411;Ne;0;2;0;2
11344;Vėrinėlis;GINTARĖLIAI;1029210296;Ne;0;1;0;1
11345;Vėrinėlis;GINTARĖLIAI;92480758419;Taip;7;1;0;8
11346;Vėrinėlis;GINTARĖLIAI;8955109359;Ne;0;1;0;1
11347;Vėrinėlis;GINTARĖLIAI;63333257753;Taip;6;0;0;6
11348;Vėrinėlis;GINTARĖLIAI;38428514086;Taip;0;2;0;2
11349;Vėrinėlis;GINTARĖLIAI;7436873997;Taip;6;1;0;7
11350;Vėrinėlis;GINTARĖLIAI;4229867189;Taip;1;0;0;1
11351;Vėrinėlis;GINTARĖLIAI;41029899086;Taip;0;1;0;1
11352;Vėrinėlis;GINTARĖLIAI;11459693163;Taip;10;0;0;10
11353;Vėrinėlis;GINTARĖLIAI;1261337457;Taip;0;3;0;3
11354;Vėrinėlis;GINTARĖLIAI;1518907235;Taip;0;1;0;1
11355;Vėrinėlis;GINTARĖLIAI;3563944204;Ne;3;0;0;3
11356;Vėrinėlis;RAMUNĖLĖS;1803838403;Taip;3;0;0;3
11357;Vėrinėlis;RAMUNĖLĖS;71830611159;Ne;5;0;0;5
11358;Vėrinėlis;RAMUNĖLĖS;39153716711;Ne;0;1;0;1
11359;Vėrinėlis;RAMUNĖLĖS;1086306523;Ne;0;7;0;7
11360;Vėrinėlis;RAMUNĖLĖS;6148700823;Ne;0;7;0;7
11361;Vėrinėlis;RAMUNĖLĖS;4415030161;Taip;8;4;0;12
11362;Vėrinėlis;RAMUNĖLĖS;9751494612;Ne;0;5;0;5
11363;Vėrinėlis;RAMUNĖLĖS;4727265555;Ne;11;5;0;16
11364;Vėrinėlis;RAMUNĖLĖS;8620836106;Taip;15;0;0;15
11365;Vėrinėlis;RAMUNĖLĖS;1897451825;Ne;0;4;0;4
11366;Vėrinėlis;RAMUNĖLĖS;5003344894;Ne;0;0;1;1
11367;Vėrinėlis;RAMUNĖLĖS;7071043164;Ne;0;0;3;3
11368;Vėrinėlis;RAMUNĖLĖS;9500715949;Taip;0;0;3;3
11369;Vėrinėlis;RAMUNĖLĖS;1493604303;Ne;0;3;0;3
11370;Vėrinėlis;RAMUNĖLĖS;9391697537;Taip;5;0;0;5
11371;Vėrinėlis;RAMUNĖLĖS;8922728881;Ne;5;1;0;6
11372;Vėrinėlis;RAMUNĖLĖS;5434506594;Ne;0;0;1;1
11373;Vėrinėlis;RAMUNĖLĖS;5041189990;Ne;10;0;0;10
11374;Vėrinėlis;KODELČIUKŲ;95040879760;Ne;0;0;5;5
11375;Vėrinėlis;KODELČIUKŲ;7070058961;Taip;0;0;1;1
11376;Vėrinėlis;KODELČIUKŲ;3308843618;Taip;0;7;0;7
11377;Vėrinėlis;KODELČIUKŲ;79317384797;Ne;0;5;0;5
11378;Vėrinėlis;KODELČIUKŲ;1535567719;Ne;5;0;0;5
11379;Vėrinėlis;KODELČIUKŲ;65408541019;Ne;0;1;0;1
11380;Vėrinėlis;KODELČIUKŲ;67987598880;Taip;15;0;5;20
11381;Vėrinėlis;KODELČIUKŲ;7431541945;Taip;5;0;9;14
11382;Vėrinėlis;KODELČIUKŲ;3703886468;Ne;0;0;1;1
11383;Vėrinėlis;KODELČIUKŲ;1028568095;Taip;0;2;0;2
11384;Vėrinėlis;KODELČIUKŲ;1170817811;Ne;19;0;0;19
11385;Vėrinėlis;KODELČIUKŲ;54361215161;Taip;0;0;2;2
11386;Vėrinėlis;KODELČIUKŲ;8755941866;Taip;0;11;3;14
11387;Vėrinėlis;KODELČIUKŲ;9686481278;Taip;0;0;1;1
11388;Vėrinėlis;KODELČIUKŲ;42298331453;Taip;0;5;0;5
11389;Vėrinėlis;KODELČIUKŲ;2944010445;Ne;6;0;8;14
11390;Vėrinėlis;KODELČIUKŲ;85262495209;Taip;0;2;0;2
11391;Vėrinėlis;KODELČIUKŲ;8709714647;Taip;6;0;1;7
11392;Vėrinėlis;ŽIRNIUKAI;3074835599;Ne;0;0;1;1
11393;Vėrinėlis;ŽIRNIUKAI;1769852084;Taip;3;0;3;6
11394;Vėrinėlis;ŽIRNIUKAI;4981127515;Ne;3;0;1;4
11395;Vėrinėlis;ŽIRNIUKAI;2815770695;Taip;20;0;0;20
11396;Vėrinėlis;ŽIRNIUKAI;8329989952;Ne;0;0;5;5
11397;Vėrinėlis;ŽIRNIUKAI;3202518504;Taip;0;0;2;2
11398;Vėrinėlis;ŽIRNIUKAI;8824435889;Ne;0;0;1;1
11399;Vėrinėlis;ŽIRNIUKAI;4752902173;Ne;0;3;0;3
11400;Vėrinėlis;ŽIRNIUKAI;7237945125;Ne;0;0;1;1
11401;Vėrinėlis;ŽIRNIUKAI;5600815908;Ne;21;0;0;21
11402;Vėrinėlis;ŽIRNIUKAI;7367485961;Taip;0;0;2;2
11403;Vėrinėlis;ŽIRNIUKAI;6576726481;Taip;0;8;0;8
11404;Vėrinėlis;ŽIRNIUKAI;8397025332;Taip;0;8;0;8
11405;Vėrinėlis;ŽIRNIUKAI;1736733257;Ne;0;0;2;2
11406;Vėrinėlis;ŽIRNIUKAI;2687583764;Ne;9;0;0;9
11407;Vėrinėlis;ŽIRNIUKAI;2633143128;Taip;0;0;2;2
11408;Vėrinėlis;ŽIRNIUKAI;9419245081;Ne;0;0;3;3
11409;Vėrinėlis;ŽIRNIUKAI;7573209012;Ne;0;0;1;1
11410;Vėrinėlis;ŽIRNIUKAI;7817387800;Ne;7;0;0;7
11411;Vėrinėlis;VARPELIAI;9009344779;Ne;0;10;0;10
11412;Vėrinėlis;VARPELIAI;9289003583;Ne;5;3;0;8
11413;Vėrinėlis;VARPELIAI;1684203955;Taip;5;3;0;8
11414;Vėrinėlis;VARPELIAI;5942475043;Taip;14;0;0;14
11415;Vėrinėlis;VARPELIAI;7364698713;Ne;0;0;2;2
11416;Vėrinėlis;VARPELIAI;7416041207;Taip;0;1;0;1
11417;Vėrinėlis;VARPELIAI;8655158155;Ne;0;4;0;4
11418;Vėrinėlis;VARPELIAI;2369434537;Taip;6;0;0;6
11419;Vėrinėlis;VARPELIAI;7440020169;Ne;0;6;0;6
11420;Vėrinėlis;VARPELIAI;4059906525;Taip;5;0;0;5
11421;Vėrinėlis;VARPELIAI;3832662507;Taip;5;0;0;5
11422;Vėrinėlis;VARPELIAI;7913975075;Taip;0;0;2;2
11423;Vėrinėlis;BORUŽĖLĖS;8759487574;Ne;0;7;0;7
11424;Vėrinėlis;BORUŽĖLĖS;4819016753;Ne;8;0;0;8
11425;Vėrinėlis;BORUŽĖLĖS;1910385020;Taip;9;0;0;9
11426;Vėrinėlis;BORUŽĖLĖS;2078857084;Ne;3;0;3;6
11427;Vėrinėlis;BORUŽĖLĖS;3934652683;Taip;17;0;1;18
11428;Vėrinėlis;BORUŽĖLĖS;6904733283;Taip;6;0;2;8
11429;Vėrinėlis;BORUŽĖLĖS;4446546335;Ne;5;0;4;9
11430;Vėrinėlis;BORUŽĖLĖS;8904833339;Ne;14;2;0;16
11431;Vėrinėlis;BORUŽĖLĖS;3312501759;Ne;14;2;0;16
11432;Vėrinėlis;BORUŽĖLĖS;9217188911;Taip;0;11;0;11
11433;Vėrinėlis;BORUŽĖLĖS;7414937335;Taip;0;15;0;15
11434;Vėrinėlis;BORUŽĖLĖS;2574507205;Ne;17;0;1;18
11435;Vėrinėlis;BORUŽĖLĖS;6671382987;Ne;5;9;0;14
11436;Vėrinėlis;BORUŽĖLĖS;3200007674;Taip;5;0;0;5
11437;Vėrinėlis;BORUŽĖLĖS;4852563692;Taip;0;6;0;6
11438;Vėrinėlis;BORUŽĖLĖS;7953446502;Taip;6;0;0;6
11439;Vėrinėlis;BORUŽĖLĖS;1712926391;Taip;15;0;0;15
11440;Vėrinėlis;BORUŽĖLĖS;5865529907;Taip;16;0;0;16
11441;Vėrinėlis;BORUŽĖLĖS;9613642664;Taip;0;0;2;2
11442;Vėrinėlis;SVEIKUOLIAI;1909742394;Ne;0;0;21;21
11443;Vėrinėlis;SVEIKUOLIAI;6176308531;Taip;0;0;12;12
11444;Vėrinėlis;SVEIKUOLIAI;3070965434;Taip;0;0;1;1
11445;Vėrinėlis;SVEIKUOLIAI;6154618103;Taip;0;0;2;2
11446;Vėrinėlis;SVEIKUOLIAI;3563114419;Taip;6;0;9;15
11447;Vėrinėlis;SVEIKUOLIAI;3973272659;Ne;0;0;13;13
11448;Vėrinėlis;SVEIKUOLIAI;8032396191;Ne;0;0;4;4
11449;Vėrinėlis;SVEIKUOLIAI;6504377326;Ne;0;0;17;17
11450;Vėrinėlis;SVEIKUOLIAI;8716965452;Ne;0;0;11;11
11451;Vėrinėlis;SVEIKUOLIAI;7584124339;Taip;7;0;8;15
11452;Vėrinėlis;SVEIKUOLIAI;9352630743;Ne;0;0;13;13
11453;Vėrinėlis;SVEIKUOLIAI;4859330774;Ne;0;0;21;21
11454;Vėrinėlis;SVEIKUOLIAI;8543081245;Ne;0;0;13;13
11455;Vėrinėlis;SVEIKUOLIAI;1800434426;Taip;0;0;1;1
11456;Vėrinėlis;SVEIKUOLIAI;5456922203;Ne;0;0;9;9
11457;Vėrinėlis;SVEIKUOLIAI;8483525051;Ne;0;0;2;2
11458;Vėrinėlis;SVEIKUOLIAI;5539714292;Taip;10;0;6;16
11459;Vėrinėlis;ŠIRDELĖS;4378592116;Taip;10;0;1;11
11460;Vėrinėlis;ŠIRDELĖS;9202471939;Ne;0;4;0;4
11461;Vėrinėlis;ŠIRDELĖS;1615837863;Ne;0;4;0;4
11462;Vėrinėlis;ŠIRDELĖS;1841277321;Taip;6;0;0;6
11463;Vėrinėlis;ŠIRDELĖS;5588658517;Taip;0;3;0;3
11464;Vėrinėlis;ŠIRDELĖS;1152010178;Taip;9;0;1;10
11465;Vėrinėlis;ŠIRDELĖS;9375922889;Taip;2;0;0;2
11466;Vėrinėlis;ŠIRDELĖS;5813009126;Taip;8;0;0;8
11467;Viltenė;Drugeliai;2392304909;Taip;5;2;0;7
11468;Viltenė;Drugeliai;2410868015;Taip;11;6;0;17
11469;Viltenė;Drugeliai;8679787688;Taip;0;3;0;3
11470;Viltenė;Drugeliai;4616047113;Taip;0;1;0;1
11471;Viltenė;Drugeliai;6810811656;Taip;0;2;0;2
11472;Viltenė;Drugeliai;9228677568;Taip;0;2;0;2
11473;Viltenė;Drugeliai;3905014810;Ne;0;16;0;16
11474;Viltenė;Drugeliai;4121448859;Taip;0;4;0;4
11475;Viltenė;Drugeliai;9157616307;Ne;3;2;0;5
11476;Viltenė;Drugeliai;9476132305;Taip;17;0;0;17
11477;Viltenė;Drugeliai;5522245968;Taip;0;1;0;1
11478;Viltenė;Drugeliai;7401460248;Taip;0;1;0;1
11479;Viltenė;Boružėlių;8473588098;Taip;9;7;0;16
11480;Viltenė;Boružėlių;3995418079;Taip;7;7;0;14
11481;Viltenė;Boružėlių;1399653129;Taip;0;1;0;1
11482;Viltenė;Boružėlių;7526555727;Taip;0;15;0;15
11483;Viltenė;Boružėlių;1936628249;Taip;0;1;0;1
11484;Viltenė;Boružėlių;7912396297;Taip;0;4;0;4
11485;Viltenė;Boružėlių;4036109404;Taip;0;11;0;11
11486;Viltenė;Boružėlių;4604298036;Taip;0;11;0;11
11487;Viltenė;Boružėlių;9242034622;Taip;0;1;0;1
11488;Viltenė;Boružėlių;5280690534;Taip;0;1;0;1
11489;Viltenė;Boružėlių;6621273812;Taip;0;4;0;4
11490;Viltenė;Boružėlių;1496943250;Ne;0;2;0;2
11491;Viltenė;Gandriukų;6481491422;Taip;3;0;2;5
11492;Viltenė;Gandriukų;2884698447;Taip;0;7;0;7
11493;Viltenė;Gandriukų;6060648988;Taip;5;0;0;5
11494;Viltenė;Gandriukų;1840626621;Taip;0;7;0;7
11495;Viltenė;Gandriukų;8549631247;Taip;5;1;0;6
11496;Viltenė;Gandriukų;7796422726;Taip;0;1;0;1
11497;Viltenė;Gandriukų;6511850468;Taip;5;2;0;7
11498;Viltenė;Gandriukų;4945108189;Taip;5;1;0;6
11499;Viltenė;Gandriukų;5850652322;Taip;0;2;0;2
11500;Viltenė;Gandriukų;8110413064;Taip;2;2;0;4
11501;Viltenė;Gandriukų;1243595112;Ne;6;1;0;7
11502;Viltenė;Gandriukų;3073228245;Taip;0;1;7;8
11503;Viltenė;Gandriukų;4468743044;Ne;0;7;0;7
11504;Viltenė;Gandriukų;6355857716;Ne;0;0;1;1
11505;Viltenė;Aitvariukai;3580530152;Ne;0;5;0;5
11506;Viltenė;Aitvariukai;3925021238;Ne;0;7;0;7
11507;Viltenė;Aitvariukai;5083515613;Ne;13;0;0;13
11508;Viltenė;Aitvariukai;2137929911;Taip;4;1;0;5
11509;Viltenė;Aitvariukai;9185054066;Taip;8;0;0;8
11510;Viltenė;Aitvariukai;2502099784;Taip;0;15;0;15
11511;Viltenė;Aitvariukai;5599943846;Taip;13;0;0;13
11512;Viltenė;Aitvariukai;6721689684;Taip;0;2;0;2
11513;Viltenė;Aitvariukai;6296509460;Taip;0;3;0;3
11514;Viltenė;Aitvariukai;2702489251;Taip;7;4;0;11
11515;Viltenė;Aitvariukai;3908574248;Taip;6;7;0;13
11516;Viltenė;Geniukų;5604263567;Taip;0;9;0;9
11517;Viltenė;Geniukų;1822220265;Ne;0;3;0;3
11518;Viltenė;Geniukų;1423254631;Ne;0;3;0;3
11519;Viltenė;Geniukų;3002690526;Taip;0;3;0;3
11520;Viltenė;Geniukų;6276349499;Taip;0;1;0;1
11521;Viltenė;Geniukų;3711956659;Taip;0;2;0;2
11522;Viltenė;Geniukų;1054469254;Taip;0;1;0;1
11523;Viltenė;Geniukų;6063181025;Taip;0;1;0;1
11524;Viltenė;Geniukų;1672091332;Taip;18;0;0;18
11525;Viltenė;Geniukų;49998813869;Taip;0;5;0;5
11526;Viltenė;Geniukų;3389110405;Taip;0;2;0;2
11527;Viltenė;Geniukų;4319685140;Ne;3;3;0;6
11528;Viltenė;Geniukų;8125023386;Taip;0;7;0;7
11529;Viltenė;Geniukų;9035687504;Taip;0;4;0;4
11530;Viltenė;Geniukų;1629377078;Taip;0;5;0;5
11531;Viltenė;Saulutės;6848403057;Taip;0;1;0;1
11532;Viltenė;Saulutės;1615415742;Taip;0;2;0;2
11533;Viltenė;Saulutės;7994367286;Ne;5;0;3;8
11534;Viltenė;Saulutės;2141002432;Taip;0;4;0;4
11535;Viltenė;Saulutės;1362308882;Ne;0;2;0;2
11536;Viltenė;Saulutės;8920533673;Taip;5;1;0;6
11537;Viltenė;Saulutės;5024192785;Taip;0;11;0;11
11538;Viltenė;Saulutės;1918867591;Ne;0;5;0;5
11539;Viltenė;Saulutės;7559243300;Taip;5;3;0;8
11540;Viltenė;Saulutės;8512665706;Taip;0;1;0;1
11541;Viltenė;Saulutės;3560474943;Taip;0;7;0;7
11542;Viltenė;Saulutės;1252657362;Taip;5;5;0;10
11543;Viltenė;Saulutės;2559945034;Taip;15;1;0;16
11544;Viltenė;Saulutės;9055821628;Taip;0;5;0;5
11545;Viltenė;Saulutės;9858998005;Taip;0;5;0;5
11546;Viltenė;Saulutės;7726650894;Taip;4;3;0;7
11547;Viltenė;Saulutės;1841732416;Taip;10;1;0;11
11548;Viltenė;Saulutės;3008272979;Taip;0;4;0;4
11549;Viltenė;Lapiukų;2016636764;Taip;4;1;0;5
11550;Viltenė;Lapiukų;1650304982;Taip;0;2;0;2
11551;Viltenė;Lapiukų;89844531860;Taip;0;1;0;1
11552;Viltenė;Lapiukų;8261531943;Taip;0;2;0;2
11553;Viltenė;Lapiukų;60092202534;Taip;10;3;0;13
11554;Viltenė;Lapiukų;22318027000;Taip;10;0;0;10
11555;Viltenė;Lapiukų;1559623914;Taip;0;1;0;1
11556;Viltenė;Lapiukų;1042196397;Taip;0;3;0;3
11557;Viltenė;Lapiukų;1210824560;Taip;0;2;0;2
11558;Viltenė;Lapiukų;2065651722;Taip;6;0;0;6
11559;Viltenė;Lapiukų;87698700338;Taip;0;1;0;1
11560;Viltenė;Lapiukų;3526237179;Ne;0;7;0;7
11561;Viltenė;Lapiukų;1662950901;Taip;0;6;0;6
11562;Viltenė;Lapiukų;1350487577;Ne;0;1;0;1
11563;Viltenė;Lapiukų;1592077335;Taip;0;6;1;7
11564;Viltenė;Lapiukų;1281808784;Taip;6;1;0;7
11565;Viltenė;Lapiukų;4470172666;Taip;10;3;0;13
11566;Viltenė;Lapiukų;2527648089;Taip;0;1;0;1
11567;Viltenė;Lapiukų;93894985640;Ne;10;5;0;15
11568;Viltenė;Lapiukų;8329611036;Ne;0;5;0;5
11569;Viltenė;Lapiukų;3057761137;Ne;9;2;0;11
11570;Viltenė;Lapiukų;2900870024;Ne;0;0;3;3
11571;Viltenė;Voveriukai;8732323660;Taip;0;9;0;9
11572;Viltenė;Voveriukai;13795858727;Ne;0;7;0;7
11573;Viltenė;Voveriukai;1306624353;Taip;3;2;0;5
11574;Viltenė;Voveriukai;69110885244;Taip;0;11;0;11
11575;Viltenė;Voveriukai;69918162258;Taip;6;0;0;6
11576;Viltenė;Voveriukai;76569470768;Taip;0;1;1;2
11577;Viltenė;Voveriukai;1262222404;Ne;0;5;1;6
11578;Viltenė;Voveriukai;7245395388;Taip;10;1;0;11
11579;Viltenė;Voveriukai;77847693433;Taip;0;0;1;1
11580;Viltenė;Voveriukai;92175043385;Taip;0;0;1;1
11581;Viltenė;Voveriukai;35466181637;Ne;0;3;0;3
11582;Viltenė;Voveriukai;68243828276;Taip;0;0;4;4
11583;Viltenė;Voveriukai;1615151982;Taip;0;6;0;6
11584;Viltenė;Voveriukai;51997485918;Ne;0;7;0;7
11585;Viltenė;Voveriukai;1872042290;Taip;0;10;0;10
11586;Viltenė;Voveriukai;1926586646;Ne;0;12;0;12
11587;Viltenė;Voveriukai;2008408325;Ne;6;3;0;9
11588;Viltenė;Voveriukai;4441280059;Taip;5;0;0;5
11589;Viltenė;Voveriukai;6160715081;Taip;0;16;0;16
11590;Viltenė;Voveriukai;1712349973;Taip;4;0;0;4
11591;Viltenė;Voveriukai;9155192250;Taip;0;8;0;8
11592;Viltenė;Voveriukai;1532633795;Ne;4;6;0;10
11593;Viltenė;Kiškučiai;6040634853;Taip;20;0;0;20
11594;Viltenė;Kiškučiai;1888167096;Taip;0;6;0;6
11595;Viltenė;Kiškučiai;2013415571;Taip;0;5;0;5
11596;Viltenė;Kiškučiai;2642080849;Taip;6;1;0;7
11597;Viltenė;Kiškučiai;2192673126;Taip;8;0;0;8
11598;Viltenė;Nykštukų;5818645490;Taip;0;0;1;1
11599;Viltenė;Nykštukų;3679704404;Taip;0;11;0;11
11600;Viltenė;Nykštukų;4243501722;Taip;0;2;0;2
11601;Viltenė;Nykštukų;9063994291;Taip;0;1;0;1
11602;Viltenė;Nykštukų;7993258845;Taip;0;0;3;3
11603;Viltenė;Nykštukų;1890096287;Taip;0;0;2;2
11604;Viltenė;Nykštukų;9846205631;Taip;6;0;1;7
11605;Viltenė;Nykštukų;9424773418;Taip;2;0;3;5
11606;Viltenė;Triušiukai;8696698257;Taip;5;0;0;5
11607;Viltenė;Triušiukai;2660622296;Taip;0;4;0;4
11608;Viltenė;Triušiukai;4550915388;Taip;9;1;0;10
11609;Viltenė;Triušiukai;8122878153;Taip;2;5;2;9
11610;Viltenė;Triušiukai;3473533533;Taip;0;2;0;2
11611;Viltenė;Triušiukai;6379567497;Taip;0;1;0;1
11612;Viltenė;Triušiukai;8248514570;Taip;8;0;0;8
11613;Viltenė;Triušiukai;2878124826;Taip;7;0;0;7
11614;Viltenė;Triušiukai;8278572246;Taip;16;0;0;16
11615;Viltenė;Triušiukai;9573891616;Taip;0;7;0;7
11616;Voveraitė;ŽVIRBLIUKŲ;6684234832;Taip;0;0;7;7
11617;Voveraitė;ŽVIRBLIUKŲ;8119493388;Taip;0;13;0;13
11618;Voveraitė;ŽVIRBLIUKŲ;5804351872;Ne;0;0;3;3
11619;Voveraitė;ŽVIRBLIUKŲ;6959751328;Taip;4;0;7;11
11620;Voveraitė;ŽVIRBLIUKŲ;8803052781;Taip;0;2;0;2
11621;Voveraitė;ŽVIRBLIUKŲ;8257748589;Taip;0;1;2;3
11622;Voveraitė;ŽVIRBLIUKŲ;1522307865;Taip;0;0;2;2
11623;Voveraitė;ŽVIRBLIUKŲ;3811230983;Taip;0;0;4;4
11624;Voveraitė;ŽVIRBLIUKŲ;8939638368;Ne;0;0;3;3
11625;Voveraitė;ŽVIRBLIUKŲ;2142507659;Taip;8;0;0;8
11626;Voveraitė;ŽVIRBLIUKŲ;5395915359;Ne;12;0;1;13
11627;Voveraitė;ŽVIRBLIUKŲ;4961315260;Ne;0;0;3;3
11628;Voveraitė;ŽVIRBLIUKŲ;6643600680;Ne;5;5;0;10
11629;Voveraitė;ŽVIRBLIUKŲ;4460047281;Ne;7;0;0;7
11630;Voveraitė;ŽVIRBLIUKŲ;3877673172;Taip;0;0;4;4
11631;Voveraitė;VOVERIUKŲ;1515087924;Taip;0;3;0;3
11632;Voveraitė;VOVERIUKŲ;9195700962;Taip;3;10;0;13
11633;Voveraitė;VOVERIUKŲ;5138855000;Taip;2;1;0;3
11634;Voveraitė;VOVERIUKŲ;1340379090;Taip;0;3;0;3
11635;Voveraitė;VOVERIUKŲ;9912862474;Taip;8;6;0;14
11636;Voveraitė;VOVERIUKŲ;1960385335;Ne;0;1;0;1
11637;Voveraitė;VOVERIUKŲ;2594535017;Taip;0;5;0;5
11638;Voveraitė;VOVERIUKŲ;4563198733;Taip;8;2;0;10
11639;Voveraitė;VOVERIUKŲ;8373093305;Ne;10;1;0;11
11640;Voveraitė;VOVERIUKŲ;9514425475;Taip;0;3;0;3
11641;Voveraitė;VOVERIUKŲ;8580034134;Taip;0;5;0;5
11642;Voveraitė;VOVERIUKŲ;6891841301;Taip;0;5;0;5
11643;Voveraitė;VOVERIUKŲ;2627555750;Taip;19;0;2;21
11644;Voveraitė;VOVERIUKŲ;5935777154;Taip;7;1;0;8
11645;Voveraitė;VOVERIUKŲ;6113913885;Ne;0;3;0;3
11646;Voveraitė;VOVERIUKŲ;6007396459;Taip;0;1;0;1
11647;Voveraitė;VOVERIUKŲ;8421104790;Taip;19;0;0;19
11648;Voveraitė;VOVERIUKŲ;4054841724;Ne;10;0;1;11
11649;Voveraitė;VOVERIUKŲ;2304604061;Ne;17;0;0;17
11650;Voveraitė;VOVERIUKŲ;5956830012;Ne;6;0;0;6
11651;Voveraitė;KIŠKUČIŲ;9537862791;Taip;12;1;0;13
11652;Voveraitė;KIŠKUČIŲ;4478984171;Taip;14;0;0;14
11653;Voveraitė;KIŠKUČIŲ;9011096222;Taip;0;17;2;19
11654;Voveraitė;KIŠKUČIŲ;3058377539;Taip;2;0;0;2
11655;Voveraitė;KIŠKUČIŲ;4626178764;Taip;5;1;0;6
11656;Voveraitė;KIŠKUČIŲ;8507818993;Taip;5;3;0;8
11657;Voveraitė;KIŠKUČIŲ;8746008166;Taip;3;0;1;4
11658;Voveraitė;KIŠKUČIŲ;8084986328;Taip;2;1;0;3
11659;Voveraitė;KIŠKUČIŲ;6261152304;Taip;15;1;0;16
11660;Voveraitė;KIŠKUČIŲ;4060906360;Taip;0;4;0;4
11661;Voveraitė;KIŠKUČIŲ;6572172779;Taip;0;0;1;1
11662;Voveraitė;KIŠKUČIŲ;5069929376;Ne;4;0;0;4
11663;Voveraitė;KIŠKUČIŲ;7379045686;Ne;0;0;1;1
11664;Voveraitė;KIŠKUČIŲ;1979839656;Taip;4;2;0;6
11665;Voveraitė;KIŠKUČIŲ;9599137158;Ne;4;1;0;5
11666;Voveraitė;KIŠKUČIŲ;8121423914;Ne;0;1;1;2
11667;Voveraitė;KIŠKUČIŲ;1322927329;Ne;2;0;0;2
11668;Voveraitė;KODĖLČIUKŲ;9117809080;Taip;4;0;0;4
11669;Voveraitė;KODĖLČIUKŲ;1772758517;Ne;0;0;1;1
11670;Voveraitė;KODĖLČIUKŲ;51213803814;Taip;0;2;1;3
11671;Voveraitė;KODĖLČIUKŲ;6653141009;Taip;0;1;0;1
11672;Voveraitė;KODĖLČIUKŲ;4045121781;Taip;3;5;0;8
11673;Voveraitė;KODĖLČIUKŲ;2304004487;Taip;1;0;0;1
11674;Voveraitė;KODĖLČIUKŲ;7744504020;Taip;3;0;0;3
11675;Voveraitė;KODĖLČIUKŲ;5296850349;Taip;0;5;0;5
11676;Voveraitė;KODĖLČIUKŲ;4468214107;Taip;4;6;0;10
11677;Voveraitė;KODĖLČIUKŲ;5449490074;Ne;0;2;6;8
11678;Voveraitė;KODĖLČIUKŲ;7786378018;Ne;0;1;0;1
11679;Voveraitė;KODĖLČIUKŲ;6690309946;Taip;0;4;0;4
11680;Voveraitė;KODĖLČIUKŲ;6819742525;Taip;0;10;0;10
11681;Voveraitė;MEŠKIUKŲ;3987058753;Taip;0;1;0;1
11682;Voveraitė;MEŠKIUKŲ;3381417855;Taip;0;2;0;2
11683;Voveraitė;MEŠKIUKŲ;3703062195;Taip;0;2;0;2
11684;Voveraitė;MEŠKIUKŲ;1058273156;Taip;0;1;0;1
11685;Voveraitė;MEŠKIUKŲ;5576058454;Taip;5;2;0;7
11686;Voveraitė;MEŠKIUKŲ;1629942114;Ne;0;3;0;3
11687;Voveraitė;MEŠKIUKŲ;1592633500;Taip;0;10;0;10
11688;Voveraitė;MEŠKIUKŲ;5437283673;Taip;0;6;7;13
11689;Voveraitė;MEŠKIUKŲ;7797966139;Taip;0;6;0;6
11690;Voveraitė;MEŠKIUKŲ;3029983180;Taip;0;3;0;3
11691;Voveraitė;MEŠKIUKŲ;6886337758;Taip;5;10;0;15
11692;Voveraitė;MEŠKIUKŲ;6994680282;Taip;0;1;0;1
11693;Voveraitė;MEŠKIUKŲ;7861722125;Taip;8;4;0;12
11694;Voveraitė;BORUŽĖLIŲ;1022447432;Ne;5;5;0;10
11695;Voveraitė;BORUŽĖLIŲ;107968318;Taip;5;1;0;6
11696;Voveraitė;BORUŽĖLIŲ;1704834744;Taip;0;2;1;3
11697;Voveraitė;BORUŽĖLIŲ;28656009009;Taip;0;2;0;2
11698;Voveraitė;BORUŽĖLIŲ;2051732666;Ne;7;0;5;12
11699;Voveraitė;BORUŽĖLIŲ;82642244788;Ne;0;6;0;6
11700;Voveraitė;BORUŽĖLIŲ;13173711840;Ne;0;7;0;7
11701;Voveraitė;BORUŽĖLIŲ;1513069857;Ne;0;0;20;20
11702;Voveraitė;BORUŽĖLIŲ;35549553867;Taip;0;1;0;1
11703;Voveraitė;BORUŽĖLIŲ;67851579200;Taip;0;7;2;9
11704;Voveraitė;BORUŽĖLIŲ;49924157014;Taip;0;0;3;3
11705;Voveraitė;BORUŽĖLIŲ;66612277823;Taip;0;2;0;2
11706;Voveraitė;BORUŽĖLIŲ;41221846403;Taip;0;0;2;2
11707;Voveraitė;BORUŽĖLIŲ;3292830298;Taip;0;7;2;9
11708;Voveraitė;PELĖDŽIUKŲ;9491132884;Taip;0;0;2;2
11709;Voveraitė;PELĖDŽIUKŲ;1775800865;Taip;7;4;0;11
11710;Voveraitė;PELĖDŽIUKŲ;1959958256;Ne;0;0;1;1
11711;Voveraitė;PELĖDŽIUKŲ;6649068571;Taip;2;3;0;5
11712;Voveraitė;PELĖDŽIUKŲ;9231751171;Taip;0;1;0;1
11713;Voveraitė;PELĖDŽIUKŲ;54408671673;Taip;2;12;0;14
11714;Voveraitė;PELĖDŽIUKŲ;72154318379;Taip;2;12;0;14
11715;Voveraitė;PELĖDŽIUKŲ;3113780055;Taip;11;0;0;11
11716;Voveraitė;PELĖDŽIUKŲ;9007031372;Ne;3;4;0;7
11717;Voveraitė;PELĖDŽIUKŲ;7069780513;Taip;2;0;2;4
11718;Voveraitė;PELĖDŽIUKŲ;9933037872;Taip;3;0;0;3
11719;Voveraitė;PELĖDŽIUKŲ;3615729576;Taip;3;0;0;3
11720;Voveraitė;PELĖDŽIUKŲ;2693544600;Taip;2;1;0;3
11721;Voveraitė;PELĖDŽIUKŲ;65926130735;Taip;10;0;0;10
11722;Voveraitė;PELĖDŽIUKŲ;6433760749;Ne;5;5;0;10
11723;Voveraitė;PELĖDŽIUKŲ;6460834118;Taip;5;4;0;9
11724;Voveraitė;PELĖDŽIUKŲ;4338861332;Taip;0;0;5;5
11725;Voveraitė;PELĖDŽIUKŲ;7314148938;Taip;9;1;0;10
11726;Voveraitė;PELĖDŽIUKŲ;4511771924;Taip;9;1;0;10
11727;Voveraitė;PELĖDŽIUKŲ;602726070;Taip;4;1;0;5
11728;Voveraitė;PELĖDŽIUKŲ;4163635632;Taip;8;0;5;13
11729;Voveraitė;PELĖDŽIUKŲ;1397274691;Ne;7;0;0;7
11730;Voveraitė;DRUGELIŲ;1441921029;Taip;7;1;0;8
11731;Voveraitė;DRUGELIŲ;7008576999;Taip;0;1;0;1
11732;Voveraitė;DRUGELIŲ;2716400502;Taip;0;1;0;1
11733;Voveraitė;DRUGELIŲ;1141304286;Taip;1;0;0;1
11734;Voveraitė;DRUGELIŲ;7531020548;Taip;0;2;4;6
11735;Voveraitė;DRUGELIŲ;4300235743;Taip;5;0;12;17
11736;Voveraitė;DRUGELIŲ;8344323109;Taip;0;2;3;5
11737;Voveraitė;DRUGELIŲ;3388547792;Taip;0;10;0;10
11738;Voveraitė;DRUGELIŲ;7990479988;Taip;8;1;0;9
11739;Voveraitė;DRUGELIŲ;1046723748;Taip;4;1;1;6
11740;Voveraitė;DRUGELIŲ;8719547570;Ne;7;0;0;7
11741;Voveraitė;DRUGELIŲ;3475601049;Ne;4;0;0;4
11742;Voveraitė;DRUGELIŲ;4017408873;Ne;0;0;6;6
11743;Voveraitė;DRUGELIŲ;7533728486;Ne;11;1;0;12
11744;Voveraitė;DRUGELIŲ;1550830434;Taip;4;1;4;9
11745;Voveraitė;DRUGELIŲ;5114768009;Taip;8;0;0;8
11746;Voveraitė;DRUGELIŲ;4605007814;Ne;8;0;0;8
11747;Voveraitė;DRUGELIŲ;4911291891;Ne;0;0;6;6
11748;Voveraitė;NYKŠTUKŲ;4350450125;Taip;0;7;0;7
11749;Voveraitė;NYKŠTUKŲ;4782336282;Ne;0;0;4;4
11750;Voveraitė;NYKŠTUKŲ;1040007977;Taip;0;0;10;10
11751;Voveraitė;NYKŠTUKŲ;6770701722;Taip;5;0;0;5
11752;Voveraitė;NYKŠTUKŲ;8534405352;Taip;0;0;6;6
11753;Voveraitė;NYKŠTUKŲ;8913940646;Taip;0;0;5;5
11754;Voveraitė;NYKŠTUKŲ;1813440087;Taip;0;0;2;2
11755;Voveraitė;NYKŠTUKŲ;9332936763;Ne;0;0;3;3
11756;Voveraitė;GENIUKŲ;2505264721;Ne;3;1;0;4
11757;Voveraitė;GENIUKŲ;1508705709;Ne;0;5;0;5
11758;Voveraitė;GENIUKŲ;8443005812;Taip;4;0;0;4
11759;Voveraitė;GENIUKŲ;6729475469;Taip;0;4;0;4
11760;Voveraitė;GENIUKŲ;1753442884;Taip;0;10;0;10
11761;Voveraitė;GENIUKŲ;9623406874;Taip;0;2;0;2
11762;Voveraitė;GENIUKŲ;1612322367;Taip;0;1;0;1
11763;Voveraitė;GENIUKŲ;7974406524;Taip;0;6;0;6
11764;Voveraitė;GENIUKŲ;2044914624;Taip;3;2;2;7
11765;Voveraitė;GENIUKŲ;6847620019;Ne;0;5;0;5
11766;Voveraitė;GENIUKŲ;8538259157;Taip;0;2;0;2
11767;Voveraitė;GENIUKŲ;1780573926;Taip;0;1;0;1
11768;Voveraitė;GENIUKŲ;1449122395;Ne;0;3;0;3
11769;Voveraitė;GENIUKŲ;1668695462;Taip;0;9;0;9
11770;Voveraitė;GENIUKŲ;1616662586;Ne;0;1;0;1
11771;Voveraitė;LAPIUKŲ;2482908027;Ne;11;0;0;11
11772;Voveraitė;LAPIUKŲ;5598685365;Ne;2;1;0;3
11773;Voveraitė;LAPIUKŲ;7605427741;Ne;2;0;8;10
11774;Voveraitė;LAPIUKŲ;3432886020;Ne;0;0;3;3
11775;Voveraitė;LAPIUKŲ;8438808999;Ne;5;0;0;5
11776;Voveraitė;LAPIUKŲ;8528435385;Ne;2;0;2;4
11777;Voveraitė;LAPIUKŲ;1482908802;Ne;7;0;0;7
11778;Voveraitė;LAPIUKŲ;3384268786;Ne;5;0;1;6
11779;Voveraitė;LAPIUKŲ;1046297151;Ne;0;2;6;8
11780;Voveraitė;LAPIUKŲ;4996778855;Ne;0;2;6;8
11781;Voveraitė;LAPIUKŲ;8594597371;Ne;0;0;7;7
11782;Voveraitė;LAPIUKŲ;9887747925;Ne;9;0;0;9
11783;Voveraitė;EŽIUKŲ;4207949414;Ne;2;4;2;8
11784;Voveraitė;EŽIUKŲ;3088866739;Ne;0;5;1;6
11785;Voveraitė;EŽIUKŲ;8154347030;Ne;0;1;0;1
11786;Voveraitė;EŽIUKŲ;6661730121;Ne;0;0;1;1
11787;Voveraitė;EŽIUKŲ;6853358062;Ne;5;0;5;10
11788;Voveraitė;EŽIUKŲ;3159659638;Ne;7;2;0;9
11789;Voveraitė;EŽIUKŲ;3532178114;Ne;7;2;0;9
11790;Voveraitė;EŽIUKŲ;3307326410;Taip;3;0;1;4
11791;Voveraitė;EŽIUKŲ;3539069705;Taip;0;1;1;2
11792;"Trakų Vokė";Voveriukų;3333979364;Taip;5;0;2;7
11793;"Trakų Vokė";Voveriukų;9928767253;Taip;0;0;5;5
11794;"Trakų Vokė";Voveriukų;4531294784;Taip;2;0;3;5
11795;"Trakų Vokė";Voveriukų;2133793458;Taip;6;0;1;7
11796;"Trakų Vokė";Voveriukų;5720994041;Taip;0;0;1;1
11797;"Trakų Vokė";Voveriukų;7459132887;Taip;0;0;1;1
11798;"Trakų Vokė";Voveriukų;1808420447;Taip;0;0;9;9
11799;"Trakų Vokė";Voveriukų;6402002961;Taip;9;0;2;11
11800;"Trakų Vokė";Voveriukų;6076083379;Taip;0;0;3;3
11801;"Trakų Vokė";Voveriukų;6787506848;Taip;0;0;1;1
11802;"Trakų Vokė";Voveriukų;3372734352;Taip;0;0;2;2
11803;"Trakų Vokė";Voveriukų;1359519176;Taip;9;0;0;9
11804;"Trakų Vokė";Boružėlių;5338798362;Ne;11;0;5;16
11805;"Trakų Vokė";Boružėlių;3319243283;Taip;0;0;2;2
11806;"Trakų Vokė";Boružėlių;7858812338;Ne;0;4;0;4
11807;"Trakų Vokė";Boružėlių;1088928094;Taip;0;0;6;6
11808;"Trakų Vokė";Boružėlių;6908913934;Taip;0;0;9;9
11809;"Trakų Vokė";Boružėlių;7909596435;Taip;12;0;0;12
11810;"Trakų Vokė";Boružėlių;7752786907;Taip;15;0;0;15
11811;"Trakų Vokė";Boružėlių;2475068032;Taip;0;0;1;1
11812;"Trakų Vokė";Boružėlių;4601374629;Ne;2;0;1;3
11813;"Trakų Vokė";Boružėlių;4014027030;Taip;0;0;1;1
11814;"Trakų Vokė";Boružėlių;7660240598;Taip;1;0;9;10
11815;"Trakų Vokė";Boružėlių;4438127190;Ne;5;0;12;17
11816;"Trakų Vokė";Boružėlių;2388817616;Taip;3;5;0;8
11817;"Trakų Vokė";Boružėlių;9453317084;Ne;7;0;0;7
11818;"Trakų Vokė";Boružėlių;1080300137;Taip;0;0;1;1
11819;"Trakų Vokė";Boružėlių;2469340933;Taip;0;0;5;5
11820;"Trakų Vokė";Boružėlių;5251929660;Taip;0;5;0;5
11821;"Trakų Vokė";KIŠKUČIŲ;9094930495;Ne;10;0;0;10
11822;"Trakų Vokė";KIŠKUČIŲ;1952128558;Taip;12;0;0;12
11823;"Trakų Vokė";KIŠKUČIŲ;2503382218;Taip;12;4;0;16
11824;"Trakų Vokė";KIŠKUČIŲ;8605461082;Ne;5;0;4;9
11825;"Trakų Vokė";KIŠKUČIŲ;6369848950;Taip;0;0;3;3
11826;"Trakų Vokė";KIŠKUČIŲ;4535167417;Ne;0;5;0;5
11827;"Trakų Vokė";KIŠKUČIŲ;2539647111;Taip;5;0;0;5
11828;"Trakų Vokė";KIŠKUČIŲ;4854440884;Taip;17;0;1;18
11829;"Trakų Vokė";KIŠKUČIŲ;2761614687;Taip;17;0;1;18
11830;"Trakų Vokė";KIŠKUČIŲ;9233090228;Taip;5;0;0;5
11831;"Trakų Vokė";KIŠKUČIŲ;4040038648;Taip;0;0;10;10
11832;"Trakų Vokė";KIŠKUČIŲ;2389794233;Taip;21;0;0;21
11833;"Trakų Vokė";KIŠKUČIŲ;6277305384;Taip;8;0;0;8
11834;"Trakų Vokė";KIŠKUČIŲ;2880299812;Taip;0;0;4;4
11835;"Trakų Vokė";KIŠKUČIŲ;1360046096;Taip;11;0;0;11
11836;"Trakų Vokė";KIŠKUČIŲ;2906508821;Taip;11;0;1;12
11837;"Trakų Vokė";KIŠKUČIŲ;3328527700;Taip;10;0;0;10
11838;"Trakų Vokė";KIŠKUČIŲ;2869217654;Taip;0;0;6;6
11839;"Trakų Vokė";KIŠKUČIŲ;1324720234;Taip;0;0;1;1
11840;"Trakų Vokė";KIŠKUČIŲ;5206616285;Taip;7;0;1;8
11841;"Trakų Vokė";BITUČIŲ;2839396687;Taip;6;0;0;6
11842;"Trakų Vokė";BITUČIŲ;7792654474;Taip;6;0;0;6
11843;"Trakų Vokė";BITUČIŲ;1461337199;Taip;1;6;1;8
11844;"Trakų Vokė";BITUČIŲ;5526830430;Taip;3;0;0;3
11845;"Trakų Vokė";BITUČIŲ;2149804129;Taip;0;0;3;3
11846;"Trakų Vokė";BITUČIŲ;3373764541;Taip;0;3;0;3
11847;"Trakų Vokė";BITUČIŲ;95320712086;Taip;0;0;1;1
11848;"Trakų Vokė";BITUČIŲ;4849992906;Taip;6;6;0;12
11849;"Trakų Vokė";BITUČIŲ;3098390989;Ne;6;0;0;6
11850;"Trakų Vokė";BITUČIŲ;4903261568;Taip;4;0;4;8
11851;"Trakų Vokė";BITUČIŲ;8542147751;Taip;2;0;2;4
11852;"Trakų Vokė";BITUČIŲ;1590598232;Taip;0;0;11;11
11853;"Trakų Vokė";BITUČIŲ;8857529726;Taip;0;5;1;6
11854;"Trakų Vokė";BITUČIŲ;1433982328;Taip;0;0;1;1
11855;"Trakų Vokė";BITUČIŲ;7566567901;Taip;0;0;2;2
11856;"Trakų Vokė";BITUČIŲ;1623166260;Taip;0;0;1;1
11857;"Trakų Vokė";BITUČIŲ;39255784762;Taip;0;0;2;2
11858;"Trakų Vokė";BITUČIŲ;2672165297;Ne;0;0;2;2
11859;"Trakų Vokė";BITUČIŲ;6835150864;Taip;4;0;0;4
11860;"Trakų Vokė";BITUČIŲ;1940148622;Ne;6;0;4;10
11861;"Trakų Vokė";BITUČIŲ;4599632235;Taip;2;0;0;2
11862;Zylutė;Katerok;8749296671;Taip;3;0;0;3
11863;Zylutė;Katerok;1621772702;Taip;4;3;0;7
11864;Zylutė;Katerok;4592825972;Taip;8;4;0;12
11865;Zylutė;Katerok;8747721198;Taip;0;16;0;16
11866;Zylutė;Katerok;8212030518;Taip;0;7;0;7
11867;Zylutė;Katerok;7706833089;Taip;10;1;0;11
11868;Zylutė;Katerok;1353114929;Taip;2;0;1;3
11869;Zylutė;Katerok;3115223229;Taip;0;0;6;6
11870;Zylutė;Katerok;2968625045;Taip;5;0;0;5
11871;Zylutė;Katerok;1897871944;Taip;0;11;0;11
11872;Zylutė;Katerok;5687201052;Taip;0;0;1;1
11873;Zylutė;Katerok;3055559237;Taip;0;0;1;1
11874;Zylutė;Katerok;2792217953;Taip;6;0;0;6
11875;Zylutė;Katerok;5948147748;Taip;0;0;2;2
11876;Zylutė;Katerok;7851423851;Taip;6;0;0;6
11877;Zylutė;Katerok;2945894661;Taip;0;0;2;2
11878;Zylutė;Katerok;9986289837;Taip;7;0;1;8
11879;Zylutė;Katerok;1423890598;Taip;6;0;2;8
11880;Zylutė;"Vesole misiaki";9262869284;Taip;0;6;0;6
11881;Zylutė;"Vesole misiaki";7140223126;Taip;0;5;2;7
11882;Zylutė;"Vesole misiaki";9953834483;Taip;8;0;0;8
11883;Zylutė;"Vesole misiaki";9664467134;Ne;0;2;0;2
11884;Zylutė;"Vesole misiaki";8336138549;Taip;0;1;0;1
11885;Zylutė;"Vesole misiaki";9457189905;Taip;0;0;2;2
11886;Zylutė;"Vesole misiaki";2445444641;Taip;0;4;0;4
11887;Zylutė;"Vesole misiaki";9908198854;Taip;0;2;0;2
11888;Zylutė;"Vesole misiaki";5670953383;Taip;0;0;7;7
11889;Zylutė;"Vesole misiaki";3332865242;Taip;0;9;2;11
11890;Zylutė;"Vesole misiaki";4715704693;Taip;7;0;0;7
11891;Zylutė;"Vesole misiaki";9457457032;Taip;0;0;2;2
11892;Zylutė;"Vesole misiaki";4543822765;Taip;5;0;0;5
11893;Zylutė;"Vesole misiaki";4566817285;Taip;4;0;3;7
11894;Zylutė;"Vesole misiaki";9737308076;Taip;0;3;0;3
11895;Zylutė;"Vesole misiaki";2999425729;Ne;11;0;0;11
11896;Zylutė;"Vesole misiaki";1290248125;Ne;10;0;0;10
11897;Zylutė;"Vesole misiaki";5027134228;Taip;0;5;0;5
11898;Zylutė;NYKŠTUKAI;8618778936;Taip;1;7;0;8
11899;Zylutė;NYKŠTUKAI;1220439948;Taip;7;0;1;8
11900;Zylutė;NYKŠTUKAI;9580188426;Ne;0;0;2;2
11901;Zylutė;NYKŠTUKAI;4646273830;Ne;10;0;0;10
11902;Zylutė;NYKŠTUKAI;1164530815;Taip;0;0;1;1
11903;Zylutė;NYKŠTUKAI;1319040747;Taip;5;0;2;7
11904;Zylutė;NYKŠTUKAI;2558354198;Taip;0;0;1;1
11905;Zylutė;NYKŠTUKAI;6165548450;Taip;4;0;0;4
11906;Zylutė;NYKŠTUKAI;6784471792;Taip;0;1;0;1
11907;Zylutė;NYKŠTUKAI;8346794629;Taip;7;0;0;7
11908;Zylutė;NYKŠTUKAI;2966482773;Taip;5;4;0;9
11909;Zylutė;NYKŠTUKAI;9769201088;Ne;3;0;0;3
11910;Zylutė;NYKŠTUKAI;2110860958;Taip;3;0;0;3
11911;Zylutė;NYKŠTUKAI;9330583784;Taip;3;0;0;3
11912;Zylutė;Ručijok;4916625058;Taip;5;1;0;6
11913;Zylutė;Ručijok;6848387941;Taip;10;2;1;13
11914;Zylutė;Ručijok;6962852787;Taip;4;4;0;8
11915;Zylutė;Ručijok;4548205666;Taip;4;3;0;7
11916;Zylutė;Ručijok;9220918504;Taip;4;3;0;7
11917;Zylutė;Ručijok;3447644735;Taip;0;3;0;3
11918;Zylutė;Ručijok;8130859512;Taip;7;0;0;7
11919;Zylutė;Ručijok;1404949829;Ne;3;0;2;5
11920;Zylutė;Ručijok;5233163416;Ne;7;0;1;8
11921;Zylutė;Ručijok;8426426785;Taip;0;0;3;3
11922;Zylutė;Raduga;9325387975;Taip;0;9;0;9
11923;Zylutė;Raduga;3363212754;Taip;6;0;2;8
11924;Zylutė;Raduga;6569135467;Taip;5;0;1;6
11925;Zylutė;Raduga;3117948118;Taip;0;0;2;2
11926;Zylutė;Raduga;2654794460;Taip;0;0;1;1
11927;Zylutė;Raduga;3826815202;Taip;0;0;1;1
11928;Zylutė;Raduga;3943002728;Taip;0;21;0;21
11929;Zylutė;Raduga;4043810535;Taip;12;1;0;13
11930;Zylutė;Raduga;2107123106;Ne;5;0;4;9
11931;Zylutė;Raduga;7482740111;Taip;0;0;1;1
11932;Zylutė;Raduga;6995285377;Ne;5;5;0;10
11933;Zylutė;Raduga;7824348276;Ne;5;0;0;5
11934;Zylutė;Raduga;4811667497;Ne;8;0;4;12
11935;Zylutė;Raduga;5683151005;Taip;0;6;0;6
11936;Zylutė;Raduga;6833030749;Taip;0;10;0;10
11937;Zylutė;Raduga;4493469560;Taip;16;0;0;16
11938;Zylutė;Raduga;4416434150;Ne;6;0;2;8
11939;Zylutė;Raduga;3059970035;Ne;8;0;0;8
11940;Zylutė;"Miki Maus";5522089327;Ne;0;0;3;3
11941;Zylutė;"Miki Maus";6833822248;Taip;16;0;0;16
11942;Zylutė;"Miki Maus";5589330186;Taip;6;0;0;6
11943;Zylutė;"Miki Maus";3848401615;Taip;11;0;0;11
11944;Zylutė;"Miki Maus";9250902486;Taip;0;6;0;6
11945;Zylutė;"Miki Maus";9159342804;Taip;0;0;2;2
11946;Zylutė;"Miki Maus";8023418946;Taip;13;0;0;13
11947;Zylutė;"Miki Maus";2313423907;Taip;0;3;0;3
11948;Zylutė;"Miki Maus";2298099102;Taip;0;6;0;6
11949;Zylutė;Solnyško;5759064166;Taip;2;0;0;2
11950;Zylutė;Solnyško;1076803315;Taip;1;0;0;1
11951;Zylutė;Solnyško;5234846079;Taip;10;0;0;10
11952;Zylutė;Solnyško;5939522435;Taip;4;0;0;4
11953;Zylutė;Solnyško;2117820453;Taip;5;0;0;5
11954;Zylutė;Solnyško;8033573972;Ne;0;0;2;2
11955;Zylutė;Solnyško;4478652694;Ne;0;2;0;2
11956;Zylutė;Solnyško;9193349264;Taip;0;8;0;8
11957;Zylutė;Motyliok;7241045507;Taip;2;0;3;5
11958;Zylutė;Motyliok;9913001904;Ne;0;0;5;5
11959;Zylutė;Motyliok;6112586092;Taip;0;8;0;8
11960;Zylutė;Motyliok;8178488164;Taip;3;0;3;6
11961;Zylutė;Motyliok;3547185618;Ne;0;0;1;1
11962;Zylutė;Motyliok;5045652581;Taip;10;3;0;13
11963;Zylutė;Motyliok;9381656201;Taip;0;0;1;1
11964;Zylutė;Motyliok;9586800176;Taip;0;4;0;4
11965;Zylutė;Motyliok;4497904128;Taip;0;13;0;13
11966;Zylutė;Motyliok;3355159275;Taip;11;2;0;13
11967;Zylutė;Motyliok;9995791665;Taip;5;4;0;9
11968;Zylutė;Motyliok;2654373943;Taip;11;0;0;11
11969;Zylutė;Motyliok;3455374127;Taip;16;0;0;16
11970;Zylutė;Motyliok;1632490481;Taip;0;10;0;10
11971;Zylutė;Motyliok;1726060015;Ne;6;0;0;6
11972;Zylutė;Motyliok;3084870481;Taip;0;0;1;1
11973;Zylutė;Motyliok;6051657134;Taip;0;0;3;3
11974;Zylutė;Motyliok;3271366684;Taip;9;0;0;9
11975;Zylutė;Motyliok;1390431397;Ne;7;0;0;7
11976;Zylutė;Motyliok;3633983359;Taip;19;0;0;19
11977;Zylutė;Motyliok;9155513221;Ne;0;0;3;3
11978;Zylutė;ŽVIRBLIUKAI;20569748356;Ne;0;1;2;3
11979;Zylutė;ŽVIRBLIUKAI;8783866036;Taip;0;1;0;1
11980;Zylutė;ŽVIRBLIUKAI;2274290871;Taip;0;11;0;11
11981;Zylutė;ŽVIRBLIUKAI;9902286013;Taip;0;0;2;2
11982;Zylutė;ŽVIRBLIUKAI;1972826928;Taip;10;0;0;10
11983;Zylutė;ŽVIRBLIUKAI;3919565034;Taip;0;6;0;6
11984;Zylutė;ŽVIRBLIUKAI;5174329244;Taip;5;0;0;5
11985;Zylutė;ŽVIRBLIUKAI;3606566852;Taip;0;4;0;4
11986;Zylutė;ŽVIRBLIUKAI;6548786007;Ne;5;2;0;7
11987;Zylutė;ŽVIRBLIUKAI;3074954453;Taip;0;1;0;1
11988;Zylutė;ŽVIRBLIUKAI;1048279422;Ne;7;0;2;9
11989;Zylutė;ŽVIRBLIUKAI;2153133102;Taip;5;0;1;6
11990;Zylutė;ŽVIRBLIUKAI;7951762204;Ne;0;10;0;10
11991;Zylutė;ŽVIRBLIUKAI;4394023057;Taip;0;5;0;5
11992;Zylutė;ŽVIRBLIUKAI;5657963819;Taip;0;6;0;6
11993;Zylutė;"DRUŽNYJE REBIATA";12377363480;Taip;0;2;0;2
11994;Zylutė;"DRUŽNYJE REBIATA";1428614163;Taip;0;5;0;5
11995;Zylutė;"DRUŽNYJE REBIATA";1674095701;Taip;6;3;0;9
11996;Zylutė;"DRUŽNYJE REBIATA";3379725202;Ne;0;2;0;2
11997;Zylutė;"DRUŽNYJE REBIATA";3843999609;Taip;12;6;0;18
11998;Zylutė;"DRUŽNYJE REBIATA";3036582121;Ne;0;10;0;10
11999;Zylutė;"DRUŽNYJE REBIATA";9163527400;Ne;0;2;0;2
12000;Zylutė;"DRUŽNYJE REBIATA";4302751308;Ne;11;0;0;11
12001;Zylutė;"DRUŽNYJE REBIATA";8293541980;Taip;11;0;0;11
12002;Zylutė;"DRUŽNYJE REBIATA";5452659798;Taip;0;7;0;7
12003;Zylutė;"DRUŽNYJE REBIATA";9589810356;Taip;0;3;0;3
12004;Zylutė;"DRUŽNYJE REBIATA";5224781417;Ne;4;0;1;5
12005;Zylutė;"DRUŽNYJE REBIATA";7804533930;Taip;0;1;0;1
12006;Zylutė;"DRUŽNYJE REBIATA";5803032683;Taip;15;0;0;15
12007;Zylutė;"DRUŽNYJE REBIATA";3089235413;Taip;2;0;6;8
12008;Zylutė;"DRUŽNYJE REBIATA";8180889070;Taip;11;0;0;11
12009;Zylutė;"DRUŽNYJE REBIATA";3238748659;Ne;8;0;0;8
12010;Zylutė;"DRUŽNYJE REBIATA";35364823312;Taip;0;5;0;5
12011;Zylutė;"DRUŽNYJE REBIATA";2306517891;Taip;0;1;0;1
12012;Zylutė;"DRUŽNYJE REBIATA";8199573104;Taip;15;0;0;15
12013;Zylutė;VIEVERSĖLIAI;2125519672;Taip;0;2;0;2
12014;Zylutė;VIEVERSĖLIAI;4505081448;Taip;7;0;0;7
12015;Zylutė;VIEVERSĖLIAI;72716975865;Taip;9;1;0;10
12016;Zylutė;VIEVERSĖLIAI;6275164528;Taip;0;2;0;2
12017;Zylutė;VIEVERSĖLIAI;5172154642;Taip;0;1;0;1
12018;Zylutė;VIEVERSĖLIAI;6907378757;Taip;2;0;0;2
12019;Zylutė;VIEVERSĖLIAI;6723650872;Taip;5;0;0;5
12020;Zylutė;VIEVERSĖLIAI;6154352500;Taip;0;1;0;1
12021;Zylutė;VIEVERSĖLIAI;4016518230;Taip;5;2;0;7
12022;Zylutė;VIEVERSĖLIAI;9660898505;Taip;0;13;0;13
12023;Zylutė;VIEVERSĖLIAI;5544338521;Taip;0;8;0;8
12024;Zylutė;VIEVERSĖLIAI;4764295850;Taip;7;1;3;11
12025;Zylutė;VIEVERSĖLIAI;2276463136;Taip;11;1;0;12
12026;Zylutė;VIEVERSĖLIAI;3246229837;Taip;0;11;0;11
12027;Zylutė;VIEVERSĖLIAI;7042731356;Taip;5;5;0;10
12028;Zylutė;VIEVERSĖLIAI;27488840113;Taip;5;1;0;6
12029;Zylutė;VIEVERSĖLIAI;7023565057;Taip;19;0;0;19
12030;Želmenėliai;Bitučių;4681686872;Ne;0;2;0;2
12031;Želmenėliai;Bitučių;3268310531;Taip;9;2;0;11
12032;Želmenėliai;Bitučių;5211426226;Taip;7;6;0;13
12033;Želmenėliai;Bitučių;2122665619;Taip;0;4;0;4
12034;Želmenėliai;Bitučių;2563117992;Taip;10;0;0;10
12035;Želmenėliai;Bitučių;6799702725;Ne;0;8;0;8
12036;Želmenėliai;Bitučių;9006406225;Taip;10;0;0;10
12037;Želmenėliai;Bitučių;7423900312;Taip;8;0;0;8
12038;Želmenėliai;Bitučių;2102401372;Taip;0;3;0;3
12039;Želmenėliai;Bitučių;4931835807;Taip;0;1;0;1
12040;Želmenėliai;Bitučių;5147895081;Taip;3;1;0;4
12041;Želmenėliai;Bitučių;6481952132;Taip;5;1;0;6
12042;Želmenėliai;Bitučių;9611741258;Taip;8;1;0;9
12043;Želmenėliai;Bitučių;1619143702;Taip;11;0;0;11
12044;Želmenėliai;Bitučių;2794274146;Taip;7;2;0;9
12045;Želmenėliai;Bitučių;9825545754;Ne;9;0;0;9
12046;Želmenėliai;Bitučių;5314438217;Taip;3;3;0;6
12047;Želmenėliai;Bitučių;4927030144;Taip;3;4;0;7
12048;Želmenėliai;Bitučių;3739751121;Taip;5;0;0;5
12049;Želmenėliai;Kačiukų;1877749103;Taip;1;1;0;2
12050;Želmenėliai;Kačiukų;2350936740;Taip;10;0;1;11
12051;Želmenėliai;Kačiukų;3063417708;Taip;8;3;0;11
12052;Želmenėliai;Kačiukų;2570248893;Taip;0;12;0;12
12053;Želmenėliai;Kačiukų;2577850672;Taip;0;2;0;2
12054;Želmenėliai;Kačiukų;7849682820;Taip;10;1;0;11
12055;Želmenėliai;Kačiukų;2111008869;Taip;4;3;0;7
12056;Želmenėliai;Kačiukų;4589396143;Taip;5;1;0;6
12057;Želmenėliai;Kačiukų;6509783586;Taip;7;1;0;8
12058;Želmenėliai;Kačiukų;4126499046;Taip;5;0;1;6
12059;Želmenėliai;Kačiukų;4758240577;Taip;0;2;1;3
12060;Želmenėliai;Kačiukų;7094853897;Taip;6;0;0;6
12061;Želmenėliai;Kačiukų;9493581034;Taip;0;2;4;6
12062;Želmenėliai;Kačiukų;4931664953;Taip;10;1;0;11
12063;Želmenėliai;Kačiukų;4376978921;Ne;5;2;0;7
12064;Želmenėliai;Voveriukų;38426234048;Taip;0;6;0;6
12065;Želmenėliai;Voveriukų;1799477959;Taip;0;11;0;11
12066;Želmenėliai;Voveriukų;3258904017;Taip;0;5;0;5
12067;Želmenėliai;Voveriukų;1952686295;Taip;0;2;0;2
12068;Želmenėliai;Voveriukų;1342094235;Ne;12;0;1;13
12069;Želmenėliai;Voveriukų;3490705425;Ne;5;4;0;9
12070;Želmenėliai;Voveriukų;2231634495;Taip;7;0;0;7
12071;Želmenėliai;Voveriukų;1582618217;Taip;6;2;0;8
12072;Želmenėliai;Voveriukų;7054808979;Ne;12;1;0;13
12073;Želmenėliai;Voveriukų;9488762308;Ne;0;0;11;11
12074;Želmenėliai;Voveriukų;6343814445;Taip;0;1;0;1
12075;Želmenėliai;Voveriukų;8418427863;Ne;13;1;0;14
12076;Želmenėliai;Voveriukų;5360157217;Ne;16;0;1;17
12077;Želmenėliai;Voveriukų;2545133678;Taip;8;0;3;11
12078;Želmenėliai;Ežiukų;5795735579;Taip;0;2;0;2
12079;Želmenėliai;Ežiukų;3572462731;Taip;0;6;0;6
12080;Želmenėliai;Ežiukų;3353793939;Ne;11;0;0;11
12081;Želmenėliai;Ežiukų;7495157523;Taip;1;0;0;1
12082;Želmenėliai;Ežiukų;3972980949;Taip;0;3;0;3
12083;Želmenėliai;Ežiukų;6779746783;Taip;21;0;0;21
12084;Želmenėliai;Ežiukų;6876147546;Taip;0;6;0;6
12085;Želmenėliai;Ežiukų;9126715074;Taip;0;2;0;2
12086;Želmenėliai;Ežiukų;1260607572;Taip;3;1;0;4
12087;Želmenėliai;Ežiukų;5638248652;Taip;5;4;0;9
12088;Želmenėliai;Ežiukų;8154713582;Taip;2;0;3;5
12089;Želmenėliai;Ežiukų;6180553648;Taip;0;11;0;11
12090;Želmenėliai;Ežiukų;5171736943;Taip;10;0;0;10
12091;Želmenėliai;Ežiukų;7294722095;Ne;14;4;0;18
12092;Želmenėliai;Ežiukų;4120125150;Taip;12;2;0;14
12093;Želmenėliai;Ežiukų;8987377791;Taip;5;0;0;5
12094;Želmenėliai;Peledžiukų;4206128805;Taip;0;5;0;5
12095;Želmenėliai;Peledžiukų;6816346946;Taip;0;4;0;4
12096;Želmenėliai;Peledžiukų;9359070885;Ne;0;1;0;1
12097;Želmenėliai;Peledžiukų;2727113833;Taip;0;6;0;6
12098;Želmenėliai;Peledžiukų;2428447892;Taip;7;1;0;8
12099;Želmenėliai;Peledžiukų;1239398642;Taip;0;4;0;4
12100;Želmenėliai;Peledžiukų;8995804360;Taip;5;3;0;8
12101;Želmenėliai;Peledžiukų;5616709457;Ne;3;2;2;7
12102;Želmenėliai;Peledžiukų;8300887366;Taip;0;14;0;14
12103;Želmenėliai;Peledžiukų;5842563754;Taip;0;1;0;1
12104;Želmenėliai;Peledžiukų;9375550172;Ne;9;2;0;11
12105;Želmenėliai;Peledžiukų;1941723687;Taip;6;1;0;7
12106;Želmenėliai;Peledžiukų;8590746750;Taip;0;3;0;3
12107;Želmenėliai;Peledžiukų;1343084840;Ne;0;5;0;5
12108;Želmenėliai;Peledžiukų;8491797555;Taip;10;11;0;21
12109;Želmenėliai;Peledžiukų;37152467004;Taip;8;0;0;8
12110;Želmenėliai;Drugelių;7664430346;Ne;0;2;0;2
12111;Želmenėliai;Drugelių;3417538909;Taip;0;1;0;1
12112;Želmenėliai;Drugelių;3295852546;Taip;0;8;0;8
12113;Želmenėliai;Drugelių;4739083871;Taip;0;0;6;6
12114;Želmenėliai;Drugelių;3379266015;Taip;0;4;0;4
12115;Želmenėliai;Drugelių;3737786832;Taip;0;4;0;4
12116;Želmenėliai;Drugelių;5633127620;Taip;0;6;0;6
12117;Želmenėliai;Drugelių;1984105453;Taip;20;0;0;20
12118;Želmenėliai;Drugelių;1920917916;Taip;2;1;0;3
12119;Želmenėliai;Drugelių;4652412483;Taip;0;3;0;3
12120;Želmenėliai;Drugelių;1652949383;Taip;0;1;0;1
12121;Želmenėliai;Drugelių;5046836398;Taip;0;1;0;1
12122;Želmenėliai;Drugelių;9237611484;Taip;0;0;1;1
12123;Želmenėliai;Drugelių;13558387807;Taip;0;1;0;1
12124;Želmenėliai;Drugelių;5143554665;Taip;0;1;0;1
12125;Želmenėliai;Drugelių;7585159351;Ne;0;6;0;6
12126;Želmenėliai;Drugelių;9207984505;Taip;8;1;0;9
12127;Želmenėliai;Drugelių;4634346755;Taip;0;0;3;3
12128;Želmenėliai;Drugelių;4916436238;Taip;0;11;0;11
12129;Želmenėliai;Drugelių;5558795651;Taip;8;0;0;8
12130;Želmenėliai;Drugelių;8504963337;Taip;0;1;0;1
12131;Želmenėliai;Voriukų;4264751761;Taip;0;6;0;6
12132;Želmenėliai;Voriukų;1203343580;Taip;0;8;0;8
12133;Želmenėliai;Voriukų;3014568232;Ne;4;0;0;4
12134;Želmenėliai;Voriukų;6916426436;Taip;0;7;0;7
12135;Želmenėliai;Voriukų;7563461821;Ne;0;6;0;6
12136;Želmenėliai;Voriukų;4534946646;Ne;3;1;0;4
12137;Želmenėliai;Voriukų;7505996978;Taip;0;7;0;7
12138;Želmenėliai;Voriukų;2722619508;Ne;0;12;0;12
12139;Želmenėliai;Voriukų;5025345647;Ne;0;12;0;12
12140;Želmenėliai;Voriukų;3043560150;Taip;0;8;0;8
12141;Želmenėliai;Voriukų;8892137326;Taip;0;1;0;1
12142;Želmenėliai;Voriukų;7700521261;Taip;0;0;1;1
12143;Želmenėliai;Boružėlių;22539846993;Taip;0;1;0;1
12144;Želmenėliai;Boružėlių;5223588064;Taip;0;1;0;1
12145;Želmenėliai;Boružėlių;2898358705;Taip;0;2;0;2
12146;Želmenėliai;Boružėlių;10462964817;Taip;0;4;0;4
12147;Želmenėliai;Boružėlių;2103938312;Taip;0;4;0;4
12148;Želmenėliai;Boružėlių;35901929384;Taip;0;2;0;2
12149;Želmenėliai;Boružėlių;98852944217;Taip;0;3;0;3
12150;Želmenėliai;Boružėlių;7502363323;Ne;12;1;0;13
12151;Želmenėliai;Boružėlių;1009164107;Taip;0;21;0;21
12152;Želmenėliai;Boružėlių;92486344928;Taip;0;5;0;5
12153;Želmenėliai;Boružėlių;1802714172;Taip;0;1;0;1
12154;Želmenėliai;Boružėlių;1933769076;Taip;0;5;0;5
12155;Želmenėliai;Boružėlių;9414488405;Taip;0;2;0;2
12156;Želmenėliai;Boružėlių;2044063398;Taip;21;0;0;21
12157;Želmenėliai;Boružėlių;1744939559;Taip;0;3;0;3
12158;Želmenėliai;Boružėlių;27187464726;Taip;5;1;0;6
12159;Želmenėliai;Pūkuotukų;73813829491;Taip;18;0;0;18
12160;Želmenėliai;Pūkuotukų;79879695958;Taip;0;0;1;1
12161;Želmenėliai;Pūkuotukų;54536849345;Taip;0;4;0;4
12162;Želmenėliai;Pūkuotukų;8936734213;Taip;0;1;0;1
12163;Želmenėliai;Pūkuotukų;1716801722;Taip;0;9;0;9
12164;Želmenėliai;Pūkuotukų;45440599686;Taip;9;1;0;10
12165;Želmenėliai;Pūkuotukų;1405460015;Taip;0;3;0;3
12166;Želmenėliai;Pūkuotukų;85619767784;Ne;0;10;0;10
12167;Želmenėliai;Pūkuotukų;1800724034;Taip;0;0;2;2
12168;Želmenėliai;Pūkuotukų;74037118861;Taip;0;1;0;1
12169;Želmenėliai;Pūkuotukų;8706951420;Taip;0;1;0;1
12170;Želmenėliai;Pūkuotukų;1426827854;Taip;0;1;0;1
12171;Želmenėliai;Pūkuotukų;75198661944;Taip;0;1;0;1
12172;Želmenėliai;Pūkuotukų;2036184590;Taip;0;2;0;2
12173;Želmenėliai;Pūkuotukų;72855365141;Taip;5;1;0;6
12174;Želmenėliai;Pūkuotukų;22138795060;Taip;0;3;0;3
12175;Želmenėliai;Pūkuotukų;6783113916;Taip;5;0;0;5
12176;Želmenėliai;Pūkuotukų;6478525575;Taip;7;0;0;7
12177;Želmenėliai;Ančiukų;5929410363;Taip;0;6;0;6
12178;Želmenėliai;Ančiukų;7751609462;Taip;8;1;0;9
12179;Želmenėliai;Ančiukų;4979494010;Ne;0;2;0;2
12180;Želmenėliai;Ančiukų;7925266303;Ne;0;2;0;2
12181;Želmenėliai;Ančiukų;4374898642;Taip;19;1;0;20
12182;Želmenėliai;Ančiukų;4485249321;Ne;0;12;0;12
12183;Želmenėliai;Ančiukų;2951719129;Taip;0;5;0;5
12184;Želmenėliai;Ančiukų;3869372021;Taip;11;1;0;12
12185;Želmenėliai;Ančiukų;1580370689;Taip;0;2;0;2
12186;Želmenėliai;Ančiukų;1983575576;Taip;9;0;0;9
12187;Želmenėliai;Ančiukų;7672980212;Taip;9;1;0;10
12188;Želmenėliai;Nykštukų;4347883309;Taip;3;3;0;6
12189;Želmenėliai;Nykštukų;6187661667;Taip;5;0;0;5
12190;Želmenėliai;Nykštukų;4746898209;Ne;0;2;1;3
12191;Želmenėliai;Nykštukų;8474210476;Taip;0;0;1;1
12192;Želmenėliai;Nykštukų;2111705047;Taip;0;0;1;1
12193;Želmenėliai;Nykštukų;6662439747;Ne;0;1;0;1
12194;Želmenėliai;Nykštukų;8118696261;Taip;3;2;0;5
12195;Želmenėliai;Nykštukų;4722890143;Taip;5;0;0;5
12196;Želmenėliai;Nykštukų;5514167627;Ne;5;0;0;5
12197;Želmenėliai;Nykštukų;5207899503;Taip;8;2;0;10
12198;Želmenėliai;Lašelių;2262009049;Taip;0;2;0;2
12199;Želmenėliai;Lašelių;5161934903;Taip;0;4;0;4
12200;Želmenėliai;Lašelių;2117995780;Taip;5;6;0;11
12201;Želmenėliai;Lašelių;8654298177;Taip;8;0;0;8
12202;Želmenėliai;Lašelių;6761848439;Taip;8;0;0;8
12203;Želmenėliai;Lašelių;4451798870;Taip;6;0;0;6
12204;Želmenėliai;Lašelių;4485851428;Taip;0;1;0;1
12205;Želmenėliai;Lašelių;8147408275;Taip;0;3;0;3
12206;Želmenėliai;Lašelių;7077832687;Taip;0;1;0;1
12207;Želmenėliai;Lašelių;6569807889;Taip;0;0;1;1
12208;Želmenėliai;Lašelių;1764468979;Taip;1;2;0;3
12209;Želmenėliai;Lašelių;5949535657;Taip;9;1;0;10
12210;Želmenėliai;Lašelių;2501163903;Taip;0;7;0;7
12211;Žemyna;Čiauškučiai;9985529041;Taip;0;9;0;9
12212;Žemyna;Čiauškučiai;9570187081;Taip;0;0;1;1
12213;Žemyna;Čiauškučiai;2547436771;Taip;6;6;0;12
12214;Žemyna;Čiauškučiai;6051208732;Taip;0;0;1;1
12215;Žemyna;Čiauškučiai;6346173832;Taip;5;0;4;9
12216;Žemyna;Čiauškučiai;8694608716;Ne;4;0;0;4
12217;Žemyna;Čiauškučiai;3074391266;Taip;5;0;1;6
12218;Žemyna;Čiauškučiai;4693414703;Taip;0;6;1;7
12219;Žemyna;Čiauškučiai;1365045512;Taip;11;0;0;11
12220;Žemyna;Čiauškučiai;7620179886;Taip;5;0;1;6
12221;Žemyna;Čiauškučiai;7376806308;Taip;5;0;2;7
12222;Žemyna;Čiauškučiai;5069437469;Taip;7;0;0;7
12223;Žemyna;Čiauškučiai;7427119736;Taip;15;0;0;15
12224;Žemyna;Čiauškučiai;4642600915;Taip;6;0;0;6
12225;Žemyna;Čiauškučiai;2354265632;Taip;4;0;0;4
12226;Žemyna;Čiauškučiai;2887459684;Taip;6;0;2;8
12227;Žemyna;Čiauškučiai;1654157342;Ne;0;5;1;6
12228;Žemyna;Čiauškučiai;4652384557;Taip;8;0;0;8
12229;Žemyna;Čiauškučiai;7352868453;Taip;8;0;0;8
12230;Žemyna;Čiauškučiai;4501408683;Taip;5;0;3;8
12231;Žemyna;Čiauškučiai;4613946229;Ne;0;0;1;1
12232;Žemyna;Nykštukai;5114094924;Ne;11;0;0;11
12233;Žemyna;Nykštukai;2461700030;Taip;0;3;0;3
12234;Žemyna;Nykštukai;1725771976;Taip;0;0;8;8
12235;Žemyna;Nykštukai;3643594001;Ne;0;4;1;5
12236;Žemyna;Nykštukai;9182709647;Taip;0;1;0;1
12237;Žemyna;Nykštukai;7121742098;Taip;3;0;2;5
12238;Žemyna;Nykštukai;3519840747;Ne;6;0;0;6
12239;Žemyna;Nykštukai;1468040559;Taip;0;0;2;2
12240;Žemyna;Nykštukai;4322192775;Taip;5;2;0;7
12241;Žemyna;Nykštukai;4444870782;Taip;0;1;3;4
12242;Žemyna;Nykštukai;7781924111;Taip;0;0;3;3
12243;Žemyna;Nykštukai;4257096808;Ne;10;0;0;10
12244;Žemyna;Nykštukai;1575505075;Taip;0;0;4;4
12245;Žemyna;Nykštukai;2860210906;Taip;0;0;9;9
12246;Žemyna;Nykštukai;7832066079;Taip;0;4;0;4
12247;Žemyna;Nykštukai;9653530823;Taip;0;4;0;4
12248;Žemyna;Nykštukai;7508491119;Taip;10;0;0;10
12249;Žemyna;Nykštukai;2928125522;Ne;0;2;0;2
12250;Žemyna;Voveriukai;3135562485;Taip;3;0;0;3
12251;Žemyna;Voveriukai;2976467316;Taip;0;0;2;2
12252;Žemyna;Voveriukai;6812823390;Taip;0;0;1;1
12253;Žemyna;Voveriukai;7925774308;Taip;2;0;1;3
12254;Žemyna;Voveriukai;2412956023;Taip;5;3;0;8
12255;Žemyna;Voveriukai;7341750699;Taip;0;0;1;1
12256;Žemyna;Voveriukai;3938938667;Taip;8;0;0;8
12257;Žemyna;Voveriukai;9958040413;Ne;12;0;1;13
12258;Žemyna;Voveriukai;1114714466;Taip;2;0;1;3
12259;Žemyna;Voveriukai;1807466584;Taip;0;19;0;19
12260;Žemyna;Voveriukai;1543415914;Taip;5;0;1;6
12261;Žemyna;Voveriukai;7125026803;Taip;5;0;0;5
12262;Žemyna;Voveriukai;9148594407;Taip;13;1;0;14
12263;Žemyna;Voveriukai;6701717634;Taip;2;5;0;7
12264;Žemyna;Voveriukai;9866110744;Taip;0;0;1;1
12265;Žemyna;Voveriukai;7693278353;Taip;0;1;1;2
12266;Žemyna;Voveriukai;1118997229;Ne;0;2;1;3
12267;Žemyna;Voveriukai;3357339710;Taip;0;16;2;18
12268;Žemyna;Kiškučiai;3398294520;Taip;1;10;1;12
12269;Žemyna;Kiškučiai;6264082741;Taip;5;0;0;5
12270;Žemyna;Kiškučiai;2593454678;Taip;5;0;1;6
12271;Žemyna;Kiškučiai;46013925783;Ne;0;0;2;2
12272;Žemyna;Kiškučiai;4014095028;Ne;0;0;4;4
12273;Žemyna;Kiškučiai;27867030470;Taip;0;8;0;8
12274;Žemyna;Kiškučiai;1654912072;Taip;0;0;1;1
12275;Žemyna;Kiškučiai;2100326039;Taip;5;0;0;5
12276;Žemyna;Kiškučiai;51870099224;Taip;0;0;1;1
12277;Žemyna;Kiškučiai;1705971732;Taip;0;2;1;3
12278;Žemyna;Kiškučiai;45222048620;Taip;1;0;0;1
12279;Žemyna;Kiškučiai;1571182096;Ne;6;0;1;7
12280;Žemyna;Kiškučiai;17784132877;Taip;5;0;0;5
12281;Žemyna;Kiškučiai;32383247850;Taip;0;0;3;3
12282;Žemyna;Kiškučiai;50369667193;Taip;0;1;0;1
12283;Žemyna;Kiškučiai;1968337404;Taip;0;2;0;2
12284;Žemyna;Kiškučiai;1941650167;Taip;0;3;0;3
12285;Žemyna;Vyturiukai;9232638767;Taip;0;2;0;2
12286;Žemyna;Vyturiukai;38769607968;Taip;1;0;1;2
12287;Žemyna;Vyturiukai;47470155594;Taip;7;0;1;8
12288;Žemyna;Vyturiukai;1687206394;Taip;0;2;0;2
12289;Žemyna;Vyturiukai;5508251792;Taip;0;0;2;2
12290;Žemyna;Vyturiukai;85135645557;Taip;8;0;1;9
12291;Žemyna;Vyturiukai;5506889213;Taip;0;4;0;4
12292;Žemyna;Vyturiukai;5306392307;Taip;7;0;1;8
12293;Žemyna;Vyturiukai;9018138289;Taip;4;0;1;5
12294;Žemyna;Vyturiukai;37570629861;Taip;4;6;0;10
12295;Žemyna;Vyturiukai;13242930752;Taip;0;2;1;3
12296;Žemyna;Vyturiukai;93423088394;Taip;0;8;0;8
12297;Žemyna;Vyturiukai;8040359407;Taip;5;0;2;7
12298;Žemyna;Vyturiukai;55161890341;Ne;4;0;0;4
12299;Žemyna;Vyturiukai;6618285685;Taip;0;0;2;2
12300;Žemyna;Vyturiukai;4524929331;Taip;4;0;0;4
12301;Žemyna;Vyturiukai;3622634119;Taip;0;1;1;2
12302;Žemyna;Vyturiukai;4235160760;Taip;3;6;0;9
12303;Žemyna;Vyturiukai;5815116293;Taip;0;0;9;9
12304;Žemyna;Vyturiukai;8096035110;Taip;6;0;1;7
12305;Žemyna;Vyturiukai;5933910526;Taip;3;0;2;5
12306;Žemyna;Pelėdžiukai;72801825176;Taip;0;0;4;4
12307;Žemyna;Pelėdžiukai;38604851102;Taip;0;0;6;6
12308;Žemyna;Pelėdžiukai;1595030102;Taip;11;0;1;12
12309;Žemyna;Pelėdžiukai;6448628301;Taip;5;0;1;6
12310;Žemyna;Pelėdžiukai;54253890981;Ne;0;0;1;1
12311;Žemyna;Pelėdžiukai;32755929074;Taip;6;5;0;11
12312;Žemyna;Pelėdžiukai;47562685723;Taip;0;0;2;2
12313;Žemyna;Pelėdžiukai;1694969407;Taip;0;0;6;6
12314;Žemyna;Pelėdžiukai;9130965949;Taip;0;0;3;3
12315;Žemyna;Pelėdžiukai;35462796459;Taip;0;0;4;4
12316;Žemyna;Pelėdžiukai;7343337032;Taip;0;0;2;2
12317;Žemyna;Pelėdžiukai;54823974018;Taip;0;5;0;5
12318;Žemyna;Pelėdžiukai;2003368811;Taip;5;0;0;5
12319;Žemyna;Pelėdžiukai;99015221693;Taip;0;0;2;2
12320;Žemyna;Pelėdžiukai;1305667359;Taip;0;0;3;3
12321;Žemyna;Pelėdžiukai;1421842247;Taip;0;0;2;2
12322;Žemyna;Pelėdžiukai;50543973728;Taip;0;0;1;1
12323;Žemyna;Šnekučiai;9501126807;Taip;0;0;5;5
12324;Žemyna;Šnekučiai;6735720135;Taip;0;2;0;2
12325;Žemyna;Šnekučiai;9912869400;Taip;0;0;6;6
12326;Žemyna;Šnekučiai;2006173745;Taip;0;3;0;3
12327;Žemyna;Šnekučiai;6116581655;Taip;0;1;0;1
12328;Žemyna;Šnekučiai;6419974691;Taip;4;0;1;5
12329;Žemyna;Šnekučiai;9219519029;Ne;0;10;0;10
12330;Žemyna;Šnekučiai;5868208651;Ne;0;6;0;6
12331;Žemyna;Šnekučiai;3992383447;Taip;15;1;0;16
12332;Žemyna;Šnekučiai;9668975591;Taip;0;1;0;1
12333;Žemyna;Šnekučiai;6856737270;Ne;0;1;0;1
12334;Žemyna;Šnekučiai;5188496664;Taip;6;0;0;6
12335;Žemyna;Šnekučiai;4872348199;Taip;0;0;1;1
12336;Žemyna;Šnekučiai;6878669773;Taip;8;1;1;10
12337;Žemyna;Šnekučiai;4502958166;Taip;5;4;0;9
12338;Žemyna;Šnekučiai;5688714928;Taip;5;0;0;5
12339;Žemyna;Šnekučiai;6728229865;Taip;0;4;0;4
12340;Žemyna;Šnekučiai;2710551760;Taip;0;9;0;9
12341;Žemyna;Pabiručiai;9827401825;Taip;0;9;0;9
12342;Žemyna;Pabiručiai;5743535463;Taip;17;0;2;19
12343;Žemyna;Pabiručiai;6958537154;Taip;0;4;0;4
12344;Žemyna;Pabiručiai;1745197274;Taip;16;0;0;16
12345;Žemyna;Pabiručiai;2034162734;Taip;0;2;0;2
12346;Žemyna;Pabiručiai;6041223291;Taip;10;0;5;15
12347;Žemyna;Pabiručiai;8248443265;Taip;10;0;0;10
12348;Žemyna;Pabiručiai;9094718595;Taip;0;16;0;16
12349;Žemyna;Pabiručiai;6208953341;Taip;12;1;0;13
12350;Žemyna;Pabiručiai;5127174926;Taip;7;0;10;17
12351;Žemyna;Pabiručiai;8559870965;Taip;0;0;1;1
12352;Žemyna;Pabiručiai;1850100203;Taip;12;0;1;13
12353;Žemyna;Pabiručiai;6450681255;Ne;7;0;0;7
12354;Žemyna;Pabiručiai;2860232791;Ne;10;0;4;14
12355;Žemyna;Pabiručiai;4237778022;Ne;17;0;0;17
12356;Žemyna;Pabiručiai;2414400761;Ne;0;10;0;10
12357;Žemyna;Pabiručiai;8681308720;Taip;5;6;0;11
12358;Žemyna;Pabiručiai;4176386795;Taip;5;2;0;7
12359;Žemyna;Drugeliai;1867198805;Taip;5;6;0;11
12360;Žemyna;Drugeliai;4519502372;Taip;0;0;4;4
12361;Žemyna;Drugeliai;5233574060;Ne;2;0;0;2
12362;Žemyna;Drugeliai;8185243991;Taip;4;0;0;4
12363;Žemyna;Drugeliai;8525229514;Ne;10;1;1;12
12364;Žemyna;Drugeliai;1846287760;Taip;1;5;5;11
12365;Žemyna;Drugeliai;8775518984;Taip;0;1;0;1
12366;Žemyna;Drugeliai;5337086029;Taip;8;0;0;8
12367;Žemyna;Drugeliai;5860113851;Taip;6;0;0;6
12368;Žemyna;Drugeliai;8926045231;Taip;7;6;0;13
12369;Žemyna;Drugeliai;9471382383;Ne;2;1;2;5
12370;Žemyna;Drugeliai;3860791215;Ne;0;0;3;3
12371;Žemyna;Drugeliai;7785889259;Taip;0;8;0;8
12372;Žemyna;Drugeliai;3895238312;Taip;0;0;7;7
12373;Žemyna;Drugeliai;15110117571;Taip;7;2;0;9
12374;Žemyna;Drugeliai;1058705875;Taip;6;10;0;16
12375;Žemyna;Drugeliai;1717797530;Ne;0;20;0;20
12376;Žemyna;Drugeliai;2090395417;Taip;17;0;0;17
12377;Žemyna;Drugeliai;5056205809;Taip;0;0;1;1
12378;Žemyna;"ŽIRNIUKAI ";5416338054;Taip;5;0;3;8
12379;Žemyna;"ŽIRNIUKAI ";5133115712;Taip;5;0;3;8
12380;Žemyna;"ŽIRNIUKAI ";1417007895;Ne;5;0;0;5
12381;Žemyna;"ŽIRNIUKAI ";5355845891;Taip;0;0;5;5
12382;Žemyna;"ŽIRNIUKAI ";9171823612;Ne;21;0;0;21
12383;Žemyna;"ŽIRNIUKAI ";1481273689;Taip;13;0;0;13
12384;Žemyna;"ŽIRNIUKAI ";8577299116;Taip;17;0;0;17
12385;Žemyna;"ŽIRNIUKAI ";7781332622;Taip;12;0;0;12
12386;Žemyna;"ŽIRNIUKAI ";1031171460;Taip;10;0;0;10
12387;Žemyna;"ŽIRNIUKAI ";1345704379;Taip;12;0;0;12
12388;Žemyna;"ŽIRNIUKAI ";7920398415;Taip;3;0;3;6
12389;Žemyna;"ŽIRNIUKAI ";6097681172;Taip;11;0;0;11
12390;Žemyna;"ŽIRNIUKAI ";3446774478;Taip;5;0;1;6
12391;Žemyna;"ŽIRNIUKAI ";6271057561;Taip;8;0;1;9
12392;Žemyna;"ŽIRNIUKAI ";2304633263;Taip;0;0;7;7
12393;Žemyna;"ŽIRNIUKAI ";3501732353;Taip;5;0;5;10
12394;Žemyna;"ŽIRNIUKAI ";2526949655;Taip;7;0;3;10
12395;Žemyna;"ŽIOGELIAI ";2102920661;Ne;15;0;0;15
12396;Žemyna;"ŽIOGELIAI ";8302345911;Taip;0;1;6;7
12397;Žemyna;"ŽIOGELIAI ";5204349188;Ne;10;0;0;10
12398;Žemyna;"ŽIOGELIAI ";3390442637;Ne;11;0;0;11
12399;Žemyna;"ŽIOGELIAI ";6575272457;Taip;11;0;0;11
12400;Žemyna;"ŽIOGELIAI ";7461187735;Taip;7;0;1;8
12401;Žemyna;"ŽIOGELIAI ";9366133892;Taip;15;0;0;15
12402;Žemyna;"ŽIOGELIAI ";2139103576;Taip;0;0;11;11
12403;Žemyna;"ŽIOGELIAI ";1279981170;Ne;5;0;0;5
12404;Žemyna;"ŽIOGELIAI ";6164541167;Taip;5;5;0;10
12405;Žemyna;"ŽIOGELIAI ";7564693757;Taip;5;2;0;7
12406;Žemyna;"ŽIOGELIAI ";3872427931;Taip;1;0;0;1
12407;Žemyna;"ŽIOGELIAI ";2231967652;Ne;17;0;0;17
12408;Žemyna;"ŽIOGELIAI ";3755964840;Taip;5;0;0;5
12409;Žemyna;"ŽIOGELIAI ";3505551915;Ne;0;2;5;7
12410;Žemuogėlė;Boružiukai;8276724226;Taip;3;14;0;17
12411;Žemuogėlė;Boružiukai;3706531223;Taip;5;1;0;6
12412;Žemuogėlė;Boružiukai;3753156044;Taip;5;0;0;5
12413;Žemuogėlė;Boružiukai;4565097904;Ne;0;1;0;1
12414;Žemuogėlė;Boružiukai;8644564820;Taip;2;7;0;9
12415;Žemuogėlė;Boružiukai;3546429231;Taip;5;5;0;10
12416;Žemuogėlė;Boružiukai;9579921777;Taip;0;1;0;1
12417;Žemuogėlė;Boružiukai;3073956225;Taip;1;0;0;1
12418;Žemuogėlė;Boružiukai;4933948491;Ne;0;6;0;6
12419;Žemuogėlė;Boružiukai;1469759840;Taip;0;2;0;2
12420;Žemuogėlė;Boružiukai;2115883173;Taip;5;2;0;7
12421;Žemuogėlė;Boružiukai;5992802843;Taip;0;6;0;6
12422;Žemuogėlė;Boružiukai;7592566602;Taip;0;12;0;12
12423;Žemuogėlė;Boružiukai;1555899448;Taip;0;18;0;18
12424;Žemuogėlė;Boružiukai;9693814425;Taip;0;10;0;10
12425;Žemuogėlė;Boružiukai;3825509486;Taip;5;1;0;6
12426;Žemuogėlė;Boružiukai;3059525247;Taip;0;7;0;7
12427;Žemuogėlė;Šviesuliukai;1049009199;Taip;0;7;0;7
12428;Žemuogėlė;Šviesuliukai;5126348190;Taip;0;0;2;2
12429;Žemuogėlė;Šviesuliukai;9534937419;Taip;4;0;0;4
12430;Žemuogėlė;Šviesuliukai;2481547868;Taip;16;0;2;18
12431;Žemuogėlė;Šviesuliukai;3612833383;Taip;12;0;0;12
12432;Žemuogėlė;Šviesuliukai;9689082202;Ne;6;2;0;8
12433;Žemuogėlė;Šviesuliukai;6707522989;Taip;0;3;0;3
12434;Žemuogėlė;Šviesuliukai;9955429241;Taip;4;0;0;4
12435;Žemuogėlė;Šviesuliukai;6059069293;Taip;4;11;0;15
12436;Žemuogėlė;Šviesuliukai;5770044886;Taip;11;0;2;13
12437;Žemuogėlė;Šviesuliukai;5971652934;Taip;0;0;1;1
12438;Žemuogėlė;Šviesuliukai;9981446556;Taip;0;1;0;1
12439;Žemuogėlė;Šviesuliukai;4578291476;Taip;0;0;10;10
12440;Žemuogėlė;Šviesuliukai;7669457695;Taip;0;6;0;6
12441;Žemuogėlė;Šviesuliukai;1953538445;Taip;12;0;0;12
12442;Žemuogėlė;Šviesuliukai;4165354124;Taip;0;0;2;2
12443;Žemuogėlė;Šviesuliukai;3041461125;Taip;0;13;0;13
12444;Žemuogėlė;Lašiukai;2086546195;Taip;6;1;0;7
12445;Žemuogėlė;Lašiukai;4231767115;Taip;0;1;0;1
12446;Žemuogėlė;Lašiukai;3977351017;Taip;4;1;0;5
12447;Žemuogėlė;Lašiukai;3854265246;Taip;1;0;0;1
12448;Žemuogėlė;Lašiukai;5147617128;Taip;0;12;0;12
12449;Žemuogėlė;Lašiukai;5625943720;Taip;0;2;1;3
12450;Žemuogėlė;Lašiukai;1058207935;Taip;10;1;0;11
12451;Žemuogėlė;Lašiukai;1628749648;Taip;3;0;0;3
12452;Žemuogėlė;Lašiukai;711908013;Taip;0;5;0;5
12453;Žemuogėlė;Lašiukai;6962103028;Taip;0;2;0;2
12454;Žemuogėlė;Lašiukai;7714826773;Taip;5;5;0;10
12455;Žemuogėlė;Lašiukai;3134493860;Taip;0;2;0;2
12456;Žemuogėlė;Lašiukai;8023936861;Taip;7;0;1;8
12457;Žemuogėlė;Lašiukai;38870047353;Taip;0;7;0;7
12458;Žemuogėlė;Lašiukai;9315711142;Taip;7;2;5;14
12459;Žemuogėlė;Lašiukai;2102057496;Taip;0;3;0;3
12460;Žemuogėlė;Lašiukai;4421397490;Taip;2;0;0;2
12461;Žemuogėlė;Skambaliukai;64182347253;Taip;6;1;0;7
12462;Žemuogėlė;Skambaliukai;89682626079;Taip;3;2;1;6
12463;Žemuogėlė;Skambaliukai;21886029194;Taip;0;1;0;1
12464;Žemuogėlė;Skambaliukai;95070515682;Ne;0;1;0;1
12465;Žemuogėlė;Skambaliukai;7503799036;Taip;5;0;0;5
12466;Žemuogėlė;Skambaliukai;95392130582;Taip;0;1;0;1
12467;Žemuogėlė;Skambaliukai;1099252682;Taip;0;0;2;2
12468;Žemuogėlė;Skambaliukai;1354590098;Taip;0;2;2;4
12469;Žemuogėlė;Skambaliukai;1543283524;Taip;0;2;0;2
12470;Žemuogėlė;Skambaliukai;1085793430;Taip;0;1;0;1
12471;Žemuogėlė;Skambaliukai;1970687025;Taip;3;0;0;3
12472;Žemuogėlė;Skambaliukai;52842591023;Taip;0;0;4;4
12473;Žemuogėlė;Skambaliukai;5911529759;Taip;0;1;0;1
12474;Žemuogėlė;Skambaliukai;70054283264;Taip;17;0;0;17
12475;Žemuogėlė;Skambaliukai;40590616715;Taip;0;1;0;1
12476;Žemuogėlė;Spinduliukai;9864664937;Taip;6;2;0;8
12477;Žemuogėlė;Spinduliukai;75012082294;Taip;5;0;0;5
12478;Žemuogėlė;Spinduliukai;9042246873;Taip;0;2;0;2
12479;Žemuogėlė;Spinduliukai;1859848343;Taip;0;15;0;15
12480;Žemuogėlė;Spinduliukai;96167322031;Ne;0;2;0;2
12481;Žemuogėlė;Spinduliukai;4766971363;Taip;5;1;0;6
12482;Žemuogėlė;Spinduliukai;3868254757;Taip;0;1;0;1
12483;Žemuogėlė;Spinduliukai;8187939143;Taip;0;1;0;1
12484;Žemuogėlė;Spinduliukai;3062268362;Taip;0;13;0;13
12485;Žemuogėlė;Spinduliukai;5395954931;Taip;0;1;0;1
12486;Žemuogėlė;Spinduliukai;5095782784;Ne;0;0;1;1
12487;Žemuogėlė;Spinduliukai;2740942924;Taip;0;6;0;6
12488;Žemuogėlė;Spinduliukai;9255723192;Taip;7;4;0;11
12489;Žemuogėlė;Spinduliukai;5972567526;Taip;6;1;0;7
12490;Žemuogėlė;Spinduliukai;1910570858;Taip;0;6;0;6
12491;Žemuogėlė;Spinduliukai;3000676765;Taip;0;12;0;12
12492;Žemuogėlė;Spinduliukai;3411390558;Taip;0;5;0;5
12493;Žemuogėlė;Spinduliukai;1275552038;Taip;0;8;0;8
12494;Žemuogėlė;Spinduliukai;1377813636;Taip;2;0;0;2
12495;Žemuogėlė;Spinduliukai;2731544174;Taip;0;14;0;14
12496;Žemuogėlė;Spinduliukai;4810459063;Taip;10;0;0;10
12497;Žemuogėlė;Spinduliukai;1745679183;Taip;0;1;0;1
12498;Žemuogėlė;Perliukai;9592456683;Taip;9;2;0;11
12499;Žemuogėlė;Perliukai;7804015060;Taip;6;1;0;7
12500;Žemuogėlė;Perliukai;3765022476;Taip;5;1;0;6
12501;Žemuogėlė;Perliukai;3714945248;Taip;13;0;2;15
12502;Žemuogėlė;Perliukai;9519563708;Taip;0;2;0;2
12503;Žemuogėlė;Perliukai;5266493632;Taip;4;10;0;14
12504;Žemuogėlė;Perliukai;3237083654;Taip;0;2;1;3
12505;Žemuogėlė;Perliukai;2259779058;Taip;5;0;0;5
12506;Žemuogėlė;Perliukai;9693894254;Taip;11;2;0;13
12507;Žemuogėlė;Perliukai;9378432383;Taip;0;2;0;2
12508;Žemuogėlė;Perliukai;6913038845;Taip;0;12;0;12
12509;Žemuogėlė;Perliukai;5418395023;Taip;11;2;0;13
12510;Žemuogėlė;Perliukai;6581889641;Ne;5;2;2;9
12511;Žemuogėlė;Perliukai;2555902309;Ne;11;0;0;11
12512;Žemuogėlė;Perliukai;4536398519;Taip;6;2;0;8
12513;Žemuogėlė;Perliukai;3458374439;Taip;6;6;0;12
12514;Žemuogėlė;Perliukai;8757701456;Taip;3;5;0;8
12515;Žemuogėlė;Perliukai;2132549536;Taip;0;6;0;6
12516;Žemuogėlė;Perliukai;1733808230;Taip;0;2;0;2
12517;Žemuogėlė;Perliukai;2841634296;Taip;0;1;0;1
12518;Žemuogėlė;Perliukai;9476688736;Taip;14;0;0;14
12519;Žemuogėlė;Drugeliai;1350671777;Taip;7;1;0;8
12520;Žemuogėlė;Drugeliai;9344628661;Taip;0;1;0;1
12521;Žemuogėlė;Drugeliai;7477731865;Taip;0;1;0;1
12522;Žemuogėlė;Drugeliai;1639634300;Taip;0;2;0;2
12523;Žemuogėlė;Drugeliai;5911215640;Taip;0;3;0;3
12524;Žemuogėlė;Drugeliai;1150466286;Taip;5;0;0;5
12525;Žemuogėlė;Drugeliai;5521993938;Taip;9;0;0;9
12526;Žemuogėlė;Drugeliai;9562512849;Taip;5;0;0;5
12527;Žemuogėlė;Drugeliai;9940095947;Taip;1;0;0;1
12528;Žemuogėlė;Drugeliai;2158359435;Ne;3;0;0;3
12529;Žemuogėlė;Drugeliai;8426601160;Taip;13;0;0;13
12530;Žemuogėlė;Drugeliai;7765880043;Taip;0;21;0;21
12531;Žemuogėlė;Drugeliai;4663181188;Taip;0;21;0;21
12532;Žemuogėlė;Drugeliai;6086270618;Ne;0;6;0;6
12533;Žemuogėlė;"VIEVERSIUKAI ";9537297860;Taip;0;11;0;11
12534;Žemuogėlė;"VIEVERSIUKAI ";7050896262;Taip;6;1;0;7
12535;Žemuogėlė;"VIEVERSIUKAI ";8557325116;Taip;10;0;0;10
12536;Žemuogėlė;"VIEVERSIUKAI ";7328566035;Taip;11;0;1;12
12537;Žemuogėlė;"VIEVERSIUKAI ";2190458676;Taip;1;10;0;11
12538;Žemuogėlė;"VIEVERSIUKAI ";7708949381;Taip;3;0;0;3
12539;Žemuogėlė;"VIEVERSIUKAI ";3413805578;Taip;5;3;2;10
12540;Žemuogėlė;"VIEVERSIUKAI ";1350383125;Taip;8;3;0;11
12541;Žemuogėlė;"VIEVERSIUKAI ";1187953952;Taip;6;0;0;6
12542;Žemuogėlė;"VIEVERSIUKAI ";8040255583;Taip;0;4;0;4
12543;Žemuogėlė;"VIEVERSIUKAI ";7668200447;Taip;5;5;2;12
12544;Žemuogėlė;"VIEVERSIUKAI ";6073591450;Taip;0;6;0;6
12545;Žemuogėlė;"VIEVERSIUKAI ";4862145385;Taip;0;21;0;21
12546;Žemuogėlė;"VIEVERSIUKAI ";3677459716;Taip;11;1;1;13
12547;Žemuogėlė;"VIEVERSIUKAI ";9902953729;Taip;21;0;0;21
12548;Žemuogėlė;"NYKŠTUKAI ";5687585794;Taip;9;0;0;9
12549;Žemuogėlė;"NYKŠTUKAI ";3710681463;Taip;12;0;0;12
12550;Žemuogėlė;"NYKŠTUKAI ";4629107942;Taip;0;16;0;16
12551;Žemuogėlė;"NYKŠTUKAI ";1306065826;Taip;0;1;0;1
12552;Žemuogėlė;"NYKŠTUKAI ";8106709288;Taip;3;3;0;6
12553;Žemuogėlė;"NYKŠTUKAI ";1060986850;Taip;0;10;0;10
12554;Žemuogėlė;"NYKŠTUKAI ";7794377881;Taip;0;4;0;4
12555;Žemuogėlė;"NYKŠTUKAI ";1658954821;Taip;5;0;0;5
12556;Žemuogėlė;"NYKŠTUKAI ";4698671798;Taip;4;1;0;5
12557;Žemuogėlė;"NYKŠTUKAI ";2922827304;Taip;0;7;1;8
12558;Žemuogėlė;"NYKŠTUKAI ";7415364637;Ne;0;21;0;21
12559;Žemuogėlė;"NYKŠTUKAI ";1796489729;Taip;9;0;0;9
12560;Žemuogėlė;"NYKŠTUKAI ";8215763877;Taip;6;0;0;6
12561;Žemuogėlė;"NYKŠTUKAI ";2934225120;Taip;13;0;0;13
12562;Žemuogėlė;"NYKŠTUKAI ";3426685084;Ne;1;0;0;1
12563;Žemuogėlė;KIŠKUČIAI;8890454460;Taip;0;20;0;20
12564;Žemuogėlė;KIŠKUČIAI;4309482351;Taip;0;1;0;1
12565;Žemuogėlė;KIŠKUČIAI;7288060676;Taip;7;5;0;12
12566;Žemuogėlė;KIŠKUČIAI;3837424301;Taip;5;1;0;6
12567;Žemuogėlė;KIŠKUČIAI;5499401648;Taip;0;7;0;7
12568;Žemuogėlė;KIŠKUČIAI;7189855370;Taip;0;2;0;2
12569;Žemuogėlė;KIŠKUČIAI;7837251012;Taip;10;0;0;10
12570;Žemuogėlė;KIŠKUČIAI;3567924341;Taip;0;20;0;20
12571;Žemuogėlė;KIŠKUČIAI;8492878852;Taip;9;0;0;9
12572;Žemuogėlė;KIŠKUČIAI;3801534195;Taip;12;5;0;17
12573;Žemuogėlė;KIŠKUČIAI;5743971810;Taip;13;4;0;17
12574;Žemuogėlė;KIŠKUČIAI;7603740057;Taip;0;8;0;8
12575;Žemuogėlė;KIŠKUČIAI;8848085495;Taip;8;6;0;14
12576;Žemuogėlė;KIŠKUČIAI;4506847669;Ne;0;2;0;2
12577;Žemuogėlė;Žiniukai;1223819270;Ne;0;5;1;6
12578;Žemuogėlė;Žiniukai;2320908623;Taip;0;4;0;4
12579;Žemuogėlė;Žiniukai;2099256322;Taip;0;1;0;1
12580;Žemuogėlė;Žiniukai;1248683052;Taip;0;6;0;6
12581;Žemuogėlė;Žiniukai;2146044539;Taip;7;7;0;14
12582;Žemuogėlė;Žiniukai;4900328025;Taip;0;1;1;2
12583;Žemuogėlė;Žiniukai;8295541141;Taip;1;9;2;12
12584;Žemuogėlė;Žiniukai;97014601220;Taip;0;4;0;4
12585;Žemuogėlė;Žiniukai;31450036105;Ne;0;17;0;17
12586;Žemuogėlė;Žiniukai;1608506638;Taip;7;1;0;8
12587;Žemuogėlė;Žiniukai;1448477562;Taip;7;1;0;8
12588;Žemuogėlė;Žiniukai;93523683833;Taip;0;2;0;2
12589;Žemuogėlė;Žiniukai;1223648771;Taip;0;5;0;5
12590;Žemuogėlė;Žiniukai;60841198741;Taip;0;1;0;1
12591;Žibutė;PELĖDŽIUKAI;3496675605;Taip;0;0;2;2
12592;Žibutė;PELĖDŽIUKAI;5811023607;Taip;0;0;1;1
12593;Žibutė;PELĖDŽIUKAI;54535455969;Taip;0;5;8;13
12594;Žibutė;PELĖDŽIUKAI;62146271609;Taip;0;0;1;1
12595;Žibutė;PELĖDŽIUKAI;85042822872;Taip;3;0;1;4
12596;Žibutė;PELĖDŽIUKAI;59824395612;Taip;0;0;1;1
12597;Žibutė;PELĖDŽIUKAI;2361682400;Taip;0;0;2;2
12598;Žibutė;PELĖDŽIUKAI;1259481487;Taip;0;1;0;1
12599;Žibutė;PELĖDŽIUKAI;3826875107;Taip;0;10;0;10
12600;Žibutė;PELĖDŽIUKAI;3186792146;Taip;0;0;2;2
12601;Žibutė;PELĖDŽIUKAI;7344095020;Taip;0;0;2;2
12602;Žibutė;PELĖDŽIUKAI;1078105287;Taip;0;2;0;2
12603;Žibutė;PELĖDŽIUKAI;2152452830;Ne;0;0;3;3
12604;Žibutė;PELĖDŽIUKAI;1394895695;Taip;0;2;0;2
12605;Žibutė;PELĖDŽIUKAI;2236930916;Taip;9;0;1;10
12606;Žibutė;PELĖDŽIUKAI;7095870173;Taip;0;4;0;4
12607;Žibutė;PELĖDŽIUKAI;2840754631;Taip;0;0;1;1
12608;Žibutė;PELĖDŽIUKAI;6089325755;Ne;0;0;3;3
12609;Žibutė;PELĖDŽIUKAI;1274409680;Taip;0;12;6;18
12610;Žibutė;PELĖDŽIUKAI;8278928396;Taip;5;0;1;6
12611;Žibutė;KREGŽDUTĖS;7036454359;Ne;11;0;3;14
12612;Žibutė;KREGŽDUTĖS;5677389434;Taip;0;1;0;1
12613;Žibutė;KREGŽDUTĖS;5416015554;Taip;10;0;6;16
12614;Žibutė;KREGŽDUTĖS;2406005105;Taip;0;0;1;1
12615;Žibutė;KREGŽDUTĖS;3555071718;Taip;13;0;1;14
12616;Žibutė;KREGŽDUTĖS;7531027545;Taip;0;0;2;2
12617;Žibutė;KREGŽDUTĖS;5412917352;Taip;0;0;1;1
12618;Žibutė;KREGŽDUTĖS;3645481894;Taip;10;1;0;11
12619;Žibutė;KREGŽDUTĖS;6074488747;Ne;12;0;1;13
12620;Žibutė;KREGŽDUTĖS;8880329060;Taip;12;0;1;13
12621;Žibutė;KREGŽDUTĖS;2957525481;Taip;2;2;1;5
12622;Žibutė;KREGŽDUTĖS;6495108202;Taip;0;0;2;2
12623;Žibutė;KREGŽDUTĖS;5009495840;Ne;0;0;1;1
12624;Žibutė;KREGŽDUTĖS;7136145033;Taip;7;0;6;13
12625;Žibutė;KREGŽDUTĖS;5187777741;Taip;5;0;1;6
12626;Žibutė;KREGŽDUTĖS;5190377896;Taip;0;0;6;6
12627;Žibutė;KREGŽDUTĖS;3191351976;Taip;0;0;7;7
12628;Žibutė;KREGŽDUTĖS;6013340521;Taip;10;5;3;18
12629;Žibutė;KREGŽDUTĖS;9498011134;Taip;6;0;7;13
12630;Žibutė;BORUŽĖLĖS;3066580779;Taip;10;0;0;10
12631;Žibutė;BORUŽĖLĖS;1786332689;Taip;0;0;1;1
12632;Žibutė;BORUŽĖLĖS;2910188022;Taip;0;0;9;9
12633;Žibutė;BORUŽĖLĖS;8879347884;Taip;0;0;5;5
12634;Žibutė;BORUŽĖLĖS;7023683517;Taip;9;0;0;9
12635;Žibutė;BORUŽĖLĖS;7764376193;Taip;10;0;1;11
12636;Žibutė;BORUŽĖLĖS;3618347199;Taip;5;0;0;5
12637;Žibutė;BORUŽĖLĖS;5186839413;Taip;0;1;4;5
12638;Žibutė;BORUŽĖLĖS;2374119662;Taip;0;2;4;6
12639;Žibutė;BORUŽĖLĖS;1381488132;Taip;0;0;2;2
12640;Žibutė;BORUŽĖLĖS;5591970907;Taip;4;0;5;9
12641;Žibutė;BORUŽĖLĖS;7481695788;Taip;5;0;0;5
12642;Žibutė;BORUŽĖLĖS;1112295932;Taip;4;0;5;9
12643;Žibutė;BORUŽĖLĖS;8155327668;Taip;0;0;1;1
12644;Žibutė;BORUŽĖLĖS;5632520305;Taip;0;0;2;2
12645;Žibutė;BITUTĖS;3194445795;Taip;0;2;1;3
12646;Žibutė;BITUTĖS;14091973543;Taip;0;1;1;2
12647;Žibutė;BITUTĖS;24818054845;Taip;0;1;0;1
12648;Žibutė;BITUTĖS;27182644850;Taip;0;4;0;4
12649;Žibutė;BITUTĖS;9591439732;Taip;0;1;2;3
12650;Žibutė;BITUTĖS;90040902859;Taip;0;1;0;1
12651;Žibutė;BITUTĖS;39367516353;Taip;0;11;0;11
12652;Žibutė;BITUTĖS;1192143609;Taip;0;2;0;2
12653;Žibutė;BITUTĖS;72357016152;Taip;0;6;0;6
12654;Žibutė;BITUTĖS;1054908586;Taip;0;1;1;2
12655;Žibutė;BITUTĖS;2603387036;Taip;0;0;5;5
12656;Žibutė;BITUTĖS;1215072172;Taip;0;1;0;1
12657;Žibutė;BITUTĖS;1317512329;Taip;0;3;0;3
12658;Žibutė;BITUTĖS;2144866874;Ne;0;3;0;3
12659;Žibutė;BITUTĖS;1010766308;Taip;5;1;0;6
12660;Žibutė;BITUTĖS;1749323904;Taip;0;2;0;2
12661;Žibutė;BITUTĖS;62187632470;Taip;2;6;0;8
12662;Žibutė;BITUTĖS;90082848356;Taip;0;1;0;1
12663;Žibutė;BITUTĖS;4480906648;Ne;6;1;1;8
12664;Žibutė;BITUTĖS;3035056391;Taip;0;3;0;3
12665;Žibutė;BITUTĖS;8587562864;Taip;0;9;2;11
12666;Žibutė;BITUTĖS;2951520056;Taip;0;0;1;1
12667;Žibutė;BITUTĖS;87741312158;Ne;0;2;2;4
12668;Žibutė;KAČIUKAI;9634311146;Ne;5;0;0;5
12669;Žibutė;KAČIUKAI;8944042589;Taip;0;4;2;6
12670;Žibutė;KAČIUKAI;9868621666;Ne;0;0;3;3
12671;Žibutė;KAČIUKAI;9700866512;Taip;7;0;1;8
12672;Žibutė;KAČIUKAI;7774532200;Taip;0;6;0;6
12673;Žibutė;KAČIUKAI;1366469428;Ne;6;0;0;6
12674;Žibutė;KAČIUKAI;4825064521;Taip;0;15;4;19
12675;Žibutė;KAČIUKAI;5826523148;Taip;0;2;0;2
12676;Žibutė;KAČIUKAI;2438980348;Taip;3;0;2;5
12677;Žibutė;KAČIUKAI;5806696915;Taip;5;0;2;7
12678;Žibutė;KAČIUKAI;3957898269;Taip;4;0;0;4
12679;Žibutė;KAČIUKAI;9918283923;Taip;5;0;1;6
12680;Žibutė;KAČIUKAI;4382812297;Taip;0;0;1;1
12681;Žibutė;KAČIUKAI;5591698130;Taip;0;0;1;1
12682;Žibutė;KAČIUKAI;5126232169;Ne;10;0;3;13
12683;Žibutė;KAČIUKAI;8792292819;Taip;21;0;0;21
12684;Žibutė;KAČIUKAI;7668484415;Taip;0;4;0;4
12685;Žibutė;KAČIUKAI;1004098038;Taip;2;0;1;3
12686;Žibutė;KAČIUKAI;2880593326;Taip;0;0;1;1
12687;Žibutė;KAČIUKAI;7479437931;Ne;5;2;0;7
12688;Žibutė;ZUIKIAI;2312717334;Taip;0;0;5;5
12689;Žibutė;ZUIKIAI;1515636796;Taip;4;3;0;7
12690;Žibutė;ZUIKIAI;4092363029;Taip;7;5;0;12
12691;Žibutė;ZUIKIAI;9168673977;Taip;10;0;3;13
12692;Žibutė;ZUIKIAI;7872636200;Taip;9;0;1;10
12693;Žibutė;ZUIKIAI;4455757640;Taip;12;0;4;16
12694;Žibutė;ZUIKIAI;6361543454;Taip;0;0;10;10
12695;Žibutė;ZUIKIAI;1297347740;Taip;10;0;0;10
12696;Žibutė;ZUIKIAI;7611641692;Taip;7;0;1;8
12697;Žibutė;ZUIKIAI;9221523836;Taip;0;5;5;10
12698;Žibutė;ZUIKIAI;6833179680;Taip;0;0;7;7
12699;Žibutė;ZUIKIAI;4685356158;Taip;0;0;4;4
12700;Žibutė;ZUIKIAI;7792267540;Taip;0;0;9;9
12701;Žibutė;ZUIKIAI;6934760468;Taip;5;1;0;6
12702;Žibutė;ZUIKIAI;1614551884;Taip;0;0;6;6
12703;Žibutė;ZUIKIAI;3632745935;Taip;0;0;9;9
12704;Žibutė;ZUIKIAI;3687123871;Taip;6;0;5;11
12705;Žibutė;ZUIKIAI;8797870379;Taip;9;0;0;9
12706;Žiedas;Bitutės;9573180529;Taip;0;15;0;15
12707;Žiedas;Bitutės;1219022794;Taip;0;9;0;9
12708;Žiedas;Bitutės;3930283171;Taip;0;4;0;4
12709;Žiedas;Bitutės;1600420971;Taip;0;13;0;13
12710;Žiedas;Bitutės;42049755986;Taip;0;3;0;3
12711;Žiedas;Bitutės;1785446716;Taip;0;1;0;1
12712;Žiedas;Bitutės;1835889494;Taip;8;1;0;9
12713;Žiedas;Bitutės;52721173922;Ne;0;1;0;1
12714;Žiedas;Bitutės;3346603228;Ne;0;6;0;6
12715;Žiedas;Bitutės;2094277643;Ne;0;1;0;1
12716;Žiedas;Bitutės;5812737969;Ne;0;3;0;3
12717;Žiedas;Bitutės;1127645903;Taip;0;2;0;2
12718;Žiedas;Bitutės;27339844730;Taip;0;10;0;10
12719;Žiedas;Bitutės;1779122644;Taip;0;1;0;1
12720;Žiedas;Bitutės;9940683245;Taip;0;1;0;1
12721;Žiedas;Bitutės;3616767119;Taip;0;2;0;2
12722;Žiedas;Bitutės;2434909184;Taip;0;2;0;2
12723;Žiedas;Bitutės;1200692015;Taip;0;1;0;1
12724;Žiedas;Bitutės;7647496475;Taip;5;2;0;7
12725;Žiedas;Bitutės;1458152054;Ne;3;1;0;4
12726;Žiedas;Varpeliai;3230107921;Ne;0;1;0;1
12727;Žiedas;Varpeliai;3178778438;Taip;10;1;2;13
12728;Žiedas;Varpeliai;9602083568;Taip;5;3;0;8
12729;Žiedas;Varpeliai;5628720422;Ne;8;1;0;9
12730;Žiedas;Varpeliai;1582961378;Ne;1;1;1;3
12731;Žiedas;Varpeliai;6444377924;Taip;0;0;1;1
12732;Žiedas;Varpeliai;9587581470;Taip;0;4;1;5
12733;Žiedas;Varpeliai;1878050384;Ne;0;1;6;7
12734;Žiedas;Varpeliai;3704491209;Taip;7;1;1;9
12735;Žiedas;Varpeliai;6882614465;Taip;0;5;4;9
12736;Žiedas;Varpeliai;5578227349;Taip;5;1;1;7
12737;Žiedas;Varpeliai;6914059680;Taip;0;2;7;9
12738;Žiedas;Varpeliai;7771247056;Ne;5;0;0;5
12739;Žiedas;Varpeliai;8812316692;Taip;8;0;0;8
12740;Žiedas;Varpeliai;6515510381;Taip;5;0;1;6
12741;Žiedas;Varpeliai;3842589827;Taip;0;21;0;21
12742;Žiedas;Varpeliai;5835309107;Taip;2;1;0;3
12743;Žiedas;Varpeliai;3387263016;Ne;5;0;0;5
12744;Žiedas;Varpeliai;3178580610;Ne;5;11;0;16
12745;Žiedas;Varpeliai;1043230748;Taip;5;1;0;6
12746;Žiedas;Varpeliai;5061575884;Taip;11;6;0;17
12747;Žiedas;Varpeliai;1333233100;Ne;5;0;0;5
12748;Žiedas;Ramunėlės;1333555044;Taip;20;0;0;20
12749;Žiedas;Ramunėlės;2092319455;Taip;7;3;0;10
12750;Žiedas;Ramunėlės;5789261620;Taip;5;1;1;7
12751;Žiedas;Ramunėlės;69245659818;Ne;0;7;0;7
12752;Žiedas;Ramunėlės;8753972322;Ne;0;4;0;4
12753;Žiedas;Ramunėlės;3900091129;Taip;0;1;0;1
12754;Žiedas;Ramunėlės;3067962647;Ne;0;21;0;21
12755;Žiedas;Ramunėlės;2843328732;Taip;1;0;1;2
12756;Žiedas;Ramunėlės;2515028280;Taip;5;2;0;7
12757;Žiedas;Ramunėlės;1583038469;Taip;10;1;0;11
12758;Žiedas;Ramunėlės;8208331527;Taip;0;3;0;3
12759;Žiedas;Ramunėlės;6815408748;Taip;5;2;0;7
12760;Žiedas;Ramunėlės;7136135394;Taip;0;4;0;4
12761;Žiedas;Ramunėlės;5577339739;Ne;0;0;4;4
12762;Žiedas;Ramunėlės;6884933845;Taip;14;0;0;14
12763;Žiedas;Ramunėlės;7548653053;Ne;0;9;0;9
12764;Žiedas;Pakalnutės;4922560649;Taip;0;9;0;9
12765;Žiedas;Pakalnutės;6703889237;Taip;0;0;1;1
12766;Žiedas;Pakalnutės;2095655987;Ne;4;2;0;6
12767;Žiedas;Pakalnutės;7814504623;Taip;8;0;0;8
12768;Žiedas;Pakalnutės;9648580306;Taip;0;3;0;3
12769;Žiedas;Pakalnutės;9699668892;Taip;0;2;0;2
12770;Žiedas;Pakalnutės;5653785844;Ne;0;1;0;1
12771;Žiedas;Pakalnutės;9247088735;Taip;13;0;1;14
12772;Žiedas;Pakalnutės;7396006218;Taip;5;0;0;5
12773;Žiedas;Pakalnutės;5588136738;Taip;0;3;0;3
12774;Žiedas;Pakalnutės;6786526552;Ne;0;2;17;19
12775;Žiedas;Pakalnutės;2511423525;Taip;0;0;1;1
12776;Žiedas;Pakalnutės;6432090199;Taip;10;2;0;12
12777;Žiedas;Pakalnutės;5626494892;Taip;3;2;2;7
12778;Žiedas;Pakalnutės;7954517383;Taip;0;1;0;1
12779;Žiedas;Pakalnutės;3702078720;Taip;3;0;0;3
12780;Žiedas;Pakalnutės;2849254119;Taip;9;7;0;16
12781;Žiedas;Pakalnutės;9736967156;Taip;0;2;2;4
12782;Žiedas;Pakalnutės;3586376571;Taip;0;0;1;1
12783;Žiedas;Pakalnutės;1139186052;Taip;4;2;0;6
12784;Žiedas;Rožytės;2718046390;Taip;0;1;4;5
12785;Žiedas;Rožytės;9757771445;Ne;3;0;5;8
12786;Žiedas;Rožytės;73923918829;Taip;0;1;0;1
12787;Žiedas;Rožytės;1772492727;Taip;0;1;3;4
12788;Žiedas;Rožytės;8372385066;Taip;6;1;0;7
12789;Žiedas;Rožytės;3613860509;Taip;0;1;2;3
12790;Žiedas;Rožytės;5537717174;Taip;0;11;0;11
12791;Žiedas;Rožytės;6925923143;Taip;0;19;0;19
12792;Žiedas;Rožytės;1453937876;Taip;3;1;0;4
12793;Žiedas;Rožytės;1781950568;Ne;0;1;2;3
12794;Žiedas;Rožytės;4749655084;Taip;6;0;0;6
12795;Žiedas;Rožytės;9702211410;Taip;0;12;0;12
12796;Žiedas;Rožytės;5570910138;Taip;0;8;0;8
12797;Žiedas;Rožytės;2763996098;Taip;20;0;0;20
12798;Žiedas;Rožytės;9894489800;Ne;0;11;0;11
12799;Žiedas;Rožytės;3641595127;Taip;0;3;0;3
12800;Žiedas;Rožytės;9129315784;Taip;0;0;8;8
12801;Žiedas;Rožytės;9094287056;Taip;0;0;5;5
12802;Žiedas;Rožytės;3370495317;Taip;0;6;0;6
12803;Žiedas;Rožytės;7952899220;Ne;0;1;2;3
12804;Žiedas;Rožytės;7672879525;Taip;0;3;0;3
12805;Žiedas;Rožytės;4222689492;Taip;5;0;0;5
12806;Žiedas;Rožytės;4983852075;Taip;0;0;6;6
12807;Žiedas;Rožytės;8517250094;Taip;0;3;0;3
12808;Žiedas;Pumpurėliai;2320543511;Ne;0;2;0;2
12809;Žiedas;Pumpurėliai;1243169901;Taip;0;4;0;4
12810;Žiedas;Pumpurėliai;6092349434;Taip;15;0;0;15
12811;Žiedas;Pumpurėliai;5920211041;Taip;0;4;0;4
12812;Žiedas;Pumpurėliai;4044156905;Taip;0;0;4;4
12813;Žiedas;Pumpurėliai;8056265378;Taip;0;1;9;10
12814;Žiedas;Pumpurėliai;4844442247;Taip;0;1;5;6
12815;Žiedas;Pumpurėliai;8088806507;Taip;12;0;0;12
12816;Žiedas;Pumpurėliai;7294671324;Taip;12;0;1;13
12817;Žiedas;Pumpurėliai;3821849812;Taip;9;1;2;12
12818;Žiedas;Pumpurėliai;2584965465;Ne;0;0;5;5
12819;Žiedas;Pumpurėliai;1580781723;Ne;4;1;0;5
12820;Žiedas;Pumpurėliai;4933650089;Ne;0;5;2;7
12821;Žiedas;Pumpurėliai;2320411618;Taip;2;2;0;4
12822;Žiedas;"Dobiliukai ";6053010050;Taip;5;1;0;6
12823;Žiedas;"Dobiliukai ";2932857132;Taip;1;1;2;4
12824;Žiedas;"Dobiliukai ";7604200899;Taip;0;1;0;1
12825;Žiedas;"Dobiliukai ";3303581707;Ne;0;2;0;2
12826;Žiedas;"Dobiliukai ";8887021328;Taip;16;0;0;16
12827;Žiedas;"Dobiliukai ";5552786845;Ne;0;1;0;1
12828;Žiedas;"Dobiliukai ";8833895006;Ne;0;3;0;3
12829;Žiedas;"Dobiliukai ";1659873036;Taip;3;0;0;3
12830;Žiedas;"Dobiliukai ";1645402434;Taip;5;0;0;5
12831;Žiedas;"Dobiliukai ";4712780337;Ne;10;0;0;10
12832;Žiedas;"Dobiliukai ";3437651010;Taip;11;0;0;11
12833;Žiedas;"Dobiliukai ";5274845525;Taip;0;21;0;21
12834;Žiedas;"Dobiliukai ";7057747531;Taip;0;1;0;1
12835;Žiedas;"Dobiliukai ";9057761408;Taip;0;1;6;7
12836;Žiedas;"Dobiliukai ";2682112101;Taip;5;1;0;6
12837;Žiedas;"Dobiliukai ";1011602827;Taip;0;7;0;7
12838;Žiedas;RŪTELĖS;5885209631;Taip;5;2;1;8
12839;Žiedas;RŪTELĖS;2134466899;Taip;0;9;0;9
12840;Žiedas;RŪTELĖS;5108263139;Taip;6;0;0;6
12841;Žiedas;RŪTELĖS;6822887260;Taip;0;2;0;2
12842;Žiedas;RŪTELĖS;9352485926;Taip;11;0;1;12
12843;Žiedas;RŪTELĖS;5914428064;Taip;0;14;0;14
12844;Žiedas;RŪTELĖS;3857121753;Taip;0;14;0;14
12845;Žiedas;RŪTELĖS;6443633568;Taip;6;2;1;9
12846;Žiedas;RŪTELĖS;7491134119;Taip;0;1;0;1
12847;Žiedas;RŪTELĖS;5959899914;Taip;6;6;0;12
12848;Žiedas;RŪTELĖS;7333813704;Ne;0;4;0;4
12849;Žiedas;RŪTELĖS;1048272199;Taip;0;1;0;1
12850;Žiedas;RŪTELĖS;7578964555;Taip;0;7;0;7
12851;Žiedas;RŪTELĖS;5126173608;Taip;7;2;0;9
12852;Žiedas;RŪTELĖS;5647232875;Taip;2;1;0;3
12853;Žiedas;RŪTELĖS;1738121071;Taip;0;4;0;4
12854;Žiedas;RŪTELĖS;1737296046;Taip;0;1;0;1
12855;Žiedas;RŪTELĖS;1253833615;Ne;0;1;0;1
12856;Žiedas;RŪTELĖS;7172793351;Ne;0;4;0;4
12857;Žiedas;RŪTELĖS;4497634040;Taip;0;0;1;1
12858;Žiedas;RŪTELĖS;9218388800;Taip;0;7;0;7
12859;Žiedas;RŪTELĖS;7072578987;Ne;5;3;0;8
12860;Žiedas;RŪTELĖS;3715928992;Taip;0;0;1;1
12861;Žiedas;SAULĖGRĄŽOS;1484464986;Taip;7;0;0;7
12862;Žiedas;SAULĖGRĄŽOS;4807479784;Taip;0;1;0;1
12863;Žiedas;SAULĖGRĄŽOS;1030089009;Ne;0;3;0;3
12864;Žiedas;SAULĖGRĄŽOS;1529988412;Taip;0;2;0;2
12865;Žiedas;SAULĖGRĄŽOS;1007894628;Ne;0;5;0;5
12866;Žiedas;SAULĖGRĄŽOS;1625009666;Taip;0;11;0;11
12867;Žiedas;SAULĖGRĄŽOS;1550350520;Taip;7;0;0;7
12868;Žiedas;SAULĖGRĄŽOS;9058688663;Ne;0;9;0;9
12869;Žiedas;SAULĖGRĄŽOS;7150433256;Taip;0;1;0;1
12870;Žiedas;SAULĖGRĄŽOS;9337128671;Taip;0;1;0;1
12871;Žiedas;SAULĖGRĄŽOS;6145720452;Taip;2;6;0;8
12872;Žiedas;SAULĖGRĄŽOS;2507543124;Taip;0;18;0;18
12873;Žiedas;SAULĖGRĄŽOS;88471315730;Taip;0;1;0;1
12874;Žiedas;SAULĖGRĄŽOS;34193530;Taip;2;2;0;4
12875;Žiedas;SAULĖGRĄŽOS;86877563124;Taip;0;5;0;5
12876;Žiedas;SAULĖGRĄŽOS;78720591915;Taip;0;3;0;3
12877;Žiedas;SAULĖGRĄŽOS;2763469583;Taip;0;13;0;13
12878;Žiedas;RUGIAGĖLĖS;8148831014;Ne;0;1;1;2
12879;Žiedas;RUGIAGĖLĖS;8645771800;Taip;8;1;0;9
12880;Žiedas;RUGIAGĖLĖS;8163645535;Taip;0;13;1;14
12881;Žiedas;RUGIAGĖLĖS;6261847845;Taip;0;0;1;1
12882;Žiedas;RUGIAGĖLĖS;6459679214;Ne;6;0;0;6
12883;Žiedas;RUGIAGĖLĖS;7584712202;Ne;5;0;1;6
12884;Žiedas;RUGIAGĖLĖS;3984607857;Taip;6;0;1;7
12885;Žiedas;RUGIAGĖLĖS;7942276632;Taip;5;0;0;5
12886;Žiedas;RUGIAGĖLĖS;6041919197;Taip;0;0;1;1
12887;Žiedas;RUGIAGĖLĖS;7799489700;Taip;15;4;0;19
12888;Žiedas;RUGIAGĖLĖS;8927034492;Taip;0;4;17;21
12889;Žiedas;RUGIAGĖLĖS;2182381160;Taip;2;1;1;4
12890;Žiedas;RUGIAGĖLĖS;6175213274;Ne;0;0;1;1
12891;Žiedas;RUGIAGĖLĖS;8822472312;Taip;0;10;0;10
12892;Žiedas;RUGIAGĖLĖS;9021286246;Taip;0;3;0;3
12893;Žiedas;RUGIAGĖLĖS;1777501190;Taip;0;1;0;1
12894;Žiedas;RUGIAGĖLĖS;1844621525;Ne;0;5;0;5
12895;Žiedas;RUGIAGĖLĖS;1219634640;Taip;0;2;0;2
12896;Žiedas;RUGIAGĖLĖS;9750690920;Taip;0;11;0;11
12897;Žiedas;RUGIAGĖLĖS;1035854293;Ne;5;0;0;5
12898;Žiedas;RUGIAGĖLĖS;1917085385;Ne;7;0;0;7
12899;Žiedas;RUGIAGĖLĖS;4284627073;Taip;0;0;1;1
12900;Žiedas;RUGIAGĖLĖS;5987689515;Taip;7;0;2;9
12901;Žiedas;Boružėlės;1733596148;Taip;0;3;1;4
12902;Žiedas;Boružėlės;1748932818;Taip;0;1;0;1
12903;Žiedas;Boružėlės;5835879070;Taip;2;0;0;2
12904;Žiedas;Boružėlės;2081656643;Taip;0;0;2;2
12905;Žiedas;Boružėlės;1120478375;Taip;0;10;0;10
12906;Žiedas;Boružėlės;1332249885;Ne;0;1;0;1
12907;Žiedas;Boružėlės;37314210812;Taip;1;1;0;2
12908;Žiedas;Boružėlės;12622490543;Ne;0;18;0;18
12909;Žiedas;Boružėlės;32671505578;Taip;0;3;0;3
12910;Žiedas;Boružėlės;9044903345;Taip;6;0;0;6
12911;Žiedas;Boružėlės;1443451076;Taip;0;0;3;3
12912;Žiedas;Boružėlės;99985645406;Taip;0;1;0;1
12913;Žiedas;Boružėlės;2147350804;Taip;0;1;0;1
12914;Žiedas;Boružėlės;17275054601;Taip;0;1;0;1
12915;Žiedas;Boružėlės;1897597456;Taip;0;3;0;3
12916;Žiedas;Boružėlės;52683198809;Ne;1;0;0;1
12917;Žiedas;Boružėlės;55459877940;Taip;0;1;0;1
12918;Žiedas;Boružėlės;1708363648;Taip;11;0;0;11
12919;Žiedas;AGUONĖLĖS;4917324037;Taip;0;5;0;5
12920;Žiedas;AGUONĖLĖS;6343634478;Taip;0;4;0;4
12921;Žiedas;AGUONĖLĖS;8857150598;Taip;10;1;0;11
12922;Žiedas;AGUONĖLĖS;8015880569;Ne;1;1;0;2
12923;Žiedas;AGUONĖLĖS;8436592169;Taip;0;1;0;1
12924;Žiedas;AGUONĖLĖS;9054709268;Ne;0;3;0;3
12925;Žiedas;AGUONĖLĖS;9964883646;Ne;5;2;0;7
12926;Žiedas;AGUONĖLĖS;4021189767;Taip;0;2;2;4
12927;Žiedas;AGUONĖLĖS;4808020243;Ne;3;0;0;3
12928;Žiedas;AGUONĖLĖS;1346658299;Taip;5;2;1;8
12929;Žiedas;AGUONĖLĖS;4697477761;Taip;2;0;0;2
12930;Žiedas;AGUONĖLĖS;7678333395;Ne;8;2;0;10
12931;Žiedas;AGUONĖLĖS;9207945616;Taip;6;0;0;6
12932;Žiedas;AGUONĖLĖS;7221702677;Ne;0;1;0;1
12933;Žiedas;AGUONĖLĖS;6614027605;Ne;10;0;0;10
12934;Žiedas;ŽIBUTĖS;2642760082;Taip;0;4;0;4
12935;Žiedas;ŽIBUTĖS;1975718197;Ne;8;0;0;8
12936;Žiedas;ŽIBUTĖS;7381658912;Ne;11;0;2;13
12937;Žiedas;ŽIBUTĖS;4242575616;Taip;9;3;0;12
12938;Žiedas;ŽIBUTĖS;8794003030;Ne;0;2;0;2
12939;Žiedas;ŽIBUTĖS;2312361963;Ne;0;16;0;16
12940;Žiedas;ŽIBUTĖS;9586578606;Taip;0;2;0;2
12941;Žiedas;ŽIBUTĖS;1758868055;Taip;6;0;1;7
12942;Žiedas;ŽIBUTĖS;2182340305;Ne;0;0;1;1
12943;Žiedas;ŽIBUTĖS;3940002957;Taip;6;2;0;8
12944;Žiedas;ŽIBUTĖS;2347857813;Taip;0;14;0;14
12945;Žiedas;ŽIBUTĖS;2148027253;Taip;10;5;0;15
12946;Žiedas;ŽIBUTĖS;7228139235;Ne;3;2;0;5
12947;Žiedas;ŽIBUTĖS;1958481432;Ne;6;2;0;8
12948;Žiedas;ŽIBUTĖS;1093479755;Ne;16;2;0;18
12949;Žiedas;ŽIBUTĖS;2124086277;Ne;10;0;0;10
12950;Žiedas;ŽIBUTĖS;6859410675;Ne;10;0;0;10
12951;Žiogelis;SKRUZDELYTĖS;1618384759;Taip;0;1;0;1
12952;Žiogelis;SKRUZDELYTĖS;5054228916;Taip;0;0;1;1
12953;Žiogelis;SKRUZDELYTĖS;8712788346;Taip;0;10;0;10
12954;Žiogelis;SKRUZDELYTĖS;7535167450;Taip;7;1;0;8
12955;Žiogelis;SKRUZDELYTĖS;3361421852;Taip;0;2;0;2
12956;Žiogelis;SKRUZDELYTĖS;1268908081;Taip;0;2;0;2
12957;Žiogelis;SKRUZDELYTĖS;3856321373;Taip;15;1;0;16
12958;Žiogelis;SKRUZDELYTĖS;6378295945;Taip;7;1;0;8
12959;Žiogelis;SKRUZDELYTĖS;7340918175;Taip;0;4;0;4
12960;Žiogelis;SKRUZDELYTĖS;4513613915;Taip;0;3;0;3
12961;Žiogelis;SKRUZDELYTĖS;6866685213;Taip;0;14;0;14
12962;Žiogelis;SKRUZDELYTĖS;7310459638;Taip;0;2;0;2
12963;Žiogelis;SKRUZDELYTĖS;9813150014;Taip;5;1;0;6
12964;Žiogelis;SKRUZDELYTĖS;8591680136;Taip;0;9;0;9
12965;Žiogelis;SKRUZDELYTĖS;8959934210;Ne;3;1;0;4
12966;Žiogelis;SKRUZDELYTĖS;6593794147;Taip;8;0;1;9
12967;Žiogelis;SKRUZDELYTĖS;8058231095;Taip;8;1;0;9
12968;Žiogelis;SKRUZDELYTĖS;1650284820;Taip;2;2;0;4
12969;Žiogelis;SKRUZDELYTĖS;5487213418;Taip;0;3;0;3
12970;Žiogelis;SKRUZDELYTĖS;1763603533;Ne;14;2;0;16
12971;Žiogelis;ŽIRNIUKAI;4677024422;Taip;4;0;0;4
12972;Žiogelis;DOBILĖLIAI;8683148826;Taip;5;0;1;6
12973;Žiogelis;DOBILĖLIAI;3308563362;Taip;0;2;0;2
12974;Žiogelis;DOBILĖLIAI;2117192553;Taip;5;0;0;5
12975;Žiogelis;DOBILĖLIAI;1190395481;Taip;6;0;0;6
12976;Žiogelis;DOBILĖLIAI;1465027680;Taip;7;0;1;8
12977;Žiogelis;DOBILĖLIAI;6495456608;Taip;0;7;0;7
12978;Žiogelis;DOBILĖLIAI;5364996984;Taip;6;0;1;7
12979;Žiogelis;DOBILĖLIAI;9568208184;Taip;6;0;1;7
12980;Žiogelis;DOBILĖLIAI;6340620973;Ne;0;14;0;14
12981;Žiogelis;DOBILĖLIAI;5961630249;Taip;11;0;0;11
12982;Žiogelis;DOBILĖLIAI;6532218580;Taip;4;0;1;5
12983;Žiogelis;DOBILĖLIAI;1763070523;Taip;6;1;0;7
12984;Žiogelis;DOBILĖLIAI;5911231906;Taip;0;2;0;2
12985;Žiogelis;DOBILĖLIAI;1609336147;Taip;10;0;0;10
12986;Žiogelis;DOBILĖLIAI;9610249055;Taip;8;0;3;11
12987;Žiogelis;DOBILĖLIAI;6115834138;Ne;14;0;0;14
12988;Žiogelis;DOBILĖLIAI;3887222613;Ne;9;2;0;11
12989;Žiogelis;DOBILĖLIAI;8485067381;Taip;5;0;0;5
12990;Žiogelis;DOBILĖLIAI;7065052244;Taip;10;0;0;10
12991;Žiogelis;DOBILĖLIAI;4103035195;Taip;9;5;0;14
12992;Žiogelis;BORUŽĖLĖS;54446173105;Taip;0;0;4;4
12993;Žiogelis;BORUŽĖLĖS;4776403513;Taip;2;0;0;2
12994;Žiogelis;BORUŽĖLĖS;1617516552;Taip;0;1;0;1
12995;Žiogelis;BORUŽĖLĖS;4465151986;Taip;0;0;8;8
12996;Žiogelis;BORUŽĖLĖS;6963163354;Taip;4;1;1;6
12997;Žiogelis;BORUŽĖLĖS;98660118094;Taip;5;5;0;10
12998;Žiogelis;BORUŽĖLĖS;8169022043;Taip;0;1;2;3
12999;Žiogelis;BORUŽĖLĖS;65387706999;Taip;0;1;0;1
13000;Žiogelis;BORUŽĖLĖS;45051106222;Taip;5;6;0;11
13001;Žiogelis;BORUŽĖLĖS;49836275638;Taip;0;1;3;4
13002;Žiogelis;BORUŽĖLĖS;48896172781;Taip;0;1;0;1
13003;Žiogelis;BORUŽĖLĖS;29876596658;Taip;0;1;0;1
13004;Žiogelis;BORUŽĖLĖS;63956907259;Ne;0;2;0;2
13005;Žiogelis;BORUŽĖLĖS;30488905109;Ne;0;1;0;1
13006;Žiogelis;BORUŽĖLĖS;87755643169;Taip;0;1;2;3
13007;Žiogelis;BORUŽĖLĖS;89934673064;Ne;0;1;1;2
13008;Žiogelis;BORUŽĖLĖS;8315172690;Taip;15;0;0;15
13009;Žiogelis;BORUŽĖLĖS;1137529145;Ne;0;1;0;1
13010;Žiogelis;BORUŽĖLĖS;18957711548;Ne;0;1;0;1
13011;Žiogelis;DRUGELIAI;4156736676;Ne;8;1;0;9
13012;Žiogelis;DRUGELIAI;7128248940;Ne;0;1;0;1
13013;Žiogelis;DRUGELIAI;3963308094;Taip;0;3;0;3
13014;Žiogelis;DRUGELIAI;9250789113;Taip;0;3;0;3
13015;Žiogelis;DRUGELIAI;7502572217;Taip;5;2;4;11
13016;Žiogelis;DRUGELIAI;5876904663;Taip;1;0;1;2
13017;Žiogelis;DRUGELIAI;8217782981;Taip;0;9;0;9
13018;Žiogelis;DRUGELIAI;7120126547;Taip;0;1;0;1
13019;Žiogelis;DRUGELIAI;9387048672;Taip;6;1;0;7
13020;Žiogelis;DRUGELIAI;4378941619;Taip;5;1;1;7
13021;Žiogelis;DRUGELIAI;3937261260;Taip;0;2;0;2
13022;Žiogelis;DRUGELIAI;8894068297;Taip;0;6;0;6
13023;Žiogelis;DRUGELIAI;4609861306;Taip;0;0;1;1
13024;Žiogelis;DRUGELIAI;2759766559;Taip;16;0;0;16
13025;Žiogelis;DRUGELIAI;4565342104;Taip;0;2;0;2
13026;Žiogelis;DRUGELIAI;1939672072;Taip;10;0;1;11
13027;Žiogelis;DRUGELIAI;8689074067;Ne;0;0;8;8
13028;Žiogelis;DRUGELIAI;6709029770;Taip;0;2;0;2
13029;Žiogelis;DRUGELIAI;7702173581;Taip;0;5;2;7
13030;Žiogelis;DRUGELIAI;7725494899;Taip;0;1;0;1
13031;Žiogelis;PELĖDŽIUKAI;9295720241;Taip;4;5;0;9
13032;Žiogelis;PELĖDŽIUKAI;24941867247;Ne;0;1;0;1
13033;Žiogelis;PELĖDŽIUKAI;8819549855;Ne;0;2;2;4
13034;Žiogelis;PELĖDŽIUKAI;3189872952;Taip;0;2;1;3
13035;Žiogelis;PELĖDŽIUKAI;2883732914;Taip;0;2;1;3
13036;Žiogelis;PELĖDŽIUKAI;3609961581;Taip;0;1;2;3
13037;Žiogelis;PELĖDŽIUKAI;3503872654;Taip;3;0;0;3
13038;Žiogelis;PELĖDŽIUKAI;6346503991;Taip;0;1;0;1
13039;Žiogelis;PELĖDŽIUKAI;7881358741;Taip;0;4;0;4
13040;Žiogelis;PELĖDŽIUKAI;8702710674;Taip;0;14;0;14
13041;Žiogelis;PELĖDŽIUKAI;4671356872;Taip;9;1;0;10
13042;Žiogelis;PELĖDŽIUKAI;18018505301;Taip;0;2;0;2
13043;Žiogelis;PELĖDŽIUKAI;3750023611;Taip;3;1;0;4
13044;Žiogelis;PELĖDŽIUKAI;4343510173;Taip;0;8;0;8
13045;Žiogelis;PELĖDŽIUKAI;6659086172;Taip;0;2;0;2
13046;Žiogelis;PELĖDŽIUKAI;4508141956;Taip;0;1;2;3
13047;Žiogelis;PELĖDŽIUKAI;95713316600;Taip;3;1;2;6
13048;Žiogelis;PELĖDŽIUKAI;3203359908;Taip;10;1;0;11
13049;Žiogelis;PELĖDŽIUKAI;3320077143;Ne;0;2;0;2
13050;Žiogelis;PELĖDŽIUKAI;6067622823;Taip;2;1;0;3
13051;Žiogelis;PELĖDŽIUKAI;1160064257;Taip;6;1;0;7
13052;Žiogelis;VARPELIAI;1198917418;Taip;7;7;0;14
13053;Žiogelis;VARPELIAI;7708273984;Taip;7;3;0;10
13054;Žiogelis;VARPELIAI;1060830668;Taip;21;0;0;21
13055;Žiogelis;VARPELIAI;6225523016;Taip;7;5;0;12
13056;Žiogelis;VARPELIAI;4402777236;Taip;5;6;0;11
13057;Žiogelis;VARPELIAI;1370071592;Taip;10;1;0;11
13058;Žiogelis;VARPELIAI;9416538794;Taip;0;4;0;4
13059;Žiogelis;VARPELIAI;7888873296;Taip;7;7;0;14
13060;Žiogelis;VARPELIAI;9032003195;Ne;0;3;0;3
13061;Žiogelis;VARPELIAI;8262619320;Taip;0;6;0;6
13062;Žiogelis;VARPELIAI;1837140329;Ne;4;1;0;5
13063;Žiogelis;VARPELIAI;3520393042;Ne;0;3;0;3
13064;Žiogelis;VARPELIAI;8983731310;Taip;0;4;0;4
13065;Žiogelis;VARPELIAI;1954544417;Ne;7;1;0;8
13066;Žiogelis;VARPELIAI;9501262918;Ne;6;1;0;7
13067;Žiogelis;VARPELIAI;6716558946;Ne;12;0;0;12
13068;Žiogelis;VARPELIAI;9874412804;Taip;0;1;0;1
13069;Žiogelis;KREGŽDUTĖS;1195431423;Taip;0;1;0;1
13070;Žiogelis;KREGŽDUTĖS;52932005977;Ne;0;3;0;3
13071;Žiogelis;KREGŽDUTĖS;28585504631;Taip;0;0;1;1
13072;Žiogelis;KREGŽDUTĖS;71387182665;Taip;8;1;0;9
13073;Žiogelis;KREGŽDUTĖS;94313785346;Taip;0;6;0;6
13074;Žiogelis;KREGŽDUTĖS;88933947850;Ne;0;0;1;1
13075;Žiogelis;KREGŽDUTĖS;22969768169;Taip;0;6;0;6
13076;Žiogelis;KREGŽDUTĖS;18304908981;Taip;0;1;0;1
13077;Žiogelis;KREGŽDUTĖS;1042591705;Taip;0;4;0;4
13078;Žiogelis;KREGŽDUTĖS;1162630845;Taip;0;2;0;2
13079;Žiogelis;KREGŽDUTĖS;2072071751;Ne;3;1;0;4
13080;Žiogelis;KREGŽDUTĖS;1200247527;Taip;0;4;0;4
13081;Žiogelis;KREGŽDUTĖS;44023584723;Taip;0;2;0;2
13082;Žiogelis;KREGŽDUTĖS;1915370991;Taip;0;8;0;8
13083;Žiogelis;KREGŽDUTĖS;24010106626;Taip;6;0;0;6
13084;Žiogelis;KREGŽDUTĖS;3802615302;Taip;0;1;0;1
13085;Žiogelis;KREGŽDUTĖS;10001742134;Taip;0;4;2;6
13086;Žiogelis;KREGŽDUTĖS;4675275745;Taip;7;0;0;7
13087;Žiogelis;KREGŽDUTĖS;80050087040;Taip;15;2;0;17
13088;Žiogelis;KREGŽDUTĖS;3072299230;Taip;0;0;1;1
13089;Žiogelis;ŽVIRBLIUKAI;4450344120;Ne;0;0;1;1
13090;Žiogelis;ŽVIRBLIUKAI;8998694866;Ne;14;0;0;14
13091;Žiogelis;ŽVIRBLIUKAI;5223426277;Taip;5;0;0;5
13092;Žiogelis;ŽVIRBLIUKAI;8475539983;Taip;0;0;3;3
13093;Žiogelis;ŽVIRBLIUKAI;1067136657;Ne;0;9;4;13
13094;Žiogelis;ŽVIRBLIUKAI;7936785905;Taip;10;0;1;11
13095;Žiogelis;ŽVIRBLIUKAI;9142952548;Ne;0;3;1;4
13096;Žiogelis;ŽVIRBLIUKAI;2463360858;Taip;0;0;1;1
13097;Žiogelis;ŽVIRBLIUKAI;3472310047;Taip;0;0;1;1
13098;Žiogelis;ŽVIRBLIUKAI;8038242532;Taip;5;0;0;5
13099;Žiogelis;ŽVIRBLIUKAI;5454676924;Ne;0;0;2;2
13100;Žiogelis;ŽVIRBLIUKAI;2771911603;Taip;0;0;2;2
13101;Žiogelis;BITUTĖS;4814936645;Taip;3;0;0;3
13102;Žiogelis;BITUTĖS;3752355139;Taip;0;0;2;2
13103;Žiogelis;BITUTĖS;4605250897;Taip;10;0;1;11
13104;Žiogelis;BITUTĖS;2173494736;Taip;0;0;2;2
13105;Žiogelis;BITUTĖS;3420228264;Taip;0;5;1;6
13106;Žiogelis;BITUTĖS;5042341085;Ne;9;0;1;10
13107;Žiogelis;BITUTĖS;6347738933;Taip;17;0;1;18
13108;Žiogelis;BITUTĖS;9627583831;Taip;0;7;0;7
13109;Žiogelis;BITUTĖS;3296450902;Taip;3;1;0;4
13110;Žiogelis;BITUTĖS;3792114246;Taip;0;0;1;1
13111;Žiogelis;BITUTĖS;9981130790;Ne;0;12;0;12
13112;Žiogelis;BITUTĖS;8293687695;Taip;0;8;0;8
13113;Žiogelis;BITUTĖS;3820534331;Ne;2;0;1;3
13114;Žiogelis;BITUTĖS;1996517542;Ne;0;7;0;7
13115;Žiogelis;BITUTĖS;5545581078;Taip;0;0;1;1
13116;Žiogelis;BITUTĖS;4630381709;Ne;0;0;1;1
13117;Žiogelis;BITUTĖS;9790463889;Taip;0;1;0;1
13118;Žiogelis;BITUTĖS;6024752960;Taip;10;1;0;11
13119;Žiogelis;BITUTĖS;8853905367;Taip;10;1;0;11
13120;Žiogelis;BITUTĖS;1397686161;Taip;7;0;0;7
13121;Žiogelis;BITUTĖS;2171351454;Taip;0;0;1;1
13122;Žiogelis;RIEŠUTĖLIAI;1937740173;Taip;0;2;0;2
13123;Žiogelis;RIEŠUTĖLIAI;4115425880;Taip;3;3;0;6
13124;Žiogelis;RIEŠUTĖLIAI;4150956779;Ne;0;1;0;1
13125;Žiogelis;RIEŠUTĖLIAI;9243862028;Taip;6;0;0;6
13126;Žiogelis;RIEŠUTĖLIAI;9819352425;Taip;6;0;0;6
13127;Žiogelis;RIEŠUTĖLIAI;9964121573;Taip;8;0;1;9
13128;Žiogelis;RIEŠUTĖLIAI;5281321968;Taip;0;0;3;3
13129;Žiogelis;RIEŠUTĖLIAI;7395901559;Ne;6;2;0;8
13130;Žiogelis;RIEŠUTĖLIAI;7881734492;Ne;5;0;0;5
13131;Žiogelis;PAKALNUTĖS;7704256764;Taip;0;1;0;1
13132;Žiogelis;PAKALNUTĖS;6701809272;Taip;0;4;0;4
13133;Žiogelis;PAKALNUTĖS;6697117406;Taip;6;0;2;8
13134;Žiogelis;PAKALNUTĖS;2028383677;Taip;0;3;0;3
13135;Žiogelis;PAKALNUTĖS;3910954904;Taip;7;0;0;7
13136;Žiogelis;PAKALNUTĖS;2233244282;Taip;2;1;0;3
13137;Žiogelis;PAKALNUTĖS;9862582346;Ne;0;1;0;1
13138;Žiogelis;PAKALNUTĖS;9406830518;Ne;0;1;0;1
13139;Žiogelis;PAKALNUTĖS;1320651707;Ne;4;3;0;7
13140;Žiogelis;PAKALNUTĖS;85437321236;Taip;11;0;0;11
13141;Žiogelis;PAKALNUTĖS;1320126836;Taip;0;2;0;2
13142;Žiogelis;PAKALNUTĖS;3310492752;Taip;0;5;0;5
13143;Žiogelis;PAKALNUTĖS;2366095661;Taip;2;5;1;8
13144;Žiogelis;PAKALNUTĖS;8675451323;Taip;0;4;0;4
13145;Žiogelis;PAKALNUTĖS;7087781379;Ne;0;5;1;6
13146;Žiogelis;PAKALNUTĖS;4015109974;Ne;0;5;1;6
13147;Žiogelis;PAKALNUTĖS;14932261911;Taip;6;4;2;12
13148;Žiogelis;PAKALNUTĖS;1551989977;Taip;0;2;0;2
13149;Žiogelis;PAKALNUTĖS;4713696984;Ne;0;2;0;2
13150;Žiogelis;PAKALNUTĖS;1442866468;Taip;0;0;6;6
13151;Žiogelis;PAKALNUTĖS;1660784232;Taip;0;0;5;5
13152;Žolynėlis;Spanguolėlė;1876292168;Taip;11;0;0;11
13153;Žolynėlis;Spanguolėlė;3261542931;Taip;15;1;2;18
13154;Žolynėlis;Spanguolėlė;3631138915;Taip;0;1;0;1
13155;Žolynėlis;Spanguolėlė;5218448120;Ne;0;1;3;4
13156;Žolynėlis;Spanguolėlė;4076450179;Taip;0;4;0;4
13157;Žolynėlis;Spanguolėlė;4494255525;Taip;0;3;0;3
13158;Žolynėlis;Spanguolėlė;2493633505;Taip;5;0;1;6
13159;Žolynėlis;Spanguolėlė;5438607463;Ne;9;1;0;10
13160;Žolynėlis;Spanguolėlė;3788102546;Taip;6;14;0;20
13161;Žolynėlis;Spanguolėlė;5208585298;Taip;7;4;0;11
13162;Žolynėlis;Spanguolėlė;3498596516;Taip;10;1;1;12
13163;Žolynėlis;"RŪTELĖ (spec)";48837362422;Taip;0;4;0;4
13164;Žolynėlis;"RŪTELĖ (spec)";1540454207;Taip;3;1;0;4
13165;Žolynėlis;"RŪTELĖ (spec)";1954888655;Taip;5;5;0;10
13166;Žolynėlis;"RŪTELĖ (spec)";5610113641;Ne;0;5;0;5
13167;Žolynėlis;"SAULUTĖ (spec)";9675783636;Taip;0;1;0;1
13168;Žolynėlis;"SAULUTĖ (spec)";7962304738;Ne;0;1;0;1
13169;Žolynėlis;"SAULUTĖ (spec)";6678697536;Taip;10;1;0;11
13170;Žolynėlis;"SAULUTĖ (spec)";3337602618;Ne;6;2;2;10
13171;Žolynėlis;"LINELIS (spec)";7717415005;Taip;0;2;0;2
13172;Žolynėlis;"LINELIS (spec)";2665355759;Taip;0;2;0;2
13173;Žolynėlis;"LINELIS (spec)";4438939800;Taip;0;1;0;1
13174;Žolynėlis;"LINELIS (spec)";1193822800;Ne;0;4;0;4
13175;Žolynėlis;"RASAKILA (spec)";6510930436;Taip;21;0;0;21
13176;Žolynėlis;"RASAKILA (spec)";6619551947;Taip;18;0;0;18
13177;Žolynėlis;"RAMUNĖLĖS (spec)";1916465295;Taip;10;0;0;10
13178;Žolynėlis;"RAMUNĖLĖS (spec)";9926551617;Taip;0;0;3;3
13179;Žolynėlis;"RAMUNĖLĖS (spec)";8552635547;Ne;0;0;1;1
13180;Žolynėlis;"RAMUNĖLĖS (spec)";2078549599;Taip;5;2;1;8
13181;Žolynėlis;"RAMUNĖLĖS (spec)";4559404699;Taip;5;0;2;7
13182;Žolynėlis;"RAMUNĖLĖS (spec)";1703785525;Taip;7;0;0;7
13183;Žolynėlis;Dobiliukai;5787331165;Ne;0;1;0;1
13184;Žolynėlis;Dobiliukai;3091749692;Ne;0;2;2;4
13185;Žolynėlis;Dobiliukai;2138633237;Taip;0;0;1;1
13186;Žolynėlis;Dobiliukai;5332349177;Taip;7;0;0;7
13187;Žolynėlis;Dobiliukai;2263679711;Taip;0;2;0;2
13188;Žolynėlis;Dobiliukai;5149512625;Taip;0;1;0;1
13189;Žolynėlis;Dobiliukai;1264022895;Taip;6;0;0;6
13190;Žolynėlis;Dobiliukai;2138454693;Taip;3;0;1;4
13191;Žolynėlis;Dobiliukai;7234022613;Ne;0;2;0;2
13192;Žolynėlis;Dobiliukai;8713225753;Ne;6;0;0;6
13193;Žolynėlis;Dobiliukai;8278327779;Ne;1;2;0;3
13194;Žolynėlis;Dobiliukai;8697184617;Ne;0;3;3;6
13195;Žolynėlis;Dobiliukai;5973298389;Ne;10;0;0;10
13196;Žolynėlis;Dobiliukai;5474876914;Ne;6;0;0;6
13197;Žolynėlis;Aguonėlė;7313345140;Taip;0;1;0;1
13198;Žolynėlis;Aguonėlė;4545601535;Taip;0;2;0;2
13199;Žolynėlis;Aguonėlė;8027151284;Taip;5;3;0;8
13200;Žolynėlis;Aguonėlė;7256502393;Taip;0;5;0;5
13201;Žolynėlis;Aguonėlė;2881461471;Taip;2;4;0;6
13202;Žolynėlis;Aguonėlė;2565770471;Taip;18;1;0;19
13203;Žolynėlis;Aguonėlė;6829144389;Taip;0;0;2;2
13204;Žolynėlis;Aguonėlė;8700231970;Taip;2;0;0;2
13205;Žolynėlis;Aguonėlė;3198470147;Taip;0;1;0;1
13206;Žolynėlis;Aguonėlė;9128728457;Taip;6;1;0;7
13207;Žolynėlis;Aguonėlė;5717038791;Taip;5;1;0;6
13208;Žolynėlis;Aguonėlė;1933377698;Taip;0;4;0;4
13209;Žolynėlis;Aguonėlė;7519302152;Ne;0;2;15;17
13210;Žolynėlis;Pienė;3520272555;Taip;0;14;0;14
13211;Žolynėlis;Pienė;3088932720;Taip;0;2;0;2
13212;Žolynėlis;Pienė;2108221942;Taip;0;6;0;6
13213;Žolynėlis;Pienė;2934361190;Ne;0;9;0;9
13214;Žolynėlis;Pienė;7980206574;Taip;0;1;0;1
13215;Žolynėlis;Pienė;2460982987;Taip;0;7;0;7
13216;Žolynėlis;Pienė;7339110559;Taip;0;1;1;2
13217;Žolynėlis;Pienė;6763515483;Taip;0;0;1;1
13218;Žolynėlis;Pienė;8215427354;Ne;3;2;6;11
13219;Žolynėlis;Pienė;1485195267;Taip;0;8;1;9
13220;Žolynėlis;Pienė;4758738231;Taip;0;21;0;21
13221;Žolynėlis;Pienė;9238832484;Ne;0;1;0;1
13222;Žolynėlis;Pienė;3877168024;Taip;6;1;0;7
13223;Žolynėlis;Pienė;6416217971;Taip;5;3;0;8
13224;Žolynėlis;Pienė;1337138547;Taip;0;2;0;2
13225;Žolynėlis;Pienė;4618251201;Taip;0;1;0;1
13226;Žolynėlis;Pienė;5432464074;Taip;0;5;0;5
13227;Žolynėlis;Pienė;8510764089;Ne;0;2;0;2
13228;Žolynėlis;Čiobreliai;3263848791;Taip;3;6;0;9
13229;Žolynėlis;Čiobreliai;8547773739;Taip;0;2;0;2
13230;Žolynėlis;Čiobreliai;1620578562;Taip;0;10;0;10
13231;Žolynėlis;Čiobreliai;1473516753;Taip;0;7;0;7
13232;Žolynėlis;Čiobreliai;79704789499;Taip;0;4;0;4
13233;Žolynėlis;Čiobreliai;84849092452;Ne;0;4;0;4
13234;Žolynėlis;Čiobreliai;95007685205;Taip;0;2;0;2
13235;Žolynėlis;Čiobreliai;77707724932;Ne;0;3;0;3
13236;Žolynėlis;Čiobreliai;28730145668;Taip;7;6;0;13
13237;Žolynėlis;Čiobreliai;1331253673;Taip;8;0;0;8
13238;Žolynėlis;Čiobreliai;1655571687;Taip;10;2;0;12
13239;Žolynėlis;Čiobreliai;76688557717;Taip;0;1;0;1
13240;Žolynėlis;Čiobreliai;15306882704;Taip;0;1;0;1
13241;Žolynėlis;Čiobreliai;75335374706;Taip;0;2;0;2
13242;Žolynėlis;Čiobreliai;1873372016;Taip;0;1;0;1
13243;Žolynėlis;Avietėlė;9904373687;Ne;0;2;0;2
13244;Žolynėlis;Avietėlė;2628636018;Ne;0;5;0;5
13245;Žolynėlis;Avietėlė;1365534272;Ne;4;0;0;4
13246;Žolynėlis;Avietėlė;3187815703;Taip;0;5;0;5
13247;Žolynėlis;Avietėlė;5835545051;Taip;6;2;0;8
13248;Žolynėlis;Avietėlė;6554864184;Taip;6;2;0;8
13249;Žolynėlis;Avietėlė;9285539649;Taip;0;2;1;3
13250;Žolynėlis;Avietėlė;5243624422;Taip;10;0;0;10
13251;Žolynėlis;Avietėlė;6385491699;Ne;0;1;0;1
13252;Žuvėdra;"JŪROS ŽVAIGŽDUTĖS";8096854841;Taip;0;0;6;6
13253;Žuvėdra;"JŪROS ŽVAIGŽDUTĖS";3148638780;Taip;0;9;0;9
13254;Žuvėdra;"JŪROS ŽVAIGŽDUTĖS";7673681906;Taip;6;7;0;13
13255;Žuvėdra;"JŪROS ŽVAIGŽDUTĖS";29500668582;Taip;13;0;1;14
13256;Žuvėdra;"JŪROS ŽVAIGŽDUTĖS";8843700949;Ne;0;0;2;2
13257;Žuvėdra;"JŪROS ŽVAIGŽDUTĖS";8589283055;Taip;5;0;2;7
13258;Žuvėdra;"JŪROS ŽVAIGŽDUTĖS";1030020199;Taip;6;0;1;7
13259;Žuvėdra;"JŪROS ŽVAIGŽDUTĖS";8008000299;Taip;5;0;2;7
13260;Žuvėdra;"JŪROS ŽVAIGŽDUTĖS";7272717439;Taip;0;0;2;2
13261;Žuvėdra;"JŪROS ŽVAIGŽDUTĖS";9230342970;Taip;0;0;2;2
13262;Žuvėdra;"JŪROS ŽVAIGŽDUTĖS";2092890028;Taip;0;0;7;7
13263;Žuvėdra;"JŪROS ŽVAIGŽDUTĖS";5049101816;Taip;0;13;0;13
13264;Žuvėdra;"JŪROS ŽVAIGŽDUTĖS";4011849839;Taip;5;2;0;7
13265;Žuvėdra;"JŪROS ŽVAIGŽDUTĖS";1164464390;Taip;1;5;0;6
13266;Žuvėdra;"JŪROS ŽVAIGŽDUTĖS";1223362311;Ne;7;0;0;7
13267;Žuvėdra;DELFINUKAI;3620753237;Taip;10;1;0;11
13268;Žuvėdra;DELFINUKAI;6294045755;Taip;0;5;0;5
13269;Žuvėdra;DELFINUKAI;3068069755;Taip;0;6;0;6
13270;Žuvėdra;DELFINUKAI;1200084485;Taip;0;8;0;8
13271;Žuvėdra;DELFINUKAI;2694424532;Ne;10;1;0;11
13272;Žuvėdra;DELFINUKAI;4177319374;Taip;0;3;0;3
13273;Žuvėdra;DELFINUKAI;8100988548;Ne;0;21;0;21
13274;Žuvėdra;DELFINUKAI;9733979816;Ne;4;1;0;5
13275;Žuvėdra;DELFINUKAI;2858729034;Taip;10;1;0;11
13276;Žuvėdra;DELFINUKAI;7121154799;Taip;11;2;0;13
13277;Žuvėdra;DELFINUKAI;8162649794;Ne;13;1;0;14
13278;Žuvėdra;DELFINUKAI;5436158437;Taip;10;0;0;10
13279;Žuvėdra;DELFINUKAI;7958768355;Ne;0;1;0;1
13280;Žuvėdra;DELFINUKAI;6952843736;Taip;0;2;0;2
13281;Žuvėdra;DELFINUKAI;7710853637;Taip;5;0;0;5
13282;Žuvėdra;DELFINUKAI;2582404760;Taip;5;5;0;10
13283;Žuvėdra;DELFINUKAI;5273726957;Ne;7;0;0;7
13284;Žuvėdra;OSMINOŽKI;24915726868;Taip;0;1;0;1
13285;Žuvėdra;OSMINOŽKI;1116645502;Taip;8;0;0;8
13286;Žuvėdra;OSMINOŽKI;1195732987;Ne;5;1;0;6
13287;Žuvėdra;OSMINOŽKI;1312918359;Taip;0;7;0;7
13288;Žuvėdra;OSMINOŽKI;1923452638;Taip;0;6;0;6
13289;Žuvėdra;OSMINOŽKI;6468506668;Ne;3;1;0;4
13290;Žuvėdra;OSMINOŽKI;1127602652;Taip;0;1;0;1
13291;Žuvėdra;OSMINOŽKI;1340241206;Taip;0;0;3;3
13292;Žuvėdra;OSMINOŽKI;5021263583;Taip;0;3;0;3
13293;Žuvėdra;OSMINOŽKI;63053155507;Taip;5;5;0;10
13294;Žuvėdra;OSMINOŽKI;1941428466;Ne;5;4;0;9
13295;Žuvėdra;OSMINOŽKI;6007871092;Taip;0;1;0;1
13296;Žuvėdra;OSMINOŽKI;2731016281;Taip;5;7;0;12
13297;Žuvėdra;OSMINOŽKI;6612880861;Taip;5;1;0;6
13298;Žuvėdra;OSMINOŽKI;75901332720;Taip;4;0;0;4
13299;Žuvėdra;OSMINOŽKI;14760907606;Taip;6;0;3;9
13300;Žuvėdra;OSMINOŽKI;5684848140;Taip;0;7;0;7
13301;Žuvėdra;OSMINOŽKI;8408371550;Taip;0;1;0;1
13302;Žuvėdra;OSMINOŽKI;5496071972;Taip;8;1;0;9
13303;Žuvėdra;OSMINOŽKI;4828788876;Taip;0;6;0;6
13304;Žuvėdra;OSMINOŽKI;6068515077;Taip;0;10;0;10
13305;Žuvėdra;RUSALAČKA;3853045274;Ne;0;9;0;9
13306;Žuvėdra;RUSALAČKA;6537464526;Taip;0;3;0;3
13307;Žuvėdra;RUSALAČKA;5674529681;Taip;6;9;1;16
13308;Žuvėdra;RUSALAČKA;7368183516;Taip;2;5;0;7
13309;Žuvėdra;RUSALAČKA;3185158741;Taip;0;2;0;2
13310;Žuvėdra;RUSALAČKA;5198825127;Taip;18;0;0;18
13311;Žuvėdra;RUSALAČKA;5561903903;Taip;0;19;0;19
13312;Žuvėdra;RUSALAČKA;2849503557;Taip;3;0;0;3
13313;Žuvėdra;RUSALAČKA;8700802853;Taip;0;7;0;7
13314;Žuvėdra;RUSALAČKA;1509519996;Taip;0;14;0;14
13315;Žuvėdra;RUSALAČKA;4907571967;Taip;3;0;1;4
13316;Žuvėdra;RUSALAČKA;3613045982;Taip;11;9;0;20
13317;Žuvėdra;RUSALAČKA;7467154866;Taip;5;0;1;6
13318;Žuvėdra;RUSALAČKA;2987217910;Taip;6;7;0;13
13319;Žuvėdra;RUSALAČKA;4715123063;Taip;0;0;1;1
13320;Žuvėdra;RUSALAČKA;6715416675;Taip;2;0;3;5
13321;Žuvėdra;RUSALAČKA;3349158713;Taip;5;0;0;5
13322;Žuvėdra;RUSALAČKA;8942228415;Taip;0;0;1;1
13323;Žuvėdra;RUSALAČKA;8822952385;Ne;11;0;0;11
13324;Žuvėdra;RUSALAČKA;8670342549;Ne;0;5;0;5
13325;Žuvėdra;JANTARIKI;1960306957;Taip;0;5;0;5
13326;Žuvėdra;JANTARIKI;4702627979;Taip;0;0;1;1
13327;Žuvėdra;JANTARIKI;2577280901;Taip;0;0;2;2
13328;Žuvėdra;JANTARIKI;9011276878;Taip;7;1;0;8
13329;Žuvėdra;JANTARIKI;7387863175;Taip;0;0;1;1
13330;Žuvėdra;JANTARIKI;2640238143;Taip;0;0;2;2
13331;Žuvėdra;JANTARIKI;5481785360;Taip;6;0;0;6
13332;Žuvėdra;JANTARIKI;8111760611;Taip;10;0;0;10
13333;Žuvėdra;JANTARIKI;5876618912;Taip;0;0;2;2
13334;Žuvėdra;JANTARIKI;1219808187;Taip;6;0;0;6
13335;Žuvėdra;"AUKSINĖ ŽUVELĖ";8472945857;Taip;0;6;0;6
13336;Žuvėdra;"AUKSINĖ ŽUVELĖ";7793937917;Taip;0;2;0;2
13337;Žuvėdra;"AUKSINĖ ŽUVELĖ";8142435757;Taip;5;0;0;5
13338;Žuvėdra;"AUKSINĖ ŽUVELĖ";7705946236;Taip;6;1;0;7
13339;Žuvėdra;"AUKSINĖ ŽUVELĖ";1632465983;Taip;7;0;1;8
13340;Žuvėdra;"AUKSINĖ ŽUVELĖ";6327915228;Taip;5;0;0;5
13341;Žuvėdra;"AUKSINĖ ŽUVELĖ";3304186400;Taip;6;2;1;9
13342;Žuvėdra;"AUKSINĖ ŽUVELĖ";7803397430;Taip;0;3;0;3
13343;Žuvėdra;"AUKSINĖ ŽUVELĖ";5002760763;Taip;0;6;0;6
13344;Žuvėdra;"AUKSINĖ ŽUVELĖ";9801618806;Taip;7;2;0;9
13345;Žvangutis;PELIUKŲ;6701947168;Taip;0;1;0;1
13346;Žvangutis;PELIUKŲ;1339151674;Ne;0;0;1;1
13347;Žvangutis;PELIUKŲ;1310113034;Ne;0;1;1;2
13348;Žvangutis;PELIUKŲ;7202747419;Taip;0;0;2;2
13349;Žvangutis;PELIUKŲ;7320625500;Taip;0;2;0;2
13350;Žvangutis;PELIUKŲ;3513746926;Taip;5;1;1;7
13351;Žvangutis;PELIUKŲ;4053450010;Taip;0;0;2;2
13352;Žvangutis;PELIUKŲ;9408369641;Ne;0;1;0;1
13353;Žvangutis;PELIUKŲ;6110958520;Taip;5;0;1;6
13354;Žvangutis;PELIUKŲ;6844824726;Ne;7;4;0;11
13355;Žvangutis;PELIUKŲ;3315858185;Ne;18;0;0;18
13356;Žvangutis;PELIUKŲ;92356998180;Taip;7;0;0;7
13357;Žvangutis;PELIUKŲ;6815104137;Ne;4;0;0;4
13358;Žvangutis;PELIUKŲ;5683601025;Taip;0;12;0;12
13359;Žvangutis;PELIUKŲ;8617941954;Taip;0;12;0;12
13360;Žvangutis;PELIUKŲ;3775960571;Taip;15;6;0;21
13361;Žvangutis;PELIUKŲ;9134683276;Taip;0;4;0;4
13362;Žvangutis;PELIUKŲ;8511103595;Taip;5;1;3;9
13363;Žvangutis;PELIUKŲ;9145365865;Taip;0;3;0;3
13364;Žvangutis;PELIUKŲ;6989839997;Taip;9;3;0;12
13365;Žvangutis;ANČIUKŲ;2705396929;Taip;5;0;0;5
13366;Žvangutis;ANČIUKŲ;1420510354;Ne;0;8;0;8
13367;Žvangutis;ANČIUKŲ;23369081648;Taip;0;7;0;7
13368;Žvangutis;ANČIUKŲ;1541156624;Taip;0;1;0;1
13369;Žvangutis;ANČIUKŲ;2251482949;Taip;0;2;0;2
13370;Žvangutis;ANČIUKŲ;45857502483;Taip;0;3;0;3
13371;Žvangutis;ANČIUKŲ;8697156717;Taip;0;2;0;2
13372;Žvangutis;ANČIUKŲ;1847928083;Taip;0;1;0;1
13373;Žvangutis;ANČIUKŲ;1823402065;Taip;3;5;0;8
13374;Žvangutis;ANČIUKŲ;4699447138;Taip;9;7;0;16
13375;Žvangutis;ANČIUKŲ;2291142377;Taip;0;2;0;2
13376;Žvangutis;ANČIUKŲ;619059820;Taip;7;0;0;7
13377;Žvangutis;ANČIUKŲ;1665136168;Taip;5;2;0;7
13378;Žvangutis;ANČIUKŲ;52544167449;Taip;0;3;0;3
13379;Žvangutis;ANČIUKŲ;1096499939;Taip;0;2;0;2
13380;Žvangutis;ANČIUKŲ;1369424754;Taip;0;8;0;8
13381;Žvangutis;ANČIUKŲ;65598561926;Taip;0;2;0;2
13382;Žvangutis;PELĖDŽIUKŲ;2755838558;Taip;0;1;0;1
13383;Žvangutis;PELĖDŽIUKŲ;1322688456;Taip;0;12;0;12
13384;Žvangutis;PELĖDŽIUKŲ;9036869235;Taip;0;1;0;1
13385;Žvangutis;PELĖDŽIUKŲ;2570379643;Taip;7;2;0;9
13386;Žvangutis;PELĖDŽIUKŲ;2600596320;Taip;0;5;0;5
13387;Žvangutis;PELĖDŽIUKŲ;2623107843;Taip;0;7;0;7
13388;Žvangutis;PELĖDŽIUKŲ;1185135525;Taip;11;1;0;12
13389;Žvangutis;PELĖDŽIUKŲ;2411307963;Ne;0;1;0;1
13390;Žvangutis;PELĖDŽIUKŲ;9468660351;Taip;0;1;0;1
13391;Žvangutis;PELĖDŽIUKŲ;2922083476;Taip;0;9;0;9
13392;Žvangutis;PELĖDŽIUKŲ;1282567366;Taip;0;2;0;2
13393;Žvangutis;PELĖDŽIUKŲ;6068428687;Taip;3;1;0;4
13394;Žvangutis;PELĖDŽIUKŲ;9149037184;Taip;0;7;0;7
13395;Žvangutis;PELĖDŽIUKŲ;3665275100;Taip;6;0;0;6
13396;Žvangutis;PELĖDŽIUKŲ;5012996199;Taip;0;17;0;17
13397;Žvangutis;PELĖDŽIUKŲ;8295525284;Ne;0;3;0;3
13398;Žvangutis;PELĖDŽIUKŲ;3276065009;Taip;0;5;0;5
13399;Žvangutis;PELĖDŽIUKŲ;6040986672;Ne;0;13;0;13
13400;Žvangutis;PELĖDŽIUKŲ;2716216474;Taip;0;1;0;1
13401;Žvangutis;PELĖDŽIUKŲ;5723728310;Taip;5;0;0;5
13402;Žvangutis;KAČIUKŲ;7213349517;Taip;0;2;0;2
13403;Žvangutis;KAČIUKŲ;7581320158;Taip;0;3;1;4
13404;Žvangutis;KAČIUKŲ;2296360416;Taip;0;8;0;8
13405;Žvangutis;KAČIUKŲ;7721746116;Taip;0;0;1;1
13406;Žvangutis;KAČIUKŲ;2598842770;Taip;3;0;1;4
13407;Žvangutis;KAČIUKŲ;1142315595;Taip;5;2;0;7
13408;Žvangutis;KAČIUKŲ;9239279639;Taip;0;2;1;3
13409;Žvangutis;KAČIUKŲ;6041698323;Taip;7;2;0;9
13410;Žvangutis;KAČIUKŲ;4696437804;Ne;0;0;5;5
13411;Žvangutis;KAČIUKŲ;6723079944;Ne;0;2;0;2
13412;Žvangutis;KAČIUKŲ;8492637734;Taip;0;5;0;5
13413;Žvangutis;KAČIUKŲ;2503355659;Taip;0;1;0;1
13414;Žvangutis;KAČIUKŲ;8360356476;Taip;5;0;0;5
13415;Žvangutis;MEŠKUČIŲ;3957064486;Taip;0;6;0;6
13416;Žvangutis;MEŠKUČIŲ;9958554027;Taip;0;1;0;1
13417;Žvangutis;MEŠKUČIŲ;2042324002;Taip;0;8;0;8
13418;Žvangutis;MEŠKUČIŲ;1328464199;Taip;0;0;1;1
13419;Žvangutis;MEŠKUČIŲ;3875906173;Taip;5;1;0;6
13420;Žvangutis;MEŠKUČIŲ;7722153982;Taip;7;0;0;7
13421;Žvangutis;MEŠKUČIŲ;8592522675;Taip;0;3;0;3
13422;Žvangutis;MEŠKUČIŲ;4992231141;Taip;2;0;0;2
13423;Žvangutis;MEŠKUČIŲ;5817402847;Taip;4;5;0;9
13424;Žvangutis;MEŠKUČIŲ;3906808900;Taip;0;7;0;7
13425;Žvangutis;KIŠKUČIŲ;5539992579;Ne;5;0;0;5
13426;Žvangutis;KIŠKUČIŲ;8030520477;Ne;0;1;0;1
13427;Žvangutis;KIŠKUČIŲ;1404378308;Taip;0;1;0;1
13428;Žvangutis;KIŠKUČIŲ;8269992031;Ne;0;0;1;1
13429;Žvangutis;KIŠKUČIŲ;5166614226;Taip;4;0;1;5
13430;Žvangutis;KIŠKUČIŲ;1224292338;Taip;7;0;0;7
13431;Žvangutis;KIŠKUČIŲ;6207989105;Taip;7;0;0;7
13432;Žvangutis;KIŠKUČIŲ;2740875969;Taip;5;0;0;5
13433;Žvangutis;KIŠKUČIŲ;7844987649;Taip;6;0;0;6
13434;Žvangutis;KIŠKUČIŲ;3408933802;Taip;0;0;1;1
13435;Žirniukas;Boružiukų;5311746004;Taip;0;0;6;6
13436;Žirniukas;Boružiukų;6466220057;Ne;5;0;0;5
13437;Žirniukas;Boružiukų;2476906136;Taip;0;6;0;6
13438;Žirniukas;Boružiukų;8213507698;Taip;0;1;0;1
13439;Žirniukas;Boružiukų;2528905738;Ne;5;12;0;17
13440;Žirniukas;Boružiukų;6268788036;Taip;5;1;0;6
13441;Žirniukas;Boružiukų;6363169823;Taip;0;1;0;1
13442;Žirniukas;Boružiukų;2636634198;Taip;2;8;0;10
13443;Žirniukas;Boružiukų;8148254025;Taip;7;1;0;8
13444;Žirniukas;Boružiukų;1867254291;Taip;6;3;0;9
13445;Žirniukas;Boružiukų;5058103759;Taip;2;0;0;2
13446;Žirniukas;Boružiukų;6531175340;Taip;2;1;0;3
13447;Žirniukas;Boružiukų;6641200341;Taip;0;8;0;8
13448;Žirniukas;Boružiukų;3022672028;Taip;17;0;0;17
13449;Žirniukas;Boružiukų;4433579937;Taip;5;2;3;10
13450;Žirniukas;Boružiukų;3909152902;Ne;5;6;0;11
13451;Žirniukas;Boružiukų;8180092480;Ne;6;1;0;7
13452;Žirniukas;Boružiukų;9896989995;Ne;2;2;3;7
13453;Žirniukas;Boružiukų;2348752207;Taip;0;3;2;5
13454;Žirniukas;Smalsučiai;1961708150;Taip;4;4;1;9
13455;Žirniukas;Smalsučiai;2282495237;Taip;0;0;4;4
13456;Žirniukas;Smalsučiai;98962928727;Taip;2;0;1;3
13457;Žirniukas;Smalsučiai;2141162140;Taip;1;0;12;13
13458;Žirniukas;Smalsučiai;1294183547;Taip;1;0;12;13
13459;Žirniukas;Smalsučiai;1991599271;Ne;2;1;2;5
13460;Žirniukas;Smalsučiai;1393738771;Taip;0;0;2;2
13461;Žirniukas;Smalsučiai;29420916883;Taip;5;0;0;5
13462;Žirniukas;Smalsučiai;32419042337;Ne;10;0;2;12
13463;Žirniukas;Smalsučiai;5189034384;Ne;3;2;1;6
13464;Žirniukas;Smalsučiai;28992463324;Taip;5;0;0;5
13465;Žirniukas;Smalsučiai;98028824068;Taip;1;1;0;2
13466;Žirniukas;Smalsučiai;2022475049;Taip;0;2;1;3
13467;Žirniukas;Smalsučiai;2294854901;Taip;0;0;1;1
13468;Žirniukas;Smalsučiai;46265018782;Taip;0;6;1;7
13469;Žirniukas;Smalsučiai;84241751923;Ne;0;0;1;1
13470;Žirniukas;Smalsučiai;69810421328;Taip;10;0;1;11
13471;Žirniukas;Smalsučiai;37852143615;Taip;14;0;1;15
13472;Žirniukas;Smalsučiai;5188013194;Taip;0;0;2;2
13473;Žirniukas;Smalsučiai;1409567693;Taip;0;3;1;4
13474;Žirniukas;Smalsučiai;51172128673;Taip;5;1;0;6
13475;Žirniukas;Smalsučiai;66153778144;Ne;0;0;2;2
13476;Žirniukas;Smalsučiai;52181077421;Taip;0;9;1;10
13477;Žirniukas;Gėlyčių;74425301830;Taip;5;1;0;6
13478;Žirniukas;Gėlyčių;6649555415;Taip;6;0;7;13
13479;Žirniukas;Gėlyčių;1878369945;Taip;0;2;1;3
13480;Žirniukas;Gėlyčių;7397202752;Taip;9;0;7;16
13481;Žirniukas;Gėlyčių;3306670221;Taip;3;0;6;9
13482;Žirniukas;Gėlyčių;6409900451;Taip;0;0;6;6
13483;Žirniukas;Gėlyčių;9374080010;Taip;14;0;1;15
13484;Žirniukas;Gėlyčių;8294569569;Taip;6;0;0;6
13485;Žirniukas;Gėlyčių;2557138057;Taip;0;0;1;1
13486;Žirniukas;Gėlyčių;1678041002;Taip;3;5;1;9
13487;Žirniukas;Gėlyčių;8644938346;Ne;0;2;0;2
13488;Žirniukas;Gėlyčių;7190628011;Taip;0;6;0;6
13489;Žirniukas;Gėlyčių;3068684150;Taip;21;0;0;21
13490;Žirniukas;Nykštukų;4378877068;Taip;0;0;1;1
13491;Žirniukas;Nykštukų;1944169398;Taip;9;0;1;10
13492;Žirniukas;Nykštukų;1514504241;Taip;0;0;2;2
13493;Žirniukas;Nykštukų;1064894307;Taip;0;0;3;3
13494;Žirniukas;Nykštukų;1162904969;Taip;0;11;1;12
13495;Žirniukas;Nykštukų;2049123663;Ne;12;0;2;14
13496;Žirniukas;Nykštukų;2151329751;Taip;0;0;3;3
13497;Žirniukas;Nykštukų;5939918015;Taip;0;0;6;6
13498;Žirniukas;Nykštukų;2162238771;Taip;0;0;4;4
13499;Žirniukas;Nykštukų;2029018108;Taip;9;0;3;12
13500;Žirniukas;Nykštukų;5987510202;Taip;0;0;2;2
13501;Žirniukas;Nykštukų;7644911127;Taip;6;0;1;7
13502;Žirniukas;Nykštukų;6180439078;Taip;0;0;1;1
13503;Žirniukas;Nykštukų;3808838764;Ne;0;1;0;1
13504;Žirniukas;Nykštukų;7975957714;Ne;0;0;6;6
13505;Žirniukas;Saulytės;9649896460;Taip;0;0;1;1
13506;Žirniukas;Saulytės;5819443551;Taip;0;0;2;2
13507;Žirniukas;Saulytės;2982628594;Taip;6;0;1;7
13508;Žirniukas;Saulytės;2733313392;Taip;0;0;1;1
13509;Žirniukas;Saulytės;9707776533;Taip;0;1;0;1
13510;Žirniukas;Saulytės;7278153529;Taip;0;1;0;1
13511;Žirniukas;Saulytės;7927815250;Taip;0;0;3;3
13512;Žirniukas;Saulytės;2325139043;Taip;5;0;1;6
13513;Žirniukas;Saulytės;4527367786;Taip;0;0;1;1
13514;Žirniukas;Saulytės;3610402086;Taip;0;0;3;3
13515;Žirniukas;Saulytės;9961947583;Taip;12;3;1;16
13516;Žirniukas;Saulytės;9656768968;Taip;0;8;2;10
13517;Žirniukas;Saulytės;4045432303;Taip;0;0;5;5
13518;Žirniukas;Saulytės;1594735501;Ne;3;0;1;4
13519;Žirniukas;Saulytės;4320686646;Taip;0;3;1;4
13520;Žirniukas;Saulytės;6254250706;Taip;3;0;6;9
13521;Žirniukas;Saulytės;1262404954;Taip;3;0;6;9
13522;Žirniukas;Saulytės;6121388208;Ne;8;0;1;9
13523;Žirniukas;Drugelių;9232828844;Taip;0;1;0;1
13524;Žirniukas;Drugelių;5269074776;Taip;0;0;2;2
13525;Žirniukas;Drugelių;3509857181;Taip;5;0;3;8
13526;Žirniukas;Drugelių;7401431725;Taip;6;0;0;6
13527;Žirniukas;Drugelių;1590778538;Taip;0;10;0;10
13528;Žirniukas;Drugelių;2517524802;Taip;0;1;0;1
13529;Žirniukas;Drugelių;9901196251;Taip;4;0;0;4
13530;Žirniukas;Drugelių;2555959199;Taip;4;0;0;4
13531;Žirniukas;Drugelių;4762596462;Taip;2;0;0;2
13532;Žirniukas;Drugelių;5046469974;Taip;5;0;0;5
13533;Žirniukas;Drugelių;1826203483;Taip;11;0;0;11
13534;Žirniukas;Drugelių;4536071547;Ne;0;2;0;2
13535;Žirniukas;Drugelių;7240364379;Taip;5;0;0;5
13536;Žirniukas;Drugelių;6300372863;Taip;6;0;0;6
13537;Žirniukas;Drugelių;5670489807;Taip;10;0;0;10
13538;Žirniukas;Drugelių;9794535841;Taip;10;0;0;10
13539;Žirniukas;Drugelių;1031316325;Taip;4;0;0;4
13540;Žirniukas;Drugelių;1018506580;Taip;3;0;0;3
13541;Žirniukas;Pelėdžiukai;7889803840;Taip;1;0;0;1
13542;Žirniukas;Pelėdžiukai;7356213150;Taip;4;0;0;4
13543;Žirniukas;Pelėdžiukai;8354728917;Taip;0;4;0;4
13544;Žirniukas;ZUIKUČIAI;5422282267;Taip;3;0;0;3
13545;Žirniukas;ZUIKUČIAI;4732089209;Taip;5;0;0;5
13546;Žirniukas;ZUIKUČIAI;2526769571;Taip;4;0;0;4
13547;Žirniukas;ZUIKUČIAI;1635353228;Taip;0;1;0;1
13548;Žirniukas;ZUIKUČIAI;2027344763;Taip;0;0;2;2
13549;Žirniukas;ZUIKUČIAI;5734197350;Taip;0;1;0;1
13550;Žirniukas;ZUIKUČIAI;3874713264;Taip;4;1;0;5
13551;Žirniukas;ZUIKUČIAI;4282344625;Taip;0;0;2;2
13552;Aušra;Kodėlčiukai;2611563172;Ne;5;0;0;5
13553;Aušra;Kodėlčiukai;3420851059;Taip;11;0;0;11
13554;Aušra;Kodėlčiukai;2199083085;Taip;0;2;2;4
13555;Aušra;Kodėlčiukai;4720749995;Taip;0;1;0;1
13556;Aušra;Kodėlčiukai;5929538617;Taip;5;0;0;5
13557;Aušra;Kodėlčiukai;6139706771;Taip;11;1;0;12
13558;Aušra;Kodėlčiukai;7314273812;Ne;2;18;0;20
13559;Aušra;Kodėlčiukai;4540040693;Taip;12;0;0;12
13560;Aušra;Kodėlčiukai;1423840991;Taip;20;1;0;21
13561;Aušra;Kodėlčiukai;5013135853;Taip;12;3;0;15
13562;Aušra;Kodėlčiukai;9728140172;Taip;1;2;0;3
13563;Aušra;Kodėlčiukai;7765504789;Taip;0;15;0;15
13564;Aušra;Kodėlčiukai;8108663467;Taip;5;0;0;5
13565;Aušra;Kodėlčiukai;4824773027;Taip;10;0;0;10
13566;Aušra;Kodėlčiukai;1897365632;Taip;0;2;0;2
13567;Aušra;Kodėlčiukai;7469266085;Taip;0;12;0;12
13568;Aušra;Kodėlčiukai;1010721404;Taip;0;11;0;11
13569;Aušra;Kodėlčiukai;1883185016;Taip;6;1;0;7
13570;Aušra;Kodėlčiukai;1773343262;Taip;0;0;1;1
13571;Aušra;Kodėlčiukai;9437530221;Taip;3;2;0;5
13572;Aušra;"4B klasė";7713995959;Ne;2;0;0;2
13573;Aušra;"4B klasė";2610054474;Ne;0;21;0;21
13574;Aušra;"4B klasė";95798840861;Taip;5;0;0;5
13575;Aušra;"4B klasė";7553225340;Ne;1;0;0;1
13576;Aušra;"4B klasė";9736905104;Ne;1;0;0;1
13577;Aušra;"4B klasė";70054065156;Taip;0;21;0;21
13578;Aušra;"4B klasė";9695887585;Ne;1;0;0;1
13579;Aušra;"4B klasė";3225989797;Ne;2;0;0;2
13580;Aušra;"4B klasė";7405776766;Ne;0;21;0;21
13581;Aušra;"4B klasė";5005513948;Ne;1;0;0;1
13582;Aušra;"4B klasė";7697924792;Ne;0;21;0;21
13583;Aušra;"4B klasė";2075587354;Ne;1;0;0;1
13584;Aušra;"4B klasė";65535488153;Taip;3;0;0;3
13585;Aušra;"4B klasė";9600565378;Ne;0;21;0;21
13586;Aušra;"4B klasė";3114317363;Ne;2;0;0;2
13587;Aušra;"4B klasė";7075053685;Ne;0;21;0;21
13588;Aušra;"4B klasė";98154599269;Taip;1;0;0;1
13589;Aušra;"4B klasė";7321317333;Ne;0;21;0;21
13590;Aušra;"4B klasė";2893668707;Ne;1;0;0;1
13591;Aušra;"4B klasė";7886658451;Ne;6;0;0;6
13592;Aušra;Smalsučiai;84116863778;Taip;0;2;0;2
13593;Aušra;Smalsučiai;1893586984;Ne;4;0;2;6
13594;Aušra;Smalsučiai;3001784066;Taip;0;0;2;2
13595;Aušra;Smalsučiai;3823619675;Taip;5;0;0;5
13596;Aušra;Smalsučiai;2227238810;Ne;0;2;1;3
13597;Aušra;Smalsučiai;57469542504;Taip;0;1;0;1
13598;Aušra;Smalsučiai;23609052737;Taip;5;0;1;6
13599;Aušra;Smalsučiai;41017803426;Taip;0;8;3;11
13600;Aušra;Smalsučiai;13825730049;Taip;0;0;2;2
13601;Aušra;Smalsučiai;8686777160;Ne;0;4;0;4
13602;Aušra;Smalsučiai;15657824495;Taip;6;0;1;7
13603;Aušra;Smalsučiai;5988529284;Taip;6;0;0;6
13604;Aušra;Smalsučiai;18943927144;Taip;5;1;0;6
13605;Aušra;Smalsučiai;5815377310;Ne;8;0;0;8
13606;Aušra;Smalsučiai;58254707316;Ne;0;8;1;9
13607;Aušra;Smalsučiai;2121418946;Taip;13;0;0;13
13608;Aušra;Smalsučiai;35429495907;Taip;0;0;1;1
13609;Aušra;Smalsučiai;59267104215;Taip;0;0;1;1
13610;Aušra;Smalsučiai;1623803107;Taip;0;2;0;2
13611;Aušra;Smalsučiai;2000206874;Taip;1;9;7;17
13612;Aušra;"1A klasė";1167565535;Taip;1;0;0;1
13613;Aušra;"1A klasė";1473962346;Taip;2;0;0;2
13614;Aušra;"1A klasė";1049364899;Taip;1;0;0;1
13615;Aušra;"1A klasė";1427235223;Taip;14;0;0;14
13616;Aušra;"1A klasė";42344686036;Ne;3;0;0;3
13617;Aušra;"1A klasė";95586246863;Taip;1;0;0;1
13618;Aušra;"1A klasė";85826303673;Taip;0;20;0;20
13619;Aušra;"1A klasė";77966124767;Taip;1;0;0;1
13620;Aušra;"1A klasė";36447115547;Taip;2;0;0;2
13621;Aušra;"1A klasė";2647629246;Taip;3;0;0;3
13622;Aušra;"1A klasė";1315930711;Taip;1;0;0;1
13623;Aušra;"1A klasė";4110537888;Taip;6;0;0;6
13624;Aušra;"1A klasė";2019480768;Taip;1;0;0;1
13625;Aušra;"2A klasė";8510995681;Taip;5;0;0;5
13626;Aušra;"2A klasė";9605206310;Taip;6;0;0;6
13627;Aušra;"2A klasė";1396233353;Taip;2;0;0;2
13628;Aušra;"2A klasė";14157070764;Taip;3;0;0;3
13629;Aušra;"2A klasė";1437126272;Taip;2;0;0;2
13630;Aušra;"2A klasė";2062775070;Taip;5;0;0;5
13631;Aušra;"2A klasė";3965445196;Taip;6;0;0;6
13632;Aušra;"2A klasė";88655846176;Taip;7;0;0;7
13633;Aušra;"2A klasė";27958163601;Taip;4;0;0;4
13634;Aušra;"2A klasė";40499781883;Taip;3;0;0;3
13635;Aušra;"2A klasė";68031503463;Taip;4;0;0;4
13636;Aušra;"2A klasė";80929303402;Taip;2;0;0;2
13637;Aušra;"2A klasė";1437385365;Taip;2;0;0;2
13638;Aušra;"2A klasė";51185323645;Taip;2;0;0;2
13639;Aušra;"2A klasė";52985512945;Taip;8;0;0;8
13640;Aušra;"2A klasė";97781409787;Ne;4;0;0;4
13641;Aušra;"3A klasė";68481706412;Taip;0;21;0;21
13642;Aušra;"3A klasė";99886964420;Taip;0;21;0;21
13643;Aušra;"3A klasė";19920237804;Taip;5;0;0;5
13644;Aušra;"3A klasė";13361663464;Taip;1;0;0;1
13645;Aušra;"3A klasė";95948867937;Taip;0;21;0;21
13646;Aušra;"3A klasė";78030425432;Taip;1;0;0;1
13647;Aušra;"3A klasė";34795588283;Taip;0;21;0;21
13648;Aušra;"3A klasė";29636399665;Taip;1;0;0;1
13649;Aušra;"3A klasė";81428848455;Taip;1;0;0;1
13650;Aušra;"3A klasė";47725613978;Taip;0;21;0;21
13651;Aušra;"3A klasė";93365393803;Ne;6;0;0;6
13652;Aušra;"3A klasė";10272136932;Taip;1;0;0;1
13653;Aušra;"3A klasė";77425098448;Taip;1;0;0;1
13654;Aušra;"3A klasė";20550256232;Ne;1;0;0;1
13655;Aušra;"3A klasė";42015974556;Taip;4;0;0;4
13656;Aušra;"3A klasė";2113586354;Taip;7;0;0;7
13657;Aušra;"3A klasė";19718806057;Taip;0;21;0;21
13658;Aušra;"3A klasė";21856009403;Taip;1;0;0;1
13659;Aušra;"3A klasė";5166358753;Taip;2;0;0;2
13660;Aušra;"3A klasė";97596344387;Taip;3;0;0;3
13661;Aušra;"3A klasė";97596344387;Taip;3;0;0;3
13662;Aušra;"4A klasė";2908360090;Ne;5;0;0;5
13663;Aušra;"4A klasė";1585279799;Ne;6;0;0;6
13664;Aušra;"4A klasė";8497743711;Ne;3;0;0;3
13665;Aušra;"4A klasė";7439801986;Ne;1;0;0;1
13666;Aušra;"4A klasė";4952796453;Ne;1;0;0;1
13667;Aušra;"4A klasė";1404310604;Ne;3;0;0;3
13668;Aušra;"4A klasė";5770340819;Ne;4;0;0;4
13669;Aušra;"4A klasė";9510786725;Ne;1;0;0;1
13670;Aušra;"4A klasė";2280410145;Ne;0;21;0;21
13671;Aušra;"4A klasė";29945175192;Taip;0;21;0;21
13672;Aušra;"4A klasė";8367064629;Taip;1;0;0;1
13673;Aušra;"4A klasė";7931858964;Ne;1;0;0;1
13674;Aušra;"4A klasė";5792862565;Ne;1;0;0;1
13675;Aušra;"4A klasė";6942076490;Ne;4;0;0;4
13676;Aušra;"4A klasė";4399210916;Ne;1;0;0;1
13677;Aušra;"4A klasė";8892613555;Ne;1;0;0;1
13678;Aušra;"4A klasė";6534693192;Ne;5;0;0;5
13679;Aušra;"4A klasė";2797588970;Ne;1;0;0;1
13680;Aušra;"4A klasė";5657162092;Ne;0;21;0;21
13681;Aušra;"4A klasė";3435983733;Ne;6;0;0;6
13682;Aušra;"4A klasė";5825720308;Ne;0;21;0;21
13683;Aušra;"4A klasė";7313001921;Ne;1;0;0;1
13684;Aušra;"4A klasė";2796012982;Ne;1;0;0;1
13685;Aušra;"4A klasė";8632721907;Ne;2;0;0;2
13686;Aušra;"4A klasė";7113793626;Ne;1;0;0;1
13687;Aušra;"4A klasė";75839555732;Taip;2;0;0;2
13688;Aušra;"4A klasė";96979357769;Taip;0;21;0;21
13689;Aušra;"4A klasė";9584232864;Ne;11;0;0;11
13690;Aušra;"3B klasė";92119607174;Taip;4;0;0;4
13691;Aušra;"3B klasė";22923377435;Ne;1;0;0;1
13692;Aušra;"3B klasė";41852924528;Taip;1;0;0;1
13693;Aušra;"3B klasė";58526614808;Taip;1;0;0;1
13694;Aušra;"3B klasė";41039525379;Taip;1;0;0;1
13695;Aušra;"3B klasė";37339481276;Taip;3;0;0;3
13696;Aušra;"3B klasė";45165946624;Taip;1;0;0;1
13697;Aušra;"3B klasė";59107169775;Ne;1;0;0;1
13698;Aušra;"3B klasė";48349819906;Ne;1;0;0;1
13699;Aušra;"3B klasė";71596384638;Taip;1;0;0;1
13700;Aušra;"3B klasė";52332096506;Taip;1;0;0;1
13701;Aušra;"3B klasė";35703433862;Taip;1;0;0;1
13702;Aušra;"3B klasė";6201728036;Taip;4;0;0;4
13703;Aušra;"3B klasė";36889923728;Taip;1;0;0;1
13704;Aušra;"3B klasė";39957179831;Taip;0;21;0;21
13705;Aušra;"3B klasė";52909474598;Taip;1;0;0;1
13706;Aušra;"3B klasė";8901585006;Taip;2;0;0;2
13707;Aušra;"3B klasė";64562667133;Taip;7;0;0;7
13708;Aušra;"3B klasė";95076478544;Ne;1;0;0;1
13709;Aušra;"3B klasė";36899257479;Ne;2;0;0;2
13710;Aušra;"3B klasė";57520886724;Taip;0;21;0;21
13711;Aušra;"3B klasė";1815771421;Taip;1;0;0;1
13712;Aušra;"3B klasė";75433637766;Taip;8;0;0;8
13713;Aušra;"3B klasė";83119050626;Taip;7;0;0;7
13714;Aušra;Pabiručiai;7542690501;Taip;10;6;0;16
13715;Aušra;Pabiručiai;7476662446;Taip;5;0;2;7
13716;Aušra;Pabiručiai;9466807067;Taip;5;0;0;5
13717;Aušra;Pabiručiai;7926621700;Taip;0;5;1;6
13718;Aušra;Pabiručiai;6555345047;Taip;0;0;1;1
13719;Aušra;Pabiručiai;7888891808;Taip;3;0;1;4
13720;Aušra;Pabiručiai;8769357172;Taip;0;1;0;1
13721;Aušra;Pabiručiai;1306616759;Taip;10;2;3;15
13722;Aušra;Pabiručiai;5797692122;Ne;6;1;3;10
13723;Aušra;Pabiručiai;4071233786;Taip;12;0;0;12
13724;Aušra;Pabiručiai;4646215025;Taip;13;0;1;14
13725;Aušra;Pabiručiai;3008573040;Taip;4;0;0;4
13726;Aušra;Pabiručiai;7944904281;Taip;4;0;0;4
13727;Aušra;Pabiručiai;3336605264;Taip;3;5;3;11
13728;Aušra;Pabiručiai;7159809546;Taip;6;0;0;6
13729;Aušra;Pabiručiai;3553620602;Taip;0;0;5;5
13730;Aušra;Pabiručiai;3759593393;Taip;0;1;7;8
13731;Aušra;Pabiručiai;2904303784;Taip;0;0;2;2
13732;Aušra;Pabiručiai;6056923592;Taip;0;0;5;5
13733;Aušra;Pabiručiai;2273160688;Taip;9;1;0;10
13734;Aušra;Pabiručiai;8462418277;Taip;0;1;0;1
13735;Aušra;Gudručiai;2271582954;Taip;10;0;0;10
13736;Aušra;Gudručiai;5854637278;Taip;2;0;1;3
13737;Aušra;Gudručiai;7367602247;Taip;0;2;0;2
13738;Aušra;Gudručiai;9628651723;Taip;0;2;0;2
13739;Aušra;Gudručiai;3627487971;Taip;0;7;0;7
13740;Aušra;Gudručiai;3343235857;Taip;11;0;0;11
13741;Aušra;Gudručiai;1337138547;Taip;11;0;0;11
13742;Aušra;Gudručiai;1450251779;Taip;0;2;4;6
13743;Aušra;Gudručiai;3530905126;Taip;7;0;0;7
13744;Aušra;Gudručiai;5955385407;Taip;14;0;0;14
13745;Aušra;Gudručiai;2243689816;Taip;5;1;0;6
13746;Aušra;Naminukai;5409157554;Taip;0;2;0;2
13747;Aušra;Naminukai;3680329197;Taip;9;0;1;10
13748;Aušra;Naminukai;8740755922;Taip;0;0;5;5
13749;Aušra;Naminukai;3898178166;Taip;0;2;0;2
13750;Aušra;Naminukai;1940882109;Taip;0;2;1;3
13751;Aušra;Naminukai;4404047456;Taip;0;0;7;7
13752;Aušra;Naminukai;97102749430;Taip;0;1;0;1
13753;Aušra;Naminukai;9702136789;Taip;0;2;0;2
13754;Aušra;Naminukai;8709340592;Taip;0;0;1;1
13755;Aušra;Naminukai;5673568541;Taip;0;0;4;4
13756;Aušra;Naminukai;5524681006;Taip;0;2;4;6
13757;Aušra;Naminukai;6384243597;Taip;0;3;0;3
13758;Aušra;Naminukai;1343532870;Taip;0;5;0;5
13759;Aušra;Naminukai;7043021721;Taip;0;11;0;11
13760;Aušra;Naminukai;1612662076;Taip;0;1;0;1
13761;Aušra;Naminukai;2288159223;Taip;8;1;0;9
13762;Aušra;Naminukai;1575761029;Taip;3;0;2;5
13763;Aušra;Naminukai;5777939563;Taip;0;2;0;2
13764;Aušra;Naminukai;7814902928;Taip;0;2;6;8
13765;Berželis;PČIOLKI;3215259838;Taip;6;0;0;6
13766;Berželis;PČIOLKI;2002649360;Ne;11;0;0;11
13767;Berželis;PČIOLKI;1893226570;Ne;4;0;1;5
13768;Berželis;PČIOLKI;25985469678;Taip;6;0;0;6
13769;Berželis;PČIOLKI;83253240251;Taip;0;0;4;4
13770;Berželis;PČIOLKI;1061894314;Taip;0;0;1;1
13771;Berželis;PČIOLKI;11671380984;Taip;0;0;1;1
13772;Berželis;PČIOLKI;9134420285;Ne;0;7;0;7
13773;Berželis;PČIOLKI;1183377037;Taip;0;0;3;3
13774;Berželis;PČIOLKI;1492203156;Taip;0;0;11;11
13775;Berželis;PČIOLKI;8939353460;Taip;21;0;0;21
13776;Berželis;PČIOLKI;2028316867;Ne;0;6;0;6
13777;Berželis;PČIOLKI;1927042277;Taip;0;6;4;10
13778;Berželis;PČIOLKI;1566912722;Taip;0;0;5;5
13779;Berželis;PČIOLKI;1511044883;Taip;0;0;2;2
13780;Berželis;PČIOLKI;1573177287;Taip;0;6;0;6
13781;Berželis;PČIOLKI;48932211843;Ne;0;0;7;7
13782;Berželis;PČIOLKI;1865658456;Taip;0;0;4;4
13783;Berželis;"BOŽJI KOROVKI";9132058594;Taip;5;1;0;6
13784;Berželis;"BOŽJI KOROVKI";7421059780;Taip;6;0;2;8
13785;Berželis;"BOŽJI KOROVKI";4100740863;Taip;0;11;0;11
13786;Berželis;"BOŽJI KOROVKI";1750209600;Taip;0;0;1;1
13787;Berželis;"BOŽJI KOROVKI";5953387226;Taip;0;11;0;11
13788;Berželis;"BOŽJI KOROVKI";9466461910;Taip;6;0;1;7
13789;Berželis;"BOŽJI KOROVKI";3070917065;Taip;0;4;2;6
13790;Berželis;"BOŽJI KOROVKI";8118040960;Taip;0;0;1;1
13791;Berželis;"BOŽJI KOROVKI";2005082089;Taip;0;3;0;3
13792;Berželis;"BOŽJI KOROVKI";5194480946;Taip;0;1;0;1
13793;Berželis;"BOŽJI KOROVKI";9848723402;Taip;7;0;0;7
13794;Berželis;"BOŽJI KOROVKI";6651007152;Taip;5;0;0;5
13795;Berželis;"BOŽJI KOROVKI";7080168105;Ne;17;0;0;17
13796;Berželis;"BOŽJI KOROVKI";1132252592;Taip;0;11;0;11
13797;Berželis;"BOŽJI KOROVKI";5550598069;Taip;0;3;1;4
13798;Berželis;"BOŽJI KOROVKI";1852964349;Ne;7;0;1;8
13799;Berželis;"BOŽJI KOROVKI";8871199713;Taip;5;0;1;6
13800;Berželis;"BOŽJI KOROVKI";1722262813;Taip;0;19;1;20
13801;Berželis;SOLNYŠKO;2182268389;Taip;7;0;0;7
13802;Berželis;SOLNYŠKO;1498165322;Taip;5;0;0;5
13803;Berželis;SOLNYŠKO;4163605313;Taip;9;5;0;14
13804;Berželis;SOLNYŠKO;2882693941;Taip;0;0;2;2
13805;Berželis;SOLNYŠKO;6189116357;Taip;0;0;8;8
13806;Berželis;SOLNYŠKO;8737788279;Taip;5;0;0;5
13807;Berželis;SOLNYŠKO;8875116641;Taip;5;8;0;13
13808;Berželis;SOLNYŠKO;8771171576;Taip;0;4;0;4
13809;Berželis;SOLNYŠKO;2901168499;Taip;10;0;5;15
13810;Berželis;SOLNYŠKO;8297975308;Taip;20;0;0;20
13811;Berželis;SOLNYŠKO;2693961315;Taip;6;0;4;10
13812;Berželis;SOLNYŠKO;7411282628;Taip;12;6;0;18
13813;Berželis;SOLNYŠKO;4249048581;Taip;5;0;0;5
13814;Berželis;SOLNYŠKO;1167103292;Taip;10;0;0;10
13815;Berželis;SOLNYŠKO;5408368340;Ne;5;0;0;5
13816;Berželis;SOLNYŠKO;1070751052;Taip;6;0;0;6
13817;Berželis;BABOČKI;4923631429;Ne;10;0;0;10
13818;Berželis;BABOČKI;1076719080;Taip;13;0;0;13
13819;Berželis;BABOČKI;2016194182;Taip;6;0;1;7
13820;Berželis;BABOČKI;2030770943;Taip;0;0;5;5
13821;Berželis;BABOČKI;9839929976;Taip;14;0;0;14
13822;Berželis;BABOČKI;2667957070;Taip;0;0;4;4
13823;Berželis;BABOČKI;7781031211;Taip;0;3;0;3
13824;Berželis;BABOČKI;2493612905;Taip;0;0;6;6
13825;Berželis;BABOČKI;5688897783;Taip;0;5;0;5
13826;Berželis;BABOČKI;6942559693;Taip;0;0;1;1
13827;Berželis;BABOČKI;9245706377;Taip;13;2;0;15
13828;Berželis;BABOČKI;6352635742;Ne;0;7;0;7
13829;Berželis;BABOČKI;3097809074;Taip;0;4;0;4
13830;Berželis;BABOČKI;3613459846;Taip;5;0;0;5
13831;Berželis;BABOČKI;8448872491;Taip;0;3;1;4
13832;Berželis;BABOČKI;5069322062;Taip;0;0;3;3
13833;Berželis;BABOČKI;2954451168;Taip;6;0;0;6
13834;Berželis;BABOČKI;9585609150;Taip;7;4;0;11
13835;Berželis;BABOČKI;9091691636;Taip;0;0;1;1
13836;Berželis;BABOČKI;7940591009;Taip;0;0;2;2
13837;Berželis;BABOČKI;4546285993;Ne;5;0;4;9
13838;Berželis;BABOČKI;5876182759;Ne;11;1;0;12
13839;Berželis;SOVUŠKI;5350402890;Taip;0;0;4;4
13840;Berželis;SOVUŠKI;8989621715;Taip;10;0;0;10
13841;Berželis;SOVUŠKI;1289333809;Taip;10;0;0;10
13842;Berželis;SOVUŠKI;9273819928;Taip;11;0;2;13
13843;Berželis;SOVUŠKI;9750863775;Taip;8;0;0;8
13844;Berželis;SOVUŠKI;1769470120;Taip;5;0;0;5
13845;Berželis;SOVUŠKI;3885474466;Taip;3;0;0;3
13846;Berželis;SOVUŠKI;1825910306;Taip;3;0;0;3
13847;Berželis;SOVUŠKI;6706273205;Taip;4;0;0;4
13848;Berželis;SOVUŠKI;2895332184;Taip;15;0;0;15
13849;Berželis;SOVUŠKI;2632535013;Taip;11;0;0;11
13850;Berželis;PODSOLNUŠKI;4521372127;Taip;0;2;0;2
13851;Berželis;PODSOLNUŠKI;2214171136;Taip;3;3;0;6
13852;Berželis;PODSOLNUŠKI;97218091736;Taip;5;8;0;13
13853;Berželis;PODSOLNUŠKI;1521982237;Taip;21;0;0;21
13854;Berželis;PODSOLNUŠKI;4013215941;Taip;10;0;0;10
13855;Berželis;PODSOLNUŠKI;64214150955;Ne;0;2;0;2
13856;Berželis;PODSOLNUŠKI;9024992452;Taip;0;6;0;6
13857;Berželis;PODSOLNUŠKI;5084171353;Taip;7;0;0;7
13858;Berželis;PODSOLNUŠKI;1225018351;Taip;0;3;0;3
13859;Berželis;PODSOLNUŠKI;1067618571;Taip;8;1;0;9
13860;Berželis;PODSOLNUŠKI;3772780161;Taip;5;0;0;5
13861;Berželis;PODSOLNUŠKI;4563582416;Taip;10;0;0;10
13862;Berželis;PODSOLNUŠKI;6113571093;Taip;18;0;0;18
13863;Berželis;PODSOLNUŠKI;1036370516;Taip;6;6;0;12
13864;Berželis;PODSOLNUŠKI;4284157599;Taip;0;4;0;4
13865;Berželis;PODSOLNUŠKI;9894751274;Taip;11;0;1;12
13866;Berželis;PODSOLNUŠKI;3298044639;Taip;0;5;0;5
13867;Berželis;PODSOLNUŠKI;3437712794;Taip;0;1;0;1
13868;Berželis;LAPIUKAI;8318089070;Taip;0;0;2;2
13869;Berželis;LAPIUKAI;2539824027;Taip;0;0;2;2
13870;Berželis;LAPIUKAI;7789414361;Taip;7;0;0;7
13871;Berželis;LAPIUKAI;2947072348;Taip;6;0;0;6
13872;Berželis;LAPIUKAI;1259743374;Taip;4;0;0;4
13873;Berželis;LAPIUKAI;2971765753;Taip;7;0;0;7
13874;Berželis;LAPIUKAI;9658062645;Taip;2;0;0;2
13875;Berželis;LAPIUKAI;2144796691;Taip;13;0;0;13
13876;Berželis;LAPIUKAI;1834920753;Taip;9;0;0;9
13877;Berželis;LAPIUKAI;6384939601;Taip;5;0;0;5
13878;Berželis;LAPIUKAI;2410514408;Taip;5;0;1;6
13879;Berželis;LAPIUKAI;2794074071;Taip;7;0;4;11
13880;Berželis;LAPIUKAI;9681310544;Taip;5;0;0;5
13881;Saulutė;Drugeliai;66108847230;Taip;0;2;7;9
13882;Saulutė;Drugeliai;3064199909;Taip;0;0;2;2
13883;Saulutė;Drugeliai;2097055107;Ne;0;1;0;1
13884;Saulutė;Drugeliai;1717909005;Taip;0;20;0;20
13885;Saulutė;Drugeliai;1283800571;Taip;0;1;1;2
13886;Saulutė;Drugeliai;8599199376;Taip;8;0;0;8
13887;Saulutė;Drugeliai;87814849917;Taip;0;1;0;1
13888;Saulutė;Drugeliai;1291318940;Taip;0;3;0;3
13889;Saulutė;Drugeliai;1391904744;Taip;0;1;0;1
13890;Saulutė;Drugeliai;8944601874;Taip;0;10;0;10
13891;Saulutė;Drugeliai;4272320685;Taip;4;0;0;4
13892;Saulutė;Drugeliai;7539721995;Taip;0;1;1;2
13893;Saulutė;Drugeliai;84919478493;Ne;0;0;1;1
13894;Saulutė;Drugeliai;1320018338;Ne;7;0;0;7
13895;Saulutė;Drugeliai;1750571258;Taip;0;0;1;1
13896;Saulutė;Drugeliai;1261384337;Taip;0;1;1;2
13897;Saulutė;"Saulės zuikučiai";8946107286;Taip;2;0;0;2
13898;Saulutė;"Saulės zuikučiai";2397257894;Taip;0;0;4;4
13899;Saulutė;"Saulės zuikučiai";2010774109;Taip;11;2;0;13
13900;Saulutė;"Saulės zuikučiai";5148542811;Taip;10;11;0;21
13901;Saulutė;"Saulės zuikučiai";2259917151;Taip;10;0;1;11
13902;Saulutė;"Saulės zuikučiai";9146298505;Taip;5;0;0;5
13903;Saulutė;"Saulės zuikučiai";8242602551;Ne;0;4;6;10
13904;Saulutė;"Saulės zuikučiai";1324799653;Taip;0;3;0;3
13905;Saulutė;"Saulės zuikučiai";5247769309;Taip;6;0;3;9
13906;Saulutė;"Saulės zuikučiai";2816806902;Taip;0;7;0;7
13907;Saulutė;"Saulės zuikučiai";2781003892;Taip;0;10;0;10
13908;Saulutė;"Saulės zuikučiai";5839981073;Ne;0;7;0;7
13909;Saulutė;"Saulės zuikučiai";7888435573;Taip;0;10;0;10
13910;Saulutė;"Saulės zuikučiai";9521155670;Taip;0;14;0;14
13911;Saulutė;"Saulės zuikučiai";7844396402;Taip;0;0;2;2
13912;Saulutė;"Saulės zuikučiai";3089541630;Ne;10;0;0;10
13913;Saulutė;"Saulės zuikučiai";9892855816;Taip;12;5;0;17
13914;Saulutė;"Saulės zuikučiai";5326279083;Taip;7;0;0;7
13915;Saulutė;"Saulės zuikučiai";1562393383;Taip;0;0;5;5
13916;Saulutė;Boružėlės;8390767549;Taip;8;0;1;9
13917;Saulutė;Boružėlės;2725491887;Ne;15;0;4;19
13918;Saulutė;Boružėlės;9314889468;Taip;5;0;1;6
13919;Saulutė;Boružėlės;5811810714;Taip;4;2;0;6
13920;Saulutė;Boružėlės;8643975544;Taip;1;0;4;5
13921;Saulutė;Boružėlės;7081700501;Taip;0;0;2;2
13922;Saulutė;Boružėlės;7474989619;Taip;2;0;2;4
13923;Saulutė;Boružėlės;8619163154;Ne;0;0;3;3
13924;Saulutė;Boružėlės;3272296969;Ne;0;7;0;7
13925;Saulutė;Boružėlės;1803710557;Taip;0;0;14;14
13926;Saulutė;Boružėlės;4818911910;Ne;5;0;7;12
13927;Saulutė;Boružėlės;9173336078;Ne;2;1;0;3
13928;Saulutė;Boružėlės;9098663596;Ne;0;0;2;2
13929;Saulutė;Boružėlės;7425789805;Ne;0;0;1;1
13930;Saulutė;Boružėlės;1265174091;Ne;0;0;2;2
13931;Saulutė;Boružėlės;2527027536;Taip;0;0;1;1
13932;Saulutė;Nykštukai;7960825423;Taip;6;0;0;6
13933;Saulutė;Nykštukai;2545930114;Taip;0;0;1;1
13934;Saulutė;Nykštukai;8984040932;Taip;4;0;0;4
13935;Saulutė;Nykštukai;2601822200;Taip;5;0;1;6
13936;Saulutė;Nykštukai;9497439410;Taip;0;8;0;8
13937;Saulutė;Nykštukai;5607937410;Taip;10;0;0;10
13938;Saulutė;Nykštukai;3571751974;Taip;8;11;0;19
13939;Saulutė;Nykštukai;3221612665;Taip;10;0;3;13
13940;Saulutė;Nykštukai;2140277182;Taip;3;4;0;7
13941;Saulutė;Nykštukai;4510990261;Taip;13;0;3;16
13942;Saulutė;Nykštukai;4800144085;Taip;0;0;2;2
13943;Saulutė;Nykštukai;7297886198;Taip;0;21;0;21
13944;Saulutė;Nykštukai;1686338325;Taip;9;0;2;11
13945;Saulutė;Nykštukai;8257363228;Ne;13;0;0;13
13946;Saulutė;Nykštukai;9947607411;Ne;16;0;0;16
13947;Saulutė;Meškiukai;2337702344;Ne;20;0;0;20
13948;Saulutė;Meškiukai;4194586403;Ne;17;0;0;17
13949;Saulutė;Meškiukai;1370201372;Ne;9;1;0;10
13950;Saulutė;Meškiukai;1853984777;Ne;15;0;0;15
13951;Saulutė;Meškiukai;3133714991;Ne;10;10;0;20
13952;Saulutė;Meškiukai;2484025931;Ne;5;8;0;13
13953;Saulutė;Meškiukai;9317649996;Ne;8;0;0;8
13954;Saulutė;Meškiukai;6219942114;Ne;0;0;1;1
13955;Saulutė;Meškiukai;6678283260;Ne;4;0;4;8
13956;Saulutė;Meškiukai;3662919521;Taip;12;0;0;12
13957;Saulutė;Meškiukai;6304028361;Taip;20;0;0;20
13958;Saulutė;Meškiukai;7967532537;Taip;0;10;0;10
13959;Saulutė;Meškiukai;4575314373;Ne;7;5;0;12
13960;Saulutė;Meškiukai;4039065925;Ne;10;0;1;11
13961;Saulutė;Meškiukai;2728669975;Ne;3;1;0;4
13962;Saulutė;Meškiukai;4067009709;Ne;20;0;0;20
13963;Saulutė;Meškiukai;2301903550;Ne;6;13;0;19
13964;Saulutė;Ežiukai;1917058710;Ne;9;0;1;10
13965;Saulutė;Ežiukai;2813274509;Taip;12;0;6;18
13966;Saulutė;Ežiukai;3410606033;Taip;0;0;2;2
13967;Saulutė;Ežiukai;6982979199;Taip;7;0;3;10
13968;Saulutė;Ežiukai;2315812734;Ne;0;15;5;20
13969;Saulutė;Ežiukai;2059342403;Ne;16;0;1;17
13970;Saulutė;Ežiukai;8736917541;Taip;9;0;0;9
13971;Saulutė;Ežiukai;7413098580;Taip;5;0;3;8
13972;Saulutė;Ežiukai;5999318972;Taip;3;0;2;5
13973;Saulutė;Ežiukai;4363210987;Ne;0;0;1;1
13974;Saulutė;Ežiukai;5972503001;Ne;11;0;0;11
13975;Saulutė;Ežiukai;4791053946;Ne;9;0;2;11
13976;Saulutė;Ežiukai;6884472677;Taip;3;0;0;3
13977;Saulutė;Bitutės;3126468651;Ne;7;0;1;8
13978;Saulutė;Bitutės;1268204445;Taip;20;0;0;20
13979;Saulutė;Bitutės;4288298305;Ne;11;0;1;12
13980;Saulutė;Bitutės;3265401334;Ne;5;6;1;12
13981;Saulutė;Bitutės;9133269796;Ne;3;0;0;3
13982;Saulutė;Bitutės;5987478379;Ne;7;0;0;7
13983;Saulutė;Bitutės;5943795519;Ne;10;9;0;19
13984;Saulutė;Bitutės;3463428772;Ne;15;0;0;15
13985;Saulutė;Bitutės;8003855875;Ne;10;0;1;11
13986;Saulutė;Bitutės;2669711574;Ne;3;0;0;3
13987;Saulutė;Bitutės;5562733723;Taip;5;10;0;15
13988;Saulutė;Bitutės;3991128892;Taip;12;8;0;20
13989;Saulutė;Bitutės;7689842018;Ne;5;7;0;12
13990;Saulutė;Bitutės;5931269521;Ne;0;20;0;20
13991;Saulutė;Bitutės;1585403702;Taip;4;4;2;10
13992;Saulutė;Bitutės;4915192103;Ne;0;0;1;1
13993;Saulutė;Bitutės;4453610732;Taip;0;0;1;1
13994;Saulutė;Pelėdžiukai;8512137633;Taip;7;0;0;7
13995;Saulutė;Pelėdžiukai;7139492238;Taip;0;1;0;1
13996;Saulutė;Pelėdžiukai;4211866191;Taip;0;1;0;1
13997;Saulutė;Pelėdžiukai;2373409300;Taip;0;20;0;20
13998;Saulutė;Pelėdžiukai;8405262902;Taip;0;1;0;1
13999;Saulutė;Pelėdžiukai;4123500930;Ne;0;1;0;1
14000;Saulutė;Pelėdžiukai;1056158093;Ne;4;0;0;4
14001;Saulutė;Pelėdžiukai;8371366346;Taip;9;4;0;13
14002;Saulutė;Pelėdžiukai;6842585310;Ne;9;0;8;17
14003;Saulutė;Pelėdžiukai;1776164273;Taip;0;0;14;14
14004;Saulutė;Pelėdžiukai;5850783789;Taip;8;0;1;9
14005;Saulutė;Pelėdžiukai;6608003946;Taip;11;3;0;14
14006;Saulutė;Pelėdžiukai;7620841597;Taip;15;0;0;15
14007;Saulutė;Pelėdžiukai;6046611248;Taip;0;6;0;6
14008;Saulutė;Pelėdžiukai;4301516165;Taip;0;15;1;16
14009;Saulutė;Pelėdžiukai;7258180835;Ne;0;11;5;16
14010;Saulutė;Zylutės;1786491396;Taip;0;4;0;4
14011;Saulutė;Zylutės;16622528829;Taip;11;3;0;14
14012;Saulutė;Zylutės;1911318708;Taip;0;0;4;4
14013;Saulutė;Zylutės;1332002470;Ne;6;2;0;8
14014;Saulutė;Zylutės;67332285574;Ne;5;0;0;5
14015;Saulutė;Zylutės;3228226715;Taip;14;0;0;14
14016;Saulutė;Zylutės;8040751073;Taip;6;0;0;6
14017;Saulutė;Zylutės;8041118115;Taip;0;15;0;15
14018;Saulutė;Zylutės;5198558993;Taip;20;0;0;20
14019;Saulutė;Zylutės;7281873166;Taip;5;1;3;9
14020;Saulutė;Zylutės;7839168221;Taip;10;0;0;10
14021;Saulutė;Zylutės;8717210130;Taip;0;1;10;11
14022;Saulutė;Zylutės;7318452189;Taip;0;0;8;8
14023;Saulutė;"1 klasė";45306237230;Taip;8;0;0;8
14024;Saulutė;"1 klasė";5511093996;Taip;6;0;0;6
14025;Saulutė;"1 klasė";2622662153;Ne;5;0;0;5
14026;Saulutė;"1 klasė";37315117916;Taip;2;0;0;2
14027;Saulutė;"1 klasė";3445723020;Ne;2;0;0;2
14028;Saulutė;"1 klasė";14195215027;Taip;8;0;0;8
14029;Saulutė;"1 klasė";2098990667;Taip;1;0;0;1
14030;Saulutė;"1 klasė";75405796772;Ne;18;0;0;18
14031;Saulutė;"1 klasė";1277263391;Taip;1;0;0;1
14032;Saulutė;"1 klasė";97145959022;Taip;13;0;0;13
14033;Saulutė;"1 klasė";77170708225;Taip;13;0;0;13
14034;Saulutė;"1 klasė";5574049005;Taip;5;0;0;5
14035;Saulutė;"1 klasė";1510434265;Taip;2;0;0;2
14036;Saulutė;"1 klasė";79438946697;Taip;6;0;0;6
14037;Saulutė;"1 klasė";29074930927;Taip;4;0;0;4
14038;Saulutė;"2 klasė";1005459768;Taip;7;0;0;7
14039;Saulutė;"2 klasė";1804521229;Taip;1;0;0;1
14040;Saulutė;"2 klasė";44452051978;Ne;1;0;0;1
14041;Saulutė;"2 klasė";78967475616;Ne;2;0;0;2
14042;Saulutė;"2 klasė";76744652185;Taip;1;0;0;1
14043;Saulutė;"2 klasė";97296161595;Taip;3;0;0;3
14044;Saulutė;"2 klasė";99841176399;Taip;3;0;0;3
14045;Saulutė;"2 klasė";21703177024;Ne;1;0;0;1
14046;Saulutė;"2 klasė";13147367113;Taip;2;0;0;2
14047;Saulutė;"2 klasė";2216383015;Taip;1;0;0;1
14048;Saulutė;"2 klasė";96497471950;Taip;2;0;0;2
14049;Saulutė;"2 klasė";6557918941;Taip;1;0;0;1
14050;Saulutė;"3 klasė";58163470119;Ne;2;0;0;2
14051;Saulutė;"3 klasė";5822529731;Taip;1;0;0;1
14052;Saulutė;"3 klasė";13916981850;Ne;3;0;0;3
14053;Saulutė;"3 klasė";92198716772;Ne;2;0;0;2
14054;Saulutė;"3 klasė";16523279366;Taip;1;0;0;1
14055;Saulutė;"3 klasė";2095347468;Taip;1;0;0;1
14056;Saulutė;"3 klasė";30863736694;Taip;5;0;0;5
14057;Saulutė;"3 klasė";45877127245;Taip;1;0;0;1
14058;Saulutė;"3 klasė";61113930769;Taip;10;0;0;10
14059;Saulutė;"3 klasė";7785909571;Ne;1;0;0;1
14060;Saulutė;"3 klasė";90078805222;Taip;1;0;0;1
14061;Saulutė;"3 klasė";42204884890;Ne;1;0;0;1
14062;Saulutė;"3 klasė";5213320470;Ne;5;0;0;5
14063;Saulutė;"4 klasė";4252242862;Taip;9;0;0;9
14064;Saulutė;"4 klasė";2517511237;Ne;6;0;0;6
14065;Saulutė;"4 klasė";8953313952;Ne;2;0;0;2
14066;Saulutė;"4 klasė";4342595483;Taip;2;0;0;2
14067;Saulutė;"4 klasė";1153099638;Taip;3;0;0;3
14068;Saulutė;"4 klasė";8531372660;Taip;3;0;0;3
14069;Saulutė;"4 klasė";3614749034;Taip;14;0;0;14
14070;Saulutė;"4 klasė";7696948081;Taip;2;0;0;2
14071;Saulutė;"4 klasė";2957436888;Taip;5;0;0;5
14072;Saulutė;"4 klasė";3937034221;Ne;5;0;0;5
14073;Saulutė;"4 klasė";1312993030;Taip;8;0;0;8
14074;Saulutė;"4 klasė";3450860412;Taip;6;0;0;6
14075;Saulutė;"4 klasė";7543978588;Taip;2;0;0;2
14076;Saulutė;"4 klasė";1701868565;Taip;3;0;0;3
14077;Svaja;SAULĖGRĄŽA;4189290919;Ne;10;11;0;21
14078;Svaja;SAULĖGRĄŽA;4333001830;Taip;0;0;5;5
14079;Svaja;SAULĖGRĄŽA;1579441289;Taip;9;0;0;9
14080;Svaja;SAULĖGRĄŽA;9811110367;Taip;9;0;0;9
14081;Svaja;SAULĖGRĄŽA;3912426942;Taip;0;0;6;6
14082;Svaja;SAULĖGRĄŽA;9680766688;Taip;6;0;0;6
14083;Svaja;SAULĖGRĄŽA;3809817617;Taip;0;0;3;3
14084;Svaja;SAULĖGRĄŽA;3792660330;Taip;12;1;0;13
14085;Svaja;SAULĖGRĄŽA;2209697834;Taip;5;0;9;14
14086;Svaja;SAULĖGRĄŽA;3563842321;Taip;0;0;2;2
14087;Svaja;SAULĖGRĄŽA;4253831334;Taip;7;0;3;10
14088;Svaja;SAULĖGRĄŽA;3461282516;Taip;5;0;3;8
14089;Svaja;SAULĖGRĄŽA;9240037050;Taip;13;1;0;14
14090;Svaja;SAULĖGRĄŽA;7089640807;Taip;11;0;1;12
14091;Svaja;SAULĖGRĄŽA;6963684639;Taip;4;0;0;4
14092;Svaja;SAULĖGRĄŽA;4510147045;Taip;11;2;0;13
14093;Svaja;SAULĖGRĄŽA;7023534254;Taip;0;0;4;4
14094;Svaja;SAULĖGRĄŽA;6928763381;Taip;0;0;6;6
14095;Svaja;SAULĖGRĄŽA;3501620040;Taip;0;3;2;5
14096;Svaja;SAULĖGRĄŽA;7575922215;Taip;4;0;1;5
14097;Svaja;SAULĖGRĄŽA;7408966637;Taip;4;0;5;9
14098;Svaja;"STEBUKLINGAS ŽIBINTAS";9814969596;Taip;0;0;5;5
14099;Svaja;"STEBUKLINGAS ŽIBINTAS";2200408537;Taip;0;0;3;3
14100;Svaja;"STEBUKLINGAS ŽIBINTAS";9086270220;Ne;0;0;3;3
14101;Svaja;"STEBUKLINGAS ŽIBINTAS";3940123543;Taip;0;0;1;1
14102;Svaja;"STEBUKLINGAS ŽIBINTAS";8353427144;Taip;0;0;2;2
14103;Svaja;"STEBUKLINGAS ŽIBINTAS";4237592104;Taip;10;0;1;11
14104;Svaja;"STEBUKLINGAS ŽIBINTAS";2658828200;Taip;0;11;0;11
14105;Svaja;"STEBUKLINGAS ŽIBINTAS";4290716676;Taip;0;0;4;4
14106;Svaja;"STEBUKLINGAS ŽIBINTAS";1558093905;Taip;0;0;1;1
14107;Svaja;"STEBUKLINGAS ŽIBINTAS";9102872020;Taip;10;5;1;16
14108;Svaja;"STEBUKLINGAS ŽIBINTAS";4394417103;Taip;0;0;4;4
14109;Svaja;"STEBUKLINGAS ŽIBINTAS";8827421660;Taip;6;0;0;6
14110;Svaja;"STEBUKLINGAS ŽIBINTAS";1050291871;Taip;7;0;2;9
14111;Svaja;"STEBUKLINGAS ŽIBINTAS";2188430052;Ne;5;0;3;8
14112;Svaja;"STEBUKLINGAS ŽIBINTAS";1860076171;Taip;5;0;3;8
14113;Svaja;"STEBUKLINGAS ŽIBINTAS";8363418532;Taip;11;0;3;14
14114;Svaja;"STEBUKLINGAS ŽIBINTAS";8172396846;Taip;0;8;0;8
14115;Svaja;"STEBUKLINGAS ŽIBINTAS";9545690301;Ne;5;0;1;6
14116;Svaja;"STEBUKLINGAS ŽIBINTAS";4004383843;Taip;0;0;1;1
14117;Svaja;"STEBUKLINGAS ŽIBINTAS";6128350581;Ne;0;0;3;3
14118;Svaja;"STEBUKLINGAS ŽIBINTAS";1150040935;Ne;15;0;1;16
14119;Svaja;SAULUTĖ;50207734108;Taip;1;0;1;2
14120;Svaja;SAULUTĖ;20473739993;Taip;4;0;0;4
14121;Svaja;SAULUTĖ;30719991872;Taip;8;0;0;8
14122;Svaja;SAULUTĖ;6665752307;Ne;9;0;1;10
14123;Svaja;SAULUTĖ;4968201186;Taip;5;1;0;6
14124;Svaja;SAULUTĖ;8689706130;Taip;0;1;0;1
14125;Svaja;SAULUTĖ;6807834176;Ne;0;0;2;2
14126;Svaja;SAULUTĖ;7020342969;Taip;0;1;0;1
14127;Svaja;SAULUTĖ;3633996231;Taip;2;0;3;5
14128;Svaja;SAULUTĖ;2750615517;Taip;10;1;0;11
14129;Svaja;SAULUTĖ;3049808328;Taip;0;0;7;7
14130;Svaja;SAULUTĖ;1045300185;Taip;0;0;3;3
14131;Svaja;SAULUTĖ;4341042027;Taip;5;0;1;6
14132;Svaja;SAULUTĖ;3802996573;Taip;5;0;0;5
14133;Svaja;SAULUTĖ;7936765752;Taip;0;0;1;1
14134;Svaja;SAULUTĖ;4293339784;Taip;21;0;0;21
14135;Svaja;SAULUTĖ;9475971731;Taip;0;0;3;3
14136;Svaja;SAULUTĖ;5479482244;Ne;0;0;4;4
14137;Svaja;SAULUTĖ;7473493846;Taip;6;0;2;8
14138;Svaja;SAULUTĖ;5443682744;Taip;14;0;0;14
14139;Svaja;SAULUTĖ;9112198914;Taip;0;0;4;4
14140;Svaja;"AUKSINĖ ŽUVELĖ";43307670660;Ne;0;5;0;5
14141;Svaja;"AUKSINĖ ŽUVELĖ";25194696146;Taip;7;0;1;8
14142;Svaja;"AUKSINĖ ŽUVELĖ";55925058866;Taip;0;0;1;1
14143;Svaja;"AUKSINĖ ŽUVELĖ";1704075006;Ne;0;11;0;11
14144;Svaja;"AUKSINĖ ŽUVELĖ";70641067006;Taip;0;5;0;5
14145;Svaja;"AUKSINĖ ŽUVELĖ";8875237023;Taip;5;9;0;14
14146;Svaja;"AUKSINĖ ŽUVELĖ";8279605005;Taip;4;0;0;4
14147;Svaja;"AUKSINĖ ŽUVELĖ";1437557657;Taip;19;0;0;19
14148;Svaja;"AUKSINĖ ŽUVELĖ";36505115395;Taip;5;0;1;6
14149;Svaja;"AUKSINĖ ŽUVELĖ";6593047776;Taip;0;9;0;9
14150;Svaja;"AUKSINĖ ŽUVELĖ";5335776957;Ne;7;0;0;7
14151;Svaja;"AUKSINĖ ŽUVELĖ";1295012978;Taip;0;0;2;2
14152;Svaja;"AUKSINĖ ŽUVELĖ";64196174690;Taip;5;5;0;10
14153;Svaja;"AUKSINĖ ŽUVELĖ";22702341083;Ne;0;8;0;8
14154;Svaja;"AUKSINĖ ŽUVELĖ";2076060840;Taip;5;0;1;6
14155;Svaja;"AUKSINĖ ŽUVELĖ";27445299450;Taip;0;0;1;1
14156;Svaja;"AUKSINĖ ŽUVELĖ";1576498450;Taip;0;0;1;1
14157;Svaja;"AUKSINĖ ŽUVELĖ";21871530266;Taip;0;0;1;1
14158;Svaja;"AUKSINĖ ŽUVELĖ";7753488216;Ne;0;0;1;1
14159;Svaja;"AUKSINĖ ŽUVELĖ";7669562010;Ne;11;0;1;12
14160;Svaja;"PRIE ĮLANKOS";2985196852;Ne;9;0;0;9
14161;Svaja;"PRIE ĮLANKOS";1046879533;Taip;0;0;1;1
14162;Svaja;"PRIE ĮLANKOS";1714711904;Taip;4;10;0;14
14163;Svaja;"PRIE ĮLANKOS";49787034798;Ne;0;0;1;1
14164;Svaja;"PRIE ĮLANKOS";9110985103;Taip;5;0;0;5
14165;Svaja;"PRIE ĮLANKOS";47457128214;Ne;5;0;0;5
14166;Svaja;"PRIE ĮLANKOS";3562817807;Taip;4;0;5;9
14167;Svaja;"PRIE ĮLANKOS";2147266053;Taip;0;5;1;6
14168;Svaja;"PRIE ĮLANKOS";1197826066;Taip;3;0;0;3
14169;Svaja;"PRIE ĮLANKOS";2069150261;Taip;5;3;0;8
14170;Svaja;"PRIE ĮLANKOS";1191494598;Taip;0;0;3;3
14171;Svaja;"PRIE ĮLANKOS";73679997517;Ne;5;0;0;5
14172;Svaja;"PRIE ĮLANKOS";15159708127;Ne;0;0;1;1
14173;Svaja;"PRIE ĮLANKOS";8503177793;Ne;0;0;1;1
14174;Svaja;"PRIE ĮLANKOS";1633236289;Ne;0;0;8;8
14175;Svaja;"PRIE ĮLANKOS";9414846817;Ne;6;0;1;7
14176;Svaja;"PRIE ĮLANKOS";56117509354;Ne;5;0;1;6
14177;Svaja;"4 A klasė";6890796785;Taip;0;21;0;21
14178;Svaja;"4 A klasė";3060720122;Taip;0;21;0;21
14179;Svaja;"4 A klasė";4191652201;Taip;0;21;0;21
14180;Svaja;"4 A klasė";2408787820;Taip;0;21;0;21
14181;Svaja;"4 A klasė";2143707618;Taip;0;21;0;21
14182;Svaja;"4 A klasė";9922327181;Taip;0;21;0;21
14183;Svaja;"4 A klasė";7360643147;Taip;0;21;0;21
14184;Svaja;"4 A klasė";9431617139;Taip;0;21;0;21
14185;Svaja;"4 A klasė";5072924063;Taip;0;21;0;21
14186;Svaja;"4 A klasė";1224863574;Ne;0;21;0;21
14187;Svaja;"4 A klasė";5866029763;Ne;0;21;0;21
14188;Svaja;"4 A klasė";5224191012;Taip;0;21;0;21
14189;Svaja;"4 A klasė";2396489897;Taip;0;21;0;21
14190;Svaja;"4 A klasė";3362976996;Taip;0;21;0;21
14191;Svaja;"4 A klasė";6924433006;Taip;0;21;0;21
14192;Svaja;"4 A klasė";6379522088;Taip;0;21;0;21
14193;Svaja;"4 A klasė";6859893256;Taip;0;21;0;21
14194;Svaja;"4 A klasė";7222472406;Taip;0;21;0;21
14195;Svaja;"4 A klasė";8566329547;Ne;0;21;0;21
14196;Svaja;"4 A klasė";8014577929;Taip;0;21;0;21
14197;Svaja;"4 A klasė";5916292577;Taip;0;21;0;21
14198;Šilelis;PAUKŠTELIAI;2823486581;Taip;0;0;3;3
14199;Šilelis;PAUKŠTELIAI;6369443270;Taip;0;0;6;6
14200;Šilelis;PAUKŠTELIAI;3053443777;Taip;3;0;1;4
14201;Šilelis;PAUKŠTELIAI;8166061969;Taip;0;8;0;8
14202;Šilelis;PAUKŠTELIAI;6916502905;Taip;0;0;1;1
14203;Šilelis;PAUKŠTELIAI;5025956218;Taip;10;0;0;10
14204;Šilelis;PAUKŠTELIAI;2913622440;Taip;0;0;4;4
14205;Šilelis;SKRUZDELIUKAI;7502057552;Taip;12;1;0;13
14206;Šilelis;SKRUZDELIUKAI;6099940488;Taip;15;0;1;16
14207;Šilelis;SKRUZDELIUKAI;6139976105;Taip;6;0;0;6
14208;Šilelis;SKRUZDELIUKAI;3823958567;Taip;3;8;0;11
14209;Šilelis;SKRUZDELIUKAI;2289616655;Taip;10;0;0;10
14210;Šilelis;SKRUZDELIUKAI;1887013803;Taip;0;3;0;3
14211;Šilelis;SKRUZDELIUKAI;6359318134;Taip;7;1;0;8
14212;Šilelis;SKRUZDELIUKAI;5598152793;Taip;5;13;0;18
14213;Šilelis;SKRUZDELIUKAI;8090773379;Taip;15;2;0;17
14214;Šilelis;SKRUZDELIUKAI;1200024379;Taip;7;0;1;8
14215;Šilelis;SKRUZDELIUKAI;7299084520;Taip;0;5;0;5
14216;Šilelis;SKRUZDELIUKAI;3373275644;Taip;7;0;3;10
14217;Šilelis;SKRUZDELIUKAI;9589138527;Taip;5;13;0;18
14218;Šilelis;SKRUZDELIUKAI;3967932407;Taip;0;5;0;5
14219;Šilelis;SKRUZDELIUKAI;4629917226;Taip;8;3;0;11
14220;Šilelis;SKRUZDELIUKAI;2972202874;Taip;5;0;4;9
14221;Šilelis;SKRUZDELIUKAI;9461117894;Taip;3;1;4;8
14222;Šilelis;SKRUZDELIUKAI;2093224908;Taip;0;0;1;1
14223;Šilelis;SKRUZDELIUKAI;5817818596;Taip;10;0;2;12
14224;Šilelis;SKRUZDELIUKAI;6827855685;Taip;10;5;0;15
14225;Šilelis;SMERFY;8980788109;Taip;1;0;0;1
14226;Šilelis;SMERFY;7936978436;Taip;0;10;0;10
14227;Šilelis;SMERFY;8100789958;Taip;10;0;1;11
14228;Šilelis;SMERFY;6572969153;Taip;0;2;0;2
14229;Šilelis;SMERFY;3015424614;Taip;0;0;4;4
14230;Šilelis;SMERFY;3247333567;Taip;0;13;0;13
14231;Šilelis;SMERFY;6999088222;Ne;10;0;0;10
14232;Šilelis;SMERFY;9886134621;Ne;10;0;0;10
14233;Šilelis;SMERFY;5036549574;Taip;8;0;1;9
14234;Šilelis;SMERFY;6773906184;Ne;6;0;2;8
14235;Šilelis;SMERFY;3089270468;Taip;0;6;0;6
14236;Šilelis;SMERFY;7824279279;Ne;0;1;0;1
14237;Šilelis;SMERFY;7534468539;Taip;5;0;1;6
14238;Šilelis;SMERFY;1821827154;Taip;0;0;2;2
14239;Šilelis;SMERFY;4196893379;Taip;6;0;0;6
14240;Šilelis;EŽIUKAI;6336168033;Taip;0;0;1;1
14241;Šilelis;EŽIUKAI;9266061396;Ne;8;0;0;8
14242;Šilelis;EŽIUKAI;1165219272;Taip;0;4;0;4
14243;Šilelis;EŽIUKAI;3234612149;Taip;17;0;0;17
14244;Šilelis;EŽIUKAI;4702068672;Taip;0;2;0;2
14245;Šilelis;EŽIUKAI;1724976098;Taip;3;6;0;9
14246;Šilelis;EŽIUKAI;1586414960;Taip;5;11;0;16
14247;Šilelis;EŽIUKAI;5020209473;Taip;0;0;3;3
14248;Šilelis;EŽIUKAI;2397366916;Taip;0;12;0;12
14249;Šilelis;EŽIUKAI;2151250706;Taip;15;0;0;15
14250;Šilelis;EŽIUKAI;2295849333;Taip;0;2;0;2
14251;Šilelis;EŽIUKAI;5131051261;Taip;17;0;0;17
14252;Šilelis;EŽIUKAI;4678970810;Taip;2;0;1;3
14253;Šilelis;EŽIUKAI;1883483049;Taip;0;10;0;10
14254;Šilelis;EŽIUKAI;6854997486;Taip;0;0;1;1
14255;Šilelis;EŽIUKAI;6386996498;Taip;0;0;6;6
14256;Šilelis;EŽIUKAI;5210301367;Taip;3;0;1;4
14257;Šilelis;EŽIUKAI;9354491312;Taip;21;0;0;21
14258;Šilelis;EŽIUKAI;4822495270;Taip;10;0;2;12
14259;Šilelis;NYKŠTUKAI;2908840424;Taip;9;0;3;12
14260;Šilelis;NYKŠTUKAI;3046954717;Taip;5;1;1;7
14261;Šilelis;NYKŠTUKAI;3158708835;Taip;8;0;0;8
14262;Šilelis;NYKŠTUKAI;6195580698;Taip;5;0;0;5
14263;Šilelis;NYKŠTUKAI;6107771932;Taip;0;0;5;5
14264;Šilelis;NYKŠTUKAI;4323998445;Taip;3;0;0;3
14265;Šilelis;NYKŠTUKAI;2095572561;Taip;3;0;0;3
14266;Šilelis;NYKŠTUKAI;2161973782;Taip;0;5;0;5
14267;Šilelis;NYKŠTUKAI;3999426414;Taip;5;0;2;7
14268;Šilelis;NYKŠTUKAI;5745874033;Taip;3;0;0;3
14269;Šilelis;NYKŠTUKAI;3295727210;Taip;0;13;0;13
14270;Šilelis;NYKŠTUKAI;9769483899;Taip;5;3;0;8
14271;Šilelis;NYKŠTUKAI;8944490184;Taip;0;0;2;2
14272;Šilelis;ANČIUKAI;6560491835;Taip;0;1;0;1
14273;Šilelis;ANČIUKAI;1621768113;Taip;0;1;0;1
14274;Šilelis;ANČIUKAI;4187993554;Taip;0;1;0;1
14275;Šilelis;ANČIUKAI;2018007566;Ne;0;10;0;10
14276;Šilelis;ANČIUKAI;1594700604;Taip;0;2;0;2
14277;Šilelis;ANČIUKAI;5375413045;Taip;0;9;0;9
14278;Šilelis;ANČIUKAI;1246899777;Taip;10;4;1;15
14279;Šilelis;ANČIUKAI;6297546907;Taip;7;1;2;10
14280;Šilelis;ANČIUKAI;5766702969;Taip;10;1;2;13
14281;Šilelis;ANČIUKAI;29368876227;Taip;0;1;0;1
14282;Šilelis;KAČIUKAI;9848760151;Taip;0;11;0;11
14283;Šilelis;KAČIUKAI;4743459915;Ne;7;0;0;7
14284;Šilelis;KAČIUKAI;8387022157;Taip;15;2;0;17
14285;Šilelis;KAČIUKAI;3393466953;Taip;0;0;2;2
14286;Šilelis;KAČIUKAI;2111979474;Taip;11;0;0;11
14287;Šilelis;KAČIUKAI;8064905796;Taip;5;1;0;6
14288;Šilelis;KAČIUKAI;5176259940;Taip;0;1;2;3
14289;Šilelis;KAČIUKAI;5589764935;Taip;21;0;0;21
14290;Šilelis;KAČIUKAI;7123048946;Taip;0;0;3;3
14291;Šilelis;KAČIUKAI;6479728064;Taip;0;8;0;8
14292;Šilelis;KAČIUKAI;3686287802;Taip;10;0;0;10
14293;Šilelis;KAČIUKAI;2906501601;Taip;0;4;0;4
14294;Šilelis;KAČIUKAI;6510813364;Taip;7;0;0;7
14295;Šilelis;KAČIUKAI;2917305351;Taip;0;0;5;5
14296;Šilelis;KAČIUKAI;8319185507;Taip;0;0;2;2
14297;Šilelis;KAČIUKAI;8504187981;Taip;0;0;4;4
14298;Šilelis;KAČIUKAI;6470073008;Taip;15;0;0;15
14299;Šilelis;KAČIUKAI;3419284228;Taip;9;0;0;9
14300;Šilelis;KAČIUKAI;3712001932;Taip;10;0;0;10
14301;Šilelis;KIŠKUČIAI;1392455608;Taip;0;0;1;1
14302;Šilelis;KIŠKUČIAI;193181908;Taip;5;0;0;5
14303;Šilelis;KIŠKUČIAI;1747920772;Taip;5;0;4;9
14304;Šilelis;KIŠKUČIAI;1640789816;Taip;0;0;1;1
14305;Šilelis;KIŠKUČIAI;6061033736;Taip;13;3;0;16
14306;Šilelis;KIŠKUČIAI;6096639483;Taip;0;0;2;2
14307;Šilelis;KIŠKUČIAI;2681063256;Taip;0;0;6;6
14308;Šilelis;KIŠKUČIAI;9234766553;Ne;0;0;3;3
14309;Šilelis;KIŠKUČIAI;7208757038;Taip;5;0;3;8
14310;Šilelis;KIŠKUČIAI;1547108532;Ne;0;15;0;15
14311;Šilelis;KIŠKUČIAI;4066969586;Taip;8;0;0;8
14312;Šilelis;KREGŽDUTĖS;1344825612;Taip;7;0;0;7
14313;Šilelis;KREGŽDUTĖS;3655800765;Taip;11;2;0;13
14314;Šilelis;KREGŽDUTĖS;1719681061;Taip;5;2;0;7
14315;Šilelis;KREGŽDUTĖS;2049105004;Taip;0;6;0;6
14316;Šilelis;KREGŽDUTĖS;36811772392;Taip;0;6;0;6
14317;Šilelis;KREGŽDUTĖS;1497479780;Taip;0;5;0;5
14318;Šilelis;KREGŽDUTĖS;1958785859;Taip;0;1;0;1
14319;Šilelis;KREGŽDUTĖS;89194687299;Taip;0;9;0;9
14320;Šilelis;KREGŽDUTĖS;1571063782;Taip;0;2;2;4
14321;Šilelis;KREGŽDUTĖS;82928837930;Taip;0;1;0;1
14322;Šilelis;KREGŽDUTĖS;1984731000;Ne;10;0;0;10
14323;Šilelis;KREGŽDUTĖS;1528581005;Taip;0;1;0;1
14324;Šilelis;KREGŽDUTĖS;40753518660;Taip;0;1;0;1
14325;Šilelis;KREGŽDUTĖS;75274553746;Taip;6;2;7;15
14326;Šilelis;KREGŽDUTĖS;7542121945;Taip;0;1;2;3
14327;Šilelis;KREGŽDUTĖS;8915228012;Taip;14;0;0;14
14328;Šilelis;KREGŽDUTĖS;1448291886;Taip;0;2;0;2
14329;Šilelis;PAGRANDUKAI;43259107285;Taip;6;1;0;7
14330;Šilelis;PAGRANDUKAI;3660152224;Taip;8;0;0;8
14331;Šilelis;PAGRANDUKAI;4814863979;Ne;13;1;0;14
14332;Šilelis;PAGRANDUKAI;9670243727;Taip;0;1;0;1
14333;Šilelis;PAGRANDUKAI;20525573092;Taip;0;4;0;4
14334;Šilelis;PAGRANDUKAI;2897196188;Ne;5;0;0;5
14335;Šilelis;PAGRANDUKAI;1288690113;Taip;0;7;0;7
14336;Šilelis;PAGRANDUKAI;3583955729;Ne;7;8;0;15
14337;Šilelis;PAGRANDUKAI;9113098594;Taip;3;0;0;3
14338;Šilelis;PAGRANDUKAI;8265212749;Taip;0;5;0;5
14339;Šilelis;PAGRANDUKAI;9081488972;Taip;0;0;2;2
14340;Šilelis;PAGRANDUKAI;55396452032;Taip;7;2;0;9
14341;Šilelis;PAGRANDUKAI;7623203279;Taip;5;0;1;6
14342;Šilelis;PAGRANDUKAI;4340856490;Taip;11;0;0;11
14343;Šilelis;PAGRANDUKAI;2354942164;Taip;5;5;0;10
14344;Šilelis;PAGRANDUKAI;8687864179;Taip;13;0;0;13
14345;Šilelis;PAGRANDUKAI;6276408187;Taip;10;0;1;11
14346;Šilelis;PAGRANDUKAI;8416126751;Taip;2;0;2;4
14347;Šilelis;BITUTĖS;2948291866;Taip;9;3;0;12
14348;Šilelis;BITUTĖS;4682742121;Taip;0;0;1;1
14349;Šilelis;BITUTĖS;7512731255;Taip;0;10;0;10
14350;Šilelis;BITUTĖS;1268335563;Taip;0;0;1;1
14351;Šilelis;BITUTĖS;4781652156;Taip;10;0;0;10
14352;Šilelis;BITUTĖS;6104538160;Taip;3;0;1;4
14353;Šilelis;BITUTĖS;7814807923;Taip;2;0;2;4
14354;Šilelis;BITUTĖS;5305660046;Taip;0;0;2;2
14355;Šilelis;BITUTĖS;9071963194;Taip;0;6;2;8
14356;Šilelis;BITUTĖS;5843337891;Taip;5;0;1;6
14357;Šilelis;BITUTĖS;1960952604;Taip;2;0;5;7
14358;Šilelis;BITUTĖS;3954379433;Taip;21;0;0;21
14359;Šilelis;BITUTĖS;7350013139;Taip;0;6;0;6
14360;Šilelis;BITUTĖS;3062557053;Taip;0;0;1;1
14361;Šilelis;BITUTĖS;1390916076;Taip;0;0;3;3
14362;Šilelis;BITUTĖS;6143099736;Ne;0;0;1;1
14363;Šilelis;BITUTĖS;2023309512;Ne;7;0;0;7
14364;Šilelis;DRUGELIAI;1877467761;Taip;0;0;16;16
14365;Šilelis;DRUGELIAI;2079073174;Taip;0;0;1;1
14366;Šilelis;DRUGELIAI;3598370884;Taip;17;0;0;17
14367;Šilelis;DRUGELIAI;1618432877;Taip;19;0;0;19
14368;Šilelis;DRUGELIAI;1347150938;Taip;9;1;0;10
14369;Šilelis;DRUGELIAI;7636725161;Taip;2;1;1;4
14370;Šilelis;DRUGELIAI;9256656029;Taip;0;2;0;2
14371;Šilelis;DRUGELIAI;1891388542;Taip;5;1;4;10
14372;Šilelis;DRUGELIAI;5759824196;Ne;7;0;0;7
14373;Šilelis;DRUGELIAI;31906089315;Taip;5;8;0;13
14374;Šilelis;DRUGELIAI;4115738520;Taip;0;5;0;5
14375;Šilelis;DRUGELIAI;3824174896;Taip;0;5;0;5
14376;Šilelis;DRUGELIAI;8090765017;Taip;9;1;0;10
14377;Šilelis;DRUGELIAI;54633547799;Taip;6;1;2;9
14378;Šilelis;DRUGELIAI;9100047520;Taip;3;1;1;5
14379;Šilelis;DRUGELIAI;1019874215;Taip;0;0;1;1
14380;Šilelis;DRUGELIAI;5863425750;Taip;19;0;0;19
14381;Šilelis;DRUGELIAI;1638362625;Taip;5;5;0;10
14382;Šilelis;DRUGELIAI;9482667810;Taip;1;0;0;1
14383;Šilelis;DRUGELIAI;6230566495;Taip;0;5;0;5
14384;Šilelis;DRUGELIAI;6523676718;Taip;9;0;0;9
14385;Vaduvos;PAGRANDUKAI;1048630061;Taip;8;8;0;16
14386;Vaduvos;PAGRANDUKAI;1431863758;Taip;0;13;0;13
14387;Vaduvos;PAGRANDUKAI;8408017356;Taip;0;5;0;5
14388;Vaduvos;PAGRANDUKAI;72724196791;Taip;0;4;0;4
14389;Vaduvos;PAGRANDUKAI;6425640531;Taip;12;0;0;12
14390;Vaduvos;PAGRANDUKAI;4029586203;Taip;0;1;0;1
14391;Vaduvos;PAGRANDUKAI;18035723255;Ne;17;0;1;18
14392;Vaduvos;PAGRANDUKAI;5954492368;Taip;0;6;0;6
14393;Vaduvos;PAGRANDUKAI;7397068779;Ne;0;4;0;4
14394;Vaduvos;PAGRANDUKAI;8875709110;Taip;0;2;0;2
14395;Vaduvos;PAGRANDUKAI;4789480822;Taip;4;4;0;8
14396;Vaduvos;PAGRANDUKAI;7305111076;Taip;0;2;0;2
14397;Vaduvos;PAGRANDUKAI;2897226343;Taip;0;4;0;4
14398;Vaduvos;PAGRANDUKAI;68848152670;Taip;12;1;0;13
14399;Vaduvos;PAGRANDUKAI;4105978403;Taip;0;3;0;3
14400;Vaduvos;PAGRANDUKAI;5428067167;Taip;0;7;0;7
14401;Vaduvos;PAGRANDUKAI;3699578284;Taip;0;8;0;8
14402;Vaduvos;PAGRANDUKAI;8299189235;Ne;12;0;1;13
14403;Vaduvos;PAGRANDUKAI;3492079864;Taip;7;0;0;7
14404;Vaduvos;KODĖLČIUKAI;3010510262;Taip;12;0;0;12
14405;Vaduvos;KODĖLČIUKAI;6210729584;Taip;10;0;3;13
14406;Vaduvos;KODĖLČIUKAI;9606193112;Taip;0;0;2;2
14407;Vaduvos;KODĖLČIUKAI;9540008495;Taip;0;0;4;4
14408;Vaduvos;KODĖLČIUKAI;4177935331;Taip;10;0;6;16
14409;Vaduvos;KODĖLČIUKAI;9983148737;Taip;0;0;2;2
14410;Vaduvos;KODĖLČIUKAI;9072097216;Ne;0;0;2;2
14411;Vaduvos;KODĖLČIUKAI;6810198013;Taip;1;0;1;2
14412;Vaduvos;KODĖLČIUKAI;3641822841;Taip;5;0;1;6
14413;Vaduvos;KODĖLČIUKAI;4270137614;Taip;11;1;0;12
14414;Vaduvos;KODĖLČIUKAI;3682708061;Taip;6;0;0;6
14415;Vaduvos;KODĖLČIUKAI;5262165284;Taip;9;0;0;9
14416;Vaduvos;KODĖLČIUKAI;8603418399;Taip;4;1;0;5
14417;Vaduvos;KODĖLČIUKAI;3096104197;Taip;19;0;0;19
14418;Vaduvos;KODĖLČIUKAI;5761137540;Ne;10;1;0;11
14419;Vaduvos;KODĖLČIUKAI;1054097622;Taip;15;1;0;16
14420;Vaduvos;KODĖLČIUKAI;6013737546;Ne;0;20;0;20
14421;Vaduvos;KODĖLČIUKAI;3962369527;Ne;10;0;1;11
14422;Vaduvos;SMALSUČIAI;5307128703;Taip;0;1;0;1
14423;Vaduvos;SMALSUČIAI;62183976729;Taip;4;0;0;4
14424;Vaduvos;SMALSUČIAI;1825188497;Taip;7;4;0;11
14425;Vaduvos;SMALSUČIAI;1622695085;Taip;9;0;4;13
14426;Vaduvos;SMALSUČIAI;3555513755;Taip;0;0;6;6
14427;Vaduvos;SMALSUČIAI;2184711783;Taip;0;3;0;3
14428;Vaduvos;SMALSUČIAI;7537754249;Taip;12;0;0;12
14429;Vaduvos;SMALSUČIAI;4565556635;Taip;0;2;0;2
14430;Vaduvos;SMALSUČIAI;5573145836;Taip;0;0;3;3
14431;Vaduvos;SMALSUČIAI;7337663549;Taip;0;0;4;4
14432;Vaduvos;SMALSUČIAI;5055972872;Taip;0;6;0;6
14433;Vaduvos;SMALSUČIAI;6192828320;Taip;3;1;0;4
14434;Vaduvos;SMALSUČIAI;13888236429;Taip;11;0;1;12
14435;Vaduvos;SMALSUČIAI;3722349868;Taip;0;5;0;5
14436;Vaduvos;SMALSUČIAI;3174998523;Ne;12;0;1;13
14437;Vaduvos;SMALSUČIAI;3091707832;Ne;8;0;1;9
14438;Vaduvos;SMALSUČIAI;6128582180;Taip;10;0;3;13
14439;Vaduvos;SMALSUČIAI;87008942241;Taip;0;0;2;2
14440;Vaduvos;SMALSUČIAI;7181151562;Taip;3;0;0;3
14441;Vaduvos;GILIUKAI;11202010413;Taip;9;1;0;10
14442;Vaduvos;GILIUKAI;1046867513;Ne;5;0;0;5
14443;Vaduvos;GILIUKAI;4342471835;Taip;0;0;1;1
14444;Vaduvos;GILIUKAI;15757662594;Taip;6;1;0;7
14445;Vaduvos;GILIUKAI;41870343319;Taip;0;6;0;6
14446;Vaduvos;GILIUKAI;93702732546;Taip;2;0;0;2
14447;Vaduvos;GILIUKAI;2006018986;Taip;5;1;0;6
14448;Vaduvos;GILIUKAI;86095539298;Taip;0;0;1;1
14449;Vaduvos;GILIUKAI;59616893535;Taip;10;0;0;10
14450;Vaduvos;GILIUKAI;56280470781;Taip;8;0;0;8
14451;Vaduvos;GILIUKAI;79437154441;Taip;7;0;2;9
14452;Vaduvos;GILIUKAI;68937983441;Taip;4;5;0;9
14453;Vaduvos;GILIUKAI;65843855427;Ne;0;5;0;5
14454;Vaduvos;GILIUKAI;2065411907;Ne;0;0;1;1
14455;Vaduvos;GILIUKAI;4513707989;Ne;7;0;1;8
14456;Vaduvos;GILIUKAI;1370696345;Taip;3;0;0;3
14457;Vaduvos;GILIUKAI;13178417729;Taip;0;8;0;8
14458;Vaduvos;BORUŽĖLĖS;6991960029;Taip;2;9;0;11
14459;Vaduvos;BORUŽĖLĖS;2277525837;Taip;0;5;0;5
14460;Vaduvos;BORUŽĖLĖS;6439773886;Taip;0;9;0;9
14461;Vaduvos;BORUŽĖLĖS;5634252033;Taip;6;0;4;10
14462;Vaduvos;BORUŽĖLĖS;6593754016;Taip;0;10;0;10
14463;Vaduvos;BORUŽĖLĖS;5356902834;Taip;11;0;1;12
14464;Vaduvos;BORUŽĖLĖS;7521846747;Taip;5;1;0;6
14465;Vaduvos;BORUŽĖLĖS;1422507884;Taip;0;7;0;7
14466;Vaduvos;BORUŽĖLĖS;3461756429;Taip;12;0;3;15
14467;Vaduvos;BORUŽĖLĖS;8324927031;Taip;0;2;0;2
14468;Vaduvos;BORUŽĖLĖS;4465504676;Taip;0;9;0;9
14469;Vaduvos;BORUŽĖLĖS;7904713344;Taip;10;0;1;11
14470;Vaduvos;BORUŽĖLĖS;2417613291;Taip;5;0;1;6
14471;Vaduvos;BORUŽĖLĖS;6462126837;Taip;0;8;0;8
14472;Vaduvos;BORUŽĖLĖS;5717064754;Ne;0;2;0;2
14473;Vaduvos;BORUŽĖLĖS;4554962891;Ne;8;5;0;13
14474;Vaduvos;BORUŽĖLĖS;8064111922;Taip;7;4;1;12
14475;Vaduvos;BORUŽĖLĖS;4317406707;Taip;0;7;4;11
14476;Vaduvos;BORUŽĖLĖS;2923920649;Taip;0;0;1;1
14477;Vaduvos;BORUŽĖLĖS;6552763746;Ne;0;3;0;3
14478;Vaduvos;BORUŽĖLĖS;3255011809;Taip;5;4;1;10
14479;Vaduvos;BORUŽĖLĖS;8946940285;Taip;0;2;0;2
14480;Vaduvos;BORUŽĖLĖS;9188471756;Ne;0;4;0;4
14481;Vaduvos;DRUGELIAI;2341467486;Taip;0;3;4;7
14482;Vaduvos;DRUGELIAI;5510687497;Ne;0;5;0;5
14483;Vaduvos;DRUGELIAI;9824469881;Taip;6;2;0;8
14484;Vaduvos;DRUGELIAI;5915272436;Taip;0;2;0;2
14485;Vaduvos;DRUGELIAI;4238942070;Taip;0;3;0;3
14486;Vaduvos;DRUGELIAI;1539465611;Taip;18;0;0;18
14487;Vaduvos;DRUGELIAI;8384302877;Taip;5;0;2;7
14488;Vaduvos;DRUGELIAI;4856601924;Taip;5;3;0;8
14489;Vaduvos;DRUGELIAI;3477273224;Taip;10;1;0;11
14490;Vaduvos;DRUGELIAI;2452309232;Taip;0;6;0;6
14491;Vaduvos;DRUGELIAI;6776150749;Taip;12;3;0;15
14492;Vaduvos;DRUGELIAI;4587836073;Taip;9;3;0;12
14493;Vaduvos;DRUGELIAI;9333495119;Taip;9;1;0;10
14494;Vaduvos;DRUGELIAI;7597268115;Taip;4;3;0;7
14495;Vaduvos;DRUGELIAI;8400344609;Ne;17;0;0;17
14496;Vaduvos;RIEŠUTĖLIAI;9705185906;Taip;3;0;0;3
14497;Vaduvos;RIEŠUTĖLIAI;9167796462;Taip;4;0;3;7
14498;Vaduvos;RIEŠUTĖLIAI;5376707663;Taip;4;10;0;14
14499;Vaduvos;RIEŠUTĖLIAI;2957685586;Taip;0;2;0;2
14500;Vaduvos;RIEŠUTĖLIAI;6514406042;Taip;15;3;0;18
14501;Vaduvos;RIEŠUTĖLIAI;8188374113;Taip;0;2;6;8
14502;Vaduvos;RIEŠUTĖLIAI;6676167440;Taip;9;2;0;11
14503;Vaduvos;RIEŠUTĖLIAI;2939561403;Taip;0;6;3;9
14504;Vaduvos;RIEŠUTĖLIAI;7573756485;Taip;0;11;0;11
14505;Vaduvos;RIEŠUTĖLIAI;2835635250;Taip;0;13;0;13
14506;Vaduvos;RIEŠUTĖLIAI;6409466338;Taip;0;2;0;2
14507;Vaduvos;"1 klasė";49738318631;Taip;0;2;0;2
14508;Vaduvos;"1 klasė";1139509471;Taip;0;21;0;21
14509;Vaduvos;"1 klasė";1107557891;Ne;0;4;0;4
14510;Vaduvos;"1 klasė";8802765960;Taip;0;1;0;1
14511;Vaduvos;"1 klasė";61243200177;Taip;0;1;0;1
14512;Vaduvos;"1 klasė";65647119496;Taip;0;1;0;1
14513;Vaduvos;"1 klasė";6155494370;Ne;0;1;0;1
14514;Vaduvos;"1 klasė";70693742936;Taip;0;1;0;1
14515;Vaduvos;"1 klasė";2348627375;Taip;0;6;0;6
14516;Vaduvos;"1 klasė";1010061503;Taip;0;1;0;1
14517;Vaduvos;"1 klasė";3172047211;Taip;0;2;0;2
14518;Vaduvos;"2 klasė";97423576166;Taip;0;1;0;1
14519;Vaduvos;"2 klasė";42498568346;Taip;0;1;0;1
14520;Vaduvos;"2 klasė";38504924027;Taip;0;6;0;6
14521;Vaduvos;"2 klasė";96148085691;Taip;0;1;0;1
14522;Vaduvos;"2 klasė";12330772986;Taip;0;1;0;1
14523;Vaduvos;"2 klasė";33277362439;Ne;0;1;0;1
14524;Vaduvos;"2 klasė";32138087379;Taip;0;21;0;21
14525;Vaduvos;"2 klasė";67324784528;Taip;0;1;0;1
14526;Vaduvos;"2 klasė";4807104855;Taip;0;1;0;1
14527;Vaduvos;"2 klasė";2181614424;Taip;0;1;0;1
14528;Vaduvos;"2 klasė";2019573643;Ne;0;1;0;1
14529;Vaduvos;"2 klasė";27419094487;Taip;0;1;0;1
14530;Vaduvos;"2 klasė";41272273463;Taip;0;1;0;1
14531;Vaduvos;"2 klasė";89793734700;Taip;0;4;0;4
14532;Vaduvos;"2 klasė";17473821556;Taip;0;1;0;1
14533;Vaduvos;"2 klasė";53866301875;Ne;0;21;0;21
14534;Vaduvos;"2 klasė";7786986697;Taip;0;1;0;1
14535;Vaduvos;"2 klasė";9147332638;Taip;0;1;0;1
14536;Vaduvos;"2 klasė";1532675814;Taip;0;6;0;6
14537;Vaduvos;"2 klasė";98259624669;Taip;0;1;0;1
14538;Vaduvos;"2 klasė";36931517006;Taip;0;1;0;1
14539;Vaduvos;"2 klasė";61243424057;Taip;0;1;0;1
14540;Vaduvos;"2 klasė";30979103892;Taip;0;1;0;1
14541;Vaduvos;"2 klasė";78245732319;Taip;0;1;0;1
14542;Vaduvos;"2 klasė";97878811046;Taip;0;9;0;9
14543;Vaduvos;"2 klasė";48433447683;Taip;0;1;0;1
14544;Vaduvos;"2 klasė";85090873161;Taip;0;1;0;1
14545;Vaduvos;"3 klasė";96473212525;Taip;0;1;0;1
14546;Vaduvos;"3 klasė";75428164558;Taip;0;6;0;6
14547;Vaduvos;"3 klasė";63286903462;Taip;0;1;0;1
14548;Vaduvos;"3 klasė";13721939854;Taip;0;1;0;1
14549;Vaduvos;"3 klasė";1171210935;Taip;0;15;0;15
14550;Vaduvos;"3 klasė";7172286009;Taip;0;10;0;10
14551;Vaduvos;"3 klasė";6049882391;Ne;0;21;0;21
14552;Vaduvos;"3 klasė";38013859931;Taip;0;1;0;1
14553;Vaduvos;"3 klasė";4591744662;Taip;0;2;0;2
14554;Vaduvos;"3 klasė";9149523910;Taip;0;1;0;1
14555;Vaduvos;"3 klasė";76662161382;Taip;0;1;0;1
14556;Vaduvos;"3 klasė";26934740147;Taip;0;21;0;21
14557;Vaduvos;"3 klasė";18300713872;Taip;0;21;0;21
14558;Vaduvos;"3 klasė";768455288;Taip;0;21;0;21
14559;Vaduvos;"3 klasė";1768173501;Taip;0;8;0;8
14560;Vaduvos;"3 klasė";60531886576;Ne;0;1;0;1
14561;Vaduvos;"3 klasė";38462664426;Ne;0;9;0;9
14562;Vaduvos;"3 klasė";1821644443;Ne;0;4;0;4
14563;Vaduvos;"4 klasė";8009941823;Taip;0;1;0;1
14564;Vaduvos;"4 klasė";2423925079;Taip;0;21;0;21
14565;Vaduvos;"4 klasė";7410760461;Taip;0;2;0;2
14566;Vaduvos;"4 klasė";6487033699;Taip;0;1;0;1
14567;Vaduvos;"4 klasė";1671409152;Taip;0;2;0;2
14568;Vaduvos;"4 klasė";5072769647;Taip;0;1;0;1
14569;Vaduvos;"4 klasė";4637670260;Taip;0;1;0;1
14570;Vaduvos;"4 klasė";7236550835;Taip;0;1;0;1
14571;Vaduvos;"4 klasė";9372936408;Taip;0;1;0;1
14572;Vaduvos;"4 klasė";7243175751;Taip;0;1;0;1
14573;Vaduvos;"4 klasė";2482212122;Taip;0;2;0;2
14574;Vaduvos;"4 klasė";1982860223;Taip;0;1;0;1
14575;Vaduvos;"4 klasė";4447152355;Taip;0;3;0;3
14576;Vaduvos;"4 klasė";3325229112;Taip;0;17;0;17
14577;Vaduvos;"4 klasė";5531150399;Taip;0;21;0;21
14578;Vaduvos;"4 klasė";6980440631;Taip;0;1;0;1
14579;Vaduvos;"4 klasė";1091221509;Ne;0;6;0;6
14580;Vaduvos;"4 klasė";7614692200;Taip;0;1;0;1
14581;Vaduvos;"4 klasė";8216757208;Taip;0;2;0;2
14582;Vaduvos;"4 klasė";5459268700;Taip;0;21;0;21
14583;Vaduvos;"4 klasė";5593756016;Taip;0;1;0;1
14584;Vaduvos;"4 klasė";1642242442;Taip;0;1;0;1
14585;Vaduvos;"4 klasė";8928517238;Taip;0;1;0;1
14586;Vaduvos;"4 klasė";5099560123;Taip;0;2;0;2
14587;Vaduvos;"4 klasė";7899239147;Taip;0;1;0;1
14588;Vaduvos;"1 B klasė";40872193458;Taip;0;1;0;1
14589;Vaduvos;"1 B klasė";78931952732;Ne;0;1;0;1
14590;Vaduvos;"1 B klasė";1241148402;Taip;0;7;0;7
14591;Vaduvos;"1 B klasė";66359913774;Taip;0;8;0;8
14592;Vaduvos;"1 B klasė";64074141491;Taip;0;1;0;1
14593;Vaduvos;"1 B klasė";87671358423;Taip;0;21;0;21
14594;Vaduvos;"1 B klasė";95104294893;Taip;0;9;0;9
14595;Vaduvos;"1 B klasė";47465933557;Taip;0;1;0;1
14596;Vaduvos;"1 B klasė";16882774330;Taip;0;2;0;2
14597;Vaduvos;"1 B klasė";55138588393;Taip;0;3;0;3
14598;Vaduvos;"1 B klasė";6500567162;Taip;0;2;0;2
14599;Vaduvos;"1 B klasė";24887196729;Taip;0;2;0;2
14600;Vaduvos;"1 B klasė";93924290247;Taip;0;3;0;3
14601;Vaduvos;"1 B klasė";3259114583;Taip;0;10;0;10
14602;Vilkpėdės;BORUŽĖLĖS;6744834487;Taip;7;5;1;13
14603;Vilkpėdės;BORUŽĖLĖS;7401886306;Ne;6;0;0;6
14604;Vilkpėdės;BORUŽĖLĖS;6820236577;Taip;12;2;0;14
14605;Vilkpėdės;BORUŽĖLĖS;4255757333;Ne;10;0;0;10
14606;Vilkpėdės;BORUŽĖLĖS;5053032081;Ne;4;7;0;11
14607;Vilkpėdės;BORUŽĖLĖS;4166416292;Taip;6;3;0;9
14608;Vilkpėdės;BORUŽĖLĖS;3785308006;Taip;11;0;2;13
14609;Vilkpėdės;BORUŽĖLĖS;6283767445;Taip;0;1;0;1
14610;Vilkpėdės;BORUŽĖLĖS;9605430333;Taip;13;0;0;13
14611;Vilkpėdės;BORUŽĖLĖS;3888880306;Ne;0;8;0;8
14612;Vilkpėdės;BORUŽĖLĖS;9601934563;Taip;6;1;0;7
14613;Vilkpėdės;BORUŽĖLĖS;1571869318;Ne;0;1;0;1
14614;Vilkpėdės;BORUŽĖLĖS;1655985778;Ne;15;0;0;15
14615;Vilkpėdės;BORUŽĖLĖS;8820585407;Ne;0;0;2;2
14616;Vilkpėdės;BORUŽĖLĖS;8385974099;Ne;15;0;0;15
14617;Vilkpėdės;BORUŽĖLĖS;6778288398;Ne;4;0;1;5
14618;Vilkpėdės;BORUŽĖLĖS;7745776486;Taip;10;1;0;11
14619;Vilkpėdės;BORUŽĖLĖS;7158737372;Taip;6;0;0;6
14620;Vilkpėdės;BORUŽĖLĖS;2263955772;Ne;0;0;5;5
14621;Vilkpėdės;SKRUZDĖLIUKAI;4018140154;Ne;8;2;1;11
14622;Vilkpėdės;SKRUZDĖLIUKAI;2419661008;Ne;7;0;1;8
14623;Vilkpėdės;SKRUZDĖLIUKAI;2525399410;Ne;11;0;6;17
14624;Vilkpėdės;SKRUZDĖLIUKAI;4656475161;Ne;0;0;12;12
14625;Vilkpėdės;SKRUZDĖLIUKAI;6198736925;Ne;0;0;2;2
14626;Vilkpėdės;SKRUZDĖLIUKAI;5812430367;Ne;9;0;1;10
14627;Vilkpėdės;SKRUZDĖLIUKAI;1478022307;Ne;0;2;0;2
14628;Vilkpėdės;SKRUZDĖLIUKAI;7931496783;Ne;9;0;1;10
14629;Vilkpėdės;SKRUZDĖLIUKAI;1342167313;Ne;13;0;2;15
14630;Vilkpėdės;SKRUZDĖLIUKAI;1838974989;Ne;0;0;6;6
14631;Vilkpėdės;DRUGELIAI;2420271759;Taip;0;5;0;5
14632;Vilkpėdės;DRUGELIAI;9294350205;Taip;2;0;0;2
14633;Vilkpėdės;DRUGELIAI;7698759895;Taip;1;4;2;7
14634;Vilkpėdės;DRUGELIAI;1019057127;Ne;12;0;4;16
14635;Vilkpėdės;DRUGELIAI;1807884737;Taip;0;1;0;1
14636;Vilkpėdės;DRUGELIAI;6816745585;Taip;4;6;0;10
14637;Vilkpėdės;DRUGELIAI;9460356725;Taip;3;6;0;9
14638;Vilkpėdės;DRUGELIAI;8015392054;Taip;1;1;2;4
14639;Vilkpėdės;DRUGELIAI;2320350937;Ne;7;2;0;9
14640;Vilkpėdės;DRUGELIAI;7894766629;Taip;5;11;0;16
14641;Vilkpėdės;DRUGELIAI;9795696242;Taip;4;1;2;7
14642;Vilkpėdės;DRUGELIAI;8581661608;Taip;0;1;0;1
14643;Vilkpėdės;DRUGELIAI;6261547304;Ne;0;6;0;6
14644;Vilkpėdės;DRUGELIAI;4095366279;Taip;7;1;0;8
14645;Vilkpėdės;DRUGELIAI;8128254701;Ne;10;1;0;11
14646;Vilkpėdės;DRUGELIAI;7747013579;Taip;2;1;0;3
14647;Vilkpėdės;DRUGELIAI;7908813288;Ne;7;0;0;7
14648;Vilkpėdės;DRUGELIAI;2251274741;Ne;6;0;0;6
14649;Vilkpėdės;DRUGELIAI;6522707709;Ne;0;3;0;3
14650;Vilkpėdės;DRUGELIAI;1217929358;Taip;6;0;1;7
14651;Vilkpėdės;DRUGELIAI;1063561954;Ne;0;0;2;2
14652;Vilkpėdės;DRUGELIAI;7010024061;Ne;0;1;0;1
14653;Vilkpėdės;ŽIOGELIAI;1267187553;Taip;3;0;0;3
14654;Vilkpėdės;ŽIOGELIAI;5551822633;Taip;16;0;1;17
14655;Vilkpėdės;ŽIOGELIAI;9544418642;Taip;0;0;2;2
14656;Vilkpėdės;ŽIOGELIAI;1063740772;Taip;0;1;0;1
14657;Vilkpėdės;ŽIOGELIAI;3666145718;Taip;0;2;1;3
14658;Vilkpėdės;ŽIOGELIAI;5633014328;Taip;9;0;0;9
14659;Vilkpėdės;ŽIOGELIAI;5422061533;Taip;4;13;0;17
14660;Vilkpėdės;ŽIOGELIAI;4311938034;Taip;0;1;0;1
14661;Vilkpėdės;ŽIOGELIAI;5346798201;Taip;0;2;1;3
14662;Vilkpėdės;ŽIOGELIAI;5340239466;Taip;5;0;0;5
14663;Vilkpėdės;ŽIOGELIAI;3720639726;Taip;0;0;1;1
14664;Vilkpėdės;ŽIOGELIAI;5274855225;Ne;13;0;0;13
14665;Vilkpėdės;ŽIOGELIAI;5334238235;Ne;8;0;0;8
14666;Vilkpėdės;ŽIOGELIAI;3350784810;Taip;7;0;0;7
14667;Vilkpėdės;BITUTĖS;6418829930;Taip;0;3;0;3
14668;Vilkpėdės;BITUTĖS;1633942236;Taip;0;3;0;3
14669;Vilkpėdės;BITUTĖS;8484873068;Taip;12;0;0;12
14670;Vilkpėdės;BITUTĖS;9570469277;Taip;5;0;0;5
14671;Vilkpėdės;BITUTĖS;8613778606;Ne;0;5;0;5
14672;Vilkpėdės;BITUTĖS;7991758361;Taip;10;0;0;10
14673;Vilkpėdės;BITUTĖS;6064336759;Taip;10;0;0;10
14674;Vilkpėdės;BITUTĖS;5577199802;Taip;12;0;0;12
14675;Vilkpėdės;BITUTĖS;8930504912;Ne;0;0;3;3
14676;Vilkpėdės;BITUTĖS;5972405023;Taip;11;0;0;11
14677;Vilkpėdės;BITUTĖS;4485811377;Ne;0;8;0;8
14678;Vilkpėdės;"2 klasė";14499651046;Ne;2;1;0;3
14679;Vilkpėdės;"2 klasė";90217345315;Taip;0;1;0;1
14680;Vilkpėdės;"2 klasė";51286525404;Taip;0;1;0;1
14681;Vilkpėdės;"2 klasė";49513181091;Taip;2;1;0;3
14682;Vilkpėdės;"2 klasė";1032216128;Taip;5;3;0;8
14683;Vilkpėdės;"2 klasė";37450374921;Taip;0;1;0;1
14684;Vilkpėdės;"2 klasė";36704555745;Taip;0;3;0;3
14685;Vilkpėdės;"2 klasė";66356984763;Taip;0;2;0;2
14686;Vilkpėdės;"2 klasė";88279045901;Taip;0;2;0;2
14687;Vilkpėdės;"2 klasė";66451097025;Taip;5;1;0;6
14688;Vilkpėdės;"2 klasė";2806307083;Taip;2;3;0;5
14689;Vilkpėdės;"2 klasė";51799865091;Taip;0;1;0;1
14690;Vilkpėdės;"2 klasė";79269485254;Taip;0;2;0;2
14691;Vilkpėdės;"2 klasė";61833757576;Taip;0;1;0;1
14692;Vilkpėdės;"2 klasė";64216245300;Taip;4;1;0;5
14693;Vilkpėdės;GUDRUČIAI;1527272055;Ne;0;0;2;2
14694;Vilkpėdės;GUDRUČIAI;1451102218;Taip;0;2;0;2
14695;Vilkpėdės;GUDRUČIAI;2065010940;Taip;0;4;0;4
14696;Vilkpėdės;GUDRUČIAI;4515945951;Taip;0;0;5;5
14697;Vilkpėdės;GUDRUČIAI;2736368118;Taip;16;0;0;16
14698;Vilkpėdės;GUDRUČIAI;7527929277;Taip;0;1;1;2
14699;Vilkpėdės;GUDRUČIAI;46561435465;Ne;0;4;0;4
14700;Vilkpėdės;GUDRUČIAI;48059844727;Ne;0;2;0;2
14701;Vilkpėdės;GUDRUČIAI;8304500877;Ne;0;0;1;1
14702;Vilkpėdės;GUDRUČIAI;2955411131;Taip;0;7;0;7
14703;Vilkpėdės;GUDRUČIAI;9867411687;Taip;0;2;0;2
14704;Vilkpėdės;GUDRUČIAI;2900581406;Ne;0;13;0;13
14705;Vilkpėdės;GUDRUČIAI;3987021185;Taip;10;0;0;10
14706;Vilkpėdės;GUDRUČIAI;7875898177;Taip;0;1;0;1
14707;Vilkpėdės;GUDRUČIAI;1195392132;Taip;0;1;0;1
14708;Vilkpėdės;GUDRUČIAI;9605399822;Taip;4;3;0;7
14709;Vilkpėdės;GUDRUČIAI;7634355147;Taip;0;1;0;1
14710;Vilkpėdės;GUDRUČIAI;4276158771;Taip;8;1;0;9
14711;Vilkpėdės;SMALSUČIAI;13241568469;Taip;0;1;0;1
14712;Vilkpėdės;SMALSUČIAI;1052719398;Taip;3;3;0;6
14713;Vilkpėdės;SMALSUČIAI;1145968615;Ne;3;1;0;4
14714;Vilkpėdės;SMALSUČIAI;55747681017;Taip;4;0;0;4
14715;Vilkpėdės;SMALSUČIAI;1136036746;Taip;0;4;0;4
14716;Vilkpėdės;SMALSUČIAI;51976067616;Ne;0;2;0;2
14717;Vilkpėdės;SMALSUČIAI;73470824566;Taip;0;5;0;5
14718;Vilkpėdės;SMALSUČIAI;5912919726;Taip;0;1;0;1
14719;Vilkpėdės;SMALSUČIAI;40385792431;Ne;0;17;0;17
14720;Vilkpėdės;SMALSUČIAI;72227817278;Ne;7;1;0;8
14721;Vilkpėdės;SMALSUČIAI;1795879331;Taip;0;1;0;1
14722;Vilkpėdės;SMALSUČIAI;2000428715;Taip;0;6;0;6
14723;Vilkpėdės;SMALSUČIAI;1042000830;Taip;0;1;0;1
14724;Vilkpėdės;SMALSUČIAI;1384224802;Taip;0;1;0;1
14725;Vilkpėdės;SMALSUČIAI;9393571483;Taip;5;8;0;13
14726;Vilkpėdės;SMALSUČIAI;1328830555;Ne;2;2;0;4
14727;Vilkpėdės;SMALSUČIAI;9613791189;Taip;10;0;0;10
14728;Vilkpėdės;SMALSUČIAI;2580491126;Taip;0;1;0;1
14729;Vilkpėdės;SMALSUČIAI;1961069495;Ne;1;2;0;3
14730;Žiburėlis;Nykštukai;6696156248;Taip;0;1;0;1
14731;Žiburėlis;Nykštukai;7163594513;Taip;0;1;0;1
14732;Žiburėlis;Nykštukai;5174211773;Taip;11;0;0;11
14733;Žiburėlis;Nykštukai;5408766721;Ne;6;0;0;6
14734;Žiburėlis;Nykštukai;3646988912;Taip;0;4;0;4
14735;Žiburėlis;Nykštukai;7211961512;Ne;4;0;0;4
14736;Žiburėlis;Nykštukai;7862546963;Taip;5;0;0;5
14737;Žiburėlis;Nykštukai;8902837168;Taip;5;1;0;6
14738;Žiburėlis;Nykštukai;7465939429;Taip;2;7;0;9
14739;Žiburėlis;Nykštukai;7307386173;Taip;3;0;0;3
14740;Žiburėlis;Nykštukai;4710995351;Taip;5;0;0;5
14741;Žiburėlis;Nykštukai;7633450988;Taip;1;0;0;1
14742;Žiburėlis;Nykštukai;2292895729;Taip;4;0;0;4
14743;Žiburėlis;Nykštukai;9806454408;Ne;0;1;0;1
14744;Žiburėlis;Nykštukai;2741301903;Ne;0;1;0;1
14745;Žiburėlis;Nykštukai;3938379566;Taip;2;1;0;3
14746;Žiburėlis;Nykštukai;9932264675;Ne;11;0;0;11
14747;Žiburėlis;Nykštukai;2253167147;Taip;17;0;0;17
14748;Žiburėlis;"Žiniukai ";5816890413;Taip;0;3;0;3
14749;Žiburėlis;"Žiniukai ";2928528630;Taip;5;1;0;6
14750;Žiburėlis;"Žiniukai ";2624326930;Taip;0;9;0;9
14751;Žiburėlis;"Žiniukai ";6300247811;Taip;5;0;0;5
14752;Žiburėlis;"Žiniukai ";3033049328;Ne;0;2;0;2
14753;Žiburėlis;"Žiniukai ";5303511810;Taip;6;1;0;7
14754;Žiburėlis;"Žiniukai ";3262856058;Ne;6;2;0;8
14755;Žiburėlis;"Žiniukai ";1720078356;Taip;2;1;0;3
14756;Žiburėlis;"Žiniukai ";2982016133;Taip;0;7;0;7
14757;Žiburėlis;"Žiniukai ";7424129974;Ne;6;0;0;6
14758;Žiburėlis;"Žiniukai ";8109335587;Taip;8;1;0;9
14759;Žiburėlis;"Žiniukai ";4187381976;Taip;21;0;0;21
14760;Žiburėlis;"Žiniukai ";1876645582;Taip;0;1;0;1
14761;Žiburėlis;"Žiniukai ";5006361324;Taip;5;0;0;5
14762;Žiburėlis;"Žiniukai ";2956339420;Taip;8;1;0;9
14763;Žiburėlis;"Žiniukai ";7070952018;Taip;7;1;0;8
14764;Žiburėlis;"Žiniukai ";8438876806;Taip;7;0;0;7
14765;Žiburėlis;"Žiniukai ";3687703187;Taip;0;1;0;1
14766;Žiburėlis;"Žiniukai ";8535429783;Ne;3;0;0;3
14767;Žiburėlis;"Smalsiukai ";6190642132;Taip;0;2;0;2
14768;Žiburėlis;"Smalsiukai ";2009050470;Ne;5;2;0;7
14769;Žiburėlis;"Smalsiukai ";57749440744;Taip;0;2;1;3
14770;Žiburėlis;"Smalsiukai ";808556747;Taip;0;4;0;4
14771;Žiburėlis;"Smalsiukai ";1612968712;Taip;0;1;0;1
14772;Žiburėlis;"Smalsiukai ";46449810717;Taip;0;1;0;1
14773;Žiburėlis;"Smalsiukai ";9069606713;Ne;0;1;0;1
14774;Žiburėlis;"Smalsiukai ";1106875762;Taip;10;0;0;10
14775;Žiburėlis;"Giliukai ";52216192635;Taip;7;2;0;9
14776;Žiburėlis;"Giliukai ";4355778076;Taip;6;1;0;7
14777;Žiburėlis;"Giliukai ";92490398630;Ne;0;4;0;4
14778;Žiburėlis;"Giliukai ";67168630669;Taip;0;1;0;1
14779;Žiburėlis;"Giliukai ";3867540155;Taip;0;0;3;3
14780;Žiburėlis;"Giliukai ";75538036055;Taip;0;2;0;2
14781;Žiburėlis;"Giliukai ";9253393819;Taip;4;0;1;5
14782;Žiburėlis;"Giliukai ";2796489509;Taip;0;1;0;1
14783;Žiburėlis;"Giliukai ";18739941845;Taip;0;2;0;2
14784;Žiburėlis;"Giliukai ";24639355056;Taip;11;0;0;11
14785;Žiburėlis;"Giliukai ";1842029645;Taip;9;0;0;9
14786;Žiburėlis;"Giliukai ";6519139977;Taip;13;5;0;18
14787;Žiburėlis;"Giliukai ";7861704875;Ne;0;10;0;10
14788;Žiburėlis;"Giliukai ";34873231652;Taip;3;1;0;4
14789;Žiburėlis;"Giliukai ";1125662904;Taip;11;0;0;11
14790;Žiburėlis;"Giliukai ";2175751377;Taip;7;0;0;7
14791;Žiburėlis;"Giliukai ";8531121002;Taip;8;2;0;10
14792;Žiburėlis;"Giliukai ";28985997205;Taip;3;4;0;7
14793;Žiburėlis;"Giliukai ";1599112927;Taip;0;3;0;3
14794;Žiburėlis;Meškiukai;4720567144;Taip;5;0;0;5
14795;Žiburėlis;Meškiukai;8936912406;Taip;6;0;1;7
14796;Žiburėlis;Meškiukai;5205959106;Taip;0;0;1;1
14797;Žiburėlis;Viščiukai;2077823704;Taip;5;0;0;5
14798;Žiburėlis;Viščiukai;5148264064;Taip;2;0;0;2
14799;Žiburėlis;Viščiukai;1090883494;Taip;5;0;0;5
14800;Žiburėlis;Viščiukai;9215654134;Taip;6;1;0;7
14801;Žiburėlis;Viščiukai;4656467260;Taip;5;0;0;5
14802;Žiburėlis;"Drambliukai ";6232492947;Taip;1;1;0;2
14803;Žiburėlis;"Drambliukai ";3807588865;Taip;5;0;0;5
14804;Žiburėlis;"Drambliukai ";4432542988;Taip;8;1;0;9
14805;Žiburėlis;"Drambliukai ";2990465012;Taip;5;0;0;5
14806;Žiburėlis;"Drambliukai ";4783894465;Taip;3;0;0;3
14807;Žiburėlis;"Drambliukai ";9494271740;Taip;0;1;1;2
14808;Žiburėlis;"Drambliukai ";3992503848;Taip;11;0;0;11
14809;Žiburėlis;"NAUJA DARŽELIS 7";7402647048;Taip;5;0;0;5
14810;Žiburėlis;"NAUJA DARŽELIS 7";6830200578;Ne;8;1;0;9
14811;Žiburėlis;"NAUJA DARŽELIS 7";5098955523;Taip;6;2;0;8
14812;Žiburėlis;"NAUJA DARŽELIS 7";5629404179;Taip;11;1;0;12
14813;Žiburėlis;"NAUJA DARŽELIS 7";8686565770;Taip;0;3;0;3
14814;Žiburėlis;"NAUJA DARŽELIS 7";8973307069;Taip;13;1;0;14
14815;Žiburėlis;"NAUJA DARŽELIS 7";6647598068;Taip;21;0;0;21
14816;Žiburėlis;"NAUJA DARŽELIS 7";6802308420;Taip;5;3;0;8
14817;Žiburėlis;"NAUJA DARŽELIS 7";5438697081;Taip;0;1;0;1
14818;Žiburėlis;"NAUJA DARŽELIS 7";1126972447;Taip;0;6;0;6
14819;Žiburėlis;"NAUJA DARŽELIS 7";8480167191;Ne;0;6;0;6
14820;Žiburėlis;"NAUJA DARŽELIS 7";5114554577;Taip;5;1;0;6
14821;Žiburėlis;"NAUJA DARŽELIS 6";4109288891;Taip;6;0;1;7
14822;Žiburėlis;"NAUJA DARŽELIS 6";4387021429;Taip;0;6;0;6
14823;Žiburėlis;"NAUJA DARŽELIS 6";5002691930;Taip;4;0;0;4
14824;Žiburėlis;"NAUJA DARŽELIS 6";8133371774;Taip;0;20;1;21
14825;Žiburėlis;"NAUJA DARŽELIS 6";8970153523;Taip;6;0;1;7
14826;Žiburėlis;"NAUJA DARŽELIS 6";1015624216;Ne;0;6;0;6
14827;Žiburėlis;"NAUJA DARŽELIS 6";4468637202;Taip;7;1;1;9
14828;Žiburėlis;"NAUJA DARŽELIS 6";4910787530;Taip;0;17;0;17
14829;Žiburėlis;"NAUJA DARŽELIS 6";5324852807;Ne;0;0;1;1
14830;Žiburėlis;"NAUJA DARŽELIS 6";7278242428;Taip;2;0;1;3
14831;Žiburėlis;"NAUJA DARŽELIS 6";8928649700;Taip;0;6;3;9
14832;Žiburėlis;"NAUJA DARŽELIS 6";1190058462;Ne;0;11;1;12
14833;Žiburėlis;"NAUJA DARŽELIS 6";5732540560;Ne;0;10;0;10
14834;Žiburėlis;"NAUJA DARŽELIS 6";1228806324;Ne;0;1;0;1
14835;Žiburėlis;"NAUJA DARŽELIS 6";2163018032;Ne;10;0;3;13
14836;Žiburėlis;"NAUJA DARŽELIS 6";2491972986;Taip;0;12;0;12
14837;Žiburėlis;"NAUJA DARŽELIS 6";8018718405;Taip;5;3;0;8
14838;Žiburėlis;"NAUJA DARŽELIS 6";3370588608;Taip;0;0;3;3
14839;Aidas;Boružėlių;2027860670;Ne;4;1;0;5
14840;Aidas;Boružėlių;8915901727;Taip;6;1;0;7
14841;Aidas;Boružėlių;5311183877;Taip;4;4;0;8
14842;Aidas;Boružėlių;5962551687;Taip;4;1;0;5
14843;Aidas;Boružėlių;1538635985;Taip;11;6;0;17
14844;Aidas;Boružėlių;1196172221;Ne;5;2;0;7
14845;Aidas;Boružėlių;7122041826;Taip;5;4;0;9
14846;Aidas;Drugelių;3237698420;Taip;0;1;0;1
14847;Aidas;Drugelių;7094228848;Ne;0;10;0;10
14848;Aidas;Drugelių;5560434420;Ne;0;10;0;10
14849;Aidas;Drugelių;2070454339;Ne;0;6;0;6
14850;Aidas;Drugelių;3465024013;Ne;5;2;0;7
14851;Aidas;Drugelių;6810906239;Ne;5;2;0;7
14852;Aidas;Drugelių;1675384533;Ne;20;0;0;20
14853;Aidas;Drugelių;4544126354;Ne;5;2;0;7
14854;Aidas;"V-VIII A jungtinė lavinamoji klasė";62142659591;Taip;0;5;0;5
14855;Aidas;"V-VIII A jungtinė lavinamoji klasė";88721781220;Ne;2;1;0;3
14856;Aidas;"V-VIII A jungtinė lavinamoji klasė";7013192521;Ne;0;1;0;1
14857;Aidas;"V-VIII A jungtinė lavinamoji klasė";6356218442;Ne;5;0;0;5
14858;Aidas;"II-IV A jungtinė lavinamoji klasė";1535004699;Ne;0;13;0;13
14859;Aidas;"II-IV B jungtinė lavinamoji klasė";1079077463;Taip;0;3;0;3
14860;Aidas;"II-IV B jungtinė lavinamoji klasė";17920063762;Taip;0;1;0;1
14861;Aidas;"II-IV B jungtinė lavinamoji klasė";7329254454;Taip;0;1;0;1
14862;Aidas;"II-IV B jungtinė lavinamoji klasė";72751441075;Taip;0;11;0;11
14863;Aidas;"II-IV B jungtinė lavinamoji klasė";9816043688;Ne;0;1;0;1
14864;Aidas;"II-IV B jungtinė lavinamoji klasė";3194974747;Taip;0;1;0;1
14865;Aidas;"II-IV B jungtinė lavinamoji klasė";2000234311;Taip;0;1;0;1
14866;Aidas;"II-IV B jungtinė lavinamoji klasė";63508565206;Ne;0;3;0;3
14867;Aidas;"V-IX oji jungtinė lavinamoji klasė";2501187241;Ne;0;1;0;1
14868;Aidas;"V-IX oji jungtinė lavinamoji klasė";6213577188;Ne;10;2;0;12
14869;Aidas;"V-IX oji jungtinė lavinamoji klasė";81654551230;Taip;0;10;0;10
14870;Aidas;"V-IX oji jungtinė lavinamoji klasė";20604410476;Ne;0;1;0;1
14871;Aidas;"V-IX oji jungtinė lavinamoji klasė";92425322676;Ne;0;5;0;5
14872;Aidas;"I-II oji jungtinė lavinamoji klasė";1505697405;Ne;0;1;0;1
14873;Aidas;"I-II oji jungtinė lavinamoji klasė";3366848846;Taip;4;4;0;8
14874;Aidas;"I-II oji jungtinė lavinamoji klasė";1999375828;Taip;2;11;0;13
14875;Aidas;"I-II oji jungtinė lavinamoji klasė";3748420427;Taip;5;1;0;6
14876;Aidas;"V-VIII B jungtinė lavinamoji klasė";7740504510;Ne;0;1;0;1
14877;Aidas;"V-VIII B jungtinė lavinamoji klasė";74897451962;Taip;0;1;0;1
14878;Aidas;"V-VIII B jungtinė lavinamoji klasė";9057435844;Ne;0;1;0;1
14879;Aidas;"V-VIII B jungtinė lavinamoji klasė";6868265902;Taip;0;21;0;21
14880;Aidas;"V-VIII B jungtinė lavinamoji klasė";2234931428;Ne;0;21;0;21
14881;Aidas;"V-VIII B jungtinė lavinamoji klasė";7354905114;Ne;0;1;0;1
14882;Aidas;"I metų socialinių įgūdžių ugdymo klasė";8642665550;Ne;21;0;0;21
14883;Aidas;"I metų socialinių įgūdžių ugdymo klasė";5309862220;Taip;0;21;0;21
14884;Aidas;"VI-X oji jungtinė lavinamoji klasė";4372628947;Ne;0;3;0;3
14885;Aidas;"VI-X oji jungtinė lavinamoji klasė";9944901942;Ne;0;2;0;2
14886;Aidas;"VI-X oji jungtinė lavinamoji klasė";5570772793;Taip;0;1;0;1
14887;Aidas;"VI-X oji jungtinė lavinamoji klasė";2681438925;Ne;4;0;0;4
14888;Aidas;"VI-X oji jungtinė lavinamoji klasė";3442250711;Ne;0;1;0;1
14889;Aidas;"II-III metų socialinių įgūdžių ugdymo klasė";2970002617;Taip;0;21;0;21
14890;Aidas;"II-III metų socialinių įgūdžių ugdymo klasė";8377829773;Ne;0;1;0;1
14891;Gėlynas;PAKALNUTĖ;5145396320;Ne;0;0;5;5
14892;Gėlynas;PAKALNUTĖ;2349352560;Ne;0;0;2;2
14893;Gėlynas;PAKALNUTĖ;4445250490;Taip;0;2;0;2
14894;Gėlynas;PAKALNUTĖ;9911225363;Ne;0;0;4;4
14895;Gėlynas;PAKALNUTĖ;2400929266;Taip;0;0;1;1
14896;Gėlynas;PAKALNUTĖ;6898127005;Ne;0;5;0;5
14897;Gėlynas;PAKALNUTĖ;2906909558;Taip;0;8;1;9
14898;Gėlynas;PAKALNUTĖ;3365442661;Taip;0;0;5;5
14899;Gėlynas;PAKALNUTĖ;77283628988;Taip;4;6;0;10
14900;Gėlynas;PAKALNUTĖ;6528464599;Taip;0;0;4;4
14901;Gėlynas;PAKALNUTĖ;8464074679;Taip;0;0;1;1
14902;Gėlynas;PAKALNUTĖ;5395474698;Ne;3;2;0;5
14903;Gėlynas;PAKALNUTĖ;90046802421;Taip;0;0;3;3
14904;Gėlynas;PAKALNUTĖ;8615943743;Ne;4;0;0;4
14905;Gėlynas;PAKALNUTĖ;7814357385;Taip;0;2;0;2
14906;Gėlynas;PAKALNUTĖ;1674569569;Taip;0;8;0;8
14907;Gėlynas;PAKALNUTĖ;5695333666;Ne;0;5;0;5
14908;Gėlynas;PAKALNUTĖ;3890687425;Taip;7;0;0;7
14909;Gėlynas;VARPELIS;1406567756;Ne;0;1;0;1
14910;Gėlynas;VARPELIS;58542813068;Taip;0;0;1;1
14911;Gėlynas;VARPELIS;2100188574;Taip;0;3;0;3
14912;Gėlynas;VARPELIS;8896526358;Taip;0;0;2;2
14913;Gėlynas;VARPELIS;8324564359;Ne;0;3;0;3
14914;Gėlynas;VARPELIS;1608626732;Taip;11;3;0;14
14915;Gėlynas;VARPELIS;1676904275;Ne;0;5;0;5
14916;Gėlynas;VARPELIS;86881175896;Taip;0;3;0;3
14917;Gėlynas;VARPELIS;1363040744;Taip;0;0;1;1
14918;Gėlynas;VARPELIS;1053422007;Ne;0;0;1;1
14919;Gėlynas;VARPELIS;44391516295;Taip;3;0;1;4
14920;Gėlynas;VARPELIS;2099722437;Taip;0;1;0;1
14921;Gėlynas;VARPELIS;2018911523;Taip;0;0;19;19
14922;Gėlynas;VARPELIS;1407350449;Taip;0;0;1;1
14923;Gėlynas;VARPELIS;47220216751;Ne;0;4;0;4
14924;Gėlynas;VARPELIS;85310323038;Ne;0;8;0;8
14925;Gėlynas;VARPELIS;1797681067;Ne;0;1;0;1
14926;Gėlynas;VARPELIS;1117528954;Taip;0;3;0;3
14927;Gėlynas;VARPELIS;57429063547;Ne;0;5;0;5
14928;Gėlynas;RAKTAŽOLĖ;6264361257;Ne;0;2;0;2
14929;Gėlynas;RAKTAŽOLĖ;1754734306;Ne;0;3;0;3
14930;Gėlynas;RAKTAŽOLĖ;84546885977;Ne;0;5;0;5
14931;Gėlynas;RAKTAŽOLĖ;5135747448;Taip;0;0;1;1
14932;Gėlynas;RAKTAŽOLĖ;7808971151;Ne;0;6;0;6
14933;Gėlynas;RAKTAŽOLĖ;1774829898;Ne;0;2;0;2
14934;Gėlynas;RAKTAŽOLĖ;7337987259;Taip;0;3;0;3
14935;Gėlynas;RAKTAŽOLĖ;9026298982;Ne;7;2;0;9
14936;Gėlynas;RAKTAŽOLĖ;4382465307;Taip;10;2;0;12
14937;Gėlynas;RAKTAŽOLĖ;7562201835;Taip;0;1;0;1
14938;Gėlynas;RAKTAŽOLĖ;1557503831;Taip;2;0;1;3
14939;Gėlynas;RAKTAŽOLĖ;5634213306;Taip;0;0;1;1
14940;Gėlynas;RAKTAŽOLĖ;3491517766;Ne;0;4;0;4
14941;Gėlynas;RAKTAŽOLĖ;4505012978;Taip;0;3;0;3
14942;Gėlynas;RAKTAŽOLĖ;5124029118;Taip;6;0;0;6
14943;Gėlynas;RAKTAŽOLĖ;9508507084;Taip;0;3;0;3
14944;Gėlynas;RAKTAŽOLĖ;8999346908;Taip;5;5;0;10
14945;Gėlynas;RAKTAŽOLĖ;1004866224;Ne;0;0;1;1
14946;Gėlynas;RAKTAŽOLĖ;8458276300;Ne;0;7;0;7
14947;Gėlynas;SAULĖGRĄŽA;7150367866;Ne;0;0;2;2
14948;Gėlynas;SAULĖGRĄŽA;5898582218;Taip;4;0;0;4
14949;Gėlynas;SAULĖGRĄŽA;1505666690;Taip;0;0;2;2
14950;Gėlynas;SAULĖGRĄŽA;3492361041;Taip;5;0;0;5
14951;Gėlynas;SAULĖGRĄŽA;6451922757;Ne;0;0;1;1
14952;Gėlynas;SAULĖGRĄŽA;2141722631;Taip;7;6;0;13
14953;Gėlynas;SAULĖGRĄŽA;2742456983;Ne;4;0;1;5
14954;Gėlynas;SAULĖGRĄŽA;4983822000;Ne;0;0;1;1
14955;Gėlynas;SAULĖGRĄŽA;3549079170;Ne;8;0;2;10
14956;Gėlynas;SAULĖGRĄŽA;9305282699;Taip;7;5;0;12
14957;Gėlynas;SAULĖGRĄŽA;6815740588;Ne;6;0;2;8
14958;Gėlynas;SAULĖGRĄŽA;3606076029;Ne;0;15;0;15
14959;Gėlynas;SAULĖGRĄŽA;5964419627;Taip;5;0;2;7
14960;Gėlynas;SAULĖGRĄŽA;9724668402;Taip;0;2;0;2
14961;Gėlynas;SAULĖGRĄŽA;9462822190;Ne;0;7;0;7
14962;Gėlynas;SAULĖGRĄŽA;6114995335;Taip;6;0;4;10
14963;Gėlynas;SAULĖGRĄŽA;5320531856;Taip;0;0;2;2
14964;Gėlynas;SAULĖGRĄŽA;7998013477;Ne;5;0;1;6
14965;Gėlynas;RAMUNĖLĖ;7605002899;Taip;0;0;3;3
14966;Gėlynas;RAMUNĖLĖ;5751256561;Taip;5;0;0;5
14967;Gėlynas;RAMUNĖLĖ;6053841081;Ne;0;5;0;5
14968;Gėlynas;RAMUNĖLĖ;1590299264;Taip;5;4;0;9
14969;Gėlynas;RAMUNĖLĖ;3470963396;Taip;0;5;0;5
14970;Gėlynas;RAMUNĖLĖ;1548317086;Taip;0;0;3;3
14971;Gėlynas;RAMUNĖLĖ;4557380282;Taip;0;0;1;1
14972;Gėlynas;RAMUNĖLĖ;9707677931;Taip;6;0;1;7
14973;Gėlynas;RAMUNĖLĖ;2171064300;Ne;6;0;1;7
14974;Gėlynas;RAMUNĖLĖ;2404562144;Taip;0;1;0;1
14975;Gėlynas;RAMUNĖLĖ;7064068912;Taip;15;0;2;17
14976;Gėlynas;RAMUNĖLĖ;6884111634;Taip;3;0;0;3
14977;Gėlynas;ŽIBUTĖ;1015554617;Taip;8;0;0;8
14978;Gėlynas;ŽIBUTĖ;2377323648;Taip;6;0;0;6
14979;Gėlynas;ŽIBUTĖ;1822933936;Taip;6;1;0;7
14980;Gėlynas;ŽIBUTĖ;8444505017;Ne;2;5;0;7
14981;Gėlynas;ŽIBUTĖ;9252696260;Taip;0;1;0;1
14982;Gėlynas;ŽIBUTĖ;4075611307;Taip;0;0;1;1
14983;Gėlynas;ŽIBUTĖ;5350834071;Taip;2;0;2;4
14984;Gėlynas;ŽIBUTĖ;6296728638;Taip;5;1;0;6
14985;Gėlynas;ŽIBUTĖ;5382148888;Taip;10;0;0;10
14986;Gėlynas;ŽIBUTĖ;4668195919;Taip;0;2;0;2
14987;Gėlynas;ŽIBUTĖ;6875794958;Taip;0;2;0;2
14988;Gėlynas;ŽIBUTĖ;8555408466;Taip;5;0;2;7
14989;Gėlynas;ŽIBUTĖ;8080660097;Ne;0;5;0;5
14990;Gėlynas;ŽIBUTĖ;2493398224;Ne;7;8;0;15
14991;Obelėlė;Gudručiai;2014314139;Taip;5;0;0;5
14992;Obelėlė;Gudručiai;9900484892;Taip;0;10;1;11
14993;Obelėlė;Gudručiai;9586720282;Taip;4;0;2;6
14994;Obelėlė;Gudručiai;4015702815;Ne;7;0;0;7
14995;Obelėlė;Gudručiai;5141585309;Taip;0;0;1;1
14996;Obelėlė;Gudručiai;9736557012;Taip;5;0;6;11
14997;Obelėlė;Gudručiai;2053807216;Taip;3;0;0;3
14998;Obelėlė;Gudručiai;1184082097;Taip;5;0;2;7
14999;Obelėlė;Gudručiai;6466755394;Taip;0;12;0;12
15000;Obelėlė;Gudručiai;2533715287;Taip;0;8;0;8
15001;Obelėlė;Gudručiai;1312484983;Taip;10;0;3;13
15002;Obelėlė;Gudručiai;1598785483;Taip;0;1;0;1
15003;Obelėlė;Gudručiai;6361228838;Taip;0;0;2;2
15004;Obelėlė;Drugeliai;5960204860;Taip;19;0;0;19
15005;Obelėlė;Drugeliai;1874574001;Taip;6;4;0;10
15006;Obelėlė;Drugeliai;1271351257;Taip;11;0;1;12
15007;Obelėlė;Drugeliai;1980250599;Taip;0;0;3;3
15008;Obelėlė;Drugeliai;4111486929;Taip;16;0;0;16
15009;Obelėlė;Drugeliai;8115772385;Taip;4;0;3;7
15010;Obelėlė;Drugeliai;2018689468;Taip;0;0;1;1
15011;Obelėlė;Drugeliai;7120041402;Taip;3;0;0;3
15012;Obelėlė;Drugeliai;9059791812;Taip;0;4;0;4
15013;Obelėlė;Drugeliai;4835765774;Taip;0;0;4;4
15014;Obelėlė;Drugeliai;1044733634;Taip;0;0;2;2
15015;Obelėlė;Drugeliai;1847501295;Taip;21;0;0;21
15016;Obelėlė;Drugeliai;6676145522;Taip;0;0;1;1
15017;Obelėlė;Drugeliai;6693601673;Taip;0;1;0;1
15018;Obelėlė;Drugeliai;1061262980;Taip;0;0;1;1
15019;Obelėlė;Pasakaitė;1695933896;Taip;5;0;1;6
15020;Obelėlė;Pasakaitė;1833543299;Taip;0;0;1;1
15021;Obelėlė;Pasakaitė;1555780072;Taip;6;0;2;8
15022;Obelėlė;Pasakaitė;77743243622;Taip;0;0;1;1
15023;Obelėlė;Pasakaitė;1543298097;Taip;6;0;0;6
15024;Obelėlė;Pasakaitė;79601449969;Ne;12;0;0;12
15025;Obelėlė;Pasakaitė;3330983614;Taip;0;0;1;1
15026;Obelėlė;Pasakaitė;4257479486;Ne;0;0;3;3
15027;Obelėlė;Pasakaitė;9527363918;Taip;0;5;0;5
15028;Obelėlė;Pasakaitė;10939948244;Taip;0;5;0;5
15029;Obelėlė;Pasakaitė;1707652145;Taip;0;0;2;2
15030;Obelėlė;Pasakaitė;6789881144;Taip;0;0;1;1
15031;Obelėlė;Pasakaitė;6253266504;Taip;0;0;1;1
15032;Obelėlė;Pasakaitė;9934596750;Taip;0;0;1;1
15033;Obelėlė;Pasakaitė;6036130112;Taip;0;4;2;6
15034;Obelėlė;Pasakaitė;7754276632;Taip;0;21;0;21
15035;Obelėlė;Svajokliai;4849499826;Taip;17;0;0;17
15036;Obelėlė;Svajokliai;1469593267;Taip;7;0;1;8
15037;Obelėlė;Svajokliai;9819048265;Taip;14;3;0;17
15038;Obelėlė;Svajokliai;1010954005;Taip;14;0;1;15
15039;Obelėlė;Svajokliai;4489212434;Taip;15;0;2;17
15040;Obelėlė;Svajokliai;6325027163;Taip;0;0;2;2
15041;Obelėlė;Svajokliai;5312394513;Taip;5;0;2;7
15042;Obelėlė;Svajokliai;5620250331;Taip;4;0;1;5
15043;Obelėlė;Svajokliai;1705232474;Taip;0;0;1;1
15044;Obelėlė;Svajokliai;5588467580;Taip;5;0;14;19
15045;Obelėlė;Svajokliai;7094715237;Taip;0;0;1;1
15046;Obelėlė;Svajokliai;9070960601;Taip;0;0;1;1
15047;Obelėlė;Svajokliai;8231489868;Taip;15;0;0;15
15048;Obelėlė;Svajokliai;7003947655;Taip;6;3;1;10
15049;Obelėlė;Svajokliai;8918176312;Taip;0;0;2;2
15050;Obelėlė;Svajokliai;8604451971;Taip;9;0;1;10
15051;Obelėlė;Svajokliai;7794072582;Taip;10;5;0;15
15052;Obelėlė;Svajokliai;6785654280;Taip;0;0;3;3
15053;Obelėlė;Svajokliai;6311322617;Taip;10;5;0;15
15054;Obelėlė;Smalsučiai;7687093936;Taip;3;0;2;5
15055;Obelėlė;Smalsučiai;1469375976;Taip;0;0;1;1
15056;Obelėlė;Smalsučiai;9323228591;Taip;10;0;0;10
15057;Obelėlė;Smalsučiai;7108517080;Taip;0;0;1;1
15058;Obelėlė;Smalsučiai;4987747783;Taip;0;0;3;3
15059;Obelėlė;Smalsučiai;5085970254;Taip;3;0;2;5
15060;Obelėlė;Smalsučiai;8709758561;Ne;3;0;4;7
15061;Obelėlė;Smalsučiai;4318546408;Taip;15;0;0;15
15062;Obelėlė;Smalsučiai;5739522736;Taip;0;0;2;2
15063;Obelėlė;Smalsučiai;2631405243;Taip;7;0;3;10
15064;Obelėlė;Smalsučiai;8173307704;Ne;6;0;4;10
15065;Obelėlė;Smalsučiai;9796759067;Taip;11;0;0;11
15066;Obelėlė;Smalsučiai;6720808705;Taip;0;0;1;1
15067;Obelėlė;Smalsučiai;7850656031;Taip;13;0;2;15
15068;Obelėlė;Smalsučiai;9084969712;Taip;14;0;2;16
15069;Obelėlė;Smalsučiai;6364101139;Taip;0;0;1;1
15070;Obelėlė;Smalsučiai;6064646690;Ne;0;0;4;4
15071;Obelėlė;Pabiručiai;1547195948;Taip;0;2;0;2
15072;Obelėlė;Pabiručiai;40103909643;Taip;0;1;0;1
15073;Obelėlė;Pabiručiai;2678719111;Taip;0;0;3;3
15074;Obelėlė;Pabiručiai;1698995389;Taip;0;1;0;1
15075;Obelėlė;Pabiručiai;79669290078;Ne;0;0;3;3
15076;Obelėlė;Pabiručiai;31018018065;Taip;0;0;1;1
15077;Obelėlė;Pabiručiai;2015165566;Taip;0;0;1;1
15078;Obelėlė;Pabiručiai;8882103124;Taip;0;0;2;2
15079;Obelėlė;Pabiručiai;5471194804;Taip;0;1;0;1
15080;Obelėlė;Pabiručiai;74455701543;Taip;6;0;2;8
15081;Obelėlė;Pabiručiai;74564453474;Taip;0;5;0;5
15082;Obelėlė;Pabiručiai;8173154620;Taip;0;3;0;3
15083;Obelėlė;Pabiručiai;3057780234;Ne;0;0;1;1
15084;Obelėlė;Strakaliukai;1706102918;Taip;0;0;3;3
15085;Obelėlė;Strakaliukai;2770477678;Taip;0;4;1;5
15086;Obelėlė;Strakaliukai;8682794598;Taip;5;0;0;5
15087;Obelėlė;Strakaliukai;8754552660;Taip;0;9;3;12
15088;Obelėlė;Strakaliukai;8092024850;Taip;5;0;0;5
15089;Obelėlė;Strakaliukai;9716500560;Taip;2;4;0;6
15090;Obelėlė;Strakaliukai;4251418414;Taip;0;0;3;3
15091;Obelėlė;Strakaliukai;5943314566;Taip;0;21;0;21
15092;Obelėlė;Strakaliukai;3116100694;Taip;0;0;4;4
15093;Obelėlė;Strakaliukai;5741823041;Taip;0;5;0;5
15094;Obelėlė;Strakaliukai;8050551266;Taip;3;0;1;4
15095;Obelėlė;Strakaliukai;7468335279;Taip;5;5;3;13
15096;Obelėlė;Strakaliukai;1180508643;Taip;0;0;2;2
15097;Obelėlė;Strakaliukai;7124393375;Taip;5;0;3;8
15098;Obelėlė;Strakaliukai;2571249434;Ne;8;0;1;9
15099;Obelėlė;Strakaliukai;7514587933;Taip;0;21;0;21
15100;Obelėlė;Strakaliukai;5001844064;Taip;0;4;0;4
15101;Obelėlė;Strakaliukai;9976694313;Ne;0;0;3;3
15102;Obelėlė;Saulutė;98290583667;Ne;9;0;1;10
15103;Obelėlė;Saulutė;77954383604;Taip;0;0;1;1
15104;Obelėlė;Saulutė;1826138505;Taip;0;0;1;1
15105;Obelėlė;Saulutė;1987783063;Taip;2;0;0;2
15106;Obelėlė;Saulutė;24010838180;Taip;0;5;0;5
15107;Obelėlė;Saulutė;1935023634;Ne;0;0;1;1
15108;Obelėlė;Saulutė;2099500866;Taip;0;5;2;7
15109;Obelėlė;Saulutė;3076493150;Taip;0;4;0;4
15110;Obelėlė;Saulutė;6720229368;Ne;0;0;3;3
15111;Obelėlė;Saulutė;1021948127;Taip;0;0;1;1
15112;Obelėlė;Saulutė;4107928390;Taip;0;1;3;4
15113;Obelėlė;Saulutė;4396725994;Taip;0;0;2;2
15114;Obelėlė;Saulutė;14574836082;Ne;2;0;3;5
15115;Obelėlė;Saulutė;5973972464;Taip;0;0;1;1
15116;Obelėlė;Rieduliukai;6470533765;Ne;8;0;3;11
15117;Obelėlė;Rieduliukai;8223715886;Ne;8;0;3;11
15118;Obelėlė;Rieduliukai;2730569223;Taip;13;0;0;13
15119;Obelėlė;Rieduliukai;7491934262;Taip;17;0;0;17
15120;Obelėlė;Rieduliukai;1858251094;Taip;11;0;2;13
15121;Obelėlė;Rieduliukai;9043542844;Taip;0;5;0;5
15122;Obelėlė;Rieduliukai;6874039388;Taip;6;0;4;10
15123;Obelėlė;Rieduliukai;4218895290;Taip;14;0;0;14
15124;Obelėlė;Rieduliukai;4209489251;Taip;0;0;4;4
15125;Obelėlė;Rieduliukai;8461505586;Taip;0;0;12;12
15126;Obelėlė;Rieduliukai;7805758264;Taip;0;2;0;2
15127;Obelėlė;Rieduliukai;4309622934;Taip;9;0;0;9
15128;Obelėlė;Rieduliukai;4321210604;Taip;0;14;0;14
15129;Obelėlė;Žirniukai;8183287212;Taip;0;5;4;9
15130;Obelėlė;Žirniukai;6161821339;Taip;14;0;0;14
15131;Obelėlė;Žirniukai;5599466885;Taip;0;0;3;3
15132;Obelėlė;Žirniukai;2035035265;Taip;12;0;3;15
15133;Obelėlė;Žirniukai;4851824672;Taip;10;0;0;10
15134;Obelėlė;Žirniukai;9634414572;Taip;0;0;4;4
15135;Obelėlė;Žirniukai;2262107831;Taip;3;0;4;7
15136;Obelėlė;Žirniukai;3951816174;Taip;10;0;0;10
15137;Obelėlė;Žirniukai;7859445600;Taip;6;0;0;6
15138;Obelėlė;Žirniukai;6946457363;Taip;3;0;0;3
15139;Obelėlė;Žirniukai;1819480590;Taip;11;0;1;12
15140;Obelėlė;Bičiuliai;3425736276;Taip;0;5;2;7
15141;Obelėlė;Bičiuliai;1507072248;Taip;0;0;2;2
15142;Obelėlė;Bičiuliai;5776116844;Taip;5;0;0;5
15143;Obelėlė;Bičiuliai;8487088625;Taip;0;3;7;10
15144;Obelėlė;Bičiuliai;1630067014;Taip;0;0;1;1
15145;Obelėlė;Bičiuliai;3517342646;Taip;10;0;11;21
15146;Obelėlė;Bičiuliai;8757731600;Taip;0;0;4;4
15147;Obelėlė;Bičiuliai;2329734472;Taip;0;0;1;1
15148;Obelėlė;Bičiuliai;4220808775;Taip;6;0;2;8
15149;Obelėlė;Bičiuliai;8155712451;Taip;0;0;3;3
15150;Obelėlė;Bičiuliai;7934760271;Ne;0;0;3;3
15151;Obelėlė;Bičiuliai;4849175527;Taip;9;0;2;11
15152;Obelėlė;Bičiuliai;1362135757;Ne;4;0;2;6
15153;Obelėlė;Bičiuliai;5374979248;Taip;5;0;1;6
15154;Obelėlė;Bičiuliai;5568285702;Taip;7;0;5;12
15155;Obelėlė;Kodėlčiukai;9960526051;Taip;7;0;0;7
15156;Obelėlė;Kodėlčiukai;1050919659;Taip;10;0;0;10
15157;Obelėlė;Kodėlčiukai;4717038536;Taip;0;2;0;2
15158;Obelėlė;Kodėlčiukai;4840134079;Taip;8;0;3;11
15159;Obelėlė;Kodėlčiukai;8366162313;Taip;12;0;0;12
15160;Obelėlė;Kodėlčiukai;7901070568;Taip;0;0;5;5
15161;Obelėlė;Kodėlčiukai;6481365666;Taip;0;14;0;14
15162;Obelėlė;Kodėlčiukai;2227383487;Taip;0;0;1;1
15163;Obelėlė;Kodėlčiukai;8818153952;Taip;15;0;0;15
15164;Obelėlė;Kodėlčiukai;4887103549;Taip;9;0;0;9
15165;Obelėlė;Kodėlčiukai;5221918341;Taip;9;0;0;9
15166;Obelėlė;Kodėlčiukai;3748406335;Taip;5;0;0;5
15167;Spygliukas;Bitutės;5827455834;Taip;0;8;0;8
15168;Spygliukas;Bitutės;9975117461;Taip;0;0;9;9
15169;Spygliukas;Bitutės;16828631895;Ne;0;0;1;1
15170;Spygliukas;Bitutės;4653108810;Ne;0;2;0;2
15171;Spygliukas;Bitutės;2980459339;Taip;10;0;1;11
15172;Spygliukas;Bitutės;7421000718;Taip;5;5;1;11
15173;Spygliukas;Bitutės;8103481313;Taip;0;6;0;6
15174;Spygliukas;Bitutės;4430242310;Taip;0;2;0;2
15175;Spygliukas;Bitutės;1228469923;Ne;0;10;1;11
15176;Spygliukas;Bitutės;5022615426;Taip;3;0;0;3
15177;Spygliukas;Bitutės;7250958367;Taip;0;1;0;1
15178;Spygliukas;Bitutės;9001243644;Taip;9;1;4;14
15179;Spygliukas;Bitutės;8646122773;Taip;0;5;0;5
15180;Spygliukas;Bitutės;4933577424;Taip;0;5;0;5
15181;Spygliukas;Bitutės;8992822256;Ne;0;3;0;3
15182;Spygliukas;Bitutės;1940209166;Ne;0;2;2;4
15183;Spygliukas;Bitutės;1939828587;Ne;8;0;0;8
15184;Spygliukas;Bitutės;1238940921;Taip;0;8;3;11
15185;Spygliukas;Bitutės;9797138740;Taip;8;0;3;11
15186;Spygliukas;Bitutės;7114613140;Taip;0;1;0;1
15187;Spygliukas;Kiškučiai;4340767624;Ne;0;0;1;1
15188;Spygliukas;Boružėlės;3569857813;Taip;5;2;0;7
15189;Spygliukas;Boružėlės;6931145017;Taip;9;0;2;11
15190;Spygliukas;Boružėlės;8802722601;Taip;0;3;1;4
15191;Spygliukas;Boružėlės;9285259322;Taip;0;4;0;4
15192;Spygliukas;Boružėlės;1341333016;Taip;0;0;21;21
15193;Spygliukas;Boružėlės;5561426508;Taip;5;0;0;5
15194;Spygliukas;Boružėlės;8806126755;Taip;12;0;1;13
15195;Spygliukas;Boružėlės;4477402331;Taip;8;0;0;8
15196;Spygliukas;Boružėlės;2772801133;Ne;15;0;0;15
15197;Spygliukas;Boružėlės;6917435881;Taip;7;0;5;12
15198;Spygliukas;Boružėlės;4245624629;Taip;14;0;1;15
15199;Spygliukas;Boružėlės;3706443395;Taip;6;0;1;7
15200;Spygliukas;Boružėlės;5765106914;Taip;0;7;0;7
15201;Spygliukas;Boružėlės;3416275094;Taip;0;0;6;6
15202;Spygliukas;Boružėlės;1401951658;Ne;7;0;0;7
15203;Spygliukas;Boružėlės;8708083787;Taip;10;7;0;17
15204;Spygliukas;Boružėlės;8825264090;Taip;0;0;4;4
15205;Spygliukas;Boružėlės;1662885055;Taip;0;8;0;8
15206;Spygliukas;Ežiukai;6242194100;Taip;3;0;1;4
15207;Spygliukas;Ežiukai;5778081118;Taip;0;0;8;8
15208;Spygliukas;Ežiukai;4577592862;Taip;6;0;4;10
15209;Spygliukas;Ežiukai;4949371837;Taip;0;0;1;1
15210;Spygliukas;Ežiukai;4650693672;Taip;0;10;0;10
15211;Spygliukas;Ežiukai;6835488489;Ne;0;10;2;12
15212;Spygliukas;Ežiukai;3658613027;Ne;0;0;2;2
15213;Spygliukas;Ežiukai;50047868918;Ne;11;0;1;12
15214;Spygliukas;Ežiukai;3365209400;Ne;0;0;2;2
15215;Spygliukas;Ežiukai;6457632191;Taip;7;0;0;7
15216;Spygliukas;Ežiukai;5962360012;Taip;0;0;2;2
15217;Spygliukas;Ežiukai;2739564216;Taip;0;0;3;3
15218;Spygliukas;Ežiukai;4610504338;Taip;0;0;2;2
15219;Spygliukas;Ežiukai;7900652746;Taip;0;8;0;8
15220;Spygliukas;Ežiukai;8048474808;Ne;0;0;2;2
15221;Spygliukas;Ežiukai;8331205164;Ne;2;2;0;4
15222;Spygliukas;Geniukai;9444569348;Taip;16;0;0;16
15223;Spygliukas;Geniukai;8404929784;Taip;5;0;0;5
15224;Spygliukas;Geniukai;4835818382;Taip;5;7;0;12
15225;Spygliukas;Geniukai;9070219319;Taip;0;3;0;3
15226;Spygliukas;Geniukai;9413950200;Taip;5;0;0;5
15227;Spygliukas;Geniukai;1664878188;Taip;0;1;0;1
15228;Spygliukas;Geniukai;8869320003;Taip;18;0;0;18
15229;Spygliukas;Geniukai;8476882854;Taip;8;5;0;13
15230;Spygliukas;Geniukai;1333556956;Taip;2;3;1;6
15231;Spygliukas;Geniukai;9112172144;Ne;10;1;0;11
15232;Spygliukas;Geniukai;8270525839;Taip;0;4;0;4
15233;Spygliukas;Geniukai;3697691132;Taip;15;1;0;16
15234;Spygliukas;Geniukai;4053158210;Taip;0;3;0;3
15235;Spygliukas;Geniukai;2395961015;Taip;0;0;4;4
15236;Spygliukas;Geniukai;5134327772;Taip;0;1;0;1
15237;Spygliukas;Geniukai;8236718590;Ne;0;0;4;4
15238;Spygliukas;Geniukai;3761715811;Ne;3;1;0;4
15239;Spygliukas;Riešutėliai;26697357569;Taip;0;1;0;1
15240;Spygliukas;Riešutėliai;7649832094;Ne;0;5;1;6
15241;Spygliukas;Riešutėliai;3037648954;Taip;0;0;2;2
15242;Spygliukas;Riešutėliai;2126162527;Taip;7;0;0;7
15243;Spygliukas;Riešutėliai;42285404110;Taip;0;0;2;2
15244;Spygliukas;Riešutėliai;29015391754;Taip;5;0;0;5
15245;Spygliukas;Riešutėliai;1832756255;Taip;5;7;0;12
15246;Spygliukas;Riešutėliai;1881745347;Taip;0;3;0;3
15247;Spygliukas;Riešutėliai;53324066837;Ne;0;0;4;4
15248;Spygliukas;Riešutėliai;2040903312;Taip;9;1;0;10
15249;Spygliukas;Riešutėliai;1211969263;Taip;0;5;0;5
15250;Spygliukas;Riešutėliai;9957292202;Taip;0;0;1;1
15251;Spygliukas;Riešutėliai;7219659640;Ne;0;0;1;1
15252;Spygliukas;Riešutėliai;84556142803;Taip;0;8;1;9
15253;Spygliukas;Riešutėliai;1298381738;Taip;5;0;2;7
15254;Spygliukas;Riešutėliai;2901031642;Taip;0;1;1;2
15255;Spygliukas;Riešutėliai;4355472423;Taip;0;0;3;3
15256;Spygliukas;Riešutėliai;5894399590;Taip;5;0;0;5
15257;Spygliukas;Pelėdžiukai;1002603766;Ne;0;6;0;6
15258;Spygliukas;Pelėdžiukai;1842315404;Taip;2;1;1;4
15259;Spygliukas;Pelėdžiukai;30201229961;Taip;0;3;0;3
15260;Spygliukas;Pelėdžiukai;9288806012;Taip;0;0;1;1
15261;Spygliukas;Pelėdžiukai;79584454527;Taip;1;0;3;4
15262;Spygliukas;Pelėdžiukai;92279064240;Taip;0;7;0;7
15263;Spygliukas;Pelėdžiukai;10858715103;Taip;0;0;1;1
15264;Spygliukas;Pelėdžiukai;4104158994;Taip;0;0;2;2
15265;Spygliukas;Pelėdžiukai;1321926079;Taip;0;0;1;1
15266;Spygliukas;Pelėdžiukai;73047963456;Taip;0;0;1;1
15267;Spygliukas;Pelėdžiukai;34209607173;Taip;0;0;1;1
15268;Spygliukas;Pelėdžiukai;9513387087;Ne;0;0;7;7
15269;Spygliukas;Pelėdžiukai;1030973848;Ne;8;0;0;8
15270;Spygliukas;Pelėdžiukai;45881077771;Ne;0;8;0;8
15271;Spygliukas;Pelėdžiukai;1415694208;Ne;0;0;1;1
15272;Spygliukas;Pelėdžiukai;29449834997;Taip;5;0;1;6
15273;Spygliukas;Zylutės;8366571422;Ne;0;0;2;2
15274;Spygliukas;Zylutės;8581453160;Taip;0;0;1;1
15275;Spygliukas;Zylutės;9601530981;Ne;4;0;0;4
15276;Spygliukas;Skruzdėliukai;1983112873;Ne;1;0;1;2
15277;Spygliukas;Skruzdėliukai;4615217628;Ne;13;0;1;14
15278;Spygliukas;Skruzdėliukai;2184487073;Ne;0;3;0;3
15279;Spygliukas;Skruzdėliukai;5612894706;Taip;1;1;1;3
15280;Spygliukas;Skruzdėliukai;6552944183;Ne;8;0;0;8
15281;Spygliukas;Skruzdėliukai;1353217998;Taip;0;0;1;1
15282;Spygliukas;Skruzdėliukai;7749937772;Ne;7;0;0;7
15283;Spygliukas;Skruzdėliukai;5160835235;Ne;0;0;2;2
15284;Spygliukas;Skruzdėliukai;1429613380;Ne;9;0;0;9
15285;Spygliukas;Skruzdėliukai;9321493897;Ne;4;0;0;4
15286;Spygliukas;Skruzdėliukai;7908419787;Taip;0;0;1;1
15287;Spygliukas;Skruzdėliukai;5366783639;Ne;0;1;0;1
15288;Spygliukas;Skruzdėliukai;7287543571;Ne;2;0;0;2
15289;Spygliukas;Voveraitės;7897603878;Taip;0;7;0;7
15290;Spygliukas;Voveraitės;3077468722;Taip;0;0;5;5
15291;Spygliukas;Voveraitės;2272141731;Taip;0;8;0;8
15292;Spygliukas;Voveraitės;3668191959;Taip;0;1;0;1
15293;Spygliukas;Voveraitės;7611880543;Ne;14;0;1;15
15294;Spygliukas;Voveraitės;8189748611;Ne;0;1;0;1
15295;Spygliukas;Voveraitės;8877911083;Taip;0;3;0;3
15296;Spygliukas;Voveraitės;6405496193;Taip;5;0;1;6
15297;Spygliukas;Voveraitės;9231097598;Taip;10;0;0;10
15298;Spygliukas;Voveraitės;4681061579;Taip;6;0;1;7
15299;Spygliukas;Voveraitės;7313828707;Taip;8;1;0;9
15300;Spygliukas;Voveraitės;1234195733;Ne;0;8;0;8
15301;Spygliukas;Giliukų;9945315122;Ne;21;0;0;21
15302;Spygliukas;Giliukų;8308394841;Ne;5;0;4;9
15303;Spygliukas;Giliukų;6343141973;Ne;8;0;6;14
15304;Spygliukas;Giliukų;1127941700;Ne;0;0;1;1
15305;Spygliukas;Giliukų;9141146733;Ne;8;0;0;8
15306;Spygliukas;Giliukų;6363991196;Taip;10;0;3;13
15307;Spygliukas;Giliukų;8093949301;Taip;11;0;3;14
15308;Spygliukas;Giliukų;3064391379;Ne;6;0;0;6
15309;Spygliukas;Giliukų;7561072315;Ne;0;0;4;4
15310;Spygliukas;Giliukų;2950722789;Ne;1;0;4;5
15311;Spygliukas;Giliukų;2459494071;Taip;0;0;4;4
15312;Spygliukas;Giliukų;7477731865;Taip;2;0;1;3
15313;Spygliukas;Drugeliai;7271659513;Taip;10;5;0;15
15314;Spygliukas;Drugeliai;4634660174;Taip;6;0;1;7
15315;Spygliukas;Drugeliai;4368224847;Taip;8;0;6;14
15316;Spygliukas;Drugeliai;9316731983;Taip;0;16;0;16
15317;Spygliukas;Drugeliai;6630979640;Taip;5;0;1;6
15318;Spygliukas;Drugeliai;5012876830;Taip;0;5;1;6
15319;Spygliukas;Drugeliai;2315421636;Taip;1;0;7;8
15320;Spygliukas;Drugeliai;7125425492;Taip;2;1;0;3
15321;Spygliukas;Drugeliai;5214431060;Ne;4;0;1;5
15322;Spygliukas;Drugeliai;9052337501;Ne;0;0;1;1
15323;Spygliukas;Drugeliai;1974541155;Taip;1;0;4;5
15324;Spygliukas;Drugeliai;2989701249;Ne;4;0;2;6
15325;Spygliukas;Drugeliai;9086986643;Taip;1;0;2;3
15326;Vieversys;Žirniukai;8129139979;Taip;0;4;0;4
15327;Vieversys;Žirniukai;1149316471;Taip;0;3;0;3
15328;Vieversys;Žirniukai;1728554204;Taip;0;1;0;1
15329;Vieversys;Žirniukai;9612415733;Taip;0;10;0;10
15330;Vieversys;Žirniukai;5917328379;Taip;0;0;3;3
15331;Vieversys;Žirniukai;53977164888;Taip;0;10;0;10
15332;Vieversys;Žirniukai;82594887399;Taip;0;3;0;3
15333;Vieversys;Žirniukai;7500147648;Taip;0;15;0;15
15334;Vieversys;Žirniukai;9835682858;Taip;0;10;0;10
15335;Vieversys;Žirniukai;5286521728;Taip;0;8;0;8
15336;Vieversys;Žirniukai;8038341998;Taip;0;1;0;1
15337;Vieversys;Žirniukai;1247565595;Taip;15;0;0;15
15338;Vieversys;Žirniukai;6720355390;Taip;4;0;9;13
15339;Vieversys;Žirniukai;4313822180;Taip;5;0;0;5
15340;Vieversys;Žirniukai;7812227428;Ne;0;10;0;10
15341;Vieversys;Žirniukai;4455039401;Taip;0;1;0;1
15342;Vieversys;Žirniukai;3205204176;Ne;0;0;2;2
15343;Vieversys;Žirniukai;9176198859;Ne;0;0;13;13
15344;Vieversys;Varpelių;41215224179;Taip;0;1;5;6
15345;Vieversys;Varpelių;78901148667;Taip;8;3;0;11
15346;Vieversys;Varpelių;2130449373;Taip;0;1;0;1
15347;Vieversys;Varpelių;2141967793;Taip;0;2;0;2
15348;Vieversys;Varpelių;2128428329;Taip;0;2;0;2
15349;Vieversys;Varpelių;1462608187;Taip;1;0;0;1
15350;Vieversys;Varpelių;1190396975;Taip;0;1;0;1
15351;Vieversys;Varpelių;3839507103;Taip;0;1;0;1
15352;Vieversys;Varpelių;12524976076;Taip;3;0;0;3
15353;Vieversys;Varpelių;44086673096;Taip;0;1;0;1
15354;Vieversys;Varpelių;55553505459;Taip;0;3;1;4
15355;Vieversys;Varpelių;16002848795;Taip;0;3;1;4
15356;Vieversys;Varpelių;46624143347;Taip;0;8;0;8
15357;Vieversys;Varpelių;1933907389;Taip;0;2;0;2
15358;Vieversys;Varpelių;61101237391;Taip;0;1;0;1
15359;Vieversys;Varpelių;1300013110;Taip;0;1;0;1
15360;Vieversys;Varpelių;5123994167;Taip;0;0;1;1
15361;Vieversys;Varpelių;62465517391;Taip;0;1;0;1
15362;Vieversys;Varpelių;2879546284;Taip;5;2;0;7
15363;Vieversys;Varpelių;8213134622;Taip;0;7;0;7
15364;Vieversys;Kiškučių;95472887427;Taip;0;2;1;3
15365;Vieversys;Kiškučių;86119860485;Taip;0;2;0;2
15366;Vieversys;Kiškučių;32630544785;Taip;0;2;0;2
15367;Vieversys;Kiškučių;57223617591;Taip;0;0;1;1
15368;Vieversys;Kiškučių;95886969053;Taip;0;6;0;6
15369;Vieversys;Kiškučių;86213464121;Taip;0;14;0;14
15370;Vieversys;Kiškučių;1815073796;Taip;0;1;0;1
15371;Vieversys;Kiškučių;1715902540;Taip;0;3;5;8
15372;Vieversys;Kiškučių;20960056744;Ne;5;0;0;5
15373;Vieversys;Kiškučių;1028950997;Taip;5;0;1;6
15374;Vieversys;Kiškučių;58287759954;Taip;0;2;0;2
15375;Vieversys;Kiškučių;5197639355;Taip;0;3;0;3
15376;Vieversys;Kiškučių;6116471730;Taip;3;1;0;4
15377;Vieversys;Kiškučių;8966153890;Taip;1;2;2;5
15378;Vieversys;Kiškučių;9980447111;Taip;0;0;1;1
15379;Vieversys;Kiškučių;6236703869;Taip;0;2;4;6
15380;Vieversys;Kiškučių;1601102808;Taip;6;0;0;6
15381;Vieversys;Kiškučių;2733479642;Taip;0;1;0;1
15382;Vieversys;Pelėdžiukų;77272293257;Taip;5;2;0;7
15383;Vieversys;Pelėdžiukų;94463134058;Taip;6;2;0;8
15384;Vieversys;Pelėdžiukų;5434952733;Taip;0;0;3;3
15385;Vieversys;Pelėdžiukų;2193074123;Taip;0;0;3;3
15386;Vieversys;Pelėdžiukų;7007620994;Taip;0;1;3;4
15387;Vieversys;Pelėdžiukų;9499315463;Taip;4;1;0;5
15388;Vieversys;Pelėdžiukų;9494957750;Taip;0;2;0;2
15389;Vieversys;Pelėdžiukų;2521488728;Taip;0;0;5;5
15390;Vieversys;Pelėdžiukų;6473759470;Taip;0;2;0;2
15391;Vieversys;Pelėdžiukų;1273951001;Taip;0;7;0;7
15392;Vieversys;Pelėdžiukų;48430863473;Taip;0;6;0;6
15393;Vieversys;Pelėdžiukų;1027693153;Taip;0;0;1;1
15394;Vieversys;Pelėdžiukų;5871715452;Taip;0;0;1;1
15395;Vieversys;Pelėdžiukų;9659337657;Taip;0;2;0;2
15396;Vieversys;Pelėdžiukų;3458399180;Taip;4;8;0;12
15397;Vieversys;Pelėdžiukų;1361156816;Taip;6;2;0;8
15398;Vieversys;Pelėdžiukų;4216521988;Taip;0;20;0;20
15399;Vieversys;Pelėdžiukų;3755410640;Ne;0;9;0;9
15400;Vieversys;Saulučių;4892622551;Taip;0;0;2;2
15401;Vieversys;Saulučių;9972526744;Taip;5;0;0;5
15402;Vieversys;Saulučių;9985374057;Taip;6;0;0;6
15403;Vieversys;Saulučių;1748006118;Taip;4;0;1;5
15404;Vieversys;Saulučių;6326056771;Taip;12;0;1;13
15405;Vieversys;Saulučių;4690095102;Taip;7;0;0;7
15406;Vieversys;Saulučių;7048475906;Taip;0;0;1;1
15407;Vieversys;Saulučių;4072323869;Taip;5;1;0;6
15408;Vieversys;Saulučių;2663322242;Taip;5;0;0;5
15409;Vieversys;Saulučių;7596355010;Taip;0;8;0;8
15410;Vieversys;Kregždučių;5645852451;Taip;0;0;1;1
15411;Vieversys;Kregždučių;9088171869;Taip;0;0;2;2
15412;Vieversys;Kregždučių;7998100115;Taip;0;10;0;10
15413;Vieversys;Kregždučių;9093088054;Taip;0;15;0;15
15414;Vieversys;Kregždučių;4870401841;Taip;5;0;0;5
15415;Vieversys;Kregždučių;6808541662;Ne;0;10;0;10
15416;Vieversys;Kregždučių;2529690060;Taip;1;7;0;8
15417;Vieversys;Kregždučių;6157594693;Taip;0;5;0;5
15418;Vieversys;Kregždučių;1322953831;Taip;0;10;0;10
15419;Vieversys;Kregždučių;9090281352;Taip;7;0;1;8
15420;Vieversys;Kregždučių;8421404290;Taip;5;0;0;5
15421;Vieversys;Kregždučių;4308330177;Taip;8;0;0;8
15422;Vieversys;Kregždučių;4347494053;Taip;0;0;5;5
15423;Vieversys;Kregždučių;3122763958;Taip;0;0;5;5
15424;Vieversys;Kregždučių;2938302462;Taip;4;0;0;4
15425;Vieversys;Boružėlių;1478357320;Taip;0;3;0;3
15426;Vieversys;Boružėlių;6838828193;Taip;0;0;3;3
15427;Vieversys;Boružėlių;8587368497;Taip;5;0;0;5
15428;Vieversys;Boružėlių;5683183310;Taip;3;0;0;3
15429;Vieversys;Boružėlių;6765094662;Taip;2;0;0;2
15430;Vieversys;Boružėlių;9884517851;Taip;4;0;0;4
15431;Vieversys;Boružėlių;4565799599;Taip;0;1;0;1
15432;Vieversys;Boružėlių;7399326463;Taip;9;0;0;9
15433;Vieversys;Boružėlių;4088189914;Taip;0;0;1;1
15434;Vieversys;Boružėlių;7364582681;Taip;0;0;1;1
15435;Vieversys;Boružėlių;9826657384;Taip;10;0;0;10
15436;Vieversys;Boružėlių;3731412573;Taip;0;6;0;6
15437;Vieversys;Boružėlių;7429565381;Ne;8;5;0;13
15438;Vieversys;Boružėlių;4297477514;Taip;9;0;0;9
15439;Vieversys;Boružėlių;8816714193;Taip;5;0;0;5
15440;Vieversys;Boružėlių;2701284187;Taip;2;0;7;9
15441;Vieversys;Boružėlių;9911792407;Taip;4;0;0;4
15442;Vieversys;Bitučių;8706336322;Taip;5;0;0;5
15443;Vieversys;Bitučių;5966170543;Taip;0;4;0;4
15444;Vieversys;Bitučių;9188208330;Taip;0;1;0;1
15445;Vieversys;Bitučių;9476611261;Taip;9;0;0;9
15446;Vieversys;Bitučių;6083402842;Taip;3;0;0;3
15447;Vieversys;Bitučių;4428101863;Taip;5;0;0;5
15448;Vieversys;Bitučių;4335653911;Taip;7;0;0;7
15449;Vieversys;Bitučių;9654507441;Taip;0;0;6;6
15450;Vieversys;Bitučių;9978867863;Taip;2;0;0;2
15451;Vieversys;Bitučių;9092693925;Taip;0;0;1;1
15452;Vieversys;Smalsučių;5922485482;Taip;0;0;1;1
15453;Vieversys;Smalsučių;9164615794;Taip;0;2;0;2
15454;Vieversys;Smalsučių;3684937630;Taip;3;4;0;7
15455;Vieversys;Smalsučių;6563139211;Taip;1;0;1;2
15456;Vieversys;Smalsučių;1757028935;Ne;12;1;0;13
15457;Vieversys;Smalsučių;4488027554;Taip;10;1;0;11
15458;Vieversys;Smalsučių;4294676988;Taip;0;1;1;2
15459;Vieversys;Smalsučių;3917758713;Taip;0;10;0;10
15460;Vieversys;Smalsučių;4835022593;Taip;18;0;1;19
15461;Vieversys;Smalsučių;3249717073;Taip;0;4;0;4
15462;Vieversys;Smalsučių;7120329258;Taip;0;1;0;1
15463;Vieversys;Smalsučių;9387421639;Taip;16;1;0;17
15464;Vieversys;Smalsučių;8174124875;Taip;1;8;0;9
15465;Vieversys;Smalsučių;5769453869;Taip;5;1;0;6
15466;Vieversys;Smalsučių;5907903394;Taip;0;0;1;1
15467;Vieversys;Smalsučių;3946609345;Taip;6;0;0;6
15468;Vieversys;Smalsučių;6982109508;Ne;2;0;2;4
15469;Vieversys;Smalsučių;2383765752;Ne;0;0;5;5
15470;Vieversys;Smalsučių;9171781646;Taip;12;0;0;12
15471;Vieversys;Smalsučių;4931253729;Taip;12;0;0;12
15472;Vieversys;Kodėlčiukų;69275621813;Taip;12;1;0;13
15473;Vieversys;Kodėlčiukų;1455615413;Taip;0;7;0;7
15474;Vieversys;Kodėlčiukų;1970088958;Taip;0;6;1;7
15475;Vieversys;Kodėlčiukų;9012978017;Taip;5;2;0;7
15476;Vieversys;Kodėlčiukų;1599787985;Ne;0;1;0;1
15477;Vieversys;Kodėlčiukų;1491424075;Taip;0;0;4;4
15478;Vieversys;Kodėlčiukų;1361494430;Taip;6;1;0;7
15479;Vieversys;Kodėlčiukų;9829388743;Taip;5;2;0;7
15480;Vieversys;Kodėlčiukų;7315438787;Taip;0;7;0;7
15481;Vieversys;Kodėlčiukų;16617102917;Taip;8;8;0;16
15482;Vieversys;Kodėlčiukų;1793994492;Taip;0;0;3;3
15483;Vieversys;Kodėlčiukų;2236904814;Taip;6;0;3;9
15484;Vieversys;Kodėlčiukų;3792076932;Taip;0;1;0;1
15485;Vieversys;Kodėlčiukų;7385860819;Taip;5;0;0;5
15486;Vieversys;Kodėlčiukų;9680719247;Taip;0;7;0;7
15487;Vieversys;Kodėlčiukų;2294276744;Taip;0;2;0;2
15488;Vieversys;Kodėlčiukų;3640960566;Taip;5;0;9;14
15489;Vieversys;Kodėlčiukų;2006325359;Taip;0;9;2;11
15490;Vieversys;Kodėlčiukų;1122002166;Taip;4;2;0;6
15491;Vieversys;NYKŠTUKAI;3262738994;Taip;0;1;0;1
15492;Vieversys;NYKŠTUKAI;5160814541;Taip;4;0;0;4
15493;Vieversys;NYKŠTUKAI;2805682329;Taip;0;1;0;1
15494;Vieversys;NYKŠTUKAI;2635722489;Taip;0;0;5;5
15495;Vieversys;NYKŠTUKAI;9102341863;Ne;6;0;0;6
15496;Vieversys;NYKŠTUKAI;3595005599;Taip;9;0;0;9
15497;Vieversys;NYKŠTUKAI;5150986489;Taip;9;0;0;9
15498;Vieversys;NYKŠTUKAI;2956566201;Taip;2;0;0;2
15499;Vieversys;NYKŠTUKAI;1924774817;Taip;5;1;0;6
15500;Vieversys;NYKŠTUKAI;9463693741;Taip;7;0;5;12
15501;Vieversys;NYKŠTUKAI;8350070741;Taip;6;0;0;6
15502;Vieversys;DRUGELIAI;5912306325;Taip;0;13;0;13
15503;Vieversys;DRUGELIAI;5898422871;Taip;0;0;4;4
15504;Vieversys;DRUGELIAI;5037806018;Taip;5;0;0;5
15505;Vieversys;DRUGELIAI;6926960486;Taip;0;0;7;7
15506;Vieversys;DRUGELIAI;1384388802;Taip;7;0;0;7
15507;Vieversys;DRUGELIAI;6709556873;Taip;0;0;4;4
15508;Vieversys;DRUGELIAI;2562413607;Taip;0;0;3;3
15509;Vieversys;DRUGELIAI;4193031329;Taip;11;0;0;11
15510;Vieversys;DRUGELIAI;4631238425;Taip;6;0;0;6
15511;Vieversys;DRUGELIAI;5182466820;Taip;2;0;4;6
15512;Vieversys;DRUGELIAI;3180687885;Taip;15;0;0;15
15513;Vieversys;DRUGELIAI;4702339508;Taip;6;0;0;6
15514;Vieversys;DRUGELIAI;9217208794;Taip;4;0;1;5
15515;Žirmūnėliai;SAULUTĖS;8030469722;Taip;10;0;0;10
15516;Žirmūnėliai;SAULUTĖS;1258769646;Taip;3;1;1;5
15517;Žirmūnėliai;SAULUTĖS;1725143117;Taip;0;1;0;1
15518;Žirmūnėliai;SAULUTĖS;1073135587;Taip;0;7;0;7
15519;Žirmūnėliai;SAULUTĖS;4598761492;Taip;0;2;0;2
15520;Žirmūnėliai;SAULUTĖS;1478039469;Taip;3;2;0;5
15521;Žirmūnėliai;SAULUTĖS;1255857051;Taip;10;2;0;12
15522;Žirmūnėliai;SAULUTĖS;72738770293;Taip;3;1;1;5
15523;Žirmūnėliai;SAULUTĖS;4517290068;Taip;4;0;0;4
15524;Žirmūnėliai;SAULUTĖS;1582563837;Taip;3;2;0;5
15525;Žirmūnėliai;SAULUTĖS;1381923106;Taip;5;1;1;7
15526;Žirmūnėliai;SAULUTĖS;5037669167;Taip;0;1;0;1
15527;Žirmūnėliai;SAULUTĖS;1761284228;Taip;0;5;1;6
15528;Žirmūnėliai;SAULUTĖS;41018224936;Taip;6;0;0;6
15529;Žirmūnėliai;SAULUTĖS;1894070647;Taip;0;3;0;3
15530;Žirmūnėliai;SAULUTĖS;1347664230;Taip;5;0;7;12
15531;Žirmūnėliai;SAULUTĖS;1302022463;Taip;0;1;0;1
15532;Žirmūnėliai;SAULUTĖS;1435743911;Ne;13;0;0;13
15533;Žirmūnėliai;SAULUTĖS;8308074932;Taip;0;5;0;5
15534;Žirmūnėliai;SAULUTĖS;7562464310;Taip;5;0;0;5
15535;Žirmūnėliai;GILIUKAI;6430944858;Taip;0;0;2;2
15536;Žirmūnėliai;GILIUKAI;3562689670;Taip;0;1;0;1
15537;Žirmūnėliai;GILIUKAI;5929166560;Taip;0;1;0;1
15538;Žirmūnėliai;GILIUKAI;3767421827;Taip;0;0;5;5
15539;Žirmūnėliai;GILIUKAI;4327504033;Taip;8;1;0;9
15540;Žirmūnėliai;GILIUKAI;5104310002;Taip;3;0;18;21
15541;Žirmūnėliai;GILIUKAI;1025809131;Taip;9;0;0;9
15542;Žirmūnėliai;GILIUKAI;8631248243;Taip;10;1;1;12
15543;Žirmūnėliai;GILIUKAI;6899109664;Taip;0;0;5;5
15544;Žirmūnėliai;GILIUKAI;1473482823;Ne;0;5;0;5
15545;Žirmūnėliai;GILIUKAI;7410921362;Taip;5;0;0;5
15546;Žirmūnėliai;GILIUKAI;6597451758;Taip;0;0;4;4
15547;Žirmūnėliai;GILIUKAI;5089884149;Taip;5;0;0;5
15548;Žirmūnėliai;GILIUKAI;1791977446;Taip;10;0;0;10
15549;Žirmūnėliai;GILIUKAI;6875484657;Taip;0;0;5;5
15550;Žirmūnėliai;GILIUKAI;9871163622;Taip;9;0;0;9
15551;Žirmūnėliai;GILIUKAI;3532895278;Taip;9;0;0;9
15552;Žirmūnėliai;GILIUKAI;8459217612;Taip;0;12;0;12
15553;Žirmūnėliai;GILIUKAI;2959090234;Taip;6;6;2;14
15554;Žirmūnėliai;DAINORĖLIAI;6493142538;Taip;5;0;0;5
15555;Žirmūnėliai;DAINORĖLIAI;1655437833;Taip;4;0;6;10
15556;Žirmūnėliai;DAINORĖLIAI;2693415717;Ne;0;0;6;6
15557;Žirmūnėliai;DAINORĖLIAI;8930536051;Taip;0;0;1;1
15558;Žirmūnėliai;DAINORĖLIAI;7953019230;Taip;0;4;0;4
15559;Žirmūnėliai;DAINORĖLIAI;3994865244;Taip;17;0;1;18
15560;Žirmūnėliai;DAINORĖLIAI;3640979388;Taip;3;0;2;5
15561;Žirmūnėliai;DAINORĖLIAI;6878528100;Taip;5;0;3;8
15562;Žirmūnėliai;DAINORĖLIAI;8440187348;Taip;9;0;0;9
15563;Žirmūnėliai;DAINORĖLIAI;9402567487;Taip;13;0;1;14
15564;Žirmūnėliai;DAINORĖLIAI;9759491055;Ne;0;0;2;2
15565;Žirmūnėliai;DAINORĖLIAI;1127214387;Taip;0;0;2;2
15566;Žirmūnėliai;DAINORĖLIAI;4101748829;Taip;5;8;0;13
15567;Žirmūnėliai;DAINORĖLIAI;2379638934;Taip;0;6;0;6
15568;Žirmūnėliai;DAINORĖLIAI;6448582622;Ne;15;0;0;15
15569;Žirmūnėliai;DAINORĖLIAI;2661052835;Taip;0;5;0;5
15570;Žirmūnėliai;DAINORĖLIAI;7011701994;Ne;0;10;0;10
15571;Žirmūnėliai;DAINORĖLIAI;4968278870;Ne;9;0;0;9
15572;Žirmūnėliai;DRUGELIAI;4218266688;Taip;8;0;0;8
15573;Žirmūnėliai;DRUGELIAI;7020486370;Ne;0;3;0;3
15574;Žirmūnėliai;DRUGELIAI;3449815783;Taip;0;2;1;3
15575;Žirmūnėliai;DRUGELIAI;5736502380;Ne;0;1;0;1
15576;Žirmūnėliai;DRUGELIAI;9154874729;Taip;10;0;0;10
15577;Žirmūnėliai;DRUGELIAI;9378860669;Taip;0;11;0;11
15578;Žirmūnėliai;DRUGELIAI;8607934394;Taip;0;1;0;1
15579;Žirmūnėliai;DRUGELIAI;5723289396;Ne;5;10;0;15
15580;Žirmūnėliai;DRUGELIAI;7892626521;Taip;0;3;0;3
15581;Žirmūnėliai;DRUGELIAI;8209309240;Taip;0;3;0;3
15582;Žirmūnėliai;DRUGELIAI;5209700153;Taip;5;0;0;5
15583;Žirmūnėliai;DRUGELIAI;2837129621;Taip;0;2;4;6
15584;Žirmūnėliai;DRUGELIAI;1273684243;Taip;5;0;0;5
15585;Žirmūnėliai;DRUGELIAI;2971175236;Taip;5;2;0;7
15586;Žirmūnėliai;DRUGELIAI;6594728970;Taip;0;8;0;8
15587;Žirmūnėliai;DRUGELIAI;7422544482;Taip;12;0;0;12
15588;Žirmūnėliai;DRUGELIAI;4336415033;Taip;5;0;0;5
15589;Žirmūnėliai;DRUGELIAI;9241738140;Taip;8;8;0;16
15590;Žirmūnėliai;DRUGELIAI;3274576752;Taip;20;1;0;21
15591;Žirmūnėliai;BORUŽIUKAI;52420072025;Ne;0;0;1;1
15592;Žirmūnėliai;BORUŽIUKAI;4796654075;Ne;8;0;2;10
15593;Žirmūnėliai;BORUŽIUKAI;1542147528;Ne;7;0;0;7
15594;Žirmūnėliai;BORUŽIUKAI;64969220116;Taip;0;14;0;14
15595;Žirmūnėliai;BORUŽIUKAI;2127930970;Taip;7;0;0;7
15596;Žirmūnėliai;BORUŽIUKAI;1017903291;Ne;0;0;1;1
15597;Žirmūnėliai;BORUŽIUKAI;3691651489;Taip;10;0;1;11
15598;Žirmūnėliai;BORUŽIUKAI;29952298800;Taip;0;1;10;11
15599;Žirmūnėliai;BORUŽIUKAI;51723882387;Taip;0;0;6;6
15600;Žirmūnėliai;BORUŽIUKAI;73664204182;Taip;5;0;2;7
15601;Žirmūnėliai;BORUŽIUKAI;1816123753;Taip;0;0;1;1
15602;Žirmūnėliai;BORUŽIUKAI;6578685370;Ne;10;0;0;10
15603;Žirmūnėliai;BORUŽIUKAI;37231106844;Taip;5;0;0;5
15604;Žirmūnėliai;BORUŽIUKAI;68678277635;Taip;5;0;0;5
15605;Žirmūnėliai;BORUŽIUKAI;5996547081;Taip;13;5;0;18
15606;Žirmūnėliai;BORUŽIUKAI;1493536049;Taip;5;3;0;8
15607;Žirmūnėliai;BORUŽIUKAI;1234956674;Taip;4;6;0;10
15608;Žirmūnėliai;EŽIUKAI;9829630143;Taip;0;8;0;8
15609;Žirmūnėliai;EŽIUKAI;1690539251;Taip;0;1;0;1
15610;Žirmūnėliai;EŽIUKAI;5527904792;Taip;0;14;0;14
15611;Žirmūnėliai;EŽIUKAI;3006508357;Taip;0;7;2;9
15612;Žirmūnėliai;EŽIUKAI;3150467744;Taip;3;0;11;14
15613;Žirmūnėliai;EŽIUKAI;4986702792;Ne;5;1;0;6
15614;Žirmūnėliai;EŽIUKAI;1273301982;Taip;0;0;2;2
15615;Žirmūnėliai;EŽIUKAI;1308593517;Taip;0;1;0;1
15616;Žirmūnėliai;EŽIUKAI;1626619024;Taip;0;2;0;2
15617;Žirmūnėliai;EŽIUKAI;1183883183;Taip;0;11;0;11
15618;Žirmūnėliai;EŽIUKAI;7929881052;Ne;0;2;1;3
15619;Žirmūnėliai;EŽIUKAI;5673929155;Taip;0;2;0;2
15620;Žirmūnėliai;EŽIUKAI;53028161711;Taip;0;5;5;10
15621;Žirmūnėliai;EŽIUKAI;1556389237;Taip;0;4;11;15
15622;Žirmūnėliai;ŽVIRBLIUKAI;2336720944;Taip;0;7;0;7
15623;Žirmūnėliai;ŽVIRBLIUKAI;93072181228;Taip;7;1;0;8
15624;Žirmūnėliai;ŽVIRBLIUKAI;9666769523;Taip;0;2;0;2
15625;Žirmūnėliai;ŽVIRBLIUKAI;4675716163;Taip;0;0;3;3
15626;Žirmūnėliai;ŽVIRBLIUKAI;1110585472;Taip;0;2;0;2
15627;Žirmūnėliai;ŽVIRBLIUKAI;24877884441;Taip;0;1;0;1
15628;Žirmūnėliai;ŽVIRBLIUKAI;155054610;Taip;5;2;0;7
15629;Žirmūnėliai;ŽVIRBLIUKAI;19389343819;Taip;0;1;0;1
15630;Žirmūnėliai;ŽVIRBLIUKAI;35353356752;Ne;0;1;1;2
15631;Žirmūnėliai;ŽVIRBLIUKAI;53081289792;Taip;0;0;1;1
15632;Žirmūnėliai;ŽVIRBLIUKAI;47645482781;Taip;0;0;1;1
15633;Žirmūnėliai;ŽVIRBLIUKAI;9448136354;Taip;0;1;0;1
15634;Žirmūnėliai;ŽVIRBLIUKAI;2216383670;Ne;13;0;0;13
15635;Žirmūnėliai;ŽVIRBLIUKAI;89429083939;Taip;4;2;0;6
15636;Žirmūnėliai;ŽVIRBLIUKAI;8824743884;Taip;0;1;0;1
15637;Žirmūnėliai;ŽVIRBLIUKAI;1961293870;Taip;0;1;0;1
15638;Žirmūnėliai;SPALVELĖS;4330975876;Taip;0;0;3;3
15639;Žirmūnėliai;SPALVELĖS;4710829908;Taip;0;2;0;2
15640;Žirmūnėliai;SPALVELĖS;1865240339;Taip;0;1;0;1
15641;Žirmūnėliai;SPALVELĖS;8339819296;Taip;0;2;0;2
15642;Žirmūnėliai;SPALVELĖS;9482910388;Taip;10;2;0;12
15643;Žirmūnėliai;SPALVELĖS;4815427530;Taip;0;0;5;5
15644;Žirmūnėliai;SPALVELĖS;7087770068;Taip;0;2;2;4
15645;Žirmūnėliai;SPALVELĖS;6641667315;Ne;0;2;0;2
15646;Žirmūnėliai;SPALVELĖS;9936156579;Taip;0;1;0;1
15647;Žirmūnėliai;SPALVELĖS;2985092368;Taip;14;0;0;14
15648;Žirmūnėliai;SPALVELĖS;1158768017;Taip;0;2;2;4
15649;Žirmūnėliai;SPALVELĖS;6306447393;Taip;5;12;0;17
15650;Žirmūnėliai;SPALVELĖS;5154076629;Taip;0;1;0;1
15651;Žirmūnėliai;SPALVELĖS;1401001989;Ne;5;1;0;6
15652;Žirmūnėliai;SPALVELĖS;2841958534;Taip;0;1;0;1
15653;Žirmūnėliai;SPALVELĖS;6259368139;Taip;10;0;1;11
15654;Žirmūnėliai;SPALVELĖS;1356219744;Taip;5;1;0;6
15655;Žirmūnėliai;SPALVELĖS;8538773532;Taip;0;2;1;3
15656;Žirmūnėliai;SPALVELĖS;6934204209;Taip;11;0;0;11
15657;Žirmūnėliai;DEBESĖLIAI;6161223611;Taip;0;1;0;1
15658;Žirmūnėliai;DEBESĖLIAI;31403739893;Taip;0;11;0;11
15659;Žirmūnėliai;DEBESĖLIAI;9926432375;Ne;5;8;0;13
15660;Žirmūnėliai;DEBESĖLIAI;5367009184;Taip;0;0;1;1
15661;Žirmūnėliai;DEBESĖLIAI;1885292520;Ne;0;11;0;11
15662;Žirmūnėliai;DEBESĖLIAI;1618573494;Taip;0;17;0;17
15663;Žirmūnėliai;DEBESĖLIAI;5611315994;Taip;5;1;2;8
15664;Žirmūnėliai;DEBESĖLIAI;2739395691;Ne;0;2;0;2
15665;Žirmūnėliai;DEBESĖLIAI;7528704460;Taip;5;1;2;8
15666;Žirmūnėliai;DEBESĖLIAI;6647641423;Taip;5;0;2;7
15667;Žirmūnėliai;DEBESĖLIAI;3351861764;Taip;0;1;0;1
15668;Žirmūnėliai;DEBESĖLIAI;3540307559;Taip;0;1;0;1
15669;Žirmūnėliai;DEBESĖLIAI;4778339658;Taip;7;7;0;14
15670;Žirmūnėliai;DEBESĖLIAI;1571242696;Ne;5;0;0;5
15671;Žirmūnėliai;DEBESĖLIAI;3431320961;Taip;6;0;0;6
15672;Žirmūnėliai;DEBESĖLIAI;7580002502;Taip;10;0;0;10
15673;Žirmūnėliai;DEBESĖLIAI;6883982889;Taip;0;0;4;4
15674;Žirmūnėliai;VIŠČIUKAI;8592714547;Taip;5;1;0;6
15675;Žirmūnėliai;VIŠČIUKAI;9042509512;Taip;10;0;1;11
15676;Žirmūnėliai;VIŠČIUKAI;1940552890;Taip;0;1;0;1
15677;Žirmūnėliai;VIŠČIUKAI;4347548125;Taip;7;0;0;7
15678;Žirmūnėliai;VIŠČIUKAI;9145626116;Taip;3;0;0;3
15679;Žirmūnėliai;VIŠČIUKAI;7675488865;Taip;14;0;0;14
15680;Žirmūnėliai;VIŠČIUKAI;7777051736;Taip;3;1;1;5
15681;Žirmūnėliai;VIŠČIUKAI;5440814849;Taip;0;1;0;1
15682;Žirmūnėliai;VIŠČIUKAI;8444883234;Taip;12;0;3;15
15683;Žirmūnėliai;VIŠČIUKAI;5676730437;Taip;4;0;0;4
15684;Žirmūnėliai;VIŠČIUKAI;4653124134;Taip;0;0;3;3
15685;Žirmūnėliai;VIŠČIUKAI;4501490189;Taip;5;0;0;5
15686;Žirmūnėliai;VIŠČIUKAI;7680479258;Taip;5;0;0;5
15687;Žirmūnėliai;VIŠČIUKAI;2392106040;Taip;0;1;0;1
15688;Žirmūnėliai;ZUIKUČIŲ;5560694124;Taip;0;0;1;1
15689;Žirmūnėliai;ZUIKUČIŲ;6116321928;Taip;5;0;1;6
15690;Žirmūnėliai;ZUIKUČIŲ;2310523676;Ne;0;9;0;9
15691;Žirmūnėliai;ZUIKUČIŲ;3646039695;Ne;1;0;0;1
15692;Žirmūnėliai;ZUIKUČIŲ;1948299433;Taip;0;0;1;1
15693;Žirmūnėliai;ZUIKUČIŲ;3902161368;Taip;5;0;1;6
15694;Žirmūnėliai;ZUIKUČIŲ;4793967980;Taip;0;1;0;1
15695;Žirmūnėliai;ZUIKUČIŲ;4069657268;Taip;0;0;1;1
15696;Žirmūnėliai;ZUIKUČIŲ;6072407337;Ne;14;0;2;16
15697;Žirmūnėliai;OBUOLIUKAI;4575123456;Taip;3;0;0;3
15698;Žirmūnėliai;OBUOLIUKAI;3795476732;Ne;8;0;0;8
15699;Žirmūnėliai;OBUOLIUKAI;9306935083;Ne;14;0;1;15
15700;Žirmūnėliai;OBUOLIUKAI;1917500190;Taip;5;2;0;7
15701;Žirmūnėliai;OBUOLIUKAI;9002868728;Taip;0;0;1;1
15702;Žirmūnėliai;OBUOLIUKAI;7059249540;Taip;16;0;0;16
15703;Žirmūnėliai;OBUOLIUKAI;4999561481;Taip;0;11;0;11
15704;Žirmūnėliai;OBUOLIUKAI;4802771311;Taip;7;0;2;9
15705;Žirmūnėliai;OBUOLIUKAI;6358006462;Taip;13;0;1;14
15706;Žirmūnėliai;OBUOLIUKAI;9213372991;Taip;11;0;0;11
15707;Žirmūnėliai;OBUOLIUKAI;3949374730;Taip;4;0;3;7
15708;Žirmūnėliai;OBUOLIUKAI;6869102228;Taip;0;0;1;1
15709;Žirmūnėliai;OBUOLIUKAI;9367849317;Taip;1;0;0;1
15710;Žirmūnėliai;OBUOLIUKAI;1523231731;Ne;10;0;0;10
15711;Dainorėliai;VARPELIAI;31902102771;Taip;0;2;2;4
15712;Dainorėliai;VARPELIAI;88781762328;Taip;7;2;3;12
15713;Dainorėliai;VARPELIAI;5693385617;Ne;0;2;0;2
15714;Dainorėliai;VARPELIAI;5959380807;Ne;2;0;0;2
15715;Dainorėliai;VARPELIAI;2074070030;Ne;0;2;3;5
15716;Dainorėliai;VARPELIAI;4591161640;Taip;0;2;0;2
15717;Dainorėliai;ŽIOGELIAI;5591598390;Taip;0;2;1;3
15718;Dainorėliai;ŽIOGELIAI;2450726148;Taip;0;5;0;5
15719;Dainorėliai;ŽIOGELIAI;4431804759;Ne;0;2;0;2
15720;Dainorėliai;ŽIOGELIAI;3897725337;Taip;5;0;0;5
15721;Dainorėliai;ŽIOGELIAI;3598951899;Taip;10;0;0;10
15722;Dainorėliai;ŽIOGELIAI;1326060123;Taip;5;0;2;7
15723;Dainorėliai;ŽIOGELIAI;7591953671;Taip;10;0;0;10
15724;Dainorėliai;ŽIOGELIAI;4973241539;Taip;6;0;0;6
15725;Dainorėliai;ŽIOGELIAI;6169434322;Taip;0;1;0;1
15726;Dainorėliai;ŽIOGELIAI;2094849111;Ne;4;2;0;6
15727;Dainorėliai;ŽIOGELIAI;3887433142;Ne;0;2;5;7
15728;Dainorėliai;ŽIOGELIAI;8239000041;Taip;0;2;4;6
15729;Dainorėliai;ŽIOGELIAI;7984447187;Ne;0;0;2;2
15730;Dainorėliai;DRUGELIAI;65253606353;Taip;0;1;0;1
15731;Dainorėliai;DRUGELIAI;6411939690;Taip;0;5;4;9
15732;Dainorėliai;DRUGELIAI;2483267929;Taip;0;2;0;2
15733;Dainorėliai;DRUGELIAI;1015870220;Taip;0;1;0;1
15734;Dainorėliai;DRUGELIAI;6404337541;Taip;0;11;0;11
15735;Dainorėliai;DRUGELIAI;94480397292;Taip;0;1;0;1
15736;Dainorėliai;DRUGELIAI;53935690864;Taip;0;1;0;1
15737;Dainorėliai;DRUGELIAI;27521381629;Taip;0;0;5;5
15738;Dainorėliai;DRUGELIAI;5238082419;Taip;0;0;1;1
15739;Dainorėliai;DRUGELIAI;49483881135;Ne;4;1;0;5
15740;Dainorėliai;DRUGELIAI;1158895670;Ne;0;3;0;3
15741;Dainorėliai;DRUGELIAI;3128897752;Taip;4;0;0;4
15742;Dainorėliai;DRUGELIAI;1357413314;Taip;0;1;0;1
15743;Dainorėliai;DRUGELIAI;1515552402;Taip;0;21;0;21
15744;Dainorėliai;DRUGELIAI;1333499160;Ne;0;1;0;1
15745;Dainorėliai;DRUGELIAI;73386013083;Ne;0;4;0;4
15746;Dainorėliai;DRUGELIAI;2287353933;Taip;0;4;0;4
15747;Dainorėliai;DRUGELIAI;5479496104;Taip;0;3;0;3
15748;Dainorėliai;"1 klasė";67124516230;Ne;0;1;0;1
15749;Dainorėliai;"1 klasė";1470784692;Taip;0;1;0;1
15750;Dainorėliai;"1 klasė";45577031767;Taip;0;1;0;1
15751;Dainorėliai;"1 klasė";58071607976;Taip;0;1;0;1
15752;Dainorėliai;"1 klasė";29132059636;Taip;0;1;0;1
15753;Dainorėliai;"1 klasė";32573583030;Taip;0;1;0;1
15754;Dainorėliai;"1 klasė";97947842490;Taip;0;1;0;1
15755;Dainorėliai;"1 klasė";63211091321;Taip;0;1;0;1
15756;Dainorėliai;"1 klasė";87717571411;Taip;0;1;0;1
15757;Dainorėliai;"1 klasė";18936645521;Ne;0;1;0;1
15758;Dainorėliai;"1 klasė";80499999855;Ne;0;1;0;1
15759;Dainorėliai;"1 klasė";35134511946;Taip;0;1;0;1
15760;Dainorėliai;"1 klasė";1121139222;Ne;0;1;0;1
15761;Dainorėliai;"1 klasė";99597416067;Taip;0;1;0;1
15762;Dainorėliai;"3 klasė";6203511535;Ne;2;0;0;2
15763;Dainorėliai;"3 klasė";23144978287;Taip;2;0;0;2
15764;Dainorėliai;"3 klasė";69409530494;Taip;1;0;0;1
15765;Dainorėliai;"3 klasė";93738984644;Taip;1;0;0;1
15766;Dainorėliai;"3 klasė";81956978417;Taip;1;0;0;1
15767;Dainorėliai;"3 klasė";91457137356;Taip;1;0;0;1
15768;Dainorėliai;"3 klasė";3018657993;Taip;1;0;0;1
15769;Dainorėliai;"3 klasė";57618865048;Ne;1;0;0;1
15770;Dainorėliai;"4 klasė";9028699114;Taip;0;1;0;1
15771;Dainorėliai;"4 klasė";1629229178;Ne;2;1;0;3
15772;Dainorėliai;"4 klasė";3109138914;Taip;0;1;0;1
15773;Dainorėliai;"4 klasė";6513001151;Taip;0;1;0;1
15774;Dainorėliai;"4 klasė";7332518731;Taip;0;1;0;1
15775;Dainorėliai;"4 klasė";7013545705;Taip;0;1;0;1
15776;Dainorėliai;"4 klasė";7589862952;Taip;0;1;0;1
15777;Dainorėliai;"4 klasė";2135997501;Taip;1;1;0;2
15778;Dainorėliai;"4 klasė";2991348691;Taip;5;1;0;6
15779;Dainorėliai;"4 klasė";1472986325;Ne;1;1;0;2
15780;Dainorėliai;"4 klasė";9691052273;Taip;0;1;0;1
15781;Dainorėliai;"4 klasė";4631981231;Taip;1;1;0;2
15782;Dainorėliai;"4 klasė";6576505338;Ne;0;1;0;1
15783;Dainorėliai;"4 klasė";47031645815;Ne;0;1;0;1
15784;Dainorėliai;"4 klasė";1734712911;Taip;0;1;0;1
15785;Dainorėliai;"4 klasė";6898321145;Taip;0;1;0;1
15786;Dainorėliai;"4 klasė";8014881349;Taip;0;1;0;1
15787;Dainorėliai;"4 klasė";2685423821;Taip;3;1;0;4
15788;Dainorėliai;"4 klasė";3713835329;Taip;0;1;0;1
15789;Dainorėliai;"4 klasė";4309610318;Taip;0;1;0;1
15790;Dainorėliai;"4 klasė";13507421714;Taip;3;0;0;3
15791;Dainorėliai;SAULUTĖS;4798415786;Ne;0;2;0;2
15792;Dainorėliai;SAULUTĖS;6385439136;Ne;1;0;0;1
15793;Dainorėliai;SAULUTĖS;6704354150;Taip;5;0;0;5
15794;Dainorėliai;SAULUTĖS;4612995336;Taip;8;0;0;8
15795;Dainorėliai;SAULUTĖS;5687390372;Ne;3;0;0;3
15796;Dainorėliai;SAULUTĖS;6697149560;Taip;0;1;0;1
15797;Dainorėliai;SAULUTĖS;8857018998;Ne;4;0;0;4
15798;Dainorėliai;SAULUTĖS;7118473669;Taip;4;1;0;5
15799;Dainorėliai;SAULUTĖS;4307591123;Taip;0;1;0;1
15800;Dainorėliai;SAULUTĖS;2070086316;Taip;0;1;0;1
15801;Dainorėliai;SAULUTĖS;7804441689;Taip;5;0;0;5
15802;Dainorėliai;SAULUTĖS;5410183494;Taip;8;0;0;8
15803;Dainorėliai;SAULUTĖS;9130473411;Ne;0;0;2;2
15804;Dainorėliai;SAULUTĖS;5587907483;Taip;8;1;0;9
15805;Dainorėliai;SAULUTĖS;1547686786;Ne;12;0;0;12
15806;Dainorėliai;SAULUTĖS;3762178533;Taip;0;1;0;1
15807;Dainorėliai;SAULUTĖS;2064843848;Taip;8;0;0;8
15808;Dainorėliai;PUMPURĖLIŲ;6513417505;Ne;7;2;0;9
15809;Dainorėliai;PUMPURĖLIŲ;8015545426;Ne;0;0;1;1
15810;Dainorėliai;PUMPURĖLIŲ;5691833295;Taip;0;16;8;24
15811;Dainorėliai;PUMPURĖLIŲ;4033317616;Ne;8;0;0;8
15812;Dainorėliai;PUMPURĖLIŲ;6284140548;Ne;8;1;0;9
15813;Dainorėliai;PUMPURĖLIŲ;4560328911;Ne;0;0;1;1
15814;Dainorėliai;PUMPURĖLIŲ;2215481883;Ne;0;0;1;1
15815;Dainorėliai;PUMPURĖLIŲ;3561729784;Ne;0;0;2;2
15816;Dainorėliai;PUMPURĖLIŲ;2534758615;Taip;10;6;0;16
15817;Dainorėliai;PUMPURĖLIŲ;4286864865;Ne;3;6;0;9
15818;Dainorėliai;PUMPURĖLIŲ;1554081754;Ne;14;0;1;15
15819;Dainorėliai;PUMPURĖLIŲ;9562194143;Ne;0;7;0;7
15820;Dainorėliai;PUMPURĖLIŲ;1233029451;Ne;0;8;0;8
15821;Dainorėliai;PUMPURĖLIŲ;4255893222;Ne;0;0;1;1
15822;Dainorėliai;DEBESĖLIŲ;1300411811;Ne;0;4;0;4
15823;Dainorėliai;DEBESĖLIŲ;2003536788;Taip;0;4;0;4
15824;Dainorėliai;DEBESĖLIŲ;40762091796;Ne;0;4;0;4
15825;Dainorėliai;DEBESĖLIŲ;42514000113;Taip;0;1;0;1
15826;Dainorėliai;DEBESĖLIŲ;74139269246;Ne;1;0;0;1
15827;Dainorėliai;DEBESĖLIŲ;25015347703;Taip;0;8;0;8
15828;Dainorėliai;DEBESĖLIŲ;2095914442;Ne;0;1;0;1
15829;Dainorėliai;DEBESĖLIŲ;3271090533;Ne;0;8;0;8
15830;Dainorėliai;DEBESĖLIŲ;5576016171;Ne;19;0;0;19
15831;Dainorėliai;DEBESĖLIŲ;36311288300;Ne;0;19;0;19
15832;Dainorėliai;DEBESĖLIŲ;5283566263;Ne;0;1;0;1
15833;Lokiukas;BITUTĖS;6758550653;Taip;0;7;1;8
15834;Lokiukas;BITUTĖS;1040288021;Taip;0;6;0;6
15835;Lokiukas;BITUTĖS;6336140882;Taip;0;14;0;14
15836;Lokiukas;BITUTĖS;8775608581;Taip;4;0;1;5
15837;Lokiukas;BITUTĖS;1752784666;Taip;10;1;0;11
15838;Lokiukas;BITUTĖS;34546519642;Taip;4;0;0;4
15839;Lokiukas;BITUTĖS;7305062511;Taip;4;0;0;4
15840;Lokiukas;BITUTĖS;1025576053;Taip;5;0;0;5
15841;Lokiukas;BITUTĖS;6069516217;Taip;0;6;0;6
15842;Lokiukas;BITUTĖS;7943213321;Taip;0;9;0;9
15843;Lokiukas;BITUTĖS;8915504279;Taip;0;1;2;3
15844;Lokiukas;BITUTĖS;4007839265;Taip;0;1;1;2
15845;Lokiukas;BITUTĖS;8796640190;Taip;0;0;2;2
15846;Lokiukas;BITUTĖS;5943412920;Taip;0;1;1;2
15847;Lokiukas;BITUTĖS;3694653020;Taip;7;1;0;8
15848;Lokiukas;BITUTĖS;4379238557;Taip;0;4;0;4
15849;Lokiukas;BITUTĖS;2052174669;Taip;10;1;0;11
15850;Lokiukas;BITUTĖS;8902619265;Taip;8;0;0;8
15851;Lokiukas;BITUTĖS;9336617879;Taip;8;1;2;11
15852;Lokiukas;BITUTĖS;3485639108;Ne;0;1;1;2
15853;Lokiukas;BITUTĖS;4060641736;Ne;0;1;0;1
15854;Lokiukas;BITUTĖS;9501202273;Ne;2;1;1;4
15855;Lokiukas;"1 B klasė";7235277422;Taip;7;0;0;7
15856;Lokiukas;"1 B klasė";1133294157;Taip;1;0;0;1
15857;Lokiukas;"1 B klasė";1072148409;Taip;1;0;0;1
15858;Lokiukas;"1 B klasė";57505829630;Taip;1;0;0;1
15859;Lokiukas;"1 B klasė";7334971595;Taip;7;0;0;7
15860;Lokiukas;"1 B klasė";51059574159;Taip;3;0;0;3
15861;Lokiukas;"1 B klasė";2959877846;Taip;21;0;0;21
15862;Lokiukas;"1 B klasė";7130407913;Taip;21;0;0;21
15863;Lokiukas;"1 B klasė";7628603262;Taip;1;0;0;1
15864;Lokiukas;"1 B klasė";61807094999;Taip;1;0;0;1
15865;Lokiukas;"1 B klasė";32714964224;Taip;1;0;0;1
15866;Lokiukas;"1 B klasė";8920359311;Taip;4;0;0;4
15867;Lokiukas;"1 B klasė";92373834478;Ne;6;0;0;6
15868;Lokiukas;"1 B klasė";2054450461;Taip;8;0;0;8
15869;Lokiukas;"1 B klasė";14234831040;Taip;8;0;0;8
15870;Lokiukas;"1 B klasė";4662981914;Taip;14;0;0;14
15871;Lokiukas;"1 B klasė";6414861823;Ne;20;0;0;20
15872;Lokiukas;"1 B klasė";98045145204;Taip;1;0;0;1
15873;Lokiukas;"1 B klasė";68390568000;Taip;1;0;0;1
15874;Lokiukas;"1 B klasė";14937983736;Taip;1;0;0;1
15875;Lokiukas;"1 B klasė";8996622650;Taip;5;0;0;5
15876;Lokiukas;"1 B klasė";2078673522;Taip;6;0;0;6
15877;Lokiukas;"1 B klasė";3255141230;Ne;19;0;0;19
15878;Lokiukas;"1 B klasė";3255141230;Ne;19;0;0;19
15879;Lokiukas;"1 B klasė";8980902068;Ne;5;0;0;5
15880;Lokiukas;"1 B klasė";4164426360;Ne;7;0;0;7
15881;Lokiukas;"1 A klasė";83279104490;Taip;21;0;0;21
15882;Lokiukas;"1 A klasė";38884246104;Ne;5;0;0;5
15883;Lokiukas;"1 A klasė";1201125655;Taip;3;0;0;3
15884;Lokiukas;"1 A klasė";67133709394;Taip;7;0;0;7
15885;Lokiukas;"1 A klasė";73696992182;Taip;3;0;0;3
15886;Lokiukas;"1 A klasė";1056075876;Taip;1;0;0;1
15887;Lokiukas;"1 A klasė";82025637099;Taip;3;0;0;3
15888;Lokiukas;"1 A klasė";8846527481;Taip;7;0;0;7
15889;Lokiukas;"1 A klasė";4353695640;Ne;2;0;0;2
15890;Lokiukas;"1 A klasė";73515179103;Taip;3;0;0;3
15891;Lokiukas;"1 A klasė";36677665098;Taip;2;0;0;2
15892;Lokiukas;"1 A klasė";131300206;Taip;8;0;0;8
15893;Lokiukas;"1 A klasė";66528256040;Taip;3;0;0;3
15894;Lokiukas;"1 A klasė";83528495608;Ne;5;0;0;5
15895;Lokiukas;"1 A klasė";1333650630;Ne;6;0;0;6
15896;Lokiukas;"1 A klasė";52940830874;Taip;3;0;0;3
15897;Lokiukas;"1 A klasė";8240261104;Taip;2;0;0;2
15898;Lokiukas;"1 A klasė";41809745552;Taip;21;0;0;21
15899;Lokiukas;"1 A klasė";83086633109;Taip;21;0;0;21
15900;Lokiukas;GUDRUČIAI;1570438208;Taip;0;0;1;1
15901;Lokiukas;GUDRUČIAI;47399326083;Taip;0;7;1;8
15902;Lokiukas;GUDRUČIAI;4569798381;Taip;12;0;0;12
15903;Lokiukas;GUDRUČIAI;3070998871;Taip;0;0;1;1
15904;Lokiukas;GUDRUČIAI;2548712970;Taip;0;8;0;8
15905;Lokiukas;GUDRUČIAI;8399364170;Taip;3;0;2;5
15906;Lokiukas;GUDRUČIAI;4427448272;Taip;11;0;0;11
15907;Lokiukas;GUDRUČIAI;4580716838;Taip;6;0;1;7
15908;Lokiukas;GUDRUČIAI;1381505711;Taip;0;5;0;5
15909;Lokiukas;GUDRUČIAI;5453470660;Taip;3;11;0;14
15910;Lokiukas;GUDRUČIAI;39975872119;Taip;5;0;0;5
15911;Lokiukas;GUDRUČIAI;8568285232;Taip;0;1;0;1
15912;Lokiukas;GUDRUČIAI;7591418969;Taip;3;2;0;5
15913;Lokiukas;BORUŽĖLĖS;4849031542;Taip;0;6;0;6
15914;Lokiukas;BORUŽĖLĖS;9307491947;Taip;5;1;0;6
15915;Lokiukas;BORUŽĖLĖS;3744484616;Taip;2;0;4;6
15916;Lokiukas;BORUŽĖLĖS;8286358519;Taip;0;12;0;12
15917;Lokiukas;BORUŽĖLĖS;2625981190;Taip;0;13;0;13
15918;Lokiukas;BORUŽĖLĖS;4585621105;Taip;10;1;0;11
15919;Lokiukas;BORUŽĖLĖS;8576418875;Taip;10;5;0;15
15920;Lokiukas;BORUŽĖLĖS;4617372387;Taip;5;0;0;5
15921;Lokiukas;BORUŽĖLĖS;6869785650;Taip;5;6;0;11
15922;Lokiukas;BORUŽĖLĖS;8630112458;Taip;14;0;0;14
15923;Lokiukas;BORUŽĖLĖS;5467387832;Taip;9;1;0;10
15924;Lokiukas;BORUŽĖLĖS;3930463578;Taip;0;6;1;7
15925;Lokiukas;BORUŽĖLĖS;3333990952;Taip;5;1;0;6
15926;Lokiukas;BORUŽĖLĖS;5548875714;Taip;10;0;0;10
15927;Lokiukas;BORUŽĖLĖS;2660616022;Taip;2;1;0;3
15928;Lokiukas;BORUŽĖLĖS;9798351980;Taip;0;0;2;2
15929;Lokiukas;BORUŽĖLĖS;5401463671;Ne;10;0;0;10
15930;Lokiukas;BORUŽĖLĖS;9996442005;Ne;10;0;0;10
15931;Lokiukas;BORUŽĖLĖS;4317453894;Taip;3;0;0;3
15932;Lokiukas;BORUŽĖLĖS;1226376844;Ne;0;1;2;3
15933;Lokiukas;BORUŽĖLĖS;4840187188;Taip;6;0;0;6
15934;Lokiukas;BORUŽĖLĖS;6516980498;Ne;0;10;1;11
15935;Lokiukas;ANČIUKAI;3397999534;Taip;0;0;5;5
15936;Lokiukas;ANČIUKAI;3329205450;Taip;0;14;0;14
15937;Lokiukas;ANČIUKAI;2126391728;Taip;0;10;0;10
15938;Lokiukas;ANČIUKAI;4551069961;Taip;0;2;1;3
15939;Lokiukas;ANČIUKAI;8059759103;Taip;0;1;0;1
15940;Lokiukas;ANČIUKAI;5217458476;Taip;2;2;0;4
15941;Lokiukas;ANČIUKAI;6260486656;Taip;0;11;0;11
15942;Lokiukas;ANČIUKAI;9480025132;Taip;0;1;0;1
15943;Lokiukas;ANČIUKAI;6883994020;Taip;6;4;1;11
15944;Lokiukas;ANČIUKAI;1987485885;Ne;7;3;0;10
15945;Lokiukas;ANČIUKAI;2671053309;Taip;0;3;0;3
15946;Lokiukas;KODĖLČIUKAI;1606617694;Ne;5;3;0;8
15947;Lokiukas;KODĖLČIUKAI;8243342948;Taip;0;8;0;8
15948;Lokiukas;KODĖLČIUKAI;3991821717;Ne;7;0;0;7
15949;Lokiukas;KODĖLČIUKAI;69364831994;Taip;0;0;1;1
15950;Lokiukas;KODĖLČIUKAI;1230490562;Ne;6;0;8;14
15951;Lokiukas;KODĖLČIUKAI;5528406839;Ne;0;1;0;1
15952;Lokiukas;KODĖLČIUKAI;8036643654;Taip;7;0;0;7
15953;Lokiukas;KODĖLČIUKAI;8452600632;Taip;0;13;0;13
15954;Lokiukas;KODĖLČIUKAI;46838695582;Taip;0;11;0;11
15955;Lokiukas;KODĖLČIUKAI;5879386524;Taip;5;0;1;6
15956;Lokiukas;KODĖLČIUKAI;39222094073;Taip;0;0;2;2
15957;Lokiukas;KODĖLČIUKAI;74169282323;Taip;0;2;0;2
15958;Lokiukas;KODĖLČIUKAI;2476231041;Ne;7;0;0;7
15959;Lokiukas;KODĖLČIUKAI;35890122494;Taip;0;3;0;3
15960;Lokiukas;KODĖLČIUKAI;1626698185;Ne;3;1;0;4
15961;Lokiukas;KODĖLČIUKAI;1625137322;Taip;0;3;0;3
15962;Lokiukas;KODĖLČIUKAI;2642065594;Taip;5;3;0;8
15963;Lokiukas;KODĖLČIUKAI;1210407640;Taip;1;2;0;3
15964;Lokiukas;KODĖLČIUKAI;7942641594;Ne;0;0;1;1
15965;Lokiukas;DRUGELIAI;1170293017;Taip;16;0;2;18
15966;Lokiukas;DRUGELIAI;4442073527;Taip;0;5;0;5
15967;Lokiukas;DRUGELIAI;2021477393;Taip;5;2;0;7
15968;Lokiukas;DRUGELIAI;4206181176;Taip;2;1;0;3
15969;Lokiukas;DRUGELIAI;7006828256;Taip;5;0;0;5
15970;Lokiukas;DRUGELIAI;7532603655;Taip;0;18;0;18
15971;Lokiukas;DRUGELIAI;4858829710;Taip;14;1;0;15
15972;Lokiukas;DRUGELIAI;8329540746;Taip;5;0;0;5
15973;Lokiukas;DRUGELIAI;2782818158;Taip;9;2;1;12
15974;Lokiukas;DRUGELIAI;4197547631;Taip;7;6;0;13
15975;Lokiukas;DRUGELIAI;8596706753;Taip;11;2;0;13
15976;Lokiukas;DRUGELIAI;4272205822;Taip;5;0;0;5
15977;Lokiukas;DRUGELIAI;2374601283;Taip;3;0;0;3
15978;Lokiukas;DRUGELIAI;7195184433;Taip;10;0;0;10
15979;Lokiukas;DRUGELIAI;4919744559;Ne;15;0;0;15
15980;Lokiukas;DRUGELIAI;6226281752;Taip;5;2;0;7
15981;Lokiukas;DRUGELIAI;1390586527;Taip;10;0;0;10
15982;Lokiukas;DRUGELIAI;9899561161;Taip;7;5;0;12
15983;Lokiukas;DRUGELIAI;2093224908;Taip;10;2;0;12
15984;Lokiukas;DRUGELIAI;1341265560;Taip;6;0;0;6
15985;Lokiukas;"2 A klasė";25170045140;Ne;21;0;0;21
15986;Lokiukas;"2 A klasė";15406362908;Taip;1;0;0;1
15987;Lokiukas;"2 A klasė";45122233067;Taip;1;0;0;1
15988;Lokiukas;"2 A klasė";15685936471;Taip;1;0;0;1
15989;Lokiukas;"2 A klasė";10948160841;Taip;21;0;0;21
15990;Lokiukas;"2 A klasė";21802863853;Taip;1;0;0;1
15991;Lokiukas;"2 A klasė";84682977618;Taip;1;0;0;1
15992;Lokiukas;"2 A klasė";22979689191;Taip;2;0;0;2
15993;Lokiukas;"2 A klasė";80754592972;Taip;2;0;0;2
15994;Lokiukas;"2 A klasė";14903100496;Ne;1;0;0;1
15995;Lokiukas;"2 A klasė";97609897018;Taip;1;0;0;1
15996;Lokiukas;"2 A klasė";4608275224;Taip;4;0;0;4
15997;Lokiukas;"2 A klasė";99706061553;Taip;1;0;0;1
15998;Lokiukas;"2 A klasė";7785940412;Taip;21;0;0;21
15999;Lokiukas;"2 A klasė";24099693663;Taip;4;0;0;4
16000;Lokiukas;"2 A klasė";72092394330;Taip;6;0;0;6
16001;Lokiukas;"2 A klasė";35769782473;Taip;9;0;0;9
16002;Lokiukas;"2 A klasė";23688235312;Taip;4;0;0;4
16003;Lokiukas;"2 A klasė";43070670534;Taip;1;0;0;1
16004;Lokiukas;"2 A klasė";38531751377;Taip;1;0;0;1
16005;Lokiukas;"2 A klasė";15574258138;Taip;1;0;0;1
16006;Lokiukas;"2 A klasė";59840033826;Taip;5;0;0;5
16007;Lokiukas;"2 A klasė";84273668685;Taip;1;0;0;1
16008;Lokiukas;"2 A klasė";9077016953;Taip;1;0;0;1
16009;Lokiukas;"2 A klasė";9747265775;Taip;1;0;0;1
16010;Lokiukas;"2 A klasė";5198408183;Taip;1;0;0;1
16011;Lokiukas;"2 A klasė";80793623068;Ne;6;0;0;6
16012;Lokiukas;"2 A klasė";93374754851;Ne;1;0;0;1
16013;Lokiukas;"2 B klasė";61890775725;Taip;1;0;0;1
16014;Lokiukas;"2 B klasė";32506466236;Taip;1;0;0;1
16015;Lokiukas;"2 B klasė";24221829774;Taip;1;0;0;1
16016;Lokiukas;"2 B klasė";96046361641;Taip;7;0;0;7
16017;Lokiukas;"2 B klasė";7324496782;Taip;21;0;0;21
16018;Lokiukas;"2 B klasė";95910336503;Taip;1;0;0;1
16019;Lokiukas;"2 B klasė";58513885211;Taip;3;0;0;3
16020;Lokiukas;"2 B klasė";57958699478;Ne;4;0;0;4
16021;Lokiukas;"2 B klasė";10811780420;Taip;1;0;0;1
16022;Lokiukas;"2 B klasė";18646642032;Taip;3;0;0;3
16023;Lokiukas;"2 B klasė";79109699217;Taip;2;0;0;2
16024;Lokiukas;"2 B klasė";50713289266;Taip;5;0;0;5
16025;Lokiukas;"2 B klasė";20231469825;Ne;2;0;0;2
16026;Lokiukas;"2 B klasė";18336619115;Taip;7;0;0;7
16027;Lokiukas;"2 B klasė";2105377652;Taip;1;0;0;1
16028;Lokiukas;"2 B klasė";39867459515;Taip;8;0;0;8
16029;Lokiukas;"2 B klasė";1146878499;Taip;1;0;0;1
16030;Lokiukas;"2 B klasė";46587243900;Ne;1;0;0;1
16031;Lokiukas;"2 B klasė";62268017779;Taip;1;0;0;1
16032;Lokiukas;"2 B klasė";28796727185;Taip;2;0;0;2
16033;Lokiukas;"2 B klasė";88415635113;Taip;2;0;0;2
16034;Lokiukas;"2 B klasė";9141446821;Taip;6;0;0;6
16035;Lokiukas;"2 B klasė";7497324442;Taip;21;0;0;21
16036;Lokiukas;"2 B klasė";7903535850;Taip;1;0;0;1
16037;Lokiukas;"2 B klasė";75507005694;Taip;1;0;0;1
16038;Lokiukas;"2 B klasė";73426072972;Ne;1;0;0;1
16039;Lokiukas;"2 B klasė";59913848400;Taip;2;0;0;2
16040;Lokiukas;"3 A klasė";67818191566;Taip;1;0;0;1
16041;Lokiukas;"3 A klasė";45280536946;Taip;21;0;0;21
16042;Lokiukas;"3 A klasė";53087036306;Taip;21;0;0;21
16043;Lokiukas;"3 A klasė";79223457439;Ne;4;0;0;4
16044;Lokiukas;"3 A klasė";75613665040;Taip;1;0;0;1
16045;Lokiukas;"3 A klasė";10240586503;Taip;21;0;0;21
16046;Lokiukas;"3 A klasė";1143130271;Taip;21;0;0;21
16047;Lokiukas;"3 A klasė";86623153797;Taip;1;0;0;1
16048;Lokiukas;"3 A klasė";27050402360;Ne;20;0;0;20
16049;Lokiukas;"3 A klasė";43389930516;Taip;1;0;0;1
16050;Lokiukas;"3 A klasė";53245573692;Taip;21;0;0;21
16051;Lokiukas;"3 A klasė";23222644824;Taip;3;0;0;3
16052;Lokiukas;"3 A klasė";52296454506;Ne;1;0;0;1
16053;Lokiukas;"3 A klasė";66999644935;Taip;21;0;0;21
16054;Lokiukas;"3 A klasė";72167964645;Ne;1;0;0;1
16055;Lokiukas;"3 A klasė";2143040924;Taip;1;0;0;1
16056;Lokiukas;"3 A klasė";3206276637;Taip;21;0;0;21
16057;Lokiukas;"3 A klasė";5775631777;Ne;1;0;0;1
16058;Lokiukas;"3 A klasė";3703002168;Taip;2;0;0;2
16059;Lokiukas;"3 A klasė";25058082693;Taip;1;0;0;1
16060;Lokiukas;"3 A klasė";38636200254;Ne;1;0;0;1
16061;Lokiukas;"3 A klasė";47410036889;Taip;1;0;0;1
16062;Lokiukas;"3 A klasė";53544600623;Taip;1;0;0;1
16063;Lokiukas;"3 A klasė";14341255985;Taip;8;0;0;8
16064;Lokiukas;"3 A klasė";6702448475;Taip;1;0;0;1
16065;Lokiukas;"3 A klasė";82966541165;Taip;1;0;0;1
16066;Lokiukas;"3 A klasė";80180114948;Taip;1;0;0;1
16067;Lokiukas;"3 A klasė";42292408557;Taip;6;0;0;6
16068;Lokiukas;"3 B klasė";35018370441;Taip;1;0;0;1
16069;Lokiukas;"3 B klasė";60370754283;Taip;1;0;0;1
16070;Lokiukas;"3 B klasė";98289469398;Taip;4;0;0;4
16071;Lokiukas;"3 B klasė";15445053855;Taip;18;0;0;18
16072;Lokiukas;"3 B klasė";3262579895;Taip;1;0;0;1
16073;Lokiukas;"3 B klasė";51554951703;Taip;7;0;0;7
16074;Lokiukas;"3 B klasė";88947878548;Ne;1;0;0;1
16075;Lokiukas;"3 B klasė";29198900240;Taip;1;0;0;1
16076;Lokiukas;"3 B klasė";17034757778;Ne;1;0;0;1
16077;Lokiukas;"3 B klasė";1716358913;Taip;1;0;0;1
16078;Lokiukas;"3 B klasė";77441549037;Taip;2;0;0;2
16079;Lokiukas;"3 B klasė";79301547085;Taip;5;0;0;5
16080;Lokiukas;"3 B klasė";10897713744;Taip;5;0;0;5
16081;Lokiukas;"3 B klasė";16889795010;Taip;1;0;0;1
16082;Lokiukas;"3 B klasė";45805925058;Taip;1;0;0;1
16083;Lokiukas;"3 B klasė";5067673212;Taip;2;0;0;2
16084;Lokiukas;"3 B klasė";1104333637;Taip;2;0;0;2
16085;Lokiukas;"3 B klasė";69089214980;Taip;1;0;0;1
16086;Lokiukas;"3 B klasė";79597160668;Taip;1;0;0;1
16087;Lokiukas;"3 B klasė";45735190114;Taip;1;0;0;1
16088;Lokiukas;"3 B klasė";37669645510;Taip;1;0;0;1
16089;Lokiukas;"3 B klasė";2353550739;Taip;3;0;0;3
16090;Lokiukas;"3 B klasė";15004419516;Taip;2;0;0;2
16091;Lokiukas;"4 A klasė";2374089307;Taip;5;0;0;5
16092;Lokiukas;"4 A klasė";2607988265;Taip;6;0;0;6
16093;Lokiukas;"4 A klasė";4992275038;Taip;6;0;0;6
16094;Lokiukas;"4 A klasė";1492303633;Taip;21;0;0;21
16095;Lokiukas;"4 A klasė";6856770462;Ne;5;0;0;5
16096;Lokiukas;"4 A klasė";8766212402;Ne;21;0;0;21
16097;Lokiukas;"4 A klasė";5559967651;Taip;21;0;0;21
16098;Lokiukas;"4 A klasė";3528533437;Taip;21;0;0;21
16099;Lokiukas;"4 A klasė";5465758477;Taip;2;0;0;2
16100;Lokiukas;"4 A klasė";5700685872;Ne;2;0;0;2
16101;Lokiukas;"4 A klasė";6496662759;Taip;21;0;0;21
16102;Lokiukas;"4 A klasė";5737714024;Ne;8;0;0;8
16103;Lokiukas;"4 A klasė";7069020705;Ne;6;0;0;6
16104;Lokiukas;"4 A klasė";6129602024;Ne;1;0;0;1
16105;Lokiukas;"4 A klasė";9199283952;Taip;21;0;0;21
16106;Lokiukas;"4 A klasė";8378630091;Taip;1;0;0;1
16107;Lokiukas;"4 A klasė";3138145333;Ne;12;0;0;12
16108;Lokiukas;"4 A klasė";3506723678;Taip;2;0;0;2
16109;Lokiukas;"4 A klasė";1555365851;Ne;13;0;0;13
16110;Lokiukas;"4 A klasė";4615481025;Ne;16;0;0;16
16111;Lokiukas;"4 A klasė";5889819809;Ne;1;0;0;1
16112;Lokiukas;"4 A klasė";8499895935;Taip;13;0;0;13
16113;Lokiukas;"4 A klasė";7553457572;Ne;3;0;0;3
16114;Lokiukas;"4 A klasė";1571404671;Taip;3;0;0;3
16115;Lokiukas;"4 A klasė";1729941577;Taip;7;0;0;7
16116;Lokiukas;"4 B klasė";5745254234;Taip;15;0;0;15
16117;Lokiukas;"4 B klasė";8189433550;Taip;21;0;0;21
16118;Lokiukas;"4 B klasė";9114504810;Taip;7;0;0;7
16119;Lokiukas;"4 B klasė";1048772300;Taip;11;0;0;11
16120;Lokiukas;"4 B klasė";2021690274;Taip;1;0;0;1
16121;Lokiukas;"4 B klasė";5918592397;Taip;12;0;0;12
16122;Lokiukas;"4 B klasė";6538311120;Taip;1;0;0;1
16123;Lokiukas;"4 B klasė";7595514531;Taip;1;0;0;1
16124;Lokiukas;"4 B klasė";7144013238;Taip;7;0;0;7
16125;Lokiukas;"4 B klasė";8235437961;Taip;1;0;0;1
16126;Lokiukas;"4 B klasė";2905935730;Taip;21;0;0;21
16127;Lokiukas;"4 B klasė";8395026474;Ne;5;0;0;5
16128;Lokiukas;"4 B klasė";7439047502;Taip;1;0;0;1
16129;Lokiukas;"4 B klasė";8954484534;Taip;1;0;0;1
16130;Lokiukas;"4 B klasė";7722830021;Taip;3;0;0;3
16131;Lokiukas;"4 B klasė";9681048306;Taip;13;0;0;13
16132;Lokiukas;"4 B klasė";1388342336;Taip;1;0;0;1
16133;Lokiukas;"4 B klasė";1746819279;Taip;15;0;0;15
16134;Lokiukas;"4 B klasė";4418425219;Taip;14;0;0;14
16135;Lokiukas;"4 B klasė";3364994110;Taip;21;0;0;21
16136;Lokiukas;"4 B klasė";6063796643;Taip;1;0;0;1
16137;Lokiukas;"4 B klasė";6663700618;Taip;2;0;0;2
16138;Lokiukas;"4 B klasė";1676862169;Ne;11;0;0;11
16139;Lokiukas;"4 B klasė";6151885589;Taip;3;0;0;3
16140;Lokiukas;"4 B klasė";1440437389;Taip;3;0;0;3
16141;Lokiukas;"4 B klasė";2059112380;Taip;2;0;0;2
16142;Šaltinėlis;Ančiukų;9769491789;Taip;0;4;0;4
16143;Šaltinėlis;Ančiukų;56396772538;Taip;0;2;0;2
16144;Šaltinėlis;Ančiukų;6462738640;Taip;0;1;0;1
16145;Šaltinėlis;Ančiukų;3493429067;Taip;0;1;0;1
16146;Šaltinėlis;Ančiukų;77872075694;Taip;0;1;0;1
16147;Šaltinėlis;Ančiukų;7133143923;Taip;0;6;0;6
16148;Šaltinėlis;Ančiukų;9820788524;Taip;0;11;0;11
16149;Šaltinėlis;Ančiukų;3691635011;Ne;0;6;0;6
16150;Šaltinėlis;Ančiukų;2973820849;Ne;0;7;0;7
16151;Šaltinėlis;Ančiukų;6487378225;Ne;4;6;0;10
16152;Šaltinėlis;Ančiukų;1464992631;Taip;0;5;0;5
16153;Šaltinėlis;Ančiukų;9274165569;Taip;0;3;0;3
16154;Šaltinėlis;Ančiukų;8500790262;Taip;6;0;0;6
16155;Šaltinėlis;Ančiukų;4332884673;Taip;0;2;0;2
16156;Šaltinėlis;Ančiukų;9362495172;Ne;0;4;0;4
16157;Šaltinėlis;Ančiukų;7737797979;Taip;0;2;0;2
16158;Šaltinėlis;Ančiukų;6887838949;Taip;9;2;0;11
16159;Šaltinėlis;Ančiukų;2084451705;Ne;11;0;0;11
16160;Šaltinėlis;Ančiukų;5251390843;Taip;0;1;0;1
16161;Šaltinėlis;Bitučių;8902634958;Ne;0;0;5;5
16162;Šaltinėlis;Bitučių;7349722463;Taip;0;0;2;2
16163;Šaltinėlis;Bitučių;3582666579;Taip;8;0;6;14
16164;Šaltinėlis;Bitučių;9595350871;Ne;0;0;2;2
16165;Šaltinėlis;Bitučių;2105963102;Taip;3;0;0;3
16166;Šaltinėlis;Bitučių;5382230695;Ne;0;0;1;1
16167;Šaltinėlis;Bitučių;1130153806;Taip;6;0;0;6
16168;Šaltinėlis;Bitučių;2801321116;Taip;0;8;1;9
16169;Šaltinėlis;Bitučių;1543331408;Taip;0;0;1;1
16170;Šaltinėlis;Bitučių;6880337593;Ne;0;0;3;3
16171;Šaltinėlis;Bitučių;3516760367;Taip;0;0;5;5
16172;Šaltinėlis;Bitučių;7483928256;Taip;4;1;0;5
16173;Šaltinėlis;Bitučių;9757246434;Taip;16;0;0;16
16174;Šaltinėlis;Saulutės;7311831014;Taip;0;1;0;1
16175;Šaltinėlis;Saulutės;5854723120;Taip;0;10;0;10
16176;Šaltinėlis;Saulutės;5833136956;Taip;3;0;1;4
16177;Šaltinėlis;Saulutės;3483756240;Taip;5;0;2;7
16178;Šaltinėlis;Saulutės;6380346298;Taip;0;0;1;1
16179;Šaltinėlis;Saulutės;5799032398;Taip;11;0;0;11
16180;Šaltinėlis;Saulutės;5525740049;Taip;0;0;1;1
16181;Šaltinėlis;Saulutės;1978469605;Ne;15;2;0;17
16182;Šaltinėlis;Saulutės;9762392403;Ne;4;0;1;5
16183;Šaltinėlis;Saulutės;4743907195;Taip;7;0;0;7
16184;Šaltinėlis;Saulutės;5343279219;Ne;10;0;0;10
16185;Šaltinėlis;Saulutės;7118672118;Taip;10;0;1;11
16186;Šaltinėlis;Saulutės;2465009553;Taip;5;0;0;5
16187;Šaltinėlis;Saulutės;9108653045;Taip;0;8;0;8
16188;Šaltinėlis;Saulutės;5345738219;Ne;14;0;0;14
16189;Šaltinėlis;Saulutės;7650840990;Taip;10;0;1;11
16190;Šaltinėlis;Saulutės;3507180650;Ne;11;0;0;11
16191;Šaltinėlis;Saulutės;1678450741;Ne;10;0;0;10
16192;Šaltinėlis;Saulutės;5774391181;Ne;5;0;2;7
16193;Šaltinėlis;Saulutės;4681460322;Ne;5;5;0;10
16194;Šaltinėlis;Meškiukų;8555517284;Taip;6;0;0;6
16195;Šaltinėlis;Meškiukų;2628936055;Taip;11;0;1;12
16196;Šaltinėlis;Meškiukų;5256665649;Taip;5;0;3;8
16197;Šaltinėlis;Meškiukų;2700475528;Taip;0;2;0;2
16198;Šaltinėlis;Meškiukų;9968637187;Taip;5;4;1;10
16199;Šaltinėlis;Meškiukų;6915625306;Ne;5;4;0;9
16200;Šaltinėlis;Meškiukų;6645807642;Ne;3;0;2;5
16201;Šaltinėlis;Meškiukų;9759912102;Taip;0;0;2;2
16202;Šaltinėlis;Meškiukų;4664741207;Taip;17;0;1;18
16203;Šaltinėlis;Meškiukų;1400918201;Ne;10;0;2;12
16204;Šaltinėlis;Meškiukų;5420067622;Taip;0;0;5;5
16205;Šaltinėlis;Meškiukų;4248763165;Ne;0;1;1;2
16206;Šaltinėlis;Meškiukų;5982018366;Taip;15;0;0;15
16207;Šaltinėlis;Meškiukų;9922223978;Ne;4;10;0;14
16208;Šaltinėlis;Meškiukų;8995077908;Taip;0;0;8;8
16209;Šaltinėlis;Meškiukų;6586783795;Taip;14;0;0;14
16210;Šaltinėlis;Meškiukų;8896316882;Taip;4;0;0;4
16211;Šaltinėlis;Meškiukų;7325258256;Ne;0;3;0;3
16212;Šaltinėlis;Nykštukai;1823048790;Ne;8;0;0;8
16213;Šaltinėlis;Nykštukai;9522524163;Ne;9;0;2;11
16214;Šaltinėlis;Nykštukai;1686009371;Taip;15;0;2;17
16215;Šaltinėlis;Nykštukai;9075507649;Taip;12;0;0;12
16216;Šaltinėlis;Nykštukai;7068058767;Ne;0;4;0;4
16217;Šaltinėlis;Nykštukai;8914777163;Taip;14;3;0;17
16218;Šaltinėlis;Nykštukai;7387221265;Taip;5;0;0;5
16219;Šaltinėlis;Nykštukai;3073692882;Taip;0;10;0;10
16220;Šaltinėlis;Nykštukai;2126751248;Taip;10;0;3;13
16221;Šaltinėlis;Nykštukai;7133044918;Taip;13;0;1;14
16222;Šaltinėlis;Nykštukai;2806453623;Taip;0;0;1;1
16223;Šaltinėlis;Nykštukai;8695191968;Taip;4;0;1;5
16224;Šaltinėlis;Nykštukai;8506287076;Ne;1;0;0;1
16225;Šaltinėlis;Nykštukai;2189112609;Taip;17;0;0;17
16226;Šaltinėlis;Nykštukai;5325974488;Taip;0;0;3;3
16227;Šaltinėlis;Nykštukai;1445108285;Taip;6;0;0;6
16228;Šaltinėlis;Nykštukai;9674923143;Taip;6;6;0;12
16229;Šaltinėlis;Nykštukai;7955094634;Taip;0;12;0;12
16230;Šaltinėlis;Nykštukai;9691993251;Taip;0;5;0;5
16231;Šaltinėlis;Perliukų;17147527171;Ne;9;0;0;9
16232;Šaltinėlis;Perliukų;11083638216;Taip;0;4;0;4
16233;Šaltinėlis;Perliukų;1091056386;Taip;0;0;1;1
16234;Šaltinėlis;Perliukų;52507085619;Taip;0;0;1;1
16235;Šaltinėlis;Perliukų;1958647188;Ne;0;0;3;3
16236;Šaltinėlis;Perliukų;1935762293;Taip;0;4;0;4
16237;Šaltinėlis;Perliukų;1583520894;Ne;14;0;1;15
16238;Šaltinėlis;Perliukų;84494627465;Taip;0;1;0;1
16239;Šaltinėlis;Perliukų;98941037508;Taip;0;0;1;1
16240;Šaltinėlis;Perliukų;9425353041;Taip;0;6;0;6
16241;Šaltinėlis;Perliukų;526307704;Taip;0;12;0;12
16242;Šaltinėlis;Perliukų;7262120071;Ne;1;4;0;5
16243;Šaltinėlis;Perliukų;6068980312;Taip;0;0;1;1
16244;Šaltinėlis;Perliukų;5869977541;Taip;0;0;2;2
16245;Šaltinėlis;Perliukų;2333071711;Ne;5;0;0;5
16246;Šaltinėlis;Perliukų;1580090516;Taip;0;0;1;1
16247;Šaltinėlis;BORUŽĖLĖS;1102861619;Ne;4;0;1;5
16248;Šaltinėlis;BORUŽĖLĖS;4226929875;Ne;0;5;0;5
16249;Šaltinėlis;BORUŽĖLĖS;3901200729;Taip;5;0;1;6
16250;Šaltinėlis;BORUŽĖLĖS;2027779524;Taip;12;0;0;12
16251;Šaltinėlis;BORUŽĖLĖS;1312785137;Taip;5;0;2;7
16252;Šaltinėlis;BORUŽĖLĖS;9209105445;Taip;6;0;0;6
16253;Šaltinėlis;BORUŽĖLĖS;9398488555;Taip;0;20;0;20
16254;Šaltinėlis;BORUŽĖLĖS;1928794692;Taip;15;0;0;15
16255;Šaltinėlis;BORUŽĖLĖS;7120592596;Taip;7;0;2;9
16256;Šaltinėlis;BORUŽĖLĖS;9112527921;Taip;0;1;0;1
16257;Šaltinėlis;BORUŽĖLĖS;1489377928;Taip;4;0;1;5
16258;Šaltinėlis;BORUŽĖLĖS;5005394548;Taip;1;0;1;2
16259;Šaltinėlis;BORUŽĖLĖS;6244924079;Taip;0;0;3;3
16260;Šaltinėlis;BORUŽĖLĖS;3806267811;Taip;17;0;0;17
16261;Šaltinėlis;"4B klasė";7142082502;Ne;0;21;0;21
16262;Šaltinėlis;"4B klasė";1756003648;Taip;0;21;0;21
16263;Šaltinėlis;"4B klasė";4141263000;Ne;0;1;0;1
16264;Šaltinėlis;"4B klasė";3863654037;Ne;0;2;0;2
16265;Šaltinėlis;"4B klasė";5776007602;Ne;0;1;0;1
16266;Šaltinėlis;"4B klasė";3037854361;Ne;0;6;0;6
16267;Šaltinėlis;"4B klasė";2089316824;Ne;0;5;0;5
16268;Šaltinėlis;"4B klasė";7420737103;Ne;0;1;0;1
16269;Šaltinėlis;"4B klasė";8380122669;Ne;0;4;0;4
16270;Šaltinėlis;"4B klasė";82404351290;Taip;0;7;0;7
16271;Šaltinėlis;"4B klasė";5999279571;Ne;0;2;0;2
16272;Šaltinėlis;"4B klasė";3329317171;Ne;0;2;0;2
16273;Šaltinėlis;"4B klasė";8219291385;Ne;0;1;0;1
16274;Šaltinėlis;"4B klasė";49275031765;Taip;0;3;0;3
16275;Šaltinėlis;1A;32264290873;Ne;0;3;0;3
16276;Šaltinėlis;1A;1767635282;Taip;0;12;0;12
16277;Šaltinėlis;1A;1390316465;Taip;0;1;0;1
16278;Šaltinėlis;1A;5442943843;Taip;0;1;0;1
16279;Šaltinėlis;1A;6764006747;Taip;0;3;0;3
16280;Šaltinėlis;1A;1658370782;Ne;0;1;0;1
16281;Šaltinėlis;1A;10918276041;Taip;0;1;0;1
16282;Šaltinėlis;1A;3455754351;Taip;0;21;0;21
16283;Šaltinėlis;1A;66575684640;Taip;0;1;0;1
16284;Šaltinėlis;1A;86592374576;Taip;0;21;0;21
16285;Šaltinėlis;1A;13808708760;Taip;0;6;0;6
16286;Šaltinėlis;1A;1614411921;Ne;0;2;0;2
16287;Šaltinėlis;1A;79406746980;Taip;0;1;0;1
16288;Šaltinėlis;1A;3577137327;Taip;0;1;0;1
16289;Šaltinėlis;1A;1224027643;Taip;0;1;0;1
16290;Šaltinėlis;1A;48525545812;Taip;0;2;0;2
16291;Šaltinėlis;1A;7073644279;Taip;0;1;0;1
16292;Šaltinėlis;1A;3022926855;Taip;0;1;0;1
16293;Šaltinėlis;1A;1190394855;Taip;0;1;0;1
16294;Šaltinėlis;1A;1456486363;Taip;0;1;0;1
16295;Šaltinėlis;1A;32949623652;Taip;0;7;0;7
16296;Šaltinėlis;"2A klasė";14213856824;Taip;0;1;0;1
16297;Šaltinėlis;"2A klasė";80649337160;Taip;0;2;0;2
16298;Šaltinėlis;"2A klasė";92958012146;Taip;0;1;0;1
16299;Šaltinėlis;"2A klasė";84656960510;Taip;0;4;0;4
16300;Šaltinėlis;"2A klasė";83621946293;Taip;0;21;0;21
16301;Šaltinėlis;"2A klasė";67808618878;Ne;0;21;0;21
16302;Šaltinėlis;"2A klasė";1278910777;Taip;0;1;0;1
16303;Šaltinėlis;"2A klasė";9647785988;Ne;0;21;0;21
16304;Šaltinėlis;"2A klasė";82671662416;Ne;0;1;0;1
16305;Šaltinėlis;"2A klasė";54025577281;Taip;0;7;0;7
16306;Šaltinėlis;"2A klasė";488285764;Taip;0;1;0;1
16307;Šaltinėlis;"2A klasė";29482180151;Taip;0;1;0;1
16308;Šaltinėlis;"2A klasė";54753218491;Taip;0;1;0;1
16309;Šaltinėlis;"2A klasė";86029472773;Taip;0;1;0;1
16310;Šaltinėlis;"2A klasė";64821172553;Taip;0;3;0;3
16311;Šaltinėlis;"2A klasė";25459069972;Ne;0;2;0;2
16312;Šaltinėlis;"2A klasė";6669392157;Ne;0;1;0;1
16313;Šaltinėlis;"2A klasė";89358384113;Taip;0;5;0;5
16314;Šaltinėlis;"2A klasė";28956971978;Taip;0;1;0;1
16315;Šaltinėlis;"2A klasė";4050444191;Taip;0;1;0;1
16316;Šaltinėlis;"2A klasė";89093437170;Taip;0;1;0;1
16317;Šaltinėlis;"2A klasė";51872331010;Taip;0;3;0;3
16318;Šaltinėlis;"2A klasė";5744976843;Taip;0;1;0;1
16319;Šaltinėlis;"2B klasė";93256161233;Taip;0;1;0;1
16320;Šaltinėlis;"2B klasė";83173349544;Taip;0;1;0;1
16321;Šaltinėlis;"2B klasė";39088869084;Ne;0;2;0;2
16322;Šaltinėlis;"2B klasė";1422035829;Taip;0;21;0;21
16323;Šaltinėlis;"2B klasė";7711903999;Ne;0;1;0;1
16324;Šaltinėlis;"2B klasė";95542489944;Taip;0;1;0;1
16325;Šaltinėlis;"2B klasė";3072314714;Taip;0;9;0;9
16326;Šaltinėlis;"2B klasė";1220687492;Taip;0;1;0;1
16327;Šaltinėlis;"2B klasė";74337710550;Ne;0;1;0;1
16328;Šaltinėlis;"2B klasė";35401075864;Ne;0;21;0;21
16329;Šaltinėlis;"2B klasė";19630605543;Taip;0;1;0;1
16330;Šaltinėlis;"2B klasė";84522552145;Taip;0;1;0;1
16331;Šaltinėlis;"2B klasė";3626545396;Ne;0;4;0;4
16332;Šaltinėlis;"2B klasė";6317111400;Taip;0;2;0;2
16333;Šaltinėlis;"2B klasė";4762756751;Ne;0;6;0;6
16334;Šaltinėlis;"2B klasė";72372808270;Taip;0;1;0;1
16335;Šaltinėlis;"2B klasė";1924418657;Taip;0;1;0;1
16336;Šaltinėlis;"2B klasė";77194317310;Taip;0;1;0;1
16337;Šaltinėlis;"2B klasė";57847832778;Taip;0;10;0;10
16338;Šaltinėlis;"2B klasė";70315400705;Ne;0;1;0;1
16339;Šaltinėlis;"2B klasė";81082410620;Taip;0;1;0;1
16340;Šaltinėlis;"2B klasė";2099800744;Taip;0;5;0;5
16341;Šaltinėlis;"3A klasė";83657465071;Taip;0;1;0;1
16342;Šaltinėlis;"3A klasė";86309198604;Taip;0;1;0;1
16343;Šaltinėlis;"3A klasė";9705941341;Taip;0;2;0;2
16344;Šaltinėlis;"3A klasė";38496350161;Taip;0;21;0;21
16345;Šaltinėlis;"3A klasė";62612067151;Taip;0;7;0;7
16346;Šaltinėlis;"3A klasė";96133834896;Ne;0;21;0;21
16347;Šaltinėlis;"3A klasė";2323456393;Ne;0;21;0;21
16348;Šaltinėlis;"3A klasė";56279691365;Taip;0;1;0;1
16349;Šaltinėlis;"3A klasė";4587186145;Taip;0;1;0;1
16350;Šaltinėlis;"3A klasė";70948186548;Taip;0;1;0;1
16351;Šaltinėlis;"3A klasė";47045578599;Taip;0;6;0;6
16352;Šaltinėlis;"3A klasė";36718328105;Taip;0;1;0;1
16353;Šaltinėlis;"3A klasė";86995081866;Ne;0;21;0;21
16354;Šaltinėlis;"3A klasė";7929809205;Ne;0;2;0;2
16355;Šaltinėlis;"3A klasė";29683761586;Ne;0;2;0;2
16356;Šaltinėlis;"3A klasė";40769315138;Taip;0;3;0;3
16357;Šaltinėlis;"3A klasė";7563879445;Taip;0;1;0;1
16358;Šaltinėlis;"3A klasė";66754907606;Taip;0;21;0;21
16359;Šaltinėlis;"3A klasė";35387543586;Taip;0;10;0;10
16360;Šaltinėlis;"3A klasė";9927833966;Ne;0;2;0;2
16361;Šaltinėlis;"4A klasė";7214517805;Ne;0;21;0;21
16362;Šaltinėlis;"4A klasė";9978493148;Ne;0;1;0;1
16363;Šaltinėlis;"4A klasė";1839665658;Ne;0;1;0;1
16364;Šaltinėlis;"4A klasė";8445115141;Ne;0;1;0;1
16365;Šaltinėlis;"4A klasė";1450894955;Ne;0;21;0;21
16366;Šaltinėlis;"4A klasė";8898225999;Ne;0;21;0;21
16367;Šaltinėlis;"4A klasė";6044895102;Ne;0;1;0;1
16368;Šaltinėlis;"4A klasė";7967108692;Ne;0;4;0;4
16369;Šaltinėlis;"4A klasė";4843823058;Ne;0;6;0;6
16370;Šaltinėlis;"4A klasė";92001008485;Taip;0;6;0;6
16371;Šaltinėlis;"4A klasė";7264810605;Ne;0;3;0;3
16372;Šaltinėlis;"4A klasė";7058348243;Ne;0;1;0;1
16373;Šaltinėlis;"4A klasė";5012608633;Ne;0;2;0;2
16374;Šaltinėlis;"4A klasė";2076892804;Ne;0;1;0;1
16375;Šaltinėlis;"4A klasė";8680271000;Ne;0;7;0;7
16376;Šaltinėlis;"4A klasė";6876036723;Ne;0;1;0;1
16377;Šaltinėlis;"4A klasė";6171441011;Ne;0;21;0;21
16378;Gabijėlė;GANDRIUKŲ;4498088417;Taip;0;4;0;4
16379;Gabijėlė;GANDRIUKŲ;9706026832;Taip;0;1;0;1
16380;Gabijėlė;GANDRIUKŲ;7087892822;Taip;12;0;2;14
16381;Gabijėlė;GANDRIUKŲ;2550300871;Taip;0;5;3;8
16382;Gabijėlė;GANDRIUKŲ;9030890792;Taip;8;0;6;14
16383;Gabijėlė;GANDRIUKŲ;3031333199;Taip;5;0;7;12
16384;Gabijėlė;GANDRIUKŲ;5057272847;Taip;4;2;4;10
16385;Gabijėlė;GANDRIUKŲ;3532989398;Taip;0;1;0;1
16386;Gabijėlė;GANDRIUKŲ;2215880644;Taip;5;0;2;7
16387;Gabijėlė;GANDRIUKŲ;8904768332;Taip;2;0;1;3
16388;Gabijėlė;GANDRIUKŲ;3799003783;Taip;9;0;0;9
16389;Gabijėlė;GANDRIUKŲ;8572833698;Taip;0;0;1;1
16390;Gabijėlė;GANDRIUKŲ;2491503656;Taip;0;4;0;4
16391;Gabijėlė;GANDRIUKŲ;9116153981;Taip;8;0;1;9
16392;Gabijėlė;GANDRIUKŲ;5513530983;Taip;3;0;0;3
16393;Gabijėlė;GANDRIUKŲ;9581539166;Taip;4;0;1;5
16394;Gabijėlė;GANDRIUKŲ;6004026516;Taip;11;0;0;11
16395;Gabijėlė;GANDRIUKŲ;4634029418;Taip;0;2;1;3
16396;Gabijėlė;GANDRIUKŲ;5715645968;Taip;0;0;11;11
16397;Gabijėlė;GANDRIUKŲ;4328252445;Taip;0;2;3;5
16398;Gabijėlė;LAKŠTINGALIUKŲ;7019425859;Taip;6;0;0;6
16399;Gabijėlė;LAKŠTINGALIUKŲ;1611004144;Taip;6;0;1;7
16400;Gabijėlė;LAKŠTINGALIUKŲ;5862882027;Taip;11;0;2;13
16401;Gabijėlė;LAKŠTINGALIUKŲ;2329827275;Taip;0;0;1;1
16402;Gabijėlė;LAKŠTINGALIUKŲ;8798786098;Taip;0;0;3;3
16403;Gabijėlė;LAKŠTINGALIUKŲ;8035360208;Taip;5;1;0;6
16404;Gabijėlė;LAKŠTINGALIUKŲ;2384469423;Taip;5;0;3;8
16405;Gabijėlė;LAKŠTINGALIUKŲ;8167646385;Taip;0;5;3;8
16406;Gabijėlė;LAKŠTINGALIUKŲ;8926268619;Taip;9;0;0;9
16407;Gabijėlė;LAKŠTINGALIUKŲ;9480021589;Taip;3;1;0;4
16408;Gabijėlė;LAKŠTINGALIUKŲ;3215569531;Taip;5;0;1;6
16409;Gabijėlė;LAKŠTINGALIUKŲ;9324498850;Taip;3;1;0;4
16410;Gabijėlė;LAKŠTINGALIUKŲ;2206038658;Taip;8;0;2;10
16411;Gabijėlė;LAKŠTINGALIUKŲ;9116943443;Taip;0;6;0;6
16412;Gabijėlė;LAKŠTINGALIUKŲ;8314088016;Ne;14;0;0;14
16413;Gabijėlė;LAKŠTINGALIUKŲ;6295299651;Ne;14;0;0;14
16414;Gabijėlė;LAKŠTINGALIUKŲ;8383489040;Taip;8;1;0;9
16415;Gabijėlė;LAKŠTINGALIUKŲ;9694544564;Taip;10;0;2;12
16416;Gabijėlė;LAKŠTINGALIUKŲ;6927730664;Ne;0;0;6;6
16417;Gabijėlė;LAKŠTINGALIUKŲ;7444385669;Ne;0;0;4;4
16418;Gabijėlė;ŽVIRBLIUKŲ;7043775905;Taip;7;0;0;7
16419;Gabijėlė;ŽVIRBLIUKŲ;4475530177;Taip;5;0;1;6
16420;Gabijėlė;ŽVIRBLIUKŲ;5743861607;Taip;0;0;1;1
16421;Gabijėlė;ŽVIRBLIUKŲ;7410541320;Taip;0;9;0;9
16422;Gabijėlė;ŽVIRBLIUKŲ;4493192224;Taip;16;0;2;18
16423;Gabijėlė;ŽVIRBLIUKŲ;3268231136;Taip;0;5;0;5
16424;Gabijėlė;ŽVIRBLIUKŲ;8879972953;Taip;5;13;0;18
16425;Gabijėlė;ŽVIRBLIUKŲ;5332825339;Taip;0;0;4;4
16426;Gabijėlė;ŽVIRBLIUKŲ;9627906252;Taip;0;0;6;6
16427;Gabijėlė;ŽVIRBLIUKŲ;1725665169;Taip;6;0;0;6
16428;Gabijėlė;ŽVIRBLIUKŲ;2264669298;Ne;13;5;0;18
16429;Gabijėlė;ŽVIRBLIUKŲ;5942625633;Taip;7;0;7;14
16430;Gabijėlė;ŽVIRBLIUKŲ;7417179112;Taip;10;0;0;10
16431;Gabijėlė;ŽVIRBLIUKŲ;5387026410;Taip;10;0;0;10
16432;Gabijėlė;ŽVIRBLIUKŲ;8292463617;Taip;3;0;0;3
16433;Gabijėlė;ŽVIRBLIUKŲ;3155403180;Taip;12;0;0;12
16434;Gabijėlė;ŽVIRBLIUKŲ;1158461185;Taip;12;0;0;12
16435;Gabijėlė;ŽVIRBLIUKŲ;6604681536;Ne;11;0;0;11
16436;Gabijėlė;ŽVIRBLIUKŲ;3218415151;Taip;5;0;4;9
16437;Gabijėlė;ŽVIRBLIUKŲ;8384795164;Taip;0;0;6;6
16438;Gabijėlė;ŽVIRBLIUKŲ;4146051969;Ne;8;0;0;8
16439;Gabijėlė;ŽVIRBLIUKŲ;6674038058;Taip;9;0;1;10
16440;Gabijėlė;ŽVIRBLIUKŲ;8823299212;Taip;6;0;0;6
16441;Gabijėlė;GENIUKŲ;3445433386;Taip;0;8;0;8
16442;Gabijėlė;GENIUKŲ;2980295345;Taip;0;1;0;1
16443;Gabijėlė;GENIUKŲ;7312628876;Taip;0;0;4;4
16444;Gabijėlė;GENIUKŲ;1581688238;Taip;16;0;1;17
16445;Gabijėlė;GENIUKŲ;5301905117;Taip;0;15;0;15
16446;Gabijėlė;GENIUKŲ;2171801433;Ne;0;0;6;6
16447;Gabijėlė;GENIUKŲ;3176075887;Taip;10;1;0;11
16448;Gabijėlė;GENIUKŲ;9972967198;Taip;15;0;0;15
16449;Gabijėlė;GENIUKŲ;1589534853;Taip;0;2;0;2
16450;Gabijėlė;GENIUKŲ;3020599503;Taip;18;1;0;19
16451;Gabijėlė;GENIUKŲ;4234733280;Taip;2;0;3;5
16452;Gabijėlė;GENIUKŲ;1922979974;Taip;5;0;1;6
16453;Gabijėlė;GENIUKŲ;6482824000;Taip;9;0;0;9
16454;Gabijėlė;GENIUKŲ;1974388885;Taip;0;0;2;2
16455;Gabijėlė;GENIUKŲ;5418276275;Taip;12;0;1;13
16456;Gabijėlė;GENIUKŲ;2407507314;Taip;11;0;1;12
16457;Gabijėlė;GENIUKŲ;6375754699;Ne;0;0;2;2
16458;Gabijėlė;GENIUKŲ;3827747057;Taip;0;10;0;10
16459;Gabijėlė;DAGILIUKŲ;9348393550;Taip;6;2;0;8
16460;Gabijėlė;DAGILIUKŲ;4264925447;Taip;6;2;0;8
16461;Gabijėlė;DAGILIUKŲ;9120107749;Taip;5;0;0;5
16462;Gabijėlė;DAGILIUKŲ;7426579018;Taip;11;1;0;12
16463;Gabijėlė;DAGILIUKŲ;3700639354;Taip;1;0;0;1
16464;Gabijėlė;DAGILIUKŲ;6438144206;Taip;8;0;2;10
16465;Gabijėlė;DAGILIUKŲ;8078326688;Taip;8;0;0;8
16466;Gabijėlė;DAGILIUKŲ;3017939983;Taip;0;1;0;1
16467;Gabijėlė;DAGILIUKŲ;4462129182;Taip;12;1;1;14
16468;Gabijėlė;DAGILIUKŲ;8662914262;Taip;0;3;0;3
16469;Gabijėlė;DAGILIUKŲ;9280283478;Ne;8;0;1;9
16470;Gabijėlė;DAGILIUKŲ;9503639471;Taip;0;0;2;2
16471;Gabijėlė;DAGILIUKŲ;1988597157;Taip;21;0;0;21
16472;Gabijėlė;DAGILIUKŲ;8036572198;Taip;21;0;0;21
16473;Gabijėlė;DAGILIUKŲ;9895518740;Taip;9;0;1;10
16474;Gabijėlė;DAGILIUKŲ;1455856766;Ne;0;0;2;2
16475;Gabijėlė;DAGILIUKŲ;6322094719;Taip;9;7;0;16
16476;Gabijėlė;DAGILIUKŲ;9449023766;Taip;0;5;0;5
16477;Gabijėlė;DAGILIUKŲ;2254104149;Taip;5;2;0;7
16478;Gabijėlė;DAGILIUKŲ;1286688629;Taip;4;0;5;9
16479;Gabijėlė;DAGILIUKŲ;8864190314;Taip;0;0;3;3
16480;Gabijėlė;DAGILIUKŲ;4797994026;Taip;12;1;0;13
16481;Gabijėlė;PELEDŽIUKŲ;94478599707;Taip;5;1;0;6
16482;Gabijėlė;PELEDŽIUKŲ;1068556799;Taip;0;0;1;1
16483;Gabijėlė;PELEDŽIUKŲ;1171257945;Ne;3;2;0;5
16484;Gabijėlė;PELEDŽIUKŲ;8044682830;Taip;0;0;6;6
16485;Gabijėlė;PELEDŽIUKŲ;43109352262;Taip;0;1;0;1
16486;Gabijėlė;PELEDŽIUKŲ;1747282196;Taip;0;0;1;1
16487;Gabijėlė;PELEDŽIUKŲ;39679870094;Taip;1;1;0;2
16488;Gabijėlė;PELEDŽIUKŲ;36642141718;Taip;1;1;0;2
16489;Gabijėlė;PELEDŽIUKŲ;1491653325;Taip;0;0;1;1
16490;Gabijėlė;PELEDŽIUKŲ;1608940997;Taip;0;0;1;1
16491;Gabijėlė;PELEDŽIUKŲ;3610392405;Ne;0;2;0;2
16492;Gabijėlė;PELEDŽIUKŲ;17443601729;Ne;7;0;3;10
16493;Gabijėlė;PELEDŽIUKŲ;1286307671;Taip;5;0;0;5
16494;Gabijėlė;PELEDŽIUKŲ;8428069167;Taip;7;0;1;8
16495;Gabijėlė;PELEDŽIUKŲ;4726771205;Taip;0;0;4;4
16496;Gabijėlė;PELEDŽIUKŲ;24035160251;Taip;5;0;2;7
16497;Gabijėlė;PELEDŽIUKŲ;38497069329;Taip;5;0;0;5
16498;Gabijėlė;PELEDŽIUKŲ;54948441867;Taip;0;0;2;2
16499;Gabijėlė;PELEDŽIUKŲ;57559227292;Taip;0;1;0;1
16500;Gabijėlė;PELEDŽIUKŲ;6866641272;Taip;0;0;6;6
16501;Gabijėlė;PELEDŽIUKŲ;9376398157;Taip;2;0;0;2
16502;Gabijėlė;KREGZDŽIUKŲ;1759118326;Ne;0;1;0;1
16503;Gabijėlė;KREGZDŽIUKŲ;9533325351;Ne;3;0;0;3
16504;Gabijėlė;KREGZDŽIUKŲ;5407565441;Taip;9;0;0;9
16505;Gabijėlė;KREGZDŽIUKŲ;9683202312;Taip;0;0;1;1
16506;Gabijėlė;KREGZDŽIUKŲ;1574272380;Taip;0;8;0;8
16507;Gabijėlė;KREGZDŽIUKŲ;9675186834;Taip;0;0;1;1
16508;Gabijėlė;KREGZDŽIUKŲ;3584692524;Taip;0;1;0;1
16509;Gabijėlė;KREGZDŽIUKŲ;8555272917;Taip;5;0;2;7
16510;Gabijėlė;KREGZDŽIUKŲ;6570702235;Taip;0;0;1;1
16511;Gabijėlė;ZYLIUKŲ;6154378055;Ne;9;0;0;9
16512;Gabijėlė;ZYLIUKŲ;4701977082;Taip;2;0;1;3
16513;Gabijėlė;ZYLIUKŲ;2727329238;Taip;0;0;1;1
16514;Gabijėlė;ZYLIUKŲ;7700700293;Ne;10;0;3;13
16515;Gabijėlė;ZYLIUKŲ;3496434361;Taip;9;0;3;12
16516;Gabijėlė;ZYLIUKŲ;6759447513;Taip;0;3;0;3
16517;Gabijėlė;ZYLIUKŲ;1090635644;Taip;0;0;2;2
16518;Gabijėlė;ZYLIUKŲ;4267803371;Taip;0;7;0;7
16519;Gabijėlė;ZYLIUKŲ;9893869150;Taip;10;0;0;10
16520;Gabijėlė;ZYLIUKŲ;2764185879;Taip;0;0;2;2
16521;Gabijėlė;ZYLIUKŲ;6463161337;Taip;0;0;3;3
16522;Gabijėlė;ZYLIUKŲ;8362509831;Taip;4;4;0;8
16523;Gabijėlė;ZYLIUKŲ;7921467223;Taip;0;0;2;2
16524;Gabijėlė;ZYLIUKŲ;4907669556;Taip;5;7;0;12
16525;Gabijėlė;ZYLIUKŲ;9398722388;Taip;0;6;0;6
16526;Gabijėlė;ZYLIUKŲ;1947898190;Taip;0;0;1;1
16527;Gabijėlė;ZYLIUKŲ;6446842432;Taip;0;0;6;6
16528;Gabijėlė;ZYLIUKŲ;2384174631;Taip;0;0;7;7
16529;Gabijėlė;ZYLIUKŲ;6562965816;Taip;6;0;0;6
16530;Gabijėlė;ZYLIUKŲ;4376486874;Taip;5;0;2;7
16531;Gabijėlė;ZYLIUKŲ;7047606048;Taip;0;0;1;1
16532;Gabijėlė;VOLUNGĖLIŲ;1779924073;Taip;3;0;1;4
16533;Gabijėlė;VOLUNGĖLIŲ;4166739739;Taip;0;7;0;7
16534;Gabijėlė;VOLUNGĖLIŲ;1492231030;Taip;0;7;0;7
16535;Gabijėlė;VOLUNGĖLIŲ;1317309811;Taip;0;2;0;2
16536;Gabijėlė;VOLUNGĖLIŲ;1523331860;Taip;7;1;0;8
16537;Gabijėlė;VOLUNGĖLIŲ;21740150080;Taip;0;3;0;3
16538;Gabijėlė;VOLUNGĖLIŲ;5558919097;Taip;0;8;0;8
16539;Gabijėlė;VOLUNGĖLIŲ;9683524530;Taip;4;0;4;8
16540;Gabijėlė;VOLUNGĖLIŲ;59837942520;Taip;7;0;0;7
16541;Gabijėlė;VOLUNGĖLIŲ;46021970332;Taip;0;8;0;8
16542;Gabijėlė;VOLUNGĖLIŲ;8480479946;Taip;5;2;0;7
16543;Gabijėlė;VOLUNGĖLIŲ;13265905500;Taip;0;4;0;4
16544;Gabijėlė;VOLUNGĖLIŲ;43737170074;Taip;7;0;0;7
16545;Gabijėlė;VOLUNGĖLIŲ;1480704497;Taip;0;4;0;4
16546;Gabijėlė;VOLUNGĖLIŲ;5704281727;Taip;8;0;0;8
16547;Gabijėlė;VOLUNGĖLIŲ;95685721388;Taip;0;2;0;2
16548;Gabijėlė;VOLUNGĖLIŲ;76416239647;Taip;12;0;0;12
16549;Gabijėlė;VOLUNGĖLIŲ;2102821834;Taip;0;0;1;1
16550;Gabijėlė;VOLUNGĖLIŲ;2051109865;Taip;7;4;0;11
16551;Gabijėlė;VOLUNGĖLIŲ;64252867351;Ne;0;8;0;8
16552;Gabijėlė;ANČIUKŲ;43123279348;Taip;0;9;0;9
16553;Gabijėlė;ANČIUKŲ;2036978425;Taip;0;7;0;7
16554;Gabijėlė;ANČIUKŲ;5219706067;Taip;10;2;0;12
16555;Gabijėlė;ANČIUKŲ;10796114623;Taip;0;15;0;15
16556;Gabijėlė;ANČIUKŲ;3454412432;Taip;5;1;0;6
16557;Gabijėlė;ANČIUKŲ;4752631976;Taip;0;0;1;1
16558;Gabijėlė;ANČIUKŲ;9822093084;Taip;8;0;2;10
16559;Gabijėlė;ANČIUKŲ;1415184607;Taip;0;0;3;3
16560;Gabijėlė;ANČIUKŲ;85836097485;Taip;0;0;1;1
16561;Gabijėlė;ANČIUKŲ;28017865889;Taip;0;9;0;9
16562;Gabijėlė;ANČIUKŲ;1917587420;Ne;0;8;0;8
16563;Gabijėlė;ANČIUKŲ;1465584524;Taip;8;0;0;8
16564;Gabijėlė;ANČIUKŲ;6198439092;Taip;0;1;0;1
16565;Gabijėlė;ANČIUKŲ;5783373671;Taip;0;4;0;4
16566;Gabijėlė;ANČIUKŲ;7948343328;Taip;0;5;11;16
16567;Gabijėlė;ANČIUKŲ;2052892422;Ne;0;0;1;1
16568;Gabijėlė;ANČIUKŲ;8111239476;Taip;6;0;0;6
16569;Gabijėlė;ANČIUKŲ;6766770793;Taip;9;0;0;9
16570;Gabijėlė;ANČIUKŲ;8778396292;Taip;7;0;2;9
16571;Gabijėlė;ANČIUKŲ;4085049535;Taip;0;5;0;5
16572;Gabijėlė;ANČIUKŲ;8893637755;Taip;0;15;0;15
16573;Gabijėlė;ANČIUKŲ;8874692591;Taip;8;0;0;8
16574;Gabijėlė;BALANDŽIUKŲ;4110081664;Taip;0;0;2;2
16575;Gabijėlė;BALANDŽIUKŲ;6719097956;Taip;0;4;0;4
16576;Gabijėlė;BALANDŽIUKŲ;9157819780;Taip;0;5;0;5
16577;Gabijėlė;BALANDŽIUKŲ;1045338865;Taip;0;9;0;9
16578;Gabijėlė;BALANDŽIUKŲ;4330624300;Taip;0;0;3;3
16579;Gabijėlė;BALANDŽIUKŲ;33124420723;Taip;3;0;1;4
16580;Gabijėlė;BALANDŽIUKŲ;2097260657;Taip;7;0;1;8
16581;Gabijėlė;BALANDŽIUKŲ;8131229306;Taip;0;0;2;2
16582;Gabijėlė;BALANDŽIUKŲ;8525869648;Taip;0;0;2;2
16583;Gabijėlė;BALANDŽIUKŲ;56914218692;Taip;9;0;2;11
16584;Gabijėlė;BALANDŽIUKŲ;2070050969;Taip;11;0;3;14
16585;Gabijėlė;BALANDŽIUKŲ;7144977279;Taip;11;1;0;12
16586;Gabijėlė;BALANDŽIUKŲ;15049855022;Taip;0;4;0;4
16587;Gabijėlė;BALANDŽIUKŲ;2776579713;Taip;1;0;0;1
16588;Gabijėlė;BALANDŽIUKŲ;7977751362;Taip;2;0;0;2
16589;Gabijėlė;BALANDŽIUKŲ;5906952432;Taip;2;0;0;2
16590;Gabijėlė;BALANDŽIUKŲ;9197020006;Taip;5;8;0;13
16591;Gabijėlė;BALANDŽIUKŲ;1615940996;Taip;0;0;3;3
16592;Gabijėlė;BALANDŽIUKŲ;1273722177;Taip;16;0;0;16
16593;Gabijėlė;BALANDŽIUKŲ;8746641978;Ne;5;0;0;5
16594;Gabijėlė;BALANDŽIUKŲ;65735862964;Taip;0;0;8;8
16595;Gabijėlė;VYTURIUKŲ;87868591956;Taip;0;4;0;4
16596;Gabijėlė;VYTURIUKŲ;44322663690;Taip;0;0;2;2
16597;Gabijėlė;VYTURIUKŲ;1479311429;Ne;4;2;0;6
16598;Gabijėlė;VYTURIUKŲ;39269336820;Taip;0;5;0;5
16599;Gabijėlė;VYTURIUKŲ;1829866148;Taip;4;0;1;5
16600;Gabijėlė;VYTURIUKŲ;1949644078;Taip;0;5;0;5
16601;Gabijėlė;VYTURIUKŲ;47989272121;Ne;0;1;0;1
16602;Gabijėlė;VYTURIUKŲ;5736000160;Taip;0;4;0;4
16603;Gabijėlė;VYTURIUKŲ;9320327120;Taip;7;3;0;10
16604;Gabijėlė;VYTURIUKŲ;4632508075;Taip;3;0;1;4
16605;Gabijėlė;VYTURIUKŲ;1426802917;Taip;0;4;0;4
16606;Gabijėlė;VYTURIUKŲ;41212490042;Taip;2;0;1;3
16607;Gabijėlė;VYTURIUKŲ;1287165224;Taip;0;1;0;1
16608;Gabijėlė;VYTURIUKŲ;34609028374;Taip;0;3;0;3
16609;Gabijėlė;VYTURIUKŲ;48342584892;Taip;7;0;0;7
16610;Gabijėlė;VYTURIUKŲ;1185452849;Taip;2;0;0;2
16611;Gabijėlė;VYTURIUKŲ;90520726029;Taip;2;0;0;2
16612;Gabijėlė;VYTURIUKŲ;6492199649;Taip;5;0;0;5
16613;Pilaitukas;BITUTĖS;4305634374;Ne;14;0;1;15
16614;Pilaitukas;BITUTĖS;3519198814;Taip;0;0;1;1
16615;Pilaitukas;BITUTĖS;8169484415;Taip;0;3;0;3
16616;Pilaitukas;BITUTĖS;1253300093;Taip;10;0;1;11
16617;Pilaitukas;BITUTĖS;1729494874;Taip;0;0;1;1
16618;Pilaitukas;BITUTĖS;2242454299;Taip;4;0;1;5
16619;Pilaitukas;BITUTĖS;4082490488;Taip;20;0;0;20
16620;Pilaitukas;BITUTĖS;3345387791;Taip;0;13;0;13
16621;Pilaitukas;BITUTĖS;3913169122;Taip;0;10;0;10
16622;Pilaitukas;BITUTĖS;3541354283;Taip;6;0;5;11
16623;Pilaitukas;BITUTĖS;5740951665;Taip;10;0;5;15
16624;Pilaitukas;BITUTĖS;4591799893;Taip;21;0;0;21
16625;Pilaitukas;BITUTĖS;6308557885;Taip;21;0;0;21
16626;Pilaitukas;BITUTĖS;6514731102;Taip;21;0;0;21
16627;Pilaitukas;BITUTĖS;5988165204;Taip;6;0;1;7
16628;Pilaitukas;BITUTĖS;3037850837;Ne;5;0;4;9
16629;Pilaitukas;BITUTĖS;9126553732;Taip;0;0;5;5
16630;Pilaitukas;BITUTĖS;7438112270;Taip;16;0;1;17
16631;Pilaitukas;BITUTĖS;6099109886;Taip;0;0;1;1
16632;Pilaitukas;ZUIKUČIAI;8993885764;Taip;0;1;1;2
16633;Pilaitukas;ZUIKUČIAI;5206637809;Taip;5;0;7;12
16634;Pilaitukas;ZUIKUČIAI;5288784331;Ne;0;1;0;1
16635;Pilaitukas;ZUIKUČIAI;8255398803;Ne;9;0;1;10
16636;Pilaitukas;ZUIKUČIAI;2862447956;Taip;8;2;0;10
16637;Pilaitukas;ZUIKUČIAI;8727175656;Taip;6;2;0;8
16638;Pilaitukas;ZUIKUČIAI;8207194955;Taip;13;1;0;14
16639;Pilaitukas;ZUIKUČIAI;5640802570;Ne;7;1;2;10
16640;Pilaitukas;ZUIKUČIAI;4623818227;Taip;0;0;1;1
16641;Pilaitukas;ZUIKUČIAI;9260893320;Taip;0;1;0;1
16642;Pilaitukas;ZUIKUČIAI;9988041515;Taip;9;1;1;11
16643;Pilaitukas;ZUIKUČIAI;9108428738;Taip;9;1;1;11
16644;Pilaitukas;ZUIKUČIAI;1607454890;Taip;6;0;0;6
16645;Pilaitukas;ZUIKUČIAI;9878890346;Ne;2;5;0;7
16646;Pilaitukas;ZUIKUČIAI;5710747769;Taip;16;0;0;16
16647;Pilaitukas;ZUIKUČIAI;7568744500;Taip;5;0;2;7
16648;Pilaitukas;ZUIKUČIAI;5407354218;Taip;7;0;1;8
16649;Pilaitukas;ZUIKUČIAI;9414051187;Taip;4;0;0;4
16650;Pilaitukas;ZUIKUČIAI;1704055907;Taip;0;0;6;6
16651;Pilaitukas;ZUIKUČIAI;7853910193;Taip;0;0;4;4
16652;Pilaitukas;ZUIKUČIAI;9735358433;Taip;0;1;0;1
16653;Pilaitukas;ANČIUKAI;5949185075;Taip;11;0;0;11
16654;Pilaitukas;ANČIUKAI;92108889661;Ne;1;0;1;2
16655;Pilaitukas;ANČIUKAI;9724892897;Taip;0;0;1;1
16656;Pilaitukas;ANČIUKAI;1114477688;Taip;3;1;0;4
16657;Pilaitukas;ANČIUKAI;1512181401;Taip;0;0;2;2
16658;Pilaitukas;ANČIUKAI;3821748678;Taip;7;0;1;8
16659;Pilaitukas;ANČIUKAI;6222888898;Taip;3;0;0;3
16660;Pilaitukas;ANČIUKAI;8319676743;Taip;0;0;5;5
16661;Pilaitukas;ANČIUKAI;4505384039;Taip;10;0;0;10
16662;Pilaitukas;ANČIUKAI;5206439753;Taip;0;4;0;4
16663;Pilaitukas;ANČIUKAI;79485847381;Taip;0;0;4;4
16664;Pilaitukas;ANČIUKAI;5211988291;Taip;10;0;0;10
16665;Pilaitukas;ANČIUKAI;2117570444;Taip;6;0;0;6
16666;Pilaitukas;ANČIUKAI;87760608710;Taip;8;0;0;8
16667;Pilaitukas;ANČIUKAI;7909465673;Taip;3;10;0;13
16668;Pilaitukas;ANČIUKAI;2298935154;Taip;5;0;0;5
16669;Pilaitukas;ANČIUKAI;4694691187;Taip;5;0;3;8
16670;Pilaitukas;ANČIUKAI;9224653856;Taip;5;0;3;8
16671;Pilaitukas;ANČIUKAI;58250008277;Taip;7;5;1;13
16672;Pilaitukas;ANČIUKAI;5252233127;Taip;6;5;0;11
16673;Pilaitukas;MEŠKIUKAI;14554050141;Taip;0;2;0;2
16674;Pilaitukas;MEŠKIUKAI;2929868229;Taip;0;0;1;1
16675;Pilaitukas;MEŠKIUKAI;1135880899;Taip;0;5;0;5
16676;Pilaitukas;MEŠKIUKAI;4505147961;Taip;0;0;1;1
16677;Pilaitukas;MEŠKIUKAI;9618329726;Taip;6;0;1;7
16678;Pilaitukas;MEŠKIUKAI;4038320896;Taip;16;0;0;16
16679;Pilaitukas;MEŠKIUKAI;18466900688;Taip;0;5;0;5
16680;Pilaitukas;MEŠKIUKAI;3214740183;Taip;0;0;1;1
16681;Pilaitukas;MEŠKIUKAI;39600380611;Taip;8;0;1;9
16682;Pilaitukas;MEŠKIUKAI;5604992163;Taip;0;5;0;5
16683;Pilaitukas;MEŠKIUKAI;9450834035;Taip;0;5;0;5
16684;Pilaitukas;MEŠKIUKAI;5689385925;Taip;0;1;0;1
16685;Pilaitukas;MEŠKIUKAI;1003278169;Ne;0;7;0;7
16686;Pilaitukas;MEŠKIUKAI;5939557073;Taip;2;5;1;8
16687;Pilaitukas;MEŠKIUKAI;6117985788;Taip;2;0;0;2
16688;Pilaitukas;MEŠKIUKAI;9924612250;Taip;0;0;4;4
16689;Pilaitukas;ŽUVYTĖS;1611616941;Taip;0;10;0;10
16690;Pilaitukas;ŽUVYTĖS;29229117661;Taip;0;7;0;7
16691;Pilaitukas;ŽUVYTĖS;4306078592;Ne;0;1;5;6
16692;Pilaitukas;ŽUVYTĖS;12327235652;Ne;11;0;0;11
16693;Pilaitukas;ŽUVYTĖS;42514613325;Taip;12;0;0;12
16694;Pilaitukas;ŽUVYTĖS;89719236172;Taip;0;6;0;6
16695;Pilaitukas;ŽUVYTĖS;89730708991;Taip;0;0;2;2
16696;Pilaitukas;ŽUVYTĖS;68571454940;Ne;0;1;0;1
16697;Pilaitukas;ŽUVYTĖS;3685682772;Ne;0;21;0;21
16698;Pilaitukas;ŽUVYTĖS;1168958446;Taip;0;0;1;1
16699;Pilaitukas;ŽUVYTĖS;90148331957;Taip;0;0;1;1
16700;Pilaitukas;ŽUVYTĖS;71302602535;Taip;0;5;1;6
16701;Pilaitukas;ŽUVYTĖS;54706920576;Taip;0;0;1;1
16702;Pilaitukas;ŽUVYTĖS;26063381713;Ne;0;2;0;2
16703;Pilaitukas;ŽUVYTĖS;8152280709;Taip;7;0;1;8
16704;Pilaitukas;ŽUVYTĖS;1613536796;Taip;0;0;1;1
16705;Pilaitukas;ŽUVYTĖS;28559756114;Ne;0;0;1;1
16706;Pilaitukas;ŽUVYTĖS;15303269615;Taip;0;2;0;2
16707;Pilaitukas;ŽUVYTĖS;1779631590;Taip;0;1;0;1
16708;Pilaitukas;PAUKŠTELIAI;7082054458;Taip;0;1;0;1
16709;Pilaitukas;PAUKŠTELIAI;7961518607;Taip;0;1;0;1
16710;Pilaitukas;PAUKŠTELIAI;82688660737;Taip;0;0;1;1
16711;Pilaitukas;PAUKŠTELIAI;58064353914;Taip;0;0;1;1
16712;Pilaitukas;PAUKŠTELIAI;7032684121;Ne;0;1;0;1
16713;Pilaitukas;PAUKŠTELIAI;1726805610;Taip;7;0;0;7
16714;Pilaitukas;PAUKŠTELIAI;2045735700;Taip;5;0;1;6
16715;Pilaitukas;PAUKŠTELIAI;4283157555;Taip;0;0;2;2
16716;Pilaitukas;PAUKŠTELIAI;9496336005;Taip;0;2;0;2
16717;Pilaitukas;PAUKŠTELIAI;6069797837;Taip;0;1;2;3
16718;Pilaitukas;PAUKŠTELIAI;91980974377;Taip;0;1;2;3
16719;Pilaitukas;PAUKŠTELIAI;74264627858;Taip;5;1;0;6
16720;Pilaitukas;BORUŽĖLĖS;56069293343;Taip;0;0;1;1
16721;Pilaitukas;BORUŽĖLĖS;7156205658;Taip;10;0;1;11
16722;Pilaitukas;BORUŽĖLĖS;8364902911;Taip;0;2;0;2
16723;Pilaitukas;BORUŽĖLĖS;5464065587;Taip;0;3;0;3
16724;Pilaitukas;BORUŽĖLĖS;5984878126;Taip;0;0;3;3
16725;Pilaitukas;BORUŽĖLĖS;6024861998;Taip;0;15;0;15
16726;Pilaitukas;BORUŽĖLĖS;58416972423;Taip;0;0;5;5
16727;Pilaitukas;BORUŽĖLĖS;9898379569;Taip;0;0;1;1
16728;Pilaitukas;BORUŽĖLĖS;5324806808;Taip;17;0;0;17
16729;Pilaitukas;BORUŽĖLĖS;5185051301;Taip;0;0;3;3
16730;Pilaitukas;BORUŽĖLĖS;5326258755;Ne;0;3;2;5
16731;Pilaitukas;BORUŽĖLĖS;8470482026;Taip;5;0;3;8
16732;Pilaitukas;BORUŽĖLĖS;6838035491;Taip;4;0;1;5
16733;Pilaitukas;BORUŽĖLĖS;1731106179;Taip;15;0;2;17
16734;Pilaitukas;DRUGELIAI;38456484551;Taip;0;10;0;10
16735;Pilaitukas;DRUGELIAI;7838787153;Taip;5;0;3;8
16736;Pilaitukas;DRUGELIAI;2613078582;Taip;0;0;3;3
16737;Pilaitukas;DRUGELIAI;1677962644;Taip;8;5;0;13
16738;Pilaitukas;DRUGELIAI;4745358362;Taip;8;5;0;13
16739;Pilaitukas;DRUGELIAI;3483758882;Taip;0;0;1;1
16740;Pilaitukas;DRUGELIAI;6646474196;Taip;5;0;2;7
16741;Pilaitukas;DRUGELIAI;9801214344;Ne;0;0;11;11
16742;Pilaitukas;DRUGELIAI;5422289286;Taip;8;0;3;11
16743;Pilaitukas;DRUGELIAI;1272758839;Taip;10;0;4;14
16744;Pilaitukas;DRUGELIAI;7082099968;Taip;5;0;4;9
16745;Pilaitukas;DRUGELIAI;6712878938;Ne;5;10;2;17
16746;Pilaitukas;DRUGELIAI;2917197418;Taip;5;0;0;5
16747;Pilaitukas;DRUGELIAI;3298272815;Taip;3;0;2;5
16748;Pilaitukas;DRUGELIAI;3772830210;Ne;0;0;1;1
16749;Pilaitukas;DRUGELIAI;4719223490;Taip;5;0;4;9
16750;Pilaitukas;PELIUKAI;7808204054;Ne;0;0;4;4
16751;Pilaitukas;PELIUKAI;4810825253;Taip;10;1;0;11
16752;Pilaitukas;PELIUKAI;8769116377;Taip;0;0;4;4
16753;Pilaitukas;PELIUKAI;8501376663;Taip;5;0;1;6
16754;Pilaitukas;PELIUKAI;5421602723;Taip;21;0;0;21
16755;Pilaitukas;PELIUKAI;6754825353;Ne;0;2;0;2
16756;Pilaitukas;PELIUKAI;8168228529;Ne;0;4;0;4
16757;Pilaitukas;PELIUKAI;9343707166;Taip;0;0;2;2
16758;Pilaitukas;PELIUKAI;4014329370;Taip;5;0;0;5
16759;Pilaitukas;PELIUKAI;6833933586;Taip;0;6;1;7
16760;Pilaitukas;PELIUKAI;9246925227;Taip;6;0;2;8
16761;Pilaitukas;PELIUKAI;2416277190;Ne;0;21;0;21
16762;Pilaitukas;PELIUKAI;9774222130;Taip;5;0;6;11
16763;Pilaitukas;PELIUKAI;1270365948;Taip;2;1;3;6
16764;Pilaitukas;PELIUKAI;7604004800;Taip;15;0;0;15
16765;Pilaitukas;PELIUKAI;9556421129;Taip;8;0;0;8
16766;Pilaitukas;PELIUKAI;3954210452;Ne;10;3;0;13
16767;Pilaitukas;PELIUKAI;9870994949;Taip;0;0;3;3
16768;Pilaitukas;PELIUKAI;5223336496;Taip;18;0;0;18
16769;Pilaitukas;PELIUKAI;3651140874;Taip;5;0;0;5
16770;Pilaitukas;PELIUKAI;2823859128;Ne;6;0;0;6
16771;Pilaitukas;PELIUKAI;7750936973;Taip;11;0;0;11
16772;Pilaitukas;KAČIUKAI;2406183145;Taip;0;2;0;2
16773;Pilaitukas;KAČIUKAI;2379660463;Taip;0;2;0;2
16774;Pilaitukas;KAČIUKAI;6234641884;Taip;14;0;0;14
16775;Pilaitukas;KAČIUKAI;1585341963;Taip;4;0;0;4
16776;Pilaitukas;KAČIUKAI;9038324313;Taip;7;1;0;8
16777;Pilaitukas;KAČIUKAI;7594484959;Taip;14;0;0;14
16778;Pilaitukas;KAČIUKAI;2463482642;Taip;10;1;1;12
16779;Pilaitukas;KAČIUKAI;3080014745;Taip;10;1;0;11
16780;Pilaitukas;KAČIUKAI;5353687011;Taip;0;6;0;6
16781;Pilaitukas;KAČIUKAI;6525191057;Taip;0;1;0;1
16782;Pilaitukas;KAČIUKAI;8009040109;Taip;4;10;0;14
16783;Pilaitukas;KAČIUKAI;2105380328;Taip;6;0;2;8
16784;Pilaitukas;KAČIUKAI;5326689274;Taip;11;0;0;11
16785;Pilaitukas;KAČIUKAI;9653647227;Taip;11;0;0;11
16786;Pilaitukas;KAČIUKAI;4022543517;Taip;6;0;0;6
16787;Pilaitukas;KAČIUKAI;1999942175;Taip;0;1;0;1
16788;Pilaitukas;KAČIUKAI;3825942473;Taip;0;10;0;10
16789;Pilaitukas;KAČIUKAI;1611371690;Taip;21;0;0;21
16790;Pilaitukas;KAČIUKAI;9247501721;Taip;16;0;0;16
16791;Pilaitukas;KAČIUKAI;6436694057;Taip;0;1;1;2
16792;Pilaitukas;KAČIUKAI;9974310580;Taip;0;3;0;3
16793;Pilaitukas;KAČIUKAI;6235375235;Taip;10;0;0;10
16794;Pilaitukas;KAČIUKAI;5391358623;Taip;6;0;0;6
16795;Pilaitukas;SAULUTĖS;7222856683;Taip;0;0;1;1
16796;Pilaitukas;SAULUTĖS;8787181006;Taip;0;4;0;4
16797;Pilaitukas;SAULUTĖS;3035456834;Ne;0;0;1;1
16798;Pilaitukas;SAULUTĖS;2830212921;Taip;0;6;0;6
16799;Pilaitukas;SAULUTĖS;2476942319;Taip;0;0;1;1
16800;Pilaitukas;SAULUTĖS;1781762820;Taip;7;0;0;7
16801;Pilaitukas;SAULUTĖS;7479542200;Taip;7;0;2;9
16802;Pilaitukas;SAULUTĖS;8033540052;Taip;5;0;2;7
16803;Pilaitukas;MENULIUKAI;2923272767;Taip;0;2;0;2
16804;Pilaitukas;MENULIUKAI;4097742120;Taip;0;2;0;2
16805;Pilaitukas;MENULIUKAI;8620858011;Taip;6;0;0;6
16806;Pilaitukas;MENULIUKAI;5026344198;Taip;5;1;0;6
16807;Pilaitukas;MENULIUKAI;3761827714;Taip;0;0;2;2
16808;Pilaitukas;MENULIUKAI;8643066116;Taip;3;0;3;6
16809;Pilaitukas;MENULIUKAI;1120549352;Taip;2;0;2;4
16810;Pilaitukas;MENULIUKAI;4286388920;Taip;0;0;2;2
16811;Pilaitukas;MENULIUKAI;1290017967;Taip;9;0;0;9
16812;Pilaitukas;ĖŽIUKAI;9187961584;Taip;0;5;1;6
16813;Pilaitukas;ĖŽIUKAI;8268790017;Taip;5;0;0;5
16814;Pilaitukas;ĖŽIUKAI;4171896175;Taip;0;0;4;4
16815;Pilaitukas;ĖŽIUKAI;1362132769;Taip;0;1;0;1
16816;Pilaitukas;ĖŽIUKAI;7781507786;Taip;12;0;0;12
16817;Pilaitukas;ĖŽIUKAI;8577357264;Taip;7;1;0;8
16818;Pilaitukas;ĖŽIUKAI;1660462256;Ne;11;0;0;11
16819;Pilaitukas;ĖŽIUKAI;1610122884;Ne;12;0;0;12
16820;Pilaitukas;ĖŽIUKAI;3867660147;Ne;12;0;0;12
16821;Pilaitukas;ĖŽIUKAI;3027792710;Taip;5;5;0;10
16822;Pilaitukas;ĖŽIUKAI;8322980583;Taip;0;0;2;2
16823;Pilaitukas;ĖŽIUKAI;5297214263;Taip;0;0;1;1
16824;Švelnukas;Pelėdžiukai;8016531082;Taip;0;17;3;20
16825;Švelnukas;Pelėdžiukai;4618560397;Taip;15;0;0;15
16826;Švelnukas;Pelėdžiukai;3361154071;Taip;7;0;1;8
16827;Švelnukas;Pelėdžiukai;8219071968;Ne;0;21;0;21
16828;Švelnukas;Pelėdžiukai;3235768013;Taip;0;21;0;21
16829;Švelnukas;Pelėdžiukai;9008722163;Taip;4;0;4;8
16830;Švelnukas;Pelėdžiukai;3645855145;Taip;10;0;1;11
16831;Švelnukas;Pelėdžiukai;5699300764;Taip;5;0;0;5
16832;Švelnukas;Pelėdžiukai;5554625346;Taip;0;21;0;21
16833;Švelnukas;Pelėdžiukai;3282020958;Taip;0;21;0;21
16834;Švelnukas;Pelėdžiukai;1116279011;Ne;8;0;0;8
16835;Švelnukas;Pelėdžiukai;3892058023;Ne;7;0;0;7
16836;Švelnukas;Pelėdžiukai;5681611554;Taip;7;0;2;9
16837;Švelnukas;Pelėdžiukai;8589226595;Taip;0;3;5;8
16838;Švelnukas;Pelėdžiukai;9802064955;Taip;0;0;3;3
16839;Švelnukas;Pelėdžiukai;3804532959;Taip;0;2;0;2
16840;Švelnukas;Pelėdžiukai;1462620951;Taip;0;3;0;3
16841;Švelnukas;Ežiukai;41365412569;Ne;0;3;0;3
16842;Švelnukas;Ežiukai;25374873288;Taip;0;3;1;4
16843;Švelnukas;Ežiukai;15308444101;Ne;0;15;0;15
16844;Švelnukas;Ežiukai;6282389058;Taip;0;0;2;2
16845;Švelnukas;Ežiukai;23795609183;Taip;0;0;1;1
16846;Švelnukas;Ežiukai;38902466526;Taip;11;0;0;11
16847;Švelnukas;Ežiukai;8399963483;Taip;0;0;1;1
16848;Švelnukas;Ežiukai;8681264696;Taip;0;1;0;1
16849;Švelnukas;Ežiukai;4373567509;Ne;10;0;1;11
16850;Švelnukas;Ežiukai;73628749439;Taip;0;16;0;16
16851;Švelnukas;Ežiukai;1165172787;Taip;0;0;1;1
16852;Švelnukas;Ežiukai;7308701231;Taip;0;0;4;4
16853;Švelnukas;Ežiukai;2400781175;Taip;7;0;0;7
16854;Švelnukas;Ežiukai;6209334207;Ne;6;0;1;7
16855;Švelnukas;Ežiukai;1201550386;Taip;5;0;2;7
16856;Švelnukas;Švelnukai;4681584014;Taip;7;0;0;7
16857;Švelnukas;Švelnukai;9766734938;Taip;3;0;2;5
16858;Švelnukas;Švelnukai;5212827184;Ne;5;0;0;5
16859;Švelnukas;Švelnukai;9829912750;Taip;0;0;2;2
16860;Švelnukas;Švelnukai;5032829856;Ne;0;16;0;16
16861;Švelnukas;Švelnukai;5213589179;Taip;0;15;0;15
16862;Švelnukas;Švelnukai;1963518457;Taip;0;6;0;6
16863;Švelnukas;Švelnukai;4194249709;Taip;0;7;1;8
16864;Švelnukas;Švelnukai;5936821902;Taip;0;0;1;1
16865;Švelnukas;Švelnukai;3228293160;Taip;0;0;6;6
16866;Švelnukas;Švelnukai;7607215137;Taip;5;0;0;5
16867;Švelnukas;Švelnukai;4629757899;Taip;7;1;0;8
16868;Švelnukas;Švelnukai;6964997767;Taip;10;0;2;12
16869;Švelnukas;Švelnukai;8951810066;Ne;13;0;0;13
16870;Švelnukas;Švelnukai;2663990082;Taip;0;0;2;2
16871;Švelnukas;Švelnukai;6204286255;Taip;0;1;1;2
16872;Švelnukas;Švelnukai;5960966542;Taip;0;21;0;21
16873;Švelnukas;Boružiukai;1951447127;Taip;10;0;0;10
16874;Švelnukas;Boružiukai;3849957906;Taip;0;0;6;6
16875;Švelnukas;Boružiukai;5550841477;Taip;3;5;1;9
16876;Švelnukas;Boružiukai;9722532034;Taip;4;0;4;8
16877;Švelnukas;Boružiukai;1264256177;Ne;5;1;0;6
16878;Švelnukas;Boružiukai;1332533332;Taip;7;0;5;12
16879;Švelnukas;Boružiukai;8787505507;Taip;0;0;10;10
16880;Švelnukas;Boružiukai;4134678301;Ne;3;0;0;3
16881;Švelnukas;Boružiukai;8458233793;Taip;8;0;0;8
16882;Švelnukas;Boružiukai;7967996032;Taip;0;5;0;5
16883;Švelnukas;Boružiukai;8951980999;Taip;2;0;0;2
16884;Švelnukas;Boružiukai;4990399144;Taip;0;1;0;1
16885;Švelnukas;Boružiukai;9575767514;Taip;11;0;1;12
16886;Švelnukas;Boružiukai;6282137936;Taip;0;2;0;2
16887;Švelnukas;Boružiukai;5409130195;Taip;8;0;0;8
16888;Švelnukas;Boružiukai;9479536507;Taip;5;10;0;15
16889;Švelnukas;Boružiukai;2088128734;Ne;0;8;0;8
16890;Švelnukas;Boružiukai;2077614498;Taip;6;0;3;9
16891;Švelnukas;Boružiukai;3145935641;Taip;8;3;0;11
16892;Švelnukas;Boružiukai;4404904322;Taip;0;3;0;3
16893;Švelnukas;Boružiukai;3561920685;Taip;0;0;2;2
16894;Švelnukas;Boružiukai;8895028305;Taip;0;0;3;3
16895;Švelnukas;Smalsučiai;76418408780;Taip;6;0;0;6
16896;Švelnukas;Smalsučiai;63394075248;Ne;0;3;0;3
16897;Švelnukas;Smalsučiai;53619702326;Taip;0;0;2;2
16898;Švelnukas;Smalsučiai;47645479348;Taip;0;2;0;2
16899;Švelnukas;Smalsučiai;19117783391;Taip;0;0;2;2
16900;Švelnukas;Smalsučiai;26077395334;Taip;0;4;0;4
16901;Švelnukas;Smalsučiai;15711256627;Taip;0;5;0;5
16902;Švelnukas;Smalsučiai;95780894209;Taip;0;8;1;9
16903;Švelnukas;Smalsučiai;3388721433;Taip;0;3;0;3
16904;Švelnukas;Smalsučiai;1742714140;Ne;7;0;0;7
16905;Švelnukas;Smalsučiai;78611632021;Taip;0;8;0;8
16906;Švelnukas;Smalsučiai;1139744541;Taip;0;8;0;8
16907;Švelnukas;Smalsučiai;26312856720;Taip;6;0;0;6
16908;Švelnukas;Smalsučiai;5910842956;Taip;0;0;1;1
16909;Švelnukas;Nykštukai;1293700097;Taip;0;0;1;1
16910;Švelnukas;Nykštukai;8221642452;Taip;0;0;2;2
16911;Švelnukas;Nykštukai;2141519946;Taip;0;3;0;3
16912;Švelnukas;Nykštukai;8771953161;Taip;0;2;3;5
16913;Švelnukas;Nykštukai;2282356211;Taip;8;1;1;10
16914;Švelnukas;Nykštukai;4697253853;Taip;0;0;4;4
16915;Švelnukas;Nykštukai;7387060610;Taip;0;7;0;7
16916;Švelnukas;Nykštukai;1762528313;Taip;0;0;9;9
16917;Švelnukas;Nykštukai;3473146893;Taip;10;2;0;12
16918;Švelnukas;Nykštukai;3370028567;Taip;0;2;0;2
16919;Švelnukas;Nykštukai;62969317035;Taip;0;0;2;2
16920;Švelnukas;Nykštukai;6633233824;Taip;8;0;2;10
16921;Švelnukas;Nykštukai;2106591525;Ne;7;0;0;7
16922;Švelnukas;Nykštukai;93497358197;Taip;0;5;0;5
16923;Švelnukas;Nykštukai;2971380970;Taip;0;3;4;7
16924;Švelnukas;Nykštukai;3389897065;Taip;0;3;4;7
16925;Švelnukas;Nykštukai;4302735157;Taip;0;0;2;2
16926;Švelnukas;Nykštukai;2785396019;Ne;7;0;0;7
16927;Švelnukas;Nykštukai;6195335543;Ne;0;0;5;5
16928;Boružėlė;"Nykštukai gudručiai";3340082011;Taip;2;0;0;2
16929;Boružėlė;"Nykštukai gudručiai";7736917485;Taip;6;2;0;8
16930;Boružėlė;"Nykštukai gudručiai";9520696660;Taip;0;0;2;2
16931;Boružėlė;"Nykštukai gudručiai";5691884576;Taip;4;0;0;4
16932;Boružėlė;"Nykštukai gudručiai";9193273478;Taip;12;0;0;12
16933;Boružėlė;"Nykštukai gudručiai";8359957290;Taip;0;2;8;10
16934;Boružėlė;"Nykštukai gudručiai";8141240094;Taip;0;0;14;14
16935;Boružėlė;"Nykštukai gudručiai";2349571778;Taip;2;2;0;4
16936;Boružėlė;"Nykštukai gudručiai";1894170218;Taip;1;0;0;1
16937;Boružėlė;"Nykštukai gudručiai";3509512899;Taip;17;0;0;17
16938;Boružėlė;"Nykštukai gudručiai";8888151470;Taip;17;0;0;17
16939;Boružėlė;"Nykštukai gudručiai";3430953692;Taip;11;1;0;12
16940;Boružėlė;"Nykštukai gudručiai";8365962523;Taip;0;0;1;1
16941;Boružėlė;"Nykštukai gudručiai";3592853535;Taip;0;2;1;3
16942;Boružėlė;"Nykštukai gudručiai";6876323023;Taip;0;2;0;2
16943;Boružėlė;"Nykštukai gudručiai";2744894565;Taip;0;1;2;3
16944;Boružėlė;"Nykštukai gudručiai";6590829182;Ne;3;2;1;6
16945;Boružėlė;"Nykštukai gudručiai";3129825206;Taip;0;2;0;2
16946;Boružėlė;"Nykštukai gudručiai";9771767352;Taip;4;1;0;5
16947;Boružėlė;"Nykštukai gudručiai";2571360077;Taip;0;1;0;1
16948;Boružėlė;"Nykštukai gudručiai";9078805020;Ne;0;2;0;2
16949;Boružėlė;"Saulės zuikučiai";4554260776;Taip;0;3;0;3
16950;Boružėlė;"Saulės zuikučiai";5298170118;Taip;0;3;0;3
16951;Boružėlė;"Saulės zuikučiai";9271331800;Taip;2;2;0;4
16952;Boružėlė;"Saulės zuikučiai";2133849514;Taip;2;3;0;5
16953;Boružėlė;"Saulės zuikučiai";1116012068;Taip;10;2;3;15
16954;Boružėlė;"Saulės zuikučiai";1292298259;Taip;9;1;0;10
16955;Boružėlė;"Saulės zuikučiai";3130977416;Taip;5;1;0;6
16956;Boružėlė;"Saulės zuikučiai";7256396576;Taip;5;2;0;7
16957;Boružėlė;"Saulės zuikučiai";2087238951;Taip;3;1;0;4
16958;Boružėlė;"Saulės zuikučiai";4999277693;Taip;10;1;0;11
16959;Boružėlė;"Saulės zuikučiai";6990311896;Taip;10;2;0;12
16960;Boružėlė;"Saulės zuikučiai";4509233532;Taip;13;0;0;13
16961;Boružėlė;"Saulės zuikučiai";3952645542;Taip;6;1;0;7
16962;Boružėlė;"Saulės zuikučiai";5516103398;Taip;10;0;0;10
16963;Boružėlė;"Saulės zuikučiai";8259586236;Taip;0;2;0;2
16964;Boružėlė;"Saulės zuikučiai";3955841578;Taip;0;1;0;1
16965;Boružėlė;"Saulės zuikučiai";1583223569;Taip;0;1;0;1
16966;Boružėlė;"Saulės zuikučiai";4433248526;Taip;0;0;2;2
16967;Boružėlė;"Saulės zuikučiai";1547802140;Taip;12;0;0;12
16968;Boružėlė;"Saulės zuikučiai";4020348640;Taip;6;0;0;6
16969;Boružėlė;"Saulės zuikučiai";2842256033;Taip;10;1;0;11
16970;Boružėlė;"Saulės zuikučiai";2561969142;Taip;6;0;14;20
16971;Boružėlė;"Saulės zuikučiai";7262515868;Taip;19;0;0;19
16972;Boružėlė;Gėlytės;1146297996;Taip;0;2;0;2
16973;Boružėlė;Gėlytės;3288141024;Taip;5;4;0;9
16974;Boružėlė;Gėlytės;1166207929;Ne;9;0;0;9
16975;Boružėlė;Gėlytės;7956982615;Taip;0;1;9;10
16976;Boružėlė;Gėlytės;4637656311;Taip;11;0;1;12
16977;Boružėlė;Gėlytės;7942043844;Taip;0;1;8;9
16978;Boružėlė;Gėlytės;3226733236;Taip;2;3;0;5
16979;Boružėlė;Gėlytės;6070356395;Taip;5;0;0;5
16980;Boružėlė;Gėlytės;1799882790;Taip;0;1;0;1
16981;Boružėlė;Gėlytės;6722353853;Taip;0;0;15;15
16982;Boružėlė;Gėlytės;5252261660;Taip;15;0;1;16
16983;Boružėlė;Gėlytės;8376436755;Ne;0;1;2;3
16984;Boružėlė;Gėlytės;3300678477;Taip;3;0;0;3
16985;Boružėlė;Gėlytės;7763958937;Ne;5;0;0;5
16986;Boružėlė;Gėlytės;9855354210;Taip;8;0;0;8
16987;Boružėlė;Smalsutis;2086485441;Taip;0;7;0;7
16988;Boružėlė;Smalsutis;5129244830;Taip;0;0;1;1
16989;Boružėlė;Smalsutis;4947670606;Taip;0;0;9;9
16990;Boružėlė;Smalsutis;5267216044;Taip;0;2;0;2
16991;Boružėlė;Smalsutis;2917508421;Taip;8;0;1;9
16992;Boružėlė;Smalsutis;7263730692;Taip;1;0;0;1
16993;Boružėlė;Smalsutis;5708558321;Taip;0;2;5;7
16994;Boružėlė;Smalsutis;2132904457;Taip;0;12;0;12
16995;Boružėlė;Smalsutis;77513300382;Ne;0;2;0;2
16996;Boružėlė;Smalsutis;39553430808;Taip;0;0;6;6
16997;Boružėlė;Smalsutis;4958704459;Taip;8;1;0;9
16998;Boružėlė;Smalsutis;5618586722;Taip;0;2;0;2
16999;Boružėlė;Smalsutis;4283064680;Taip;0;3;5;8
17000;Boružėlė;Smalsutis;2447148171;Ne;6;1;0;7
17001;Boružėlė;Smalsutis;1391562352;Taip;0;0;1;1
17002;Boružėlė;Smalsutis;7386694567;Taip;5;0;0;5
17003;Boružėlė;Smalsutis;9634967237;Taip;3;0;0;3
17004;Boružėlė;Smalsutis;3592594142;Taip;3;0;0;3
17005;Boružėlė;Drugeliai;8357946299;Taip;0;1;0;1
17006;Boružėlė;Drugeliai;1130980139;Taip;0;2;0;2
17007;Boružėlė;Drugeliai;6463583187;Taip;0;1;0;1
17008;Boružėlė;Drugeliai;8683282162;Taip;0;3;0;3
17009;Boružėlė;Drugeliai;3136028536;Taip;5;1;4;10
17010;Boružėlė;Drugeliai;2211576663;Taip;0;9;0;9
17011;Boružėlė;Drugeliai;1559001916;Taip;3;1;0;4
17012;Boružėlė;Drugeliai;4233602822;Taip;0;2;0;2
17013;Boružėlė;Drugeliai;9463322491;Taip;0;1;0;1
17014;Boružėlė;Drugeliai;3108758436;Taip;0;0;1;1
17015;Boružėlė;Drugeliai;8482813204;Taip;0;1;4;5
17016;Boružėlė;Drugeliai;6369070055;Taip;0;0;1;1
17017;Boružėlė;Drugeliai;6902130914;Taip;0;0;2;2
17018;Boružėlė;Drugeliai;5726187445;Taip;2;0;0;2
17019;Boružėlė;Drugeliai;2308405580;Taip;0;0;1;1
17020;Boružėlė;Drugeliai;3405184929;Taip;0;5;1;6
17021;Boružėlė;Drugeliai;8213060214;Taip;0;0;1;1
17022;Boružėlė;Vyturėliai;1913540317;Taip;5;1;0;6
17023;Boružėlė;Vyturėliai;1950269258;Taip;0;6;0;6
17024;Boružėlė;Vyturėliai;1591582954;Taip;2;6;0;8
17025;Boružėlė;Vyturėliai;3322567969;Taip;0;1;0;1
17026;Boružėlė;Vyturėliai;1718509953;Taip;0;2;0;2
17027;Boružėlė;Vyturėliai;8311383437;Taip;0;1;8;9
17028;Boružėlė;Vyturėliai;7534482245;Taip;6;1;5;12
17029;Boružėlė;Vyturėliai;3310676316;Taip;0;1;0;1
17030;Boružėlė;Vyturėliai;87834777247;Taip;9;2;0;11
17031;Boružėlė;Vyturėliai;50071056728;Taip;0;12;0;12
17032;Boružėlė;Vyturėliai;43300167107;Taip;10;2;0;12
17033;Boružėlė;Vyturėliai;2098408445;Taip;3;1;0;4
17034;Boružėlė;Vyturėliai;8706461730;Taip;0;4;0;4
17035;Boružėlė;Vyturėliai;5337704114;Taip;0;2;0;2
17036;Boružėlė;Vyturėliai;8146684259;Taip;0;2;0;2
17037;Boružėlė;Vyturėliai;9150703371;Taip;3;0;0;3
17038;Boružėlė;Vyturėliai;5811751925;Taip;0;12;0;12
17039;Boružėlė;Vyturėliai;7136428795;Taip;0;0;1;1
17040;Boružėlė;Žvaigždutės;4990831292;Taip;5;0;0;5
17041;Boružėlė;Žvaigždutės;9838823214;Taip;13;1;0;14
17042;Boružėlė;Žvaigždutės;7825636053;Taip;0;6;0;6
17043;Boružėlė;Žvaigždutės;6293878183;Taip;0;6;0;6
17044;Boružėlė;Žvaigždutės;7901880926;Taip;5;0;0;5
17045;Boružėlė;Žvaigždutės;6242220139;Taip;0;2;0;2
17046;Boružėlė;Žvaigždutės;3489498503;Taip;6;2;0;8
17047;Boružėlė;Žvaigždutės;5274016839;Taip;0;2;0;2
17048;Boružėlė;Žvaigždutės;9720535449;Taip;2;2;3;7
17049;Boružėlė;Žvaigždutės;6435556131;Taip;2;2;3;7
17050;Boružėlė;Žvaigždutės;3140264242;Taip;4;1;0;5
17051;Boružėlė;Žvaigždutės;5804189049;Taip;0;0;14;14
17052;Boružėlė;Žvaigždutės;5307997577;Taip;15;0;0;15
17053;Boružėlė;Žvaigždutės;8916241914;Taip;0;2;0;2
17054;Boružėlė;Žvaigždutės;6724101421;Taip;0;8;1;9
17055;Boružėlė;Žvaigždutės;7078709057;Taip;4;0;0;4
17056;Boružėlė;Žvaigždutės;6972646373;Taip;9;2;0;11
17057;Boružėlė;Žvaigždutės;8820827882;Ne;0;1;0;1
17058;Boružėlė;Žvaigždutės;2857645329;Ne;5;1;0;6
17059;Boružėlė;Žvaigždutės;5242187638;Taip;6;0;0;6
17060;Boružėlė;Ąžuoliukai;5774358876;Taip;0;4;0;4
17061;Boružėlė;Ąžuoliukai;4519645340;Taip;0;2;1;3
17062;Boružėlė;Ąžuoliukai;24315678618;Taip;0;16;0;16
17063;Boružėlė;Ąžuoliukai;4994696176;Ne;5;0;0;5
17064;Boružėlė;Ąžuoliukai;3040376382;Taip;0;2;2;4
17065;Boružėlė;Ąžuoliukai;3912668735;Taip;12;1;0;13
17066;Boružėlė;Ąžuoliukai;3840860155;Ne;0;10;0;10
17067;Boružėlė;Ąžuoliukai;7722277859;Taip;0;2;0;2
17068;Boružėlė;Ąžuoliukai;6954794465;Taip;9;2;6;17
17069;Boružėlė;Ąžuoliukai;5832223872;Taip;0;2;0;2
17070;Boružėlė;Ąžuoliukai;3695411422;Taip;0;13;0;13
17071;Boružėlė;Ąžuoliukai;5148410392;Ne;0;0;6;6
17072;Boružėlė;Ąžuoliukai;45181369655;Taip;0;0;1;1
17073;Boružėlė;Ąžuoliukai;2077228543;Taip;0;0;15;15
17074;Boružėlė;Ąžuoliukai;6022191251;Ne;3;8;0;11
17075;Boružėlė;Ąžuoliukai;3869817904;Taip;0;2;0;2
17076;Boružėlė;Ąžuoliukai;8029389952;Taip;0;2;1;3
17077;Boružėlė;Saulutės;46425201501;Taip;0;1;0;1
17078;Boružėlė;Saulutės;1247185819;Taip;0;2;0;2
17079;Boružėlė;Saulutės;8814486475;Taip;0;2;0;2
17080;Boružėlė;Saulutės;96500755145;Ne;0;1;0;1
17081;Boružėlė;Saulutės;1506999888;Taip;0;2;0;2
17082;Boružėlė;Saulutės;2402968573;Taip;0;2;0;2
17083;Boružėlė;Saulutės;2690216341;Ne;0;4;0;4
17084;Boružėlė;Saulutės;64347371263;Taip;0;2;1;3
17085;Boružėlė;Saulutės;1750151078;Taip;0;2;16;18
17086;Boružėlė;Saulutės;1580917200;Taip;0;3;0;3
17087;Boružėlė;Saulutės;89046897963;Taip;0;0;2;2
17088;Boružėlė;Saulutės;55049551150;Taip;0;3;0;3
17089;Boružėlė;Saulutės;2618814096;Taip;0;3;1;4
17090;Boružėlė;Ežiukai;80490841186;Taip;15;0;0;15
17091;Boružėlė;Ežiukai;97765175729;Taip;5;1;0;6
17092;Boružėlė;Ežiukai;58923894463;Taip;5;2;0;7
17093;Boružėlė;Ežiukai;27456755162;Taip;0;2;0;2
17094;Boružėlė;Ežiukai;1339605077;Taip;0;1;0;1
17095;Boružėlė;Ežiukai;80239337645;Taip;0;2;0;2
17096;Boružėlė;Ežiukai;1007058344;Taip;10;2;0;12
17097;Boružėlė;Ežiukai;86859788504;Taip;0;2;0;2
17098;Boružėlė;Ežiukai;2138048547;Ne;3;1;0;4
17099;Boružėlė;Ežiukai;1431869021;Taip;13;1;0;14
17100;Boružėlė;Ežiukai;1474967056;Taip;0;2;0;2
17101;Boružėlė;Ežiukai;62548032852;Ne;0;2;0;2
17102;Boružėlė;Ežiukai;17258743024;Taip;0;1;0;1
17103;Boružėlė;Ežiukai;31109596405;Taip;0;10;0;10
17104;Boružėlė;Ežiukai;46486992436;Taip;12;0;0;12
17105;Boružėlė;Ežiukai;61932744418;Taip;0;1;0;1
17106;Boružėlė;Ežiukai;1459630343;Taip;0;4;0;4
17107;Boružėlė;Ežiukai;8266904750;Taip;5;6;0;11
17108;Boružėlė;Ežiukai;80378241169;Taip;0;1;0;1
17109;Boružėlė;Ežiukai;73347816357;Taip;0;1;0;1
17110;Boružėlė;Boružiukai;2524469162;Ne;6;0;0;6
17111;Boružėlė;Boružiukai;5768415821;Taip;0;2;0;2
17112;Boružėlė;Boružiukai;6609156790;Taip;0;4;1;5
17113;Boružėlė;Boružiukai;7068409148;Taip;5;1;0;6
17114;Boružėlė;Boružiukai;8804878419;Taip;0;4;5;9
17115;Boružėlė;Boružiukai;3871593172;Taip;0;4;5;9
17116;Boružėlė;Boružiukai;3953507461;Taip;8;7;0;15
17117;Boružėlė;Boružiukai;3859125174;Taip;15;0;0;15
17118;Boružėlė;Boružiukai;1492091211;Taip;0;1;0;1
17119;Boružėlė;Boružiukai;1830043506;Taip;0;1;0;1
17120;Boružėlė;Boružiukai;5680510186;Taip;0;11;0;11
17121;Boružėlė;Boružiukai;1152697871;Taip;0;10;0;10
17122;Boružėlė;Boružiukai;5508064424;Taip;0;2;5;7
17123;Boružėlė;Nykštukai;2926620929;Taip;5;4;0;9
17124;Boružėlė;Nykštukai;5825164520;Taip;4;0;12;16
17125;Boružėlė;Nykštukai;1784594085;Taip;0;2;0;2
17126;Boružėlė;Nykštukai;6448688592;Taip;0;0;2;2
17127;Boružėlė;Nykštukai;2429696310;Taip;6;1;0;7
17128;Boružėlė;Nykštukai;9893643199;Taip;0;5;0;5
17129;Boružėlė;Nykštukai;3112016309;Ne;11;0;0;11
17130;Boružėlė;Nykštukai;5394149649;Ne;11;0;0;11
17131;Boružėlė;Nykštukai;7260471712;Taip;0;4;1;5
17132;Boružėlė;Nykštukai;9423458813;Taip;1;0;0;1
17133;Boružėlė;Nykštukai;7190980006;Ne;0;1;0;1
17134;Žaliakalnio;Drugeliai;1012597457;Taip;0;6;0;6
17135;Žaliakalnio;Drugeliai;5428225559;Ne;0;0;5;5
17136;Žaliakalnio;Drugeliai;20794781914;Taip;0;0;2;2
17137;Žaliakalnio;Drugeliai;6379145626;Ne;7;0;0;7
17138;Žaliakalnio;Drugeliai;9771191966;Taip;6;0;3;9
17139;Žaliakalnio;Drugeliai;7094914749;Taip;11;0;1;12
17140;Žaliakalnio;Drugeliai;7449949339;Ne;0;0;1;1
17141;Žaliakalnio;Drugeliai;2607433844;Taip;0;6;0;6
17142;Žaliakalnio;Drugeliai;1413563085;Ne;6;1;0;7
17143;Žaliakalnio;Drugeliai;3058369504;Ne;9;2;0;11
17144;Žaliakalnio;Drugeliai;2432935088;Ne;0;3;0;3
17145;Žaliakalnio;Drugeliai;92533370070;Ne;0;8;0;8
17146;Žaliakalnio;Drugeliai;40283689721;Taip;0;2;0;2
17147;Žaliakalnio;Drugeliai;6986149495;Ne;0;1;0;1
17148;Žaliakalnio;Boružėlių;5843020412;Taip;0;5;0;5
17149;Žaliakalnio;Boružėlių;9625531462;Taip;0;13;0;13
17150;Žaliakalnio;Boružėlių;6699373334;Taip;0;13;0;13
17151;Žaliakalnio;Boružėlių;7087535800;Taip;0;2;0;2
17152;Žaliakalnio;Boružėlių;1528111839;Taip;3;0;2;5
17153;Žaliakalnio;Boružėlių;7023886811;Taip;0;2;0;2
17154;Žaliakalnio;Boružėlių;1673321992;Taip;0;3;0;3
17155;Žaliakalnio;Boružėlių;2284465378;Taip;4;6;0;10
17156;Žaliakalnio;Boružėlių;7977009681;Taip;0;2;0;2
17157;Žaliakalnio;Boružėlių;2808776865;Taip;10;0;2;12
17158;Žaliakalnio;Boružėlių;2278681435;Taip;5;0;5;10
17159;Žaliakalnio;Boružėlių;5157814568;Taip;5;0;0;5
17160;Žaliakalnio;Boružėlių;9421259943;Taip;12;0;0;12
17161;Žaliakalnio;Boružėlių;3445649442;Taip;0;3;0;3
17162;Žaliakalnio;Boružėlių;3105500733;Taip;0;8;0;8
17163;Žaliakalnio;Boružėlių;5764128482;Taip;9;0;0;9
17164;Žaliakalnio;Boružėlių;1200844791;Ne;6;0;0;6
17165;Žaliakalnio;Boružėlių;8052539476;Taip;4;0;4;8
17166;Žaliakalnio;Boružėlių;6590016097;Ne;0;9;0;9
17167;Žaliakalnio;Boružėlių;8304431519;Ne;0;0;2;2
17168;Žaliakalnio;Boružėlių;5488964606;Taip;5;0;0;5
17169;Žaliakalnio;Zuikučiai;1592051491;Taip;0;5;0;5
17170;Žaliakalnio;Zuikučiai;6088333997;Taip;7;3;0;10
17171;Žaliakalnio;Zuikučiai;2673619031;Taip;0;2;0;2
17172;Žaliakalnio;Zuikučiai;5843314345;Ne;5;1;1;7
17173;Žaliakalnio;Zuikučiai;2180165053;Taip;5;1;0;6
17174;Žaliakalnio;Zuikučiai;6823528666;Ne;15;1;0;16
17175;Žaliakalnio;Zuikučiai;3509064089;Taip;0;2;0;2
17176;Žaliakalnio;Zuikučiai;7000429934;Taip;0;1;0;1
17177;Žaliakalnio;Zuikučiai;5730610895;Taip;0;3;0;3
17178;Žaliakalnio;Zuikučiai;6881070397;Taip;0;6;0;6
17179;Žaliakalnio;Zuikučiai;8209559343;Taip;10;0;0;10
17180;Žaliakalnio;Zuikučiai;3835667120;Taip;0;0;3;3
17181;Žaliakalnio;Zuikučiai;9799056285;Ne;0;1;0;1
17182;Žaliakalnio;Zuikučiai;1321592040;Ne;0;1;0;1
17183;Žaliakalnio;Zuikučiai;8298313285;Taip;0;1;3;4
17184;Žaliakalnio;Zuikučiai;9331287916;Taip;2;4;0;6
17185;Žaliakalnio;Zuikučiai;6726832258;Taip;0;6;0;6
17186;Žaliakalnio;Zuikučiai;4607456527;Taip;13;1;0;14
17187;Žaliakalnio;Zuikučiai;6341640909;Taip;7;0;2;9
17188;Žaliakalnio;Bitutė;5744370516;Ne;9;0;0;9
17189;Žaliakalnio;Bitutė;3619817569;Ne;6;0;0;6
17190;Žaliakalnio;Bitutė;3905448562;Taip;10;0;0;10
17191;Žaliakalnio;Bitutė;8481665290;Taip;7;0;1;8
17192;Žaliakalnio;Bitutė;8950583202;Ne;0;5;0;5
17193;Žaliakalnio;Bitutė;8201084481;Taip;4;0;1;5
17194;Žaliakalnio;Bitutė;6324315523;Ne;9;5;0;14
17195;Žaliakalnio;Bitutė;6877235095;Ne;7;0;0;7
17196;Žaliakalnio;Bitutė;2280683252;Ne;5;0;0;5
17197;Žaliakalnio;Bitutė;7711347723;Ne;6;0;0;6
17198;Žaliakalnio;Bitutė;4561672875;Ne;2;0;0;2
17199;Žaliakalnio;Bitutė;8185190219;Taip;5;0;0;5
17200;Žaliakalnio;Bitutė;1423481154;Ne;0;3;0;3
17201;Žaliakalnio;Bitutė;2613771302;Taip;5;0;0;5
17202;Žaliakalnio;Bitutė;3976548663;Taip;3;0;0;3
17203;Žaliakalnio;Bitutė;8599646291;Ne;3;0;0;3
17204;Žaliakalnio;Bitutė;3721878250;Ne;5;0;2;7
17205;Žaliakalnio;Nykštukų;9057678671;Ne;5;2;1;8
17206;Žaliakalnio;Nykštukų;8640423692;Taip;0;2;2;4
17207;Žaliakalnio;Nykštukų;19192494119;Taip;2;1;0;3
17208;Žaliakalnio;Nykštukų;91524700281;Ne;0;1;0;1
17209;Žaliakalnio;Nykštukų;1753760382;Taip;0;1;0;1
17210;Žaliakalnio;Nykštukų;4936664829;Taip;0;1;0;1
17211;Žaliakalnio;Nykštukų;1657390839;Ne;0;7;0;7
17212;Žaliakalnio;Nykštukų;8085215871;Taip;0;4;0;4
17213;Žaliakalnio;Nykštukų;41844570217;Ne;0;1;0;1
17214;Žaliakalnio;Nykštukų;6638075273;Ne;4;4;0;8
17215;Žaliakalnio;Nykštukų;21744638321;Taip;0;1;0;1
17216;Žaliakalnio;Nykštukų;1514982516;Taip;9;0;0;9
17217;Žaliakalnio;Nykštukų;5946168564;Ne;0;2;0;2
17218;Žaliakalnio;Nykštukų;44058368949;Ne;0;2;0;2
17219;Žaliakalnio;ŽIOGELIAI;2426844621;Ne;0;3;0;3
17220;Žaliakalnio;ŽIOGELIAI;5752912101;Ne;0;9;0;9
17221;Žaliakalnio;ŽIOGELIAI;9967098834;Ne;0;0;1;1
17222;Žaliakalnio;ŽIOGELIAI;1133557422;Taip;0;4;0;4
17223;Žaliakalnio;ŽIOGELIAI;3464935314;Taip;0;2;0;2
17224;Žaliakalnio;ŽIOGELIAI;4497938258;Ne;0;6;0;6
17225;Žaliakalnio;ŽIOGELIAI;7648422668;Ne;5;3;0;8
17226;Žaliakalnio;ŽIOGELIAI;4702470511;Ne;8;1;0;9
17227;Žaliakalnio;ŽIOGELIAI;2272043654;Taip;0;3;2;5
17228;Žaliakalnio;ŽIOGELIAI;2305496316;Ne;15;2;0;17
17229;Žaliakalnio;ŽIOGELIAI;6674631040;Taip;10;0;0;10
17230;Žaliakalnio;ŽIOGELIAI;8245784590;Taip;20;0;0;20
17231;Žaliakalnio;ŽIOGELIAI;9485995178;Taip;0;9;0;9
17232;Žaliakalnio;ŽIOGELIAI;8179329874;Ne;12;0;0;12
17233;Žaliakalnio;ŽIOGELIAI;8383425712;Ne;0;6;0;6
17234;Žaliakalnio;ŽIOGELIAI;1309236035;Ne;7;0;0;7
17235;Žaliakalnio;ŽIOGELIAI;7025195076;Ne;8;0;0;8
17236;Žaliakalnio;ŽIOGELIAI;2514763739;Ne;6;2;0;8
17237;Žaliakalnio;ŽIOGELIAI;8891815592;Ne;5;0;0;5
17238;Volungė;Bitutės;6273977588;Ne;0;0;1;1
17239;Volungė;Bitutės;1689261748;Taip;1;0;1;2
17240;Volungė;Bitutės;2139675610;Taip;0;0;2;2
17241;Volungė;Bitutės;1333045175;Ne;0;0;2;2
17242;Volungė;Bitutės;1742777458;Taip;0;0;2;2
17243;Volungė;Bitutės;2111319986;Ne;0;0;1;1
17244;Volungė;Bitutės;3803129970;Taip;1;0;2;3
17245;Volungė;Bitutės;1752357091;Taip;3;0;0;3
17246;Volungė;Bitutės;1974360497;Taip;3;0;2;5
17247;Volungė;Bitutės;7075466773;Taip;0;0;1;1
17248;Volungė;Bitutės;1167124464;Ne;7;0;0;7
17249;Volungė;Bitutės;2763686861;Taip;21;0;0;21
17250;Volungė;Bitutės;1900204936;Taip;0;2;0;2
17251;Volungė;Bitutės;1726933019;Taip;3;0;0;3
17252;Volungė;Bitutės;1539188909;Taip;3;0;0;3
17253;Volungė;Bitutės;3155184296;Ne;0;0;3;3
17254;Volungė;Bitutės;1291153830;Taip;2;8;0;10
17255;Volungė;Bitutės;1333755594;Taip;0;0;2;2
17256;Volungė;Bitutės;86769531194;Taip;0;0;2;2
17257;Volungė;Bitutės;19340864795;Taip;0;10;0;10
17258;Volungė;Bitutės;86784613109;Taip;0;0;5;5
17259;Volungė;Bitutės;1731981819;Ne;7;0;0;7
17260;Volungė;Boružiukai;6431477042;Taip;0;0;1;1
17261;Volungė;Boružiukai;1137713075;Taip;0;9;0;9
17262;Volungė;Boružiukai;2322594823;Ne;8;5;0;13
17263;Volungė;Boružiukai;7965601199;Taip;0;0;1;1
17264;Volungė;Boružiukai;5710662590;Taip;0;0;2;2
17265;Volungė;Boružiukai;3746978206;Taip;0;0;1;1
17266;Volungė;Boružiukai;1528289101;Taip;0;0;3;3
17267;Volungė;Boružiukai;4839484528;Taip;0;0;9;9
17268;Volungė;Boružiukai;9188994935;Taip;5;13;0;18
17269;Volungė;Boružiukai;8285309230;Taip;5;0;0;5
17270;Volungė;Boružiukai;4598763851;Taip;0;0;2;2
17271;Volungė;Boružiukai;5174427959;Taip;7;1;4;12
17272;Volungė;Boružiukai;7867741556;Ne;4;3;0;7
17273;Volungė;Boružiukai;3430719834;Taip;0;1;0;1
17274;Volungė;Boružiukai;8459167833;Taip;3;0;3;6
17275;Volungė;Boružiukai;8784150784;Taip;0;11;0;11
17276;Volungė;Žvirbliukai;2599441104;Taip;0;0;1;1
17277;Volungė;Žvirbliukai;4745609424;Taip;0;0;3;3
17278;Volungė;Žvirbliukai;8333832673;Taip;0;0;2;2
17279;Volungė;Žvirbliukai;3222329369;Ne;0;0;11;11
17280;Volungė;Žvirbliukai;7584598377;Taip;0;0;1;1
17281;Volungė;Žvirbliukai;7151952679;Taip;0;0;11;11
17282;Volungė;Žvirbliukai;3106135598;Taip;0;0;1;1
17283;Volungė;Žvirbliukai;3832613221;Ne;8;0;0;8
17284;Volungė;Žvirbliukai;6755366051;Taip;6;0;3;9
17285;Volungė;Žvirbliukai;8470433743;Taip;7;0;2;9
17286;Volungė;Žvirbliukai;9343118795;Ne;4;0;6;10
17287;Volungė;Žvirbliukai;7971287899;Ne;0;3;0;3
17288;Volungė;Žvirbliukai;4013639324;Taip;0;0;15;15
17289;Volungė;Žvirbliukai;3666364101;Taip;0;0;15;15
17290;Volungė;Pelėdžiukai;1105647976;Ne;0;0;1;1
17291;Volungė;Pelėdžiukai;1705153224;Taip;0;0;1;1
17292;Volungė;Pelėdžiukai;2048619311;Taip;5;0;2;7
17293;Volungė;Pelėdžiukai;9097775073;Ne;2;0;0;2
17294;Volungė;Pelėdžiukai;1938717633;Taip;6;0;0;6
17295;Volungė;Pelėdžiukai;1072302178;Taip;0;0;1;1
17296;Volungė;Pelėdžiukai;6977873198;Taip;0;0;6;6
17297;Volungė;Pelėdžiukai;1917593287;Taip;9;0;1;10
17298;Volungė;Pelėdžiukai;1861218588;Ne;0;0;4;4
17299;Volungė;Pelėdžiukai;8236836742;Taip;0;0;2;2
17300;Volungė;Pelėdžiukai;3632828615;Ne;13;0;0;13
17301;Volungė;Pelėdžiukai;72152762554;Ne;0;0;2;2
17302;Volungė;Pelėdžiukai;1021284696;Taip;0;0;5;5
17303;Volungė;Pelėdžiukai;79934072325;Ne;0;0;3;3
17304;Volungė;"SKRUZDĖLIUKAI ";8174587725;Taip;0;0;18;18
17305;Volungė;"SKRUZDĖLIUKAI ";7521910384;Taip;0;0;5;5
17306;Volungė;"SKRUZDĖLIUKAI ";2566901599;Taip;0;0;3;3
17307;Volungė;"SKRUZDĖLIUKAI ";3215314804;Ne;0;0;1;1
17308;Volungė;"SKRUZDĖLIUKAI ";7281448136;Ne;0;2;0;2
17309;Volungė;"SKRUZDĖLIUKAI ";2420242319;Taip;0;0;3;3
17310;Volungė;"SKRUZDĖLIUKAI ";1120682487;Taip;0;0;3;3
17311;Volungė;"SKRUZDĖLIUKAI ";1366066359;Taip;0;0;6;6
17312;Volungė;"SKRUZDĖLIUKAI ";9068889427;Ne;0;0;5;5
17313;Volungė;"SKRUZDĖLIUKAI ";1225378067;Ne;5;0;3;8
17314;Volungė;"SKRUZDĖLIUKAI ";3356901662;Taip;10;0;3;13
17315;Volungė;"SKRUZDĖLIUKAI ";9082860913;Taip;5;0;3;8
17316;Volungė;"SKRUZDĖLIUKAI ";9629567682;Taip;0;15;2;17
17317;Volungė;"SKRUZDĖLIUKAI ";3814647332;Taip;0;0;2;2
17318;Volungė;"SKRUZDĖLIUKAI ";4123080241;Taip;0;21;0;21
17319;Volungė;"SKRUZDĖLIUKAI ";17534618616;Ne;0;0;1;1
17320;Volungė;"SKRUZDĖLIUKAI ";7364431725;Ne;0;0;3;3
17321;Giliukas;SMALSUČIAI;3252419072;Taip;1;10;0;11
17322;Giliukas;SMALSUČIAI;9608331265;Taip;5;2;3;10
17323;Giliukas;SMALSUČIAI;1870173947;Taip;11;0;0;11
17324;Giliukas;SMALSUČIAI;9644050818;Taip;13;1;0;14
17325;Giliukas;SMALSUČIAI;3150981084;Taip;12;2;0;14
17326;Giliukas;SMALSUČIAI;6134554678;Taip;0;4;2;6
17327;Giliukas;SMALSUČIAI;3137768675;Taip;8;0;0;8
17328;Giliukas;SMALSUČIAI;9408948207;Taip;7;2;1;10
17329;Giliukas;SMALSUČIAI;2003990493;Taip;0;3;0;3
17330;Giliukas;SMALSUČIAI;4960232685;Taip;5;0;0;5
17331;Giliukas;SMALSUČIAI;2692141913;Taip;18;0;0;18
17332;Giliukas;SMALSUČIAI;8267507304;Ne;21;0;0;21
17333;Giliukas;SMALSUČIAI;4854370266;Taip;4;2;0;6
17334;Giliukas;SMALSUČIAI;6338583515;Taip;1;1;0;2
17335;Giliukas;SMALSUČIAI;9458151965;Taip;0;0;1;1
17336;Giliukas;SMALSUČIAI;6703080106;Taip;10;1;0;11
17337;Giliukas;SMALSUČIAI;3691791222;Taip;0;1;0;1
17338;Giliukas;SMALSUČIAI;3847358328;Taip;0;11;0;11
17339;Giliukas;SMALSUČIAI;1890147760;Taip;6;0;0;6
17340;Giliukas;SMALSUČIAI;1469477982;Taip;15;0;0;15
17341;Giliukas;SMALSUČIAI;3983555939;Taip;0;2;3;5
17342;Giliukas;SMALSUČIAI;2951628295;Taip;0;2;0;2
17343;Giliukas;SMALSUČIAI;9401247559;Taip;0;4;0;4
17344;Giliukas;SMALSUČIAI;5994213515;Taip;11;0;0;11
17345;Giliukas;SMALSUČIAI;4916844983;Taip;0;5;0;5
17346;Giliukas;SMALSUČIAI;5787041097;Taip;9;0;0;9
17347;Giliukas;SMALSUČIAI;7159681896;Taip;0;0;2;2
17348;Giliukas;GUDRUČIAI;45270647252;Taip;0;1;0;1
17349;Giliukas;GUDRUČIAI;1289574961;Taip;0;2;0;2
17350;Giliukas;GUDRUČIAI;89954209937;Taip;0;1;0;1
17351;Giliukas;GUDRUČIAI;4053376466;Ne;12;2;0;14
17352;Giliukas;GUDRUČIAI;26109227683;Taip;10;0;0;10
17353;Giliukas;GUDRUČIAI;9225515816;Taip;0;2;0;2
17354;Giliukas;GUDRUČIAI;10326073797;Taip;12;1;0;13
17355;Giliukas;GUDRUČIAI;7732836522;Taip;4;0;0;4
17356;Giliukas;GUDRUČIAI;1406371374;Taip;5;11;0;16
17357;Giliukas;GUDRUČIAI;1664239181;Taip;10;0;0;10
17358;Giliukas;GUDRUČIAI;40373221046;Taip;0;1;0;1
17359;Giliukas;GUDRUČIAI;1595057434;Taip;3;2;1;6
17360;Giliukas;GUDRUČIAI;1417138570;Taip;0;0;1;1
17361;Giliukas;GUDRUČIAI;1463748654;Taip;0;2;0;2
17362;Giliukas;GUDRUČIAI;14318411597;Taip;0;2;0;2
17363;Giliukas;GUDRUČIAI;9461909264;Taip;5;1;0;6
17364;Giliukas;GUDRUČIAI;8575067944;Ne;2;4;0;6
17365;Giliukas;GUDRUČIAI;6453425490;Taip;7;0;0;7
17366;Giliukas;GUDRUČIAI;1190611675;Ne;0;1;0;1
17367;"Lazdynų mokykla";Drugeliai;6209271043;Taip;0;1;0;1
17368;"Lazdynų mokykla";Drugeliai;7154882168;Taip;0;21;0;21
17369;"Lazdynų mokykla";Drugeliai;4520091712;Taip;2;0;3;5
17370;"Lazdynų mokykla";Drugeliai;1177208864;Taip;9;0;0;9
17371;"Lazdynų mokykla";Drugeliai;8472834181;Ne;0;2;0;2
17372;"Lazdynų mokykla";Drugeliai;9196184984;Taip;5;0;0;5
17373;"Lazdynų mokykla";Drugeliai;6394098306;Taip;0;0;8;8
17374;"Lazdynų mokykla";Drugeliai;2027751624;Taip;5;1;0;6
17375;"Lazdynų mokykla";Drugeliai;2767732459;Ne;10;3;0;13
17376;"Lazdynų mokykla";Drugeliai;3680758366;Taip;0;10;0;10
17377;"Lazdynų mokykla";Drugeliai;7524849851;Taip;6;0;0;6
17378;"Lazdynų mokykla";Zuikučiai;6615724604;Taip;6;1;0;7
17379;"Lazdynų mokykla";Zuikučiai;25106446270;Taip;0;1;0;1
17380;"Lazdynų mokykla";Zuikučiai;9123178095;Taip;0;7;0;7
17381;"Lazdynų mokykla";Zuikučiai;6848743350;Taip;0;9;0;9
17382;"Lazdynų mokykla";Zuikučiai;1365362641;Taip;0;2;0;2
17383;"Lazdynų mokykla";Zuikučiai;3435025978;Taip;0;0;7;7
17384;"Lazdynų mokykla";Zuikučiai;8899186547;Taip;2;0;0;2
17385;"Lazdynų mokykla";Zuikučiai;1044630813;Taip;0;2;0;2
17386;"Lazdynų mokykla";Zuikučiai;3268305561;Taip;0;14;2;16
17387;"Lazdynų mokykla";Zuikučiai;8650496265;Taip;7;0;0;7
17388;"Lazdynų mokykla";Zuikučiai;3535244441;Taip;10;0;0;10
17389;"Lazdynų mokykla";RUPG;1017100748;Taip;0;2;0;2
17390;"Lazdynų mokykla";RUPG;9236417880;Taip;2;0;0;2
17391;"Lazdynų mokykla";RUPG;2601881804;Taip;2;0;0;2
17392;"Lazdynų mokykla";RUPG;7743741353;Taip;0;20;0;20
17393;"Lazdynų mokykla";RUPG;8886654664;Taip;14;0;0;14
17394;"Lazdynų mokykla";RUPG;5076773045;Ne;0;0;2;2
17395;"Lazdynų mokykla";RUPG;6646352376;Ne;0;20;0;20
17396;"Lazdynų mokykla";PG;64706392096;Ne;6;2;0;8
17397;"Lazdynų mokykla";PG;1169321455;Taip;8;0;3;11
17398;"Lazdynų mokykla";PG;64601938351;Taip;0;7;0;7
17399;"Lazdynų mokykla";PG;1608544032;Taip;5;0;0;5
17400;"Lazdynų mokykla";PG;80459437057;Ne;2;0;0;2
17401;"Lazdynų mokykla";PG;8324750958;Ne;0;0;1;1
17402;"Lazdynų mokykla";PG;9591838054;Taip;7;1;0;8
17403;"Lazdynų mokykla";PG;3171487020;Taip;0;0;2;2
17404;"„Atžalyno” mokykla-darželis";Giliukai;8354263485;Ne;0;0;3;3
17405;"„Atžalyno” mokykla-darželis";Giliukai;67951758325;Ne;4;0;0;4
17406;"„Atžalyno” mokykla-darželis";Giliukai;3917667527;Ne;17;0;0;17
17407;"„Atžalyno” mokykla-darželis";Giliukai;12954283491;Taip;3;0;0;3
17408;"„Atžalyno” mokykla-darželis";Giliukai;25326505521;Ne;5;0;1;6
17409;"„Atžalyno” mokykla-darželis";Giliukai;41775536104;Ne;6;0;0;6
17410;"„Atžalyno” mokykla-darželis";Giliukai;25013138823;Taip;5;0;1;6
17411;"„Atžalyno” mokykla-darželis";Giliukai;9132383069;Taip;4;0;0;4
17412;"„Atžalyno” mokykla-darželis";Giliukai;1646943569;Ne;5;0;0;5
17413;"„Atžalyno” mokykla-darželis";Giliukai;1282991939;Taip;0;0;1;1
17414;"„Atžalyno” mokykla-darželis";Giliukai;1220962473;Taip;0;0;1;1
17415;"„Atžalyno” mokykla-darželis";Giliukai;58448505612;Taip;5;0;1;6
17416;"„Atžalyno” mokykla-darželis";Giliukai;1713297707;Taip;5;0;1;6
17417;"„Atžalyno” mokykla-darželis";Giliukai;18997417056;Ne;0;0;1;1
17418;"„Atžalyno” mokykla-darželis";Giliukai;38762730531;Ne;6;0;5;11
17419;"„Atžalyno” mokykla-darželis";Giliukai;3461773781;Taip;5;0;2;7
17420;"„Atžalyno” mokykla-darželis";Giliukai;71840666522;Ne;5;0;1;6
17421;"„Atžalyno” mokykla-darželis";Giliukai;4290226052;Ne;5;0;6;11
17422;"„Atžalyno” mokykla-darželis";Giliukai;37897965773;Ne;2;0;2;4
17423;"„Atžalyno” mokykla-darželis";Riešutėliai;4784990018;Ne;5;1;0;6
17424;"„Atžalyno” mokykla-darželis";Riešutėliai;4422345256;Taip;0;0;1;1
17425;"„Atžalyno” mokykla-darželis";Riešutėliai;5596753512;Ne;0;0;1;1
17426;"„Atžalyno” mokykla-darželis";Riešutėliai;9806203065;Taip;5;1;0;6
17427;"„Atžalyno” mokykla-darželis";Riešutėliai;4832534190;Taip;0;1;1;2
17428;"„Atžalyno” mokykla-darželis";Riešutėliai;9215658103;Taip;0;0;3;3
17429;"„Atžalyno” mokykla-darželis";Riešutėliai;3484401937;Taip;2;0;3;5
17430;"„Atžalyno” mokykla-darželis";Riešutėliai;7652421432;Taip;3;0;0;3
17431;"„Atžalyno” mokykla-darželis";Riešutėliai;8254801574;Taip;0;1;0;1
17432;"„Atžalyno” mokykla-darželis";Riešutėliai;9013323901;Taip;11;3;0;14
17433;"„Atžalyno” mokykla-darželis";Riešutėliai;3529875728;Ne;5;1;0;6
17434;"„Atžalyno” mokykla-darželis";Riešutėliai;8688627865;Ne;7;0;1;8
17435;"„Atžalyno” mokykla-darželis";Riešutėliai;5030879885;Taip;5;0;2;7
17436;"„Atžalyno” mokykla-darželis";Riešutėliai;2772290605;Ne;8;0;3;11
17437;"„Atžalyno” mokykla-darželis";Riešutėliai;3170216428;Ne;0;0;1;1
17438;"„Atžalyno” mokykla-darželis";Riešutėliai;2935281062;Taip;0;0;1;1
17439;"„Atžalyno” mokykla-darželis";Riešutėliai;1311162040;Ne;5;0;1;6
17440;"„Atžalyno” mokykla-darželis";Riešutėliai;2601122166;Taip;5;0;0;5
17441;"„Atžalyno” mokykla-darželis";Riešutėliai;4427232735;Ne;0;9;0;9
17442;"„Atžalyno” mokykla-darželis";Riešutėliai;5503766544;Taip;0;4;0;4
17443;"„Atžalyno” mokykla-darželis";Riešutėliai;3770972703;Ne;1;0;0;1
17444;"„Atžalyno” mokykla-darželis";Žirniukai;6903825217;Ne;0;11;0;11
17445;"„Atžalyno” mokykla-darželis";Žirniukai;9101301819;Taip;8;1;0;9
17446;"„Atžalyno” mokykla-darželis";Žirniukai;6602037942;Taip;0;3;0;3
17447;"„Atžalyno” mokykla-darželis";Žirniukai;7579781779;Ne;5;1;0;6
17448;"„Atžalyno” mokykla-darželis";Žirniukai;1915676392;Ne;8;0;0;8
17449;"„Atžalyno” mokykla-darželis";Žirniukai;7669725276;Taip;2;12;0;14
17450;"„Atžalyno” mokykla-darželis";Žirniukai;5986664970;Taip;0;0;5;5
17451;"„Atžalyno” mokykla-darželis";Žirniukai;9913048992;Taip;0;5;0;5
17452;"„Atžalyno” mokykla-darželis";Žirniukai;4107946143;Taip;12;1;0;13
17453;"„Atžalyno” mokykla-darželis";Žirniukai;7883570492;Ne;3;6;0;9
17454;"„Atžalyno” mokykla-darželis";Žirniukai;8320161812;Taip;3;11;0;14
17455;"„Atžalyno” mokykla-darželis";Žirniukai;5335059675;Taip;0;9;0;9
17456;"„Atžalyno” mokykla-darželis";Žirniukai;9690554753;Taip;3;0;1;4
17457;"„Atžalyno” mokykla-darželis";Žirniukai;1961428224;Ne;8;0;1;9
17458;"„Atžalyno” mokykla-darželis";Žirniukai;8070499557;Taip;0;5;0;5
17459;"„Atžalyno” mokykla-darželis";Žirniukai;2446697763;Ne;0;0;4;4
17460;"„Atžalyno” mokykla-darželis";Žirniukai;8515097324;Taip;12;0;0;12
17461;"„Atžalyno” mokykla-darželis";PIPIRIUKAI;8357021249;Taip;5;3;0;8
17462;"„Atžalyno” mokykla-darželis";PIPIRIUKAI;5615246040;Taip;4;0;1;5
17463;"„Atžalyno” mokykla-darželis";PIPIRIUKAI;4379645417;Ne;2;0;1;3
17464;"„Atžalyno” mokykla-darželis";PIPIRIUKAI;6721771665;Ne;7;0;0;7
17465;"„Atžalyno” mokykla-darželis";PIPIRIUKAI;7946139474;Ne;5;2;0;7
17466;"„Atžalyno” mokykla-darželis";PIPIRIUKAI;2921181385;Taip;0;0;1;1
17467;"„Atžalyno” mokykla-darželis";PIPIRIUKAI;2108706876;Ne;8;0;0;8
17468;"„Atžalyno” mokykla-darželis";PIPIRIUKAI;1228919159;Taip;7;0;0;7
17469;"„Atžalyno” mokykla-darželis";PIPIRIUKAI;3919301151;Ne;8;0;0;8
17470;"„Atžalyno” mokykla-darželis";PIPIRIUKAI;3624299098;Ne;0;0;4;4
17471;"„Atžalyno” mokykla-darželis";PIPIRIUKAI;2537063401;Ne;0;0;1;1
17472;"„Atžalyno” mokykla-darželis";PIPIRIUKAI;4166521512;Taip;18;0;0;18
17473;"„Atžalyno” mokykla-darželis";PIPIRIUKAI;3204191459;Taip;15;0;0;15
17474;"„Atžalyno” mokykla-darželis";PIPIRIUKAI;9674145631;Ne;12;0;0;12
17475;"„Atžalyno” mokykla-darželis";PIPIRIUKAI;5321475187;Taip;1;0;0;1
17476;"Vilniaus Emilijos Pliaterytės progimnazija";PELĖDŽIUKAI;15500820772;Ne;3;0;2;5
17477;"Vilniaus Emilijos Pliaterytės progimnazija";PELĖDŽIUKAI;36716138833;Taip;0;0;5;5
17478;"Vilniaus Emilijos Pliaterytės progimnazija";PELĖDŽIUKAI;1683299408;Taip;2;2;0;4
17479;"Vilniaus Emilijos Pliaterytės progimnazija";PELĖDŽIUKAI;94650801877;Taip;0;5;0;5
17480;"Vilniaus Emilijos Pliaterytės progimnazija";PELĖDŽIUKAI;2818073374;Taip;5;0;0;5
17481;"Vilniaus Emilijos Pliaterytės progimnazija";PELĖDŽIUKAI;2321707122;Taip;0;0;1;1
17482;"Vilniaus Emilijos Pliaterytės progimnazija";PELĖDŽIUKAI;59343571746;Taip;6;0;0;6
17483;"Vilniaus Emilijos Pliaterytės progimnazija";PELĖDŽIUKAI;9192660067;Taip;3;0;0;3
17484;"Vilniaus Emilijos Pliaterytės progimnazija";PELĖDŽIUKAI;8444759709;Taip;0;1;0;1
17485;"Vilniaus Emilijos Pliaterytės progimnazija";PELĖDŽIUKAI;2544422668;Taip;0;1;0;1
17486;"Vilniaus Emilijos Pliaterytės progimnazija";BITUTĖS;6826626104;Taip;0;0;2;2
17487;"Vilniaus Emilijos Pliaterytės progimnazija";BITUTĖS;4743331873;Ne;0;0;9;9
17488;"Vilniaus Emilijos Pliaterytės progimnazija";BITUTĖS;6763073659;Ne;5;0;1;6
17489;"Vilniaus Emilijos Pliaterytės progimnazija";BITUTĖS;38755774035;Taip;4;0;0;4
17490;"Vilniaus Emilijos Pliaterytės progimnazija";BITUTĖS;1759218238;Taip;11;0;0;11
17491;"Vilniaus Emilijos Pliaterytės progimnazija";BITUTĖS;91658912153;Taip;0;5;1;6
17492;"Vilniaus Emilijos Pliaterytės progimnazija";BITUTĖS;64959385010;Taip;0;0;1;1
17493;"Vilniaus Emilijos Pliaterytės progimnazija";BITUTĖS;2026582294;Taip;0;0;2;2
17494;"Vilniaus Emilijos Pliaterytės progimnazija";BITUTĖS;2019000592;Taip;3;0;3;6
17495;"Vilniaus Emilijos Pliaterytės progimnazija";BITUTĖS;14978429821;Taip;0;0;1;1
17496;"Vilniaus Emilijos Pliaterytės progimnazija";BITUTĖS;3215514769;Taip;0;0;3;3
17497;"Vilniaus Emilijos Pliaterytės progimnazija";BITUTĖS;8741172408;Taip;0;0;5;5
17498;"Vilniaus Emilijos Pliaterytės progimnazija";BITUTĖS;2159037118;Ne;0;0;1;1
17499;"Vilniaus Emilijos Pliaterytės progimnazija";BITUTĖS;40696452801;Taip;0;0;1;1
17500;"Vilniaus Karaliaus Mindaugo pagrindinė mokykla";"PUG 2";4743885834;Taip;0;0;7;7
17501;"Vilniaus Karaliaus Mindaugo pagrindinė mokykla";"PUG 2";94289379983;Taip;0;1;2;3
17502;"Vilniaus Karaliaus Mindaugo pagrindinė mokykla";"PUG 2";86134224919;Taip;0;2;0;2
17503;"Vilniaus Karaliaus Mindaugo pagrindinė mokykla";"PUG 2";1331295966;Ne;0;0;2;2
17504;"Vilniaus Karaliaus Mindaugo pagrindinė mokykla";"PUG 2";9166145365;Ne;0;0;3;3
17505;"Vilniaus Karaliaus Mindaugo pagrindinė mokykla";"PUG 2";13209811505;Taip;2;0;0;2
17506;"Vilniaus Karaliaus Mindaugo pagrindinė mokykla";"PUG 2";1744313172;Taip;0;0;1;1
17507;"Vilniaus Karaliaus Mindaugo pagrindinė mokykla";"PUG 2";1447824885;Ne;0;0;3;3
17508;"Vilniaus Karaliaus Mindaugo pagrindinė mokykla";"PUG 2";2851017880;Ne;0;0;2;2
17509;"Vilniaus Karaliaus Mindaugo pagrindinė mokykla";"PUG 2";2429224297;Ne;0;0;2;2
17510;"Vilniaus Karaliaus Mindaugo pagrindinė mokykla";"PUG 1";9669281441;Taip;5;0;1;6
17511;"Vilniaus Karaliaus Mindaugo pagrindinė mokykla";"PUG 1";40438226874;Taip;0;0;2;2
17512;"Vilniaus Karaliaus Mindaugo pagrindinė mokykla";"PUG 1";1000393691;Ne;5;0;0;5
17513;"Vilniaus Karaliaus Mindaugo pagrindinė mokykla";"PUG 1";3227066520;Taip;0;0;4;4
17514;"Vilniaus Karaliaus Mindaugo pagrindinė mokykla";"PUG 1";50017415248;Taip;0;5;0;5
17515;"Vilniaus Karaliaus Mindaugo pagrindinė mokykla";"PUG 1";1236147310;Ne;9;0;0;9
17516;"Vilniaus Karaliaus Mindaugo pagrindinė mokykla";"PUG 1";65711574140;Taip;0;0;1;1
17517;"Vilniaus Karaliaus Mindaugo pagrindinė mokykla";"PUG 1";63043069680;Taip;0;1;2;3
17518;"Vilniaus Karaliaus Mindaugo pagrindinė mokykla";"PUG 1";1738802158;Taip;0;0;1;1
17519;"Vilniaus Karaliaus Mindaugo pagrindinė mokykla";"PUG 1";1430790285;Taip;0;7;2;9
17520;"Vilniaus Karaliaus Mindaugo pagrindinė mokykla";"PUG 1";9654611393;Taip;7;0;1;8
17521;"Vilniaus Karaliaus Mindaugo pagrindinė mokykla";"PUG 1";1836892386;Taip;0;0;2;2
17522;"Vilniaus Karaliaus Mindaugo pagrindinė mokykla";"PUG 1";68484583641;Taip;4;0;2;6
17523;"Vilniaus Karaliaus Mindaugo pagrindinė mokykla";"PUG 1";1089500743;Taip;0;1;4;5
17524;"Vilniaus Karaliaus Mindaugo pagrindinė mokykla";"PUG 1";7087183198;Ne;4;0;2;6
17525;"Vilniaus Karaliaus Mindaugo pagrindinė mokykla";"PUG 1";28382049716;Taip;0;0;2;2
17526;"Vilniaus Levo Karsavino vidurinė mokykla";"Priešmokyklinukai A";1145364380;Taip;3;0;1;4
17527;"Vilniaus Levo Karsavino vidurinė mokykla";"Priešmokyklinukai A";23826981323;Taip;6;0;1;7
17528;"Vilniaus Levo Karsavino vidurinė mokykla";"Priešmokyklinukai A";1251970125;Taip;0;6;0;6
17529;"Vilniaus Levo Karsavino vidurinė mokykla";"Priešmokyklinukai A";1418000665;Taip;5;0;2;7
17530;"Vilniaus Levo Karsavino vidurinė mokykla";"Priešmokyklinukai A";1445891751;Taip;4;0;0;4
17531;"Vilniaus Levo Karsavino vidurinė mokykla";"Priešmokyklinukai A";45779928616;Taip;0;0;3;3
17532;"Vilniaus Levo Karsavino vidurinė mokykla";"Priešmokyklinukai A";1756267879;Ne;10;0;1;11
17533;"Vilniaus Levo Karsavino vidurinė mokykla";"Priešmokyklinukai A";1001570452;Taip;0;0;1;1
17534;"Vilniaus Levo Karsavino vidurinė mokykla";"Priešmokyklinukai A";1801436436;Ne;8;0;1;9
17535;"Vilniaus Levo Karsavino vidurinė mokykla";"Priešmokyklinukai A";6578432803;Ne;0;0;1;1
17536;"Vilniaus Levo Karsavino vidurinė mokykla";"Priešmokyklinukai B";1113638060;Taip;0;21;0;21
17537;"Vilniaus Levo Karsavino vidurinė mokykla";"Priešmokyklinukai B";1290119150;Taip;0;21;0;21
17538;"Vilniaus Levo Karsavino vidurinė mokykla";"Priešmokyklinukai B";99799126572;Taip;5;4;1;10
17539;"Vilniaus Levo Karsavino vidurinė mokykla";"Priešmokyklinukai B";6341589553;Taip;0;21;0;21
17540;"Vilniaus Levo Karsavino vidurinė mokykla";"Priešmokyklinukai B";5879965735;Taip;4;0;0;4
17541;"Vilniaus Levo Karsavino vidurinė mokykla";"Priešmokyklinukai B";95548866362;Taip;0;1;0;1
17542;"Vilniaus Levo Karsavino vidurinė mokykla";"Priešmokyklinukai B";3028866163;Ne;0;20;0;20
17543;"Vilniaus Levo Karsavino vidurinė mokykla";"Priešmokyklinukai B";4438653210;Taip;0;17;0;17
17544;"Vilniaus Levo Karsavino vidurinė mokykla";"Priešmokyklinukai B";76463522285;Ne;6;0;0;6
17545;"Vilniaus Levo Karsavino vidurinė mokykla";"Priešmokyklinukai B";1515536619;Taip;8;7;0;15
17546;"Vilniaus Levo Karsavino vidurinė mokykla";"Priešmokyklinukai B";2764568625;Taip;1;0;0;1
17547;"Vilniaus Levo Karsavino vidurinė mokykla";"Priešmokyklinukai B";53994799769;Taip;0;1;0;1
17548;"Vilniaus Levo Karsavino vidurinė mokykla";"Priešmokyklinukai B";9094328900;Taip;0;6;0;6
17549;"Vilniaus Levo Karsavino vidurinė mokykla";"Priešmokyklinukai B";3801820891;Ne;0;0;1;1
17550;"Vilniaus Liepkalnio Pagrindinė Mokykla";Bitutės;1863845099;Ne;0;0;1;1
17551;"Vilniaus Liepkalnio Pagrindinė Mokykla";Bitutės;9871477318;Taip;10;0;2;12
17552;"Vilniaus Liepkalnio Pagrindinė Mokykla";Bitutės;53725247148;Taip;0;0;1;1
17553;"Vilniaus Liepkalnio Pagrindinė Mokykla";Bitutės;5424383005;Taip;0;0;1;1
17554;"Vilniaus Liepkalnio Pagrindinė Mokykla";Bitutės;6355534391;Ne;5;0;1;6
17555;"Vilniaus Liepkalnio Pagrindinė Mokykla";Bitutės;47141854213;Taip;0;0;2;2
17556;"Vilniaus Liepkalnio Pagrindinė Mokykla";Bitutės;9929297266;Ne;12;0;3;15
17557;"Vilniaus Liepkalnio Pagrindinė Mokykla";Bitutės;4320017329;Taip;5;0;1;6
17558;"Vilniaus Liepkalnio Pagrindinė Mokykla";Bitutės;58391864442;Taip;4;0;0;4
17559;"Vilniaus Liepkalnio Pagrindinė Mokykla";Bitutės;1843306606;Taip;4;0;3;7
17560;"Vilniaus Liepkalnio Pagrindinė Mokykla";Bitutės;1106183808;Taip;7;0;5;12
17561;"Vilniaus Liepkalnio Pagrindinė Mokykla";Bitutės;9103319661;Ne;8;0;0;8
17562;"Vilniaus Liepkalnio Pagrindinė Mokykla";Bitutės;2947239203;Ne;0;0;1;1
17563;"Vilniaus Liepkalnio Pagrindinė Mokykla";Bitutės;9909794030;Taip;0;0;4;4
17564;"Vilniaus Liepkalnio Pagrindinė Mokykla";Bitutės;2050384850;Ne;0;0;1;1
17565;"Vilniaus Pranciškaus Skorinos gimnazija";Saulytė;3374669528;Taip;8;1;0;9
17566;"Vilniaus Pranciškaus Skorinos gimnazija";Saulytė;2034261990;Taip;0;1;3;4
17567;"Vilniaus Pranciškaus Skorinos gimnazija";Saulytė;1590889839;Taip;0;1;1;2
17568;"Vilniaus Pranciškaus Skorinos gimnazija";Saulytė;4332682721;Ne;0;0;2;2
17569;"Vilniaus Pranciškaus Skorinos gimnazija";Saulytė;1711690546;Ne;0;0;2;2
17570;"Vilniaus Pranciškaus Skorinos gimnazija";Saulytė;4789626884;Ne;5;3;1;9
17571;"Vilniaus Pranciškaus Skorinos gimnazija";Saulytė;6236051765;Taip;2;0;1;3
17572;"Vilniaus Pranciškaus Skorinos gimnazija";Saulytė;1388103298;Ne;0;0;2;2
17573;"Vilniaus Pranciškaus Skorinos gimnazija";Saulytė;20920553773;Taip;0;3;0;3
17574;"Vilniaus Pranciškaus Skorinos gimnazija";Saulytė;2397630691;Ne;11;0;0;11
17575;"Vilniaus Pranciškaus Skorinos gimnazija";Saulytė;5194059497;Ne;11;2;0;13
17576;"Vilniaus Simono Konarskio mokykla";"1 gr.";40995112936;Taip;5;0;0;5
17577;"Vilniaus Simono Konarskio mokykla";"1 gr.";3961043533;Taip;6;0;0;6
17578;"Vilniaus Simono Konarskio mokykla";"1 gr.";3341090773;Ne;16;0;0;16
17579;"Vilniaus Simono Konarskio mokykla";"1 gr.";2125176999;Ne;9;0;0;9
17580;"Vilniaus Trakų Vokės gimnazija";Priešmokyklinė;88989814775;Ne;0;0;2;2
17581;"Vilniaus Trakų Vokės gimnazija";Priešmokyklinė;86504089176;Ne;0;0;1;1
17582;"Vilniaus Trakų Vokės gimnazija";Priešmokyklinė;64083541565;Ne;0;0;3;3
17583;"Vilniaus Trakų Vokės gimnazija";Priešmokyklinė;69866048102;Ne;0;0;2;2
17584;"Vilniaus Trakų Vokės gimnazija";Priešmokyklinė;24064321676;Ne;0;0;4;4
17585;"Vilniaus Trakų Vokės gimnazija";Priešmokyklinė;69311478204;Ne;0;10;3;13
17586;"Vilniaus Trakų Vokės gimnazija";Priešmokyklinė;6675993703;Ne;0;0;1;1
17587;"Vilniaus Trakų Vokės gimnazija";Priešmokyklinė;6418198934;Ne;8;5;0;13
17588;"Vilniaus Trakų Vokės gimnazija";Priešmokyklinė;71417288063;Ne;0;0;1;1
17589;"Vilniaus Trakų Vokės gimnazija";Priešmokyklinė;64019248229;Ne;0;0;1;1
17590;"Vilniaus Trakų Vokės gimnazija";Priešmokyklinė;18796898215;Ne;0;0;12;12
17591;"Vilniaus Trakų Vokės gimnazija";Priešmokyklinė;9287999220;Ne;9;0;0;9
17592;"Vilniaus Trakų Vokės gimnazija";Priešmokyklinė;85293469079;Ne;3;0;0;3
17593;"Vilniaus Trakų Vokės gimnazija";Priešmokyklinė;9449948668;Ne;0;1;0;1
17594;"Vilniaus Trakų Vokės gimnazija";Priešmokyklinė;1766156349;Ne;0;0;1;1
17595;"Vilniaus Trakų Vokės gimnazija";Priešmokyklinė;9386629495;Ne;0;0;2;2
17596;"Vilniaus Trakų Vokės gimnazija";Priešmokyklinė;6209271043;Taip;0;0;1;1
17597;"Vilniaus Trakų Vokės gimnazija";"Priešmokyklinė 2";67434532111;Ne;0;6;0;6
17598;"Vilniaus Trakų Vokės gimnazija";"Priešmokyklinė 2";10453975773;Ne;0;2;0;2
17599;"Vilniaus Trakų Vokės gimnazija";"Priešmokyklinė 2";66085180057;Ne;0;3;0;3
17600;"Vilniaus Trakų Vokės gimnazija";"Priešmokyklinė 2";1074730366;Ne;1;0;1;2
17601;"Vilniaus Trakų Vokės gimnazija";"Priešmokyklinė 2";4046440160;Ne;0;0;5;5
17602;"Vilniaus Trakų Vokės gimnazija";"Priešmokyklinė 2";50697040061;Ne;0;0;4;4
17603;"Vilniaus Trakų Vokės gimnazija";"Priešmokyklinė 2";1117304239;Taip;0;0;1;1
17604;"Vilniaus Trakų Vokės gimnazija";"Priešmokyklinė 2";44023296535;Ne;0;0;6;6
17605;"Vilniaus Trakų Vokės gimnazija";"Priešmokyklinė 2";26598573711;Ne;6;2;0;8
17606;"Vilniaus Trakų Vokės gimnazija";"Priešmokyklinė 2";6740592681;Ne;0;0;1;1
17607;"Vilniaus Trakų Vokės gimnazija";"Priešmokyklinė 2";1179402963;Ne;0;2;0;2
17608;"Vilniaus Trakų Vokės gimnazija";"Priešmokyklinė 2";5109850366;Ne;10;1;0;11
17609;"Vilniaus Trakų Vokės gimnazija";"Priešmokyklinė 2";15897808544;Ne;0;0;1;1
17610;"Vilniaus Trakų Vokės gimnazija";"Priešmokyklinė 2";6593654477;Ne;0;0;7;7
17611;"Vilniaus Trakų Vokės gimnazija";"Priešmokyklinė 2";9582511053;Taip;0;5;0;5
17612;"Vilniaus Trakų Vokės gimnazija";"Priešmokyklinė 2";1693185124;Ne;0;2;0;2
17613;"Vilniaus Trakų Vokės gimnazija";"Priešmokyklinė 2";9039274775;Ne;9;0;0;9
17614;"Vilniaus Trakų Vokės gimnazija";"Priešmokyklinė 2";4615315809;Taip;6;0;1;7
17615;"Vilniaus Trakų Vokės gimnazija";"Priešmokyklinė 2";25106446270;Taip;0;2;0;2
17616;"Vilniaus Salininkų gimnazija";"Priešmokyklinė A";1883307260;Ne;0;1;0;1
17617;"Vilniaus Salininkų gimnazija";"Priešmokyklinė A";1948988168;Ne;0;0;3;3
17618;"Vilniaus Salininkų gimnazija";"Priešmokyklinė A";20609963605;Ne;4;0;0;4
17619;"Vilniaus Salininkų gimnazija";"Priešmokyklinė A";1521333219;Taip;0;5;0;5
17620;"Vilniaus Salininkų gimnazija";"Priešmokyklinė A";23990693770;Ne;0;8;0;8
17621;"Vilniaus Salininkų gimnazija";"Priešmokyklinė A";58234889370;Ne;0;20;0;20
17622;"Vilniaus Salininkų gimnazija";"Priešmokyklinė A";9074440999;Ne;0;0;1;1
17623;"Vilniaus Salininkų gimnazija";"Priešmokyklinė A";51756630728;Taip;3;0;1;4
17624;"Vilniaus Salininkų gimnazija";"Priešmokyklinė A";6830115988;Ne;0;3;0;3
17625;"Vilniaus Salininkų gimnazija";"Priešmokyklinė A";7537900082;Ne;0;0;1;1
17626;"Vilniaus Salininkų gimnazija";"Priešmokyklinė A";5434294777;Taip;0;0;1;1
17627;"Vilniaus Salininkų gimnazija";"Priešmokyklinė A";1963139815;Ne;5;0;1;6
17628;"Vilniaus Salininkų gimnazija";"Priešmokyklinė A";1641123436;Ne;10;0;0;10
17629;"Vilniaus Salininkų gimnazija";"Priešmokyklinė A";2062813004;Ne;0;2;0;2
17630;"Vilniaus Salininkų gimnazija";"PRIEŠMOKYKLINĖ B";2171462527;Ne;2;0;0;2
17631;"Vilniaus Salininkų gimnazija";"PRIEŠMOKYKLINĖ B";2031724954;Ne;0;2;0;2
17632;"Vilniaus Salininkų gimnazija";"PRIEŠMOKYKLINĖ B";52499970010;Ne;0;7;0;7
17633;"Vilniaus Salininkų gimnazija";"PRIEŠMOKYKLINĖ B";1439852031;Ne;0;5;0;5
17634;"Vilniaus Salininkų gimnazija";"PRIEŠMOKYKLINĖ B";14626363996;Ne;0;11;0;11
17635;"Vilniaus Salininkų gimnazija";"PRIEŠMOKYKLINĖ B";1470744233;Ne;0;5;0;5
17636;"Vilniaus Salininkų gimnazija";"PRIEŠMOKYKLINĖ B";1815368137;Ne;8;0;0;8
17637;"Vilniaus Salininkų gimnazija";"PRIEŠMOKYKLINĖ B";1699958696;Ne;0;2;0;2
17638;"Vilniaus Salininkų gimnazija";"PRIEŠMOKYKLINĖ B";65190372194;Ne;10;0;0;10
17639;"Vilniaus Salininkų gimnazija";"PRIEŠMOKYKLINĖ B";15199054558;Ne;0;2;0;2
17640;"Vilniaus Salininkų gimnazija";"PRIEŠMOKYKLINĖ B";86019335524;Taip;6;0;0;6
17641;"Vilniaus Salininkų gimnazija";"PRIEŠMOKYKLINĖ B";5301130718;Ne;0;20;0;20
17642;"Vilniaus Salininkų gimnazija";"PRIEŠMOKYKLINĖ B";67593920224;Ne;2;0;0;2
17643;"Vilniaus Salininkų gimnazija";"PRIEŠMOKYKLINĖ B";25941514634;Ne;1;0;0;1
17644;"Vilniaus Salininkų gimnazija";"PRIEŠMOKYKLINĖ B";3210453801;Ne;2;0;0;2
17645;"Vilniaus Salininkų gimnazija";"PRIEŠMOKYKLINĖ B";7296677745;Ne;1;0;0;1
17646;"Vilniaus Salininkų gimnazija";"PRIEŠMOKYKLINĖ B";6125334614;Ne;3;0;0;3
17647;"Vilniaus „Spindulio“ progimnazija";PM3;4460061333;Ne;5;0;0;5
17648;"Vilniaus „Spindulio“ progimnazija";PM3;3769217717;Ne;5;0;0;5
17649;"Vilniaus „Spindulio“ progimnazija";PM3;9168812609;Taip;0;4;0;4
17650;"Vilniaus „Spindulio“ progimnazija";PM3;29225108934;Taip;3;0;0;3
17651;"Vilniaus „Spindulio“ progimnazija";PM3;33133728999;Taip;0;21;0;21
17652;"Vilniaus „Spindulio“ progimnazija";PM3;4569691896;Taip;3;1;0;4
17653;"Vilniaus „Spindulio“ progimnazija";PM3;12287981032;Taip;2;0;0;2
17654;"Vilniaus „Spindulio“ progimnazija";PM3;92286460424;Taip;0;6;0;6
17655;"Vilniaus „Spindulio“ progimnazija";PM3;1036752305;Taip;0;21;0;21
17656;"Vilniaus „Spindulio“ progimnazija";PM3;61158254770;Ne;5;0;1;6
17657;"Vilniaus „Spindulio“ progimnazija";PM3;34706967888;Taip;0;21;0;21
17658;"Vilniaus „Spindulio“ progimnazija";PM2;5495813195;Taip;0;2;1;3
17659;"Vilniaus „Spindulio“ progimnazija";PM2;2993704795;Taip;0;7;0;7
17660;"Vilniaus „Spindulio“ progimnazija";PM2;16785309188;Ne;7;2;0;9
17661;"Vilniaus „Spindulio“ progimnazija";PM2;1613911039;Taip;0;0;1;1
17662;"Vilniaus „Spindulio“ progimnazija";PM2;1301231548;Taip;4;0;0;4
17663;"Vilniaus „Spindulio“ progimnazija";PM2;3678560815;Taip;0;7;0;7
17664;"Vilniaus „Spindulio“ progimnazija";PM2;60150682872;Taip;4;1;0;5
17665;"Vilniaus „Spindulio“ progimnazija";PM2;2009324145;Taip;0;2;0;2
17666;"Vilniaus „Spindulio“ progimnazija";PM2;98742243823;Taip;3;0;0;3
17667;"Vilniaus „Spindulio“ progimnazija";PM2;94713648240;Taip;7;1;0;8
17668;"Vilniaus „Spindulio“ progimnazija";PM2;2074439295;Taip;0;4;0;4
17669;"Vilniaus „Spindulio“ progimnazija";PM2;2096874518;Taip;7;0;0;7
17670;"Vilniaus „Spindulio“ progimnazija";PM2;4142864015;Taip;7;1;0;8
17671;"Vilniaus „Spindulio“ progimnazija";PM1;2402524470;Taip;0;1;1;2
17672;"Vilniaus „Spindulio“ progimnazija";PM1;1939499375;Taip;0;4;0;4
17673;"Vilniaus „Spindulio“ progimnazija";PM1;27140729689;Ne;3;0;0;3
17674;"Vilniaus „Spindulio“ progimnazija";PM1;1882919126;Taip;3;3;0;6
17675;"Vilniaus „Spindulio“ progimnazija";PM1;1479759021;Taip;0;6;0;6
17676;"Vilniaus „Spindulio“ progimnazija";PM1;57676205527;Ne;0;2;0;2
17677;"Vilniaus „Spindulio“ progimnazija";PM1;71523999168;Ne;0;2;0;2
17678;"Vilniaus „Spindulio“ progimnazija";PM1;56154878520;Ne;0;5;0;5
17679;"Vilniaus „Spindulio“ progimnazija";PM1;2049079012;Taip;6;3;0;9
17680;"Vilniaus „Spindulio“ progimnazija";PM1;4405301567;Taip;4;0;1;5
17681;"Vilniaus Vladislavo Sirokomlės gimnazija";Nykštukai;5282211767;Taip;0;2;0;2
17682;"Vilniaus Vladislavo Sirokomlės gimnazija";Nykštukai;9380332489;Taip;0;3;1;4
17683;"Vilniaus Vladislavo Sirokomlės gimnazija";Nykštukai;2112394008;Taip;5;0;0;5
17684;"Vilniaus Vladislavo Sirokomlės gimnazija";Nykštukai;30180586342;Taip;0;1;2;3
17685;"Vilniaus Vladislavo Sirokomlės gimnazija";Nykštukai;2686950289;Taip;1;0;0;1
17686;"Vilniaus Vladislavo Sirokomlės gimnazija";Nykštukai;19486911273;Ne;0;1;0;1
17687;"Vilniaus Vladislavo Sirokomlės gimnazija";Nykštukai;1077526046;Taip;0;1;0;1
17688;"Vilniaus Vladislavo Sirokomlės gimnazija";Nykštukai;71806077882;Ne;0;0;1;1
17689;"Vilniaus Vladislavo Sirokomlės gimnazija";Smurfai;74475070018;Taip;0;4;0;4
17690;"Vilniaus Vladislavo Sirokomlės gimnazija";Smurfai;1012658900;Taip;0;5;0;5
17691;"Vilniaus Vladislavo Sirokomlės gimnazija";Smurfai;1398564881;Ne;0;2;0;2
17692;"Vilniaus Vladislavo Sirokomlės gimnazija";Smurfai;8226921630;Taip;4;1;0;5
17693;"Vilniaus Vladislavo Sirokomlės gimnazija";Smurfai;7956620111;Taip;4;18;0;22
17694;"Vilniaus Vladislavo Sirokomlės gimnazija";Smurfai;8995997848;Taip;0;2;0;2
17695;"Vilniaus Vladislavo Sirokomlės gimnazija";Smurfai;5544613599;Taip;0;5;0;5
17696;"Vilniaus Vladislavo Sirokomlės gimnazija";Smurfai;2219712757;Taip;0;1;0;1
17697;"Vilniaus Joachimo Lelevelio inžinerijos mokykla";0A;7451214674;Ne;5;0;0;5
17698;"Vilniaus Joachimo Lelevelio inžinerijos mokykla";0A;27082059521;Taip;5;0;0;5
17699;"Vilniaus Joachimo Lelevelio inžinerijos mokykla";0A;16357824257;Taip;0;0;1;1
17700;"Vilniaus Joachimo Lelevelio inžinerijos mokykla";0A;70188972463;Taip;0;0;5;5
17701;"Vilniaus Joachimo Lelevelio inžinerijos mokykla";0A;5104957185;Ne;0;0;1;1
17702;"Vilniaus Joachimo Lelevelio inžinerijos mokykla";0A;4101387438;Taip;5;0;0;5
17703;"Vilniaus Joachimo Lelevelio inžinerijos mokykla";0A;47825918748;Taip;0;1;0;1
17704;"Vilniaus Joachimo Lelevelio inžinerijos mokykla";0A;18542160352;Taip;0;2;0;2
17705;"Vilniaus Joachimo Lelevelio inžinerijos mokykla";0A;3842907348;Taip;0;4;0;4
17706;"Vilniaus Joachimo Lelevelio inžinerijos mokykla";0A;1771141306;Taip;0;5;0;5
17707;"Vilniaus Joachimo Lelevelio inžinerijos mokykla";0B;2711819539;Ne;0;2;1;3
17708;"Vilniaus Joachimo Lelevelio inžinerijos mokykla";0B;2169729414;Ne;1;5;0;6
17709;"Vilniaus Joachimo Lelevelio inžinerijos mokykla";0B;1049699735;Taip;0;8;0;8
17710;"Vilniaus Joachimo Lelevelio inžinerijos mokykla";0B;32583177093;Ne;0;1;0;1
17711;"Vilniaus Joachimo Lelevelio inžinerijos mokykla";0B;6713783853;Taip;0;0;6;6
17712;"Vilniaus Joachimo Lelevelio inžinerijos mokykla";0B;2492364016;Taip;1;1;1;3
17713;"Vilniaus Joachimo Lelevelio inžinerijos mokykla";0B;1367704050;Taip;7;0;5;12
17714;"Vilniaus Joachimo Lelevelio inžinerijos mokykla";0B;2118500745;Taip;0;0;3;3
17715;"Vilniaus Joachimo Lelevelio inžinerijos mokykla";0B;2072018782;Taip;0;2;0;2
17716;"Vilniaus Joachimo Lelevelio inžinerijos mokykla";0B;1378845384;Taip;5;0;1;6
17717;"Vilniaus Joachimo Lelevelio inžinerijos mokykla";0B;1409708149;Taip;5;0;0;5
17718;"Vilniaus Joachimo Lelevelio inžinerijos mokykla";0B;8552721960;Taip;3;0;0;3
17719;"Vilniaus Joachimo Lelevelio inžinerijos mokykla";0B;1477555365;Taip;4;4;0;8
17720;"Vilniaus Juzefo Ignacijaus Kraševskio gimnazija";Priešmokyklinė;3041637447;Taip;8;1;0;9
17721;"Vilniaus Juzefo Ignacijaus Kraševskio gimnazija";Priešmokyklinė;1963122314;Taip;10;1;0;11
17722;"Vilniaus Juzefo Ignacijaus Kraševskio gimnazija";Priešmokyklinė;9167719015;Ne;11;1;0;12
17723;"Vilniaus Juzefo Ignacijaus Kraševskio gimnazija";Priešmokyklinė;6560740320;Taip;0;1;0;1
17724;"Vilniaus Juzefo Ignacijaus Kraševskio gimnazija";Priešmokyklinė;6224053661;Taip;0;5;0;5
17725;"Vilniaus Juzefo Ignacijaus Kraševskio gimnazija";Priešmokyklinė;3738703854;Taip;0;1;0;1
17726;"Vilniaus Juzefo Ignacijaus Kraševskio gimnazija";Priešmokyklinė;1812071213;Taip;0;1;1;2
17727;"Vilniaus Juzefo Ignacijaus Kraševskio gimnazija";Priešmokyklinė;4747481676;Ne;0;1;1;2
17728;"Vilniaus Juzefo Ignacijaus Kraševskio gimnazija";Priešmokyklinė;83027842354;Ne;9;1;0;10
17729;"Vilniaus Juzefo Ignacijaus Kraševskio gimnazija";Priešmokyklinė;1459614385;Taip;0;1;2;3
17730;"Vilniaus Juzefo Ignacijaus Kraševskio gimnazija";Priešmokyklinė;8469042778;Taip;0;1;0;1
17731;"Vilniaus Juzefo Ignacijaus Kraševskio gimnazija";Priešmokyklinė;6887858560;Ne;6;1;0;7
17732;"Vilniaus Juzefo Ignacijaus Kraševskio gimnazija";Priešmokyklinė;8323242104;Taip;0;5;0;5
17733;"Vilniaus Juzefo Ignacijaus Kraševskio gimnazija";Priešmokyklinė;1166820133;Ne;2;1;0;3
17734;"Vilniaus Juzefo Ignacijaus Kraševskio gimnazija";Priešmokyklinė;2201538495;Ne;7;1;0;8
17735;"Vilniaus Juzefo Ignacijaus Kraševskio gimnazija";Priešmokyklinė;9114472645;Ne;0;1;0;1
17736;"Vilniaus Juzefo Ignacijaus Kraševskio gimnazija";Priešmokyklinė;5261769707;Taip;5;1;0;6
17737;"Vilniaus Juzefo Ignacijaus Kraševskio gimnazija";Priešmokyklinė;9685152753;Taip;0;1;0;1
17738;"Vilniaus Juzefo Ignacijaus Kraševskio gimnazija";Priešmokyklinė;1993899235;Ne;0;1;0;1
17739;"Vilniaus Juzefo Ignacijaus Kraševskio gimnazija";Priešmokyklinė;5255617339;Ne;0;1;0;1
17740;"Vilniaus Jono Pauliaus II progimnazija";Nykštukai;43342043904;Ne;0;20;0;20
17741;"Vilniaus Jono Pauliaus II progimnazija";Nykštukai;8802891670;Ne;0;20;0;20
17742;"Vilniaus Jono Pauliaus II progimnazija";Nykštukai;20492762368;Ne;0;20;0;20
17743;"Vilniaus Jono Pauliaus II progimnazija";Nykštukai;5392514118;Ne;0;2;2;4
17744;"Vilniaus Jono Pauliaus II progimnazija";Nykštukai;1223627682;Ne;16;1;0;17
17745;"Vilniaus Jono Pauliaus II progimnazija";Nykštukai;8226906949;Ne;0;1;0;1
17746;"Vilniaus Jono Pauliaus II progimnazija";Nykštukai;9383951600;Ne;0;21;0;21
17747;"Vilniaus Jono Pauliaus II progimnazija";Nykštukai;3126726854;Ne;0;5;0;5
17748;"Vilniaus Jono Pauliaus II progimnazija";Nykštukai;1661768112;Ne;0;1;0;1
17749;"Vilniaus Jono Pauliaus II progimnazija";Nykštukai;5207473829;Ne;0;1;0;1
17750;"Vilniaus Jono Pauliaus II progimnazija";Nykštukai;8172222365;Ne;0;8;0;8
17751;"Vilniaus Jono Pauliaus II progimnazija";Nykštukai;1931763128;Ne;0;0;2;2
17752;"Vilniaus Jono Pauliaus II progimnazija";Nykštukai;48118825872;Ne;2;2;0;4
17753;"Vilniaus Jono Pauliaus II progimnazija";Nykštukai;2037477873;Ne;5;0;0;5
17754;"Vilniaus Jono Pauliaus II progimnazija";Nykštukai;2597864783;Ne;4;0;0;4
17755;"Vilniaus Jono Pauliaus II progimnazija";Nykštukai;96010737590;Ne;3;2;0;5
17756;"Vilniaus Jono Pauliaus II progimnazija";Nykštukai;6299191475;Ne;6;1;0;7
17757;"Vilniaus Jono Pauliaus II progimnazija";Žiniukai;11343969028;Ne;3;2;0;5
17758;"Vilniaus Jono Pauliaus II progimnazija";Žiniukai;76758476679;Taip;10;0;0;10
17759;"Vilniaus Jono Pauliaus II progimnazija";Žiniukai;1239744245;Ne;6;1;0;7
17760;"Vilniaus Jono Pauliaus II progimnazija";Žiniukai;1408704528;Ne;6;1;0;7
17761;"Vilniaus Jono Pauliaus II progimnazija";Žiniukai;1256879956;Ne;0;9;0;9
17762;"Vilniaus Jono Pauliaus II progimnazija";Žiniukai;4416064304;Ne;9;0;0;9
17763;"Vilniaus Jono Pauliaus II progimnazija";Žiniukai;4786380413;Ne;0;21;0;21
17764;"Vilniaus Jono Pauliaus II progimnazija";Žiniukai;1206774772;Ne;0;20;0;20
17765;"Vilniaus Jono Pauliaus II progimnazija";Žiniukai;74190923349;Taip;0;0;2;2
17766;"Vilniaus Jono Pauliaus II progimnazija";Žiniukai;4541308000;Ne;8;0;1;9
17767;"Vilniaus Jono Pauliaus II progimnazija";Žiniukai;1750552925;Ne;0;2;0;2
17768;"Vilniaus Jono Pauliaus II progimnazija";Žiniukai;1393351147;Ne;0;1;0;1
17769;"Vilniaus Jono Pauliaus II progimnazija";Žiniukai;1029009937;Ne;1;0;1;2
17770;"Vilniaus Jono Pauliaus II progimnazija";Žiniukai;6958822972;Taip;2;0;0;2
17771;"Vilniaus Jono Pauliaus II progimnazija";Žiniukai;26468121179;Taip;0;0;1;1
17772;"Vilniaus Jono Pauliaus II progimnazija";Žiniukai;1588070786;Ne;0;0;1;1
17773;"Vilniaus Jono Pauliaus II progimnazija";Spindulėlis;81796510706;Ne;4;0;0;4
17774;"Vilniaus Jono Pauliaus II progimnazija";Spindulėlis;9428634658;Ne;0;0;1;1
17775;"Vilniaus Jono Pauliaus II progimnazija";Spindulėlis;2022412040;Taip;0;1;0;1
17776;"Vilniaus Jono Pauliaus II progimnazija";Spindulėlis;6775770656;Ne;0;2;5;7
17777;"Vilniaus Jono Pauliaus II progimnazija";Spindulėlis;5098282548;Ne;0;1;0;1
17778;"Vilniaus Jono Pauliaus II progimnazija";Spindulėlis;8182873487;Ne;0;1;0;1
17779;"Vilniaus Jono Pauliaus II progimnazija";Spindulėlis;1343667707;Ne;3;1;0;4
17780;"Vilniaus Jono Pauliaus II progimnazija";Spindulėlis;1184543607;Ne;3;0;0;3
17781;"Vilniaus Jono Pauliaus II progimnazija";Spindulėlis;2043278242;Ne;0;1;0;1
17782;"Vilniaus Jono Pauliaus II progimnazija";Spindulėlis;2069277030;Taip;0;1;1;2
17783;"Vilniaus Jono Pauliaus II progimnazija";Spindulėlis;1996032555;Ne;0;1;0;1
17784;"Vilniaus Jono Pauliaus II progimnazija";Spindulėlis;2212814026;Taip;0;1;0;1
17785;Gluosnis;KIŠKUČIAI;4591550636;Taip;5;2;0;7
17786;Gluosnis;KIŠKUČIAI;8689557248;Taip;0;3;0;3
17787;Gluosnis;KIŠKUČIAI;2984134115;Taip;0;0;2;2
17788;Gluosnis;KIŠKUČIAI;6955695422;Taip;0;4;1;5
17789;Gluosnis;KIŠKUČIAI;6140294839;Taip;9;0;2;11
17790;Gluosnis;KIŠKUČIAI;1305651237;Taip;6;0;11;17
17791;Gluosnis;KIŠKUČIAI;1341265560;Taip;0;5;0;5
17792;Gluosnis;KIŠKUČIAI;4285562600;Taip;7;4;2;13
17793;Gluosnis;KIŠKUČIAI;5432102004;Taip;7;0;1;8
17794;Gluosnis;KIŠKUČIAI;8009719622;Taip;0;9;0;9
17795;Gluosnis;KIŠKUČIAI;9833971809;Ne;15;0;0;15
17796;Gluosnis;KIŠKUČIAI;6883663577;Taip;2;0;2;4
17797;Gluosnis;KIŠKUČIAI;1512855055;Taip;5;8;3;16
17798;Gluosnis;KIŠKUČIAI;8337313448;Taip;10;0;7;17
17799;Gluosnis;KIŠKUČIAI;4632419177;Taip;7;0;5;12
17800;Gluosnis;KIŠKUČIAI;6113153127;Taip;7;0;1;8
17801;Gluosnis;KIŠKUČIAI;7769522093;Taip;12;0;1;13
17802;Gluosnis;KIŠKUČIAI;8928597187;Taip;0;4;7;11
17803;Gluosnis;KIŠKUČIAI;9993638596;Taip;0;0;9;9
17804;Gluosnis;KIŠKUČIAI;6994005000;Taip;0;0;1;1
17805;Gluosnis;KIŠKUČIAI;9221983318;Taip;0;10;0;10
17806;Gluosnis;KIŠKUČIAI;2187312618;Taip;0;0;1;1
17807;Gluosnis;KIŠKUČIAI;5664156894;Taip;6;0;0;6
17808;Gluosnis;EŽIUKAI;4153713911;Taip;7;0;3;10
17809;Gluosnis;EŽIUKAI;6612468095;Taip;10;0;1;11
17810;Gluosnis;EŽIUKAI;3323237449;Ne;7;5;0;12
17811;Gluosnis;EŽIUKAI;9888037899;Taip;0;10;6;16
17812;Gluosnis;EŽIUKAI;3273127718;Taip;9;0;2;11
17813;Gluosnis;EŽIUKAI;1301904113;Taip;9;0;1;10
17814;Gluosnis;EŽIUKAI;5350702449;Taip;0;0;2;2
17815;Gluosnis;EŽIUKAI;8577271806;Taip;5;0;7;12
17816;Gluosnis;EŽIUKAI;6622415563;Taip;5;0;5;10
17817;Gluosnis;EŽIUKAI;3988305400;Taip;6;0;0;6
17818;Gluosnis;EŽIUKAI;9788278155;Taip;13;0;0;13
17819;Gluosnis;EŽIUKAI;7974944779;Taip;4;4;0;8
17820;Gluosnis;EŽIUKAI;7526020668;Taip;0;0;1;1
17821;Gluosnis;EŽIUKAI;5522411084;Taip;0;0;2;2
17822;Gluosnis;EŽIUKAI;5392759654;Taip;9;2;3;14
17823;Gluosnis;EŽIUKAI;6681653921;Taip;16;0;0;16
17824;Gluosnis;MEŠKIUKAI;4022182529;Taip;17;0;1;18
17825;Gluosnis;MEŠKIUKAI;8981904827;Taip;0;0;1;1
17826;Gluosnis;MEŠKIUKAI;8998776286;Taip;10;0;0;10
17827;Gluosnis;MEŠKIUKAI;1846499141;Taip;17;0;3;20
17828;Gluosnis;MEŠKIUKAI;7935750427;Taip;0;0;1;1
17829;Gluosnis;MEŠKIUKAI;9102081648;Taip;4;0;1;5
17830;Gluosnis;MEŠKIUKAI;4498429439;Taip;0;0;3;3
17831;Gluosnis;MEŠKIUKAI;6067801976;Taip;11;0;1;12
17832;Gluosnis;MEŠKIUKAI;8259160584;Ne;1;9;0;10
17833;Gluosnis;MEŠKIUKAI;1235091885;Taip;6;5;0;11
17834;Gluosnis;MEŠKIUKAI;1165636758;Taip;0;10;1;11
17835;Gluosnis;MEŠKIUKAI;8499748544;Taip;3;0;0;3
17836;Gluosnis;MEŠKIUKAI;2867319899;Taip;4;0;1;5
17837;Gluosnis;MEŠKIUKAI;9699577397;Taip;0;0;19;19
17838;Gluosnis;MEŠKIUKAI;1712795835;Taip;0;1;0;1
17839;Gluosnis;MEŠKIUKAI;7995558671;Ne;15;0;0;15
17840;Gluosnis;MEŠKIUKAI;1602556462;Taip;3;0;1;4
17841;Gluosnis;MEŠKIUKAI;8842139496;Taip;7;0;0;7
17842;Gluosnis;MEŠKIUKAI;4060859156;Taip;0;0;1;1
17843;Gluosnis;MEŠKIUKAI;6428753580;Ne;2;5;0;7
17844;Gluosnis;BORUŽĖLĖS;8840658383;Taip;3;2;0;5
17845;Gluosnis;BORUŽĖLĖS;1102935178;Taip;0;0;2;2
17846;Gluosnis;BORUŽĖLĖS;8328948120;Ne;0;0;4;4
17847;Gluosnis;BORUŽĖLĖS;2167312808;Taip;7;0;0;7
17848;Gluosnis;BORUŽĖLĖS;4204797742;Ne;5;7;0;12
17849;Gluosnis;BORUŽĖLĖS;6302765948;Taip;0;0;2;2
17850;Gluosnis;BORUŽĖLĖS;9938235476;Ne;1;4;0;5
17851;Gluosnis;BORUŽĖLĖS;2945796648;Taip;6;4;0;10
17852;Gluosnis;BORUŽĖLĖS;2173191971;Taip;5;0;0;5
17853;Gluosnis;BORUŽĖLĖS;4237053702;Taip;15;4;0;19
17854;Gluosnis;BORUŽĖLĖS;6320411660;Ne;7;0;0;7
17855;Gluosnis;BORUŽĖLĖS;7731887361;Taip;7;0;0;7
17856;Gluosnis;BORUŽĖLĖS;8502947568;Taip;0;2;0;2
17857;Gluosnis;BORUŽĖLĖS;1335152703;Taip;0;11;2;13
17858;Gluosnis;BORUŽĖLĖS;1314992969;Taip;0;0;7;7
17859;Gluosnis;BORUŽĖLĖS;7833136455;Taip;5;0;0;5
17860;Gluosnis;BORUŽĖLĖS;5556821953;Ne;0;5;0;5
17861;Gluosnis;BORUŽĖLĖS;2515646510;Taip;9;0;0;9
17862;Gluosnis;BORUŽĖLĖS;3212658311;Taip;0;0;2;2
17863;Gluosnis;BORUŽĖLĖS;2603201633;Ne;7;0;6;13
17864;Gluosnis;BORUŽĖLĖS;6086258054;Ne;12;0;1;13
17865;Gluosnis;LAPIUKAI;94487630173;Taip;5;2;0;7
17866;Gluosnis;LAPIUKAI;7445566160;Taip;0;0;5;5
17867;Gluosnis;LAPIUKAI;1933496033;Ne;0;0;3;3
17868;Gluosnis;LAPIUKAI;8259035822;Taip;0;4;0;4
17869;Gluosnis;LAPIUKAI;5354082364;Ne;0;0;9;9
17870;Gluosnis;LAPIUKAI;3504197974;Taip;0;0;1;1
17871;Gluosnis;LAPIUKAI;1153781469;Taip;14;5;1;20
17872;Gluosnis;LAPIUKAI;2181550091;Taip;5;0;0;5
17873;Gluosnis;LAPIUKAI;2810808007;Taip;0;17;1;18
17874;Gluosnis;LAPIUKAI;6163009686;Taip;0;2;0;2
17875;Gluosnis;LAPIUKAI;9146356004;Taip;6;8;0;14
17876;Gluosnis;LAPIUKAI;1671693932;Taip;0;0;2;2
17877;Gluosnis;LAPIUKAI;4005023841;Ne;0;0;2;2
17878;Gluosnis;LAPIUKAI;9497547057;Ne;10;0;3;13
17879;Gluosnis;LAPIUKAI;1119389682;Taip;0;0;5;5
17880;Gluosnis;LAPIUKAI;1298724775;Taip;0;0;5;5
17881;Gluosnis;LAPIUKAI;2819283284;Taip;12;0;0;12
17882;Gluosnis;LAPIUKAI;1185903576;Taip;0;3;0;3
17883;Gluosnis;LAPIUKAI;7842723958;Ne;15;0;0;15
17884;Gluosnis;LAPIUKAI;6865973084;Taip;6;0;0;6
17885;Gluosnis;PELĖDŽIUKAI;1739047746;Ne;0;0;2;2
17886;Gluosnis;PELĖDŽIUKAI;3840001741;Ne;5;0;3;8
17887;Gluosnis;PELĖDŽIUKAI;4856769984;Taip;0;0;3;3
17888;Gluosnis;PELĖDŽIUKAI;1944291082;Taip;0;0;1;1
17889;Gluosnis;PELĖDŽIUKAI;75777330223;Taip;0;1;1;2
17890;Gluosnis;PELĖDŽIUKAI;1319664504;Taip;0;0;6;6
17891;Gluosnis;PELĖDŽIUKAI;62170308628;Taip;0;0;5;5
17892;Gluosnis;PELĖDŽIUKAI;3107005229;Taip;15;0;0;15
17893;Gluosnis;PELĖDŽIUKAI;98818207299;Ne;4;1;0;5
17894;Gluosnis;PELĖDŽIUKAI;48170110340;Taip;0;0;1;1
17895;Gluosnis;PELĖDŽIUKAI;31133574731;Taip;11;0;1;12
17896;Gluosnis;PELĖDŽIUKAI;1244309058;Taip;0;0;3;3
17897;Gluosnis;PELĖDŽIUKAI;5853981937;Taip;12;0;0;12
17898;Gluosnis;PELĖDŽIUKAI;49606187547;Taip;1;0;5;6
17899;Gluosnis;PELĖDŽIUKAI;1630582747;Taip;7;0;1;8
17900;Gluosnis;PELĖDŽIUKAI;1147279898;Taip;15;0;0;15
17901;Gluosnis;PELĖDŽIUKAI;3961201852;Taip;13;0;0;13
17902;Gluosnis;PELĖDŽIUKAI;1565251804;Taip;7;0;0;7
17903;Gluosnis;VOVERIUKAI;6047375980;Taip;6;0;2;8
17904;Gluosnis;VOVERIUKAI;8719047997;Taip;8;0;6;14
17905;Gluosnis;VOVERIUKAI;5059528135;Taip;0;0;1;1
17906;Gluosnis;VOVERIUKAI;7075070566;Taip;8;0;0;8
17907;Gluosnis;VOVERIUKAI;3434902234;Taip;6;0;0;6
17908;Gluosnis;VOVERIUKAI;8928237970;Taip;0;10;3;13
17909;Gluosnis;VOVERIUKAI;6493474181;Taip;0;0;2;2
17910;Gluosnis;VOVERIUKAI;6944918504;Taip;5;0;7;12
17911;Gluosnis;VOVERIUKAI;9669118189;Taip;3;0;4;7
17912;Gluosnis;VOVERIUKAI;9379825678;Taip;0;0;4;4
17913;Gluosnis;VOVERIUKAI;6113600571;Taip;7;0;1;8
17914;Gluosnis;VOVERIUKAI;6443602669;Taip;0;11;0;11
17915;Gluosnis;VOVERIUKAI;1076538028;Taip;0;8;0;8
17916;Gluosnis;VOVERIUKAI;1787206205;Ne;12;0;1;13
17917;Gluosnis;VOVERIUKAI;5264930854;Taip;0;0;2;2
17918;Gluosnis;VOVERIUKAI;5204445760;Taip;0;0;1;1
17919;Gluosnis;VOVERIUKAI;6001358241;Ne;0;0;3;3
17920;Gluosnis;VOVERIUKAI;4332070320;Taip;0;0;2;2
17921;Gluosnis;VOVERIUKAI;5380755693;Ne;0;0;14;14
17922;Gluosnis;VOVERIUKAI;4966816780;Taip;1;0;5;6
17923;Gluosnis;VOVERIUKAI;8627523283;Taip;0;0;1;1
17924;Gluosnis;DRUGELIAI;5949954525;Ne;6;8;2;16
17925;Gluosnis;DRUGELIAI;7537587118;Taip;0;0;5;5
17926;Gluosnis;DRUGELIAI;6478139233;Taip;0;0;1;1
17927;Gluosnis;DRUGELIAI;1716235604;Taip;5;5;0;10
17928;Gluosnis;DRUGELIAI;8430102757;Taip;1;0;0;1
17929;Gluosnis;DRUGELIAI;4125830926;Taip;0;0;19;19
17930;Gluosnis;DRUGELIAI;6358187113;Taip;15;0;1;16
17931;Gluosnis;DRUGELIAI;9084785666;Taip;7;0;1;8
17932;Gluosnis;DRUGELIAI;4940563623;Ne;0;0;2;2
17933;Gluosnis;DRUGELIAI;1113731535;Taip;0;5;0;5
17934;Gluosnis;DRUGELIAI;4653963373;Taip;15;0;1;16
17935;Gluosnis;DRUGELIAI;2458662117;Taip;9;10;0;19
17936;Gluosnis;DRUGELIAI;3936418539;Taip;1;0;2;3
17937;Gluosnis;DRUGELIAI;8314366921;Taip;0;0;2;2
17938;Gluosnis;DRUGELIAI;4220504133;Ne;1;0;8;9
17939;Gluosnis;DRUGELIAI;9931766935;Taip;1;14;1;16
17940;Gluosnis;DRUGELIAI;3527418865;Taip;13;0;1;14
17941;Gluosnis;DRUGELIAI;6914171069;Taip;5;0;1;6
17942;Gluosnis;DRUGELIAI;1848647593;Taip;7;4;0;11
17943;Gluosnis;DRUGELIAI;7756397778;Taip;4;0;0;4
17944;Gluosnis;DRUGELIAI;5943955268;Taip;0;0;19;19
17945;Gluosnis;BITUTĖS;4176300773;Taip;3;0;0;3
17946;Gluosnis;BITUTĖS;2554790908;Taip;7;0;1;8
17947;Gluosnis;BITUTĖS;8281499182;Taip;20;0;0;20
17948;Gluosnis;BITUTĖS;8690911930;Taip;5;0;2;7
17949;Gluosnis;BITUTĖS;2403029153;Ne;5;11;0;16
17950;Gluosnis;BITUTĖS;1966484574;Taip;6;0;2;8
17951;Gluosnis;BITUTĖS;4353195155;Taip;2;0;14;16
17952;Gluosnis;BITUTĖS;5889360726;Taip;0;0;8;8
17953;Gluosnis;BITUTĖS;3362089746;Taip;0;0;5;5
17954;Gluosnis;BITUTĖS;4505504276;Taip;14;0;3;17
17955;Gluosnis;BITUTĖS;7390361159;Taip;5;0;1;6
17956;Gluosnis;BITUTĖS;8380310240;Taip;5;8;0;13
17957;Gluosnis;BITUTĖS;4481544177;Taip;15;0;0;15
17958;Gluosnis;BITUTĖS;2495616844;Taip;3;0;1;4
17959;Gluosnis;BITUTĖS;3673702157;Taip;5;0;0;5
17960;Gluosnis;BITUTĖS;9098141563;Ne;0;0;7;7
17961;Gluosnis;BITUTĖS;9201769624;Taip;0;0;1;1
17962;Gluosnis;BITUTĖS;1306381382;Ne;0;0;1;1
17963;Gluosnis;BITUTĖS;5329894543;Taip;0;0;1;1
17964;"Vilniaus Saulėtekio mokykla-daugiafunkcinis centras";Priešmokyklinė;1139585557;Taip;5;0;0;5
17965;"Vilniaus Saulėtekio mokykla-daugiafunkcinis centras";Priešmokyklinė;3406566321;Ne;8;0;0;8
17966;"Vilniaus Saulėtekio mokykla-daugiafunkcinis centras";Priešmokyklinė;65268360807;Taip;8;0;0;8
17967;"Vilniaus Saulėtekio mokykla-daugiafunkcinis centras";Priešmokyklinė;1055737892;Taip;4;0;0;4
17968;"Vilniaus Saulėtekio mokykla-daugiafunkcinis centras";Priešmokyklinė;29012161897;Taip;1;0;0;1
17969;"Vilniaus Saulėtekio mokykla-daugiafunkcinis centras";"PRIEŠMOKYKLINĖ 2";2823248215;Ne;5;0;2;7
17970;"Vilniaus Saulėtekio mokykla-daugiafunkcinis centras";"PRIEŠMOKYKLINĖ 2";82073061357;Taip;5;1;0;6
17971;"Vilniaus Saulėtekio mokykla-daugiafunkcinis centras";"PRIEŠMOKYKLINĖ 2";55197056543;Taip;3;0;0;3
17972;"Vilniaus Saulėtekio mokykla-daugiafunkcinis centras";"PRIEŠMOKYKLINĖ 2";78122408360;Taip;0;0;9;9
17973;"Vilniaus Saulėtekio mokykla-daugiafunkcinis centras";"PRIEŠMOKYKLINĖ 2";8852228006;Taip;0;5;0;5
17974;"Vilniaus Saulėtekio mokykla-daugiafunkcinis centras";"PRIEŠMOKYKLINĖ 2";1618813873;Taip;12;0;3;15
17975;"Vilniaus Saulėtekio mokykla-daugiafunkcinis centras";"PRIEŠMOKYKLINĖ 2";27625410128;Ne;7;1;0;8
17976;"Vilniaus Saulėtekio mokykla-daugiafunkcinis centras";"PRIEŠMOKYKLINĖ 2";1537712920;Taip;0;0;1;1
17977;"Vilniaus Saulėtekio mokykla-daugiafunkcinis centras";"PRIEŠMOKYKLINĖ 2";1268330178;Ne;0;5;4;9
17978;"Vilniaus Saulėtekio mokykla-daugiafunkcinis centras";"PRIEŠMOKYKLINĖ 2";1417989409;Ne;6;0;0;6
17979;"Vilniaus Saulėtekio mokykla-daugiafunkcinis centras";"PRIEŠMOKYKLINĖ 2";3049862993;Ne;6;0;3;9
17980;"Vilniaus Saulėtekio mokykla-daugiafunkcinis centras";"PRIEŠMOKYKLINĖ 2";6161829923;Ne;0;6;0;6
17981;"Vilniaus Saulėtekio mokykla-daugiafunkcinis centras";"PRIEŠMOKYKLINĖ 2";9465331919;Taip;0;0;8;8
17982;"Vilniaus Saulėtekio mokykla-daugiafunkcinis centras";"PRIEŠMOKYKLINĖ 2";2267599637;Taip;7;0;1;8
17983;"Vilniaus Saulėtekio mokykla-daugiafunkcinis centras";"PRIEŠMOKYKLINĖ 2";1383759549;Taip;7;0;1;8
17984;"Vilniaus Saulėtekio mokykla-daugiafunkcinis centras";"PRIEŠMOKYKLINĖ 2";8575943476;Taip;0;0;4;4
17985;"Vilniaus Martyno Mažvydo progimnazija";PRIEŠMOKYKLINĖ;8122944228;Ne;12;0;2;14
17986;"Vilniaus Martyno Mažvydo progimnazija";PRIEŠMOKYKLINĖ;19429820228;Taip;7;0;0;7
17987;"Vilniaus Martyno Mažvydo progimnazija";PRIEŠMOKYKLINĖ;1487082744;Taip;5;0;0;5
17988;"Vilniaus Martyno Mažvydo progimnazija";PRIEŠMOKYKLINĖ;1915791061;Taip;0;1;0;1
17989;"Vilniaus Martyno Mažvydo progimnazija";PRIEŠMOKYKLINĖ;2063259303;Taip;0;6;0;6
17990;"Vilniaus Martyno Mažvydo progimnazija";PRIEŠMOKYKLINĖ;1835817116;Taip;1;0;0;1
17991;"Vilniaus Martyno Mažvydo progimnazija";PRIEŠMOKYKLINĖ;1536331721;Ne;0;3;0;3
17992;"Vilniaus Martyno Mažvydo progimnazija";PRIEŠMOKYKLINĖ;85274001355;Taip;0;0;2;2
17993;"Vilniaus Martyno Mažvydo progimnazija";PRIEŠMOKYKLINĖ;2831484614;Taip;3;0;0;3
17994;"Vilniaus Martyno Mažvydo progimnazija";PRIEŠMOKYKLINĖ;1573413882;Taip;5;0;0;5
17995;"Vilniaus Martyno Mažvydo progimnazija";PRIEŠMOKYKLINĖ;1986547624;Taip;0;1;0;1
17996;"Vilniaus „Genio“ progimnazija";Priešmokyklinė;97778827111;Ne;7;1;0;8
17997;"Vilniaus „Genio“ progimnazija";Priešmokyklinė;59524319348;Taip;10;0;0;10
17998;"Vilniaus „Genio“ progimnazija";Priešmokyklinė;5272792732;Taip;11;0;0;11
17999;"Vilniaus „Genio“ progimnazija";Priešmokyklinė;56474981516;Taip;0;3;0;3
