Nr.;"Darželio pavadinimas";"Grupės pavadinimas";"Vaiko Identifikacinis Nr.";"Deklaruotas mieste";"Pateisintos dėl ligos";"Pateisintos dėl kitų priežasčių";"Nepateisintos dienos";"Praleistos dienos Viso"
1;Aitvaras;"VIJURKAI (ALERG.)";9649742132;Taip;0;12;0;12
2;Aitvaras;"VIJURKAI (ALERG.)";84922258988;Taip;3;4;0;7
3;Aitvaras;"VIJURKAI (ALERG.)";1201862001;Taip;0;2;1;3
4;Aitvaras;"VIJURKAI (ALERG.)";8970519668;Taip;0;7;0;7
5;Aitvaras;"VIJURKAI (ALERG.)";1600657305;Taip;1;2;0;3
6;Aitvaras;"VIJURKAI (ALERG.)";1621302802;Taip;9;5;0;14
7;Aitvaras;"VIJURKAI (ALERG.)";94080483856;Taip;0;2;0;2
8;Aitvaras;"VIJURKAI (ALERG.)";5083382326;Taip;1;0;0;1
9;Aitvaras;"VIJURKAI (ALERG.)";1773366241;Taip;1;5;0;6
10;Aitvaras;"VIJURKAI (ALERG.)";1553462849;Taip;0;7;0;7
11;Aitvaras;"VIJURKAI (ALERG.)";2159901439;Taip;1;4;0;5
12;Aitvaras;"VIJURKAI (ALERG.)";3716313515;Taip;0;2;0;2
13;Aitvaras;"VIJURKAI (ALERG.)";8366627546;Taip;0;2;0;2
14;Aitvaras;"VIJURKAI (ALERG.)";1481849611;Taip;0;2;5;7
15;Aitvaras;"VIJURKAI (ALERG.)";1090979323;Taip;0;1;0;1
16;Aitvaras;"VIJURKAI (ALERG.)";5595233402;Taip;5;0;1;6
17;Aitvaras;"VIJURKAI (ALERG.)";1652681820;Taip;3;1;0;4
18;Aitvaras;"SMALSUČIAI (ALERG.)";14251469975;Taip;5;0;1;6
19;Aitvaras;"SMALSUČIAI (ALERG.)";4868552034;Taip;0;0;2;2
20;Aitvaras;"SMALSUČIAI (ALERG.)";61721665912;Taip;0;0;2;2
21;Aitvaras;"SMALSUČIAI (ALERG.)";1516018865;Taip;0;5;0;5
22;Aitvaras;"SMALSUČIAI (ALERG.)";55369747065;Taip;15;0;0;15
23;Aitvaras;"SMALSUČIAI (ALERG.)";69352006024;Taip;0;7;0;7
24;Aitvaras;"SMALSUČIAI (ALERG.)";2083332491;Taip;0;2;0;2
25;Aitvaras;"SMALSUČIAI (ALERG.)";2021772475;Taip;0;1;0;1
26;Aitvaras;"SMALSUČIAI (ALERG.)";6238828251;Taip;0;2;0;2
27;Aitvaras;"SMALSUČIAI (ALERG.)";1872130301;Taip;4;12;2;18
28;Aitvaras;"SMALSUČIAI (ALERG.)";1207249857;Taip;0;2;1;3
29;Aitvaras;"SMALSUČIAI (ALERG.)";1392528718;Taip;7;1;0;8
30;Aitvaras;"SMALSUČIAI (ALERG.)";34735287315;Taip;0;15;0;15
31;Aitvaras;"SMALSUČIAI (ALERG.)";1542575012;Taip;0;3;0;3
32;Aitvaras;"SMALSUČIAI (ALERG.)";3471031093;Taip;0;1;0;1
33;Aitvaras;"SMALSUČIAI (ALERG.)";1999569488;Taip;0;7;0;7
34;Aitvaras;"SMALSUČIAI (ALERG.)";3133031845;Taip;4;2;0;6
35;Aitvaras;"SMALSUČIAI (ALERG.)";6166757095;Taip;5;6;4;15
36;Aitvaras;"SMALSUČIAI (ALERG.)";4480921300;Taip;8;0;5;13
37;Aitvaras;"SMALSUČIAI (ALERG.)";1019661577;Taip;0;2;0;2
38;Aitvaras;PADAUŽIUKAI;5922357091;Taip;0;2;1;3
39;Aitvaras;PADAUŽIUKAI;1494094426;Taip;0;4;5;9
40;Aitvaras;PADAUŽIUKAI;6647800967;Taip;0;6;0;6
41;Aitvaras;PADAUŽIUKAI;1493048970;Taip;0;4;1;5
42;Aitvaras;PADAUŽIUKAI;70367340825;Taip;0;5;0;5
43;Aitvaras;PADAUŽIUKAI;54496602809;Taip;0;1;0;1
44;Aitvaras;PADAUŽIUKAI;42556460388;Taip;10;0;0;10
45;Aitvaras;PADAUŽIUKAI;52679806772;Taip;2;1;0;3
46;Aitvaras;PADAUŽIUKAI;85560586048;Taip;6;1;0;7
47;Aitvaras;PADAUŽIUKAI;1790437467;Taip;0;5;0;5
48;Aitvaras;PADAUŽIUKAI;74628671065;Taip;0;4;3;7
49;Aitvaras;PADAUŽIUKAI;1306408890;Taip;0;2;0;2
50;Aitvaras;PADAUŽIUKAI;62126044317;Taip;0;8;0;8
51;Aitvaras;PADAUŽIUKAI;1500548803;Taip;5;4;0;9
52;Aitvaras;PADAUŽIUKAI;1886917840;Taip;10;7;0;17
53;Aitvaras;PADAUŽIUKAI;46021715174;Taip;0;2;0;2
54;Aitvaras;PADAUŽIUKAI;59572108690;Taip;4;0;0;4
55;Aitvaras;PADAUŽIUKAI;1487264184;Taip;0;8;0;8
56;Aitvaras;PADAUŽIUKAI;3836513736;Taip;8;0;1;9
57;Aitvaras;PADAUŽIUKAI;1681260995;Taip;0;0;2;2
58;Aitvaras;PADAUŽIUKAI;5103057090;Taip;5;1;0;6
59;Aitvaras;PADAUŽIUKAI;26906648835;Taip;0;5;0;5
60;Aitvaras;"AITVARIUKAI (ALERG.)";9810370596;Taip;4;0;0;4
61;Aitvaras;"AITVARIUKAI (ALERG.)";9745864667;Taip;0;1;0;1
62;Aitvaras;"AITVARIUKAI (ALERG.)";5389627560;Taip;0;10;9;19
63;Aitvaras;"AITVARIUKAI (ALERG.)";5956333024;Taip;0;7;0;7
64;Aitvaras;"AITVARIUKAI (ALERG.)";1636794584;Taip;0;3;0;3
65;Aitvaras;"AITVARIUKAI (ALERG.)";2953536545;Taip;0;1;0;1
66;Aitvaras;"AITVARIUKAI (ALERG.)";3535659630;Taip;0;0;4;4
67;Aitvaras;"AITVARIUKAI (ALERG.)";3488467265;Taip;0;1;0;1
68;Aitvaras;"AITVARIUKAI (ALERG.)";2566375128;Taip;5;0;0;5
69;Aitvaras;"AITVARIUKAI (ALERG.)";3639102842;Taip;0;3;0;3
70;Aitvaras;"AITVARIUKAI (ALERG.)";7243387750;Taip;2;9;0;11
71;Aitvaras;"AITVARIUKAI (ALERG.)";6587437949;Taip;0;4;0;4
72;Aitvaras;"AITVARIUKAI (ALERG.)";7461284958;Taip;0;1;0;1
73;Aitvaras;"AITVARIUKAI (ALERG.)";6214880713;Taip;0;1;0;1
74;Aitvaras;"AITVARIUKAI (ALERG.)";5330618557;Taip;3;1;0;4
75;Aitvaras;"AITVARIUKAI (ALERG.)";5504431748;Taip;0;0;3;3
76;Aitvaras;"AITVARIUKAI (ALERG.)";1877245088;Taip;13;3;0;16
77;Aitvaras;"AITVARIUKAI (ALERG.)";24247118884;Taip;0;6;0;6
78;Aitvaras;"AITVARIUKAI (ALERG.)";3394251305;Taip;5;5;0;10
79;Aitvaras;"AITVARIUKAI (ALERG.)";1954364886;Taip;0;2;1;3
80;Aitvaras;"AITVARIUKAI (ALERG.)";6936031222;Taip;0;1;0;1
81;Aitvaras;"AITVARIUKAI (ALERG.)";6459307767;Taip;3;0;0;3
82;Aitvaras;"SAULĖS ZUIKUČIAI  (ALERG.)";5711324951;Taip;0;1;0;1
83;Aitvaras;"SAULĖS ZUIKUČIAI  (ALERG.)";5619137905;Taip;0;1;0;1
84;Aitvaras;"SAULĖS ZUIKUČIAI  (ALERG.)";4426643908;Taip;0;3;0;3
85;Aitvaras;"SAULĖS ZUIKUČIAI  (ALERG.)";4106097701;Taip;0;2;0;2
86;Aitvaras;"SAULĖS ZUIKUČIAI  (ALERG.)";9659883026;Taip;0;0;1;1
87;Aitvaras;"SAULĖS ZUIKUČIAI  (ALERG.)";2184231202;Taip;11;2;0;13
88;Aitvaras;"SAULĖS ZUIKUČIAI  (ALERG.)";2478737835;Taip;7;3;3;13
89;Aitvaras;"SAULĖS ZUIKUČIAI  (ALERG.)";1136438927;Taip;0;1;0;1
90;Aitvaras;"SAULĖS ZUIKUČIAI  (ALERG.)";9147954612;Taip;7;0;0;7
91;Aitvaras;"SAULĖS ZUIKUČIAI  (ALERG.)";2511844613;Taip;0;1;0;1
92;Aitvaras;"SAULĖS ZUIKUČIAI  (ALERG.)";7907357058;Taip;0;1;0;1
93;Aitvaras;"SAULĖS ZUIKUČIAI  (ALERG.)";9534206000;Taip;11;6;0;17
94;Aitvaras;"SAULĖS ZUIKUČIAI  (ALERG.)";3737054758;Taip;17;0;0;17
95;Aitvaras;"SAULĖS ZUIKUČIAI  (ALERG.)";4646876966;Taip;7;0;0;7
96;Aitvaras;"SAULĖS ZUIKUČIAI  (ALERG.)";9271534775;Taip;12;0;0;12
97;Aitvaras;"SAULĖS ZUIKUČIAI  (ALERG.)";3730442890;Taip;14;1;0;15
98;Aitvaras;"SAULĖS ZUIKUČIAI  (ALERG.)";8849563638;Taip;0;1;0;1
99;Aitvaras;"SAULĖS ZUIKUČIAI  (ALERG.)";6950820937;Taip;0;0;1;1
100;Aitvaras;"SAULĖS ZUIKUČIAI  (ALERG.)";5252728205;Taip;6;0;1;7
101;Aitvaras;"ŽEMYNUKAI (ALERG.)";2650483861;Taip;0;12;2;14
102;Aitvaras;"ŽEMYNUKAI (ALERG.)";9562494357;Taip;16;12;0;28
103;Aitvaras;"ŽEMYNUKAI (ALERG.)";6021342178;Taip;7;18;0;25
104;Aitvaras;"ŽEMYNUKAI (ALERG.)";9142513631;Taip;5;27;0;32
105;Aitvaras;"ŽEMYNUKAI (ALERG.)";8567255042;Ne;0;0;1;1
106;Aitvaras;"ŽEMYNUKAI (ALERG.)";6218019092;Taip;0;4;4;8
107;Aitvaras;"ŽEMYNUKAI (ALERG.)";7560642918;Taip;0;5;0;5
108;Aitvaras;"ŽEMYNUKAI (ALERG.)";3820930777;Taip;14;4;0;18
109;Aitvaras;"ŽEMYNUKAI (ALERG.)";6624986090;Taip;13;1;0;14
110;Aitvaras;"ŽEMYNUKAI (ALERG.)";4733627644;Taip;5;8;6;19
111;Aitvaras;"ŽEMYNUKAI (ALERG.)";3104109370;Taip;0;9;3;12
112;Aitvaras;"ŽEMYNUKAI (ALERG.)";7853714142;Taip;22;10;0;32
113;Aitvaras;"ŽEMYNUKAI (ALERG.)";1949144346;Taip;0;12;4;16
114;Aitvaras;"ŽEMYNUKAI (ALERG.)";8641433486;Taip;0;9;3;12
115;Aitvaras;"ŽEMYNUKAI (ALERG.)";9947610763;Taip;0;7;0;7
116;Aitvaras;"ŽEMYNUKAI (ALERG.)";4801034095;Taip;17;15;0;32
117;Aitvaras;"ŽEMYNUKAI (ALERG.)";7113016866;Taip;1;8;0;9
118;Aitvaras;"ŽEMYNUKAI (ALERG.)";3944052351;Ne;3;5;0;8
119;Aitvaras;"ŽEMYNUKAI (ALERG.)";4377666052;Taip;0;9;0;9
120;Aitvaras;"ŽEMYNUKAI (ALERG.)";6393256426;Taip;2;7;0;9
121;Aitvaras;"ŽEMYNUKAI (ALERG.)";8333823078;Taip;7;12;1;20
122;Aitvaras;"ŽEMYNUKAI (ALERG.)";5623106419;Taip;0;1;0;1
123;Aitvaras;"LINKSMUČIAI (ALERG.)";5238819066;Taip;7;0;0;7
124;Aitvaras;"LINKSMUČIAI (ALERG.)";7109001184;Taip;5;0;0;5
125;Aitvaras;"LINKSMUČIAI (ALERG.)";5378212904;Taip;3;2;0;5
126;Aitvaras;"LINKSMUČIAI (ALERG.)";8666824607;Taip;0;1;0;1
127;Aitvaras;"LINKSMUČIAI (ALERG.)";5612991255;Taip;9;0;0;9
128;Aitvaras;"LINKSMUČIAI (ALERG.)";7260577885;Taip;0;7;0;7
129;Aitvaras;"LINKSMUČIAI (ALERG.)";1599183050;Taip;6;0;1;7
130;Aitvaras;"LINKSMUČIAI (ALERG.)";1115202169;Taip;0;2;2;4
131;Aitvaras;"LINKSMUČIAI (ALERG.)";7029464687;Taip;15;0;3;18
132;Aitvaras;"LINKSMUČIAI (ALERG.)";4613894944;Taip;0;0;1;1
133;Aitvaras;"LINKSMUČIAI (ALERG.)";2760970218;Taip;0;2;0;2
134;Aitvaras;"LINKSMUČIAI (ALERG.)";4120515569;Taip;10;7;0;17
135;Aitvaras;"LINKSMUČIAI (ALERG.)";9885781306;Taip;0;6;1;7
136;Aitvaras;"LINKSMUČIAI (ALERG.)";4564723798;Taip;9;0;4;13
137;Aitvaras;"LINKSMUČIAI (ALERG.)";4612994715;Taip;0;5;4;9
138;Aitvaras;"LINKSMUČIAI (ALERG.)";4176681907;Taip;0;13;0;13
139;Aitvaras;"LINKSMUČIAI (ALERG.)";7392689023;Taip;0;7;0;7
140;Aitvaras;"LINKSMUČIAI (ALERG.)";6286268740;Taip;0;4;1;5
141;Aitvaras;"LINKSMUČIAI (ALERG.)";2547934790;Taip;8;1;0;9
142;Aitvaras;NAMINUKAI;3053557807;Taip;20;0;0;20
143;Aitvaras;NAMINUKAI;6126913961;Taip;6;0;1;7
144;Aitvaras;NAMINUKAI;3347213578;Taip;7;0;9;16
145;Aitvaras;NAMINUKAI;9024245490;Taip;3;2;0;5
146;Aitvaras;NAMINUKAI;8512502118;Taip;0;3;0;3
147;Aitvaras;NAMINUKAI;1376605323;Taip;4;0;0;4
148;Aitvaras;NAMINUKAI;6060880045;Taip;4;0;0;4
149;Aitvaras;NAMINUKAI;2821221241;Taip;5;0;0;5
150;Aitvaras;NAMINUKAI;9039303562;Taip;5;2;2;9
151;Aitvaras;NAMINUKAI;6080549524;Taip;5;2;2;9
152;Aitvaras;NAMINUKAI;6048701733;Taip;0;6;0;6
153;Aitvaras;NAMINUKAI;6110226958;Taip;0;0;6;6
154;Aitvaras;NAMINUKAI;4555281655;Taip;5;2;0;7
155;Aitvaras;NAMINUKAI;8043062737;Taip;8;6;0;14
156;Aitvaras;NAMINUKAI;3005447572;Taip;4;1;0;5
157;Aitvaras;NAMINUKAI;1549552392;Taip;10;1;0;11
158;Aitvaras;NAMINUKAI;4498792867;Taip;0;3;0;3
159;Aitvaras;NAMINUKAI;9490714865;Taip;5;3;0;8
160;Aitvaras;NAMINUKAI;1498630458;Taip;10;0;0;10
161;Aitvaras;NAMINUKAI;5967188507;Taip;9;0;0;9
162;Aitvaras;NAMINUKAI;5161069611;Taip;3;0;0;3
163;Aitvaras;NAMINUKAI;7934344218;Taip;3;1;0;4
164;Aitvaras;NAMINUKAI;6279152796;Taip;0;8;0;8
165;Aitvaras;ŠELMIAI;9332771711;Taip;8;2;0;10
166;Aitvaras;ŠELMIAI;6550426644;Taip;8;3;0;11
167;Aitvaras;ŠELMIAI;5818794912;Taip;0;2;0;2
168;Aitvaras;ŠELMIAI;58780461337;Ne;7;2;1;10
169;Aitvaras;ŠELMIAI;1116271183;Taip;2;0;0;2
170;Aitvaras;ŠELMIAI;44046627149;Taip;0;12;0;12
171;Aitvaras;ŠELMIAI;43711349817;Taip;5;0;0;5
172;Aitvaras;ŠELMIAI;7469656671;Taip;0;1;0;1
173;Aitvaras;ŠELMIAI;2408952971;Taip;5;0;0;5
174;Aitvaras;ŠELMIAI;2330782717;Taip;0;0;1;1
175;Aitvaras;ŠELMIAI;47875842134;Taip;0;3;0;3
176;Aitvaras;ŠELMIAI;40799643122;Taip;0;1;0;1
177;Aitvaras;ŠELMIAI;2601983670;Taip;2;1;0;3
178;Aitvaras;ŠELMIAI;8503279655;Taip;0;3;0;3
179;Aitvaras;ŠELMIAI;2804106417;Taip;1;2;0;3
180;Aitvaras;ŠELMIAI;2711888522;Taip;0;1;0;1
181;Aitvaras;ŠELMIAI;1996524718;Taip;0;2;1;3
182;Aitvaras;ŠELMIAI;4110585744;Taip;0;3;0;3
183;Aitvaras;ŠELMIAI;6010324894;Taip;0;1;0;1
184;Aitvaras;ŠELMIAI;9015675095;Taip;0;2;0;2
185;Aitvaras;ŠELMIAI;2895663259;Taip;5;0;1;6
186;Aitvaras;KODĖLČIUKAI;6214572150;Taip;22;0;0;22
187;Aitvaras;KODĖLČIUKAI;3323458595;Taip;9;1;0;10
188;Aitvaras;KODĖLČIUKAI;8065540507;Taip;2;10;2;14
189;Aitvaras;KODĖLČIUKAI;1288810999;Taip;0;8;1;9
190;Aitvaras;KODĖLČIUKAI;6501943902;Taip;0;2;4;6
191;Aitvaras;KODĖLČIUKAI;3101015381;Ne;0;4;0;4
192;Aitvaras;KODĖLČIUKAI;4350590529;Taip;2;0;1;3
193;Aitvaras;KODĖLČIUKAI;7777235021;Taip;18;0;0;18
194;Aitvaras;KODĖLČIUKAI;5641224483;Taip;0;5;0;5
195;Aitvaras;KODĖLČIUKAI;1830134108;Ne;4;9;0;13
196;Aitvaras;KODĖLČIUKAI;8121858940;Taip;0;6;0;6
197;Aitvaras;KODĖLČIUKAI;3178965623;Taip;0;1;0;1
198;Aitvaras;KODĖLČIUKAI;5905456814;Taip;0;1;0;1
199;Aitvaras;KODĖLČIUKAI;6739827530;Taip;0;1;0;1
200;Aitvaras;KODĖLČIUKAI;2807595769;Taip;7;5;0;12
201;Aitvaras;KODĖLČIUKAI;1252145346;Taip;6;0;0;6
202;Aitvaras;KODĖLČIUKAI;7455895024;Taip;0;4;0;4
203;Aitvaras;KODĖLČIUKAI;8439586875;Taip;5;0;0;5
204;Aitvaras;KODĖLČIUKAI;2328771385;Taip;0;11;0;11
205;Aitvaras;KODĖLČIUKAI;3735941659;Taip;5;0;0;5
206;Aitvaras;KODĖLČIUKAI;8360380303;Taip;0;2;1;3
207;Aitvaras;KODĖLČIUKAI;1594675221;Taip;3;2;2;7
208;Aitvaras;PABIRUČIAI;4551774368;Taip;3;1;0;4
209;Aitvaras;PABIRUČIAI;8558414510;Taip;3;1;0;4
210;Aitvaras;PABIRUČIAI;1203732956;Taip;7;2;0;9
211;Aitvaras;PABIRUČIAI;1495399113;Taip;8;2;0;10
212;Aitvaras;PABIRUČIAI;6319953077;Taip;4;0;0;4
213;Aitvaras;PABIRUČIAI;5782609781;Taip;17;0;0;17
214;Aitvaras;PABIRUČIAI;7805819121;Taip;0;12;0;12
215;Aitvaras;PABIRUČIAI;7352233454;Taip;0;2;0;2
216;Aitvaras;PABIRUČIAI;1019103539;Taip;7;10;0;17
217;Aitvaras;PABIRUČIAI;4812423010;Taip;0;2;10;12
218;Aitvaras;PABIRUČIAI;8756012613;Taip;0;5;0;5
219;Aitvaras;PABIRUČIAI;1901118931;Taip;0;1;0;1
220;Aitvaras;PABIRUČIAI;2185746898;Taip;0;1;0;1
221;Aitvaras;PABIRUČIAI;8119154459;Taip;0;4;0;4
222;Aitvaras;PABIRUČIAI;5601517340;Taip;0;1;0;1
223;Aitvaras;PABIRUČIAI;1112142035;Taip;3;0;0;3
224;Aitvaras;"SVAJOKLIAI  (ALERG.)";2004112424;Taip;0;4;0;4
225;Aitvaras;"SVAJOKLIAI  (ALERG.)";6084096300;Taip;0;1;0;1
226;Aitvaras;"SVAJOKLIAI  (ALERG.)";5750154036;Taip;7;0;0;7
227;Aitvaras;"SVAJOKLIAI  (ALERG.)";6201118021;Taip;22;0;0;22
228;Aitvaras;"SVAJOKLIAI  (ALERG.)";1275561645;Taip;1;2;0;3
229;Aitvaras;"SVAJOKLIAI  (ALERG.)";1347364985;Taip;0;5;0;5
230;Aitvaras;"SVAJOKLIAI  (ALERG.)";5425259260;Taip;3;4;0;7
231;Aitvaras;"SVAJOKLIAI  (ALERG.)";9228736015;Taip;0;6;0;6
232;Aitvaras;"SVAJOKLIAI  (ALERG.)";9763502346;Taip;7;0;0;7
233;Aitvaras;"SVAJOKLIAI  (ALERG.)";7568388141;Taip;6;2;0;8
234;Aitvaras;"SVAJOKLIAI  (ALERG.)";4204923580;Taip;0;5;0;5
235;Aitvaras;"SVAJOKLIAI  (ALERG.)";1532588441;Taip;0;2;0;2
236;Aitvaras;"SVAJOKLIAI  (ALERG.)";8206046301;Taip;9;0;0;9
237;Aitvaras;"SVAJOKLIAI  (ALERG.)";3775634117;Taip;0;1;0;1
238;Aitvaras;"SVAJOKLIAI  (ALERG.)";2615576367;Taip;7;0;0;7
239;Aitvaras;"SVAJOKLIAI  (ALERG.)";3429046261;Taip;0;10;0;10
240;Aitvaras;"SVAJOKLIAI  (ALERG.)";2146963673;Taip;21;0;0;21
241;Aitvaras;"SVAJOKLIAI  (ALERG.)";4777266938;Taip;0;0;1;1
242;Aitvaras;"SVAJOKLIAI  (ALERG.)";3954840915;Taip;0;0;3;3
243;Aitvaras;"SVAJOKLIAI  (ALERG.)";9157794193;Taip;8;0;6;14
244;Atžalėlės;Gėlytės;5742471497;Taip;0;0;6;6
245;Atžalėlės;Gėlytės;4284673729;Taip;12;5;5;22
246;Atžalėlės;Gėlytės;8695865604;Taip;0;14;0;14
247;Atžalėlės;Gėlytės;1137741059;Taip;4;0;1;5
248;Atžalėlės;Gėlytės;2385614957;Taip;0;0;7;7
249;Atžalėlės;Gėlytės;5432433423;Taip;0;8;0;8
250;Atžalėlės;Gėlytės;9715625283;Taip;0;5;0;5
251;Atžalėlės;Gėlytės;6024189665;Taip;0;11;0;11
252;Atžalėlės;Gėlytės;4682216852;Taip;0;0;1;1
253;Atžalėlės;Gėlytės;4238773173;Taip;5;0;11;16
254;Atžalėlės;Gėlytės;2131592139;Taip;7;0;2;9
255;Atžalėlės;Gėlytės;1500456945;Taip;0;0;3;3
256;Atžalėlės;Gėlytės;6177038838;Taip;0;1;3;4
257;Atžalėlės;Gėlytės;1722233272;Taip;0;11;0;11
258;Atžalėlės;Gėlytės;7702502252;Taip;0;7;0;7
259;Atžalėlės;Gėlytės;9189223222;Taip;0;11;0;11
260;Atžalėlės;Gėlytės;3283415814;Taip;5;0;4;9
261;Atžalėlės;Gėlytės;1146492807;Taip;0;0;9;9
262;Atžalėlės;Gėlytės;3870758086;Taip;0;0;2;2
263;Atžalėlės;Gėlytės;1036410428;Taip;0;3;0;3
264;Atžalėlės;Gėlytės;1450609695;Taip;5;0;0;5
265;Atžalėlės;Gėlytės;6202250600;Taip;5;8;1;14
266;Atžalėlės;Gėlytės;4098210138;Taip;2;0;1;3
267;Atžalėlės;Drugeliai;6903666624;Taip;0;0;8;8
268;Atžalėlės;Drugeliai;4902947406;Taip;0;0;4;4
269;Atžalėlės;Drugeliai;6570245757;Taip;0;0;6;6
270;Atžalėlės;Drugeliai;6782007470;Taip;0;9;0;9
271;Atžalėlės;Drugeliai;1805496887;Taip;0;0;2;2
272;Atžalėlės;Drugeliai;9463215947;Taip;0;3;0;3
273;Atžalėlės;Drugeliai;7953922166;Taip;5;1;0;6
274;Atžalėlės;Drugeliai;5147078840;Taip;0;3;0;3
275;Atžalėlės;Drugeliai;9222670655;Taip;0;2;0;2
276;Atžalėlės;Drugeliai;1429493246;Taip;7;7;0;14
277;Atžalėlės;Drugeliai;6114426973;Taip;0;10;0;10
278;Atžalėlės;Drugeliai;1456979448;Taip;5;1;0;6
279;Atžalėlės;Drugeliai;4032519781;Taip;0;4;0;4
280;Atžalėlės;Drugeliai;1426744251;Taip;0;3;0;3
281;Atžalėlės;Drugeliai;7756889911;Taip;0;1;2;3
282;Atžalėlės;Drugeliai;5063094678;Taip;3;0;3;6
283;Atžalėlės;Drugeliai;3422605135;Taip;0;0;2;2
284;Atžalėlės;Drugeliai;8718036014;Taip;18;1;3;22
285;Atžalėlės;Drugeliai;4884599397;Taip;18;1;3;22
286;Atžalėlės;Gandriukai;32154742975;Taip;0;6;0;6
287;Atžalėlės;Gandriukai;93452036571;Taip;0;4;0;4
288;Atžalėlės;Gandriukai;4483002806;Taip;0;0;2;2
289;Atžalėlės;Gandriukai;16442821393;Taip;0;5;0;5
290;Atžalėlės;Gandriukai;1197205716;Taip;0;4;2;6
291;Atžalėlės;Gandriukai;87334806437;Taip;0;0;1;1
292;Atžalėlės;Gandriukai;1204800605;Taip;0;2;0;2
293;Atžalėlės;Gandriukai;1074259644;Taip;4;0;0;4
294;Atžalėlės;Gandriukai;66107666615;Taip;4;0;3;7
295;Atžalėlės;Gandriukai;2124150483;Taip;0;1;0;1
296;Atžalėlės;Gandriukai;87567915519;Taip;0;1;0;1
297;Atžalėlės;Gandriukai;78120202936;Taip;0;1;0;1
298;Atžalėlės;Gandriukai;1011601294;Taip;0;4;0;4
299;Atžalėlės;Gandriukai;54869610865;Taip;0;0;2;2
300;Atžalėlės;Gandriukai;80500800894;Taip;3;0;2;5
301;Atžalėlės;Gandriukai;519493490;Taip;0;4;0;4
302;Atžalėlės;Gandriukai;82777644548;Taip;0;0;4;4
303;Atžalėlės;Gandriukai;23453799177;Taip;0;3;0;3
304;Atžalėlės;Voveriukai;1312772153;Taip;2;0;1;3
305;Atžalėlės;Voveriukai;6975941393;Taip;6;0;0;6
306;Atžalėlės;Voveriukai;1865339755;Taip;0;8;3;11
307;Atžalėlės;Voveriukai;8138683218;Taip;6;4;0;10
308;Atžalėlės;Voveriukai;4467364336;Taip;0;0;4;4
309;Atžalėlės;Voveriukai;1316154666;Taip;0;1;3;4
310;Atžalėlės;Voveriukai;9699811980;Taip;0;3;0;3
311;Atžalėlės;Voveriukai;8847754477;Taip;0;4;0;4
312;Atžalėlės;Voveriukai;7689394485;Taip;5;0;0;5
313;Atžalėlės;Voveriukai;2013707106;Taip;0;7;0;7
314;Atžalėlės;Voveriukai;8819893830;Taip;0;0;2;2
315;Atžalėlės;Voveriukai;3069192413;Taip;0;0;2;2
316;Atžalėlės;Voveriukai;2662384275;Taip;0;1;0;1
317;Atžalėlės;Voveriukai;2067246260;Taip;0;0;19;19
318;Atžalėlės;Voveriukai;69883334049;Taip;0;0;3;3
319;Atžalėlės;Voveriukai;7532672266;Taip;0;0;1;1
320;Atžalėlės;Voveriukai;5705303891;Taip;1;0;0;1
321;Atžalėlės;Voveriukai;57580381980;Taip;0;0;1;1
322;Atžalėlės;Voveriukai;5650427433;Taip;0;1;0;1
323;Atžalėlės;Žirniukai;7613931447;Taip;3;3;0;6
324;Atžalėlės;Žirniukai;7522643082;Taip;12;0;0;12
325;Atžalėlės;Žirniukai;9707462467;Taip;8;10;2;20
326;Atžalėlės;Žirniukai;5584105084;Taip;0;12;0;12
327;Atžalėlės;Žirniukai;9677943321;Taip;0;0;4;4
328;Atžalėlės;Žirniukai;9967641617;Taip;0;14;0;14
329;Atžalėlės;Žirniukai;9508110719;Taip;0;0;1;1
330;Atžalėlės;Žirniukai;7196464328;Taip;0;8;0;8
331;Atžalėlės;Žirniukai;9085453655;Taip;0;7;0;7
332;Atžalėlės;Žirniukai;1538643591;Taip;3;14;2;19
333;Atžalėlės;Žirniukai;3143856911;Taip;0;7;0;7
334;Atžalėlės;Žirniukai;4661388894;Taip;0;2;0;2
335;Atžalėlės;Žirniukai;5148142239;Taip;0;8;0;8
336;Atžalėlės;Žirniukai;1212074068;Taip;14;0;0;14
337;Atžalėlės;Žirniukai;9736390705;Taip;3;0;0;3
338;Atžalėlės;Ežiukai;1423254771;Taip;0;0;1;1
339;Atžalėlės;Ežiukai;9053620501;Taip;0;0;5;5
340;Atžalėlės;Ežiukai;9054589111;Taip;0;2;0;2
341;Atžalėlės;Ežiukai;9346744866;Taip;0;3;0;3
342;Atžalėlės;Ežiukai;6665199013;Taip;0;8;0;8
343;Atžalėlės;Ežiukai;1505286928;Taip;0;5;0;5
344;Atžalėlės;Ežiukai;4148412941;Taip;0;0;3;3
345;Atžalėlės;Ežiukai;3333808381;Taip;0;0;4;4
346;Atžalėlės;Ežiukai;1614261572;Taip;0;3;0;3
347;Atžalėlės;Ežiukai;9481268935;Taip;0;0;3;3
348;Atžalėlės;Ežiukai;6447615639;Taip;0;0;8;8
349;Atžalėlės;Ežiukai;5972419628;Taip;0;4;0;4
350;Atžalėlės;Paukšteliai;4081717007;Taip;12;0;0;12
351;Atžalėlės;Paukšteliai;7807313362;Taip;3;0;2;5
352;Atžalėlės;Paukšteliai;8768704484;Taip;4;0;3;7
353;Atžalėlės;Paukšteliai;6675588261;Taip;4;0;3;7
354;Atžalėlės;Paukšteliai;8524244526;Taip;0;5;2;7
355;Atžalėlės;Paukšteliai;6873507667;Taip;2;0;0;2
356;Atžalėlės;Paukšteliai;7321516783;Taip;0;1;0;1
357;Atžalėlės;Paukšteliai;6265777690;Taip;0;1;0;1
358;Atžalėlės;Paukšteliai;1844980319;Taip;0;12;0;12
359;Atžalėlės;Paukšteliai;5997958773;Taip;5;12;0;17
360;Atžalėlės;Paukšteliai;7356877676;Taip;0;3;0;3
361;Atžalėlės;Paukšteliai;8512283024;Taip;9;7;0;16
362;Atžalėlės;Paukšteliai;2078781673;Taip;10;0;0;10
363;Atžalėlės;Paukšteliai;1520206753;Taip;3;0;2;5
364;Atžalėlės;Paukšteliai;4790322154;Taip;0;7;0;7
365;Atžalėlės;Paukšteliai;9327437508;Taip;0;19;0;19
366;Atžalėlės;Meškiukai;1431197358;Taip;0;0;6;6
367;Atžalėlės;Meškiukai;4177753994;Taip;5;3;1;9
368;Atžalėlės;Meškiukai;9925178685;Taip;1;0;1;2
369;Atžalėlės;Meškiukai;2617568019;Taip;11;4;0;15
370;Atžalėlės;Meškiukai;3743308789;Taip;6;4;0;10
371;Atžalėlės;Meškiukai;4233689945;Taip;0;0;2;2
372;Atžalėlės;Meškiukai;8619613890;Taip;5;0;0;5
373;Atžalėlės;Meškiukai;3281114596;Taip;0;12;0;12
374;Atžalėlės;Meškiukai;5466374223;Taip;0;0;1;1
375;Atžalėlės;Meškiukai;2433029299;Taip;14;0;1;15
376;Atžalėlės;Meškiukai;5682652546;Taip;0;16;0;16
377;Atžalėlės;Meškiukai;9631336340;Taip;0;11;0;11
378;Atžalėlės;Meškiukai;2930612059;Ne;0;3;15;18
379;Atžalėlės;Meškiukai;6385777303;Ne;0;0;1;1
380;Atžalėlės;Meškiukai;2569491645;Taip;0;1;0;1
381;Aušrelė;PASAKIUKAI;1659335142;Taip;0;3;0;3
382;Aušrelė;PASAKIUKAI;2974714806;Taip;2;12;0;14
383;Aušrelė;PASAKIUKAI;8960462835;Taip;7;4;4;15
384;Aušrelė;PASAKIUKAI;6037757548;Taip;3;0;0;3
385;Aušrelė;PASAKIUKAI;1408751702;Taip;0;9;0;9
386;Aušrelė;PASAKIUKAI;6995749373;Taip;3;2;0;5
387;Aušrelė;PASAKIUKAI;8372554796;Taip;0;6;0;6
388;Aušrelė;PASAKIUKAI;1502146844;Taip;6;8;0;14
389;Aušrelė;PASAKIUKAI;8341539501;Ne;0;2;0;2
390;Aušrelė;PASAKIUKAI;8230362307;Taip;13;0;0;13
391;Aušrelė;PASAKIUKAI;4306578299;Taip;14;2;2;18
392;Aušrelė;PASAKIUKAI;6277405405;Taip;0;1;0;1
393;Aušrelė;PASAKIUKAI;3682523696;Taip;9;5;0;14
394;Aušrelė;PASAKIUKAI;1814972981;Taip;6;2;2;10
395;Aušrelė;PASAKIUKAI;34891640909;Taip;0;2;0;2
396;Aušrelė;PASAKIUKAI;2125080379;Taip;0;10;0;10
397;Aušrelė;BORUŽĖLĖS;4895872593;Taip;22;0;0;22
398;Aušrelė;BORUŽĖLĖS;6673034329;Taip;5;3;0;8
399;Aušrelė;BORUŽĖLĖS;3165692699;Taip;0;1;0;1
400;Aušrelė;BORUŽĖLĖS;1928260563;Taip;0;2;1;3
401;Aušrelė;BORUŽĖLĖS;2626569015;Taip;0;5;0;5
402;Aušrelė;BORUŽĖLĖS;1543314096;Taip;0;2;7;9
403;Aušrelė;BORUŽĖLĖS;4505922394;Taip;13;4;0;17
404;Aušrelė;BORUŽĖLĖS;7190665397;Taip;0;0;1;1
405;Aušrelė;BORUŽĖLĖS;2991828434;Taip;0;4;0;4
406;Aušrelė;BORUŽĖLĖS;6321332888;Taip;0;2;3;5
407;Aušrelė;SMALSUČIAI;6761263775;Taip;0;5;1;6
408;Aušrelė;SMALSUČIAI;3015028879;Taip;0;22;0;22
409;Aušrelė;SMALSUČIAI;2863655361;Taip;5;0;0;5
410;Aušrelė;SMALSUČIAI;2390128933;Taip;0;1;0;1
411;Aušrelė;SMALSUČIAI;8503309819;Taip;5;0;0;5
412;Aušrelė;SMALSUČIAI;2827216981;Taip;0;1;0;1
413;Aušrelė;SMALSUČIAI;9443641849;Taip;0;5;0;5
414;Aušrelė;SMALSUČIAI;7930717076;Taip;0;1;0;1
415;Aušrelė;SMALSUČIAI;7609339123;Taip;0;1;0;1
416;Aušrelė;SMALSUČIAI;5478028396;Taip;0;6;0;6
417;Aušrelė;SMALSUČIAI;7070013052;Taip;0;10;0;10
418;Aušrelė;SMALSUČIAI;2266390402;Taip;0;3;0;3
419;Aušrelė;SMALSUČIAI;8032661062;Taip;0;0;3;3
420;Aušrelė;KODĖLČIUKAI;7723159748;Taip;13;2;0;15
421;Aušrelė;KODĖLČIUKAI;7367268748;Taip;14;0;3;17
422;Aušrelė;KODĖLČIUKAI;5712867880;Taip;0;1;0;1
423;Aušrelė;KODĖLČIUKAI;3623813061;Taip;0;2;0;2
424;Aušrelė;KODĖLČIUKAI;8693750994;Taip;12;1;1;14
425;Aušrelė;KODĖLČIUKAI;7327544406;Taip;0;1;1;2
426;Aušrelė;KODĖLČIUKAI;9566144610;Taip;0;6;2;8
427;Aušrelė;KODĖLČIUKAI;6186758486;Taip;0;6;1;7
428;Aušrelė;KODĖLČIUKAI;3320399046;Taip;4;0;2;6
429;Aušrelė;KODĖLČIUKAI;6911735462;Taip;10;4;0;14
430;Aušrelė;KODĖLČIUKAI;4248808572;Taip;0;22;0;22
431;Aušrelė;KODĖLČIUKAI;5046027475;Taip;0;2;0;2
432;Aušrelė;KODĖLČIUKAI;8338569001;Taip;0;2;2;4
433;Aušrelė;KODĖLČIUKAI;2766357229;Taip;0;0;6;6
434;Aušrelė;KODĖLČIUKAI;5358315970;Taip;5;0;1;6
435;Aušrelė;KODĖLČIUKAI;7515666888;Taip;0;1;0;1
436;Aušrelė;PELĖDŽIUKAI;5955421544;Ne;0;0;13;13
437;Aušrelė;PELĖDŽIUKAI;1706417053;Taip;0;0;1;1
438;Aušrelė;PELĖDŽIUKAI;1160772086;Taip;0;1;0;1
439;Aušrelė;PELĖDŽIUKAI;1352195876;Taip;0;0;4;4
440;Aušrelė;PELĖDŽIUKAI;1599595256;Taip;0;8;0;8
441;Aušrelė;PELĖDŽIUKAI;1539176090;Taip;0;2;0;2
442;Aušrelė;PELĖDŽIUKAI;1225272131;Taip;0;0;4;4
443;Aušrelė;PELĖDŽIUKAI;1868818387;Taip;0;4;2;6
444;Aušrelė;PELĖDŽIUKAI;2987088389;Ne;0;0;2;2
445;Aušrelė;PELĖDŽIUKAI;1506444915;Taip;0;9;0;9
446;Aušrelė;PELĖDŽIUKAI;5304765447;Taip;0;2;1;3
447;Aušrelė;PELĖDŽIUKAI;85739624682;Taip;3;0;6;9
448;Aušrelė;PELĖDŽIUKAI;6837623034;Ne;0;0;14;14
449;Aušrelė;PELĖDŽIUKAI;42721248496;Taip;0;1;0;1
450;Aušrelė;PELĖDŽIUKAI;1177022224;Taip;0;6;0;6
451;Aušrelė;PELĖDŽIUKAI;1666811336;Taip;0;0;2;2
452;Aušrelė;PELĖDŽIUKAI;6337567632;Taip;0;17;0;17
453;Aušrelė;AITVARIUKAI;49583107808;Taip;1;0;1;2
454;Aušrelė;AITVARIUKAI;1153416324;Taip;0;22;0;22
455;Aušrelė;AITVARIUKAI;1340754039;Taip;0;4;0;4
456;Aušrelė;AITVARIUKAI;79695989966;Taip;0;6;0;6
457;Aušrelė;AITVARIUKAI;1045290039;Taip;0;22;0;22
458;Aušrelė;AITVARIUKAI;51119593813;Taip;0;0;1;1
459;Aušrelė;AITVARIUKAI;5813735533;Taip;0;10;5;15
460;Aušrelė;AITVARIUKAI;18117725053;Taip;0;2;1;3
461;Aušrelė;AITVARIUKAI;27629722512;Taip;5;1;0;6
462;Aušrelė;AITVARIUKAI;1830501248;Taip;0;2;0;2
463;Aušrelė;AITVARIUKAI;65369497777;Taip;0;22;0;22
464;Aušrelė;AITVARIUKAI;1750555187;Taip;0;2;0;2
465;Aušrelė;AITVARIUKAI;8221635058;Ne;4;1;0;5
466;Aušrelė;AITVARIUKAI;1163757003;Taip;0;11;0;11
467;Aušrelė;AITVARIUKAI;1792774415;Taip;0;4;0;4
468;Aušrelė;AITVARIUKAI;6604163285;Taip;0;1;0;1
469;Aušrelė;AITVARIUKAI;1306572766;Taip;0;22;0;22
470;Aušrelė;AITVARIUKAI;9004468035;Taip;13;1;0;14
471;Aušrelė;AITVARIUKAI;13826429088;Ne;0;6;4;10
472;Aušrelė;BITUTĖS;4882556718;Taip;0;2;0;2
473;Aušrelė;BITUTĖS;1741716341;Taip;0;22;0;22
474;Aušrelė;BITUTĖS;4989544273;Taip;14;0;2;16
475;Aušrelė;BITUTĖS;9960201865;Taip;1;1;0;2
476;Aušrelė;BITUTĖS;2071674661;Ne;0;19;0;19
477;Aušrelė;BITUTĖS;1450827353;Taip;4;0;1;5
478;Aušrelė;BITUTĖS;4935192851;Taip;0;10;0;10
479;Aušrelė;BITUTĖS;9505496063;Ne;10;0;0;10
480;Aušrelė;BITUTĖS;1931955562;Ne;5;0;0;5
481;Aušrelė;BITUTĖS;5614774250;Ne;0;4;0;4
482;Aušrelė;BITUTĖS;4500226170;Ne;0;1;0;1
483;Aušrelė;BITUTĖS;6591538425;Taip;0;22;0;22
484;Aušrelė;BITUTĖS;8203256528;Taip;0;21;0;21
485;Aušrelė;BITUTĖS;5741252819;Taip;0;21;0;21
486;Aušrelė;BITUTĖS;1243825974;Taip;0;1;0;1
487;Aušrelė;ŽIRNIUKAI;1949809977;Taip;3;0;0;3
488;Aušrelė;ŽIRNIUKAI;9733877752;Taip;0;3;0;3
489;Aušrelė;ŽIRNIUKAI;8542012622;Taip;22;0;0;22
490;Aušrelė;ŽIRNIUKAI;1544869163;Taip;10;2;0;12
491;Aušrelė;ŽIRNIUKAI;6577540623;Taip;9;0;0;9
492;Aušrelė;ŽIRNIUKAI;5460833944;Taip;3;0;0;3
493;Aušrelė;ŽIRNIUKAI;6372004855;Taip;0;6;0;6
494;Aušrelė;ŽIRNIUKAI;3795172018;Taip;0;5;0;5
495;Aušrelė;ŽIRNIUKAI;3713528812;Taip;5;0;0;5
496;Aušrelė;ŽIRNIUKAI;2107898976;Taip;7;0;0;7
497;Aušrelė;ŽIRNIUKAI;1607338052;Taip;0;2;0;2
498;Aušrelė;ŽIRNIUKAI;8573348956;Taip;0;22;0;22
499;Aušrelė;ŽIRNIUKAI;6463141345;Taip;0;2;0;2
500;Aušrelė;ŽIRNIUKAI;1798478023;Taip;7;4;3;14
501;Aušrelė;GRYBUKAI;7406063630;Taip;2;1;0;3
502;Aušrelė;GRYBUKAI;9938762910;Taip;0;1;0;1
503;Aušrelė;GRYBUKAI;1463724119;Taip;0;1;0;1
504;Aušrelė;GRYBUKAI;8438945369;Taip;14;0;0;14
505;Aušrelė;GRYBUKAI;6761874176;Taip;0;2;10;12
506;Aušrelė;GRYBUKAI;6672975558;Taip;13;0;1;14
507;Aušrelė;GRYBUKAI;4565813136;Taip;0;14;0;14
508;Aušrelė;GRYBUKAI;9877307844;Taip;0;2;1;3
509;Aušrelė;GRYBUKAI;7130040621;Taip;0;1;0;1
510;Aušrelė;GRYBUKAI;2441221298;Taip;0;22;0;22
511;Aušrelė;GRYBUKAI;2311552230;Taip;5;0;0;5
512;Aušrelė;GRYBUKAI;1458580523;Taip;20;0;0;20
513;Aušrelė;GRYBUKAI;1871799626;Taip;8;0;0;8
514;Aušrelė;GRYBUKAI;5733298006;Taip;0;6;0;6
515;Aušrelė;DRUGELIAI;2468245186;Taip;0;2;1;3
516;Aušrelė;DRUGELIAI;8210698019;Taip;0;22;0;22
517;Aušrelė;DRUGELIAI;2545065554;Taip;0;1;0;1
518;Aušrelė;DRUGELIAI;8411336992;Taip;0;2;5;7
519;Aušrelė;DRUGELIAI;8917907028;Taip;5;0;0;5
520;Aušrelė;DRUGELIAI;7494298336;Taip;5;11;0;16
521;Aušrelė;DRUGELIAI;4012186237;Taip;0;0;4;4
522;Aušrelė;DRUGELIAI;3738923947;Taip;0;1;0;1
523;Aušrelė;DRUGELIAI;3223092149;Taip;0;6;0;6
524;Aušrelė;DRUGELIAI;8580241126;Taip;0;0;10;10
525;Aušrelė;DRUGELIAI;4227228548;Taip;3;2;2;7
526;Aušrelė;DRUGELIAI;8996445434;Taip;3;2;0;5
527;Aušrelė;DRUGELIAI;6109859056;Taip;2;1;0;3
528;Aušrelė;DRUGELIAI;4942168388;Taip;0;22;0;22
529;Aušrelė;DRUGELIAI;5312189552;Taip;0;2;2;4
530;Aušrelė;DRUGELIAI;4725588671;Taip;0;7;0;7
531;Aušrelė;NYKŠTUKAI;6434548772;Taip;9;0;1;10
532;Aušrelė;NYKŠTUKAI;4595435635;Taip;0;11;0;11
533;Aušrelė;NYKŠTUKAI;9158248746;Taip;4;2;1;7
534;Aušrelė;NYKŠTUKAI;5708459561;Taip;5;1;0;6
535;Aušrelė;NYKŠTUKAI;5125295651;Taip;0;2;1;3
536;Aušrelė;NYKŠTUKAI;9608444990;Taip;0;0;1;1
537;Aušrelė;NYKŠTUKAI;5602774323;Taip;0;1;0;1
538;Aušrelė;NYKŠTUKAI;1039180129;Taip;3;2;0;5
539;Aušrelė;NYKŠTUKAI;3288449407;Taip;6;0;1;7
540;Aušrelė;NYKŠTUKAI;6081100604;Taip;0;1;0;1
541;Aušrelė;NYKŠTUKAI;2030555139;Taip;0;5;0;5
542;Aušrelė;NYKŠTUKAI;3807967685;Taip;4;0;0;4
543;Aušrelė;NYKŠTUKAI;8102749675;Taip;0;2;0;2
544;Aušrelė;NYKŠTUKAI;7978186455;Taip;0;22;0;22
545;Aušrelė;NYKŠTUKAI;7847650967;Taip;0;3;0;3
546;Aušrelė;"NAUJA (LOPŠELIS)";5801943729;Taip;0;6;0;6
547;Aušrelė;"NAUJA (LOPŠELIS)";1446194971;Taip;3;2;0;5
548;Aušrelė;"NAUJA (LOPŠELIS)";6418762623;Taip;3;12;0;15
549;Aušrelė;"NAUJA (LOPŠELIS)";2319188134;Taip;10;0;2;12
550;Aušrelė;"NAUJA (LOPŠELIS)";8801906679;Taip;0;0;1;1
551;Aušrelė;"NAUJA (LOPŠELIS)";8835689988;Ne;0;0;2;2
552;Aušrelė;"NAUJA (LOPŠELIS)";5358736178;Taip;10;0;0;10
553;Aušrelė;"NAUJA (LOPŠELIS)";7966060521;Taip;0;2;0;2
554;Aušrelė;"NAUJA (LOPŠELIS)";9251919940;Taip;3;0;17;20
555;Aušrelė;"NAUJA (LOPŠELIS)";1985540746;Taip;15;0;1;16
556;Aušrelė;"NAUJA (LOPŠELIS)";7208341200;Ne;0;22;0;22
557;Beržynėlis;SVIRPLIUKAI;7649359221;Taip;4;6;0;10
558;Beržynėlis;SVIRPLIUKAI;74856278886;Ne;0;1;0;1
559;Beržynėlis;SVIRPLIUKAI;1682929565;Taip;7;0;1;8
560;Beržynėlis;SVIRPLIUKAI;5196910604;Taip;15;4;0;19
561;Beržynėlis;SVIRPLIUKAI;1395819329;Taip;0;0;5;5
562;Beržynėlis;SVIRPLIUKAI;7248602510;Taip;0;2;0;2
563;Beržynėlis;SVIRPLIUKAI;2791734213;Taip;0;7;0;7
564;Beržynėlis;SVIRPLIUKAI;9566341884;Taip;4;1;0;5
565;Beržynėlis;SVIRPLIUKAI;3278699117;Taip;0;1;0;1
566;Beržynėlis;SVIRPLIUKAI;1838631438;Taip;6;0;0;6
567;Beržynėlis;SVIRPLIUKAI;2681482042;Taip;0;5;1;6
568;Beržynėlis;SVIRPLIUKAI;1136091326;Taip;0;5;0;5
569;Beržynėlis;SVIRPLIUKAI;1516309509;Taip;0;2;0;2
570;Beržynėlis;SVIRPLIUKAI;6395436937;Taip;4;1;0;5
571;Beržynėlis;SVIRPLIUKAI;5189335842;Taip;0;1;0;1
572;Beržynėlis;PELEDŽIUKAI;17743947386;Taip;0;2;0;2
573;Beržynėlis;PELEDŽIUKAI;2067928004;Taip;0;6;0;6
574;Beržynėlis;PELEDŽIUKAI;1527942602;Taip;0;1;0;1
575;Beržynėlis;PELEDŽIUKAI;2023412985;Taip;8;0;0;8
576;Beržynėlis;PELEDŽIUKAI;1466742506;Taip;0;0;6;6
577;Beržynėlis;PELEDŽIUKAI;1885972165;Taip;0;3;0;3
578;Beržynėlis;PELEDŽIUKAI;1910024785;Taip;8;7;0;15
579;Beržynėlis;PELEDŽIUKAI;1426962644;Taip;0;1;0;1
580;Beržynėlis;PELEDŽIUKAI;7520394353;Taip;0;1;0;1
581;Beržynėlis;PELEDŽIUKAI;95544821432;Taip;0;1;0;1
582;Beržynėlis;PELEDŽIUKAI;1367442186;Taip;0;7;0;7
583;Beržynėlis;PELEDŽIUKAI;1014895926;Taip;0;4;0;4
584;Beržynėlis;PELEDŽIUKAI;1391844432;Taip;0;4;0;4
585;Beržynėlis;PELEDŽIUKAI;1945230630;Taip;2;0;1;3
586;Beržynėlis;PELEDŽIUKAI;81022321678;Taip;0;0;2;2
587;Beržynėlis;PELEDŽIUKAI;45685658789;Taip;0;2;0;2
588;Beržynėlis;PELEDŽIUKAI;7289803632;Taip;4;2;0;6
589;Beržynėlis;PELEDŽIUKAI;1207208151;Taip;0;7;2;9
590;Beržynėlis;PELEDŽIUKAI;29356394553;Taip;11;0;0;11
591;Beržynėlis;PELEDŽIUKAI;1895493234;Taip;0;5;1;6
592;Beržynėlis;PELEDŽIUKAI;1612137286;Taip;0;2;0;2
593;Beržynėlis;ŽIOGELIAI;4035764376;Taip;4;0;0;4
594;Beržynėlis;ŽIOGELIAI;4970999989;Taip;9;2;0;11
595;Beržynėlis;ŽIOGELIAI;1325972861;Taip;3;0;3;6
596;Beržynėlis;ŽIOGELIAI;8688852668;Taip;0;2;0;2
597;Beržynėlis;ŽIOGELIAI;9088059487;Taip;5;0;0;5
598;Beržynėlis;ŽIOGELIAI;5473666098;Taip;0;1;0;1
599;Beržynėlis;ŽIOGELIAI;7589778533;Taip;0;6;0;6
600;Beržynėlis;ŽIOGELIAI;6739927917;Taip;6;10;0;16
601;Beržynėlis;ŽIOGELIAI;2971686368;Taip;0;13;0;13
602;Beržynėlis;ŽIOGELIAI;9409317403;Taip;0;2;3;5
603;Beržynėlis;ŽIOGELIAI;6334152631;Taip;8;6;0;14
604;Beržynėlis;ŽIOGELIAI;9305279614;Taip;0;10;0;10
605;Beržynėlis;ŽIOGELIAI;9511051386;Taip;0;2;0;2
606;Beržynėlis;ŽIOGELIAI;8114761925;Taip;2;0;0;2
607;Beržynėlis;ŽVIRBLIUKAI;2892553878;Taip;0;1;0;1
608;Beržynėlis;ŽVIRBLIUKAI;4466393687;Taip;0;4;0;4
609;Beržynėlis;ŽVIRBLIUKAI;4774769217;Taip;3;0;1;4
610;Beržynėlis;ŽVIRBLIUKAI;9503352345;Taip;0;9;0;9
611;Beržynėlis;ŽVIRBLIUKAI;8881566865;Taip;0;0;11;11
612;Beržynėlis;ŽVIRBLIUKAI;8280378527;Taip;0;10;0;10
613;Beržynėlis;ŽVIRBLIUKAI;9754455116;Taip;0;1;0;1
614;Beržynėlis;ŽVIRBLIUKAI;3334994408;Taip;0;9;0;9
615;Beržynėlis;ŽVIRBLIUKAI;6293884233;Taip;0;0;1;1
616;Beržynėlis;ŽVIRBLIUKAI;4161974847;Taip;5;2;1;8
617;Beržynėlis;ŽVIRBLIUKAI;5194416351;Taip;8;0;0;8
618;Beržynėlis;ŽIRNIUKAI;5847488152;Taip;6;9;0;15
619;Beržynėlis;ŽIRNIUKAI;8880151537;Taip;0;12;0;12
620;Beržynėlis;ŽIRNIUKAI;2221708263;Taip;15;0;0;15
621;Beržynėlis;ŽIRNIUKAI;9580286493;Taip;3;0;4;7
622;Beržynėlis;ŽIRNIUKAI;1468551784;Taip;12;0;0;12
623;Beržynėlis;ŽIRNIUKAI;6516665294;Taip;7;2;0;9
624;Beržynėlis;ŽIRNIUKAI;7389141619;Taip;0;2;5;7
625;Beržynėlis;ŽIRNIUKAI;5027712732;Taip;0;6;5;11
626;Beržynėlis;ŽIRNIUKAI;7555487759;Taip;5;2;0;7
627;Beržynėlis;ŽIRNIUKAI;4595080695;Taip;4;0;0;4
628;Beržynėlis;ŽIRNIUKAI;6932094459;Taip;0;5;0;5
629;Beržynėlis;ŽIRNIUKAI;6673910279;Taip;7;0;0;7
630;Beržynėlis;ŽIRNIUKAI;5864265458;Taip;0;6;0;6
631;Beržynėlis;ŽIRNIUKAI;6301767635;Taip;10;4;0;14
632;Beržynėlis;VIŠČIUKAI;7953957525;Taip;0;2;0;2
633;Beržynėlis;VIŠČIUKAI;5081543379;Taip;3;3;0;6
634;Beržynėlis;VIŠČIUKAI;8233464088;Taip;0;4;0;4
635;Beržynėlis;VIŠČIUKAI;4013099670;Taip;0;3;0;3
636;Beržynėlis;VIŠČIUKAI;7016454952;Taip;3;19;0;22
637;Beržynėlis;VIŠČIUKAI;3418730586;Taip;0;2;0;2
638;Beržynėlis;VIŠČIUKAI;8404801225;Taip;0;0;7;7
639;Beržynėlis;VIŠČIUKAI;4134371415;Taip;0;1;0;1
640;Beržynėlis;VIŠČIUKAI;3841363368;Taip;0;0;1;1
641;Beržynėlis;VIŠČIUKAI;8303684788;Taip;13;0;0;13
642;Beržynėlis;VIŠČIUKAI;7903644161;Taip;8;0;0;8
643;Beržynėlis;VIŠČIUKAI;1707585750;Taip;17;0;0;17
644;Beržynėlis;VIŠČIUKAI;4382068779;Taip;14;0;0;14
645;Beržynėlis;VIŠČIUKAI;2272661119;Taip;5;0;0;5
646;Birutės;SKRUZDELIUKŲ;1761065941;Taip;0;3;0;3
647;Birutės;SKRUZDELIUKŲ;9610268046;Taip;3;0;1;4
648;Birutės;SKRUZDELIUKŲ;4027700332;Taip;0;0;1;1
649;Birutės;SKRUZDELIUKŲ;1105133326;Taip;8;0;14;22
650;Birutės;SKRUZDELIUKŲ;9411016611;Taip;0;0;1;1
651;Birutės;SKRUZDELIUKŲ;7119951690;Taip;0;6;0;6
652;Birutės;SKRUZDELIUKŲ;1945532852;Taip;0;0;6;6
653;Birutės;SKRUZDELIUKŲ;6815916679;Taip;0;9;5;14
654;Birutės;SKRUZDELIUKŲ;7940403585;Taip;0;4;0;4
655;Birutės;SKRUZDELIUKŲ;9187671201;Taip;7;0;1;8
656;Birutės;SKRUZDELIUKŲ;8413760872;Taip;0;1;0;1
657;Birutės;SKRUZDELIUKŲ;7251592439;Taip;0;2;0;2
658;Birutės;SKRUZDELIUKŲ;2859160609;Taip;0;2;0;2
659;Birutės;SKRUZDELIUKŲ;9904827482;Taip;2;5;0;7
660;Birutės;SKRUZDELIUKŲ;2140552221;Ne;0;0;3;3
661;Birutės;BITUČIŲ;1599159924;Ne;0;3;0;3
662;Birutės;BITUČIŲ;33770983649;Taip;0;2;7;9
663;Birutės;BITUČIŲ;2975442228;Taip;8;2;0;10
664;Birutės;BITUČIŲ;98391790116;Taip;2;1;0;3
665;Birutės;BITUČIŲ;5947971037;Taip;0;3;0;3
666;Birutės;BITUČIŲ;3436637062;Taip;0;1;0;1
667;Birutės;BITUČIŲ;8465645434;Taip;9;0;0;9
668;Birutės;BITUČIŲ;9722922540;Taip;0;0;2;2
669;Birutės;BITUČIŲ;7856891698;Ne;0;0;1;1
670;Birutės;BITUČIŲ;3061210677;Taip;0;0;1;1
671;Birutės;BITUČIŲ;6431396285;Taip;0;0;1;1
672;Birutės;BITUČIŲ;6081472534;Taip;0;0;2;2
673;Birutės;BITUČIŲ;2674259453;Taip;0;0;19;19
674;Birutės;BITUČIŲ;17865476849;Taip;15;0;1;16
675;Birutės;BITUČIŲ;2329522074;Taip;0;6;0;6
676;Birutės;BORUŽIUKAI;1400510886;Taip;0;7;0;7
677;Birutės;BORUŽIUKAI;5457357625;Taip;4;0;1;5
678;Birutės;BORUŽIUKAI;5869137292;Taip;5;0;0;5
679;Birutės;BORUŽIUKAI;5026442722;Taip;0;3;0;3
680;Birutės;BORUŽIUKAI;6977276295;Taip;0;0;18;18
681;Birutės;BORUŽIUKAI;4906874758;Taip;0;9;0;9
682;Birutės;BORUŽIUKAI;7494879160;Taip;5;0;0;5
683;Birutės;BORUŽIUKAI;4488481136;Taip;0;6;2;8
684;Birutės;BORUŽIUKAI;6460415179;Taip;0;4;0;4
685;Birutės;BORUŽIUKAI;6973898557;Taip;0;7;0;7
686;Birutės;BORUŽIUKAI;7033907787;Taip;4;0;10;14
687;Birutės;BORUŽIUKAI;5745377474;Taip;0;0;7;7
688;Birutės;BORUŽIUKAI;5897671273;Taip;0;0;5;5
689;Birutės;DRUGELIAI;1884820602;Taip;0;1;0;1
690;Birutės;DRUGELIAI;1447494370;Taip;0;0;1;1
691;Birutės;DRUGELIAI;22036269009;Taip;0;0;2;2
692;Birutės;DRUGELIAI;23540610503;Taip;0;0;2;2
693;Birutės;DRUGELIAI;1346957081;Taip;0;0;3;3
694;Birutės;DRUGELIAI;9662009307;Taip;4;0;8;12
695;Birutės;DRUGELIAI;9860683556;Taip;0;0;2;2
696;Birutės;DRUGELIAI;53416654439;Taip;0;0;2;2
697;Birutės;DRUGELIAI;5574120561;Taip;0;0;1;1
698;Birutės;DRUGELIAI;7215289265;Taip;0;0;3;3
699;Birutės;DRUGELIAI;18503890312;Taip;0;1;0;1
700;Birutės;DRUGELIAI;1719394957;Taip;0;0;1;1
701;Birutės;DRUGELIAI;9936423295;Taip;0;0;1;1
702;Birutės;DRUGELIAI;10932023263;Taip;0;0;1;1
703;Birutės;"NAUJA 2";2016711225;Taip;5;2;0;7
704;Bitutė;Aitvariukų;3254061362;Taip;0;3;0;3
705;Bitutė;Aitvariukų;6674923740;Taip;0;3;0;3
706;Bitutė;Aitvariukų;8394685672;Taip;0;10;0;10
707;Bitutė;Aitvariukų;3796188100;Taip;0;21;0;21
708;Bitutė;Aitvariukų;1846974702;Taip;0;3;0;3
709;Bitutė;Aitvariukų;1560715159;Taip;0;12;0;12
710;Bitutė;Aitvariukų;6204566294;Taip;0;6;0;6
711;Bitutė;Aitvariukų;2518730247;Taip;14;11;0;25
712;Bitutė;Aitvariukų;8743734366;Taip;0;13;0;13
713;Bitutė;Aitvariukų;2804203556;Taip;0;3;0;3
714;Bitutė;Aitvariukų;5455919343;Taip;0;7;0;7
715;Bitutė;Aitvariukų;3432065233;Taip;0;17;0;17
716;Bitutė;Aitvariukų;5679397165;Taip;0;18;0;18
717;Bitutė;Aitvariukų;7056737587;Taip;0;6;0;6
718;Bitutė;Aitvariukų;1564763789;Taip;0;1;0;1
719;Bitutė;Aitvariukų;5810344229;Taip;0;7;0;7
720;Bitutė;Aitvariukų;4985270536;Taip;8;2;0;10
721;Bitutė;Aitvariukų;1590501589;Taip;13;2;0;15
722;Bitutė;Ežiukų;40949937934;Taip;0;0;3;3
723;Bitutė;Ežiukų;1262030751;Taip;0;5;3;8
724;Bitutė;Ežiukų;70388118169;Taip;0;1;1;2
725;Bitutė;Ežiukų;4315172747;Taip;5;2;0;7
726;Bitutė;Ežiukų;5126303823;Taip;0;4;0;4
727;Bitutė;Ežiukų;9838379838;Taip;0;32;0;32
728;Bitutė;Ežiukų;42098027592;Taip;0;1;0;1
729;Bitutė;Ežiukų;17953339860;Taip;0;0;1;1
730;Bitutė;Ežiukų;4764586168;Taip;0;6;2;8
731;Bitutė;Ežiukų;8905075899;Taip;0;3;1;4
732;Bitutė;Ežiukų;1709788155;Taip;0;7;0;7
733;Bitutė;Ežiukų;3600670185;Taip;0;4;1;5
734;Bitutė;Ežiukų;6341806464;Taip;15;1;1;17
735;Bitutė;Ežiukų;7456328992;Ne;0;8;0;8
736;Bitutė;Ežiukų;2812580726;Taip;0;3;3;6
737;Bitutė;Ežiukų;8186706520;Taip;0;32;0;32
738;Bitutė;Ežiukų;1904108612;Taip;0;7;0;7
739;Bitutė;Žvirbliukų;7047262367;Taip;4;4;1;9
740;Bitutė;Žvirbliukų;3804171750;Taip;0;3;0;3
741;Bitutė;Žvirbliukų;5406667195;Taip;9;9;0;18
742;Bitutė;Žvirbliukų;4458990772;Taip;0;1;2;3
743;Bitutė;Žvirbliukų;3723040682;Taip;10;2;0;12
744;Bitutė;Žvirbliukų;2190439190;Taip;5;1;0;6
745;Bitutė;Žvirbliukų;7113693496;Taip;0;5;2;7
746;Bitutė;Žvirbliukų;4177331531;Taip;0;0;1;1
747;Bitutė;Žvirbliukų;2483462846;Taip;8;9;0;17
748;Bitutė;Žvirbliukų;7678106084;Taip;0;2;1;3
749;Bitutė;Žvirbliukų;6044969600;Taip;5;13;0;18
750;Bitutė;Žvirbliukų;2444289145;Taip;4;11;0;15
751;Bitutė;Žvirbliukų;3517750478;Taip;5;0;0;5
752;Bitutė;Žvirbliukų;5291764696;Taip;0;2;0;2
753;Bitutė;Žvirbliukų;4303490614;Taip;7;9;0;16
754;Bitutė;Žvirbliukų;9523588597;Taip;8;1;0;9
755;Bitutė;Žvirbliukų;3654065124;Taip;9;1;0;10
756;Bitutė;Žvirbliukų;9166624750;Taip;7;6;0;13
757;Bitutė;Žvirbliukų;8373105196;Taip;4;6;4;14
758;Bitutė;Žvirbliukų;6014726741;Taip;0;6;0;6
759;Bitutė;Žvirbliukų;4527880105;Taip;10;3;2;15
760;Bitutė;Žvirbliukų;9834697190;Taip;0;0;1;1
761;Bitutė;Gandriukų;2104500642;Taip;0;9;0;9
762;Bitutė;Gandriukų;4054959628;Taip;0;7;2;9
763;Bitutė;Gandriukų;14787330368;Taip;0;2;0;2
764;Bitutė;Gandriukų;11128936533;Taip;8;0;0;8
765;Bitutė;Gandriukų;1385876629;Taip;0;5;0;5
766;Bitutė;Gandriukų;9314363274;Taip;0;32;0;32
767;Bitutė;Gandriukų;84694903978;Taip;0;5;0;5
768;Bitutė;Gandriukų;86636444738;Taip;0;9;0;9
769;Bitutė;Gandriukų;1703630417;Taip;4;7;0;11
770;Bitutė;Gandriukų;6591291681;Taip;0;20;0;20
771;Bitutė;Gandriukų;98029500731;Taip;3;2;0;5
772;Bitutė;Gandriukų;74038944722;Taip;0;2;0;2
773;Bitutė;Gandriukų;2775304620;Ne;0;6;0;6
774;Bitutė;Gandriukų;1956718350;Taip;0;4;0;4
775;Bitutė;Gandriukų;80788107109;Taip;0;5;0;5
776;Bitutė;Gandriukų;22504941477;Taip;0;1;0;1
777;Bitutė;Gandriukų;26573486858;Taip;0;1;0;1
778;Bitutė;Gandriukų;8754340459;Taip;0;3;0;3
779;Bitutė;Pelėdžiukai;8912459968;Taip;0;1;1;2
780;Bitutė;Pelėdžiukai;1590580158;Taip;0;5;0;5
781;Bitutė;Pelėdžiukai;1064809221;Taip;0;1;0;1
782;Bitutė;Pelėdžiukai;1354608761;Taip;0;10;0;10
783;Bitutė;Pelėdžiukai;87960363246;Taip;0;2;0;2
784;Bitutė;Pelėdžiukai;61233878620;Taip;0;10;0;10
785;Bitutė;Pelėdžiukai;26206836171;Taip;0;5;1;6
786;Bitutė;Pelėdžiukai;1130379531;Taip;0;8;0;8
787;Bitutė;Pelėdžiukai;1307910515;Taip;18;5;0;23
788;Bitutė;Pelėdžiukai;2126118124;Taip;0;0;2;2
789;Bitutė;Pelėdžiukai;38436660859;Taip;0;0;3;3
790;Bitutė;Pelėdžiukai;95252521365;Taip;0;10;0;10
791;Bitutė;Pelėdžiukai;1521753712;Taip;0;3;1;4
792;Bitutė;Pelėdžiukai;37364063140;Taip;0;5;3;8
793;Bitutė;Pelėdžiukai;1913421864;Taip;0;14;0;14
794;Bitutė;Pelėdžiukai;6969112590;Taip;0;5;0;5
795;Bitutė;Pelėdžiukai;12719290707;Taip;0;0;3;3
796;Bitutė;Pelėdžiukai;1082091910;Taip;0;2;0;2
797;Bitutė;Boružėlių;6586888742;Taip;0;6;2;8
798;Bitutė;Boružėlių;5783154071;Taip;0;7;0;7
799;Bitutė;Boružėlių;6052204491;Taip;0;4;3;7
800;Bitutė;Boružėlių;37105491775;Taip;4;7;2;13
801;Bitutė;Boružėlių;9683582019;Taip;7;1;1;9
802;Bitutė;Boružėlių;7352524951;Taip;0;1;0;1
803;Bitutė;Boružėlių;27144303911;Taip;0;6;6;12
804;Bitutė;Boružėlių;1802887869;Taip;0;6;0;6
805;Bitutė;Boružėlių;51054491845;Taip;0;3;0;3
806;Bitutė;Boružėlių;5653055907;Taip;0;6;4;10
807;Bitutė;Boružėlių;1809034174;Taip;0;6;3;9
808;Bitutė;Boružėlių;2350260809;Taip;0;1;6;7
809;Bitutė;Boružėlių;1307749129;Taip;0;8;0;8
810;Bitutė;Boružėlių;3980455738;Taip;0;2;1;3
811;Bitutė;Boružėlių;6678928989;Ne;0;6;0;6
812;Bitutė;Boružėlių;1942685472;Taip;0;9;1;10
813;Bitutė;Boružėlių;11567978993;Taip;0;7;0;7
814;Bitutė;Boružėlių;8519978626;Taip;0;2;8;10
815;Bitutė;Boružėlių;6659750060;Taip;0;6;0;6
816;Bitutė;Boružėlių;7387822939;Taip;0;0;7;7
817;Bitutė;Boružėlių;90943054285;Taip;0;12;0;12
818;Bitutė;Šokliukų;8211710975;Ne;1;12;3;16
819;Bitutė;Šokliukų;8872286273;Taip;10;3;0;13
820;Bitutė;Šokliukų;5169768042;Taip;8;7;0;15
821;Bitutė;Šokliukų;4917599786;Taip;5;1;0;6
822;Bitutė;Šokliukų;1348548294;Taip;10;8;0;18
823;Bitutė;Šokliukų;9855080887;Taip;0;3;1;4
824;Bitutė;Šokliukų;7318555933;Taip;0;7;2;9
825;Bitutė;Šokliukų;1012702386;Taip;0;2;0;2
826;Bitutė;Šokliukų;9924340801;Taip;5;17;0;22
827;Bitutė;Šokliukų;7165511381;Taip;0;13;1;14
828;Bitutė;Šokliukų;9465186207;Taip;0;13;0;13
829;Bitutė;Šokliukų;2853616585;Taip;5;10;2;17
830;Bitutė;Šokliukų;5109258680;Taip;0;1;0;1
831;Bitutė;Šokliukų;8439759353;Taip;4;5;0;9
832;Bitutė;Šokliukų;3417576747;Taip;0;15;0;15
833;Bitutė;Šokliukų;8422448947;Taip;7;5;0;12
834;Bitutė;Šokliukų;7926482326;Taip;0;7;2;9
835;Bitutė;Šokliukų;5876700984;Taip;0;6;0;6
836;Bitutė;Šokliukų;5759407291;Taip;8;1;0;9
837;Bitutė;Šokliukų;4471813998;Taip;6;3;0;9
838;Bitutė;Šokliukų;4468366941;Taip;0;6;1;7
839;Bitutė;Drugelių;57770829048;Taip;0;7;0;7
840;Bitutė;Drugelių;2531472741;Taip;0;3;0;3
841;Bitutė;Drugelių;55812244900;Taip;0;3;0;3
842;Bitutė;Drugelių;74525712637;Taip;5;0;0;5
843;Bitutė;Drugelių;56620848568;Taip;0;1;0;1
844;Bitutė;Drugelių;2049938111;Taip;4;4;0;8
845;Bitutė;Drugelių;58668298206;Taip;0;7;0;7
846;Bitutė;Drugelių;1863634233;Taip;0;4;0;4
847;Bitutė;Drugelių;9550491607;Taip;0;5;0;5
848;Bitutė;Drugelių;3982159333;Taip;15;4;0;19
849;Bitutė;Drugelių;27461264704;Taip;2;3;0;5
850;Bitutė;Drugelių;29300327608;Taip;8;5;0;13
851;Bitutė;Drugelių;50605497381;Taip;0;4;0;4
852;Bitutė;Drugelių;1030677273;Taip;0;1;0;1
853;Bitutė;Drugelių;92700808654;Ne;0;1;1;2
854;Bitutė;Drugelių;3319657847;Taip;4;7;0;11
855;Bitutė;Drugelių;1861373542;Taip;0;1;0;1
856;Bitutė;Drugelių;48695762145;Taip;0;1;0;1
857;Bitutė;Drugelių;7236048627;Ne;0;4;0;4
858;Bitutė;Kiškučių;9451529077;Taip;19;10;1;30
859;Bitutė;Kiškučių;1907876695;Taip;0;4;0;4
860;Bitutė;Kiškučių;7720798466;Taip;0;4;0;4
861;Bitutė;Kiškučių;1662815358;Taip;0;4;0;4
862;Bitutė;Kiškučių;1733189730;Taip;0;15;3;18
863;Bitutė;Kiškučių;3227252972;Ne;0;4;0;4
864;Bitutė;Kiškučių;8373296210;Taip;4;0;0;4
865;Bitutė;Kiškučių;1985958540;Taip;0;14;0;14
866;Bitutė;Kiškučių;8743960488;Taip;0;1;1;2
867;Bitutė;Kiškučių;9337144831;Taip;8;0;0;8
868;Bitutė;Kiškučių;1024337077;Taip;0;28;0;28
869;Bitutė;Kiškučių;4566919587;Taip;12;5;0;17
870;Bitutė;Kiškučių;2806899030;Taip;0;5;0;5
871;Bitutė;Kiškučių;5443722813;Taip;0;16;0;16
872;Bitutė;Kiškučių;1241863345;Taip;0;7;1;8
873;Bitutė;Kiškučių;8789574593;Taip;0;0;4;4
874;Bitutė;Kiškučių;8799003374;Taip;1;11;0;12
875;Bitutė;Kiškučių;4639968278;Taip;0;32;0;32
876;Bitutė;Kiškučių;4845620063;Taip;0;6;12;18
877;Bitutė;Kiškučių;9217178863;Taip;0;2;0;2
878;Bitutė;"Viščiukų ";5606049201;Taip;9;23;0;32
879;Bitutė;"Viščiukų ";9521938997;Taip;3;3;0;6
880;Bitutė;"Viščiukų ";2623999429;Taip;0;18;0;18
881;Bitutė;"Viščiukų ";1218462939;Taip;0;3;0;3
882;Bitutė;"Viščiukų ";2144809294;Taip;0;32;0;32
883;Bitutė;"Viščiukų ";5081300818;Taip;3;6;0;9
884;Bitutė;"Viščiukų ";6035394425;Taip;4;3;0;7
885;Bitutė;"Viščiukų ";5471241132;Taip;5;7;3;15
886;Bitutė;"Viščiukų ";7095475821;Taip;4;1;0;5
887;Bitutė;"Viščiukų ";7132616264;Taip;0;18;0;18
888;Bitutė;"Viščiukų ";6455582149;Taip;7;1;0;8
889;Bitutė;"Viščiukų ";4884898917;Taip;0;5;0;5
890;Bitutė;"Viščiukų ";4869423833;Taip;0;5;0;5
891;Bitutė;"Viščiukų ";6030674568;Taip;8;6;1;15
892;Bitutė;"Viščiukų ";6840722112;Taip;12;1;2;15
893;Bitutė;"Viščiukų ";8796728627;Taip;0;5;0;5
894;Bitutė;"Viščiukų ";9668365838;Taip;17;4;0;21
895;Bitutė;"Skruzdėliukai ";7977651492;Ne;6;0;0;6
896;Bitutė;"Skruzdėliukai ";1423694056;Taip;0;1;1;2
897;Bitutė;"Skruzdėliukai ";6311396261;Taip;2;1;1;4
898;Bitutė;"Skruzdėliukai ";5188828679;Taip;0;3;0;3
899;Bitutė;"Skruzdėliukai ";8109028957;Taip;0;3;0;3
900;Bitutė;"Skruzdėliukai ";2252157473;Taip;0;4;0;4
901;Bitutė;"Skruzdėliukai ";6169426273;Taip;10;0;0;10
902;Bitutė;"Skruzdėliukai ";4513783927;Taip;3;2;1;6
903;Bitutė;"Skruzdėliukai ";8667259778;Taip;22;6;0;28
904;Bitutė;"Skruzdėliukai ";8607718704;Taip;0;3;1;4
905;Bitutė;"Skruzdėliukai ";4413880918;Taip;7;5;6;18
906;Bitutė;"Skruzdėliukai ";9436414962;Taip;5;5;0;10
907;Bitutė;"Skruzdėliukai ";9864771568;Taip;0;5;0;5
908;Bitutė;"Skruzdėliukai ";6353690252;Taip;15;6;0;21
909;Bitutė;"Skruzdėliukai ";2160735504;Taip;7;1;1;9
910;Bitutė;"Skruzdėliukai ";3156654672;Taip;5;6;10;21
911;Bitutė;"Skruzdėliukai ";1387310054;Taip;3;13;0;16
912;Bitutė;"Skruzdėliukai ";7245807233;Taip;12;1;1;14
913;Bitutė;"Skruzdėliukai ";4467090141;Taip;0;3;0;3
914;Bitutė;"Skruzdėliukai ";5433617195;Taip;0;11;0;11
915;Bitutė;"Nykštukų ";5146691157;Taip;4;0;0;4
916;Bitutė;"Nykštukų ";8962725357;Taip;10;0;0;10
917;Bitutė;"Nykštukų ";5759595005;Taip;15;6;0;21
918;Bitutė;"Nykštukų ";6325890676;Taip;8;4;4;16
919;Bitutė;"Nykštukų ";1558826102;Taip;10;2;1;13
920;Bitutė;"Nykštukų ";2029309955;Taip;7;7;0;14
921;Bitutė;"Nykštukų ";2085899696;Taip;4;4;0;8
922;Bitutė;"Nykštukų ";7376746010;Taip;4;8;0;12
923;Bitutė;"Nykštukų ";5845408472;Taip;4;7;3;14
924;Bitutė;"Nykštukų ";3611348253;Taip;0;1;1;2
925;Bitutė;"Nykštukų ";8727525320;Taip;0;1;1;2
926;Bitutė;"Nykštukų ";5796600501;Taip;0;3;1;4
927;Bitutė;"Nykštukų ";2748400429;Taip;0;6;0;6
928;Bitutė;"Nykštukų ";9094567866;Taip;0;0;2;2
929;Bitutė;"Nykštukų ";5278510767;Taip;0;6;0;6
930;Coliukė;DRUGELIAI;6725408547;Ne;1;0;0;1
931;Coliukė;DRUGELIAI;2167230398;Taip;10;0;0;10
932;Coliukė;DRUGELIAI;2275327607;Taip;0;1;1;2
933;Coliukė;DRUGELIAI;4845247006;Taip;4;0;0;4
934;Coliukė;DRUGELIAI;5349969025;Ne;3;0;0;3
935;Coliukė;DRUGELIAI;9334564869;Taip;22;0;0;22
936;Coliukė;DRUGELIAI;3719547522;Taip;3;0;0;3
937;Coliukė;DRUGELIAI;8715608220;Taip;5;1;0;6
938;Coliukė;DRUGELIAI;5018335921;Taip;10;0;0;10
939;Coliukė;DRUGELIAI;2469993058;Taip;4;3;0;7
940;Coliukė;DRUGELIAI;7216221020;Ne;0;3;0;3
941;Coliukė;DRUGELIAI;7358018315;Taip;3;0;2;5
942;Coliukė;DRUGELIAI;4140716483;Ne;3;0;0;3
943;Coliukė;DRUGELIAI;9688432169;Ne;3;0;0;3
944;Coliukė;BITUTĖS;82989338835;Ne;0;8;0;8
945;Coliukė;BITUTĖS;1960898805;Taip;0;6;0;6
946;Coliukė;BITUTĖS;58421006265;Taip;0;4;0;4
947;Coliukė;BITUTĖS;8457120425;Taip;1;0;0;1
948;Coliukė;BITUTĖS;81003830638;Taip;0;3;0;3
949;Coliukė;BITUTĖS;7920728387;Ne;0;9;0;9
950;Coliukė;BITUTĖS;1240946719;Taip;0;8;0;8
951;Coliukė;BITUTĖS;3346269598;Taip;0;2;0;2
952;Coliukė;BITUTĖS;6860757091;Taip;0;9;0;9
953;Coliukė;BITUTĖS;1458763954;Taip;0;1;0;1
954;Coliukė;BITUTĖS;1968467455;Taip;8;0;0;8
955;Coliukė;BITUTĖS;1328505569;Ne;0;2;0;2
956;Coliukė;BITUTĖS;6011110970;Ne;3;1;0;4
957;Coliukė;BITUTĖS;8767261039;Ne;4;0;0;4
958;Coliukė;BITUTĖS;9885547263;Taip;0;0;2;2
959;Coliukė;BITUTĖS;9331485675;Taip;0;10;0;10
960;Coliukė;VABALIUKAI;62876576078;Taip;0;6;0;6
961;Coliukė;VABALIUKAI;33587152454;Taip;0;1;0;1
962;Coliukė;VABALIUKAI;63258983714;Taip;0;3;0;3
963;Coliukė;VABALIUKAI;1476750428;Taip;12;1;0;13
964;Coliukė;VABALIUKAI;5596775091;Taip;5;1;0;6
965;Coliukė;VABALIUKAI;6333099356;Taip;0;10;0;10
966;Coliukė;VABALIUKAI;9526108197;Ne;10;1;0;11
967;Coliukė;VABALIUKAI;2363472917;Taip;0;1;1;2
968;Coliukė;VABALIUKAI;4739310916;Taip;2;2;0;4
969;Coliukė;VABALIUKAI;5541328815;Ne;15;0;0;15
970;Coliukė;VABALIUKAI;4010374947;Taip;16;0;0;16
971;Coliukė;VABALIUKAI;7622526793;Taip;0;1;0;1
972;Coliukė;VABALIUKAI;4626722910;Taip;22;0;0;22
973;Coliukė;VABALIUKAI;6475497234;Taip;5;1;0;6
974;Coliukė;VABALIUKAI;4493314926;Taip;3;1;0;4
975;Coliukė;VABALIUKAI;3905904092;Taip;13;0;0;13
976;Coliukė;VABALIUKAI;8521846076;Taip;0;8;0;8
977;Coliukė;VABALIUKAI;1105879142;Taip;13;0;1;14
978;Coliukė;VABALIUKAI;9879369365;Taip;4;3;0;7
979;Coliukė;VABALIUKAI;5108993131;Taip;11;1;0;12
980;Coliukė;VABALIUKAI;9083546061;Taip;12;1;0;13
981;Coliukė;NYKŠTUKAI;2168987649;Taip;4;0;0;4
982;Coliukė;NYKŠTUKAI;4499924331;Taip;3;0;0;3
983;Coliukė;NYKŠTUKAI;7670166244;Taip;0;5;0;5
984;Coliukė;NYKŠTUKAI;4845049639;Taip;4;0;0;4
985;Coliukė;NYKŠTUKAI;1537341012;Taip;1;4;0;5
986;Coliukė;NYKŠTUKAI;6403149921;Taip;0;3;0;3
987;Coliukė;NYKŠTUKAI;1600495468;Taip;0;6;0;6
988;Coliukė;NYKŠTUKAI;6781303455;Taip;0;10;0;10
989;Coliukė;NYKŠTUKAI;7502911642;Taip;0;17;0;17
990;Coliukė;NYKŠTUKAI;7993975989;Ne;0;4;0;4
991;Coliukė;NYKŠTUKAI;7870865302;Ne;9;1;1;11
992;Coliukė;NYKŠTUKAI;1263306271;Ne;8;10;0;18
993;Coliukė;NYKŠTUKAI;6984254334;Taip;0;1;2;3
994;Coliukė;NYKŠTUKAI;5450167562;Taip;0;1;0;1
995;Coliukė;GĖLYTĖS;1390751418;Ne;8;0;0;8
996;Coliukė;GĖLYTĖS;4881447596;Ne;7;0;1;8
997;Coliukė;GĖLYTĖS;9750447455;Ne;3;11;0;14
998;Coliukė;GĖLYTĖS;2385917598;Ne;1;0;3;4
999;Coliukė;GĖLYTĖS;3628571567;Taip;0;2;0;2
1000;Coliukė;GĖLYTĖS;8478006305;Ne;0;1;5;6
1001;Coliukė;GĖLYTĖS;1220834062;Ne;0;3;0;3
1002;Coliukė;GĖLYTĖS;6781663126;Taip;13;1;1;15
1003;Coliukė;GĖLYTĖS;9107676840;Taip;0;1;0;1
1004;Coliukė;GĖLYTĖS;8601059431;Ne;15;0;0;15
1005;Coliukė;GĖLYTĖS;7621095517;Ne;0;0;1;1
1006;Coliukė;GĖLYTĖS;7345905007;Taip;4;0;0;4
1007;Coliukė;"BORUŽĖLĖS (SPEC.)";2080118127;Taip;0;7;0;7
1008;Coliukė;"BORUŽĖLĖS (SPEC.)";2617816991;Taip;0;3;0;3
1009;Coliukė;"BORUŽĖLĖS (SPEC.)";1233731506;Taip;0;11;0;11
1010;Coliukė;"BORUŽĖLĖS (SPEC.)";1644303265;Taip;3;0;6;9
1011;Coliukė;"BORUŽĖLĖS (SPEC.)";5706671963;Taip;0;10;0;10
1012;Coliukė;"BORUŽĖLĖS (SPEC.)";4961762841;Taip;7;0;0;7
1013;Coliukė;"BORUŽĖLĖS (SPEC.)";7826554599;Taip;6;0;2;8
1014;Coliukė;"BORUŽĖLĖS (SPEC.)";6920961967;Taip;0;4;0;4
1015;Coliukė;"BORUŽĖLĖS (SPEC.)";1134875499;Taip;9;0;2;11
1016;Coliukė;"BORUŽĖLĖS (SPEC.)";2351866339;Taip;19;0;3;22
1017;Coliukė;"BORUŽĖLĖS (SPEC.)";21764273722;Taip;0;4;0;4
1018;Coliukė;"BORUŽĖLĖS (SPEC.)";5756690199;Taip;14;3;0;17
1019;Coliukė;"BORUŽĖLĖS (SPEC.)";6972921877;Taip;0;1;0;1
1020;Coliukė;"BORUŽĖLĖS (SPEC.)";2947495861;Ne;8;0;3;11
1021;Čiauškutis;BITUTĖS;7893181156;Taip;0;8;0;8
1022;Čiauškutis;BITUTĖS;7976738303;Ne;21;0;0;21
1023;Čiauškutis;BITUTĖS;4026881335;Taip;0;0;1;1
1024;Čiauškutis;BITUTĖS;9753680961;Taip;0;0;5;5
1025;Čiauškutis;BITUTĖS;4652951382;Ne;8;9;4;21
1026;Čiauškutis;BITUTĖS;3837360101;Taip;3;0;0;3
1027;Čiauškutis;BITUTĖS;2319237497;Taip;5;0;1;6
1028;Čiauškutis;BITUTĖS;1765857419;Taip;22;0;0;22
1029;Čiauškutis;ŽVIRBLIUKAI;4037117222;Taip;8;0;0;8
1030;Čiauškutis;ŽVIRBLIUKAI;2633243682;Taip;0;6;0;6
1031;Čiauškutis;ŽVIRBLIUKAI;7009893338;Taip;2;0;1;3
1032;Čiauškutis;ŽVIRBLIUKAI;7654242839;Taip;1;0;0;1
1033;Čiauškutis;ŽVIRBLIUKAI;5957587644;Taip;5;0;4;9
1034;Čiauškutis;ŽVIRBLIUKAI;1733251156;Taip;3;0;0;3
1035;Čiauškutis;ŽVIRBLIUKAI;5575614158;Taip;10;0;5;15
1036;Čiauškutis;SAULUTĖS;22717947028;Taip;0;22;0;22
1037;Čiauškutis;SAULUTĖS;2099735647;Taip;0;0;1;1
1038;Čiauškutis;SAULUTĖS;72264057427;Taip;0;0;5;5
1039;Čiauškutis;SAULUTĖS;1849532875;Taip;0;0;3;3
1040;Čiauškutis;SAULUTĖS;1621605644;Taip;3;0;0;3
1041;Čiauškutis;SAULUTĖS;4917339896;Taip;0;1;0;1
1042;Čiauškutis;SAULUTĖS;2030362509;Taip;0;6;0;6
1043;Čiauškutis;EŽIUKAI;7746580858;Taip;0;0;1;1
1044;Čiauškutis;EŽIUKAI;1928404791;Taip;6;0;0;6
1045;Čiauškutis;EŽIUKAI;7489733038;Taip;0;1;1;2
1046;Čiauškutis;EŽIUKAI;5404165993;Taip;4;0;0;4
1047;Čiauškutis;EŽIUKAI;1158816422;Taip;0;1;0;1
1048;Čiauškutis;EŽIUKAI;7239878097;Taip;0;1;0;1
1049;Čiauškutis;EŽIUKAI;5910818962;Ne;8;0;2;10
1050;Čiauškutis;EŽIUKAI;1234494170;Taip;1;0;0;1
1051;Čiauškutis;DRUGELIAI;7080320173;Taip;2;0;0;2
1052;Čiauškutis;DRUGELIAI;7312776041;Ne;1;0;0;1
1053;Čiauškutis;DRUGELIAI;9072764004;Ne;1;0;2;3
1054;Čiauškutis;DRUGELIAI;1036358147;Taip;0;0;10;10
1055;Čiauškutis;DRUGELIAI;1750040659;Taip;0;1;0;1
1056;Čiauškutis;DRUGELIAI;8346845876;Taip;0;4;0;4
1057;Čiauškutis;DRUGELIAI;98579606504;Taip;0;1;0;1
1058;Čiauškutis;DRUGELIAI;3724324861;Taip;4;18;0;22
1059;Čiauškutis;DRUGELIAI;2237570705;Taip;0;1;0;1
1060;Čiauškutis;DRUGELIAI;7027181377;Taip;5;14;3;22
1061;Čiauškutis;GENELIAI;54635137954;Taip;0;0;2;2
1062;Čiauškutis;GENELIAI;1732370199;Ne;22;0;0;22
1063;Čiauškutis;GENELIAI;5900996969;Taip;6;0;0;6
1064;Čiauškutis;GENELIAI;1804509009;Taip;0;1;0;1
1065;Čiauškutis;GENELIAI;3370047940;Taip;2;1;3;6
1066;Čiauškutis;GENELIAI;9208388159;Ne;5;0;1;6
1067;Čiauškutis;GENELIAI;31203540590;Taip;0;19;3;22
1068;Čiauškutis;GENELIAI;1422589887;Taip;0;0;3;3
1069;Čiauškutis;GENELIAI;8709039752;Taip;8;0;3;11
1070;Čiauškutis;GENELIAI;46847640903;Taip;0;0;10;10
1071;Čiauškutis;LINKSMUČIAI;3499391608;Taip;0;22;0;22
1072;Čiauškutis;LINKSMUČIAI;30480486366;Taip;0;0;2;2
1073;Čiauškutis;LINKSMUČIAI;1443155220;Taip;0;0;2;2
1074;Čiauškutis;LINKSMUČIAI;8808041204;Taip;1;0;0;1
1075;Čiauškutis;LINKSMUČIAI;95770489933;Taip;0;0;5;5
1076;Čiauškutis;LINKSMUČIAI;7060197354;Ne;0;0;5;5
1077;Čiauškutis;LINKSMUČIAI;63077673322;Taip;0;0;3;3
1078;Čiauškutis;LINKSMUČIAI;1480363762;Taip;0;0;4;4
1079;Čiauškutis;KIŠKUČIAI;2218793969;Taip;0;1;0;1
1080;Čiauškutis;KIŠKUČIAI;6115354862;Taip;6;1;8;15
1081;Čiauškutis;KIŠKUČIAI;5759367884;Taip;0;1;0;1
1082;Čiauškutis;KIŠKUČIAI;1456067541;Taip;1;1;1;3
1083;Čiauškutis;KIŠKUČIAI;7367933940;Taip;0;1;2;3
1084;Čiauškutis;KIŠKUČIAI;7440425102;Ne;3;1;0;4
1085;Čiauškutis;KIŠKUČIAI;76449285846;Taip;0;1;1;2
1086;Čiauškutis;KIŠKUČIAI;4658994599;Taip;8;0;0;8
1087;Čiauškutis;LAPIUKAI;60265156684;Taip;0;1;5;6
1088;Čiauškutis;LAPIUKAI;1657452686;Taip;6;1;2;9
1089;Čiauškutis;LAPIUKAI;43313173294;Taip;5;17;0;22
1090;Čiauškutis;LAPIUKAI;1739403100;Taip;0;22;0;22
1091;Čiauškutis;LAPIUKAI;5052137859;Taip;1;15;6;22
1092;Čiauškutis;LAPIUKAI;9897499968;Taip;6;16;0;22
1093;Čiauškutis;MEŠKUČIAI;7630342576;Taip;3;0;1;4
1094;Čiauškutis;MEŠKUČIAI;7135435979;Ne;0;0;2;2
1095;Čiauškutis;MEŠKUČIAI;7274368180;Taip;0;0;4;4
1096;Čiauškutis;MEŠKUČIAI;6146321785;Taip;0;16;6;22
1097;Čiauškutis;MEŠKUČIAI;6434727608;Taip;10;11;1;22
1098;Čiauškutis;MEŠKUČIAI;7526975680;Taip;7;0;0;7
1099;Čiauškutis;MEŠKUČIAI;2172687454;Taip;7;0;0;7
1100;Čiauškutis;MEŠKUČIAI;1313716840;Taip;0;0;1;1
1101;Čiauškutis;PELĖDŽIUKAI;1561833758;Taip;2;0;0;2
1102;Čiauškutis;PELĖDŽIUKAI;3833382641;Taip;5;0;2;7
1103;Čiauškutis;PELĖDŽIUKAI;6615319751;Taip;18;0;0;18
1104;Čiauškutis;PELĖDŽIUKAI;2377986721;Ne;8;0;0;8
1105;Čiauškutis;PELĖDŽIUKAI;8111541739;Taip;11;0;0;11
1106;Čiauškutis;NYKŠTUKAI;1809511815;Taip;0;1;0;1
1107;Čiauškutis;NYKŠTUKAI;1533938659;Taip;0;4;0;4
1108;Čiauškutis;NYKŠTUKAI;9052859205;Taip;0;2;0;2
1109;Čiauškutis;NYKŠTUKAI;3353905368;Taip;0;5;0;5
1110;Čiauškutis;NYKŠTUKAI;8689127061;Taip;0;16;0;16
1111;Čiauškutis;NYKŠTUKAI;9062135043;Taip;18;0;0;18
1112;Čiauškutis;NYKŠTUKAI;1306672095;Taip;0;11;0;11
1113;Čiauškutis;NYKŠTUKAI;1224986101;Taip;2;14;0;16
1114;Delfinukas;Boružėlių;8411289299;Taip;0;2;0;2
1115;Delfinukas;Boružėlių;9184207705;Taip;0;2;9;11
1116;Delfinukas;Boružėlių;7780893730;Taip;8;1;0;9
1117;Delfinukas;Boružėlių;6938708939;Taip;0;2;3;5
1118;Delfinukas;Boružėlių;6604115681;Taip;10;1;0;11
1119;Delfinukas;Boružėlių;2730512600;Taip;0;2;3;5
1120;Delfinukas;Boružėlių;8884939114;Taip;0;5;0;5
1121;Delfinukas;Boružėlių;1119373532;Taip;14;0;0;14
1122;Delfinukas;Boružėlių;4488260667;Taip;0;2;0;2
1123;Delfinukas;Boružėlių;6325092903;Taip;2;1;0;3
1124;Delfinukas;Boružėlių;5990192934;Taip;8;1;0;9
1125;Delfinukas;Boružėlių;7737665102;Taip;8;0;0;8
1126;Delfinukas;Boružėlių;7615519932;Taip;0;1;0;1
1127;Delfinukas;Saulytės;8315269427;Taip;11;0;1;12
1128;Delfinukas;Saulytės;4215887291;Taip;0;2;3;5
1129;Delfinukas;Saulytės;3631520143;Taip;0;0;9;9
1130;Delfinukas;Saulytės;9424966984;Taip;0;0;9;9
1131;Delfinukas;Saulytės;6069600728;Taip;3;0;1;4
1132;Delfinukas;Saulytės;9729550922;Taip;0;7;0;7
1133;Delfinukas;Saulytės;1404270345;Taip;0;0;4;4
1134;Delfinukas;Saulytės;3842160990;Taip;0;1;0;1
1135;Delfinukas;Saulytės;8402529296;Taip;4;0;0;4
1136;Delfinukas;Saulytės;5642328792;Taip;6;0;0;6
1137;Delfinukas;Saulytės;8176576958;Taip;22;0;0;22
1138;Delfinukas;Saulytės;8275943176;Taip;0;0;1;1
1139;Delfinukas;Saulytės;8085530134;Taip;10;6;0;16
1140;Delfinukas;Saulytės;8148610460;Taip;0;1;0;1
1141;Delfinukas;Saulytės;6935992202;Taip;12;0;0;12
1142;Delfinukas;Saulytės;8186312409;Taip;8;0;0;8
1143;Delfinukas;Saulytės;7904803011;Taip;5;0;0;5
1144;Delfinukas;Saulytės;5665463557;Taip;22;0;0;22
1145;Delfinukas;Saulytės;7224966634;Taip;15;0;0;15
1146;Delfinukas;Pelėdžiukų;3940838205;Taip;6;2;0;8
1147;Delfinukas;Pelėdžiukų;8774145277;Taip;0;13;0;13
1148;Delfinukas;Pelėdžiukų;3770227955;Taip;6;0;0;6
1149;Delfinukas;Pelėdžiukų;6113662246;Taip;4;6;0;10
1150;Delfinukas;Pelėdžiukų;4710894128;Taip;3;0;0;3
1151;Delfinukas;Pelėdžiukų;1526129772;Taip;0;0;4;4
1152;Delfinukas;Pelėdžiukų;8659309242;Taip;6;2;0;8
1153;Delfinukas;Pelėdžiukų;8267992425;Taip;0;2;2;4
1154;Delfinukas;Pelėdžiukų;9319874239;Taip;0;2;0;2
1155;Delfinukas;Pelėdžiukų;2809947323;Ne;0;4;0;4
1156;Delfinukas;Pelėdžiukų;3465186420;Taip;0;0;10;10
1157;Delfinukas;Pelėdžiukų;4096274346;Taip;15;0;0;15
1158;Delfinukas;Pelėdžiukų;5246300518;Taip;2;7;0;9
1159;Delfinukas;Pelėdžiukų;2420308954;Taip;8;0;0;8
1160;Delfinukas;Pelėdžiukų;6286748047;Taip;0;9;0;9
1161;Delfinukas;Pelėdžiukų;8432654056;Taip;6;2;0;8
1162;Delfinukas;Pelėdžiukų;1918878505;Taip;0;1;0;1
1163;Delfinukas;Pelėdžiukų;3795705735;Taip;4;13;0;17
1164;Delfinukas;Pelėdžiukų;1575125658;Taip;11;1;0;12
1165;Delfinukas;Pelėdžiukų;4384995354;Taip;0;3;1;4
1166;Delfinukas;Varliukų;9266646602;Ne;3;0;0;3
1167;Delfinukas;Varliukų;9516852657;Taip;0;2;0;2
1168;Delfinukas;Varpelių;8913681176;Taip;0;2;0;2
1169;Delfinukas;Varpelių;9514189769;Taip;0;1;0;1
1170;Delfinukas;Varpelių;4713803167;Taip;4;3;0;7
1171;Delfinukas;Varpelių;8936645508;Taip;0;16;0;16
1172;Delfinukas;Varpelių;6047881184;Taip;7;0;1;8
1173;Delfinukas;Varpelių;3818558339;Taip;3;0;0;3
1174;Delfinukas;Varpelių;4877757730;Taip;0;0;1;1
1175;Delfinukas;Varpelių;7973858761;Taip;6;0;1;7
1176;Delfinukas;Varpelių;3562066765;Taip;8;1;0;9
1177;Delfinukas;Drugeliai;6561536457;Taip;0;0;1;1
1178;Delfinukas;Drugeliai;1672021829;Ne;3;0;0;3
1179;Delfinukas;Drugeliai;9921730735;Taip;3;0;0;3
1180;Delfinukas;Drugeliai;1160537966;Taip;7;0;0;7
1181;Delfinukas;Žuvytės;6572690788;Taip;0;3;0;3
1182;Delfinukas;Žuvytės;3397350274;Taip;4;1;1;6
1183;Delfinukas;Žuvytės;9520598359;Taip;0;2;0;2
1184;Delfinukas;Žuvytės;3804996594;Taip;3;5;0;8
1185;Delfinukas;Žuvytės;1136182876;Ne;0;5;0;5
1186;Delfinukas;Žuvytės;7873373923;Taip;3;0;0;3
1187;Delfinukas;Žuvytės;2066127119;Taip;4;3;0;7
1188;Delfinukas;Žuvytės;7487111570;Taip;0;6;0;6
1189;Delfinukas;Žuvytės;6844500395;Taip;0;2;0;2
1190;Delfinukas;Žuvytės;9074294473;Taip;0;0;17;17
1191;Delfinukas;Žuvytės;8160982025;Taip;0;0;1;1
1192;Delfinukas;Žuvytės;6949000708;Taip;4;0;0;4
1193;Delfinukas;Žuvytės;6322255194;Taip;5;0;0;5
1194;Delfinukas;Žuvytės;9898412288;Taip;0;2;1;3
1195;Delfinukas;Žuvytės;8702718951;Taip;3;0;0;3
1196;Delfinukas;Žuvytės;6445868759;Taip;2;2;1;5
1197;Delfinukas;Delfinai;9628317328;Taip;1;0;0;1
1198;Delfinukas;Delfinai;8038737019;Taip;4;0;0;4
1199;Delfinukas;Delfinai;5241426445;Taip;3;2;1;6
1200;Delfinukas;Delfinai;3108430680;Taip;0;6;0;6
1201;Delfinukas;Delfinai;7663934825;Taip;0;2;0;2
1202;Delfinukas;Delfinai;2382077576;Taip;0;2;1;3
1203;Delfinukas;Delfinai;1200205376;Taip;0;2;1;3
1204;Delfinukas;Delfinai;7629622746;Taip;0;2;3;5
1205;Delfinukas;Delfinai;4347116918;Taip;0;22;0;22
1206;Delfinukas;Delfinai;6270012707;Taip;22;0;0;22
1207;Delfinukas;Delfinai;3407321091;Taip;0;2;0;2
1208;Delfinukas;Delfinai;7354837777;Taip;17;0;0;17
1209;Delfinukas;Delfinai;9903010418;Taip;0;3;0;3
1210;Delfinukas;Paukšteliai;7609115506;Taip;6;2;0;8
1211;Delfinukas;Paukšteliai;6873181103;Taip;3;6;0;9
1212;Delfinukas;Paukšteliai;2756574162;Taip;0;1;0;1
1213;Delfinukas;Paukšteliai;5060445169;Taip;0;2;0;2
1214;Delfinukas;Paukšteliai;6992505341;Taip;0;1;0;1
1215;Delfinukas;Paukšteliai;9927854348;Taip;11;0;0;11
1216;Delfinukas;Paukšteliai;8028279246;Taip;17;0;1;18
1217;Delfinukas;Paukšteliai;2985669766;Taip;17;0;0;17
1218;Delfinukas;Paukšteliai;8328481987;Taip;9;0;0;9
1219;Delfinukas;Paukšteliai;9635669748;Taip;13;0;0;13
1220;Delfinukas;Paukšteliai;8526813977;Taip;13;0;0;13
1221;Delfinukas;Paukšteliai;6457042338;Taip;6;3;1;10
1222;Delfinukas;Paukšteliai;3134897964;Taip;0;1;0;1
1223;Delfinukas;Paukšteliai;3796051179;Taip;22;0;0;22
1224;Delfinukas;Paukšteliai;4484804360;Taip;0;2;3;5
1225;Delfinukas;Kiškučiai;2094258481;Taip;0;1;0;1
1226;Delfinukas;Kiškučiai;9602317911;Taip;0;2;0;2
1227;Delfinukas;Kiškučiai;8625023976;Taip;0;4;0;4
1228;Delfinukas;Kiškučiai;3284212595;Taip;0;3;0;3
1229;Delfinukas;Kiškučiai;8076961367;Taip;0;2;0;2
1230;Delfinukas;Kiškučiai;8439204095;Taip;0;4;0;4
1231;Delfinukas;Kiškučiai;5783537897;Taip;0;5;0;5
1232;Delfinukas;Kiškučiai;1153948822;Taip;0;2;3;5
1233;Delfinukas;Kiškučiai;2010703982;Taip;0;2;0;2
1234;Delfinukas;Kiškučiai;8728791932;Taip;0;3;2;5
1235;Delfinukas;Kiškučiai;7365398150;Ne;0;0;1;1
1236;Delfinukas;Kiškučiai;2883959240;Taip;0;1;0;1
1237;Delfinukas;Kiškučiai;4179507316;Taip;0;1;0;1
1238;Delfinukas;Kiškučiai;8440546956;Taip;0;2;0;2
1239;Delfinukas;Kiškučiai;1030958414;Taip;1;0;0;1
1240;Delfinukas;Kiškučiai;7638190553;Taip;0;2;4;6
1241;Delfinukas;Kiškučiai;6577214344;Taip;0;3;0;3
1242;Delfinukas;BITUTĖS;9719348837;Taip;2;4;1;7
1243;Delfinukas;BITUTĖS;6211076154;Taip;3;0;0;3
1244;Delfinukas;BITUTĖS;6601922746;Taip;0;5;0;5
1245;Delfinukas;BITUTĖS;8896957908;Taip;0;5;0;5
1246;Delfinukas;BITUTĖS;5339993544;Taip;0;1;0;1
1247;Delfinukas;BITUTĖS;6929926768;Taip;16;1;0;17
1248;Delfinukas;BITUTĖS;7310363229;Taip;10;0;3;13
1249;Delfinukas;BITUTĖS;5557399916;Taip;11;0;0;11
1250;Delfinukas;BITUTĖS;5179080544;Taip;2;7;0;9
1251;Delfinukas;BITUTĖS;7727263761;Taip;5;1;0;6
1252;Delfinukas;BITUTĖS;9941631164;Taip;10;1;0;11
1253;Delfinukas;BITUTĖS;4198261848;Taip;0;1;0;1
1254;Delfinukas;BITUTĖS;8081895401;Taip;5;0;0;5
1255;Delfinukas;BITUTĖS;5600320855;Taip;0;17;2;19
1256;Delfinukas;BITUTĖS;9195828884;Taip;0;0;5;5
1257;Delfinukas;BITUTĖS;8552371520;Taip;8;0;0;8
1258;Delfinukas;BITUTĖS;2377204734;Taip;9;5;0;14
1259;Delfinukas;BITUTĖS;9557606112;Taip;8;1;0;9
1260;Delfinukas;BITUTĖS;6243471374;Taip;5;2;0;7
1261;Delfinukas;BITUTĖS;2163238846;Taip;18;3;0;21
1262;Delfinukas;"NAUJA DARŽELIS";9360553910;Taip;6;4;0;10
1263;Delfinukas;"NAUJA DARŽELIS";5964021733;Taip;10;9;1;20
1264;Delfinukas;"NAUJA DARŽELIS";7976681530;Taip;0;0;1;1
1265;Delfinukas;"NAUJA DARŽELIS";4949220786;Taip;6;0;2;8
1266;Delfinukas;"NAUJA DARŽELIS";5095713834;Taip;15;0;2;17
1267;Delfinukas;"NAUJA DARŽELIS";6301601832;Taip;1;0;0;1
1268;Delfinukas;"NAUJA DARŽELIS";3050258185;Taip;13;0;1;14
1269;Delfinukas;"NAUJA DARŽELIS";6115370195;Taip;8;0;0;8
1270;Delfinukas;"NAUJA DARŽELIS";9095895182;Taip;8;3;0;11
1271;Delfinukas;"NAUJA DARŽELIS";5821591959;Taip;8;11;1;20
1272;Delfinukas;"NAUJA DARŽELIS";5138840297;Taip;0;6;0;6
1273;Drevinukas;ZUIKUČIAI;3392249574;Taip;5;0;0;5
1274;Drevinukas;ZUIKUČIAI;6582186497;Ne;0;0;2;2
1275;Drevinukas;ZUIKUČIAI;3032536983;Taip;5;0;0;5
1276;Drevinukas;ZUIKUČIAI;5524567803;Taip;0;0;1;1
1277;Drevinukas;ZUIKUČIAI;2929598743;Taip;0;9;0;9
1278;Drevinukas;ZUIKUČIAI;4076576850;Taip;0;0;19;19
1279;Drevinukas;ZUIKUČIAI;6373230526;Taip;9;4;0;13
1280;Drevinukas;ZUIKUČIAI;4312429104;Taip;0;0;3;3
1281;Drevinukas;ZUIKUČIAI;6316000019;Taip;0;0;6;6
1282;Drevinukas;ZUIKUČIAI;4404254932;Taip;0;0;4;4
1283;Drevinukas;ZUIKUČIAI;2378493422;Taip;0;0;1;1
1284;Drevinukas;ZUIKUČIAI;1859208322;Taip;8;0;0;8
1285;Drevinukas;ZUIKUČIAI;5875459639;Taip;7;4;0;11
1286;Drevinukas;ZUIKUČIAI;7218201733;Taip;0;0;4;4
1287;Drevinukas;AŽUOLIUKŲ;3617570755;Taip;0;0;17;17
1288;Drevinukas;AŽUOLIUKŲ;1720464417;Taip;13;0;4;17
1289;Drevinukas;AŽUOLIUKŲ;3981507849;Taip;0;0;1;1
1290;Drevinukas;AŽUOLIUKŲ;5679723776;Taip;0;11;0;11
1291;Drevinukas;AŽUOLIUKŲ;7753238387;Taip;0;0;1;1
1292;Drevinukas;AŽUOLIUKŲ;6833120798;Taip;0;0;4;4
1293;Drevinukas;AŽUOLIUKŲ;8479979176;Taip;1;0;0;1
1294;Drevinukas;AŽUOLIUKŲ;2531207946;Taip;1;0;0;1
1295;Drevinukas;AŽUOLIUKŲ;1099462840;Taip;0;0;7;7
1296;Drevinukas;AŽUOLIUKŲ;1152161183;Taip;0;0;10;10
1297;Drevinukas;AŽUOLIUKŲ;8611131264;Taip;0;8;0;8
1298;Drevinukas;AŽUOLIUKŲ;8936058501;Taip;5;0;3;8
1299;Drevinukas;AŽUOLIUKŲ;7607135647;Taip;0;0;3;3
1300;Drevinukas;AŽUOLIUKŲ;9772484901;Taip;1;0;4;5
1301;Drevinukas;AŽUOLIUKŲ;7520907833;Taip;0;8;0;8
1302;Drevinukas;PELĖDŽIUKAI;1123115847;Taip;0;0;6;6
1303;Drevinukas;PELĖDŽIUKAI;1987939679;Taip;0;0;9;9
1304;Drevinukas;PELĖDŽIUKAI;9336227821;Taip;0;0;1;1
1305;Drevinukas;PELĖDŽIUKAI;4784716615;Taip;2;0;0;2
1306;Drevinukas;PELĖDŽIUKAI;8661862777;Taip;0;0;3;3
1307;Drevinukas;PELĖDŽIUKAI;9803670483;Taip;0;0;5;5
1308;Drevinukas;PELĖDŽIUKAI;7519369167;Taip;6;0;6;12
1309;Drevinukas;PELĖDŽIUKAI;16952164778;Taip;0;0;2;2
1310;Drevinukas;PELĖDŽIUKAI;3657451903;Taip;6;0;1;7
1311;Drevinukas;PELĖDŽIUKAI;8180027849;Taip;2;0;2;4
1312;Drevinukas;PELĖDŽIUKAI;4332606643;Taip;14;0;1;15
1313;Drevinukas;PELĖDŽIUKAI;7632515230;Taip;0;0;5;5
1314;Drevinukas;PELĖDŽIUKAI;6304169257;Taip;0;0;1;1
1315;Drevinukas;PELĖDŽIUKAI;85288014888;Taip;0;0;1;1
1316;Drevinukas;PELĖDŽIUKAI;1019214451;Taip;0;0;3;3
1317;Drevinukas;PELĖDŽIUKAI;6954102486;Ne;0;0;2;2
1318;Drevinukas;BORUŽĖLĖS;5348609358;Taip;0;7;5;12
1319;Drevinukas;BORUŽĖLĖS;1098647410;Taip;0;0;1;1
1320;Drevinukas;BORUŽĖLĖS;2312241894;Taip;10;2;0;12
1321;Drevinukas;BORUŽĖLĖS;5394143000;Taip;10;1;0;11
1322;Drevinukas;BORUŽĖLĖS;3871506691;Taip;10;1;0;11
1323;Drevinukas;BORUŽĖLĖS;6914111231;Taip;10;1;0;11
1324;Drevinukas;BORUŽĖLĖS;3046196006;Taip;0;14;0;14
1325;Drevinukas;BORUŽĖLĖS;3377957769;Taip;0;8;3;11
1326;Drevinukas;BORUŽĖLĖS;7334626684;Taip;11;0;3;14
1327;Drevinukas;BORUŽĖLĖS;2423143170;Taip;4;0;4;8
1328;Drevinukas;BORUŽĖLĖS;1343431478;Taip;0;0;5;5
1329;Drevinukas;BORUŽĖLĖS;8262224710;Taip;0;3;0;3
1330;Drevinukas;BITUTĖS;67237066332;Taip;10;4;0;14
1331;Drevinukas;BITUTĖS;1818789769;Ne;0;1;0;1
1332;Drevinukas;BITUTĖS;5962885680;Taip;0;1;2;3
1333;Drevinukas;BITUTĖS;7570410899;Taip;0;1;0;1
1334;Drevinukas;BITUTĖS;59090501289;Taip;0;4;0;4
1335;Drevinukas;BITUTĖS;3625661236;Taip;0;6;0;6
1336;Drevinukas;BITUTĖS;1577311253;Taip;0;1;2;3
1337;Drevinukas;BITUTĖS;3604979285;Taip;0;3;0;3
1338;Drevinukas;BITUTĖS;78348414683;Taip;0;5;0;5
1339;Drevinukas;BITUTĖS;6539595624;Taip;0;1;0;1
1340;Drevinukas;BITUTĖS;1970787957;Taip;0;19;0;19
1341;Drevinukas;BITUTĖS;1929303009;Taip;0;10;3;13
1342;Drevinukas;BITUTĖS;46323011887;Taip;5;0;0;5
1343;Drevinukas;BITUTĖS;1276720097;Taip;0;1;2;3
1344;Drevinukas;BITUTĖS;1585468549;Taip;0;4;0;4
1345;Drevinukas;BITUTĖS;5521378389;Taip;0;1;1;2
1346;Drevinukas;BITUTĖS;1723901018;Taip;0;10;5;15
1347;Drevinukas;BITUTĖS;7822458982;Taip;4;4;3;11
1348;Drevinukas;BITUTĖS;4352184625;Taip;0;6;0;6
1349;Drevinukas;NYKŠTUKAI;9513405583;Taip;8;0;0;8
1350;Drevinukas;NYKŠTUKAI;6165662595;Taip;7;0;2;9
1351;Drevinukas;NYKŠTUKAI;4203106313;Taip;0;0;1;1
1352;Drevinukas;NYKŠTUKAI;4147987057;Taip;9;0;0;9
1353;Drevinukas;NYKŠTUKAI;8719022482;Taip;9;1;0;10
1354;Drevinukas;NYKŠTUKAI;9695419813;Taip;0;5;0;5
1355;Drevinukas;NYKŠTUKAI;9517560132;Taip;2;0;8;10
1356;Drevinukas;NYKŠTUKAI;6895472558;Taip;19;0;0;19
1357;Drevinukas;NYKŠTUKAI;2039086829;Taip;0;0;1;1
1358;Drevinukas;NYKŠTUKAI;2571295179;Taip;5;8;0;13
1359;Drevinukas;NYKŠTUKAI;2820241608;Taip;0;4;0;4
1360;Drevinukas;NYKŠTUKAI;5860361695;Taip;0;0;1;1
1361;Drevinukas;SMALSUČIAI;4242944055;Taip;8;0;11;19
1362;Drevinukas;SMALSUČIAI;6243097297;Taip;0;0;8;8
1363;Drevinukas;SMALSUČIAI;8873060121;Taip;0;0;1;1
1364;Drevinukas;SMALSUČIAI;3381363132;Taip;22;0;0;22
1365;Drevinukas;SMALSUČIAI;7054681115;Taip;0;4;0;4
1366;Drevinukas;SMALSUČIAI;1094428951;Taip;3;10;0;13
1367;Drevinukas;SMALSUČIAI;5704489483;Taip;0;3;1;4
1368;Drevinukas;SMALSUČIAI;5928234487;Taip;0;0;5;5
1369;Drevinukas;SMALSUČIAI;9105675010;Taip;5;0;0;5
1370;Drevinukas;SMALSUČIAI;9004568476;Taip;8;0;2;10
1371;Drevinukas;SMALSUČIAI;9283862598;Taip;5;0;0;5
1372;Drevinukas;SMALSUČIAI;1567790084;Taip;9;2;0;11
1373;Drevinukas;SMALSUČIAI;3293457412;Taip;0;0;1;1
1374;Drevinukas;SMALSUČIAI;8578579808;Taip;3;9;1;13
1375;Drevinukas;SMALSUČIAI;3611870655;Taip;0;7;8;15
1376;Drevinukas;ŽVIRBLIUKAI;5721031754;Taip;0;0;4;4
1377;Drevinukas;ŽVIRBLIUKAI;9534007163;Ne;0;16;0;16
1378;Drevinukas;ŽVIRBLIUKAI;8701250912;Taip;8;0;6;14
1379;Drevinukas;ŽVIRBLIUKAI;3643007998;Ne;7;9;0;16
1380;Drevinukas;ŽVIRBLIUKAI;6891793135;Taip;0;1;3;4
1381;Drevinukas;ŽVIRBLIUKAI;9915130747;Ne;0;11;0;11
1382;Drevinukas;ŽVIRBLIUKAI;3887137828;Taip;22;0;0;22
1383;Drevinukas;ŽVIRBLIUKAI;1644656704;Taip;0;1;1;2
1384;Drevinukas;ŽVIRBLIUKAI;8143614891;Taip;5;6;0;11
1385;Drevinukas;ŽVIRBLIUKAI;4262951360;Taip;6;0;5;11
1386;Drevinukas;ŽVIRBLIUKAI;7689145214;Taip;0;1;6;7
1387;Drevinukas;ŽVIRBLIUKAI;1564065835;Taip;0;7;0;7
1388;Drevinukas;ŽVIRBLIUKAI;1058927778;Taip;0;1;0;1
1389;Drevinukas;ŽVIRBLIUKAI;4213259879;Taip;0;3;0;3
1390;Drevinukas;ŽVIRBLIUKAI;9289471118;Taip;0;22;0;22
1391;Drevinukas;ŽVIRBLIUKAI;2300338724;Taip;3;1;4;8
1392;Drevinukas;ŽVIRBLIUKAI;8477241365;Taip;0;1;12;13
1393;Drugelis;NYKŠTUKŲ;3551095669;Taip;0;2;2;4
1394;Drugelis;NYKŠTUKŲ;1785724340;Taip;0;16;0;16
1395;Drugelis;NYKŠTUKŲ;6632884258;Taip;0;2;4;6
1396;Drugelis;NYKŠTUKŲ;4523513611;Taip;0;2;0;2
1397;Drugelis;NYKŠTUKŲ;6594452094;Taip;0;4;3;7
1398;Drugelis;NYKŠTUKŲ;5122256823;Taip;10;1;0;11
1399;Drugelis;NYKŠTUKŲ;4825232236;Taip;0;2;2;4
1400;Drugelis;NYKŠTUKŲ;8752459733;Taip;0;1;0;1
1401;Drugelis;NYKŠTUKŲ;8717445483;Taip;0;8;0;8
1402;Drugelis;NYKŠTUKŲ;4867387611;Taip;0;19;0;19
1403;Drugelis;NYKŠTUKŲ;7609530453;Taip;0;6;3;9
1404;Drugelis;NYKŠTUKŲ;5692743298;Taip;0;2;0;2
1405;Drugelis;NYKŠTUKŲ;6452921695;Taip;3;0;3;6
1406;Drugelis;NYKŠTUKŲ;8591548746;Taip;0;4;0;4
1407;Drugelis;SMALSUČIŲ;3096906506;Taip;0;1;0;1
1408;Drugelis;SMALSUČIŲ;1856912386;Taip;0;9;0;9
1409;Drugelis;SMALSUČIŲ;68223183150;Taip;8;2;0;10
1410;Drugelis;SMALSUČIŲ;3479833265;Taip;0;1;6;7
1411;Drugelis;SMALSUČIŲ;3202149560;Taip;0;1;0;1
1412;Drugelis;SMALSUČIŲ;27569805506;Taip;0;4;0;4
1413;Drugelis;SMALSUČIŲ;1901608445;Taip;0;6;0;6
1414;Drugelis;SMALSUČIŲ;1843605624;Taip;0;8;0;8
1415;Drugelis;SMALSUČIŲ;1421438458;Taip;0;7;0;7
1416;Drugelis;SMALSUČIŲ;1961898730;Taip;0;1;0;1
1417;Drugelis;SMALSUČIŲ;1541276266;Taip;0;1;0;1
1418;Drugelis;SMALSUČIŲ;5954059321;Taip;1;10;2;13
1419;Drugelis;SMALSUČIŲ;1888002607;Taip;0;1;0;1
1420;Drugelis;SMALSUČIŲ;1255124184;Taip;0;0;2;2
1421;Drugelis;SMALSUČIŲ;1217635751;Taip;0;0;12;12
1422;Drugelis;SMALSUČIŲ;7406396614;Taip;0;2;0;2
1423;Drugelis;SMALSUČIŲ;1576853049;Taip;0;1;5;6
1424;Drugelis;MUMINUKŲ;3311620018;Taip;0;1;0;1
1425;Drugelis;MUMINUKŲ;8812550811;Taip;5;3;0;8
1426;Drugelis;MUMINUKŲ;5661335344;Taip;0;1;0;1
1427;Drugelis;MUMINUKŲ;9851124145;Taip;5;0;0;5
1428;Drugelis;MUMINUKŲ;7253876812;Taip;1;0;1;2
1429;Drugelis;MUMINUKŲ;1816845006;Taip;3;0;0;3
1430;Drugelis;MUMINUKŲ;1666992752;Taip;5;0;1;6
1431;Drugelis;MUMINUKŲ;9510744779;Taip;0;2;0;2
1432;Drugelis;MUMINUKŲ;9029137302;Taip;3;0;0;3
1433;Drugelis;MUMINUKŲ;9907121223;Taip;0;4;0;4
1434;Drugelis;MUMINUKŲ;8500348389;Taip;0;7;0;7
1435;Drugelis;MUMINUKŲ;1858504360;Taip;14;0;0;14
1436;Drugelis;MUMINUKŲ;8107970910;Taip;4;6;1;11
1437;Drugelis;MUMINUKŲ;5515894973;Taip;2;2;0;4
1438;Drugelis;MUMINUKŲ;3293212749;Taip;0;4;1;5
1439;Drugelis;PŪKUOTUKAI;49035429728;Taip;0;2;1;3
1440;Drugelis;PŪKUOTUKAI;3156382280;Taip;0;2;0;2
1441;Drugelis;PŪKUOTUKAI;26436464504;Taip;0;3;0;3
1442;Drugelis;PŪKUOTUKAI;1657445173;Taip;0;2;2;4
1443;Drugelis;PŪKUOTUKAI;27379769302;Taip;0;0;1;1
1444;Drugelis;PŪKUOTUKAI;91538620813;Taip;0;2;2;4
1445;Drugelis;PŪKUOTUKAI;68716515660;Taip;0;1;0;1
1446;Drugelis;PŪKUOTUKAI;1162058481;Taip;0;2;5;7
1447;Drugelis;PŪKUOTUKAI;20943932955;Taip;0;0;1;1
1448;Drugelis;PŪKUOTUKAI;1667056936;Taip;0;1;5;6
1449;Drugelis;PŪKUOTUKAI;63777226415;Taip;0;2;3;5
1450;Drugelis;PŪKUOTUKAI;1005872691;Taip;0;5;0;5
1451;Drugelis;PŪKUOTUKAI;3403116175;Taip;0;0;6;6
1452;Drugelis;PŪKUOTUKAI;1160161173;Taip;0;1;0;1
1453;Drugelis;PŪKUOTUKAI;48956671934;Taip;14;1;0;15
1454;Drugelis;PŪKUOTUKAI;9149748841;Taip;0;7;2;9
1455;Drugelis;SPINDULIUKAI;6890441262;Taip;0;2;1;3
1456;Drugelis;SPINDULIUKAI;6613520046;Taip;8;0;1;9
1457;Drugelis;SPINDULIUKAI;2196445523;Taip;0;1;0;1
1458;Drugelis;SPINDULIUKAI;3645668411;Taip;0;2;0;2
1459;Drugelis;SPINDULIUKAI;3261462674;Taip;2;4;0;6
1460;Drugelis;SPINDULIUKAI;5533529267;Taip;0;4;1;5
1461;Drugelis;SPINDULIUKAI;3733097479;Taip;0;0;1;1
1462;Drugelis;SPINDULIUKAI;9066572677;Taip;0;0;1;1
1463;Drugelis;SPINDULIUKAI;2644563881;Taip;0;4;0;4
1464;Drugelis;SPINDULIUKAI;9650052415;Taip;8;0;5;13
1465;Drugelis;SPINDULIUKAI;1375535260;Taip;12;0;3;15
1466;Drugelis;SPINDULIUKAI;3081918342;Taip;5;0;1;6
1467;Drugelis;KIŠKUČIAI;3603051567;Taip;18;0;0;18
1468;Drugelis;KIŠKUČIAI;8962657389;Taip;0;2;0;2
1469;Drugelis;KIŠKUČIAI;4628926113;Taip;13;3;0;16
1470;Drugelis;KIŠKUČIAI;7307032077;Taip;0;6;0;6
1471;Drugelis;KIŠKUČIAI;4871624566;Taip;0;0;3;3
1472;Drugelis;KIŠKUČIAI;4805858183;Taip;7;7;0;14
1473;Drugelis;KIŠKUČIAI;1213610973;Taip;0;2;0;2
1474;Drugelis;KIŠKUČIAI;9211760307;Taip;12;0;0;12
1475;Drugelis;KIŠKUČIAI;6071997970;Taip;16;0;0;16
1476;Drugelis;KIŠKUČIAI;8819853863;Taip;11;4;0;15
1477;Drugelis;KIŠKUČIAI;6533325098;Taip;0;1;0;1
1478;Drugelis;KIŠKUČIAI;9900296726;Taip;14;0;0;14
1479;Drugelis;KIŠKUČIAI;6997707085;Taip;9;3;1;13
1480;Drugelis;NYKŠTUKAI;1164620381;Taip;4;0;0;4
1481;"Du gaideliai";Uodelių;8042203623;Taip;6;1;4;11
1482;"Du gaideliai";Uodelių;9585785202;Taip;0;4;0;4
1483;"Du gaideliai";Uodelių;5611102395;Ne;0;10;0;10
1484;"Du gaideliai";Uodelių;2100449108;Taip;0;11;0;11
1485;"Du gaideliai";Uodelių;3019797369;Taip;3;2;0;5
1486;"Du gaideliai";Uodelių;2845145754;Taip;0;9;0;9
1487;"Du gaideliai";Uodelių;7726490359;Taip;4;2;0;6
1488;"Du gaideliai";Uodelių;6762171696;Taip;0;6;0;6
1489;"Du gaideliai";Uodelių;5728374219;Taip;0;2;0;2
1490;"Du gaideliai";Uodelių;8410547195;Taip;0;1;0;1
1491;"Du gaideliai";Uodelių;2905083899;Taip;4;0;0;4
1492;"Du gaideliai";Uodelių;2151825222;Taip;0;3;0;3
1493;"Du gaideliai";Uodelių;1156396094;Taip;3;0;0;3
1494;"Du gaideliai";Uodelių;9356275460;Taip;0;2;0;2
1495;"Du gaideliai";Uodelių;6204233540;Taip;0;1;0;1
1496;"Du gaideliai";Uodelių;6120647567;Taip;0;2;0;2
1497;"Du gaideliai";Uodelių;5801081015;Taip;22;0;0;22
1498;"Du gaideliai";Uodelių;7391278306;Taip;14;0;0;14
1499;"Du gaideliai";OŽIUKŲ;2240947701;Taip;11;0;6;17
1500;"Du gaideliai";OŽIUKŲ;3507387826;Taip;5;2;0;7
1501;"Du gaideliai";OŽIUKŲ;4144269068;Taip;0;3;0;3
1502;"Du gaideliai";OŽIUKŲ;1785976627;Taip;0;1;0;1
1503;"Du gaideliai";OŽIUKŲ;5894974508;Taip;0;0;2;2
1504;"Du gaideliai";OŽIUKŲ;5103483956;Taip;0;5;6;11
1505;"Du gaideliai";OŽIUKŲ;4378924981;Ne;8;1;0;9
1506;"Du gaideliai";OŽIUKŲ;1268479215;Taip;0;2;0;2
1507;"Du gaideliai";OŽIUKŲ;3854355215;Taip;6;0;0;6
1508;"Du gaideliai";OŽIUKŲ;2262425557;Taip;0;15;0;15
1509;"Du gaideliai";OŽIUKŲ;7033276798;Taip;0;1;2;3
1510;"Du gaideliai";OŽIUKŲ;8047413507;Taip;0;1;0;1
1511;"Du gaideliai";OŽIUKŲ;5998344519;Taip;20;0;0;20
1512;"Du gaideliai";OŽIUKŲ;6870356241;Taip;9;2;0;11
1513;"Du gaideliai";OŽIUKŲ;5788923258;Taip;0;2;0;2
1514;"Du gaideliai";OŽIUKŲ;9568647033;Taip;11;0;0;11
1515;"Du gaideliai";OŽIUKŲ;1751328192;Taip;14;0;0;14
1516;"Du gaideliai";Vištyčių;6170362846;Taip;2;1;0;3
1517;"Du gaideliai";Vištyčių;1758546983;Taip;0;1;0;1
1518;"Du gaideliai";Vištyčių;7783203480;Taip;0;13;0;13
1519;"Du gaideliai";Vištyčių;94639433266;Taip;0;1;0;1
1520;"Du gaideliai";Vištyčių;9324740716;Taip;0;1;0;1
1521;"Du gaideliai";Vištyčių;6715434585;Taip;0;6;0;6
1522;"Du gaideliai";Vištyčių;7084763712;Taip;0;1;0;1
1523;"Du gaideliai";Vištyčių;1500684755;Taip;3;9;0;12
1524;"Du gaideliai";Vištyčių;6750787450;Taip;0;11;0;11
1525;"Du gaideliai";Vištyčių;1549762923;Taip;0;2;1;3
1526;"Du gaideliai";Vištyčių;3771563320;Taip;0;4;0;4
1527;"Du gaideliai";Vištyčių;6203383711;Taip;0;0;1;1
1528;"Du gaideliai";Vištyčių;1962859229;Taip;0;1;0;1
1529;"Du gaideliai";Vištyčių;1557413692;Taip;0;5;0;5
1530;"Du gaideliai";Vištyčių;3560637865;Taip;0;13;0;13
1531;"Du gaideliai";Vištyčių;1135098595;Taip;0;5;2;7
1532;"Du gaideliai";Vištyčių;3370029981;Taip;5;2;0;7
1533;"Du gaideliai";Vištyčių;7373413569;Taip;0;2;0;2
1534;"Du gaideliai";Vištyčių;27733314504;Taip;0;6;0;6
1535;"Du gaideliai";GAIDŽIUKŲ;80297570999;Taip;0;0;2;2
1536;"Du gaideliai";GAIDŽIUKŲ;13384312035;Taip;5;0;0;5
1537;"Du gaideliai";GAIDŽIUKŲ;1923863232;Taip;0;1;0;1
1538;"Du gaideliai";GAIDŽIUKŲ;1291620608;Taip;0;1;2;3
1539;"Du gaideliai";GAIDŽIUKŲ;41922349110;Taip;0;3;0;3
1540;"Du gaideliai";GAIDŽIUKŲ;73447542654;Taip;3;0;0;3
1541;"Du gaideliai";GAIDŽIUKŲ;1261678548;Taip;0;0;1;1
1542;"Du gaideliai";GAIDŽIUKŲ;85962801220;Taip;0;1;0;1
1543;"Du gaideliai";GAIDŽIUKŲ;30562958921;Taip;0;1;0;1
1544;"Du gaideliai";GAIDŽIUKŲ;60934378499;Taip;0;1;0;1
1545;"Du gaideliai";GAIDŽIUKŲ;1128234653;Taip;0;1;2;3
1546;"Du gaideliai";GAIDŽIUKŲ;14681393632;Taip;0;2;0;2
1547;"Du gaideliai";GAIDŽIUKŲ;1628346439;Taip;4;6;0;10
1548;"Du gaideliai";GAIDŽIUKŲ;1791530261;Taip;0;4;0;4
1549;"Du gaideliai";GAIDŽIUKŲ;1512578437;Ne;0;0;1;1
1550;"Du gaideliai";GAIDŽIUKŲ;8665467175;Taip;9;0;0;9
1551;"Du gaideliai";Musyčių;8420400705;Taip;0;4;0;4
1552;"Du gaideliai";Musyčių;4408537397;Taip;0;1;0;1
1553;"Du gaideliai";Musyčių;4157021754;Taip;7;0;1;8
1554;"Du gaideliai";Musyčių;6132405512;Taip;4;7;0;11
1555;"Du gaideliai";Musyčių;2756525592;Taip;5;0;0;5
1556;"Du gaideliai";Musyčių;7563789811;Taip;5;0;0;5
1557;"Du gaideliai";Musyčių;9374869616;Taip;4;0;0;4
1558;"Du gaideliai";Musyčių;5726096980;Taip;0;0;2;2
1559;"Du gaideliai";Musyčių;1527839162;Taip;22;0;0;22
1560;"Du gaideliai";Musyčių;5809089345;Taip;0;1;0;1
1561;"Du gaideliai";Musyčių;1968978650;Taip;0;7;0;7
1562;"Du gaideliai";Musyčių;6942798420;Taip;0;2;0;2
1563;"Du gaideliai";Musyčių;7193151965;Taip;11;3;0;14
1564;"Du gaideliai";MALŪNO;4799107717;Taip;0;1;0;1
1565;"Du gaideliai";MALŪNO;8921985681;Taip;0;15;0;15
1566;"Du gaideliai";MALŪNO;9934568135;Taip;12;2;0;14
1567;"Du gaideliai";MALŪNO;2616106413;Taip;13;0;0;13
1568;"Du gaideliai";MALŪNO;3654057453;Taip;5;5;0;10
1569;"Du gaideliai";MALŪNO;2084660815;Taip;0;0;1;1
1570;"Du gaideliai";MALŪNO;4204930257;Taip;5;0;0;5
1571;"Du gaideliai";MALŪNO;6224116229;Taip;0;3;1;4
1572;"Du gaideliai";MALŪNO;1882241729;Taip;13;0;3;16
1573;"Du gaideliai";MALŪNO;9506572113;Taip;0;6;0;6
1574;"Du gaideliai";MALŪNO;4918717178;Taip;0;10;0;10
1575;"Du gaideliai";MALŪNO;5291934919;Taip;0;1;0;1
1576;"Du gaideliai";MALŪNO;7372149799;Taip;0;7;0;7
1577;"Du gaideliai";MALŪNO;6630053388;Taip;3;0;3;6
1578;"Du gaideliai";MALŪNO;5225949099;Taip;0;1;0;1
1579;Eglutė;RAMUNĖ;1125331552;Taip;5;0;1;6
1580;Eglutė;RAMUNĖ;27441180688;Taip;0;0;5;5
1581;Eglutė;RAMUNĖ;1044133613;Taip;0;0;1;1
1582;Eglutė;RAMUNĖ;1206623876;Taip;0;5;2;7
1583;Eglutė;RAMUNĖ;1864153865;Taip;0;0;3;3
1584;Eglutė;RAMUNĖ;20582720349;Taip;0;0;1;1
1585;Eglutė;RAMUNĖ;1272418234;Taip;0;0;6;6
1586;Eglutė;RAMUNĖ;65985749472;Taip;0;0;4;4
1587;Eglutė;RAMUNĖ;1555843610;Taip;0;1;0;1
1588;Eglutė;RAMUNĖ;37487292437;Taip;0;5;0;5
1589;Eglutė;RAMUNĖ;2109443590;Taip;0;5;2;7
1590;Eglutė;RAMUNĖ;1477651468;Taip;0;4;0;4
1591;Eglutė;RAMUNĖ;2112417439;Taip;0;0;1;1
1592;Eglutė;RAMUNĖ;2064962114;Taip;0;1;0;1
1593;Eglutė;PELĖDŽIUKAI;2395506996;Taip;2;0;0;2
1594;Eglutė;PELĖDŽIUKAI;2041825568;Taip;0;0;3;3
1595;Eglutė;PELĖDŽIUKAI;1747424609;Taip;0;0;3;3
1596;Eglutė;PELĖDŽIUKAI;64360778537;Taip;0;0;2;2
1597;Eglutė;PELĖDŽIUKAI;1882915662;Taip;0;0;1;1
1598;Eglutė;PELĖDŽIUKAI;1120848949;Taip;0;0;2;2
1599;Eglutė;PELĖDŽIUKAI;1814357743;Taip;0;0;3;3
1600;Eglutė;PELĖDŽIUKAI;1881111005;Taip;0;0;2;2
1601;Eglutė;PELĖDŽIUKAI;1939447097;Taip;0;0;1;1
1602;Eglutė;PELĖDŽIUKAI;1187563631;Taip;0;0;4;4
1603;Eglutė;PELĖDŽIUKAI;90878878800;Taip;0;2;1;3
1604;Eglutė;PELĖDŽIUKAI;1418516444;Taip;8;0;0;8
1605;Eglutė;PELĖDŽIUKAI;63268716266;Taip;0;0;2;2
1606;Eglutė;KODĖLČIUKAI;1941042419;Taip;8;0;4;12
1607;Eglutė;KODĖLČIUKAI;4490295754;Ne;0;5;0;5
1608;Eglutė;KODĖLČIUKAI;3883122650;Taip;4;2;0;6
1609;Eglutė;KODĖLČIUKAI;7859815752;Taip;8;12;0;20
1610;Eglutė;KODĖLČIUKAI;4348313801;Taip;19;3;0;22
1611;Eglutė;KODĖLČIUKAI;7758643349;Taip;3;8;0;11
1612;Eglutė;KODĖLČIUKAI;6483580751;Taip;0;4;0;4
1613;Eglutė;KODĖLČIUKAI;5924994736;Taip;8;0;0;8
1614;Eglutė;KODĖLČIUKAI;1759383841;Taip;0;2;0;2
1615;Eglutė;KODĖLČIUKAI;6597261061;Taip;0;1;0;1
1616;Eglutė;KODĖLČIUKAI;9046652370;Taip;0;0;10;10
1617;Eglutė;KODĖLČIUKAI;9356785605;Taip;0;2;0;2
1618;Eglutė;KODĖLČIUKAI;8943684351;Taip;4;0;0;4
1619;Eglutė;KODĖLČIUKAI;9967488317;Taip;0;2;0;2
1620;Eglutė;KODĖLČIUKAI;3584247594;Taip;4;1;0;5
1621;Eglutė;KODĖLČIUKAI;9758104910;Ne;3;8;1;12
1622;Eglutė;KODĖLČIUKAI;1531942494;Taip;0;8;0;8
1623;Eglutė;OBUOLIUKAI;7703290039;Taip;10;0;1;11
1624;Eglutė;OBUOLIUKAI;4099257155;Taip;15;0;0;15
1625;Eglutė;OBUOLIUKAI;5636437290;Taip;0;1;5;6
1626;Eglutė;OBUOLIUKAI;6009794480;Taip;0;2;0;2
1627;Eglutė;OBUOLIUKAI;2872597971;Taip;15;0;0;15
1628;Eglutė;OBUOLIUKAI;7098548563;Taip;3;0;3;6
1629;Eglutė;OBUOLIUKAI;8534997648;Taip;0;0;15;15
1630;Eglutė;OBUOLIUKAI;5166183300;Taip;0;5;0;5
1631;Eglutė;OBUOLIUKAI;1842517164;Taip;0;0;22;22
1632;Eglutė;OBUOLIUKAI;7530638623;Taip;0;3;0;3
1633;Eglutė;OBUOLIUKAI;2357276888;Taip;0;4;0;4
1634;Eglutė;OBUOLIUKAI;6899575758;Ne;0;12;0;12
1635;Eglutė;OBUOLIUKAI;6539887315;Taip;0;0;4;4
1636;Eglutė;OBUOLIUKAI;2816913563;Taip;0;6;5;11
1637;Eglutė;OBUOLIUKAI;4252256130;Taip;3;0;0;3
1638;Eglutė;OBUOLIUKAI;6146679388;Taip;9;1;0;10
1639;Eglutė;OBUOLIUKAI;7234851379;Taip;8;0;0;8
1640;Eglutė;OBUOLIUKAI;9402686801;Taip;0;22;0;22
1641;Eglutė;OBUOLIUKAI;6653111225;Taip;4;0;5;9
1642;Eglutė;KAŠTONAS;1436966647;Taip;0;1;0;1
1643;Eglutė;KAŠTONAS;8523618773;Taip;0;0;8;8
1644;Eglutė;KAŠTONAS;6891834971;Taip;0;3;0;3
1645;Eglutė;KAŠTONAS;8162972897;Taip;0;5;0;5
1646;Eglutė;KAŠTONAS;8364693548;Taip;0;8;0;8
1647;Eglutė;KAŠTONAS;1265463853;Taip;0;0;2;2
1648;Eglutė;KAŠTONAS;3856651647;Taip;4;2;7;13
1649;Eglutė;KAŠTONAS;7307564177;Taip;0;10;4;14
1650;Eglutė;KAŠTONAS;1122308715;Taip;0;1;0;1
1651;Eglutė;KAŠTONAS;9992438336;Taip;3;2;0;5
1652;Eglutė;KAŠTONAS;8421062747;Taip;8;7;0;15
1653;Eglutė;KAŠTONAS;1908835124;Ne;0;8;0;8
1654;Eglutė;KAŠTONAS;1321901982;Taip;0;8;0;8
1655;Eglutė;KAŠTONAS;7354260503;Ne;0;2;0;2
1656;Eglutė;KAŠTONAS;9527732584;Taip;0;0;5;5
1657;Eglutė;KAŠTONAS;5731355126;Taip;4;0;0;4
1658;Eglutė;KAŠTONAS;9439309687;Taip;0;0;2;2
1659;Eglutė;KAŠTONAS;7314537168;Taip;0;0;20;20
1660;Eglutė;EŽIUKAI;4560670047;Taip;0;6;0;6
1661;Eglutė;EŽIUKAI;1048451048;Taip;0;6;0;6
1662;Eglutė;EŽIUKAI;6142326330;Taip;0;22;0;22
1663;Eglutė;EŽIUKAI;4047404616;Taip;0;13;0;13
1664;Eglutė;EŽIUKAI;1422631723;Taip;0;21;0;21
1665;Eglutė;EŽIUKAI;6709551046;Taip;0;0;1;1
1666;Eglutė;EŽIUKAI;6093932811;Taip;1;0;0;1
1667;Eglutė;EŽIUKAI;6544877723;Taip;0;5;1;6
1668;Eglutė;EŽIUKAI;7491022301;Taip;6;4;0;10
1669;Eglutė;EŽIUKAI;2651867769;Taip;0;3;3;6
1670;Eglutė;EŽIUKAI;3473388722;Taip;0;0;1;1
1671;Eglutė;EŽIUKAI;2597978713;Taip;0;11;0;11
1672;Eglutė;EŽIUKAI;4451772812;Taip;18;0;0;18
1673;Eglutė;EŽIUKAI;8493750509;Taip;0;3;2;5
1674;Eglutė;EŽIUKAI;5943856319;Taip;0;6;0;6
1675;Eglutė;EŽIUKAI;1050313582;Taip;5;0;0;5
1676;Eglutė;EŽIUKAI;9728550000;Taip;0;0;1;1
1677;Eglutė;EŽIUKAI;1534556744;Taip;0;6;0;6
1678;Eglutė;EŽIUKAI;4230594049;Taip;0;3;0;3
1679;Eglutė;EŽIUKAI;9929681000;Taip;7;0;0;7
1680;Eglutė;EŽIUKAI;6105927493;Taip;0;4;0;4
1681;Eglutė;GILĖ;7148210944;Taip;0;7;0;7
1682;Eglutė;GILĖ;3616979217;Taip;0;7;0;7
1683;Eglutė;GILĖ;9333028072;Taip;6;0;0;6
1684;Eglutė;GILĖ;2638807860;Taip;8;0;0;8
1685;Eglutė;GILĖ;8033370429;Taip;0;1;1;2
1686;Eglutė;GILĖ;3203786388;Taip;0;0;3;3
1687;Eglutė;GILĖ;1209962222;Taip;0;6;0;6
1688;Eglutė;GILĖ;9950953029;Taip;0;0;2;2
1689;Eglutė;GILĖ;3275796441;Taip;0;0;1;1
1690;Eglutė;GILĖ;3178489517;Taip;0;0;4;4
1691;Eglutė;GILĖ;6518497374;Taip;4;0;0;4
1692;Eglutė;GILĖ;8606991706;Taip;3;0;0;3
1693;Eglutė;GILĖ;1324622835;Taip;15;0;7;22
1694;Eglutė;GILĖ;2082716398;Taip;0;10;0;10
1695;Eglutė;GILĖ;1510706652;Taip;0;4;1;5
1696;Eglutė;GILĖ;1695732622;Taip;0;4;1;5
1697;Eglutė;GILĖ;3393414294;Taip;0;8;0;8
1698;Eglutė;GILĖ;5856250605;Taip;0;8;0;8
1699;Eglutė;GILĖ;7149060118;Taip;0;2;0;2
1700;Eglutė;GILĖ;5840014240;Taip;0;0;22;22
1701;Eglutė;SAULUTĖ;9741776217;Taip;0;7;0;7
1702;Eglutė;SAULUTĖ;3091324735;Taip;0;0;3;3
1703;Eglutė;SAULUTĖ;8739346084;Taip;0;0;5;5
1704;Eglutė;SAULUTĖ;5518570006;Taip;3;0;0;3
1705;Eglutė;SAULUTĖ;9084576953;Ne;0;0;10;10
1706;Eglutė;SAULUTĖ;2259077568;Ne;0;2;0;2
1707;Eglutė;SAULUTĖ;4489150480;Taip;19;1;0;20
1708;Eglutė;SAULUTĖ;2425927050;Ne;0;0;14;14
1709;Eglutė;SAULUTĖ;5918429438;Taip;0;0;3;3
1710;Eglutė;SAULUTĖ;9098132159;Taip;0;0;2;2
1711;Eglutė;SAULUTĖ;2615824395;Taip;0;0;4;4
1712;Eglutė;SAULUTĖ;5006042568;Taip;0;3;0;3
1713;Eglutė;SAULUTĖ;5275306818;Taip;0;0;1;1
1714;Eglutė;SAULUTĖ;2621445549;Taip;8;0;0;8
1715;Eglutė;SAULUTĖ;6328900251;Taip;0;1;0;1
1716;Eglutė;SAULUTĖ;9661883776;Taip;0;1;0;1
1717;Eglutė;SAULUTĖ;5505398901;Taip;4;0;0;4
1718;Eglutė;SAULUTĖ;8799063905;Taip;0;1;0;1
1719;Eglutė;SAULUTĖ;5108928996;Taip;0;1;0;1
1720;Eglutė;SAULUTĖ;6572235324;Taip;0;8;0;8
1721;Eglutė;ŠARKELĖ;1899379269;Taip;0;0;1;1
1722;Eglutė;ŠARKELĖ;8325288373;Taip;7;0;0;7
1723;Eglutė;ŠARKELĖ;3740322448;Taip;0;12;0;12
1724;Eglutė;ŠARKELĖ;9746021019;Taip;0;13;0;13
1725;Eglutė;ŠARKELĖ;1814323427;Taip;3;0;2;5
1726;Eglutė;ŠARKELĖ;5013664843;Taip;0;0;4;4
1727;Eglutė;ŠARKELĖ;2276311106;Taip;0;5;0;5
1728;Eglutė;ŠARKELĖ;1550045866;Taip;0;0;1;1
1729;Eglutė;ŠARKELĖ;6272115803;Taip;0;7;0;7
1730;Eglutė;ŠARKELĖ;2857760751;Taip;0;9;1;10
1731;Eglutė;ŠARKELĖ;8129230197;Taip;0;1;0;1
1732;Eglutė;ŠARKELĖ;1393626624;Taip;0;11;0;11
1733;Eglutė;ŠARKELĖ;6924344686;Taip;4;0;0;4
1734;Eglutė;ŠARKELĖ;3605053253;Taip;22;0;0;22
1735;Eglutė;ŠARKELĖ;6550999480;Taip;0;4;0;4
1736;Eglutė;ŠARKELĖ;5645197324;Taip;16;2;0;18
1737;Eglutė;NYKŠTUKAI;1923176808;Ne;0;8;0;8
1738;Eglutė;NYKŠTUKAI;7735192219;Taip;4;0;0;4
1739;Eglutė;NYKŠTUKAI;8721209423;Taip;5;0;0;5
1740;Eglutė;NYKŠTUKAI;7789753835;Taip;4;6;0;10
1741;Eglutė;NYKŠTUKAI;3011330968;Taip;0;1;4;5
1742;Eglutė;NYKŠTUKAI;8037564034;Taip;0;18;0;18
1743;Eglutė;NYKŠTUKAI;3690266358;Taip;0;1;1;2
1744;Eglutė;NYKŠTUKAI;3368734808;Taip;0;7;0;7
1745;Eglutė;NYKŠTUKAI;8749425471;Taip;0;4;0;4
1746;Eglutė;NYKŠTUKAI;5779671024;Taip;0;11;0;11
1747;Eglutė;NYKŠTUKAI;5783776734;Taip;0;7;0;7
1748;Eglutė;NYKŠTUKAI;4490541539;Taip;6;0;0;6
1749;Eglutė;NYKŠTUKAI;4151258155;Taip;0;0;15;15
1750;Eglutė;NYKŠTUKAI;1774538642;Taip;0;5;2;7
1751;Eglutė;NYKŠTUKAI;6965837585;Taip;5;0;0;5
1752;Eglutė;NYKŠTUKAI;1460628870;Taip;10;0;0;10
1753;Eglutė;NYKŠTUKAI;1380219881;Taip;5;0;0;5
1754;Eglutė;ŽIRNIUKAI;4268438476;Taip;20;0;0;20
1755;Eglutė;ŽIRNIUKAI;7216076735;Taip;3;1;5;9
1756;Eglutė;ŽIRNIUKAI;3387392137;Taip;0;9;0;9
1757;Eglutė;ŽIRNIUKAI;9054104040;Taip;14;0;0;14
1758;Eglutė;ŽIRNIUKAI;5239028554;Taip;0;14;0;14
1759;Eglutė;ŽIRNIUKAI;3112281182;Taip;5;0;4;9
1760;Eglutė;ŽIRNIUKAI;7598993411;Taip;0;17;0;17
1761;Eglutė;ŽIRNIUKAI;8384141923;Taip;0;0;20;20
1762;Eglutė;ŽIRNIUKAI;1432716037;Taip;0;0;3;3
1763;Eglutė;ŽIRNIUKAI;9542684993;Taip;0;2;0;2
1764;Eglutė;ŽIRNIUKAI;9193920390;Taip;5;1;1;7
1765;Eglutė;BORUŽIUKAI;1122907387;Taip;0;5;0;5
1766;Eglutė;BORUŽIUKAI;3237476593;Taip;3;1;0;4
1767;Eglutė;BORUŽIUKAI;6382927775;Taip;0;0;13;13
1768;Eglutė;BORUŽIUKAI;5509138443;Taip;7;5;0;12
1769;Eglutė;BORUŽIUKAI;5407757245;Taip;0;4;0;4
1770;Eglutė;BORUŽIUKAI;7831541089;Taip;8;0;0;8
1771;Eglutė;BORUŽIUKAI;9964146295;Taip;3;0;0;3
1772;Eglutė;BORUŽIUKAI;1420067187;Taip;0;9;0;9
1773;Eglutė;BORUŽIUKAI;1630903587;Taip;17;2;0;19
1774;Eglutė;BORUŽIUKAI;3430016771;Taip;0;19;0;19
1775;Eglutė;BORUŽIUKAI;9686836846;Taip;2;6;0;8
1776;Eglutė;BORUŽIUKAI;4932945207;Taip;0;0;22;22
1777;Eglutė;BORUŽIUKAI;9542103745;Taip;10;0;0;10
1778;Eglutė;BORUŽIUKAI;7658345479;Taip;0;7;0;7
1779;Eglutė;BORUŽIUKAI;7919553451;Taip;3;3;0;6
1780;"Geniukų kalvė";SAULUTĖS;9557055841;Taip;11;0;0;11
1781;"Geniukų kalvė";SAULUTĖS;3111400962;Taip;1;3;0;4
1782;"Geniukų kalvė";SAULUTĖS;4329782598;Taip;0;5;0;5
1783;"Geniukų kalvė";SAULUTĖS;8932671578;Taip;0;11;0;11
1784;"Geniukų kalvė";SAULUTĖS;9711047774;Taip;11;0;0;11
1785;"Geniukų kalvė";SAULUTĖS;1910363787;Taip;0;1;0;1
1786;"Geniukų kalvė";SAULUTĖS;7940706717;Taip;0;0;3;3
1787;"Geniukų kalvė";SAULUTĖS;9522911738;Taip;3;0;0;3
1788;"Geniukų kalvė";SAULUTĖS;5348211316;Taip;0;6;0;6
1789;"Geniukų kalvė";SAULUTĖS;6384832317;Taip;10;0;9;19
1790;"Geniukų kalvė";SAULUTĖS;4525874796;Taip;0;3;0;3
1791;"Geniukų kalvė";SAULUTĖS;7289942679;Taip;0;0;13;13
1792;"Geniukų kalvė";SAULUTĖS;7889781552;Taip;5;0;1;6
1793;"Geniukų kalvė";SAULUTĖS;3889643236;Taip;8;4;0;12
1794;"Geniukų kalvė";SAULUTĖS;6016735700;Taip;0;0;3;3
1795;"Geniukų kalvė";BITUTĖS;2718961466;Taip;4;2;1;7
1796;"Geniukų kalvė";BITUTĖS;4967513360;Taip;0;1;0;1
1797;"Geniukų kalvė";BITUTĖS;2016254460;Taip;0;7;0;7
1798;"Geniukų kalvė";BITUTĖS;5776314197;Taip;2;1;0;3
1799;"Geniukų kalvė";BITUTĖS;4105170344;Taip;0;2;0;2
1800;"Geniukų kalvė";BITUTĖS;6500641378;Taip;0;2;0;2
1801;"Geniukų kalvė";BITUTĖS;3984265624;Taip;0;7;0;7
1802;"Geniukų kalvė";BITUTĖS;4813232640;Taip;0;0;1;1
1803;"Geniukų kalvė";BITUTĖS;9676782662;Taip;5;2;0;7
1804;"Geniukų kalvė";BITUTĖS;1451190239;Taip;0;2;4;6
1805;"Geniukų kalvė";BITUTĖS;5542539934;Taip;0;2;1;3
1806;"Geniukų kalvė";BITUTĖS;2233161242;Taip;0;14;0;14
1807;"Geniukų kalvė";KIŠKUČIAI;1568133009;Taip;9;6;0;15
1808;"Geniukų kalvė";KIŠKUČIAI;7664689396;Taip;3;0;0;3
1809;"Geniukų kalvė";KIŠKUČIAI;4758435835;Taip;0;5;0;5
1810;"Geniukų kalvė";KIŠKUČIAI;23023070502;Taip;0;4;0;4
1811;"Geniukų kalvė";KIŠKUČIAI;2262014110;Taip;0;1;0;1
1812;"Geniukų kalvė";KIŠKUČIAI;1947173142;Taip;0;11;0;11
1813;"Geniukų kalvė";KIŠKUČIAI;43097490633;Taip;0;12;0;12
1814;"Geniukų kalvė";KIŠKUČIAI;2043786151;Taip;0;5;0;5
1815;"Geniukų kalvė";KIŠKUČIAI;1460456166;Taip;0;2;0;2
1816;"Geniukų kalvė";KIŠKUČIAI;2140334255;Ne;0;3;0;3
1817;"Geniukų kalvė";KIŠKUČIAI;2301758912;Taip;0;12;0;12
1818;"Geniukų kalvė";KIŠKUČIAI;8635708009;Taip;0;1;0;1
1819;"Geniukų kalvė";KIŠKUČIAI;9081596975;Taip;0;6;0;6
1820;"Geniukų kalvė";KIŠKUČIAI;30932565379;Taip;0;6;2;8
1821;"Geniukų kalvė";KIŠKUČIAI;2337226175;Taip;4;1;0;5
1822;"Geniukų kalvė";KIŠKUČIAI;8668696743;Ne;0;9;0;9
1823;"Geniukų kalvė";KIŠKUČIAI;7507857415;Taip;8;4;2;14
1824;"Geniukų kalvė";VYTURĖLIAI;1716204178;Taip;6;1;5;12
1825;"Geniukų kalvė";VYTURĖLIAI;83443339743;Taip;3;0;0;3
1826;"Geniukų kalvė";VYTURĖLIAI;3599151643;Taip;4;0;1;5
1827;"Geniukų kalvė";VYTURĖLIAI;3553253934;Taip;0;0;3;3
1828;"Geniukų kalvė";VYTURĖLIAI;1084055203;Taip;0;0;1;1
1829;"Geniukų kalvė";VYTURĖLIAI;1818485774;Taip;0;1;0;1
1830;"Geniukų kalvė";VYTURĖLIAI;1806626063;Taip;0;0;3;3
1831;"Geniukų kalvė";VYTURĖLIAI;1774738349;Taip;4;0;0;4
1832;"Geniukų kalvė";VYTURĖLIAI;2120890722;Taip;0;4;0;4
1833;"Geniukų kalvė";VYTURĖLIAI;2094764804;Taip;0;3;4;7
1834;"Geniukų kalvė";VYTURĖLIAI;87718471880;Taip;0;0;1;1
1835;"Geniukų kalvė";VYTURĖLIAI;90227736128;Taip;0;3;0;3
1836;"Geniukų kalvė";VYTURĖLIAI;37079991701;Taip;0;1;0;1
1837;"Geniukų kalvė";VYTURĖLIAI;1810973279;Taip;0;1;0;1
1838;"Geniukų kalvė";VYTURĖLIAI;5945583960;Taip;3;0;0;3
1839;"Geniukų kalvė";VYTURĖLIAI;5756909142;Taip;0;0;2;2
1840;"Geniukų kalvė";DRUGELIAI;45542289762;Taip;0;2;0;2
1841;"Geniukų kalvė";DRUGELIAI;65418822653;Taip;0;10;0;10
1842;"Geniukų kalvė";DRUGELIAI;2003986836;Taip;0;13;0;13
1843;"Geniukų kalvė";DRUGELIAI;19181427380;Taip;10;0;2;12
1844;"Geniukų kalvė";DRUGELIAI;42328019754;Taip;0;1;0;1
1845;"Geniukų kalvė";DRUGELIAI;5792552722;Taip;0;0;1;1
1846;"Geniukų kalvė";DRUGELIAI;1684481833;Taip;4;0;4;8
1847;"Geniukų kalvė";DRUGELIAI;14939415217;Taip;1;0;9;10
1848;"Geniukų kalvė";DRUGELIAI;82277353185;Taip;0;5;1;6
1849;"Geniukų kalvė";DRUGELIAI;84974376966;Taip;0;0;1;1
1850;"Geniukų kalvė";DRUGELIAI;67762121244;Taip;0;1;0;1
1851;"Geniukų kalvė";DRUGELIAI;1990303616;Taip;0;1;0;1
1852;"Geniukų kalvė";DRUGELIAI;23964009189;Taip;0;4;0;4
1853;"Geniukų kalvė";DRUGELIAI;6253940549;Taip;3;0;5;8
1854;"Geniukų kalvė";DRUGELIAI;93834840514;Taip;0;7;0;7
1855;"Geniukų kalvė";DRUGELIAI;44345867922;Taip;6;0;0;6
1856;"Geniukų kalvė";DRUGELIAI;97616612192;Taip;0;2;0;2
1857;"Geniukų kalvė";DRUGELIAI;1663744490;Taip;0;1;0;1
1858;"Geniukų kalvė";"SAULĖS ZUIKUČIAI";7082945033;Taip;0;1;0;1
1859;"Geniukų kalvė";"SAULĖS ZUIKUČIAI";2313382307;Taip;0;0;4;4
1860;"Geniukų kalvė";"SAULĖS ZUIKUČIAI";8309953586;Taip;0;5;0;5
1861;"Geniukų kalvė";"SAULĖS ZUIKUČIAI";1443348537;Taip;0;11;0;11
1862;"Geniukų kalvė";"SAULĖS ZUIKUČIAI";2783285969;Taip;0;5;4;9
1863;"Geniukų kalvė";"SAULĖS ZUIKUČIAI";7500079028;Taip;0;6;0;6
1864;"Geniukų kalvė";"SAULĖS ZUIKUČIAI";8071493871;Taip;0;13;0;13
1865;"Geniukų kalvė";"SAULĖS ZUIKUČIAI";1718428600;Taip;0;0;1;1
1866;"Geniukų kalvė";"SAULĖS ZUIKUČIAI";6016585056;Taip;4;4;1;9
1867;"Geniukų kalvė";"SAULĖS ZUIKUČIAI";2816691996;Taip;10;8;0;18
1868;"Geniukų kalvė";"SAULĖS ZUIKUČIAI";5512172533;Taip;0;7;0;7
1869;"Geniukų kalvė";"SAULĖS ZUIKUČIAI";1375674317;Taip;0;4;0;4
1870;"Geniukų kalvė";"SAULĖS ZUIKUČIAI";4722801116;Taip;0;1;2;3
1871;"Geniukų kalvė";"SAULĖS ZUIKUČIAI";5763009912;Taip;0;1;0;1
1872;"Geniukų kalvė";"SAULĖS ZUIKUČIAI";5245434552;Taip;0;1;0;1
1873;"Geniukų kalvė";"SAULĖS ZUIKUČIAI";5725034297;Taip;2;3;0;5
1874;"Geniukų kalvė";"SAULĖS ZUIKUČIAI";1499735818;Taip;15;3;0;18
1875;"Geniukų kalvė";"SAULĖS ZUIKUČIAI";4186376527;Taip;0;1;0;1
1876;"Geniukų kalvė";SMALSUČIAI;5974481787;Taip;22;0;0;22
1877;"Geniukų kalvė";SMALSUČIAI;7915720190;Taip;10;0;0;10
1878;"Geniukų kalvė";SMALSUČIAI;5129841490;Taip;5;0;0;5
1879;"Geniukų kalvė";SMALSUČIAI;5705917381;Taip;3;0;0;3
1880;"Geniukų kalvė";SMALSUČIAI;4231659246;Taip;3;0;0;3
1881;"Geniukų kalvė";SMALSUČIAI;2300947427;Taip;0;1;0;1
1882;"Geniukų kalvė";SMALSUČIAI;1028242614;Taip;9;1;0;10
1883;"Geniukų kalvė";SMALSUČIAI;6730270449;Taip;12;10;0;22
1884;"Geniukų kalvė";SMALSUČIAI;4405381922;Taip;6;0;0;6
1885;"Geniukų kalvė";SMALSUČIAI;6473724074;Taip;0;11;0;11
1886;"Geniukų kalvė";SMALSUČIAI;1896980533;Taip;0;1;0;1
1887;"Geniukų kalvė";SMALSUČIAI;9155681194;Taip;0;0;1;1
1888;"Geniukų kalvė";SMALSUČIAI;7440029486;Taip;0;2;0;2
1889;"Geniukų kalvė";SMALSUČIAI;6168422514;Taip;22;0;0;22
1890;"Geniukų kalvė";RUDNOSIUKAI;7079072084;Taip;0;10;0;10
1891;"Geniukų kalvė";RUDNOSIUKAI;6060825704;Taip;0;10;2;12
1892;"Geniukų kalvė";RUDNOSIUKAI;6149037133;Taip;0;0;2;2
1893;"Geniukų kalvė";RUDNOSIUKAI;5883913787;Taip;11;0;0;11
1894;"Geniukų kalvė";RUDNOSIUKAI;9696452101;Taip;0;0;1;1
1895;"Geniukų kalvė";RUDNOSIUKAI;5205178173;Taip;0;8;4;12
1896;"Geniukų kalvė";RUDNOSIUKAI;2836282651;Taip;2;2;0;4
1897;"Geniukų kalvė";RUDNOSIUKAI;9847003556;Taip;0;2;0;2
1898;"Geniukų kalvė";RUDNOSIUKAI;7300853810;Taip;0;0;1;1
1899;"Geniukų kalvė";RUDNOSIUKAI;4664026888;Taip;3;0;0;3
1900;"Geniukų kalvė";RUDNOSIUKAI;3852896932;Taip;0;1;4;5
1901;"Geniukų kalvė";RUDNOSIUKAI;1229056613;Taip;0;11;4;15
1902;"Geniukų kalvė";RUDNOSIUKAI;2165793561;Taip;0;9;0;9
1903;"Geniukų kalvė";RUDNOSIUKAI;8973285553;Taip;5;3;0;8
1904;"Geniukų kalvė";RUDNOSIUKAI;4985606198;Taip;13;0;0;13
1905;"Geniukų kalvė";RUDNOSIUKAI;2798750158;Taip;0;1;0;1
1906;"Geniukų kalvė";RUDNOSIUKAI;9107114221;Ne;5;0;2;7
1907;"Geniukų kalvė";PELĖDŽIUKAI;2217221922;Taip;0;5;0;5
1908;"Geniukų kalvė";PELĖDŽIUKAI;3826265557;Ne;0;1;2;3
1909;"Geniukų kalvė";PELĖDŽIUKAI;8271041553;Taip;0;8;0;8
1910;"Geniukų kalvė";PELĖDŽIUKAI;1237228692;Taip;5;0;0;5
1911;"Geniukų kalvė";PELĖDŽIUKAI;9976423099;Taip;4;4;4;12
1912;"Geniukų kalvė";PELĖDŽIUKAI;1051563985;Taip;0;9;0;9
1913;"Geniukų kalvė";PELĖDŽIUKAI;6174114461;Taip;6;0;0;6
1914;"Geniukų kalvė";PELĖDŽIUKAI;6737863183;Taip;0;9;5;14
1915;"Geniukų kalvė";PELĖDŽIUKAI;5704223824;Taip;0;3;0;3
1916;"Geniukų kalvė";PELĖDŽIUKAI;1811866428;Ne;0;7;0;7
1917;"Geniukų kalvė";PELĖDŽIUKAI;6410008429;Taip;0;1;0;1
1918;"Geniukų kalvė";PELĖDŽIUKAI;8770345339;Taip;3;8;6;17
1919;"Geniukų kalvė";PELĖDŽIUKAI;5146141771;Taip;9;1;0;10
1920;"Geniukų kalvė";PELĖDŽIUKAI;1611845627;Taip;5;0;1;6
1921;"Geniukų kalvė";PELĖDŽIUKAI;9677583445;Taip;4;3;0;7
1922;"Geniukų kalvė";PELĖDŽIUKAI;6237208661;Taip;8;0;0;8
1923;"Geniukų kalvė";BORUŽĖLĖS;4958738745;Taip;0;3;0;3
1924;"Geniukų kalvė";BORUŽĖLĖS;9069256760;Taip;8;0;0;8
1925;"Geniukų kalvė";BORUŽĖLĖS;5161535756;Taip;11;2;0;13
1926;"Geniukų kalvė";BORUŽĖLĖS;3493492581;Taip;0;1;0;1
1927;"Geniukų kalvė";BORUŽĖLĖS;3085228868;Taip;0;2;5;7
1928;"Geniukų kalvė";BORUŽĖLĖS;4777155321;Taip;5;1;0;6
1929;"Geniukų kalvė";BORUŽĖLĖS;1037854104;Taip;3;2;1;6
1930;"Geniukų kalvė";BORUŽĖLĖS;2180860623;Ne;0;1;0;1
1931;"Geniukų kalvė";BORUŽĖLĖS;8769761434;Taip;4;0;2;6
1932;"Geniukų kalvė";BORUŽĖLĖS;9643242164;Taip;5;3;0;8
1933;"Geniukų kalvė";BORUŽĖLĖS;2665955524;Taip;0;2;0;2
1934;"Geniukų kalvė";BORUŽĖLĖS;3297360222;Taip;0;2;4;6
1935;"Geniukų kalvė";BORUŽĖLĖS;6828079735;Taip;3;0;0;3
1936;"Geniukų kalvė";BORUŽĖLĖS;2710207578;Taip;0;2;0;2
1937;"Geniukų kalvė";BORUŽĖLĖS;1046406910;Taip;0;0;2;2
1938;"Geniukų kalvė";BORUŽĖLĖS;1454724752;Taip;1;0;0;1
1939;"Geniukų kalvė";PAGRANDUKAI;7784155503;Taip;0;0;3;3
1940;"Geniukų kalvė";PAGRANDUKAI;4507631652;Taip;0;3;0;3
1941;"Geniukų kalvė";PAGRANDUKAI;5604315555;Taip;0;0;2;2
1942;"Geniukų kalvė";PAGRANDUKAI;9543553237;Taip;5;0;0;5
1943;"Geniukų kalvė";PAGRANDUKAI;2032408983;Taip;5;0;0;5
1944;"Geniukų kalvė";PAGRANDUKAI;9041901202;Taip;11;3;0;14
1945;"Geniukų kalvė";PAGRANDUKAI;5078771341;Taip;7;5;0;12
1946;"Geniukų kalvė";PAGRANDUKAI;9075192344;Taip;8;7;0;15
1947;"Geniukų kalvė";PAGRANDUKAI;9730758999;Taip;8;0;0;8
1948;"Geniukų kalvė";PAGRANDUKAI;4864216994;Taip;4;0;2;6
1949;"Geniukų kalvė";PAGRANDUKAI;4639389587;Taip;0;0;1;1
1950;"Geniukų kalvė";PAGRANDUKAI;3676717541;Taip;11;0;0;11
1951;"Geniukų kalvė";PAGRANDUKAI;9579750299;Taip;2;5;0;7
1952;"Geniukų kalvė";PAGRANDUKAI;1945456486;Taip;0;2;0;2
1953;"Geniukų kalvė";PAGRANDUKAI;3221034847;Taip;8;4;0;12
1954;"Geniukų kalvė";PAGRANDUKAI;1844495906;Taip;5;7;0;12
1955;"Geniukų kalvė";PAGRANDUKAI;9386761753;Taip;3;6;1;10
1956;"Geniukų kalvė";NYKŠTUKAI;4633553106;Taip;2;0;0;2
1957;"Geniukų kalvė";NYKŠTUKAI;7744441981;Taip;3;0;3;6
1958;"Geniukų kalvė";NYKŠTUKAI;1209268848;Taip;5;0;3;8
1959;"Geniukų kalvė";NYKŠTUKAI;2110578252;Taip;12;0;0;12
1960;"Geniukų kalvė";NYKŠTUKAI;3669378459;Taip;8;2;0;10
1961;"Geniukų kalvė";NYKŠTUKAI;1492140432;Taip;22;0;0;22
1962;"Geniukų kalvė";NYKŠTUKAI;4201333532;Taip;11;0;0;11
1963;"Geniukų kalvė";NYKŠTUKAI;9455124402;Taip;3;10;0;13
1964;"Geniukų kalvė";NYKŠTUKAI;5102325807;Taip;0;6;0;6
1965;"Geniukų kalvė";NYKŠTUKAI;8570015975;Taip;0;10;1;11
1966;"Geniukų kalvė";NYKŠTUKAI;7453065865;Taip;8;0;1;9
1967;"Geniukų kalvė";NYKŠTUKAI;7747615302;Taip;0;7;0;7
1968;"Geniukų kalvė";NYKŠTUKAI;6351861630;Taip;11;0;0;11
1969;"Geniukų kalvė";NYKŠTUKAI;4691978116;Taip;13;0;0;13
1970;"Geniukų kalvė";NYKŠTUKAI;6111168227;Taip;1;3;1;5
1971;Gelvonėlis;ĄŽUOLIUKAI;7919814808;Taip;0;18;0;18
1972;Gelvonėlis;ĄŽUOLIUKAI;9323579468;Taip;3;0;0;3
1973;Gelvonėlis;ĄŽUOLIUKAI;3830940009;Taip;0;3;0;3
1974;Gelvonėlis;ĄŽUOLIUKAI;2742000725;Taip;0;8;0;8
1975;Gelvonėlis;ĄŽUOLIUKAI;3147489259;Taip;0;2;0;2
1976;Gelvonėlis;ĄŽUOLIUKAI;1284359362;Taip;0;5;0;5
1977;Gelvonėlis;ĄŽUOLIUKAI;8775661719;Taip;3;2;2;7
1978;Gelvonėlis;ĄŽUOLIUKAI;21684706944;Taip;0;7;0;7
1979;Gelvonėlis;ĄŽUOLIUKAI;75676389361;Taip;0;0;6;6
1980;Gelvonėlis;ĄŽUOLIUKAI;2077783219;Taip;0;1;0;1
1981;Gelvonėlis;ĄŽUOLIUKAI;3089755141;Taip;0;8;0;8
1982;Gelvonėlis;ĄŽUOLIUKAI;1408313697;Taip;0;0;2;2
1983;Gelvonėlis;ĄŽUOLIUKAI;3670612781;Taip;0;5;0;5
1984;Gelvonėlis;ĄŽUOLIUKAI;69073786634;Taip;0;4;0;4
1985;Gelvonėlis;ĄŽUOLIUKAI;29928181395;Taip;0;0;1;1
1986;Gelvonėlis;ĄŽUOLIUKAI;6255253658;Taip;3;0;0;3
1987;Gelvonėlis;ĄŽUOLIUKAI;5511174729;Ne;0;0;6;6
1988;Gelvonėlis;ĄŽUOLIUKAI;4855800131;Taip;0;0;1;1
1989;Gelvonėlis;ŽVIRBLIUKAI;6604992169;Taip;0;5;0;5
1990;Gelvonėlis;ŽVIRBLIUKAI;6556472766;Taip;0;4;1;5
1991;Gelvonėlis;ŽVIRBLIUKAI;7182180008;Taip;0;4;1;5
1992;Gelvonėlis;ŽVIRBLIUKAI;8885088900;Taip;0;6;0;6
1993;Gelvonėlis;ŽVIRBLIUKAI;2400289466;Taip;0;0;3;3
1994;Gelvonėlis;ŽVIRBLIUKAI;9493536517;Taip;7;0;1;8
1995;Gelvonėlis;ŽVIRBLIUKAI;9059244134;Taip;0;1;0;1
1996;Gelvonėlis;ŽVIRBLIUKAI;1987204544;Taip;0;12;0;12
1997;Gelvonėlis;ŽVIRBLIUKAI;2515471132;Taip;0;0;10;10
1998;Gelvonėlis;ŽVIRBLIUKAI;1085845218;Taip;4;0;0;4
1999;Gelvonėlis;ŽVIRBLIUKAI;6319058542;Taip;0;1;0;1
2000;Gelvonėlis;ŽVIRBLIUKAI;9538571448;Taip;8;6;0;14
2001;Gelvonėlis;ŽVIRBLIUKAI;9147186080;Taip;0;2;0;2
2002;Gelvonėlis;ŽVIRBLIUKAI;7195164378;Taip;8;0;1;9
2003;Gelvonėlis;ŽVIRBLIUKAI;6598178467;Taip;0;1;7;8
2004;Gelvonėlis;ŽVIRBLIUKAI;6068473734;Taip;4;0;0;4
2005;Gelvonėlis;RASELĖS;9847156800;Ne;0;5;0;5
2006;Gelvonėlis;RASELĖS;9108760720;Taip;0;5;0;5
2007;Gelvonėlis;RASELĖS;9387523651;Ne;0;11;0;11
2008;Gelvonėlis;RASELĖS;1597669426;Taip;0;10;0;10
2009;Gelvonėlis;RASELĖS;30812081628;Taip;0;0;2;2
2010;Gelvonėlis;RASELĖS;6256962184;Taip;0;0;22;22
2011;Gelvonėlis;RASELĖS;1610362831;Taip;0;9;0;9
2012;Gelvonėlis;RASELĖS;12715604772;Taip;0;5;0;5
2013;Gelvonėlis;RASELĖS;8050788182;Taip;0;0;6;6
2014;Gelvonėlis;RASELĖS;4917453676;Taip;0;0;1;1
2015;Gelvonėlis;RASELĖS;31744699590;Taip;5;0;0;5
2016;Gelvonėlis;RASELĖS;1030246127;Taip;3;1;0;4
2017;Gelvonėlis;RASELĖS;9777094764;Taip;0;4;0;4
2018;Gelvonėlis;RASELĖS;3379601736;Taip;0;9;0;9
2019;Gelvonėlis;RASELĖS;43407309643;Taip;0;1;0;1
2020;Gelvonėlis;SAULUTĖ;9396676137;Taip;6;0;0;6
2021;Gelvonėlis;SAULUTĖ;9353066785;Taip;3;0;1;4
2022;Gelvonėlis;SAULUTĖ;3121251271;Taip;0;2;0;2
2023;Gelvonėlis;SAULUTĖ;8475204684;Ne;0;8;0;8
2024;Gelvonėlis;SAULUTĖ;7392743619;Taip;10;0;1;11
2025;Gelvonėlis;SAULUTĖ;8228796927;Taip;0;0;1;1
2026;Gelvonėlis;SAULUTĖ;4550077609;Taip;0;0;4;4
2027;Gelvonėlis;SAULUTĖ;1734685590;Taip;6;0;7;13
2028;Gelvonėlis;SAULUTĖ;7936622964;Taip;0;2;0;2
2029;Gelvonėlis;SAULUTĖ;3719670896;Taip;0;3;0;3
2030;Gelvonėlis;PELĖDŽIUKAI;1373771258;Taip;0;4;0;4
2031;Gelvonėlis;PELĖDŽIUKAI;1772713183;Taip;8;0;0;8
2032;Gelvonėlis;PELĖDŽIUKAI;2997738880;Taip;0;0;4;4
2033;Gelvonėlis;PELĖDŽIUKAI;1355742622;Taip;0;5;0;5
2034;Gelvonėlis;PELĖDŽIUKAI;23181505838;Taip;0;11;0;11
2035;Gelvonėlis;PELĖDŽIUKAI;21250325232;Taip;0;7;0;7
2036;Gelvonėlis;PELĖDŽIUKAI;2096702999;Taip;0;6;0;6
2037;Gelvonėlis;PELĖDŽIUKAI;9919860358;Taip;0;1;0;1
2038;Gelvonėlis;PELĖDŽIUKAI;1835508505;Taip;0;0;2;2
2039;Gelvonėlis;PELĖDŽIUKAI;87746258537;Taip;0;5;0;5
2040;Gelvonėlis;PELĖDŽIUKAI;9784762153;Taip;0;0;1;1
2041;Gelvonėlis;PELĖDŽIUKAI;86895427397;Taip;4;0;0;4
2042;Gelvonėlis;PELĖDŽIUKAI;90961913967;Taip;0;0;2;2
2043;Gelvonėlis;PELĖDŽIUKAI;6635285387;Taip;0;0;2;2
2044;Gelvonėlis;PELĖDŽIUKAI;92420286100;Taip;0;1;4;5
2045;Gelvonėlis;DRUGELIAI;5305480599;Taip;3;0;0;3
2046;Gelvonėlis;DRUGELIAI;5633162524;Taip;0;5;0;5
2047;Gelvonėlis;DRUGELIAI;8792171281;Taip;3;0;0;3
2048;Gelvonėlis;DRUGELIAI;5598186460;Taip;3;1;0;4
2049;Gelvonėlis;DRUGELIAI;4268590631;Taip;8;0;0;8
2050;Gelvonėlis;DRUGELIAI;1939318286;Taip;0;1;0;1
2051;Gelvonėlis;DRUGELIAI;2847839917;Taip;18;0;0;18
2052;Gelvonėlis;DRUGELIAI;3514762919;Taip;0;6;0;6
2053;Gelvonėlis;DRUGELIAI;3687250255;Taip;3;6;0;9
2054;Gelvonėlis;DRUGELIAI;5281400074;Taip;9;10;0;19
2055;Gelvonėlis;DRUGELIAI;2452711535;Taip;6;0;0;6
2056;Gelvonėlis;DRUGELIAI;1980703633;Taip;0;3;0;3
2057;Gelvonėlis;DRUGELIAI;9767254134;Taip;13;0;0;13
2058;Gelvonėlis;DRUGELIAI;6330751030;Taip;6;0;0;6
2059;Gelvonėlis;DRUGELIAI;6710189985;Taip;8;0;0;8
2060;Gelvonėlis;DRUGELIAI;3371560338;Taip;8;0;0;8
2061;Gelvonėlis;VARPELIAI;9149117970;Taip;9;3;0;12
2062;Gelvonėlis;VARPELIAI;3483144401;Taip;0;0;2;2
2063;Gelvonėlis;VARPELIAI;6451557430;Taip;0;9;0;9
2064;Gelvonėlis;VARPELIAI;6225854165;Taip;0;0;1;1
2065;Gelvonėlis;VARPELIAI;2638430817;Taip;0;0;11;11
2066;Gelvonėlis;VARPELIAI;9600526942;Taip;0;12;0;12
2067;Gelvonėlis;VARPELIAI;1387948936;Taip;0;8;0;8
2068;Gelvonėlis;VARPELIAI;1462716950;Taip;1;7;0;8
2069;Gelvonėlis;VARPELIAI;6949090250;Taip;19;0;0;19
2070;Gelvonėlis;VARPELIAI;9622818893;Taip;11;0;0;11
2071;Gelvonėlis;VARPELIAI;3446593424;Taip;9;0;1;10
2072;Gelvonėlis;VARPELIAI;6869418701;Taip;3;0;2;5
2073;Gelvonėlis;VARPELIAI;5207153784;Taip;0;0;3;3
2074;Gelvonėlis;VARPELIAI;6226970200;Taip;0;0;2;2
2075;Gelvonėlis;VARPELIAI;9963769327;Taip;4;0;0;4
2076;Gelvonėlis;BORUŽĖLĖS;8209225630;Taip;10;0;0;10
2077;Gelvonėlis;BORUŽĖLĖS;6554989142;Ne;5;1;2;8
2078;Gelvonėlis;BORUŽĖLĖS;8056058298;Taip;0;1;0;1
2079;Gelvonėlis;BORUŽĖLĖS;2434789595;Taip;3;0;0;3
2080;Gelvonėlis;BORUŽĖLĖS;4112607183;Taip;0;0;4;4
2081;Gelvonėlis;BORUŽĖLĖS;6243360625;Taip;0;11;0;11
2082;Gelvonėlis;BORUŽĖLĖS;5790038422;Taip;0;4;0;4
2083;Gelvonėlis;BORUŽĖLĖS;8515746171;Taip;9;2;0;11
2084;Gelvonėlis;BORUŽĖLĖS;1712926391;Taip;10;0;5;15
2085;Gelvonėlis;BORUŽĖLĖS;6647585785;Taip;13;0;0;13
2086;Gelvonėlis;BORUŽĖLĖS;1539850989;Taip;5;0;1;6
2087;Gelvonėlis;BORUŽĖLĖS;1107633909;Ne;0;12;0;12
2088;Gelvonėlis;BORUŽĖLĖS;8973272332;Taip;8;0;0;8
2089;Gelvonėlis;BORUŽĖLĖS;9849765037;Taip;8;1;0;9
2090;Gelvonėlis;BORUŽĖLĖS;4749071286;Taip;0;3;0;3
2091;Gelvonėlis;BORUŽĖLĖS;8806934077;Taip;13;0;0;13
2092;Gelvonėlis;BORUŽĖLĖS;6534527571;Taip;5;6;0;11
2093;Gelvonėlis;BORUŽĖLĖS;3926733474;Taip;0;0;11;11
2094;Gelvonėlis;NYKŠTUKAI;8987012601;Taip;18;0;0;18
2095;Gelvonėlis;NYKŠTUKAI;7632523330;Taip;0;0;2;2
2096;Gelvonėlis;NYKŠTUKAI;1112841066;Taip;6;0;3;9
2097;Gelvonėlis;NYKŠTUKAI;2553846157;Taip;0;0;1;1
2098;Gelvonėlis;NYKŠTUKAI;8003522011;Taip;3;1;0;4
2099;Gelvonėlis;NYKŠTUKAI;5713586282;Taip;0;10;0;10
2100;Gelvonėlis;NYKŠTUKAI;3217646353;Taip;0;7;0;7
2101;Gelvonėlis;NYKŠTUKAI;8560940316;Taip;3;8;0;11
2102;Gelvonėlis;NYKŠTUKAI;8540204705;Taip;0;1;0;1
2103;Gelvonėlis;NYKŠTUKAI;8124516993;Taip;0;0;10;10
2104;Gelvonėlis;NYKŠTUKAI;9751580494;Taip;5;0;1;6
2105;Gelvonėlis;NYKŠTUKAI;4156493586;Taip;3;0;1;4
2106;Gelvonėlis;NYKŠTUKAI;5124211917;Taip;0;2;0;2
2107;Gelvonėlis;BITUTĖS;7759317220;Taip;0;5;0;5
2108;Gelvonėlis;BITUTĖS;7983982378;Taip;0;12;0;12
2109;Gelvonėlis;BITUTĖS;5721858659;Taip;0;5;0;5
2110;Gelvonėlis;BITUTĖS;9667024635;Taip;5;0;3;8
2111;Gelvonėlis;BITUTĖS;1753617545;Taip;0;4;0;4
2112;Gelvonėlis;BITUTĖS;6317822775;Taip;0;0;4;4
2113;Gelvonėlis;BITUTĖS;9184192787;Taip;0;17;0;17
2114;Gelvonėlis;BITUTĖS;9369121356;Taip;0;0;1;1
2115;Gelvonėlis;BITUTĖS;2119550116;Taip;0;0;1;1
2116;Gelvonėlis;BITUTĖS;5047022305;Taip;6;0;0;6
2117;Gelvonėlis;RAMUNĖLĖS;7449710008;Taip;0;8;0;8
2118;Gelvonėlis;RAMUNĖLĖS;2329699993;Taip;4;0;0;4
2119;Gelvonėlis;RAMUNĖLĖS;3677100165;Taip;0;0;3;3
2120;Gelvonėlis;RAMUNĖLĖS;5368171142;Taip;0;9;0;9
2121;Gelvonėlis;RAMUNĖLĖS;9492898584;Taip;0;8;0;8
2122;Gelvonėlis;RAMUNĖLĖS;7070038335;Taip;0;8;0;8
2123;Gelvonėlis;RAMUNĖLĖS;3942630720;Taip;0;0;22;22
2124;Gelvonėlis;RAMUNĖLĖS;1453271708;Taip;3;1;0;4
2125;Gelvonėlis;RAMUNĖLĖS;9756155028;Taip;12;0;0;12
2126;Gelvonėlis;RAMUNĖLĖS;3165015754;Taip;2;0;0;2
2127;Gelvonėlis;RAMUNĖLĖS;1274119900;Taip;0;8;0;8
2128;Gelvonėlis;RAMUNĖLĖS;1403890893;Taip;5;5;0;10
2129;Gelvonėlis;RAMUNĖLĖS;5901499708;Taip;0;6;1;7
2130;Gelvonėlis;RAMUNĖLĖS;9058956012;Taip;0;0;15;15
2131;Gelvonėlis;RIEŠUTĖLIAI;3973248307;Taip;0;0;2;2
2132;Gelvonėlis;RIEŠUTĖLIAI;5461812139;Taip;0;15;2;17
2133;Gelvonėlis;RIEŠUTĖLIAI;5986018609;Taip;0;1;1;2
2134;Gelvonėlis;RIEŠUTĖLIAI;8532801167;Ne;0;0;1;1
2135;Gelvonėlis;RIEŠUTĖLIAI;4208103106;Taip;6;0;0;6
2136;Gelvonėlis;RIEŠUTĖLIAI;6305084811;Taip;3;0;0;3
2137;Gelvonėlis;RIEŠUTĖLIAI;2005647155;Taip;0;1;0;1
2138;Gelvonėlis;RIEŠUTĖLIAI;1266479895;Taip;0;4;0;4
2139;Gelvonėlis;RIEŠUTĖLIAI;5934077931;Taip;0;0;1;1
2140;Gelvonėlis;RIEŠUTĖLIAI;4280463938;Taip;0;4;0;4
2141;Gelvonėlis;RIEŠUTĖLIAI;6471921512;Taip;5;0;0;5
2142;Gelvonėlis;RIEŠUTĖLIAI;3448444552;Taip;0;0;1;1
2143;Gelvonėlis;RIEŠUTĖLIAI;4832167372;Taip;0;12;0;12
2144;Gelvonėlis;RIEŠUTĖLIAI;9301814935;Taip;0;5;0;5
2145;Gelvonėlis;RIEŠUTĖLIAI;1466616814;Taip;0;0;6;6
2146;Gelvonėlis;RIEŠUTĖLIAI;2015807805;Taip;17;0;0;17
2147;Gelvonėlis;RIEŠUTĖLIAI;9323228591;Taip;0;0;1;1
2148;"Gervelė (Dzūkų g. 32)";ŽIRNIUKAI;1353920541;Taip;0;6;0;6
2149;"Gervelė (Dzūkų g. 32)";ŽIRNIUKAI;8273301992;Taip;0;5;0;5
2150;"Gervelė (Dzūkų g. 32)";ŽIRNIUKAI;6834663627;Taip;0;17;2;19
2151;"Gervelė (Dzūkų g. 32)";ŽIRNIUKAI;2446758975;Taip;5;4;0;9
2152;"Gervelė (Dzūkų g. 32)";ŽIRNIUKAI;7924884022;Taip;0;10;0;10
2153;"Gervelė (Dzūkų g. 32)";ŽIRNIUKAI;1637204236;Taip;0;0;1;1
2154;"Gervelė (Dzūkų g. 32)";ŽIRNIUKAI;1323074335;Taip;0;1;3;4
2155;"Gervelė (Dzūkų g. 32)";ŽIRNIUKAI;6058944385;Taip;0;8;0;8
2156;"Gervelė (Dzūkų g. 32)";ŽIRNIUKAI;5767158743;Taip;0;13;0;13
2157;"Gervelė (Dzūkų g. 32)";ŽIRNIUKAI;2523056808;Taip;0;0;1;1
2158;"Gervelė (Dzūkų g. 32)";ŽIRNIUKAI;8533480337;Taip;0;4;0;4
2159;"Gervelė (Dzūkų g. 32)";ŽIRNIUKAI;6895415337;Taip;5;0;2;7
2160;"Gervelė (Dzūkų g. 32)";ŽIRNIUKAI;6227091658;Taip;12;2;0;14
2161;"Gervelė (Dzūkų g. 32)";LAŠIUKAI;1160084928;Taip;5;0;0;5
2162;"Gervelė (Dzūkų g. 32)";LAŠIUKAI;3333885493;Taip;0;11;0;11
2163;"Gervelė (Dzūkų g. 32)";LAŠIUKAI;4394752176;Taip;3;0;0;3
2164;"Gervelė (Dzūkų g. 32)";LAŠIUKAI;6228025635;Taip;4;0;0;4
2165;"Gervelė (Dzūkų g. 32)";LAŠIUKAI;9977349707;Taip;0;10;0;10
2166;"Gervelė (Dzūkų g. 32)";LAŠIUKAI;4295743997;Ne;6;6;0;12
2167;"Gervelė (Dzūkų g. 32)";LAŠIUKAI;7935059565;Taip;0;1;0;1
2168;"Gervelė (Dzūkų g. 32)";LAŠIUKAI;5267617723;Taip;0;1;0;1
2169;"Gervelė (Dzūkų g. 32)";LAŠIUKAI;6263562066;Ne;0;1;0;1
2170;"Gervelė (Dzūkų g. 32)";LAŠIUKAI;4038179503;Taip;13;3;0;16
2171;"Gervelė (Dzūkų g. 32)";LAŠIUKAI;8016341646;Taip;0;2;0;2
2172;"Gervelė (Dzūkų g. 32)";LAŠIUKAI;6155979185;Taip;7;6;0;13
2173;"Gervelė (Dzūkų g. 32)";LAŠIUKAI;3449674095;Ne;3;1;0;4
2174;"Gervelė (Dzūkų g. 32)";LAŠIUKAI;3702908570;Taip;0;0;3;3
2175;"Gervelė (Dzūkų g. 32)";LAŠIUKAI;4294916559;Taip;5;3;0;8
2176;"Gervelė (Dzūkų g. 32)";LAŠIUKAI;3647044817;Taip;3;0;0;3
2177;"Gervelė (Dzūkų g. 32)";LAŠIUKAI;6431701403;Taip;10;0;1;11
2178;"Gervelė (Dzūkų g. 32)";LAŠIUKAI;7721421570;Taip;0;4;1;5
2179;"Gervelė (Dzūkų g. 32)";LAŠIUKAI;2413995770;Taip;0;0;1;1
2180;"Gervelė (Dzūkų g. 32)";LAŠIUKAI;5953552777;Taip;5;8;0;13
2181;"Gervelė (Dzūkų g. 32)";PABIRUČIAI;9970293084;Taip;0;3;0;3
2182;"Gervelė (Dzūkų g. 32)";PABIRUČIAI;7162551366;Taip;0;22;0;22
2183;"Gervelė (Dzūkų g. 32)";PABIRUČIAI;1616949023;Taip;0;7;0;7
2184;"Gervelė (Dzūkų g. 32)";PABIRUČIAI;3427400844;Taip;0;5;0;5
2185;"Gervelė (Dzūkų g. 32)";PABIRUČIAI;8152446576;Taip;0;0;3;3
2186;"Gervelė (Dzūkų g. 32)";PABIRUČIAI;7302238728;Ne;0;4;0;4
2187;"Gervelė (Dzūkų g. 32)";PABIRUČIAI;8062089041;Taip;0;3;0;3
2188;"Gervelė (Dzūkų g. 32)";PABIRUČIAI;7697761552;Taip;0;6;3;9
2189;"Gervelė (Dzūkų g. 32)";PABIRUČIAI;5989713844;Taip;0;2;0;2
2190;"Gervelė (Dzūkų g. 32)";PABIRUČIAI;4560752068;Taip;0;20;0;20
2191;"Gervelė (Dzūkų g. 32)";PABIRUČIAI;4705514590;Taip;0;0;4;4
2192;"Gervelė (Dzūkų g. 32)";PABIRUČIAI;89076506192;Taip;0;0;1;1
2193;"Gervelė (Dzūkų g. 32)";PABIRUČIAI;87619285504;Taip;0;0;9;9
2194;"Gervelė (Dzūkų g. 32)";PABIRUČIAI;1991238577;Taip;0;8;0;8
2195;"Gervelė (Dzūkų g. 32)";PABIRUČIAI;2167744244;Taip;4;4;0;8
2196;"Gervelė (Dzūkų g. 32)";PABIRUČIAI;3525060645;Taip;0;7;0;7
2197;"Gervelė (Dzūkų g. 32)";PABIRUČIAI;7317091881;Taip;0;0;13;13
2198;"Gervelė (Dzūkų g. 32)";PABIRUČIAI;7020599764;Taip;3;0;0;3
2199;"Gervelė (Dzūkų g. 32)";PABIRUČIAI;1400044294;Taip;0;0;1;1
2200;"Gervelė (Dzūkų g. 32)";PABIRUČIAI;1112844296;Taip;0;0;6;6
2201;"Gervelė (Dzūkų g. 32)";PABIRUČIAI;6287806975;Taip;0;0;4;4
2202;"Gervelė (Dzūkų g. 32)";BITUTĖS;49013139623;Taip;0;0;1;1
2203;"Gervelė (Dzūkų g. 32)";BITUTĖS;1697536098;Taip;0;3;0;3
2204;"Gervelė (Dzūkų g. 32)";BITUTĖS;1617055167;Taip;3;0;2;5
2205;"Gervelė (Dzūkų g. 32)";BITUTĖS;1492459180;Taip;0;3;1;4
2206;"Gervelė (Dzūkų g. 32)";BITUTĖS;1921567602;Ne;3;0;0;3
2207;"Gervelė (Dzūkų g. 32)";BITUTĖS;62782512806;Taip;0;1;0;1
2208;"Gervelė (Dzūkų g. 32)";BITUTĖS;3278950938;Taip;0;8;0;8
2209;"Gervelė (Dzūkų g. 32)";BITUTĖS;88273293270;Taip;0;0;2;2
2210;"Gervelė (Dzūkų g. 32)";BITUTĖS;6349428106;Ne;0;11;0;11
2211;"Gervelė (Dzūkų g. 32)";BITUTĖS;2019214634;Taip;0;0;1;1
2212;"Gervelė (Dzūkų g. 32)";BITUTĖS;2798349541;Ne;0;6;0;6
2213;"Gervelė (Dzūkų g. 32)";BITUTĖS;8035942210;Taip;0;8;0;8
2214;"Gervelė (Dzūkų g. 32)";BURATINO;1815418720;Taip;0;10;0;10
2215;"Gervelė (Dzūkų g. 32)";BURATINO;92859033264;Taip;0;9;0;9
2216;"Gervelė (Dzūkų g. 32)";BURATINO;3946391650;Taip;0;4;0;4
2217;"Gervelė (Dzūkų g. 32)";BURATINO;7620764911;Taip;4;0;3;7
2218;"Gervelė (Dzūkų g. 32)";BURATINO;5440557094;Taip;0;3;0;3
2219;"Gervelė (Dzūkų g. 32)";BURATINO;2646901307;Taip;22;0;0;22
2220;"Gervelė (Dzūkų g. 32)";BURATINO;9239897472;Taip;0;11;0;11
2221;"Gervelė (Dzūkų g. 32)";BURATINO;8997525194;Taip;11;0;0;11
2222;"Gervelė (Dzūkų g. 32)";BURATINO;5000209135;Taip;0;0;2;2
2223;"Gervelė (Dzūkų g. 32)";BURATINO;3359793310;Taip;0;0;2;2
2224;"Gervelė (Dzūkų g. 32)";BURATINO;9982951468;Taip;10;5;0;15
2225;"Gervelė (Dzūkų g. 32)";BURATINO;5900623823;Taip;0;10;0;10
2226;"Gervelė (Dzūkų g. 32)";BURATINO;4775822341;Taip;0;15;0;15
2227;"Gervelė (Dzūkų g. 32)";BURATINO;8012122042;Taip;0;8;0;8
2228;"Gervelė (Dzūkų g. 32)";BURATINO;2541771432;Ne;8;9;0;17
2229;"Gervelė (Dzūkų g. 32)";BURATINO;6967078836;Taip;0;8;0;8
2230;"Gervelė (Dzūkų g. 32)";BURATINO;24315961901;Taip;0;0;16;16
2231;"Gervelė (Dzūkų g. 32)";VIŠČIUKŲ;6844406500;Taip;0;17;0;17
2232;"Gervelė (Dzūkų g. 32)";VIŠČIUKŲ;2359854614;Taip;5;0;0;5
2233;"Gervelė (Dzūkų g. 32)";VIŠČIUKŲ;1573560581;Taip;8;0;0;8
2234;"Gervelė (Dzūkų g. 32)";VIŠČIUKŲ;1783612448;Taip;0;0;3;3
2235;"Gervelė (Dzūkų g. 32)";VIŠČIUKŲ;1020706652;Taip;8;0;0;8
2236;"Gervelė (Dzūkų g. 32)";VIŠČIUKŲ;9133101055;Taip;15;0;0;15
2237;"Gervelė (Dzūkų g. 32)";VIŠČIUKŲ;1474660999;Taip;0;22;0;22
2238;Gilužis;Skruzdėliukų;35511006307;Taip;0;1;0;1
2239;Gilužis;Skruzdėliukų;44807904472;Taip;13;0;0;13
2240;Gilužis;Skruzdėliukų;1671692484;Taip;2;1;0;3
2241;Gilužis;Skruzdėliukų;1615293331;Taip;0;5;1;6
2242;Gilužis;Skruzdėliukų;9474400084;Taip;0;1;0;1
2243;Gilužis;Skruzdėliukų;8120898865;Taip;0;2;0;2
2244;Gilužis;Skruzdėliukų;4611735601;Taip;8;0;0;8
2245;Gilužis;Skruzdėliukų;4747769984;Taip;6;0;0;6
2246;Gilužis;Skruzdėliukų;5920357223;Taip;0;2;0;2
2247;Gilužis;Skruzdėliukų;8595541498;Taip;6;1;0;7
2248;Gilužis;Skruzdėliukų;5365582271;Taip;15;0;0;15
2249;Gilužis;Skruzdėliukų;7364297673;Taip;0;0;1;1
2250;Gilužis;Skruzdėliukų;4362244070;Taip;0;1;0;1
2251;Gilužis;Skruzdėliukų;3216004438;Taip;0;0;1;1
2252;Gilužis;Skruzdėliukų;7766747590;Taip;3;0;0;3
2253;Gilužis;Skruzdėliukų;48365991937;Taip;12;1;0;13
2254;Gilužis;Skruzdėliukų;1569805585;Taip;0;2;0;2
2255;Gilužis;Skruzdėliukų;1452016675;Taip;0;1;0;1
2256;Gilužis;Skruzdėliukų;29586826889;Taip;7;4;0;11
2257;Gilužis;Nykštukų;4147821853;Taip;0;2;2;4
2258;Gilužis;Nykštukų;8899557365;Taip;8;0;0;8
2259;Gilužis;Nykštukų;2661894041;Taip;9;2;0;11
2260;Gilužis;Nykštukų;5109935385;Taip;0;2;0;2
2261;Gilužis;Nykštukų;1459273692;Taip;0;2;0;2
2262;Gilužis;Nykštukų;4156613717;Taip;3;2;7;12
2263;Gilužis;Nykštukų;5713786735;Taip;0;8;1;9
2264;Gilužis;Nykštukų;2784416935;Ne;0;10;0;10
2265;Gilužis;Nykštukų;4956685016;Taip;0;5;0;5
2266;Gilužis;Nykštukų;6315155554;Taip;0;5;0;5
2267;Gilužis;Nykštukų;1146713023;Taip;0;3;0;3
2268;Gilužis;Nykštukų;9332056404;Taip;0;4;0;4
2269;Gilužis;Nykštukų;4541291716;Taip;0;5;0;5
2270;Gilužis;Nykštukų;8522552650;Taip;0;1;0;1
2271;Gilužis;Nykštukų;3176305306;Taip;13;1;0;14
2272;Gilužis;Nykštukų;4795108770;Ne;0;4;0;4
2273;Gilužis;Nykštukų;4094486541;Taip;3;0;0;3
2274;Gilužis;Bitučių;2585736095;Taip;12;2;1;15
2275;Gilužis;Bitučių;4841014668;Taip;4;0;0;4
2276;Gilužis;Bitučių;3399162399;Taip;6;0;0;6
2277;Gilužis;Bitučių;5973671038;Taip;2;0;0;2
2278;Gilužis;Bitučių;1634295583;Taip;0;0;3;3
2279;Gilužis;Bitučių;6931726275;Taip;7;4;0;11
2280;Gilužis;Bitučių;1867185320;Taip;11;1;0;12
2281;Gilužis;Bitučių;3429435736;Taip;22;0;0;22
2282;Gilužis;Bitučių;8539946703;Taip;6;5;0;11
2283;Gilužis;Bitučių;9000351000;Taip;9;8;1;18
2284;Gilužis;Bitučių;5366174839;Taip;8;2;0;10
2285;Gilužis;Bitučių;5162397237;Taip;0;0;4;4
2286;Gilužis;Bitučių;7250617867;Taip;0;5;0;5
2287;Gilužis;Bitučių;9053608903;Taip;11;0;0;11
2288;Gilužis;Bitučių;6115776872;Taip;0;0;2;2
2289;Gilužis;Bitučių;5651799121;Taip;10;0;2;12
2290;Gilužis;Bitučių;1334619137;Taip;8;0;1;9
2291;Gilužis;Bitučių;2950813185;Taip;9;1;0;10
2292;Gilužis;Bitučių;6515525848;Taip;7;1;0;8
2293;Gilužis;Kačiukų;4978922821;Taip;7;2;0;9
2294;Gilužis;Kačiukų;2945406185;Taip;7;3;0;10
2295;Gilužis;Kačiukų;1582241363;Taip;0;3;0;3
2296;Gilužis;Kačiukų;7330938312;Taip;2;0;1;3
2297;Gilužis;Kačiukų;6571132974;Taip;0;22;0;22
2298;Gilužis;Kačiukų;6966795180;Taip;8;0;0;8
2299;Gilužis;Kačiukų;5128383851;Taip;17;0;0;17
2300;Gilužis;Kačiukų;8318405114;Taip;10;0;0;10
2301;Gilužis;Kačiukų;7826015897;Taip;7;5;0;12
2302;Gilužis;Kačiukų;4403218878;Taip;12;1;0;13
2303;Gilužis;Kačiukų;9186274541;Taip;11;0;0;11
2304;Gilužis;Kačiukų;3419281756;Taip;0;11;0;11
2305;Gilužis;Kačiukų;1862524255;Taip;0;2;0;2
2306;Gilužis;Kačiukų;9421351780;Taip;0;14;0;14
2307;Gilužis;Kačiukų;6404411477;Taip;0;6;0;6
2308;Gilužis;Kačiukų;4128387076;Taip;2;0;3;5
2309;Gilužis;Kačiukų;3392212344;Taip;7;1;2;10
2310;Gilužis;Kačiukų;7042664923;Taip;0;0;2;2
2311;Gilužis;Kačiukų;9097165155;Taip;22;0;0;22
2312;Gilužis;Kačiukų;6853311695;Taip;4;0;15;19
2313;Gilužis;Pelėdžiukų;5217748032;Taip;7;3;0;10
2314;Gilužis;Pelėdžiukų;7998695149;Taip;12;0;0;12
2315;Gilužis;Pelėdžiukų;7742783427;Taip;12;0;0;12
2316;Gilužis;Pelėdžiukų;7358572344;Taip;0;3;0;3
2317;Gilužis;Pelėdžiukų;4617259961;Taip;0;0;1;1
2318;Gilužis;Pelėdžiukų;1222370750;Taip;0;7;0;7
2319;Gilužis;Pelėdžiukų;9833451628;Taip;0;2;0;2
2320;Gilužis;Pelėdžiukų;6270071724;Taip;2;2;0;4
2321;Gilužis;Pelėdžiukų;7505729606;Taip;6;0;0;6
2322;Gilužis;Pelėdžiukų;4051726208;Taip;7;3;0;10
2323;Gilužis;Pelėdžiukų;7092060789;Taip;0;2;0;2
2324;Gilužis;Pelėdžiukų;1804218972;Taip;0;8;0;8
2325;Gilužis;Pelėdžiukų;2434419240;Taip;4;0;0;4
2326;Gilužis;Pelėdžiukų;1832039250;Taip;0;13;0;13
2327;Gilužis;Pelėdžiukų;3166161973;Taip;0;1;0;1
2328;Gilužis;Pelėdžiukų;5070988982;Taip;7;5;0;12
2329;Gilužis;Pelėdžiukų;7899274495;Taip;0;0;7;7
2330;Gilužis;Pelėdžiukų;6469454991;Ne;0;0;5;5
2331;Gilužis;Pelėdžiukų;2869506388;Taip;0;1;0;1
2332;Gilužis;Drugelių;6121625070;Taip;0;0;1;1
2333;Gilužis;Drugelių;1770064694;Taip;0;4;0;4
2334;Gilužis;Drugelių;9591229878;Taip;4;0;1;5
2335;Gilužis;Drugelių;9092013248;Taip;15;0;0;15
2336;Gilužis;Drugelių;9109883577;Taip;12;0;3;15
2337;Gilužis;Drugelių;8006465211;Taip;0;0;2;2
2338;Gilužis;Drugelių;5118401707;Taip;14;0;0;14
2339;Gilužis;Drugelių;3190597262;Taip;9;0;5;14
2340;Gilužis;Drugelių;2988856911;Taip;0;1;0;1
2341;Gilužis;Drugelių;3532863024;Taip;0;22;0;22
2342;Gilužis;Drugelių;1376645277;Taip;0;9;0;9
2343;Gilužis;Drugelių;1410870589;Taip;0;8;0;8
2344;Gilužis;Drugelių;6786334223;Taip;8;0;1;9
2345;Gilužis;Drugelių;9112993465;Taip;7;0;0;7
2346;Gilužis;Drugelių;8244385001;Taip;0;1;0;1
2347;Gilužis;Drugelių;7731169885;Taip;2;6;0;8
2348;Gilužis;Drugelių;1093643746;Taip;0;1;0;1
2349;Gilužis;Drugelių;3902713866;Taip;0;0;1;1
2350;Gilužis;Drugelių;6950139609;Taip;8;0;0;8
2351;Gilužis;Drugelių;2397231165;Taip;15;0;1;16
2352;Gilužis;Saulučių;17896774143;Taip;5;0;0;5
2353;Gilužis;Saulučių;9918995545;Taip;4;0;0;4
2354;Gilužis;Saulučių;4209000927;Taip;3;0;2;5
2355;Gilužis;Saulučių;4575619425;Taip;4;0;0;4
2356;Gilužis;Saulučių;4473810097;Taip;0;8;0;8
2357;Gilužis;Saulučių;1649256496;Taip;0;4;0;4
2358;Gilužis;Saulučių;96550272401;Taip;5;0;0;5
2359;Gilužis;Saulučių;69504888193;Taip;0;1;0;1
2360;Gilužis;Saulučių;2391630554;Taip;2;0;3;5
2361;Gilužis;Saulučių;18997894859;Taip;0;3;0;3
2362;Gilužis;Saulučių;7744997250;Taip;8;5;0;13
2363;Gilužis;Saulučių;32730847948;Taip;0;3;0;3
2364;Gilužis;Saulučių;3181765606;Taip;0;2;0;2
2365;Gilužis;Saulučių;5905237803;Taip;2;0;0;2
2366;Gilužis;Saulučių;79805583046;Taip;0;0;4;4
2367;Gilužis;Saulučių;2872439079;Taip;0;0;5;5
2368;Gilužis;Saulučių;28447690974;Taip;0;4;0;4
2369;Gilužis;Saulučių;87425898496;Taip;0;1;0;1
2370;Gilužis;Saulučių;9367673896;Taip;0;1;0;1
2371;Gilužis;Saulučių;1453976300;Taip;0;1;0;1
2372;Gilužis;Saulučių;1211233315;Taip;0;0;1;1
2373;Gilužis;Paukštelių;49114819476;Taip;0;1;1;2
2374;Gilužis;Paukštelių;1366594390;Taip;4;0;2;6
2375;Gilužis;Paukštelių;3091779337;Taip;0;0;1;1
2376;Gilužis;Paukštelių;57938423314;Taip;4;0;2;6
2377;Gilužis;Paukštelių;72153018644;Taip;0;6;0;6
2378;Gilužis;Paukštelių;1873200936;Taip;0;5;0;5
2379;Gilužis;Paukštelių;1930906118;Taip;0;6;0;6
2380;Gilužis;Paukštelių;8989448562;Taip;5;0;2;7
2381;Gilužis;Paukštelių;4199640400;Taip;0;0;3;3
2382;Gilužis;Paukštelių;89789237180;Taip;4;0;2;6
2383;Gilužis;Paukštelių;85356812538;Taip;0;7;0;7
2384;Gilužis;Paukštelių;1879108981;Taip;0;2;0;2
2385;Gilužis;Paukštelių;73793165310;Taip;0;0;1;1
2386;Gilužis;Paukštelių;28788742249;Taip;5;0;1;6
2387;Gilužis;Paukštelių;44115826781;Taip;0;1;0;1
2388;Gilužis;Obuoliukų;27834192987;Taip;0;1;0;1
2389;Gilužis;Obuoliukų;2134161601;Taip;2;0;0;2
2390;Gilužis;Obuoliukų;1637726675;Taip;0;6;0;6
2391;Gilužis;Obuoliukų;1404236599;Taip;6;5;0;11
2392;Gilužis;Obuoliukų;2031851095;Taip;0;1;0;1
2393;Gilužis;Obuoliukų;96799037695;Taip;4;0;0;4
2394;Gilužis;Obuoliukų;2138402546;Taip;0;1;0;1
2395;Gilužis;Obuoliukų;84834458261;Taip;0;2;0;2
2396;Gilužis;Obuoliukų;5121769570;Taip;0;4;0;4
2397;Gilužis;Obuoliukų;1428994411;Taip;3;0;0;3
2398;Gilužis;Obuoliukų;5899163275;Taip;0;1;0;1
2399;Gilužis;Obuoliukų;2126527730;Taip;0;1;0;1
2400;Gilužis;Obuoliukų;53388692764;Taip;0;3;0;3
2401;Gilužis;Obuoliukų;1067512693;Taip;0;2;0;2
2402;Gilužis;Obuoliukų;4777937216;Taip;0;2;4;6
2403;Gilužis;Obuoliukų;1877467761;Taip;22;0;0;22
2404;Gilužis;KIŠKUČIŲ;21128521886;Taip;0;3;0;3
2405;Gilužis;KIŠKUČIŲ;97906928411;Taip;0;1;0;1
2406;Gilužis;KIŠKUČIŲ;1191967409;Taip;2;6;0;8
2407;Gilužis;KIŠKUČIŲ;1025400197;Taip;0;0;4;4
2408;Gilužis;KIŠKUČIŲ;24558082285;Taip;0;11;0;11
2409;Gilužis;KIŠKUČIŲ;69205729963;Taip;0;1;0;1
2410;Gilužis;KIŠKUČIŲ;1464348972;Taip;2;0;0;2
2411;Gilužis;KIŠKUČIŲ;7740703388;Taip;0;10;0;10
2412;Gilužis;KIŠKUČIŲ;54636558233;Taip;0;1;0;1
2413;Gilužis;KIŠKUČIŲ;57074114440;Ne;0;9;0;9
2414;Gilužis;KIŠKUČIŲ;15192433393;Taip;0;0;3;3
2415;Gilužis;KIŠKUČIŲ;1307302669;Taip;0;0;12;12
2416;Gilužis;KIŠKUČIŲ;2246345257;Taip;0;7;5;12
2417;Gilužis;KIŠKUČIŲ;1163722642;Taip;0;0;1;1
2418;Gilužis;KIŠKUČIŲ;1495145663;Taip;0;0;1;1
2419;Gilužis;KIŠKUČIŲ;34330362446;Taip;0;0;5;5
2420;Gilužis;KIŠKUČIŲ;2118119414;Taip;3;0;0;3
2421;Gilužis;KIŠKUČIŲ;5621912516;Taip;0;5;0;5
2422;Gilužis;Meškučių;5008795520;Taip;0;2;0;2
2423;Gilužis;Meškučių;82153247890;Taip;0;1;0;1
2424;Gilužis;Meškučių;9104396905;Taip;1;1;0;2
2425;Gilužis;Meškučių;15672746324;Taip;0;1;0;1
2426;Gilužis;Meškučių;8278207628;Taip;0;2;0;2
2427;Gilužis;Meškučių;2144919007;Taip;0;2;0;2
2428;Gilužis;Meškučių;6840555273;Taip;0;8;0;8
2429;Gilužis;Meškučių;2111997678;Taip;0;2;0;2
2430;Gilužis;Meškučių;1664140841;Taip;0;9;0;9
2431;Gilužis;Meškučių;1201973661;Taip;0;11;0;11
2432;Gilužis;Meškučių;99889836604;Taip;2;1;0;3
2433;Gilužis;Meškučių;93541096118;Taip;22;0;0;22
2434;Gilužis;Meškučių;41791785706;Taip;0;22;0;22
2435;Gilužis;Meškučių;3104707033;Taip;0;1;0;1
2436;Gilužis;Meškučių;3884351522;Taip;0;2;0;2
2437;Gilužis;Meškučių;48400196395;Taip;0;1;0;1
2438;Gilužis;Meškučių;1003733551;Taip;4;1;0;5
2439;Gilužis;Meškučių;41887832166;Taip;0;1;0;1
2440;Gilužis;Meškučių;57285847418;Taip;1;9;0;10
2441;Gilužis;Meškučių;37771334557;Taip;0;11;0;11
2442;Gilužis;Meškučių;3451034791;Ne;12;0;0;12
2443;Gilužis;Meškučių;1642252063;Taip;0;1;0;1
2444;Gilužis;Pagrandukai;7560732216;Taip;0;8;0;8
2445;Gilužis;Pagrandukai;4242362889;Taip;0;8;0;8
2446;Gilužis;Pagrandukai;8194444043;Taip;10;0;0;10
2447;Gilužis;Pagrandukai;8201769917;Taip;3;5;0;8
2448;Gilužis;Pagrandukai;4592380105;Taip;0;22;0;22
2449;Gilužis;Pagrandukai;7398446674;Taip;9;0;0;9
2450;Gilužis;Pagrandukai;6172360933;Taip;8;1;0;9
2451;Gilužis;Pagrandukai;7716908903;Taip;0;1;0;1
2452;Gilužis;Pagrandukai;5476140202;Taip;13;0;0;13
2453;Gilužis;Pagrandukai;1540018160;Taip;8;0;0;8
2454;Gilužis;Pagrandukai;7606394325;Taip;7;5;0;12
2455;Gilužis;Pagrandukai;3131597174;Taip;2;6;0;8
2456;Gilužis;Pagrandukai;6239369861;Taip;7;0;0;7
2457;Gilužis;Pagrandukai;8325534742;Ne;0;22;0;22
2458;Gilužis;Pagrandukai;6737884137;Taip;2;11;0;13
2459;Gilužis;Pagrandukai;6825745985;Taip;2;2;0;4
2460;Gilužis;Boružėlių;5721924532;Taip;19;0;0;19
2461;Gilužis;Boružėlių;5497242500;Taip;7;0;0;7
2462;Gilužis;Boružėlių;2516315604;Taip;0;22;0;22
2463;Gilužis;Boružėlių;9783700319;Taip;21;0;0;21
2464;Gilužis;Boružėlių;5394693502;Taip;3;0;0;3
2465;Gilužis;Boružėlių;4455977087;Taip;13;0;0;13
2466;Gilužis;Boružėlių;4876074981;Taip;13;0;0;13
2467;Gilužis;Boružėlių;2633680406;Taip;8;1;0;9
2468;Gilužis;Boružėlių;2221786284;Taip;7;2;0;9
2469;Gilužis;Boružėlių;3002266577;Taip;22;0;0;22
2470;Gilužis;Boružėlių;9489594782;Taip;21;1;0;22
2471;Gilužis;Boružėlių;9484221435;Taip;3;0;0;3
2472;Gilužis;Boružėlių;5190752112;Ne;14;1;0;15
2473;Gilužis;Boružėlių;2440762487;Ne;14;1;0;15
2474;Gilužis;Boružėlių;8639633038;Taip;15;0;0;15
2475;Gilužis;Boružėlių;4509741536;Taip;4;2;0;6
2476;Gilužis;Boružėlių;2680643896;Taip;0;7;0;7
2477;Gilužis;Boružėlių;5744027226;Taip;6;0;0;6
2478;"Gintarėlis (Didlaukio g. 35)";PAPŪGĖLĖS;8498936096;Taip;0;2;11;13
2479;"Gintarėlis (Didlaukio g. 35)";PAPŪGĖLĖS;8913652291;Taip;5;0;6;11
2480;"Gintarėlis (Didlaukio g. 35)";PAPŪGĖLĖS;2485750596;Taip;10;0;0;10
2481;"Gintarėlis (Didlaukio g. 35)";PAPŪGĖLĖS;1033624080;Taip;4;0;0;4
2482;"Gintarėlis (Didlaukio g. 35)";PAPŪGĖLĖS;2919700367;Ne;5;2;4;11
2483;"Gintarėlis (Didlaukio g. 35)";PAPŪGĖLĖS;1768789948;Taip;3;0;3;6
2484;"Gintarėlis (Didlaukio g. 35)";PAPŪGĖLĖS;2595566032;Taip;0;2;0;2
2485;"Gintarėlis (Didlaukio g. 35)";PAPŪGĖLĖS;9141438560;Taip;0;2;0;2
2486;"Gintarėlis (Didlaukio g. 35)";PAPŪGĖLĖS;9494521554;Taip;0;16;0;16
2487;"Gintarėlis (Didlaukio g. 35)";PAPŪGĖLĖS;7494884360;Taip;0;6;0;6
2488;"Gintarėlis (Didlaukio g. 35)";PAPŪGĖLĖS;7147842224;Taip;0;2;2;4
2489;"Gintarėlis (Didlaukio g. 35)";PAPŪGĖLĖS;5783939567;Taip;0;2;0;2
2490;"Gintarėlis (Didlaukio g. 35)";PAPŪGĖLĖS;7674351459;Taip;6;1;0;7
2491;"Gintarėlis (Didlaukio g. 35)";PAPŪGĖLĖS;6292664833;Taip;5;0;2;7
2492;"Gintarėlis (Didlaukio g. 35)";PAPŪGĖLĖS;8610886062;Taip;0;1;0;1
2493;"Gintarėlis (Didlaukio g. 35)";PAPŪGĖLĖS;5811396263;Taip;5;4;0;9
2494;"Gintarėlis (Didlaukio g. 35)";PAPŪGĖLĖS;4904966263;Taip;5;1;0;6
2495;"Gintarėlis (Didlaukio g. 35)";PAPŪGĖLĖS;1648843117;Taip;4;2;1;7
2496;"Gintarėlis (Didlaukio g. 35)";PAPŪGĖLĖS;1861324153;Taip;0;7;0;7
2497;"Gintarėlis (Didlaukio g. 35)";PAPŪGĖLĖS;3457974670;Taip;6;13;1;20
2498;"Gintarėlis (Didlaukio g. 35)";PAPŪGĖLĖS;1511718436;Taip;0;5;0;5
2499;"Gintarėlis (Didlaukio g. 35)";PAPŪGĖLĖS;4484711857;Taip;0;2;8;10
2500;"Gintarėlis (Didlaukio g. 35)";SPINDULIUKAI;9903314418;Taip;0;1;0;1
2501;"Gintarėlis (Didlaukio g. 35)";SPINDULIUKAI;31365533022;Taip;0;2;0;2
2502;"Gintarėlis (Didlaukio g. 35)";SPINDULIUKAI;2000986290;Taip;0;3;0;3
2503;"Gintarėlis (Didlaukio g. 35)";SPINDULIUKAI;98684742007;Taip;4;2;1;7
2504;"Gintarėlis (Didlaukio g. 35)";SPINDULIUKAI;54145290842;Taip;0;2;1;3
2505;"Gintarėlis (Didlaukio g. 35)";SPINDULIUKAI;6421537455;Taip;0;4;0;4
2506;"Gintarėlis (Didlaukio g. 35)";SPINDULIUKAI;5451653510;Taip;5;0;0;5
2507;"Gintarėlis (Didlaukio g. 35)";SPINDULIUKAI;58701768194;Taip;0;11;0;11
2508;"Gintarėlis (Didlaukio g. 35)";SPINDULIUKAI;1595816431;Taip;0;1;0;1
2509;"Gintarėlis (Didlaukio g. 35)";SPINDULIUKAI;1159773367;Taip;0;1;0;1
2510;"Gintarėlis (Didlaukio g. 35)";SPINDULIUKAI;19813827223;Taip;0;2;0;2
2511;"Gintarėlis (Didlaukio g. 35)";SPINDULIUKAI;26259581924;Taip;0;7;0;7
2512;"Gintarėlis (Didlaukio g. 35)";SPINDULIUKAI;3047429502;Taip;0;1;0;1
2513;"Gintarėlis (Didlaukio g. 35)";SPINDULIUKAI;4076421692;Taip;0;2;0;2
2514;"Gintarėlis (Didlaukio g. 35)";SPINDULIUKAI;6091264509;Taip;5;13;0;18
2515;"Gintarėlis (Didlaukio g. 35)";LAŠIUKAI;3504738389;Taip;7;0;0;7
2516;"Gintarėlis (Didlaukio g. 35)";LAŠIUKAI;77591601744;Taip;5;0;6;11
2517;"Gintarėlis (Didlaukio g. 35)";LAŠIUKAI;29645999843;Taip;0;13;0;13
2518;"Gintarėlis (Didlaukio g. 35)";LAŠIUKAI;90891401453;Taip;0;2;5;7
2519;"Gintarėlis (Didlaukio g. 35)";LAŠIUKAI;1539226211;Taip;6;3;4;13
2520;"Gintarėlis (Didlaukio g. 35)";LAŠIUKAI;1076400051;Taip;0;3;0;3
2521;"Gintarėlis (Didlaukio g. 35)";LAŠIUKAI;5835437020;Taip;6;9;0;15
2522;"Gintarėlis (Didlaukio g. 35)";LAŠIUKAI;1191846491;Taip;0;0;2;2
2523;"Gintarėlis (Didlaukio g. 35)";LAŠIUKAI;24774460882;Taip;0;0;10;10
2524;"Gintarėlis (Didlaukio g. 35)";LAŠIUKAI;83754732536;Taip;3;2;1;6
2525;"Gintarėlis (Didlaukio g. 35)";LAŠIUKAI;2032900352;Taip;0;4;0;4
2526;"Gintarėlis (Didlaukio g. 35)";LAŠIUKAI;85557344192;Taip;0;2;0;2
2527;"Gintarėlis (Didlaukio g. 35)";LAŠIUKAI;1069395570;Taip;0;1;0;1
2528;"Gintarėlis (Didlaukio g. 35)";LAŠIUKAI;1110150536;Taip;21;0;0;21
2529;"Gintarėlis (Didlaukio g. 35)";LAŠIUKAI;1543013649;Taip;0;14;0;14
2530;"Gintarėlis (Didlaukio g. 35)";LAŠIUKAI;1642627920;Taip;0;11;0;11
2531;"Gintarėlis (Didlaukio g. 35)";LAŠIUKAI;8373623055;Taip;11;1;2;14
2532;"Gintarėlis (Didlaukio g. 35)";LAŠIUKAI;1593455162;Taip;0;5;0;5
2533;"Gintarėlis (Didlaukio g. 35)";LAŠIUKAI;9705808868;Taip;0;2;1;3
2534;"Gintarėlis (Didlaukio g. 35)";GAIDŽIUKAI;45480802894;Taip;6;4;3;13
2535;"Gintarėlis (Didlaukio g. 35)";GAIDŽIUKAI;1770479969;Taip;0;2;0;2
2536;"Gintarėlis (Didlaukio g. 35)";GAIDŽIUKAI;1441282039;Taip;0;2;0;2
2537;"Gintarėlis (Didlaukio g. 35)";GAIDŽIUKAI;4660581415;Taip;0;2;2;4
2538;"Gintarėlis (Didlaukio g. 35)";GAIDŽIUKAI;3794027499;Taip;7;2;0;9
2539;"Gintarėlis (Didlaukio g. 35)";GAIDŽIUKAI;1327681704;Taip;0;1;0;1
2540;"Gintarėlis (Didlaukio g. 35)";GAIDŽIUKAI;8206947475;Taip;0;0;3;3
2541;"Gintarėlis (Didlaukio g. 35)";GAIDŽIUKAI;5916948150;Taip;0;2;0;2
2542;"Gintarėlis (Didlaukio g. 35)";GAIDŽIUKAI;2203238888;Taip;0;2;1;3
2543;"Gintarėlis (Didlaukio g. 35)";GAIDŽIUKAI;3978892232;Taip;0;1;0;1
2544;"Gintarėlis (Didlaukio g. 35)";GAIDŽIUKAI;7942036741;Taip;0;0;1;1
2545;"Gintarėlis (Didlaukio g. 35)";GAIDŽIUKAI;6785086096;Ne;0;4;0;4
2546;"Gintarėlis (Didlaukio g. 35)";GAIDŽIUKAI;4612041848;Taip;0;2;1;3
2547;"Gintarėlis (Didlaukio g. 35)";GAIDŽIUKAI;6607854244;Taip;0;2;0;2
2548;"Gintarėlis (Didlaukio g. 35)";GAIDŽIUKAI;7813187438;Taip;5;8;0;13
2549;"Gintarėlis (Didlaukio g. 35)";GAIDŽIUKAI;7123016029;Taip;0;2;0;2
2550;"Gintarėlis (Didlaukio g. 35)";GAIDŽIUKAI;3000371147;Taip;0;5;0;5
2551;"Gintarėlis (Didlaukio g. 35)";GAIDŽIUKAI;3987801707;Taip;14;0;0;14
2552;"Gintarėlis (Didlaukio g. 35)";GAIDŽIUKAI;2256002308;Taip;6;2;0;8
2553;"Gintarėlis (Didlaukio g. 35)";GAIDŽIUKAI;3484172382;Taip;2;2;0;4
2554;"Gintarėlis (Didlaukio g. 35)";GAIDŽIUKAI;9539570835;Taip;0;2;4;6
2555;"Gintarėlis (Didlaukio g. 35)";GAIDŽIUKAI;3088663209;Taip;0;2;0;2
2556;"Gintarėlis (Didlaukio g. 35)";MEŠKUČIAI;2926488239;Taip;0;2;0;2
2557;"Gintarėlis (Didlaukio g. 35)";MEŠKUČIAI;6618240550;Taip;0;1;0;1
2558;"Gintarėlis (Didlaukio g. 35)";MEŠKUČIAI;8790078624;Taip;5;1;0;6
2559;"Gintarėlis (Didlaukio g. 35)";MEŠKUČIAI;2518840573;Taip;8;1;0;9
2560;"Gintarėlis (Didlaukio g. 35)";MEŠKUČIAI;5187894822;Taip;0;1;0;1
2561;"Gintarėlis (Didlaukio g. 35)";MEŠKUČIAI;3630567294;Taip;0;4;0;4
2562;"Gintarėlis (Didlaukio g. 35)";MEŠKUČIAI;5181872438;Taip;0;3;0;3
2563;"Gintarėlis (Didlaukio g. 35)";MEŠKUČIAI;1565802953;Taip;0;22;0;22
2564;"Gintarėlis (Didlaukio g. 35)";MEŠKUČIAI;2072435242;Taip;0;2;0;2
2565;"Gintarėlis (Didlaukio g. 35)";MEŠKUČIAI;7989239799;Taip;0;2;0;2
2566;"Gintarėlis (Didlaukio g. 35)";MEŠKUČIAI;4356211536;Taip;8;1;0;9
2567;"Gintarėlis (Didlaukio g. 35)";MEŠKUČIAI;1502740714;Taip;0;1;0;1
2568;"Gintarėlis (Didlaukio g. 35)";MEŠKUČIAI;6636835034;Taip;0;2;0;2
2569;"Gintarėlis (Didlaukio g. 35)";MEŠKUČIAI;3830154353;Taip;8;0;0;8
2570;"Gintarėlis (Didlaukio g. 35)";MEŠKUČIAI;3947405446;Taip;2;6;0;8
2571;"Gintarėlis (Didlaukio g. 35)";MEŠKUČIAI;7948438165;Taip;0;6;0;6
2572;"Gintarėlis (Didlaukio g. 35)";MEŠKUČIAI;4642142931;Taip;10;4;0;14
2573;"Gintarėlis (Didlaukio g. 35)";MEŠKUČIAI;6711753930;Taip;0;22;0;22
2574;"Gintarėlis (Didlaukio g. 35)";MEŠKUČIAI;9017592249;Taip;0;3;0;3
2575;"Gintarėlis (Didlaukio g. 35)";MEŠKUČIAI;8375475174;Taip;7;7;0;14
2576;"Gintarėlis (Didlaukio g. 35)";MEŠKUČIAI;7029401386;Taip;2;3;0;5
2577;"Gintarėlis (Didlaukio g. 35)";MEŠKUČIAI;1790629500;Taip;3;0;0;3
2578;"Gintarėlis (Didlaukio g. 35)";MEŠKUČIAI;7320085613;Taip;8;0;0;8
2579;"Gintarėlis (Didlaukio g. 35)";DRUGELIAI;6655809299;Taip;10;0;1;11
2580;"Gintarėlis (Didlaukio g. 35)";DRUGELIAI;2614258442;Taip;0;4;0;4
2581;"Gintarėlis (Didlaukio g. 35)";DRUGELIAI;1452402931;Taip;0;5;0;5
2582;"Gintarėlis (Didlaukio g. 35)";DRUGELIAI;4217329880;Taip;0;1;0;1
2583;"Gintarėlis (Didlaukio g. 35)";DRUGELIAI;1759217543;Taip;0;8;0;8
2584;"Gintarėlis (Didlaukio g. 35)";DRUGELIAI;7571352126;Taip;0;0;3;3
2585;"Gintarėlis (Didlaukio g. 35)";DRUGELIAI;1042222561;Taip;0;8;0;8
2586;"Gintarėlis (Didlaukio g. 35)";DRUGELIAI;9687974376;Taip;0;2;4;6
2587;"Gintarėlis (Didlaukio g. 35)";DRUGELIAI;8704248985;Taip;0;4;0;4
2588;"Gintarėlis (Didlaukio g. 35)";DRUGELIAI;6655645997;Taip;5;0;0;5
2589;"Gintarėlis (Didlaukio g. 35)";DRUGELIAI;6080108998;Taip;9;0;0;9
2590;"Gintarėlis (Didlaukio g. 35)";DRUGELIAI;7449437199;Taip;0;2;0;2
2591;"Gintarėlis (Didlaukio g. 35)";DRUGELIAI;2016067859;Taip;0;0;1;1
2592;"Gintarėlis (Didlaukio g. 35)";DRUGELIAI;6898320582;Ne;0;0;22;22
2593;"Gintarėlis (Didlaukio g. 35)";KAČIUKAI;5569843168;Taip;5;2;0;7
2594;"Gintarėlis (Didlaukio g. 35)";KAČIUKAI;3665764153;Taip;0;1;0;1
2595;"Gintarėlis (Didlaukio g. 35)";KAČIUKAI;9774056578;Taip;0;1;0;1
2596;"Gintarėlis (Didlaukio g. 35)";KAČIUKAI;2212296954;Taip;0;2;0;2
2597;"Gintarėlis (Didlaukio g. 35)";KAČIUKAI;3825700024;Taip;0;1;0;1
2598;"Gintarėlis (Didlaukio g. 35)";KAČIUKAI;7057877483;Taip;0;1;0;1
2599;"Gintarėlis (Didlaukio g. 35)";KAČIUKAI;9825811100;Taip;0;0;3;3
2600;"Gintarėlis (Didlaukio g. 35)";KAČIUKAI;7875981690;Taip;0;12;0;12
2601;"Gintarėlis (Didlaukio g. 35)";KAČIUKAI;2544338275;Taip;0;12;0;12
2602;"Gintarėlis (Didlaukio g. 35)";KAČIUKAI;4754929282;Taip;0;3;0;3
2603;"Gintarėlis (Didlaukio g. 35)";KAČIUKAI;5214984111;Taip;0;3;0;3
2604;"Gintarėlis (Didlaukio g. 35)";KAČIUKAI;1011749698;Taip;0;2;5;7
2605;"Gintarėlis (Didlaukio g. 35)";KAČIUKAI;8261770154;Taip;0;18;0;18
2606;"Gintarėlis (Didlaukio g. 35)";KAČIUKAI;7061545258;Taip;0;1;0;1
2607;"Gintarėlis (Didlaukio g. 35)";KAČIUKAI;5436695400;Ne;0;2;0;2
2608;"Gintarėlis (Didlaukio g. 35)";KAČIUKAI;5921751507;Taip;0;4;0;4
2609;"Gintarėlis (Didlaukio g. 35)";KAČIUKAI;9450900915;Taip;0;0;5;5
2610;"Gintarėlis (Didlaukio g. 35)";KAČIUKAI;5153948767;Taip;3;0;0;3
2611;"Gintarėlis (Didlaukio g. 35)";KAČIUKAI;3814485627;Taip;0;5;0;5
2612;"Gintarėlis (Didlaukio g. 35)";KAČIUKAI;1571260478;Ne;0;22;0;22
2613;"Gintarėlis (Didlaukio g. 35)";KAČIUKAI;9244715396;Taip;4;2;0;6
2614;"Gintarėlis (Didlaukio g. 35)";KIŠKUČIAI;9279399214;Taip;0;1;0;1
2615;"Gintarėlis (Didlaukio g. 35)";KIŠKUČIAI;3921015919;Taip;0;1;0;1
2616;"Gintarėlis (Didlaukio g. 35)";KIŠKUČIAI;8000297636;Taip;0;2;6;8
2617;"Gintarėlis (Didlaukio g. 35)";KIŠKUČIAI;7971810025;Taip;0;3;0;3
2618;"Gintarėlis (Didlaukio g. 35)";KIŠKUČIAI;2814569415;Taip;0;4;0;4
2619;"Gintarėlis (Didlaukio g. 35)";KIŠKUČIAI;7143014339;Taip;0;2;4;6
2620;"Gintarėlis (Didlaukio g. 35)";KIŠKUČIAI;5796729245;Taip;0;2;0;2
2621;"Gintarėlis (Didlaukio g. 35)";KIŠKUČIAI;9915887420;Taip;0;2;0;2
2622;"Gintarėlis (Didlaukio g. 35)";KIŠKUČIAI;8287685690;Taip;0;12;0;12
2623;"Gintarėlis (Didlaukio g. 35)";KIŠKUČIAI;6142819210;Taip;0;4;0;4
2624;"Gintarėlis (Didlaukio g. 35)";KIŠKUČIAI;5919205817;Taip;0;4;0;4
2625;"Gintarėlis (Didlaukio g. 35)";KIŠKUČIAI;7815317644;Taip;0;2;1;3
2626;"Gintarėlis (Didlaukio g. 35)";KIŠKUČIAI;2165332442;Taip;0;2;0;2
2627;"Gintarėlis (Didlaukio g. 35)";KIŠKUČIAI;6914904213;Taip;0;2;5;7
2628;"Gintarėlis (Didlaukio g. 35)";KIŠKUČIAI;1696337909;Taip;0;2;5;7
2629;"Gintarėlis (Didlaukio g. 35)";KIŠKUČIAI;6862629244;Taip;11;3;0;14
2630;"Gintarėlis (Didlaukio g. 35)";KIŠKUČIAI;3398936974;Taip;2;17;0;19
2631;"Gintarėlis (Didlaukio g. 35)";KIŠKUČIAI;1918879534;Taip;11;0;0;11
2632;"Gintarėlis (Didlaukio g. 35)";KIŠKUČIAI;7509100750;Taip;0;7;0;7
2633;"Gintarėlis (Didlaukio g. 35)";KIŠKUČIAI;6991746305;Taip;9;0;0;9
2634;"Gintarėlis (Didlaukio g. 35)";KIŠKUČIAI;3792697409;Taip;3;0;0;3
2635;"Gintarėlis (Didlaukio g. 35)";VYTURIUKAI;1553747935;Taip;6;0;1;7
2636;"Gintarėlis (Didlaukio g. 35)";VYTURIUKAI;22394648690;Ne;0;9;0;9
2637;"Gintarėlis (Didlaukio g. 35)";VYTURIUKAI;56124970238;Taip;0;1;0;1
2638;"Gintarėlis (Didlaukio g. 35)";VYTURIUKAI;34606130829;Taip;0;9;0;9
2639;"Gintarėlis (Didlaukio g. 35)";VYTURIUKAI;21658913551;Taip;0;4;1;5
2640;"Gintarėlis (Didlaukio g. 35)";VYTURIUKAI;18715625324;Taip;0;1;0;1
2641;"Gintarėlis (Didlaukio g. 35)";VYTURIUKAI;8405210216;Ne;0;6;0;6
2642;"Gintarėlis (Didlaukio g. 35)";VYTURIUKAI;2721386855;Taip;0;4;0;4
2643;"Gintarėlis (Didlaukio g. 35)";VYTURIUKAI;2914156353;Taip;0;0;4;4
2644;"Gintarėlis (Didlaukio g. 35)";VYTURIUKAI;2843012824;Taip;10;2;0;12
2645;"Gintarėlis (Didlaukio g. 35)";VYTURIUKAI;5717123412;Taip;3;7;0;10
2646;"Gintarėlis (Didlaukio g. 35)";BORUŽĖLĖS;1771868868;Taip;0;5;0;5
2647;"Gintarėlis (Didlaukio g. 35)";BORUŽĖLĖS;39372328122;Taip;0;1;0;1
2648;"Gintarėlis (Didlaukio g. 35)";BORUŽĖLĖS;25451522701;Taip;0;2;0;2
2649;"Gintarėlis (Didlaukio g. 35)";BORUŽĖLĖS;82344200095;Taip;0;2;0;2
2650;"Gintarėlis (Didlaukio g. 35)";BORUŽĖLĖS;1168158494;Taip;3;0;0;3
2651;"Gintarėlis (Didlaukio g. 35)";BORUŽĖLĖS;88451515187;Taip;0;6;0;6
2652;"Gintarėlis (Didlaukio g. 35)";BORUŽĖLĖS;2145479870;Taip;3;1;0;4
2653;"Gintarėlis (Didlaukio g. 35)";BORUŽĖLĖS;49506158711;Taip;0;3;0;3
2654;"Gintarėlis (Didlaukio g. 35)";BORUŽĖLĖS;30066476338;Taip;5;1;0;6
2655;"Gintarėlis (Didlaukio g. 35)";BORUŽĖLĖS;91798408335;Taip;0;10;0;10
2656;"Gintarėlis (Didlaukio g. 35)";BORUŽĖLĖS;25684002087;Taip;0;5;0;5
2657;"Gintarėlis (Didlaukio g. 35)";BORUŽĖLĖS;10826255781;Taip;0;6;0;6
2658;"Gintarėlis (Didlaukio g. 35)";BORUŽĖLĖS;1505703905;Taip;0;2;0;2
2659;"Gintarėlis (Didlaukio g. 35)";BORUŽĖLĖS;3341850450;Taip;5;0;0;5
2660;"Gintarėlis (Didlaukio g. 35)";EŽIUKAI;4487346983;Taip;0;2;0;2
2661;"Gintarėlis (Didlaukio g. 35)";EŽIUKAI;2263102527;Taip;11;1;0;12
2662;"Gintarėlis (Didlaukio g. 35)";EŽIUKAI;9040480798;Taip;0;0;1;1
2663;"Gintarėlis (Didlaukio g. 35)";EŽIUKAI;8055928882;Taip;0;2;0;2
2664;"Gintarėlis (Didlaukio g. 35)";EŽIUKAI;5024727902;Taip;0;10;0;10
2665;"Gintarėlis (Didlaukio g. 35)";EŽIUKAI;2088008759;Taip;0;0;1;1
2666;"Gintarėlis (Didlaukio g. 35)";EŽIUKAI;3799412062;Taip;0;2;1;3
2667;"Gintarėlis (Didlaukio g. 35)";EŽIUKAI;4660854883;Taip;0;2;0;2
2668;"Gintarėlis (Didlaukio g. 35)";EŽIUKAI;94354056029;Taip;0;6;0;6
2669;"Gintarėlis (Didlaukio g. 35)";EŽIUKAI;2036488789;Taip;0;4;6;10
2670;"Gintarėlis (Didlaukio g. 35)";EŽIUKAI;7644607132;Taip;4;0;0;4
2671;"Gintarėlis (Didlaukio g. 35)";EŽIUKAI;2970527490;Taip;0;1;0;1
2672;"Gintarėlis (Didlaukio g. 35)";EŽIUKAI;1028456578;Taip;7;0;0;7
2673;"Gintarėlis (Didlaukio g. 35)";EŽIUKAI;1066741732;Taip;9;0;2;11
2674;"Gintarėlis (Didlaukio g. 35)";EŽIUKAI;1778573935;Taip;0;6;0;6
2675;"Gintarėlis (Didlaukio g. 35)";EŽIUKAI;9917367735;Taip;0;4;0;4
2676;"Gintarėlis (Didlaukio g. 35)";VIŠČIUKAI;1981825456;Taip;6;1;0;7
2677;"Gintarėlis (Didlaukio g. 35)";VIŠČIUKAI;3973889495;Taip;0;1;0;1
2678;"Gintarėlis (Didlaukio g. 35)";VIŠČIUKAI;4749559606;Taip;0;1;0;1
2679;"Gintarėlis (Didlaukio g. 35)";VIŠČIUKAI;4458703839;Ne;8;2;2;12
2680;"Gintarėlis (Didlaukio g. 35)";VIŠČIUKAI;6239242631;Taip;0;22;0;22
2681;"Gintarėlis (Didlaukio g. 35)";VIŠČIUKAI;2178808286;Taip;10;2;10;22
2682;"Gintarėlis (Didlaukio g. 35)";VIŠČIUKAI;9073499040;Taip;3;2;0;5
2683;"Gintarėlis (Didlaukio g. 35)";VIŠČIUKAI;6547060300;Taip;0;4;0;4
2684;"Gintarėlis (Didlaukio g. 35)";VIŠČIUKAI;4535071342;Taip;13;1;0;14
2685;"Gintarėlis (Didlaukio g. 35)";VIŠČIUKAI;8448725884;Taip;13;1;0;14
2686;"Gintarėlis (Didlaukio g. 35)";VIŠČIUKAI;6251670953;Taip;8;5;0;13
2687;"Gintarėlis (Didlaukio g. 35)";VIŠČIUKAI;8805356168;Taip;0;5;0;5
2688;"Gintarėlis (Didlaukio g. 35)";VIŠČIUKAI;4751066825;Taip;0;3;0;3
2689;"Gintarėlis (Didlaukio g. 35)";VIŠČIUKAI;1039098192;Taip;0;14;0;14
2690;"Gintarėlis (Didlaukio g. 35)";VIŠČIUKAI;6042885133;Taip;9;13;0;22
2691;"Gintarėlis (Didlaukio g. 35)";VIŠČIUKAI;7418672923;Taip;17;0;0;17
2692;"Gintarėlis (Didlaukio g. 35)";VIŠČIUKAI;7562170082;Taip;6;15;0;21
2693;"Gintarėlis (Didlaukio g. 35)";"SAULĖS ZUIKUČIAI";4348245746;Taip;0;4;0;4
2694;"Gintarėlis (Didlaukio g. 35)";"SAULĖS ZUIKUČIAI";6558614008;Taip;8;1;0;9
2695;"Gintarėlis (Didlaukio g. 35)";"SAULĖS ZUIKUČIAI";3091731769;Taip;0;1;0;1
2696;"Gintarėlis (Didlaukio g. 35)";"SAULĖS ZUIKUČIAI";6484966941;Taip;3;2;3;8
2697;"Gintarėlis (Didlaukio g. 35)";"SAULĖS ZUIKUČIAI";9004590065;Taip;2;2;2;6
2698;"Gintarėlis (Didlaukio g. 35)";"SAULĖS ZUIKUČIAI";2624469768;Taip;0;6;0;6
2699;"Gintarėlis (Didlaukio g. 35)";"SAULĖS ZUIKUČIAI";8784796186;Taip;9;2;0;11
2700;"Gintarėlis (Didlaukio g. 35)";"SAULĖS ZUIKUČIAI";8516817506;Taip;13;2;0;15
2701;"Gintarėlis (Didlaukio g. 35)";"SAULĖS ZUIKUČIAI";4809352525;Taip;0;2;0;2
2702;"Gintarėlis (Didlaukio g. 35)";"SAULĖS ZUIKUČIAI";5965570522;Taip;3;1;0;4
2703;"Gintarėlis (Didlaukio g. 35)";"SAULĖS ZUIKUČIAI";7118758040;Taip;9;5;0;14
2704;"Gintarėlis (Didlaukio g. 35)";"SAULĖS ZUIKUČIAI";9970786396;Taip;0;2;5;7
2705;"Gintarėlis (Didlaukio g. 35)";"SAULĖS ZUIKUČIAI";3235154374;Taip;0;22;0;22
2706;"Gintarėlis (Didlaukio g. 35)";"SAULĖS ZUIKUČIAI";4334349824;Taip;5;7;1;13
2707;"Gintarėlis (Didlaukio g. 35)";"SAULĖS ZUIKUČIAI";6402043654;Taip;3;2;8;13
2708;"Gintarėlis (Didlaukio g. 35)";"SAULĖS ZUIKUČIAI";4278770021;Taip;0;1;0;1
2709;Giraitė;Aviliukas;89221382880;Taip;5;0;2;7
2710;Giraitė;Aviliukas;4031993742;Taip;0;0;1;1
2711;Giraitė;Aviliukas;82915040164;Taip;0;5;0;5
2712;Giraitė;Aviliukas;26032013284;Taip;18;0;0;18
2713;Giraitė;Aviliukas;2190246729;Taip;0;7;3;10
2714;Giraitė;Aviliukas;8941330547;Taip;0;1;0;1
2715;Giraitė;Aviliukas;1238299747;Taip;0;4;0;4
2716;Giraitė;Aviliukas;36650870278;Taip;0;3;0;3
2717;Giraitė;Aviliukas;1025627643;Taip;0;0;1;1
2718;Giraitė;Aviliukas;5810648237;Taip;3;0;9;12
2719;Giraitė;Aviliukas;5862292995;Taip;0;3;0;3
2720;Giraitė;Aviliukas;64357457379;Taip;5;1;0;6
2721;Giraitė;Aviliukas;1375377927;Taip;0;0;1;1
2722;Giraitė;Aviliukas;18968645937;Taip;0;0;1;1
2723;Giraitė;Aviliukas;7547897354;Taip;0;0;1;1
2724;Giraitė;Aviliukas;2016939046;Taip;0;1;0;1
2725;Giraitė;Aviliukas;5435336235;Taip;0;0;2;2
2726;Giraitė;Aviliukas;4742424647;Taip;0;0;5;5
2727;Giraitė;Aviliukas;2079967590;Taip;0;1;1;2
2728;Giraitė;LapiukaI;6141730004;Taip;0;1;0;1
2729;Giraitė;LapiukaI;7831526566;Taip;15;0;0;15
2730;Giraitė;LapiukaI;1921430434;Taip;0;4;0;4
2731;Giraitė;LapiukaI;5006156109;Taip;0;4;0;4
2732;Giraitė;LapiukaI;4663343304;Taip;1;0;0;1
2733;Giraitė;LapiukaI;4811513778;Taip;0;5;0;5
2734;Giraitė;LapiukaI;4296449093;Taip;0;6;0;6
2735;Giraitė;LapiukaI;1974159110;Taip;9;0;5;14
2736;Giraitė;LapiukaI;5902161665;Taip;0;4;0;4
2737;Giraitė;LapiukaI;4955786826;Taip;0;5;0;5
2738;Giraitė;LapiukaI;9088123796;Taip;0;3;0;3
2739;Giraitė;LapiukaI;7772177095;Taip;12;0;0;12
2740;Giraitė;LapiukaI;8492822889;Ne;0;1;0;1
2741;Giraitė;Voveriukai;7354834895;Taip;5;0;0;5
2742;Giraitė;Voveriukai;6265908751;Taip;9;0;0;9
2743;Giraitė;Voveriukai;4822168634;Taip;1;0;0;1
2744;Giraitė;Voveriukai;6963656869;Taip;0;2;1;3
2745;Giraitė;Voveriukai;3875214088;Taip;4;6;0;10
2746;Giraitė;Voveriukai;5202562049;Taip;0;4;0;4
2747;Giraitė;Voveriukai;7481895278;Taip;2;0;0;2
2748;Giraitė;Voveriukai;1945918102;Taip;0;6;2;8
2749;Giraitė;Voveriukai;8799195526;Taip;0;0;1;1
2750;Giraitė;Voveriukai;6225092500;Taip;0;0;3;3
2751;Giraitė;Voveriukai;4137699629;Taip;12;0;0;12
2752;Giraitė;Voveriukai;4932174149;Taip;0;0;1;1
2753;Giraitė;Voveriukai;7919088987;Taip;1;0;2;3
2754;Giraitė;Voveriukai;5616242311;Taip;5;0;1;6
2755;Giraitė;Voveriukai;7739516049;Taip;2;0;1;3
2756;Giraitė;Voveriukai;4773517160;Taip;10;0;0;10
2757;Giraitė;Voveriukai;2177856916;Taip;0;0;2;2
2758;Giraitė;Grybukai;1234136698;Taip;1;0;2;3
2759;Giraitė;Grybukai;1958553421;Taip;10;0;0;10
2760;Giraitė;Grybukai;1181578380;Taip;13;0;0;13
2761;Giraitė;Grybukai;1641872824;Taip;0;1;0;1
2762;Giraitė;Grybukai;3628448974;Taip;0;0;1;1
2763;Giraitė;Grybukai;1464444782;Taip;1;0;3;4
2764;Giraitė;Grybukai;56380808064;Taip;0;10;0;10
2765;Giraitė;Grybukai;8020051188;Taip;0;0;13;13
2766;Giraitė;Grybukai;1149254911;Taip;0;0;1;1
2767;Giraitė;Grybukai;1435017557;Taip;3;11;0;14
2768;Giraitė;Grybukai;4444292550;Taip;1;1;1;3
2769;Giraitė;Grybukai;77765768952;Taip;0;6;0;6
2770;Giraitė;Grybukai;2065944230;Taip;0;0;2;2
2771;Giraitė;Grybukai;1547711379;Taip;0;0;1;1
2772;Giraitė;Grybukai;48291239027;Taip;0;0;3;3
2773;Giraitė;Grybukai;2990968206;Taip;0;0;4;4
2774;Giraitė;Grybukai;81907805809;Taip;0;0;11;11
2775;Giraitė;Riešutėliai;5167002022;Taip;13;0;0;13
2776;Giraitė;Riešutėliai;9495968363;Taip;0;2;0;2
2777;Giraitė;Riešutėliai;1253151830;Taip;0;2;0;2
2778;Giraitė;Riešutėliai;4336519836;Taip;0;9;0;9
2779;Giraitė;Riešutėliai;9882372025;Taip;0;0;3;3
2780;Giraitė;Riešutėliai;5721669627;Taip;0;10;0;10
2781;Giraitė;Riešutėliai;5029839281;Ne;0;0;4;4
2782;Giraitė;Riešutėliai;23319979302;Ne;0;1;0;1
2783;Giraitė;Riešutėliai;4785524898;Taip;0;5;0;5
2784;Giraitė;Riešutėliai;4839351300;Taip;0;1;1;2
2785;Giraitė;Riešutėliai;9224845723;Taip;0;1;0;1
2786;Giraitė;Riešutėliai;4687228561;Taip;0;0;1;1
2787;Giraitė;Riešutėliai;9918028862;Taip;0;2;0;2
2788;Giraitė;Riešutėliai;1111614295;Taip;0;3;0;3
2789;Giraitė;Riešutėliai;1312761239;Taip;0;2;0;2
2790;Giraitė;Meškiukai;2513312448;Taip;0;2;0;2
2791;Giraitė;Meškiukai;5367392810;Taip;3;1;0;4
2792;Giraitė;Meškiukai;1608876140;Taip;0;1;0;1
2793;Giraitė;Meškiukai;1355594003;Taip;3;4;0;7
2794;Giraitė;Meškiukai;1560868105;Taip;0;7;0;7
2795;Giraitė;Meškiukai;1050699551;Taip;0;3;3;6
2796;Giraitė;Meškiukai;1876815077;Ne;0;1;0;1
2797;Giraitė;Meškiukai;1063628206;Taip;0;10;0;10
2798;Giraitė;Meškiukai;1318214394;Taip;0;7;0;7
2799;Giraitė;Meškiukai;1704154980;Taip;7;0;3;10
2800;Giraitė;Meškiukai;6156715234;Taip;0;5;0;5
2801;Giraitė;Meškiukai;1594965200;Taip;3;5;3;11
2802;Giraitė;Meškiukai;5726182600;Taip;0;2;3;5
2803;Giraitė;Meškiukai;1772790396;Taip;6;0;0;6
2804;Giraitė;Uogelės;8908602761;Taip;0;1;0;1
2805;Giraitė;Uogelės;4717851198;Taip;3;0;1;4
2806;Giraitė;Uogelės;9503157590;Taip;5;1;0;6
2807;Giraitė;Uogelės;4317544803;Taip;8;0;3;11
2808;Giraitė;Uogelės;9927102264;Taip;0;6;1;7
2809;Giraitė;Uogelės;4121361794;Taip;8;0;0;8
2810;Giraitė;Uogelės;4843415587;Taip;10;0;0;10
2811;Giraitė;Uogelės;5471577047;Taip;0;1;5;6
2812;Giraitė;Uogelės;2732715332;Taip;0;1;0;1
2813;Giraitė;Uogelės;2307307454;Taip;7;0;1;8
2814;Giraitė;Uogelės;2102237550;Taip;13;0;0;13
2815;Giraitė;Uogelės;6065010363;Taip;0;1;1;2
2816;Giraitė;Uogelės;5255040944;Taip;0;7;0;7
2817;Giraitė;Uogelės;7094750784;Taip;0;1;1;2
2818;Giraitė;Uogelės;1583733838;Taip;0;1;0;1
2819;Giraitė;Uogelės;4009092043;Taip;0;1;0;1
2820;Giraitė;Uogelės;1196333895;Taip;22;0;0;22
2821;Giraitė;Uogelės;7377939409;Ne;0;6;0;6
2822;Giraitė;Uogelės;4288937528;Taip;0;0;3;3
2823;Giraitė;Šaltinėlis;8986196352;Taip;3;0;1;4
2824;Giraitė;Šaltinėlis;31110630088;Taip;0;0;1;1
2825;Giraitė;Šaltinėlis;7779733510;Taip;0;0;5;5
2826;Giraitė;Šaltinėlis;5378240128;Taip;0;6;1;7
2827;Giraitė;Šaltinėlis;1110792632;Taip;0;0;2;2
2828;Giraitė;Šaltinėlis;8824642760;Taip;6;0;3;9
2829;Giraitė;Šaltinėlis;99494458394;Taip;0;4;0;4
2830;Giraitė;Šaltinėlis;1103462199;Taip;0;0;3;3
2831;Giraitė;Šaltinėlis;74256775397;Taip;0;1;0;1
2832;Giraitė;Šaltinėlis;43475840493;Taip;3;2;0;5
2833;Giraitė;Šaltinėlis;3031181239;Taip;0;5;0;5
2834;Giraitė;Šaltinėlis;80789407020;Taip;13;5;0;18
2835;Giraitė;Šaltinėlis;2551280794;Taip;0;10;1;11
2836;Giraitė;Boružėlės;7803047658;Taip;5;0;0;5
2837;Giraitė;Boružėlės;7566944002;Taip;8;0;0;8
2838;Giraitė;Boružėlės;3839432744;Taip;0;10;0;10
2839;Giraitė;Boružėlės;7423115504;Taip;0;0;1;1
2840;Giraitė;Boružėlės;6838184704;Taip;6;0;0;6
2841;Giraitė;Boružėlės;6288016799;Taip;17;0;0;17
2842;Giraitė;Boružėlės;4371263826;Taip;9;0;0;9
2843;Giraitė;Boružėlės;5161383686;Taip;1;9;0;10
2844;Giraitė;Boružėlės;8567304224;Taip;9;0;0;9
2845;Giraitė;Boružėlės;7580600719;Taip;6;0;0;6
2846;Giraitė;Boružėlės;3116241918;Taip;10;0;0;10
2847;Giraitė;Boružėlės;4795464133;Taip;13;0;0;13
2848;Giraitė;Boružėlės;3278871662;Taip;2;0;2;4
2849;Giraitė;Boružėlės;4168934880;Taip;5;1;0;6
2850;Giraitė;Boružėlės;9144465313;Taip;8;0;0;8
2851;Giraitė;Gandriukai;4680913596;Taip;11;0;0;11
2852;Giraitė;Gandriukai;7384795349;Taip;18;0;0;18
2853;Giraitė;Gandriukai;3643426944;Taip;0;7;0;7
2854;Giraitė;Gandriukai;6474975269;Taip;0;0;1;1
2855;Giraitė;Gandriukai;8525380061;Taip;13;9;0;22
2856;Giraitė;Gandriukai;7390702355;Taip;5;3;0;8
2857;Giraitė;Gandriukai;4851987149;Taip;4;0;1;5
2858;Giraitė;Gandriukai;6277788515;Taip;0;0;1;1
2859;Giraitė;Gandriukai;7767820565;Taip;10;1;0;11
2860;Giraitė;Gandriukai;8819218663;Taip;5;0;1;6
2861;Giraitė;Gandriukai;7269074498;Taip;3;9;2;14
2862;Giraitė;Gandriukai;1490748887;Ne;3;0;2;5
2863;Giraitė;Gandriukai;7789414361;Taip;13;9;0;22
2864;Giraitė;Gandriukai;9850432917;Taip;13;0;0;13
2865;Giraitė;Gandriukai;2313273738;Taip;5;3;0;8
2866;Giraitė;ŽVIRBLIUKAI;6715354865;Taip;0;0;1;1
2867;Giraitė;ŽVIRBLIUKAI;8461725999;Taip;0;0;5;5
2868;Giraitė;ŽVIRBLIUKAI;7395332578;Taip;5;6;0;11
2869;Giraitė;ŽVIRBLIUKAI;5086296808;Taip;2;13;0;15
2870;Giraitė;ŽVIRBLIUKAI;9669916418;Taip;6;0;0;6
2871;Giraitė;ŽVIRBLIUKAI;3481695682;Taip;4;0;0;4
2872;Giraitė;ŽVIRBLIUKAI;7678134658;Taip;0;2;0;2
2873;Giraitė;ŽVIRBLIUKAI;9471560738;Taip;4;2;0;6
2874;Giraitė;ŽVIRBLIUKAI;7230351549;Taip;8;0;1;9
2875;Giraitė;ŽVIRBLIUKAI;9392127689;Taip;0;0;1;1
2876;Giraitė;ŽVIRBLIUKAI;2416162886;Taip;12;0;2;14
2877;Giraitė;ŽVIRBLIUKAI;6293111179;Taip;16;0;0;16
2878;Giraitė;ŽVIRBLIUKAI;7543605905;Taip;7;4;0;11
2879;Giraitė;ŽVIRBLIUKAI;8128401630;Taip;12;0;0;12
2880;Giraitė;ŽVIRBLIUKAI;4233170371;Taip;3;1;0;4
2881;Giraitė;ŽVIRBLIUKAI;8871979627;Taip;0;4;0;4
2882;Giraitė;ŽVIRBLIUKAI;5548434439;Taip;0;0;1;1
2883;Giraitė;Kiškeliai;3085107071;Taip;1;0;2;3
2884;Giraitė;Kiškeliai;4440444700;Taip;4;0;6;10
2885;Giraitė;Kiškeliai;3348517050;Taip;3;0;2;5
2886;Giraitė;Kiškeliai;5275912609;Taip;2;0;1;3
2887;Giraitė;Kiškeliai;4008393576;Taip;0;5;4;9
2888;Giraitė;Kiškeliai;2219854347;Taip;3;9;1;13
2889;Giraitė;Kiškeliai;7807844145;Taip;3;3;0;6
2890;Giraitė;Kiškeliai;3757900478;Taip;4;0;0;4
2891;Giraitė;Kiškeliai;7876457529;Taip;4;0;3;7
2892;Giraitė;Kiškeliai;3992069614;Taip;4;0;0;4
2893;Giraitė;Kiškeliai;6121586335;Taip;11;0;8;19
2894;Giraitė;Kiškeliai;5356944812;Taip;12;0;0;12
2895;Giraitė;Kiškeliai;2338867192;Taip;7;0;0;7
2896;Giraitė;Kiškeliai;3719285343;Taip;3;0;4;7
2897;Giraitė;Kiškeliai;4758750245;Taip;7;0;0;7
2898;Gudrutis;Gandriukų;1225698076;Taip;0;10;0;10
2899;Gudrutis;Gandriukų;5408444872;Taip;0;0;6;6
2900;Gudrutis;Gandriukų;8240340213;Taip;0;0;3;3
2901;Gudrutis;Gandriukų;9697445037;Taip;0;4;0;4
2902;Gudrutis;Gandriukų;9752360809;Taip;0;2;1;3
2903;Gudrutis;Gandriukų;7934673005;Taip;10;0;0;10
2904;Gudrutis;Gandriukų;7006545234;Taip;0;0;3;3
2905;Gudrutis;Gandriukų;2199222671;Taip;0;0;2;2
2906;Gudrutis;Gandriukų;1670550212;Taip;6;1;0;7
2907;Gudrutis;Gandriukų;5241856014;Taip;0;0;2;2
2908;Gudrutis;Gandriukų;8500911420;Taip;13;0;2;15
2909;Gudrutis;Gandriukų;5728436444;Taip;8;0;0;8
2910;Gudrutis;Gandriukų;9041133527;Taip;0;1;0;1
2911;Gudrutis;Gandriukų;2291393238;Taip;0;0;3;3
2912;Gudrutis;Gandriukų;1384696362;Taip;0;0;3;3
2913;Gudrutis;Gandriukų;1587454709;Taip;0;0;1;1
2914;Gudrutis;Gandriukų;3281890659;Taip;0;5;0;5
2915;Gudrutis;"Saulės zuikučių";6835038962;Taip;0;0;10;10
2916;Gudrutis;"Saulės zuikučių";2118727861;Taip;0;8;0;8
2917;Gudrutis;"Saulės zuikučių";1725920873;Taip;0;0;2;2
2918;Gudrutis;"Saulės zuikučių";1901358996;Taip;0;0;1;1
2919;Gudrutis;"Saulės zuikučių";7664517480;Taip;0;0;2;2
2920;Gudrutis;"Saulės zuikučių";9701111916;Taip;0;9;0;9
2921;Gudrutis;"Saulės zuikučių";6198012431;Taip;0;0;7;7
2922;Gudrutis;"Saulės zuikučių";3646335609;Taip;0;0;5;5
2923;Gudrutis;"Saulės zuikučių";7871991275;Taip;0;0;7;7
2924;Gudrutis;"Saulės zuikučių";5580618896;Taip;0;0;7;7
2925;Gudrutis;"Saulės zuikučių";3625838131;Taip;0;2;0;2
2926;Gudrutis;"Saulės zuikučių";2337493193;Taip;0;3;0;3
2927;Gudrutis;"Saulės zuikučių";2764843216;Taip;1;0;0;1
2928;Gudrutis;"Saulės zuikučių";7955353991;Taip;0;1;0;1
2929;Gudrutis;"Saulės zuikučių";9847597133;Taip;8;0;0;8
2930;Gudrutis;"Saulės zuikučių";2468434676;Taip;0;5;0;5
2931;Gudrutis;"Saulės zuikučių";2293472716;Taip;5;0;3;8
2932;Gudrutis;Pelėdžiukų;7443277768;Taip;10;0;2;12
2933;Gudrutis;Pelėdžiukų;2592224860;Taip;0;1;0;1
2934;Gudrutis;Pelėdžiukų;4193661251;Taip;0;7;0;7
2935;Gudrutis;Pelėdžiukų;9797417587;Taip;0;2;0;2
2936;Gudrutis;Pelėdžiukų;5574287734;Taip;0;4;0;4
2937;Gudrutis;Pelėdžiukų;2431077357;Taip;0;6;0;6
2938;Gudrutis;Pelėdžiukų;7116979528;Taip;3;0;0;3
2939;Gudrutis;Pelėdžiukų;1693306014;Taip;0;6;9;15
2940;Gudrutis;Pelėdžiukų;8398961969;Taip;0;1;0;1
2941;Gudrutis;Pelėdžiukų;1991658503;Taip;5;0;0;5
2942;Gudrutis;Pelėdžiukų;9841172472;Taip;7;0;2;9
2943;Gudrutis;Pelėdžiukų;3359028602;Taip;0;1;1;2
2944;Gudrutis;Pelėdžiukų;4945755164;Taip;0;2;2;4
2945;Gudrutis;Pelėdžiukų;3363824185;Taip;8;0;0;8
2946;Gudrutis;Pelėdžiukų;1228190677;Taip;0;1;0;1
2947;Gudrutis;Pelėdžiukų;6700254479;Taip;3;0;2;5
2948;Gudrutis;BITUČIŲ;1490739175;Ne;0;0;7;7
2949;Gudrutis;BITUČIŲ;1823786522;Taip;0;1;0;1
2950;Gudrutis;BITUČIŲ;87981934125;Taip;0;11;0;11
2951;Gudrutis;BITUČIŲ;1618442704;Taip;0;8;0;8
2952;Gudrutis;BITUČIŲ;77776725399;Taip;0;1;0;1
2953;Gudrutis;BITUČIŲ;8768627605;Taip;9;0;0;9
2954;Gudrutis;BITUČIŲ;8085295588;Taip;0;6;0;6
2955;Gudrutis;BITUČIŲ;18320321051;Taip;0;0;2;2
2956;Gudrutis;BITUČIŲ;11383212272;Taip;0;2;0;2
2957;Gudrutis;BITUČIŲ;1434565790;Taip;1;0;0;1
2958;Gudrutis;BITUČIŲ;1238607523;Taip;0;1;0;1
2959;Gudrutis;BITUČIŲ;1998630017;Taip;5;0;0;5
2960;Gudrutis;Boružėlių;2197278086;Taip;22;0;0;22
2961;Gudrutis;Boružėlių;7984911632;Taip;0;1;0;1
2962;Gudrutis;Boružėlių;7755882832;Taip;0;1;0;1
2963;Gudrutis;Boružėlių;1012579870;Taip;3;0;0;3
2964;Gudrutis;Boružėlių;8512130106;Taip;0;1;0;1
2965;Gudrutis;Boružėlių;3919786807;Taip;0;1;3;4
2966;Gudrutis;Boružėlių;8165828215;Taip;2;1;2;5
2967;Gudrutis;Boružėlių;5508723821;Taip;10;2;0;12
2968;Gudrutis;Boružėlių;9044566825;Taip;0;3;0;3
2969;Gudrutis;Boružėlių;7942601528;Taip;0;10;0;10
2970;Gudrutis;Boružėlių;4844838728;Taip;0;1;3;4
2971;Gudrutis;Boružėlių;1685531183;Taip;4;0;0;4
2972;Gudrutis;Boružėlių;1051407930;Taip;0;0;1;1
2973;Gudrutis;Boružėlių;7663746093;Taip;17;1;0;18
2974;Gudrutis;Boružėlių;1485530468;Taip;8;0;0;8
2975;Gudrutis;Boružėlių;9253468183;Taip;3;0;0;3
2976;Gudrutis;Boružėlių;2630768189;Taip;0;0;1;1
2977;Gudrutis;Boružėlių;6358318238;Taip;10;2;1;13
2978;Gudrutis;Drugeliai;7930414623;Taip;0;5;0;5
2979;Gudrutis;Drugeliai;6458053920;Taip;3;0;0;3
2980;Gudrutis;Drugeliai;5498218329;Taip;22;0;0;22
2981;Gudrutis;Drugeliai;4600814480;Taip;8;0;1;9
2982;Gudrutis;Drugeliai;9454206104;Taip;0;8;0;8
2983;Gudrutis;Drugeliai;5054363773;Taip;4;1;3;8
2984;Gudrutis;Drugeliai;7531077386;Taip;1;0;0;1
2985;Gudrutis;Drugeliai;5931281687;Taip;0;7;2;9
2986;Gudrutis;Drugeliai;3264829331;Taip;11;1;0;12
2987;Gudrutis;Drugeliai;7143849852;Ne;3;1;0;4
2988;Gudrutis;Drugeliai;9784116399;Taip;0;1;3;4
2989;Gudrutis;Drugeliai;3743529726;Taip;3;0;19;22
2990;Gudrutis;Drugeliai;3760014407;Taip;0;8;2;10
2991;Gudrutis;Drugeliai;1588396018;Taip;2;1;2;5
2992;Gudrutis;Drugeliai;3316297441;Taip;4;1;0;5
2993;Gudrutis;Drugeliai;6307643172;Taip;0;1;1;2
2994;Gudrutis;Drugeliai;2256458624;Ne;8;1;0;9
2995;Jurginėlis;Ąžuoliukai;7753784918;Taip;0;26;0;26
2996;Jurginėlis;Ąžuoliukai;4852619394;Taip;0;6;0;6
2997;Jurginėlis;Ąžuoliukai;8972814655;Taip;0;2;3;5
2998;Jurginėlis;Ąžuoliukai;1361108271;Taip;0;0;1;1
2999;Jurginėlis;Ąžuoliukai;8784076886;Taip;0;10;0;10
3000;Jurginėlis;Ąžuoliukai;47243459592;Taip;3;0;0;3
3001;Jurginėlis;Ąžuoliukai;1563317396;Taip;0;7;0;7
3002;Jurginėlis;Ąžuoliukai;3068120316;Ne;3;0;0;3
3003;Jurginėlis;Ąžuoliukai;1701720412;Taip;5;0;1;6
3004;Jurginėlis;Ąžuoliukai;6111863896;Taip;0;11;0;11
3005;Jurginėlis;Ąžuoliukai;4851923549;Taip;0;3;1;4
3006;Jurginėlis;Ąžuoliukai;1467200002;Taip;2;4;8;14
3007;Jurginėlis;Ąžuoliukai;1758862051;Taip;0;1;0;1
3008;Jurginėlis;Ąžuoliukai;9589394406;Taip;0;0;2;2
3009;Jurginėlis;Ąžuoliukai;3027573572;Taip;0;4;1;5
3010;Jurginėlis;Ąžuoliukai;2171115974;Taip;0;2;1;3
3011;Jurginėlis;Ąžuoliukai;8920304044;Taip;0;1;1;2
3012;Jurginėlis;Ąžuoliukai;5756997642;Ne;0;10;0;10
3013;Jurginėlis;Ąžuoliukai;2446630485;Taip;0;2;0;2
3014;Jurginėlis;Ąžuoliukai;5386710069;Taip;0;16;0;16
3015;Jurginėlis;Žiogeliai;8144038013;Taip;0;5;0;5
3016;Jurginėlis;Žiogeliai;7928799065;Taip;0;1;0;1
3017;Jurginėlis;Žiogeliai;2624313807;Taip;0;2;0;2
3018;Jurginėlis;Žiogeliai;9646318532;Taip;3;5;0;8
3019;Jurginėlis;Žiogeliai;5242359650;Taip;0;12;0;12
3020;Jurginėlis;Žiogeliai;1102466152;Taip;0;2;0;2
3021;Jurginėlis;Žiogeliai;4806248290;Taip;0;6;0;6
3022;Jurginėlis;Žiogeliai;1082593212;Taip;3;6;0;9
3023;Jurginėlis;Žiogeliai;1175441410;Taip;0;5;0;5
3024;Jurginėlis;Žiogeliai;1983924909;Taip;0;14;0;14
3025;Jurginėlis;Žiogeliai;1586599624;Taip;0;5;0;5
3026;Jurginėlis;Žiogeliai;7297672386;Taip;0;11;0;11
3027;Jurginėlis;Žiogeliai;1787311340;Taip;0;3;0;3
3028;Jurginėlis;Žiogeliai;2535601005;Taip;8;0;0;8
3029;Jurginėlis;Žiogeliai;2639125463;Taip;0;1;0;1
3030;Jurginėlis;Žiogeliai;6413324051;Taip;0;8;0;8
3031;Jurginėlis;Žiogeliai;3708774681;Taip;0;22;0;22
3032;Jurginėlis;Žiogeliai;7920082372;Taip;0;13;0;13
3033;Jurginėlis;Žiogeliai;8227660508;Taip;0;2;0;2
3034;Jurginėlis;Pelėdžiukų;9882919290;Taip;0;1;0;1
3035;Jurginėlis;Pelėdžiukų;5984893389;Taip;0;9;0;9
3036;Jurginėlis;Pelėdžiukų;3079495897;Taip;0;10;0;10
3037;Jurginėlis;Pelėdžiukų;8727844649;Taip;8;1;14;23
3038;Jurginėlis;Pelėdžiukų;1455749921;Taip;7;10;0;17
3039;Jurginėlis;Pelėdžiukų;9946892497;Taip;0;1;3;4
3040;Jurginėlis;Pelėdžiukų;7809274980;Taip;0;0;6;6
3041;Jurginėlis;Pelėdžiukų;2417314519;Taip;0;2;0;2
3042;Jurginėlis;Pelėdžiukų;6968528293;Taip;0;2;0;2
3043;Jurginėlis;Pelėdžiukų;4292932046;Taip;0;1;0;1
3044;Jurginėlis;Pelėdžiukų;8779807396;Taip;4;0;1;5
3045;Jurginėlis;Pelėdžiukų;8443412187;Taip;0;0;1;1
3046;Jurginėlis;Pelėdžiukų;4967548277;Taip;0;16;7;23
3047;Jurginėlis;Pelėdžiukų;2925253653;Taip;5;0;0;5
3048;Jurginėlis;Pelėdžiukų;1340689348;Taip;0;13;0;13
3049;Jurginėlis;Pelėdžiukų;2221708420;Taip;4;0;0;4
3050;Jurginėlis;Pelėdžiukų;6181547354;Taip;19;1;0;20
3051;Jurginėlis;Pelėdžiukų;2490875633;Taip;0;0;3;3
3052;Jurginėlis;Pelėdžiukų;9760394658;Taip;0;1;1;2
3053;Jurginėlis;Boružėlių;51685299187;Taip;6;1;0;7
3054;Jurginėlis;Boružėlių;1828295769;Taip;1;0;0;1
3055;Jurginėlis;Boružėlių;17286700686;Ne;0;4;0;4
3056;Jurginėlis;Boružėlių;1329203545;Taip;0;1;0;1
3057;Jurginėlis;Boružėlių;1400142372;Taip;0;1;0;1
3058;Jurginėlis;Boružėlių;1881790340;Taip;0;8;0;8
3059;Jurginėlis;Boružėlių;12659496203;Taip;0;2;0;2
3060;Jurginėlis;Boružėlių;87991288027;Taip;3;0;0;3
3061;Jurginėlis;Boružėlių;94107758268;Taip;0;9;0;9
3062;Jurginėlis;Boružėlių;20527253593;Taip;0;1;0;1
3063;Jurginėlis;Boružėlių;92602685294;Taip;0;1;0;1
3064;Jurginėlis;Boružėlių;86427848578;Taip;0;1;0;1
3065;Jurginėlis;Bitučių;54494144846;Taip;0;7;0;7
3066;Jurginėlis;Bitučių;6072633581;Taip;0;7;0;7
3067;Jurginėlis;Bitučių;8414893303;Taip;7;5;1;13
3068;Jurginėlis;Bitučių;91909797332;Taip;0;3;0;3
3069;Jurginėlis;Bitučių;18273043496;Taip;0;5;0;5
3070;Jurginėlis;Bitučių;97726131559;Taip;0;0;5;5
3071;Jurginėlis;Bitučių;1416995981;Taip;0;0;1;1
3072;Jurginėlis;Bitučių;59935106302;Taip;0;0;3;3
3073;Jurginėlis;Bitučių;2544904907;Taip;5;4;4;13
3074;Jurginėlis;Bitučių;52877525045;Taip;0;0;4;4
3075;Jurginėlis;Bitučių;35653034443;Taip;1;1;0;2
3076;Jurginėlis;Bitučių;70733592257;Taip;0;0;3;3
3077;Jurginėlis;Bitučių;1295024976;Taip;0;0;1;1
3078;Jurginėlis;Bitučių;45200409204;Taip;0;0;2;2
3079;Jurginėlis;Bitučių;7278855565;Taip;0;0;5;5
3080;Jurginėlis;Skruzdeliukų;1351306981;Taip;11;0;0;11
3081;Jurginėlis;Skruzdeliukų;9146039217;Taip;3;0;0;3
3082;Jurginėlis;Skruzdeliukų;3558752347;Taip;0;5;0;5
3083;Jurginėlis;Skruzdeliukų;8509392550;Taip;6;0;0;6
3084;Jurginėlis;Skruzdeliukų;5734506036;Ne;0;4;0;4
3085;Jurginėlis;Skruzdeliukų;3699180485;Taip;0;6;0;6
3086;Jurginėlis;Skruzdeliukų;1634502874;Taip;0;0;2;2
3087;Jurginėlis;Skruzdeliukų;2441840949;Taip;0;5;0;5
3088;Jurginėlis;Skruzdeliukų;1763849354;Taip;7;0;0;7
3089;Jurginėlis;Skruzdeliukų;4944292549;Taip;0;6;0;6
3090;Jurginėlis;Skruzdeliukų;9506129699;Taip;14;0;0;14
3091;Jurginėlis;Skruzdeliukų;9550110246;Taip;1;3;0;4
3092;Jurginėlis;Skruzdeliukų;3822916547;Taip;12;0;0;12
3093;Jurginėlis;Skruzdeliukų;1204999684;Taip;17;0;0;17
3094;Jurginėlis;Skruzdeliukų;9937405742;Taip;10;0;0;10
3095;Jurginėlis;Skruzdeliukų;1726968598;Taip;0;15;0;15
3096;Jurginėlis;Skruzdeliukų;2332714713;Taip;14;4;0;18
3097;Jurginėlis;Skruzdeliukų;9961083854;Taip;0;5;0;5
3098;Jurginėlis;Skruzdeliukų;5180951251;Taip;12;0;3;15
3099;Jurginėlis;Skruzdeliukų;6542567172;Taip;2;9;0;11
3100;Jurginėlis;Drugelių;8823175066;Taip;7;0;0;7
3101;Jurginėlis;Drugelių;4180071775;Taip;0;0;6;6
3102;Jurginėlis;Drugelių;2820249307;Taip;4;2;0;6
3103;Jurginėlis;Drugelių;6197396872;Taip;0;0;1;1
3104;Jurginėlis;Drugelių;6341896288;Taip;1;0;2;3
3105;Jurginėlis;Drugelių;5958832413;Taip;4;0;0;4
3106;Jurginėlis;Drugelių;4763313715;Taip;22;0;0;22
3107;Jurginėlis;Drugelių;4432849717;Taip;0;3;0;3
3108;Jurginėlis;Drugelių;8097652962;Taip;3;1;0;4
3109;Jurginėlis;Drugelių;6671759364;Taip;3;0;0;3
3110;Jurginėlis;Drugelių;8937404520;Taip;0;0;3;3
3111;Jurginėlis;Drugelių;8161347781;Taip;0;4;0;4
3112;Jurginėlis;Drugelių;2113399076;Taip;0;0;1;1
3113;Jurginėlis;Drugelių;7283697595;Taip;8;0;0;8
3114;Jurginėlis;Žibučių;4979618298;Taip;0;1;0;1
3115;Jurginėlis;Žibučių;6636147085;Taip;3;5;0;8
3116;Jurginėlis;Žibučių;1438159631;Taip;2;6;1;9
3117;Jurginėlis;Žibučių;1336429135;Taip;8;6;4;18
3118;Jurginėlis;Žibučių;6948834218;Taip;10;6;4;20
3119;Jurginėlis;Žibučių;7721612113;Taip;7;1;0;8
3120;Jurginėlis;Žibučių;6988386438;Taip;0;3;0;3
3121;Jurginėlis;Žibučių;8111158692;Taip;0;2;0;2
3122;Jurginėlis;Žibučių;5936508522;Taip;0;20;0;20
3123;Jurginėlis;Žibučių;6717892969;Taip;0;2;0;2
3124;Jurginėlis;Žibučių;5126282685;Taip;18;5;0;23
3125;Jurginėlis;Žibučių;7977676733;Taip;3;2;1;6
3126;Jurginėlis;Žibučių;7530846375;Taip;0;4;0;4
3127;Jurginėlis;Žibučių;3899526893;Taip;0;2;0;2
3128;Jurginėlis;Žibučių;3861311860;Taip;5;2;0;7
3129;Jurginėlis;Žibučių;1263601087;Taip;3;0;1;4
3130;Jurginėlis;Žibučių;5549766339;Taip;0;3;0;3
3131;Jurginėlis;Žibučių;4429780802;Taip;0;1;0;1
3132;Jurginėlis;Zuikučių;1762685527;Taip;0;1;0;1
3133;Jurginėlis;Zuikučių;8178112926;Taip;10;0;0;10
3134;Jurginėlis;Zuikučių;78496894090;Taip;0;14;0;14
3135;Jurginėlis;Zuikučių;51603579121;Taip;0;3;0;3
3136;Jurginėlis;Zuikučių;9714764714;Taip;10;0;0;10
3137;Jurginėlis;Zuikučių;2264351097;Taip;0;11;0;11
3138;Jurginėlis;Zuikučių;6475508583;Taip;0;5;4;9
3139;Jurginėlis;Zuikučių;91517951071;Taip;0;3;0;3
3140;Jurginėlis;Zuikučių;7419836868;Ne;0;1;0;1
3141;Jurginėlis;Zuikučių;1500087367;Taip;0;6;0;6
3142;Jurginėlis;Zuikučių;1773100970;Taip;0;5;0;5
3143;Jurginėlis;Zuikučių;1498351759;Taip;3;2;0;5
3144;Jurginėlis;Zuikučių;8084970770;Taip;3;0;0;3
3145;Jurginėlis;Zuikučių;1159550277;Taip;0;5;0;5
3146;Jurginėlis;Zuikučių;75383941896;Taip;0;1;0;1
3147;Jurginėlis;Zuikučių;87444065733;Taip;0;8;0;8
3148;Jurginėlis;Zuikučių;1927843089;Taip;10;1;0;11
3149;Jurginėlis;Zuikučių;6707289955;Taip;12;1;0;13
3150;Jurginėlis;Viščiukų;5037980414;Taip;4;1;6;11
3151;Jurginėlis;Viščiukų;5160581631;Taip;5;5;0;10
3152;Jurginėlis;Viščiukų;7251598691;Taip;0;1;0;1
3153;Jurginėlis;Viščiukų;3083045137;Taip;0;5;0;5
3154;Jurginėlis;Viščiukų;7010130915;Taip;5;0;1;6
3155;Jurginėlis;Viščiukų;7907096012;Taip;5;11;0;16
3156;Jurginėlis;Viščiukų;7250246853;Taip;10;4;0;14
3157;Jurginėlis;Viščiukų;4110053674;Taip;22;6;0;28
3158;Jurginėlis;Viščiukų;6438669072;Taip;0;8;0;8
3159;Jurginėlis;Viščiukų;7300018733;Taip;0;10;0;10
3160;Jurginėlis;Viščiukų;4674128568;Taip;0;18;4;22
3161;Jurginėlis;Viščiukų;9305884152;Taip;0;16;5;21
3162;Jurginėlis;Viščiukų;4191553800;Ne;0;28;0;28
3163;Jurginėlis;Viščiukų;6906225772;Taip;9;6;3;18
3164;Jurginėlis;Meškiukų;9850874714;Taip;0;0;1;1
3165;Jurginėlis;Meškiukų;6202225321;Taip;4;0;1;5
3166;Jurginėlis;Meškiukų;6153432639;Taip;8;0;0;8
3167;Jurginėlis;Meškiukų;5861418459;Taip;9;9;0;18
3168;Jurginėlis;Meškiukų;6851855147;Taip;8;0;0;8
3169;Jurginėlis;Meškiukų;7081618073;Taip;9;1;1;11
3170;Jurginėlis;Meškiukų;2501462080;Taip;5;0;0;5
3171;Jurginėlis;Meškiukų;5869170503;Taip;0;9;0;9
3172;Jurginėlis;Meškiukų;5861832676;Taip;5;0;0;5
3173;Jurginėlis;Meškiukų;6168508647;Taip;8;0;3;11
3174;Jurginėlis;Meškiukų;8969526123;Taip;0;0;1;1
3175;Jurginėlis;Meškiukų;9571275146;Taip;0;13;0;13
3176;Jurginėlis;Meškiukų;9889620429;Taip;0;9;0;9
3177;Jurginėlis;Meškiukų;9029587175;Taip;0;9;0;9
3178;Jurginėlis;Meškiukų;3324811458;Taip;6;0;0;6
3179;Jurginėlis;Meškiukų;3933113321;Taip;0;4;0;4
3180;Jurginėlis;Meškiukų;8310464710;Taip;5;0;17;22
3181;Jurginėlis;Gandriukų;8017976529;Taip;0;19;0;19
3182;Jurginėlis;Gandriukų;3530906368;Ne;0;5;0;5
3183;Jurginėlis;Gandriukų;6806704355;Taip;9;5;0;14
3184;Jurginėlis;Gandriukų;9288380246;Taip;0;13;0;13
3185;Jurginėlis;Gandriukų;2548920722;Taip;0;6;0;6
3186;Jurginėlis;Gandriukų;7288921301;Taip;4;10;3;17
3187;Jurginėlis;Gandriukų;4827340942;Taip;0;1;1;2
3188;Jurginėlis;Gandriukų;5921714669;Taip;0;10;0;10
3189;Jurginėlis;Gandriukų;1414888906;Taip;0;5;2;7
3190;Jurginėlis;Gandriukų;2225892248;Taip;0;0;3;3
3191;Jurginėlis;Gandriukų;6579565337;Taip;0;9;0;9
3192;Jurginėlis;Gandriukų;7990015623;Taip;0;2;0;2
3193;Jurginėlis;Gandriukų;4158502752;Taip;0;3;0;3
3194;Jurginėlis;Gandriukų;2214809186;Taip;8;0;0;8
3195;Jurginėlis;Gandriukų;3284464951;Taip;0;26;0;26
3196;Jurginėlis;Gandriukų;2263818210;Taip;0;15;0;15
3197;Jurginėlis;Gandriukų;3091019969;Taip;11;5;0;16
3198;Jurginėlis;Gandriukų;2837099502;Taip;6;7;4;17
3199;Jurginėlis;Gandriukų;4295285885;Taip;0;9;0;9
3200;Jurginėlis;Gandriukų;3462969423;Taip;1;4;1;6
3201;Jurginėlis;Gandriukų;7486778826;Taip;14;7;0;21
3202;Karusėlė;PAGRANDUKAS;1621482372;Taip;0;7;0;7
3203;Karusėlė;PAGRANDUKAS;3330374479;Taip;7;1;0;8
3204;Karusėlė;PAGRANDUKAS;6183785840;Taip;0;8;0;8
3205;Karusėlė;PAGRANDUKAS;3984262482;Taip;6;16;0;22
3206;Karusėlė;PAGRANDUKAS;9130534156;Taip;6;0;1;7
3207;Karusėlė;PAGRANDUKAS;3660843696;Taip;6;2;1;9
3208;Karusėlė;PAGRANDUKAS;5132581245;Taip;0;7;0;7
3209;Karusėlė;PAGRANDUKAS;2412418335;Taip;0;5;0;5
3210;Karusėlė;PAGRANDUKAS;7393434659;Taip;0;1;0;1
3211;Karusėlė;PAGRANDUKAS;5695697634;Taip;6;0;1;7
3212;Karusėlė;PAGRANDUKAS;8127218866;Taip;10;1;0;11
3213;Karusėlė;PAGRANDUKAS;3620722907;Taip;5;0;2;7
3214;Karusėlė;PAGRANDUKAS;7013765804;Taip;0;12;0;12
3215;Karusėlė;PAGRANDUKAS;3429495073;Taip;3;2;0;5
3216;Karusėlė;PAGRANDUKAS;5951045233;Taip;3;2;4;9
3217;Karusėlė;PAGRANDUKAS;6252613489;Taip;3;6;0;9
3218;Karusėlė;PAGRANDUKAS;5595950213;Taip;11;0;0;11
3219;Karusėlė;PAGRANDUKAS;6004882312;Taip;12;1;2;15
3220;Karusėlė;PAGRANDUKAS;6856800484;Taip;5;0;0;5
3221;Karusėlė;PAGRANDUKAS;5028265234;Taip;0;14;3;17
3222;Karusėlė;PAGRANDUKAS;3972815393;Taip;0;10;0;10
3223;Karusėlė;PAGRANDUKAS;8157193503;Taip;4;8;0;12
3224;Karusėlė;PAGRANDUKAS;8656806219;Taip;4;2;0;6
3225;Karusėlė;NYKŠTUKAS;1560316431;Taip;0;8;0;8
3226;Karusėlė;NYKŠTUKAS;1250530261;Taip;0;8;0;8
3227;Karusėlė;NYKŠTUKAS;1397009220;Taip;0;6;0;6
3228;Karusėlė;NYKŠTUKAS;62938709605;Taip;7;0;0;7
3229;Karusėlė;NYKŠTUKAS;1534689679;Taip;5;0;0;5
3230;Karusėlė;NYKŠTUKAS;1226371512;Taip;0;0;5;5
3231;Karusėlė;NYKŠTUKAS;68739693482;Taip;0;1;0;1
3232;Karusėlė;NYKŠTUKAS;9377426384;Taip;0;5;0;5
3233;Karusėlė;NYKŠTUKAS;1311631554;Taip;11;0;0;11
3234;Karusėlė;NYKŠTUKAS;5481354767;Taip;0;6;0;6
3235;Karusėlė;NYKŠTUKAS;1135386852;Taip;2;2;0;4
3236;Karusėlė;NYKŠTUKAS;9683054409;Ne;0;11;0;11
3237;Karusėlė;NYKŠTUKAS;45634061915;Taip;0;3;0;3
3238;Karusėlė;NYKŠTUKAS;1886562437;Taip;0;4;0;4
3239;Karusėlė;NYKŠTUKAS;7707725540;Taip;8;0;0;8
3240;Karusėlė;NYKŠTUKAS;4068106379;Taip;0;1;0;1
3241;Karusėlė;NYKŠTUKAS;3963576314;Taip;0;1;2;3
3242;Karusėlė;BITUTĖ;1065703569;Taip;0;13;0;13
3243;Karusėlė;BITUTĖ;4291893779;Taip;3;0;0;3
3244;Karusėlė;BITUTĖ;1295435839;Taip;0;5;0;5
3245;Karusėlė;BITUTĖ;3870601809;Taip;0;1;0;1
3246;Karusėlė;BITUTĖ;2001623432;Taip;0;1;13;14
3247;Karusėlė;BITUTĖ;8033732937;Taip;0;4;0;4
3248;Karusėlė;BITUTĖ;1798723081;Taip;3;0;0;3
3249;Karusėlė;BITUTĖ;1593728369;Taip;3;0;0;3
3250;Karusėlė;BITUTĖ;6417699445;Taip;0;4;0;4
3251;Karusėlė;BITUTĖ;1193711193;Taip;0;9;0;9
3252;Karusėlė;BITUTĖ;2426822679;Taip;0;7;0;7
3253;Karusėlė;BITUTĖ;1205498782;Taip;0;15;0;15
3254;Karusėlė;BITUTĖ;1322617786;Taip;2;0;0;2
3255;Karusėlė;BITUTĖ;7824913364;Ne;8;1;0;9
3256;Karusėlė;BITUTĖ;7995385969;Taip;4;0;0;4
3257;Karusėlė;BITUTĖ;4735916273;Taip;0;7;0;7
3258;Karusėlė;BITUTĖ;5960946826;Taip;6;1;0;7
3259;Karusėlė;BORUŽĖLĖ;1705790474;Taip;3;0;0;3
3260;Karusėlė;BORUŽĖLĖ;8608177987;Taip;0;1;0;1
3261;Karusėlė;BORUŽĖLĖ;1311907441;Ne;14;1;0;15
3262;Karusėlė;BORUŽĖLĖ;6313010762;Taip;0;1;0;1
3263;Karusėlė;BORUŽĖLĖ;5859827168;Taip;8;0;0;8
3264;Karusėlė;BORUŽĖLĖ;37349219339;Taip;0;6;0;6
3265;Karusėlė;BORUŽĖLĖ;6811862463;Taip;0;10;0;10
3266;Karusėlė;BORUŽĖLĖ;5471989295;Taip;9;2;1;12
3267;Karusėlė;BORUŽĖLĖ;9753876554;Taip;0;1;1;2
3268;Karusėlė;BORUŽĖLĖ;8717484092;Taip;5;0;0;5
3269;Karusėlė;BORUŽĖLĖ;5632697184;Taip;5;2;4;11
3270;Karusėlė;BORUŽĖLĖ;2247913568;Taip;0;1;0;1
3271;Karusėlė;BORUŽĖLĖ;4262640017;Taip;0;2;0;2
3272;Karusėlė;BORUŽĖLĖ;4845558814;Taip;9;8;0;17
3273;Karusėlė;BORUŽĖLĖ;8406462155;Taip;8;1;0;9
3274;Karusėlė;BORUŽĖLĖ;6495631086;Taip;0;1;0;1
3275;Karusėlė;BORUŽĖLĖ;1183484176;Taip;7;4;0;11
3276;Karusėlė;BORUŽĖLĖ;2287979864;Taip;5;1;2;8
3277;Karusėlė;BORUŽĖLĖ;3389843421;Taip;9;6;0;15
3278;Karusėlė;BORUŽĖLĖ;9409462734;Ne;0;1;6;7
3279;Karusėlė;UOGELĖ;9805481603;Taip;5;1;0;6
3280;Karusėlė;UOGELĖ;8182071103;Taip;11;3;0;14
3281;Karusėlė;UOGELĖ;8175498192;Taip;0;0;9;9
3282;Karusėlė;UOGELĖ;3053539045;Taip;0;0;6;6
3283;Karusėlė;UOGELĖ;2084276906;Taip;16;0;1;17
3284;Karusėlė;UOGELĖ;8665314366;Taip;5;10;0;15
3285;Karusėlė;UOGELĖ;4121668687;Taip;7;0;3;10
3286;Karusėlė;UOGELĖ;8316147204;Taip;5;14;0;19
3287;Karusėlė;UOGELĖ;5504719953;Taip;0;9;0;9
3288;Karusėlė;UOGELĖ;5919009583;Taip;0;17;5;22
3289;Karusėlė;UOGELĖ;4199597984;Taip;0;3;0;3
3290;Karusėlė;UOGELĖ;2383023280;Taip;0;3;0;3
3291;Karusėlė;UOGELĖ;1575408822;Taip;0;5;0;5
3292;Karusėlė;UOGELĖ;3917113787;Taip;0;1;0;1
3293;Karusėlė;UOGELĖ;4638918427;Taip;0;0;1;1
3294;Karusėlė;UOGELĖ;3615957761;Taip;15;7;0;22
3295;Karusėlė;UOGELĖ;3514026443;Taip;5;0;0;5
3296;Karusėlė;UOGELĖ;1891147022;Taip;0;0;2;2
3297;Karusėlė;UOGELĖ;9389017016;Taip;0;0;3;3
3298;Karusėlė;GINTARĖLIS;89669425763;Taip;0;0;21;21
3299;Karusėlė;GINTARĖLIS;1625704473;Taip;0;3;0;3
3300;Karusėlė;GINTARĖLIS;5267055924;Taip;0;2;0;2
3301;Karusėlė;GINTARĖLIS;17254955427;Taip;0;2;7;9
3302;Karusėlė;GINTARĖLIS;33935704865;Taip;0;3;0;3
3303;Karusėlė;GINTARĖLIS;80377577910;Taip;0;0;15;15
3304;Karusėlė;GINTARĖLIS;1302846796;Taip;0;2;1;3
3305;Karusėlė;GINTARĖLIS;6181109173;Taip;0;0;5;5
3306;Karusėlė;GINTARĖLIS;90635580825;Taip;0;0;8;8
3307;Karusėlė;GINTARĖLIS;93635113154;Taip;0;0;2;2
3308;Karusėlė;GINTARĖLIS;2386140324;Taip;4;5;0;9
3309;Karusėlė;GINTARĖLIS;90731574209;Taip;0;3;19;22
3310;Karusėlė;GINTARĖLIS;6596029324;Taip;4;0;0;4
3311;Karusėlė;GINTARĖLIS;1477282992;Taip;0;6;0;6
3312;Karusėlė;GINTARĖLIS;1487641646;Taip;0;4;0;4
3313;Karusėlė;GINTARĖLIS;9274456755;Taip;0;6;0;6
3314;Karusėlė;GINTARĖLIS;2606829789;Ne;3;4;0;7
3315;Karusėlė;GINTARĖLIS;47491327916;Taip;0;7;0;7
3316;Karusėlė;GINTARĖLIS;52452661421;Ne;10;0;5;15
3317;Karusėlė;SAULUTĖ;5627583683;Taip;4;10;0;14
3318;Karusėlė;SAULUTĖ;5985915835;Taip;1;0;0;1
3319;Karusėlė;SAULUTĖ;2242659064;Taip;0;16;2;18
3320;Karusėlė;SAULUTĖ;5146709341;Taip;0;1;0;1
3321;Karusėlė;SAULUTĖ;9996567374;Taip;0;4;0;4
3322;Karusėlė;SAULUTĖ;8331985564;Taip;0;2;0;2
3323;Karusėlė;SAULUTĖ;9400171357;Taip;7;5;0;12
3324;Karusėlė;SAULUTĖ;9656723409;Taip;0;9;0;9
3325;Karusėlė;SAULUTĖ;5766390337;Taip;6;3;0;9
3326;Karusėlė;SAULUTĖ;5803808409;Taip;0;2;0;2
3327;Karusėlė;SAULUTĖ;2269840705;Taip;5;2;0;7
3328;Karusėlė;SAULUTĖ;3149575456;Taip;3;0;0;3
3329;Karusėlė;SAULUTĖ;5640656442;Taip;4;1;0;5
3330;Karusėlė;SAULUTĖ;9451789237;Taip;1;11;0;12
3331;Karusėlė;SAULUTĖ;9450841251;Taip;7;8;1;16
3332;Karusėlė;SAULUTĖ;3082636224;Taip;0;0;6;6
3333;Karusėlė;TIGRIUKAS;1982126099;Taip;0;6;0;6
3334;Karusėlė;TIGRIUKAS;1292576152;Taip;0;6;0;6
3335;Karusėlė;TIGRIUKAS;18831943978;Taip;0;9;0;9
3336;Karusėlė;TIGRIUKAS;1305485683;Taip;9;1;0;10
3337;Karusėlė;TIGRIUKAS;3752570475;Taip;0;5;0;5
3338;Karusėlė;TIGRIUKAS;8881750322;Taip;4;0;0;4
3339;Karusėlė;TIGRIUKAS;8946147763;Taip;8;0;0;8
3340;Karusėlė;TIGRIUKAS;3960354989;Taip;0;0;1;1
3341;Karusėlė;TIGRIUKAS;8076851284;Taip;2;1;0;3
3342;Karusėlė;TIGRIUKAS;4426462711;Taip;8;0;1;9
3343;Karusėlė;TIGRIUKAS;9484773068;Taip;0;1;0;1
3344;Karusėlė;TIGRIUKAS;8678437720;Taip;5;2;0;7
3345;Karusėlė;TIGRIUKAS;1698478530;Taip;9;1;0;10
3346;Karusėlė;TIGRIUKAS;9561892809;Taip;18;0;0;18
3347;Karusėlė;TIGRIUKAS;9726299722;Taip;0;4;0;4
3348;Karusėlė;TIGRIUKAS;1576201225;Taip;0;1;0;1
3349;Karusėlė;TIGRIUKAS;9344514262;Taip;9;0;0;9
3350;Karusėlė;VAIVORYKŠTĖ;1289442716;Taip;3;0;1;4
3351;Karusėlė;VAIVORYKŠTĖ;9855242602;Taip;8;0;1;9
3352;Karusėlė;VAIVORYKŠTĖ;8063412271;Taip;7;0;0;7
3353;Karusėlė;VAIVORYKŠTĖ;9408843254;Taip;0;3;3;6
3354;Karusėlė;VAIVORYKŠTĖ;3514315636;Taip;8;0;4;12
3355;Karusėlė;VAIVORYKŠTĖ;8085919723;Taip;8;0;4;12
3356;Karusėlė;VAIVORYKŠTĖ;5444753290;Taip;5;5;0;10
3357;Karusėlė;VAIVORYKŠTĖ;1581504806;Taip;17;0;0;17
3358;Karusėlė;VAIVORYKŠTĖ;2215367063;Taip;0;1;0;1
3359;Karusėlė;VAIVORYKŠTĖ;6424622497;Taip;10;0;1;11
3360;Karusėlė;VAIVORYKŠTĖ;5855430678;Taip;0;2;0;2
3361;Karusėlė;VAIVORYKŠTĖ;5128774216;Taip;2;0;2;4
3362;Karusėlė;VAIVORYKŠTĖ;2757263085;Taip;0;4;0;4
3363;Karusėlė;VAIVORYKŠTĖ;4110024673;Taip;3;5;0;8
3364;Karusėlė;VAIVORYKŠTĖ;6444553698;Ne;2;9;0;11
3365;Karusėlė;VAIVORYKŠTĖ;9400856559;Taip;0;5;0;5
3366;Karusėlė;VAIVORYKŠTĖ;1083786182;Taip;0;5;0;5
3367;Karusėlė;VAIVORYKŠTĖ;5998868204;Taip;0;1;1;2
3368;Karusėlė;VAIVORYKŠTĖ;6734936247;Taip;0;14;0;14
3369;Karusėlė;"AUKSINĖ ŽUVELĖ";3714893919;Taip;14;8;0;22
3370;Karusėlė;"AUKSINĖ ŽUVELĖ";8855096080;Taip;0;8;0;8
3371;Karusėlė;"AUKSINĖ ŽUVELĖ";4966362343;Taip;9;1;0;10
3372;Karusėlė;"AUKSINĖ ŽUVELĖ";2397938004;Taip;8;0;0;8
3373;Karusėlė;"AUKSINĖ ŽUVELĖ";3696384277;Taip;0;6;0;6
3374;Karusėlė;"AUKSINĖ ŽUVELĖ";7817417459;Taip;13;0;0;13
3375;Karusėlė;"AUKSINĖ ŽUVELĖ";9654804545;Taip;5;2;0;7
3376;Karusėlė;"AUKSINĖ ŽUVELĖ";4445214427;Taip;3;3;0;6
3377;Karusėlė;"AUKSINĖ ŽUVELĖ";7439791054;Taip;5;7;0;12
3378;Karusėlė;"AUKSINĖ ŽUVELĖ";3605966015;Taip;3;2;1;6
3379;Karusėlė;"AUKSINĖ ŽUVELĖ";2993499990;Taip;16;0;0;16
3380;Karusėlė;"AUKSINĖ ŽUVELĖ";9997776739;Taip;9;10;0;19
3381;Karusėlė;"AUKSINĖ ŽUVELĖ";5834070970;Taip;8;14;0;22
3382;Karusėlė;"AUKSINĖ ŽUVELĖ";9354431582;Taip;0;1;0;1
3383;Karusėlė;"AUKSINĖ ŽUVELĖ";2945027875;Taip;19;0;0;19
3384;Karusėlė;"AUKSINĖ ŽUVELĖ";3622914118;Taip;0;1;0;1
3385;Karusėlė;"AUKSINĖ ŽUVELĖ";8671884362;Taip;7;0;0;7
3386;Karusėlė;"AUKSINĖ ŽUVELĖ";5216815933;Taip;9;3;0;12
3387;Karusėlė;RAMUNĖ;8409412605;Taip;0;0;2;2
3388;Karusėlė;RAMUNĖ;8481143199;Taip;2;0;0;2
3389;Karusėlė;RAMUNĖ;1019322763;Taip;12;0;0;12
3390;Karusėlė;RAMUNĖ;3534074990;Taip;15;2;0;17
3391;Karusėlė;RAMUNĖ;3904453423;Taip;0;4;0;4
3392;Karusėlė;RAMUNĖ;7489136297;Taip;11;0;0;11
3393;Karusėlė;RAMUNĖ;3773170060;Taip;0;2;0;2
3394;Karusėlė;RAMUNĖ;7540323186;Taip;9;0;1;10
3395;Karusėlė;RAMUNĖ;6905591549;Taip;9;0;0;9
3396;Karusėlė;RAMUNĖ;3136606610;Taip;0;5;0;5
3397;Karusėlė;RAMUNĖ;6581798125;Taip;7;0;2;9
3398;Karusėlė;RAMUNĖ;8362740639;Taip;9;0;0;9
3399;Karusėlė;RAMUNĖ;3157893936;Taip;17;0;0;17
3400;Karusėlė;RAMUNĖ;3460470459;Taip;3;0;0;3
3401;Karusėlė;RAMUNĖ;4302662341;Taip;0;9;0;9
3402;Karusėlė;"NAUJA DARŽELIS";8012963667;Taip;0;0;2;2
3403;Karusėlė;"NAUJA DARŽELIS";7501323454;Taip;0;0;9;9
3404;Karusėlė;"NAUJA DARŽELIS";4130693235;Taip;16;0;2;18
3405;Karusėlė;"NAUJA DARŽELIS";9304912028;Taip;0;0;2;2
3406;Karusėlė;"NAUJA DARŽELIS";2306922755;Taip;0;8;0;8
3407;Karusėlė;"NAUJA DARŽELIS";9340167973;Taip;5;0;0;5
3408;Karusėlė;"NAUJA DARŽELIS";1412890120;Taip;9;0;5;14
3409;Karusėlė;"NAUJA DARŽELIS";6826455161;Taip;0;0;2;2
3410;Karusėlė;"NAUJA DARŽELIS";6062361348;Ne;0;0;4;4
3411;Karusėlė;"NAUJA DARŽELIS";2160071272;Taip;0;0;4;4
3412;Karusėlė;"NAUJA DARŽELIS";5135054911;Taip;8;0;5;13
3413;Karusėlė;"NAUJA DARŽELIS";2727440190;Taip;0;0;7;7
3414;Karusėlė;"NAUJA DARŽELIS";3661917922;Taip;4;6;1;11
3415;Karusėlė;"NAUJA DARŽELIS";4211688032;Taip;0;0;2;2
3416;Karusėlė;"NAUJA DARŽELIS";3271464159;Taip;12;0;0;12
3417;Karusėlė;"NAUJA DARŽELIS";5802996641;Taip;0;0;1;1
3418;Karusėlė;"NAUJA DARŽELIS";4325959483;Taip;0;4;0;4
3419;Karusėlė;"NAUJA DARŽELIS";1211005513;Taip;0;0;7;7
3420;Karusėlė;"NAUJA DARŽELIS";4951249625;Taip;0;0;4;4
3421;Karusėlė;"NAUJA DARŽELIS";9985033530;Taip;0;3;0;3
3422;Kaštonas;NYKŠTUKAI;9061158412;Ne;3;8;0;11
3423;Kaštonas;NYKŠTUKAI;2832688622;Ne;8;3;0;11
3424;Kaštonas;NYKŠTUKAI;7408901858;Taip;10;7;0;17
3425;Kaštonas;NYKŠTUKAI;8582453109;Taip;0;10;0;10
3426;Kaštonas;NYKŠTUKAI;2106924435;Taip;0;4;0;4
3427;Kaštonas;NYKŠTUKAI;5307755844;Taip;10;0;0;10
3428;Kaštonas;NYKŠTUKAI;4215759647;Taip;0;7;0;7
3429;Kaštonas;NYKŠTUKAI;6289073634;Taip;0;7;0;7
3430;Kaštonas;NYKŠTUKAI;8297662673;Taip;7;1;0;8
3431;Kaštonas;NYKŠTUKAI;3961661158;Taip;6;7;0;13
3432;Kaštonas;NYKŠTUKAI;2434765663;Ne;10;0;0;10
3433;Kaštonas;NYKŠTUKAI;4444087861;Taip;5;4;0;9
3434;Kaštonas;NYKŠTUKAI;6934262510;Taip;0;6;0;6
3435;Kaštonas;NYKŠTUKAI;3383390078;Taip;0;6;0;6
3436;Kaštonas;NYKŠTUKAI;2361839733;Taip;10;1;0;11
3437;Kaštonas;NYKŠTUKAI;6967725663;Taip;0;8;0;8
3438;Kaštonas;NYKŠTUKAI;8446233414;Taip;10;1;0;11
3439;Kaštonas;NYKŠTUKAI;7911007041;Taip;0;10;0;10
3440;Kaštonas;DRUGELIAI;6511223066;Taip;10;2;0;12
3441;Kaštonas;DRUGELIAI;81834426663;Taip;3;1;0;4
3442;Kaštonas;DRUGELIAI;9702914628;Taip;17;0;0;17
3443;Kaštonas;DRUGELIAI;2417951642;Taip;0;1;0;1
3444;Kaštonas;DRUGELIAI;5884427036;Taip;6;5;0;11
3445;Kaštonas;DRUGELIAI;6251564828;Taip;0;2;0;2
3446;Kaštonas;DRUGELIAI;5969052108;Taip;14;0;0;14
3447;Kaštonas;DRUGELIAI;8166925991;Taip;0;14;0;14
3448;Kaštonas;DRUGELIAI;6114301692;Taip;0;3;0;3
3449;Kaštonas;DRUGELIAI;9985164505;Taip;5;5;0;10
3450;Kaštonas;DRUGELIAI;8257643251;Taip;3;15;0;18
3451;Kaštonas;DRUGELIAI;8990194475;Taip;0;12;0;12
3452;Kaštonas;KIŠKUČIAI;6175014441;Taip;9;2;0;11
3453;Kaštonas;KIŠKUČIAI;8275673303;Taip;9;1;0;10
3454;Kaštonas;KIŠKUČIAI;2877124424;Taip;0;10;0;10
3455;Kaštonas;KIŠKUČIAI;8214699601;Taip;0;8;0;8
3456;Kaštonas;KIŠKUČIAI;4837002666;Taip;0;16;0;16
3457;Kaštonas;KIŠKUČIAI;1748975865;Taip;0;3;0;3
3458;Kaštonas;KIŠKUČIAI;9903176616;Taip;1;2;0;3
3459;Kaštonas;KIŠKUČIAI;4061364544;Taip;0;1;0;1
3460;Kaštonas;KIŠKUČIAI;1614180834;Taip;0;0;18;18
3461;Kaštonas;KIŠKUČIAI;1031628633;Taip;5;7;0;12
3462;Kaštonas;KIŠKUČIAI;4551111709;Taip;5;7;0;12
3463;Kaštonas;KIŠKUČIAI;8014645421;Taip;4;0;0;4
3464;Kaštonas;KIŠKUČIAI;1761520786;Taip;11;5;0;16
3465;Kaštonas;KIŠKUČIAI;9285927858;Taip;0;15;0;15
3466;Kaštonas;KIŠKUČIAI;8250964197;Taip;0;1;0;1
3467;Kaštonas;KIŠKUČIAI;2701042709;Taip;0;10;0;10
3468;Kaštonas;KIŠKUČIAI;9778140363;Ne;15;4;0;19
3469;Kaštonas;KIŠKUČIAI;7290414209;Taip;3;17;0;20
3470;Kaštonas;BITUTĖS;1162926887;Taip;0;2;0;2
3471;Kaštonas;BITUTĖS;1465714333;Taip;0;7;0;7
3472;Kaštonas;BITUTĖS;1252815477;Taip;9;4;0;13
3473;Kaštonas;BITUTĖS;1747580231;Ne;0;14;0;14
3474;Kaštonas;BITUTĖS;4449017708;Taip;6;6;0;12
3475;Kaštonas;BITUTĖS;2539596633;Taip;0;0;1;1
3476;Kaštonas;BITUTĖS;3507672150;Taip;0;4;0;4
3477;Kaštonas;BITUTĖS;1859126564;Taip;0;13;0;13
3478;Kaštonas;BITUTĖS;4033866425;Taip;0;4;0;4
3479;Kaštonas;BITUTĖS;8151333699;Taip;3;1;0;4
3480;Kaštonas;BITUTĖS;7291448857;Taip;0;9;0;9
3481;Kaštonas;BITUTĖS;5328263421;Taip;4;0;0;4
3482;Kaštonas;BITUTĖS;3649329598;Taip;0;13;0;13
3483;Kaštonas;MEŠKIUKAI;8797584508;Taip;10;0;0;10
3484;Kaštonas;MEŠKIUKAI;7138581709;Taip;0;7;0;7
3485;Kaštonas;MEŠKIUKAI;9965517774;Taip;0;7;0;7
3486;Kaštonas;MEŠKIUKAI;1196590128;Taip;5;2;2;9
3487;Kaštonas;MEŠKIUKAI;2125410714;Taip;0;7;0;7
3488;Kaštonas;MEŠKIUKAI;6606094891;Taip;6;2;0;8
3489;Kaštonas;MEŠKIUKAI;1364391105;Taip;6;2;0;8
3490;Kaštonas;MEŠKIUKAI;5153948802;Ne;0;0;1;1
3491;Kaštonas;MEŠKIUKAI;3554337770;Taip;0;0;2;2
3492;Kaštonas;MEŠKIUKAI;1249299633;Taip;0;0;5;5
3493;Kaštonas;MEŠKIUKAI;7553024183;Taip;0;4;0;4
3494;Kaštonas;MEŠKIUKAI;1801371129;Taip;6;0;0;6
3495;Kaštonas;MEŠKIUKAI;4824511567;Taip;7;0;0;7
3496;Kaštonas;MEŠKIUKAI;7956422880;Taip;2;3;0;5
3497;Kaštonas;MEŠKIUKAI;70838449788;Taip;3;1;0;4
3498;Kaštonas;MEŠKIUKAI;4308169582;Taip;8;1;4;13
3499;Kaštonas;BORUŽĖLĖS;9320223622;Taip;0;14;0;14
3500;Kaštonas;BORUŽĖLĖS;6896372095;Taip;4;2;0;6
3501;Kaštonas;BORUŽĖLĖS;1141693073;Taip;4;1;0;5
3502;Kaštonas;BORUŽĖLĖS;6425908247;Taip;6;0;3;9
3503;Kaštonas;BORUŽĖLĖS;9356018629;Taip;1;2;0;3
3504;Kaštonas;BORUŽĖLĖS;7992154554;Taip;0;2;0;2
3505;Kaštonas;BORUŽĖLĖS;2020612346;Taip;10;1;0;11
3506;Kaštonas;BORUŽĖLĖS;4384907654;Taip;9;3;0;12
3507;Kaštonas;BORUŽĖLĖS;3544696101;Taip;4;5;0;9
3508;Kaštonas;BORUŽĖLĖS;9298372326;Ne;9;2;0;11
3509;Kaštonas;BORUŽĖLĖS;2178971789;Taip;3;0;0;3
3510;Kaštonas;BORUŽĖLĖS;6585977073;Taip;22;0;0;22
3511;Kaštonas;BORUŽĖLĖS;4570064071;Taip;3;6;0;9
3512;Kaštonas;BORUŽĖLĖS;1207372235;Ne;8;2;0;10
3513;Krivūlė;SPINDULIUKAI;3233000497;Taip;11;0;4;15
3514;Krivūlė;SPINDULIUKAI;2191720088;Taip;10;0;4;14
3515;Krivūlė;SPINDULIUKAI;1937803301;Taip;0;0;1;1
3516;Krivūlė;SPINDULIUKAI;9865192795;Taip;0;0;2;2
3517;Krivūlė;SPINDULIUKAI;4094383258;Taip;4;0;0;4
3518;Krivūlė;SPINDULIUKAI;3913058095;Taip;0;0;2;2
3519;Krivūlė;SPINDULIUKAI;1840809151;Taip;0;0;1;1
3520;Krivūlė;SPINDULIUKAI;5057452653;Taip;0;0;1;1
3521;Krivūlė;SPINDULIUKAI;7335245963;Taip;15;0;0;15
3522;Krivūlė;SPINDULIUKAI;5802739148;Taip;0;1;6;7
3523;Krivūlė;SPINDULIUKAI;5667934115;Taip;13;0;3;16
3524;Krivūlė;SPINDULIUKAI;8348288864;Taip;7;0;3;10
3525;Krivūlė;SPINDULIUKAI;7155162698;Taip;0;0;11;11
3526;Krivūlė;SPINDULIUKAI;1151179495;Taip;0;0;2;2
3527;Krivūlė;SPINDULIUKAI;9320613086;Taip;18;0;3;21
3528;Krivūlė;SPINDULIUKAI;6632875947;Taip;5;0;2;7
3529;Krivūlė;SPINDULIUKAI;4750075323;Taip;0;0;1;1
3530;Krivūlė;SPINDULIUKAI;2430372719;Taip;8;0;1;9
3531;Krivūlė;SPINDULIUKAI;7540940063;Taip;0;22;0;22
3532;Krivūlė;BORUŽĖLĖS;4969782237;Taip;0;9;0;9
3533;Krivūlė;BORUŽĖLĖS;3605506478;Taip;0;0;3;3
3534;Krivūlė;BORUŽĖLĖS;4896656209;Taip;0;0;3;3
3535;Krivūlė;BORUŽĖLĖS;4845515196;Taip;0;14;0;14
3536;Krivūlė;BORUŽĖLĖS;5676562063;Taip;17;0;0;17
3537;Krivūlė;BORUŽĖLĖS;6935969502;Taip;0;0;3;3
3538;Krivūlė;BORUŽĖLĖS;4972360440;Taip;3;0;1;4
3539;Krivūlė;BORUŽĖLĖS;3912620138;Taip;5;0;7;12
3540;Krivūlė;BORUŽĖLĖS;3246787504;Taip;0;0;6;6
3541;Krivūlė;BORUŽĖLĖS;5531566792;Taip;0;3;2;5
3542;Krivūlė;BORUŽĖLĖS;2386053480;Taip;15;0;0;15
3543;Krivūlė;BORUŽĖLĖS;8586287004;Taip;10;0;1;11
3544;Krivūlė;BORUŽĖLĖS;4540069843;Taip;0;11;4;15
3545;Krivūlė;BORUŽĖLĖS;2138125571;Taip;0;0;4;4
3546;Krivūlė;BORUŽĖLĖS;4177660973;Taip;0;2;0;2
3547;Krivūlė;BORUŽĖLĖS;2517785727;Taip;6;0;6;12
3548;Krivūlė;BORUŽĖLĖS;2711010212;Taip;17;0;0;17
3549;Krivūlė;BORUŽĖLĖS;4025821636;Taip;13;0;0;13
3550;Krivūlė;BORUŽĖLĖS;7781918674;Taip;2;2;0;4
3551;Krivūlė;BORUŽĖLĖS;1987255206;Taip;0;0;2;2
3552;Krivūlė;BORUŽĖLĖS;7025398689;Taip;18;0;0;18
3553;Krivūlė;DRUGELIŲ;8463621294;Taip;0;0;13;13
3554;Krivūlė;DRUGELIŲ;4824008306;Taip;4;0;7;11
3555;Krivūlė;DRUGELIŲ;20743334216;Taip;0;1;0;1
3556;Krivūlė;DRUGELIŲ;1113026818;Taip;0;0;1;1
3557;Krivūlė;DRUGELIŲ;76285364171;Taip;0;0;3;3
3558;Krivūlė;DRUGELIŲ;49106308532;Taip;0;2;0;2
3559;Krivūlė;DRUGELIŲ;7477773004;Taip;0;0;1;1
3560;Krivūlė;DRUGELIŲ;50186813736;Taip;0;0;3;3
3561;Krivūlė;DRUGELIŲ;4648003100;Taip;0;1;0;1
3562;Krivūlė;DRUGELIŲ;10433396718;Taip;0;0;2;2
3563;Krivūlė;DRUGELIŲ;44741515819;Taip;2;0;1;3
3564;Krivūlė;DRUGELIŲ;86659723162;Taip;0;9;0;9
3565;Krivūlė;DRUGELIŲ;1699961817;Taip;0;0;4;4
3566;Krivūlė;DRUGELIŲ;701438210;Taip;0;0;2;2
3567;Krivūlė;"BITUTĖS (VALDOFRO)";46337826378;Taip;0;22;0;22
3568;Krivūlė;"BITUTĖS (VALDOFRO)";3994278221;Taip;0;0;3;3
3569;Krivūlė;"BITUTĖS (VALDOFRO)";18486357195;Taip;21;0;0;21
3570;Krivūlė;"BITUTĖS (VALDOFRO)";4248042049;Taip;20;0;0;20
3571;Krivūlė;"BITUTĖS (VALDOFRO)";4982146852;Taip;20;0;0;20
3572;Krivūlė;"BITUTĖS (VALDOFRO)";3769812444;Taip;0;1;0;1
3573;Krivūlė;"BITUTĖS (VALDOFRO)";5128760019;Taip;0;1;0;1
3574;Krivūlė;"BITUTĖS (VALDOFRO)";1851097789;Taip;0;0;4;4
3575;Krivūlė;"BITUTĖS (VALDOFRO)";7789248863;Taip;0;0;4;4
3576;Krivūlė;"BITUTĖS (VALDOFRO)";2647149927;Taip;0;1;0;1
3577;Krivūlė;"BITUTĖS (VALDOFRO)";5113297248;Taip;0;0;9;9
3578;Krivūlė;"BITUTĖS (VALDOFRO)";9632352765;Taip;0;2;0;2
3579;Krivūlė;"BITUTĖS (VALDOFRO)";7848471009;Taip;0;0;4;4
3580;Krivūlė;"BITUTĖS (VALDOFRO)";5405660104;Taip;4;0;3;7
3581;Krivūlė;"BITUTĖS (VALDOFRO)";8834855616;Taip;0;5;0;5
3582;Krivūlė;"BITUTĖS (VALDOFRO)";3655576855;Taip;0;0;7;7
3583;Krivūlė;"BITUTĖS (VALDOFRO)";1791812461;Taip;0;6;0;6
3584;Krivūlė;"BITUTĖS (VALDOFRO)";1561180871;Taip;0;8;0;8
3585;Krivūlė;"BITUTĖS (VALDOFRO)";9702372816;Taip;0;0;1;1
3586;Krivūlė;"BITUTĖS (VALDOFRO)";6753080815;Taip;0;22;0;22
3587;Krivūlė;"BITUTĖS (VALDOFRO)";4619224314;Taip;0;22;0;22
3588;Krivūlė;"BITUTĖS (VALDOFRO)";8105688948;Taip;0;0;4;4
3589;Krivūlė;"BITUTĖS (VALDOFRO)";1932209134;Taip;0;0;5;5
3590;Krivūlė;"BITUTĖS (VALDOFRO)";7768827505;Taip;0;0;7;7
3591;Krivūlė;EŽIUKAI;2302809484;Taip;0;5;0;5
3592;Krivūlė;EŽIUKAI;1590383390;Taip;0;0;1;1
3593;Krivūlė;EŽIUKAI;96319752378;Taip;0;0;1;1
3594;Krivūlė;EŽIUKAI;66981981114;Taip;0;0;3;3
3595;Krivūlė;EŽIUKAI;81401012140;Taip;0;0;6;6
3596;Krivūlė;EŽIUKAI;1039316424;Taip;0;0;3;3
3597;Krivūlė;EŽIUKAI;1437074990;Taip;0;8;0;8
3598;Krivūlė;EŽIUKAI;1207171374;Taip;0;0;1;1
3599;Krivūlė;EŽIUKAI;1940633287;Taip;0;0;1;1
3600;Krivūlė;EŽIUKAI;1807774373;Taip;0;0;1;1
3601;Krivūlė;EŽIUKAI;8628201310;Taip;0;0;6;6
3602;Krivūlė;EŽIUKAI;2764636358;Taip;0;20;0;20
3603;Krivūlė;EŽIUKAI;9562957603;Taip;0;5;0;5
3604;Krivūlė;EŽIUKAI;55075988807;Taip;0;0;1;1
3605;Krivūlė;NYKŠTUKAI;37502093836;Taip;0;7;2;9
3606;Krivūlė;NYKŠTUKAI;83840444975;Taip;0;7;2;9
3607;Krivūlė;NYKŠTUKAI;9267414141;Taip;0;0;1;1
3608;Krivūlė;NYKŠTUKAI;19674882649;Taip;6;0;1;7
3609;Krivūlė;NYKŠTUKAI;73760357378;Taip;3;0;0;3
3610;Krivūlė;NYKŠTUKAI;3015266398;Taip;0;0;3;3
3611;Krivūlė;NYKŠTUKAI;7873123757;Taip;0;1;0;1
3612;Krivūlė;NYKŠTUKAI;97398901468;Taip;3;6;0;9
3613;Krivūlė;NYKŠTUKAI;1515185307;Taip;5;1;1;7
3614;Krivūlė;NYKŠTUKAI;1217856292;Taip;0;0;1;1
3615;Krivūlė;NYKŠTUKAI;3064591570;Taip;0;0;1;1
3616;Krivūlė;NYKŠTUKAI;9311270695;Taip;0;1;1;2
3617;Krivūlė;NYKŠTUKAI;6861483854;Taip;2;0;4;6
3618;Krivūlė;NYKŠTUKAI;5818988913;Taip;5;2;0;7
3619;Krivūlė;NYKŠTUKAI;2654066358;Taip;0;3;5;8
3620;Krivūlė;NYKŠTUKAI;5966543639;Taip;0;0;2;2
3621;Krivūlė;NYKŠTUKAI;2903062788;Taip;8;0;1;9
3622;Krivūlė;"PABIRUČIŲ (Vokiečių g. 1)";5304221329;Taip;3;0;2;5
3623;Krivūlė;"PABIRUČIŲ (Vokiečių g. 1)";3076382863;Taip;4;0;1;5
3624;Krivūlė;"PABIRUČIŲ (Vokiečių g. 1)";5199600243;Taip;0;0;5;5
3625;Krivūlė;"PABIRUČIŲ (Vokiečių g. 1)";4845066055;Taip;0;0;8;8
3626;Krivūlė;"PABIRUČIŲ (Vokiečių g. 1)";7528273082;Taip;0;0;1;1
3627;Krivūlė;"PABIRUČIŲ (Vokiečių g. 1)";8042469720;Taip;4;0;0;4
3628;Krivūlė;"PABIRUČIŲ (Vokiečių g. 1)";7508079584;Taip;0;0;3;3
3629;Krivūlė;"PABIRUČIŲ (Vokiečių g. 1)";1815336153;Taip;0;22;0;22
3630;Krivūlė;"PABIRUČIŲ (Vokiečių g. 1)";4491462086;Taip;12;0;2;14
3631;Krivūlė;"PABIRUČIŲ (Vokiečių g. 1)";6521798502;Taip;0;0;1;1
3632;Krivūlė;"PABIRUČIŲ (Vokiečių g. 1)";9328365491;Taip;6;0;0;6
3633;Krivūlė;"PABIRUČIŲ (Vokiečių g. 1)";9229817861;Taip;0;0;3;3
3634;Krivūlė;"PABIRUČIŲ (Vokiečių g. 1)";7997564406;Taip;0;1;0;1
3635;Krivūlė;"SMALSUČIŲ (Vokiečių g.1)";5753204752;Taip;0;0;4;4
3636;Krivūlė;"SMALSUČIŲ (Vokiečių g.1)";6241144079;Taip;3;0;1;4
3637;Krivūlė;"SMALSUČIŲ (Vokiečių g.1)";2536472220;Taip;0;6;0;6
3638;Krivūlė;"SMALSUČIŲ (Vokiečių g.1)";1622495013;Taip;0;0;5;5
3639;Krivūlė;"SMALSUČIŲ (Vokiečių g.1)";7436569684;Taip;0;0;1;1
3640;Krivūlė;"SMALSUČIŲ (Vokiečių g.1)";6072261879;Taip;8;14;0;22
3641;Krivūlė;"SMALSUČIŲ (Vokiečių g.1)";5149419581;Taip;0;0;3;3
3642;Krivūlė;"SMALSUČIŲ (Vokiečių g.1)";7789605738;Taip;0;0;10;10
3643;Krivūlė;"SMALSUČIŲ (Vokiečių g.1)";5097101097;Taip;0;0;3;3
3644;Krivūlė;"SMALSUČIŲ (Vokiečių g.1)";5462491857;Ne;0;4;2;6
3645;Krivūlė;"SMALSUČIŲ (Vokiečių g.1)";5182563483;Taip;0;0;1;1
3646;Krivūlė;"SMALSUČIŲ (Vokiečių g.1)";7727246187;Taip;0;1;2;3
3647;Krivūlė;"GUDRUČIŲ (Vokiečių g. 1)";1180183091;Taip;0;21;0;21
3648;Krivūlė;"GUDRUČIŲ (Vokiečių g. 1)";6543038595;Taip;0;4;2;6
3649;Krivūlė;"GUDRUČIŲ (Vokiečių g. 1)";1371753067;Taip;0;0;1;1
3650;Krivūlė;"GUDRUČIŲ (Vokiečių g. 1)";8301938009;Taip;0;0;1;1
3651;Krivūlė;"GUDRUČIŲ (Vokiečių g. 1)";2769668641;Taip;0;4;0;4
3652;Krivūlė;"GUDRUČIŲ (Vokiečių g. 1)";2012112541;Taip;0;0;2;2
3653;Krivūlė;"GUDRUČIŲ (Vokiečių g. 1)";4668155071;Taip;0;0;2;2
3654;Krivūlė;"GUDRUČIŲ (Vokiečių g. 1)";4261133734;Taip;0;0;5;5
3655;Krivūlė;"GUDRUČIŲ (Vokiečių g. 1)";9388057389;Taip;0;0;4;4
3656;Krivūlė;"GUDRUČIŲ (Vokiečių g. 1)";3583848327;Taip;0;0;3;3
3657;Krivūlė;"GUDRUČIŲ (Vokiečių g. 1)";6429160371;Taip;2;0;1;3
3658;Krivūlė;"GUDRUČIŲ (Vokiečių g. 1)";3924127476;Taip;0;5;2;7
3659;Krivūlė;"GUDRUČIŲ (Vokiečių g. 1)";5274553442;Taip;0;21;0;21
3660;Krivūlė;"GUDRUČIŲ (Vokiečių g. 1)";24951231987;Taip;0;0;12;12
3661;Krivūlė;"GUDRUČIŲ (Vokiečių g. 1)";7275607891;Taip;0;0;1;1
3662;Krivūlė;"GUDRUČIŲ (Vokiečių g. 1)";5765537984;Taip;0;1;2;3
3663;Kodėlčiukas;Saulutės;1725624698;Taip;3;0;0;3
3664;Kodėlčiukas;Saulutės;7327247516;Taip;9;0;1;10
3665;Kodėlčiukas;Saulutės;8992265000;Taip;0;0;6;6
3666;Kodėlčiukas;Saulutės;6285018663;Taip;10;2;0;12
3667;Kodėlčiukas;Saulutės;1033969800;Taip;10;0;0;10
3668;Kodėlčiukas;Saulutės;2433094435;Ne;0;8;0;8
3669;Kodėlčiukas;Saulutės;9042404309;Taip;0;0;4;4
3670;Kodėlčiukas;Saulutės;3276075664;Taip;1;0;1;2
3671;Kodėlčiukas;Saulutės;9476376350;Ne;0;3;0;3
3672;Kodėlčiukas;Saulutės;7611485881;Taip;2;0;0;2
3673;Kodėlčiukas;Saulutės;7561763602;Taip;0;0;4;4
3674;Kodėlčiukas;Saulutės;2289687766;Taip;0;0;5;5
3675;Kodėlčiukas;Saulutės;6476445296;Taip;6;2;2;10
3676;Kodėlčiukas;Saulutės;4168864882;Taip;0;6;0;6
3677;Kodėlčiukas;Nežiniukai;6045564826;Taip;5;1;2;8
3678;Kodėlčiukas;Nežiniukai;7136890681;Taip;0;0;3;3
3679;Kodėlčiukas;Nežiniukai;7971932716;Taip;5;0;2;7
3680;Kodėlčiukas;Nežiniukai;7282579315;Taip;6;7;0;13
3681;Kodėlčiukas;Nežiniukai;6905424567;Taip;10;0;2;12
3682;Kodėlčiukas;Nežiniukai;1233880820;Taip;3;0;2;5
3683;Kodėlčiukas;Nežiniukai;5443377251;Taip;0;6;0;6
3684;Kodėlčiukas;Nežiniukai;7626940433;Taip;0;9;0;9
3685;Kodėlčiukas;Nežiniukai;9803206596;Taip;10;0;0;10
3686;Kodėlčiukas;Nežiniukai;4917910801;Taip;4;0;1;5
3687;Kodėlčiukas;Nežiniukai;6248137523;Taip;0;0;3;3
3688;Kodėlčiukas;Nežiniukai;3473981974;Taip;0;0;1;1
3689;Kodėlčiukas;Nežiniukai;4038168647;Taip;9;0;5;14
3690;Kodėlčiukas;Nežiniukai;8378295683;Taip;0;0;10;10
3691;Kodėlčiukas;Nežiniukai;6000831611;Taip;2;0;0;2
3692;Kodėlčiukas;Nežiniukai;7286497455;Taip;3;4;3;10
3693;Kodėlčiukas;Nežiniukai;1603752483;Taip;8;0;0;8
3694;Kodėlčiukas;Nežiniukai;6074758814;Ne;0;7;0;7
3695;Kodėlčiukas;Nežiniukai;1699358514;Ne;2;1;0;3
3696;Kodėlčiukas;Nežiniukai;1302383608;Taip;0;0;6;6
3697;Kodėlčiukas;Gintarėliai;2560864315;Taip;4;8;2;14
3698;Kodėlčiukas;Gintarėliai;58406224468;Taip;0;0;11;11
3699;Kodėlčiukas;Gintarėliai;1485012710;Taip;0;4;0;4
3700;Kodėlčiukas;Gintarėliai;2062878300;Taip;13;0;0;13
3701;Kodėlčiukas;Gintarėliai;20084022099;Taip;0;3;0;3
3702;Kodėlčiukas;Gintarėliai;9686497547;Taip;0;1;0;1
3703;Kodėlčiukas;Gintarėliai;1632458573;Taip;0;5;0;5
3704;Kodėlčiukas;Gintarėliai;9332136116;Taip;0;0;1;1
3705;Kodėlčiukas;Gintarėliai;4944791330;Taip;0;0;5;5
3706;Kodėlčiukas;Gintarėliai;8219424737;Taip;0;1;0;1
3707;Kodėlčiukas;Gintarėliai;4849314647;Taip;0;1;4;5
3708;Kodėlčiukas;Gintarėliai;8647609373;Taip;7;0;0;7
3709;Kodėlčiukas;Gintarėliai;4738357524;Taip;0;0;2;2
3710;Kodėlčiukas;Gintarėliai;8873629130;Taip;4;0;0;4
3711;Kodėlčiukas;Gintarėliai;1190408818;Taip;0;0;11;11
3712;Kodėlčiukas;Gintarėliai;2260623869;Taip;0;0;7;7
3713;Kodėlčiukas;Šnekučiai;1550915654;Taip;0;9;0;9
3714;Kodėlčiukas;Šnekučiai;1935757837;Taip;0;2;0;2
3715;Kodėlčiukas;Šnekučiai;8114859362;Taip;0;17;0;17
3716;Kodėlčiukas;Šnekučiai;1666743304;Taip;0;1;0;1
3717;Kodėlčiukas;Šnekučiai;9178209049;Taip;4;0;4;8
3718;Kodėlčiukas;Šnekučiai;5988863934;Taip;0;13;0;13
3719;Kodėlčiukas;Šnekučiai;5386820408;Taip;0;5;0;5
3720;Kodėlčiukas;Šnekučiai;6194726931;Taip;0;3;0;3
3721;Kodėlčiukas;Šnekučiai;5782600824;Taip;6;0;0;6
3722;Kodėlčiukas;Šnekučiai;7074381835;Taip;3;2;0;5
3723;Kodėlčiukas;Šnekučiai;7757494295;Ne;7;6;0;13
3724;Kodėlčiukas;Šnekučiai;2988674717;Ne;0;4;3;7
3725;Kodėlčiukas;Šnekučiai;1834696935;Ne;0;3;0;3
3726;Kodėlčiukas;Šnekučiai;4273202718;Taip;0;0;3;3
3727;Kodėlčiukas;Šnekučiai;2244326972;Taip;2;13;0;15
3728;Kodėlčiukas;Pabiručiai;7630180473;Taip;9;1;3;13
3729;Kodėlčiukas;Pabiručiai;8140940288;Taip;5;0;0;5
3730;Kodėlčiukas;Pabiručiai;3880019350;Taip;0;0;5;5
3731;Kodėlčiukas;Pabiručiai;4818678923;Taip;11;0;0;11
3732;Kodėlčiukas;Pabiručiai;9589692031;Taip;6;0;6;12
3733;Kodėlčiukas;Pabiručiai;1906128091;Taip;0;8;1;9
3734;Kodėlčiukas;Pabiručiai;9460792167;Taip;8;0;0;8
3735;Kodėlčiukas;Pabiručiai;1218904283;Ne;0;0;1;1
3736;Kodėlčiukas;Pabiručiai;7324303899;Taip;0;0;2;2
3737;Kodėlčiukas;Pabiručiai;9794875862;Taip;0;6;4;10
3738;Kodėlčiukas;Pabiručiai;9528997865;Taip;9;4;1;14
3739;Kodėlčiukas;Pabiručiai;1919722425;Taip;0;0;1;1
3740;Kodėlčiukas;Pabiručiai;2593524511;Taip;0;9;0;9
3741;Kodėlčiukas;Pabiručiai;8879977943;Taip;0;12;0;12
3742;Kodėlčiukas;Smalsučiai;1782784297;Taip;0;3;0;3
3743;Kodėlčiukas;Smalsučiai;12421864073;Taip;0;0;4;4
3744;Kodėlčiukas;Smalsučiai;1532235421;Taip;7;0;0;7
3745;Kodėlčiukas;Smalsučiai;8393750817;Taip;0;6;0;6
3746;Kodėlčiukas;Smalsučiai;1723716524;Taip;5;0;0;5
3747;Kodėlčiukas;Smalsučiai;18557158044;Taip;6;0;2;8
3748;Kodėlčiukas;Smalsučiai;1106092960;Taip;0;0;1;1
3749;Kodėlčiukas;Smalsučiai;1662717348;Ne;0;0;2;2
3750;Kodėlčiukas;Smalsučiai;20467065338;Taip;0;0;2;2
3751;Kodėlčiukas;Smalsučiai;87784905691;Taip;0;0;2;2
3752;Kodėlčiukas;Smalsučiai;1048653620;Taip;0;0;2;2
3753;Kodėlčiukas;Smalsučiai;32318234528;Taip;0;0;1;1
3754;Kodėlčiukas;Smalsučiai;1978279511;Taip;0;0;2;2
3755;Kodėlčiukas;Smalsučiai;84450296241;Taip;3;0;0;3
3756;Kodėlčiukas;Smalsučiai;2061169442;Taip;0;0;3;3
3757;Kodėlčiukas;Smalsučiai;70940790491;Taip;0;0;1;1
3758;Kodėlčiukas;Smalsučiai;6168432879;Taip;0;0;7;7
3759;Kodėlčiukas;Smalsučiai;3542081571;Taip;0;2;0;2
3760;Kodėlčiukas;Smalsučiai;1115828736;Taip;0;0;1;1
3761;Kodėlčiukas;Smalsučiai;1584936719;Taip;6;0;4;10
3762;Kodėlčiukas;Smalsučiai;1151612627;Ne;0;0;3;3
3763;Kodėlčiukas;Giliukai;26010333641;Taip;0;0;1;1
3764;Kodėlčiukas;Giliukai;93684599166;Taip;0;0;9;9
3765;Kodėlčiukas;Giliukai;88371652763;Taip;0;0;1;1
3766;Kodėlčiukas;Giliukai;80767435810;Taip;0;0;1;1
3767;Kodėlčiukas;Giliukai;1825630143;Taip;13;0;5;18
3768;Kodėlčiukas;Giliukai;11130172902;Taip;0;0;2;2
3769;Kodėlčiukas;Giliukai;29830674331;Taip;0;0;1;1
3770;Kodėlčiukas;Giliukai;1330761392;Taip;0;0;1;1
3771;Kodėlčiukas;Giliukai;2637712514;Taip;0;0;5;5
3772;Kodėlčiukas;Giliukai;45393129631;Ne;0;0;1;1
3773;Kodėlčiukas;Giliukai;47667750562;Taip;0;8;0;8
3774;Kodėlčiukas;Giliukai;8204069897;Taip;1;9;0;10
3775;Kodėlčiukas;Giliukai;1938753417;Taip;0;0;1;1
3776;Kodėlčiukas;Giliukai;29319461634;Taip;0;0;1;1
3777;Kodėlčiukas;Giliukai;37250933602;Taip;8;2;0;10
3778;Kodėlčiukas;Giliukai;1550337708;Taip;3;0;3;6
3779;Kodėlčiukas;Giliukai;4030981879;Taip;0;0;1;1
3780;Kodėlčiukas;Giliukai;44431255380;Taip;0;0;5;5
3781;Kodėlčiukas;Giliukai;1850261935;Taip;0;0;10;10
3782;Kodėlčiukas;Gudručiai;1191430672;Taip;0;2;0;2
3783;Kodėlčiukas;Gudručiai;6988515253;Taip;7;0;0;7
3784;Kodėlčiukas;Gudručiai;3385551650;Taip;8;0;3;11
3785;Kodėlčiukas;Gudručiai;7318908956;Taip;3;0;2;5
3786;Kodėlčiukas;Gudručiai;9865803714;Taip;0;0;2;2
3787;Kodėlčiukas;Gudručiai;7430239198;Taip;0;0;4;4
3788;Kodėlčiukas;Gudručiai;8400610717;Taip;0;0;9;9
3789;Kodėlčiukas;Gudručiai;7116594055;Taip;0;0;2;2
3790;Kodėlčiukas;Gudručiai;9483378853;Taip;0;4;1;5
3791;Kodėlčiukas;Gudručiai;8890987483;Taip;0;0;1;1
3792;Kodėlčiukas;Gudručiai;4543838852;Taip;5;0;0;5
3793;Kodėlčiukas;Gudručiai;2216791610;Taip;0;0;2;2
3794;Kodėlčiukas;Gudručiai;9028856983;Taip;9;0;1;10
3795;Kodėlčiukas;Gudručiai;1588132166;Taip;8;0;0;8
3796;Kodėlčiukas;Gudručiai;6014084915;Taip;0;9;0;9
3797;Kodėlčiukas;Gudručiai;3068084704;Taip;3;2;6;11
3798;Kodėlčiukas;Gudručiai;6985788287;Taip;0;0;4;4
3799;Kodėlčiukas;Žirniukai;7937365710;Taip;7;0;5;12
3800;Kodėlčiukas;Žirniukai;7007386353;Taip;0;4;0;4
3801;Kodėlčiukas;Žirniukai;2943146610;Taip;22;0;0;22
3802;Kodėlčiukas;Žirniukai;2122779530;Taip;4;0;0;4
3803;Kodėlčiukas;Žirniukai;8017465692;Taip;0;3;0;3
3804;Kodėlčiukas;Žirniukai;9733831323;Taip;7;0;2;9
3805;Kodėlčiukas;Žirniukai;9754425363;Taip;14;0;0;14
3806;Kodėlčiukas;Žirniukai;5587782917;Taip;19;0;1;20
3807;Kodėlčiukas;Žirniukai;9721353724;Taip;11;0;0;11
3808;Kodėlčiukas;Žirniukai;8785157050;Taip;0;19;0;19
3809;Kodėlčiukas;Žirniukai;5770748359;Taip;18;0;1;19
3810;Kodėlčiukas;Žirniukai;5573845415;Taip;3;0;0;3
3811;Kodėlčiukas;Žirniukai;8100861190;Taip;4;3;0;7
3812;Kodėlčiukas;Žirniukai;7639341503;Taip;0;8;5;13
3813;Kodėlčiukas;Katinėliai;1087808091;Ne;2;2;0;4
3814;Kodėlčiukas;Katinėliai;7246943802;Taip;12;0;0;12
3815;Kodėlčiukas;Katinėliai;8586746296;Taip;7;0;0;7
3816;Kodėlčiukas;Katinėliai;9278139998;Taip;0;2;0;2
3817;Kodėlčiukas;Katinėliai;5359866071;Taip;0;0;1;1
3818;Kodėlčiukas;Katinėliai;6008027505;Taip;0;0;1;1
3819;Kodėlčiukas;Katinėliai;9511144369;Taip;0;4;3;7
3820;Kodėlčiukas;Katinėliai;8189938439;Taip;0;11;0;11
3821;Kodėlčiukas;Katinėliai;1039982141;Taip;6;0;2;8
3822;Kodėlčiukas;Katinėliai;8444690698;Taip;11;0;3;14
3823;Kodėlčiukas;Katinėliai;5894631257;Ne;2;8;0;10
3824;Kodėlčiukas;Katinėliai;5587200800;Taip;4;0;2;6
3825;Kodėlčiukas;Katinėliai;9480926599;Taip;3;0;1;4
3826;Kodėlčiukas;Katinėliai;7570122834;Taip;7;0;0;7
3827;Kodėlčiukas;Katinėliai;7455949617;Taip;0;8;0;8
3828;Kodėlčiukas;Katinėliai;5801430256;Taip;0;8;0;8
3829;Kodėlčiukas;Katinėliai;6065858518;Taip;3;1;0;4
3830;Kodėlčiukas;Katinėliai;1433623973;Taip;9;0;0;9
3831;Kodėlčiukas;Nykštukai;3882838712;Taip;0;9;0;9
3832;Kodėlčiukas;Nykštukai;6670171992;Taip;0;5;0;5
3833;Kodėlčiukas;Nykštukai;4507928289;Taip;6;0;0;6
3834;Kodėlčiukas;Nykštukai;8291672306;Taip;0;6;0;6
3835;Kodėlčiukas;Nykštukai;9295561516;Taip;0;2;0;2
3836;Kodėlčiukas;Nykštukai;6935233288;Taip;17;0;0;17
3837;Kodėlčiukas;Nykštukai;3869826429;Taip;10;4;0;14
3838;Kodėlčiukas;Nykštukai;9830842598;Taip;0;0;5;5
3839;Kodėlčiukas;Nykštukai;7705057116;Taip;9;0;0;9
3840;Kodėlčiukas;Nykštukai;8823086730;Taip;22;0;0;22
3841;Kodėlčiukas;Nykštukai;6643473339;Taip;9;1;0;10
3842;Kodėlčiukas;Nykštukai;7686420784;Taip;0;0;1;1
3843;Kodėlčiukas;Nykštukai;8348024909;Taip;22;0;0;22
3844;Kodėlčiukas;Nykštukai;8759498015;Ne;2;4;0;6
3845;Kodėlčiukas;Nykštukai;3686259290;Taip;0;0;3;3
3846;Kodėlčiukas;Nykštukai;7778188733;Taip;8;0;0;8
3847;Kodėlčiukas;ŽIOGELIAI;6232570825;Taip;11;0;2;13
3848;Kodėlčiukas;ŽIOGELIAI;2549153581;Taip;21;0;0;21
3849;Kodėlčiukas;ŽIOGELIAI;9398732476;Taip;0;0;1;1
3850;Kodėlčiukas;ŽIOGELIAI;1925590099;Taip;0;2;0;2
3851;Kodėlčiukas;ŽIOGELIAI;2298734536;Taip;0;5;1;6
3852;Kodėlčiukas;ŽIOGELIAI;7643398934;Taip;0;1;5;6
3853;Kodėlčiukas;ŽIOGELIAI;7119815662;Taip;3;0;5;8
3854;Kodėlčiukas;ŽIOGELIAI;2871111867;Taip;0;1;0;1
3855;Kodėlčiukas;ŽIOGELIAI;1808211253;Taip;0;10;0;10
3856;Kodėlčiukas;ŽIOGELIAI;8799798070;Taip;0;0;4;4
3857;Kodėlčiukas;ŽIOGELIAI;9914322177;Taip;0;0;1;1
3858;Kodėlčiukas;ŽIOGELIAI;2720748563;Taip;13;0;0;13
3859;Kodėlčiukas;ŽIOGELIAI;6261333618;Taip;4;0;0;4
3860;Kodėlčiukas;ŽIOGELIAI;7848240865;Taip;0;0;4;4
3861;Kodėlčiukas;BITUTĖS;3130715310;Taip;0;7;0;7
3862;Kodėlčiukas;BITUTĖS;2313607716;Taip;6;0;0;6
3863;Kodėlčiukas;BITUTĖS;5061852590;Taip;7;1;2;10
3864;Kodėlčiukas;BITUTĖS;8829986201;Taip;4;11;0;15
3865;Kodėlčiukas;BITUTĖS;3985455729;Taip;0;0;4;4
3866;Kodėlčiukas;BITUTĖS;8144034996;Taip;0;0;6;6
3867;Kodėlčiukas;BITUTĖS;3156788328;Taip;6;3;0;9
3868;Kodėlčiukas;BITUTĖS;7910205296;Taip;0;0;8;8
3869;Kodėlčiukas;BITUTĖS;5178305435;Taip;13;0;0;13
3870;Kodėlčiukas;BITUTĖS;9736751250;Taip;0;1;0;1
3871;Kodėlčiukas;BITUTĖS;8037386529;Taip;9;5;0;14
3872;Kodėlčiukas;BITUTĖS;1047209628;Taip;3;19;0;22
3873;Kodėlčiukas;BITUTĖS;5068611716;Taip;0;0;13;13
3874;Kodėlčiukas;BITUTĖS;8932472612;Taip;0;6;0;6
3875;Kodėlčiukas;BITUTĖS;7186835214;Taip;3;0;4;7
3876;Kodėlčiukas;BITUTĖS;4782931414;Taip;0;1;0;1
3877;Kodėlčiukas;BITUTĖS;2731207996;Taip;0;0;11;11
3878;Kodėlčiukas;VYŠNIUKAI;2162480212;Taip;0;0;1;1
3879;Kodėlčiukas;VYŠNIUKAI;3778271049;Taip;5;0;4;9
3880;Kodėlčiukas;VYŠNIUKAI;1074477043;Taip;0;1;4;5
3881;Kodėlčiukas;VYŠNIUKAI;2542104903;Taip;0;4;0;4
3882;Kodėlčiukas;VYŠNIUKAI;3470151604;Taip;0;8;2;10
3883;Kodėlčiukas;VYŠNIUKAI;7510273691;Taip;0;10;0;10
3884;Kodėlčiukas;VYŠNIUKAI;4490196764;Taip;17;0;0;17
3885;Kodėlčiukas;VYŠNIUKAI;6761903865;Ne;6;0;0;6
3886;Kodėlčiukas;VYŠNIUKAI;9527296531;Ne;0;1;0;1
3887;Kodėlčiukas;VYŠNIUKAI;2351468626;Taip;5;5;0;10
3888;Kodėlčiukas;VYŠNIUKAI;6764015170;Taip;7;4;0;11
3889;Kodėlčiukas;VYŠNIUKAI;8447045958;Taip;12;0;2;14
3890;Kodėlčiukas;VYŠNIUKAI;7647582987;Ne;5;0;1;6
3891;Kodėlčiukas;VYŠNIUKAI;3403889915;Taip;0;1;0;1
3892;Kodėlčiukas;VYŠNIUKAI;1160612316;Taip;0;0;4;4
3893;Kodėlčiukas;VYŠNIUKAI;8606551477;Taip;7;0;0;7
3894;Kodėlčiukas;VYŠNIUKAI;8070400563;Taip;6;0;0;6
3895;Kodėlčiukas;VYŠNIUKAI;1992569595;Ne;0;0;8;8
3896;Kodėlčiukas;BORUŽĖLĖS;9109362006;Taip;0;0;2;2
3897;Kodėlčiukas;BORUŽĖLĖS;9724373368;Taip;0;9;0;9
3898;Kodėlčiukas;BORUŽĖLĖS;5075801618;Taip;12;0;1;13
3899;Kodėlčiukas;BORUŽĖLĖS;2819860331;Taip;2;0;1;3
3900;Kodėlčiukas;BORUŽĖLĖS;4941186694;Taip;0;4;0;4
3901;Kodėlčiukas;BORUŽĖLĖS;4866089623;Taip;0;1;3;4
3902;Kodėlčiukas;BORUŽĖLĖS;5952121209;Taip;0;4;0;4
3903;Kodėlčiukas;BORUŽĖLĖS;4230906452;Taip;4;8;0;12
3904;Kodėlčiukas;BORUŽĖLĖS;6505671642;Taip;0;10;1;11
3905;Kodėlčiukas;BORUŽĖLĖS;8779350309;Taip;0;0;1;1
3906;Kodėlčiukas;BORUŽĖLĖS;9208137169;Ne;6;2;1;9
3907;Kodėlčiukas;BORUŽĖLĖS;6587593805;Taip;2;0;0;2
3908;Kodėlčiukas;BORUŽĖLĖS;1827752731;Taip;0;0;4;4
3909;Kodėlčiukas;BORUŽĖLĖS;1005178052;Taip;8;0;2;10
3910;Kodėlčiukas;BORUŽĖLĖS;9252478832;Taip;0;5;4;9
3911;Kodėlčiukas;VYTURĖLIAI;6714818379;Taip;0;7;0;7
3912;Kodėlčiukas;VYTURĖLIAI;4218096561;Taip;0;14;0;14
3913;Kodėlčiukas;VYTURĖLIAI;4514764005;Taip;0;1;0;1
3914;Kodėlčiukas;VYTURĖLIAI;2448536092;Taip;10;0;1;11
3915;Kodėlčiukas;VYTURĖLIAI;4884233329;Taip;0;0;8;8
3916;Kodėlčiukas;VYTURĖLIAI;8263945732;Taip;5;0;5;10
3917;Kodėlčiukas;VYTURĖLIAI;2904858964;Taip;18;0;0;18
3918;Kodėlčiukas;VYTURĖLIAI;3413659259;Taip;4;0;0;4
3919;Kodėlčiukas;VYTURĖLIAI;9673271313;Taip;0;0;6;6
3920;Kodėlčiukas;VYTURĖLIAI;5710301153;Taip;0;0;12;12
3921;Kodėlčiukas;VYTURĖLIAI;1746835627;Taip;0;0;2;2
3922;Kodėlčiukas;VYTURĖLIAI;5474125905;Taip;8;0;0;8
3923;Kodėlčiukas;VYTURĖLIAI;2298099102;Taip;0;0;1;1
3924;Kodėlčiukas;VYTURĖLIAI;8427457478;Taip;7;0;3;10
3925;Kodėlčiukas;VYTURĖLIAI;7908217415;Taip;5;0;0;5
3926;Kodėlčiukas;VYTURĖLIAI;5181211722;Taip;10;1;0;11
3927;Kodėlčiukas;VYTURĖLIAI;3472862544;Taip;0;0;1;1
3928;Kodėlčiukas;DRUGELIAI;1149682376;Taip;0;7;0;7
3929;Kodėlčiukas;DRUGELIAI;7587203481;Taip;4;2;0;6
3930;Kodėlčiukas;DRUGELIAI;2353960861;Taip;0;1;0;1
3931;Kodėlčiukas;DRUGELIAI;6103959702;Taip;0;0;3;3
3932;Kodėlčiukas;DRUGELIAI;3267687337;Taip;4;0;1;5
3933;Kodėlčiukas;DRUGELIAI;5577154148;Taip;2;1;0;3
3934;Kodėlčiukas;DRUGELIAI;9979034031;Taip;0;9;0;9
3935;Kodėlčiukas;DRUGELIAI;3240221130;Ne;0;1;0;1
3936;Kodėlčiukas;DRUGELIAI;7714816675;Taip;10;0;0;10
3937;Kodėlčiukas;DRUGELIAI;9139424911;Taip;0;0;1;1
3938;Kodėlčiukas;DRUGELIAI;9664432781;Taip;9;0;4;13
3939;Kodėlčiukas;DRUGELIAI;5197946954;Taip;3;0;3;6
3940;Kodėlčiukas;DRUGELIAI;8315176054;Taip;6;1;2;9
3941;Kodėlčiukas;DRUGELIAI;3651073383;Taip;0;0;1;1
3942;Kodėlčiukas;DRUGELIAI;3854719881;Taip;0;9;0;9
3943;Kodėlčiukas;OBUOLIUKAI;8784531004;Taip;8;0;1;9
3944;Kodėlčiukas;OBUOLIUKAI;1289342844;Taip;0;4;0;4
3945;Kodėlčiukas;OBUOLIUKAI;8208448849;Taip;4;0;0;4
3946;Kodėlčiukas;OBUOLIUKAI;1683506414;Taip;3;0;1;4
3947;Kodėlčiukas;OBUOLIUKAI;3315862631;Taip;7;9;0;16
3948;Kodėlčiukas;OBUOLIUKAI;3168418461;Taip;12;0;0;12
3949;Kodėlčiukas;OBUOLIUKAI;9645987751;Taip;14;1;0;15
3950;Kodėlčiukas;OBUOLIUKAI;8782155591;Taip;0;5;0;5
3951;Kodėlčiukas;OBUOLIUKAI;8104220950;Taip;0;10;0;10
3952;Kodėlčiukas;OBUOLIUKAI;2005453189;Taip;3;9;3;15
3953;Kodėlčiukas;OBUOLIUKAI;1180399735;Taip;0;2;0;2
3954;Kodėlčiukas;OBUOLIUKAI;5173730926;Taip;13;8;1;22
3955;Kodėlčiukas;OBUOLIUKAI;3442449482;Taip;0;6;0;6
3956;Kodėlčiukas;OBUOLIUKAI;7946010973;Taip;0;7;0;7
3957;Kodėlčiukas;OBUOLIUKAI;5342852235;Taip;19;0;0;19
3958;Kodėlčiukas;OBUOLIUKAI;8563412043;Taip;0;0;2;2
3959;Kodėlčiukas;OBUOLIUKAI;1735618441;Taip;17;0;1;18
3960;Kodėlčiukas;NAUJA;3925021238;Taip;5;3;0;8
3961;Kurpaitė;Viščiukų;4657523142;Taip;0;3;0;3
3962;Kurpaitė;Viščiukų;4426311033;Taip;5;0;0;5
3963;Kurpaitė;Viščiukų;2157581956;Taip;0;1;0;1
3964;Kurpaitė;Viščiukų;3481813493;Taip;8;0;0;8
3965;Kurpaitė;Viščiukų;1927773278;Taip;0;13;0;13
3966;Kurpaitė;Viščiukų;4607835570;Taip;10;0;0;10
3967;Kurpaitė;Viščiukų;1964193512;Ne;0;3;0;3
3968;Kurpaitė;Viščiukų;3989274600;Taip;5;6;0;11
3969;Kurpaitė;Viščiukų;9221882007;Taip;0;1;0;1
3970;Kurpaitė;Viščiukų;3456815576;Taip;0;19;0;19
3971;Kurpaitė;Viščiukų;8361612709;Taip;0;5;0;5
3972;Kurpaitė;Viščiukų;8402747029;Taip;0;10;0;10
3973;Kurpaitė;Viščiukų;3139272175;Taip;0;3;0;3
3974;Kurpaitė;Viščiukų;4769611100;Taip;2;0;0;2
3975;Kurpaitė;Viščiukų;4687182527;Taip;9;0;0;9
3976;Kurpaitė;Gėlyčių;9922582884;Ne;3;0;0;3
3977;Kurpaitė;Gėlyčių;6466518987;Taip;0;3;0;3
3978;Kurpaitė;Gėlyčių;3634641300;Taip;0;5;0;5
3979;Kurpaitė;Gėlyčių;4602268315;Taip;22;0;0;22
3980;Kurpaitė;Gėlyčių;4592795281;Taip;0;15;0;15
3981;Kurpaitė;Gėlyčių;8868415451;Taip;0;4;0;4
3982;Kurpaitė;Gėlyčių;2290343066;Taip;0;2;0;2
3983;Kurpaitė;Gėlyčių;4188925256;Taip;0;3;0;3
3984;Kurpaitė;Gėlyčių;1273426668;Taip;0;9;0;9
3985;Kurpaitė;Gėlyčių;4684525618;Taip;13;4;0;17
3986;Kurpaitė;Gėlyčių;3417549110;Ne;6;4;0;10
3987;Kurpaitė;Gėlyčių;9769835612;Taip;0;1;0;1
3988;Kurpaitė;Gėlyčių;6688536661;Taip;0;1;0;1
3989;Kurpaitė;Drugelių;2359555461;Taip;0;4;0;4
3990;Kurpaitė;Drugelių;65434834152;Taip;0;5;0;5
3991;Kurpaitė;Drugelių;1218040871;Taip;0;16;0;16
3992;Kurpaitė;Drugelių;1505783589;Taip;0;3;0;3
3993;Kurpaitė;Drugelių;5844470373;Taip;7;0;0;7
3994;Kurpaitė;Drugelių;7546409044;Taip;0;11;0;11
3995;Kurpaitė;Drugelių;9063294667;Taip;0;4;0;4
3996;Kurpaitė;Drugelių;2827617670;Taip;0;7;0;7
3997;Kurpaitė;Drugelių;1457318954;Taip;0;8;0;8
3998;Kurpaitė;Drugelių;7897713994;Taip;0;5;0;5
3999;Kurpaitė;Drugelių;4312062240;Taip;8;0;0;8
4000;Kurpaitė;Drugelių;4168882748;Taip;0;4;0;4
4001;Kurpaitė;Drugelių;3003517700;Taip;0;1;0;1
4002;Kurpaitė;Drugelių;9915241987;Taip;5;3;0;8
4003;Kurpaitė;Drugelių;9200404698;Ne;0;3;0;3
4004;Kurpaitė;Pelyčių;54840686231;Taip;0;6;0;6
4005;Kurpaitė;Pelyčių;48526842780;Taip;0;6;0;6
4006;Kurpaitė;Pelyčių;1730735673;Taip;0;1;0;1
4007;Kurpaitė;Pelyčių;43247754405;Taip;0;7;0;7
4008;Kurpaitė;Pelyčių;31201788860;Taip;5;1;0;6
4009;Kurpaitė;Pelyčių;5394176979;Taip;18;0;0;18
4010;Kurpaitė;Pelyčių;72710210157;Taip;0;4;0;4
4011;Kurpaitė;Pelyčių;1094620507;Taip;4;0;0;4
4012;Kurpaitė;Pelyčių;58127430940;Taip;0;13;0;13
4013;Kurpaitė;Pelyčių;2116580903;Taip;0;2;0;2
4014;Kurpaitė;Pelyčių;2200676656;Taip;0;2;0;2
4015;Kurpaitė;Pelyčių;7431793716;Taip;0;15;0;15
4016;Kurpaitė;Pelyčių;24410351286;Taip;0;9;0;9
4017;Kurpaitė;Pelyčių;9435979008;Taip;0;3;0;3
4018;"Kūlverstukas (Suvalkų g. 6)";Saulutės;8853848991;Taip;0;0;3;3
4019;"Kūlverstukas (Suvalkų g. 6)";Saulutės;6287636806;Taip;5;3;4;12
4020;"Kūlverstukas (Suvalkų g. 6)";Saulutės;4285624305;Taip;4;0;0;4
4021;"Kūlverstukas (Suvalkų g. 6)";Saulutės;4073233921;Taip;5;0;1;6
4022;"Kūlverstukas (Suvalkų g. 6)";Saulutės;8092104136;Taip;0;0;17;17
4023;"Kūlverstukas (Suvalkų g. 6)";Saulutės;3238807604;Taip;0;0;10;10
4024;"Kūlverstukas (Suvalkų g. 6)";Saulutės;1932066021;Taip;3;0;0;3
4025;"Kūlverstukas (Suvalkų g. 6)";Saulutės;9655585527;Taip;15;0;0;15
4026;"Kūlverstukas (Suvalkų g. 6)";Saulutės;5488852698;Taip;5;0;1;6
4027;"Kūlverstukas (Suvalkų g. 6)";Saulutės;7480593611;Ne;3;0;1;4
4028;"Kūlverstukas (Suvalkų g. 6)";Saulutės;3069047204;Taip;10;0;2;12
4029;"Kūlverstukas (Suvalkų g. 6)";Saulutės;5345423038;Taip;0;8;0;8
4030;"Kūlverstukas (Suvalkų g. 6)";Saulutės;3270176280;Taip;0;14;1;15
4031;"Kūlverstukas (Suvalkų g. 6)";Saulutės;2396379813;Ne;0;0;5;5
4032;"Kūlverstukas (Suvalkų g. 6)";Saulutės;7449993309;Taip;8;0;2;10
4033;"Kūlverstukas (Suvalkų g. 6)";Saulutės;5319938519;Ne;0;0;9;9
4034;"Kūlverstukas (Suvalkų g. 6)";Saulutės;2450625415;Taip;8;1;0;9
4035;"Kūlverstukas (Suvalkų g. 6)";Saulutės;2101490038;Taip;8;1;0;9
4036;"Kūlverstukas (Suvalkų g. 6)";Saulutės;9096819614;Taip;0;0;2;2
4037;"Kūlverstukas (Suvalkų g. 6)";Saulutės;7118949795;Taip;0;0;3;3
4038;"Kūlverstukas (Suvalkų g. 6)";Saulutės;4173514390;Taip;0;0;1;1
4039;"Kūlverstukas (Suvalkų g. 6)";Peledžiukai;8362459952;Taip;3;0;0;3
4040;"Kūlverstukas (Suvalkų g. 6)";Peledžiukai;2586428057;Taip;0;0;3;3
4041;"Kūlverstukas (Suvalkų g. 6)";Peledžiukai;6577897961;Taip;2;0;0;2
4042;"Kūlverstukas (Suvalkų g. 6)";Peledžiukai;74829986958;Taip;0;12;0;12
4043;"Kūlverstukas (Suvalkų g. 6)";Peledžiukai;5488011852;Taip;10;0;3;13
4044;"Kūlverstukas (Suvalkų g. 6)";Peledžiukai;2072009099;Taip;0;5;3;8
4045;"Kūlverstukas (Suvalkų g. 6)";Peledžiukai;1226883894;Taip;0;7;2;9
4046;"Kūlverstukas (Suvalkų g. 6)";Peledžiukai;37991935289;Taip;0;16;2;18
4047;"Kūlverstukas (Suvalkų g. 6)";Peledžiukai;3937419139;Taip;0;0;3;3
4048;"Kūlverstukas (Suvalkų g. 6)";Peledžiukai;1699783763;Taip;0;4;0;4
4049;"Kūlverstukas (Suvalkų g. 6)";Peledžiukai;3162189859;Taip;0;0;10;10
4050;"Kūlverstukas (Suvalkų g. 6)";Peledžiukai;6975324309;Taip;7;0;2;9
4051;"Kūlverstukas (Suvalkų g. 6)";Peledžiukai;9396183748;Taip;0;6;0;6
4052;"Kūlverstukas (Suvalkų g. 6)";Peledžiukai;1452422691;Taip;5;0;5;10
4053;"Kūlverstukas (Suvalkų g. 6)";Peledžiukai;4396230034;Taip;6;0;0;6
4054;"Kūlverstukas (Suvalkų g. 6)";Peledžiukai;4622570992;Taip;0;0;10;10
4055;"Kūlverstukas (Suvalkų g. 6)";Gelytės;1795306946;Taip;19;0;1;20
4056;"Kūlverstukas (Suvalkų g. 6)";Gelytės;4846324136;Taip;0;0;1;1
4057;"Kūlverstukas (Suvalkų g. 6)";Gelytės;8294873714;Ne;2;1;0;3
4058;"Kūlverstukas (Suvalkų g. 6)";Gelytės;8353856412;Taip;11;0;0;11
4059;"Kūlverstukas (Suvalkų g. 6)";Gelytės;2762230590;Taip;10;0;1;11
4060;"Kūlverstukas (Suvalkų g. 6)";Gelytės;5103259175;Taip;0;0;2;2
4061;"Kūlverstukas (Suvalkų g. 6)";Gelytės;9167460438;Taip;4;5;0;9
4062;"Kūlverstukas (Suvalkų g. 6)";Gelytės;8319255735;Taip;13;0;0;13
4063;"Kūlverstukas (Suvalkų g. 6)";Gelytės;7505926208;Taip;0;1;0;1
4064;"Kūlverstukas (Suvalkų g. 6)";Gelytės;1014630718;Taip;0;1;0;1
4065;"Kūlverstukas (Suvalkų g. 6)";Gelytės;1898905623;Taip;3;0;0;3
4066;"Kūlverstukas (Suvalkų g. 6)";Gelytės;7970898546;Ne;0;4;0;4
4067;"Kūlverstukas (Suvalkų g. 6)";Gelytės;4532151103;Taip;20;0;0;20
4068;"Kūlverstukas (Suvalkų g. 6)";Gelytės;3811616695;Taip;5;12;0;17
4069;"Kūlverstukas (Suvalkų g. 6)";Gelytės;5340239466;Taip;0;9;0;9
4070;"Kūlverstukas (Suvalkų g. 6)";Gelytės;6598688551;Taip;5;0;1;6
4071;"Kūlverstukas (Suvalkų g. 6)";Gelytės;3162808486;Taip;0;0;1;1
4072;"Kūlverstukas (Suvalkų g. 6)";Gelytės;8346712630;Taip;3;0;1;4
4073;"Kūlverstukas (Suvalkų g. 6)";Gelytės;3448880105;Taip;6;3;1;10
4074;"Kūlverstukas (Suvalkų g. 6)";Bitutės;1679412281;Taip;0;3;0;3
4075;"Kūlverstukas (Suvalkų g. 6)";Bitutės;1067182820;Taip;3;0;0;3
4076;"Kūlverstukas (Suvalkų g. 6)";Bitutės;3790418633;Taip;0;3;0;3
4077;"Kūlverstukas (Suvalkų g. 6)";Bitutės;2389231051;Taip;0;0;1;1
4078;"Kūlverstukas (Suvalkų g. 6)";Bitutės;8964753108;Taip;0;0;1;1
4079;"Kūlverstukas (Suvalkų g. 6)";Bitutės;4111966910;Taip;7;0;0;7
4080;"Kūlverstukas (Suvalkų g. 6)";Bitutės;1967837561;Taip;0;1;1;2
4081;"Kūlverstukas (Suvalkų g. 6)";Bitutės;8722717930;Taip;0;0;9;9
4082;"Kūlverstukas (Suvalkų g. 6)";Bitutės;8333084277;Taip;0;0;15;15
4083;"Kūlverstukas (Suvalkų g. 6)";Bitutės;8701405518;Taip;3;0;0;3
4084;"Kūlverstukas (Suvalkų g. 6)";Bitutės;7112217569;Taip;0;0;13;13
4085;"Kūlverstukas (Suvalkų g. 6)";Bitutės;2316978273;Taip;7;0;2;9
4086;"Kūlverstukas (Suvalkų g. 6)";Bitutės;6916013898;Taip;0;8;0;8
4087;"Kūlverstukas (Suvalkų g. 6)";Bitutės;8618967238;Taip;19;0;0;19
4088;"Kūlverstukas (Suvalkų g. 6)";Bitutės;5391554530;Taip;0;14;0;14
4089;"Kūlverstukas (Suvalkų g. 6)";Bitutės;4696990344;Taip;4;3;0;7
4090;"Kūlverstukas (Suvalkų g. 6)";Bitutės;4651091340;Taip;22;0;0;22
4091;Lakštingala;Saulutės;2156571482;Taip;0;2;1;3
4092;Lakštingala;Saulutės;4651600682;Taip;4;0;0;4
4093;Lakštingala;Saulutės;2084960114;Taip;13;0;0;13
4094;Lakštingala;Saulutės;3911509979;Taip;0;2;1;3
4095;Lakštingala;Saulutės;1598639284;Taip;0;1;0;1
4096;Lakštingala;Saulutės;3723986383;Taip;4;0;1;5
4097;Lakštingala;Saulutės;2742489026;Taip;3;0;0;3
4098;Lakštingala;Saulutės;1243254166;Taip;0;0;7;7
4099;Lakštingala;Saulutės;9628476764;Taip;4;1;1;6
4100;Lakštingala;Saulutės;4344553248;Taip;7;0;1;8
4101;Lakštingala;Saulutės;9457533516;Taip;0;0;3;3
4102;Lakštingala;Saulutės;6567480562;Taip;0;0;7;7
4103;Lakštingala;Saulutės;2543779273;Taip;5;1;0;6
4104;Lakštingala;Saulutės;2093953744;Taip;0;1;0;1
4105;Lakštingala;Saulutės;2626498928;Taip;8;0;0;8
4106;Lakštingala;Saulutės;9441296489;Taip;0;1;3;4
4107;Lakštingala;Saulutės;6369696598;Taip;0;1;2;3
4108;Lakštingala;Saulutės;3618452008;Taip;0;0;6;6
4109;Lakštingala;Saulutės;9297542026;Taip;5;3;0;8
4110;Lakštingala;Nykštukai;1863034132;Taip;22;0;0;22
4111;Lakštingala;Nykštukai;9879064676;Taip;0;10;1;11
4112;Lakštingala;Nykštukai;8284565948;Taip;13;0;0;13
4113;Lakštingala;Nykštukai;2423651716;Taip;3;0;0;3
4114;Lakštingala;Nykštukai;9489982241;Taip;0;1;0;1
4115;Lakštingala;Nykštukai;4032030375;Taip;0;1;0;1
4116;Lakštingala;Nykštukai;3993759015;Taip;3;7;0;10
4117;Lakštingala;Nykštukai;2652305131;Taip;0;7;0;7
4118;Lakštingala;Nykštukai;9725851433;Taip;11;0;1;12
4119;Lakštingala;Nykštukai;6332498461;Taip;7;0;0;7
4120;Lakštingala;Nykštukai;1655202909;Taip;19;0;0;19
4121;Lakštingala;Nykštukai;9375002191;Taip;0;6;0;6
4122;Lakštingala;Nykštukai;4857448665;Taip;5;0;0;5
4123;Lakštingala;Nykštukai;2304340938;Taip;2;0;0;2
4124;Lakštingala;Nykštukai;8217315818;Taip;0;3;0;3
4125;Lakštingala;Nykštukai;6292331193;Taip;2;0;0;2
4126;Lakštingala;Nykštukai;7963839249;Taip;0;3;0;3
4127;Lakštingala;Bitutės;6150013105;Taip;0;1;0;1
4128;Lakštingala;Bitutės;98609129644;Taip;0;1;0;1
4129;Lakštingala;Bitutės;1868573076;Taip;0;14;0;14
4130;Lakštingala;Bitutės;7325183642;Taip;14;0;0;14
4131;Lakštingala;Bitutės;2013216779;Taip;0;2;0;2
4132;Lakštingala;Bitutės;25449089230;Taip;0;1;0;1
4133;Lakštingala;Bitutės;1676655778;Taip;9;2;2;13
4134;Lakštingala;Bitutės;1310400524;Taip;8;0;0;8
4135;Lakštingala;Bitutės;58056130761;Taip;1;0;10;11
4136;Lakštingala;Bitutės;14410791110;Taip;0;4;0;4
4137;Lakštingala;Bitutės;1297637335;Taip;0;1;0;1
4138;Lakštingala;Bitutės;88947243829;Taip;3;4;3;10
4139;Lakštingala;Bitutės;6329787217;Taip;0;9;5;14
4140;Lakštingala;Bitutės;9381815353;Taip;0;11;0;11
4141;Lakštingala;Bitutės;7139669240;Taip;0;4;0;4
4142;Lakštingala;Bitutės;89747320378;Taip;0;3;0;3
4143;Lakštingala;Bitutės;4261431738;Taip;5;2;0;7
4144;Lakštingala;Pūkeliai;5598711072;Taip;13;0;0;13
4145;Lakštingala;Pūkeliai;8171357606;Taip;6;4;0;10
4146;Lakštingala;Pūkeliai;9774836470;Taip;22;0;0;22
4147;Lakštingala;Pūkeliai;1958696382;Taip;0;0;1;1
4148;Lakštingala;Pūkeliai;4542992319;Taip;0;0;5;5
4149;Lakštingala;Pūkeliai;7929034243;Taip;10;0;0;10
4150;Lakštingala;Pūkeliai;2130192341;Taip;22;0;0;22
4151;Lakštingala;Pūkeliai;8165998647;Taip;20;0;0;20
4152;Lakštingala;Pūkeliai;1458348357;Taip;0;0;2;2
4153;Lakštingala;Pūkeliai;4465752871;Taip;5;0;0;5
4154;Lakštingala;Pūkeliai;4722328994;Taip;3;0;0;3
4155;Lakštingala;Pūkeliai;1587899391;Taip;9;0;0;9
4156;Lakštingala;Pūkeliai;6234559044;Taip;9;0;0;9
4157;Lakštingala;Pūkeliai;5727308039;Taip;0;1;0;1
4158;Lakštingala;Pūkeliai;9431022632;Taip;8;0;0;8
4159;Lakštingala;Pūkeliai;5051773825;Taip;12;0;0;12
4160;Lakštingala;Aitvariukai;5851957031;Ne;0;0;3;3
4161;Lakštingala;Aitvariukai;9390342572;Taip;0;1;1;2
4162;Lakštingala;Aitvariukai;7918688955;Taip;2;0;0;2
4163;Lakštingala;Aitvariukai;3509165175;Taip;22;0;0;22
4164;Lakštingala;Aitvariukai;4179366572;Taip;9;0;4;13
4165;Lakštingala;Aitvariukai;8679582358;Taip;22;0;0;22
4166;Lakštingala;Aitvariukai;5445945319;Taip;9;0;0;9
4167;Lakštingala;Aitvariukai;2266870318;Taip;9;0;0;9
4168;Lakštingala;Aitvariukai;6565318145;Taip;10;0;0;10
4169;Lakštingala;Aitvariukai;4384468922;Ne;0;0;7;7
4170;Lakštingala;Aitvariukai;5162605666;Taip;10;0;0;10
4171;Lakštingala;Aitvariukai;2073818724;Taip;5;0;0;5
4172;Lakštingala;Aitvariukai;6872095965;Taip;5;0;0;5
4173;Lakštingala;Boružiukai;9795993812;Taip;0;2;0;2
4174;Lakštingala;Boružiukai;9004336424;Ne;10;3;0;13
4175;Lakštingala;Boružiukai;8820053026;Taip;0;2;0;2
4176;Lakštingala;Boružiukai;4811759034;Taip;5;2;0;7
4177;Lakštingala;Boružiukai;1898853302;Taip;0;5;0;5
4178;Lakštingala;Boružiukai;7443563000;Taip;0;0;5;5
4179;Lakštingala;Boružiukai;55720630870;Taip;3;8;0;11
4180;Lakštingala;Boružiukai;1444534032;Taip;0;2;0;2
4181;Lakštingala;Boružiukai;9724531753;Taip;0;2;0;2
4182;Lakštingala;Boružiukai;1783776913;Taip;0;2;0;2
4183;Lakštingala;Boružiukai;1667277983;Taip;6;1;0;7
4184;Lakštingala;Boružiukai;6947565845;Taip;0;2;0;2
4185;Lakštingala;Boružiukai;3009692491;Taip;0;1;0;1
4186;Lakštingala;Boružiukai;1800927281;Taip;7;0;0;7
4187;Lakštingala;Boružiukai;9998322501;Taip;20;0;0;20
4188;Lakštingala;Žiogeliai;1832608585;Taip;8;0;0;8
4189;Lakštingala;Žiogeliai;9958821769;Taip;0;2;0;2
4190;Lakštingala;Žiogeliai;7953724873;Taip;0;2;0;2
4191;Lakštingala;Žiogeliai;1411121466;Taip;0;9;0;9
4192;Lakštingala;Žiogeliai;8944088082;Taip;0;0;4;4
4193;Lakštingala;Žiogeliai;9897713625;Taip;0;0;2;2
4194;Lakštingala;Žiogeliai;70798601578;Taip;0;3;0;3
4195;Lakštingala;Žiogeliai;1736130324;Taip;0;5;0;5
4196;Lakštingala;Žiogeliai;2039579203;Taip;0;5;0;5
4197;Lakštingala;Žiogeliai;7900597697;Taip;0;0;7;7
4198;Lakštingala;Žiogeliai;8470575927;Taip;0;10;0;10
4199;Lakštingala;Žiogeliai;1265027238;Taip;0;16;0;16
4200;Lakštingala;Žiogeliai;5672932116;Ne;6;1;7;14
4201;Lakštingala;SPINDULIUKAI;4365413054;Taip;12;0;1;13
4202;Lakštingala;SPINDULIUKAI;9762500668;Taip;15;0;0;15
4203;Lakštingala;SPINDULIUKAI;7640007392;Taip;10;0;3;13
4204;Lakštingala;SPINDULIUKAI;4784677514;Taip;0;1;0;1
4205;Lakštingala;SPINDULIUKAI;1619201521;Taip;0;6;0;6
4206;Lakštingala;SPINDULIUKAI;8429523368;Taip;0;2;3;5
4207;Lakštingala;SPINDULIUKAI;1767414096;Taip;2;0;2;4
4208;Lakštingala;SPINDULIUKAI;6668075753;Ne;6;0;1;7
4209;Lakštingala;SPINDULIUKAI;9081653166;Taip;1;2;0;3
4210;Lakštingala;SPINDULIUKAI;8160825203;Taip;0;0;1;1
4211;Lakštingala;SPINDULIUKAI;6780591792;Taip;13;9;0;22
4212;Lakštingala;SPINDULIUKAI;8422745100;Taip;4;12;0;16
4213;Lakštingala;SPINDULIUKAI;4698879435;Taip;4;0;0;4
4214;Lakštingala;SPINDULIUKAI;8722490845;Taip;0;0;1;1
4215;Lakštingala;SPINDULIUKAI;1220858944;Taip;7;0;0;7
4216;Lakštingala;SPINDULIUKAI;3823860988;Taip;3;0;0;3
4217;Lakštingala;SPINDULIUKAI;3282771613;Taip;0;6;0;6
4218;Lakštingala;SPINDULIUKAI;2795341401;Taip;0;2;0;2
4219;Lakštingala;SPINDULIUKAI;5815240975;Taip;2;6;1;9
4220;Lakštingala;SPINDULIUKAI;5391954600;Taip;0;1;0;1
4221;Lakštingala;SPINDULIUKAI;9052256710;Taip;5;0;0;5
4222;Lakštingala;Pėledžiukai;1347480198;Taip;0;3;0;3
4223;Lakštingala;Pėledžiukai;3520592784;Taip;4;1;0;5
4224;Lakštingala;Pėledžiukai;5258588961;Taip;7;0;0;7
4225;Lakštingala;Pėledžiukai;6135103377;Taip;2;0;0;2
4226;Lakštingala;Pėledžiukai;4774354751;Ne;12;0;4;16
4227;Lakštingala;Pėledžiukai;3369263112;Taip;0;0;2;2
4228;Lakštingala;Pėledžiukai;8375506323;Taip;10;0;2;12
4229;Lakštingala;Pėledžiukai;8717764626;Taip;11;0;0;11
4230;Lakštingala;Pėledžiukai;8075192528;Taip;5;0;1;6
4231;Lakštingala;Pėledžiukai;3766779594;Taip;0;1;0;1
4232;Lakštingala;Pėledžiukai;6161860331;Taip;0;0;8;8
4233;Lakštingala;Pėledžiukai;6866935290;Taip;4;0;11;15
4234;Lakštingala;Pėledžiukai;8787118512;Taip;22;0;0;22
4235;Lakštingala;Pėledžiukai;2395109471;Taip;0;0;4;4
4236;Lakštingala;Pėledžiukai;6805882038;Taip;22;0;0;22
4237;Lakštingala;Katinėliai;6981178960;Taip;6;0;11;17
4238;Lakštingala;Katinėliai;3908175786;Taip;5;0;2;7
4239;Lakštingala;Katinėliai;9860169528;Taip;5;0;0;5
4240;Lakštingala;Katinėliai;4935753482;Taip;0;2;0;2
4241;Lakštingala;Katinėliai;5008933316;Taip;20;0;0;20
4242;Lakštingala;Katinėliai;3766986041;Taip;14;0;1;15
4243;Lakštingala;Katinėliai;1974950823;Taip;8;7;0;15
4244;Lakštingala;Katinėliai;3502341538;Taip;8;0;8;16
4245;Lakštingala;Katinėliai;1226908540;Taip;0;4;2;6
4246;Lakštingala;Katinėliai;3951057865;Taip;6;0;0;6
4247;Lakštingala;Katinėliai;7361353346;Taip;0;4;2;6
4248;Lakštingala;Katinėliai;7661973162;Taip;7;0;0;7
4249;Lakštingala;Katinėliai;7104398627;Taip;0;1;0;1
4250;Lakštingala;Katinėliai;1494530289;Taip;0;0;3;3
4251;Lakštingala;Katinėliai;5455119187;Taip;0;8;0;8
4252;Lakštingala;Deimantėliai;2723364075;Taip;7;0;9;16
4253;Lakštingala;Deimantėliai;1474796466;Taip;4;0;0;4
4254;Lakštingala;Deimantėliai;9083753159;Taip;1;4;0;5
4255;Lakštingala;Deimantėliai;3820420199;Taip;6;0;0;6
4256;Lakštingala;Deimantėliai;7240426529;Taip;8;0;0;8
4257;Lakštingala;Deimantėliai;8558000223;Taip;7;0;7;14
4258;Lakštingala;Deimantėliai;5244646855;Taip;0;3;0;3
4259;Lakštingala;Deimantėliai;3166474163;Taip;0;5;0;5
4260;Lakštingala;Deimantėliai;8609822839;Taip;0;4;0;4
4261;Lakštingala;Deimantėliai;7404386777;Taip;0;0;2;2
4262;Lakštingala;Deimantėliai;4403673558;Taip;7;0;0;7
4263;Lakštingala;Deimantėliai;7879280198;Taip;0;5;0;5
4264;Lakštingala;Deimantėliai;9856189053;Taip;0;2;0;2
4265;Lakštingala;Deimantėliai;8421786788;Taip;2;0;0;2
4266;Lakštingala;Deimantėliai;1248909711;Taip;1;0;0;1
4267;Lakštingala;Deimantėliai;4546036762;Taip;8;0;0;8
4268;Lakštingala;KIŠKUČIAI;42012300013;Taip;1;2;0;3
4269;Lakštingala;KIŠKUČIAI;7448175606;Taip;0;6;0;6
4270;Lakštingala;KIŠKUČIAI;2002196654;Taip;0;1;0;1
4271;Lakštingala;KIŠKUČIAI;5033145687;Taip;3;2;0;5
4272;Lakštingala;KIŠKUČIAI;95832669291;Taip;8;1;0;9
4273;Lakštingala;KIŠKUČIAI;70748679017;Taip;0;10;0;10
4274;Lakštingala;KIŠKUČIAI;58847206918;Taip;0;2;2;4
4275;Lakštingala;KIŠKUČIAI;19003276281;Taip;0;2;2;4
4276;Lakštingala;KIŠKUČIAI;31911078405;Taip;0;2;2;4
4277;Lakštingala;KIŠKUČIAI;8838078447;Taip;0;2;4;6
4278;Lakštingala;KIŠKUČIAI;4183492894;Taip;3;2;1;6
4279;Lakštingala;KIŠKUČIAI;11399672681;Taip;0;8;0;8
4280;Lakštingala;KIŠKUČIAI;1263184555;Taip;8;0;0;8
4281;Lakštingala;KIŠKUČIAI;26288159700;Taip;6;6;0;12
4282;Lakštingala;KIŠKUČIAI;48160996499;Taip;0;2;0;2
4283;Lakštingala;KIŠKUČIAI;601001178;Taip;0;11;0;11
4284;Lakštingala;KIŠKUČIAI;4770775472;Taip;0;1;0;1
4285;Lakštingala;KIŠKUČIAI;53914093216;Taip;1;2;2;5
4286;Lakštingala;KIŠKUČIAI;77528823822;Taip;0;1;0;1
4287;Lakštingala;KIŠKUČIAI;3426133948;Taip;0;9;0;9
4288;Lakštingala;KIŠKUČIAI;9689911725;Taip;0;1;0;1
4289;Lašelis;VIŠČIUKAI;1279052767;Ne;9;0;0;9
4290;Lašelis;VIŠČIUKAI;1042560186;Taip;5;0;0;5
4291;Lašelis;VIŠČIUKAI;4832223461;Taip;11;0;1;12
4292;Lašelis;VIŠČIUKAI;5416590600;Taip;22;0;0;22
4293;Lašelis;VIŠČIUKAI;6836452490;Taip;0;0;2;2
4294;Lašelis;VIŠČIUKAI;1983312896;Taip;0;7;0;7
4295;Lašelis;VIŠČIUKAI;8814796010;Taip;0;7;0;7
4296;Lašelis;VIŠČIUKAI;2593126568;Taip;4;0;0;4
4297;Lašelis;VIŠČIUKAI;2509469243;Taip;0;0;7;7
4298;Lašelis;VIŠČIUKAI;1490179832;Ne;0;9;2;11
4299;Lašelis;VIŠČIUKAI;2223293390;Taip;5;0;3;8
4300;Lašelis;VIŠČIUKAI;3675606390;Taip;17;0;0;17
4301;Lašelis;VIŠČIUKAI;9086385624;Taip;14;5;0;19
4302;Lašelis;VIŠČIUKAI;6477439886;Taip;11;0;0;11
4303;Lašelis;VIŠČIUKAI;6857428142;Taip;7;5;0;12
4304;Lašelis;VIŠČIUKAI;8906479495;Taip;0;0;3;3
4305;Lašelis;ŠYPSENA;1926439959;Taip;0;0;9;9
4306;Lašelis;ŠYPSENA;5731394231;Taip;0;0;1;1
4307;Lašelis;ŠYPSENA;3805049682;Taip;4;0;0;4
4308;Lašelis;ŠYPSENA;1035888733;Taip;0;6;0;6
4309;Lašelis;ŠYPSENA;8132517365;Taip;0;5;0;5
4310;Lašelis;ŠYPSENA;1244168190;Taip;5;0;1;6
4311;Lašelis;ŠYPSENA;2034007263;Taip;0;0;1;1
4312;Lašelis;ŠYPSENA;8318512396;Taip;0;11;0;11
4313;Lašelis;ŠYPSENA;7657786815;Taip;9;5;0;14
4314;Lašelis;ŠYPSENA;7107685761;Taip;7;0;0;7
4315;Lašelis;ŠYPSENA;3495676199;Taip;0;8;0;8
4316;Lašelis;ŠYPSENA;2886967297;Taip;16;3;0;19
4317;Lašelis;ŠYPSENA;2401058384;Ne;0;0;4;4
4318;Lašelis;ŠYPSENA;6041192600;Taip;0;22;0;22
4319;Lašelis;ŠYPSENA;1085950130;Taip;2;0;1;3
4320;Lašelis;ŠYPSENA;1816377082;Ne;0;3;0;3
4321;Lašelis;NYKŠTUKAI;3144718477;Taip;15;0;0;15
4322;Lašelis;NYKŠTUKAI;7998812497;Taip;0;7;0;7
4323;Lašelis;NYKŠTUKAI;6669130831;Taip;3;0;0;3
4324;Lašelis;NYKŠTUKAI;7351939034;Taip;0;1;0;1
4325;Lašelis;NYKŠTUKAI;3239288878;Taip;6;0;1;7
4326;Lašelis;NYKŠTUKAI;6829438486;Taip;0;0;2;2
4327;Lašelis;NYKŠTUKAI;6080664872;Taip;3;0;10;13
4328;Lašelis;NYKŠTUKAI;2204859014;Taip;4;0;0;4
4329;Lašelis;NYKŠTUKAI;1515920896;Ne;5;0;2;7
4330;Lašelis;NYKŠTUKAI;1085400709;Taip;0;3;6;9
4331;Lašelis;NYKŠTUKAI;8889959782;Taip;4;0;2;6
4332;Lašelis;NYKŠTUKAI;1646912457;Taip;0;0;2;2
4333;Lašelis;NYKŠTUKAI;4508779926;Taip;8;0;2;10
4334;Lašelis;SAULUTĖ;5046619730;Taip;4;5;0;9
4335;Lašelis;SAULUTĖ;7471332824;Taip;0;2;0;2
4336;Lašelis;SAULUTĖ;4599789649;Taip;0;9;0;9
4337;Lašelis;BORUŽĖLĖS;6137626795;Taip;0;4;0;4
4338;Lašelis;BORUŽĖLĖS;3995905195;Taip;4;15;0;19
4339;Lašelis;BORUŽĖLĖS;1635921119;Ne;0;12;0;12
4340;Lašelis;BORUŽĖLĖS;9664015801;Taip;4;4;0;8
4341;Lašelis;BORUŽĖLĖS;2306501498;Taip;9;0;1;10
4342;Lašelis;BORUŽĖLĖS;2606193652;Ne;0;4;1;5
4343;Lašelis;BORUŽĖLĖS;9434932943;Taip;10;5;0;15
4344;Lašelis;BORUŽĖLĖS;1690011834;Ne;2;14;0;16
4345;Lašelis;BORUŽĖLĖS;1367955273;Ne;14;0;0;14
4346;Lašelis;BORUŽĖLĖS;9341950439;Ne;6;1;0;7
4347;Lašelis;BORUŽĖLĖS;2824852871;Taip;7;4;0;11
4348;Lašelis;BORUŽĖLĖS;2210915728;Ne;6;0;0;6
4349;Lašelis;BORUŽĖLĖS;9943294701;Ne;8;0;0;8
4350;Lašelis;BORUŽĖLĖS;1507113019;Ne;22;0;0;22
4351;Lašelis;BORUŽĖLĖS;9884946783;Taip;11;6;0;17
4352;Lašelis;BORUŽĖLĖS;2702582486;Taip;12;4;0;16
4353;Lašelis;BORUŽĖLĖS;1343964112;Taip;18;0;0;18
4354;Lašelis;SKRUZDELIUKAI;1429188137;Taip;14;0;0;14
4355;Lašelis;SKRUZDELIUKAI;5634517740;Ne;0;16;1;17
4356;Lašelis;SKRUZDELIUKAI;4893073148;Taip;11;1;0;12
4357;Lašelis;SKRUZDELIUKAI;8394290574;Taip;15;1;0;16
4358;Lašelis;SKRUZDELIUKAI;1511922965;Taip;8;4;0;12
4359;Lašelis;SKRUZDELIUKAI;1294930990;Taip;6;1;0;7
4360;Lašelis;SKRUZDELIUKAI;2121080776;Taip;7;0;0;7
4361;Lašelis;SKRUZDELIUKAI;1305611902;Taip;21;0;0;21
4362;Lašelis;SKRUZDELIUKAI;7418586100;Taip;18;0;0;18
4363;Lašelis;SKRUZDELIUKAI;9440665009;Ne;13;0;0;13
4364;Lašelis;SKRUZDELIUKAI;7502668870;Taip;3;6;0;9
4365;Lašelis;SKRUZDELIUKAI;7811809908;Taip;5;0;0;5
4366;Lazdynėlis;BITUTĖS;3650483589;Taip;3;0;0;3
4367;Lazdynėlis;BITUTĖS;4881322530;Taip;21;0;0;21
4368;Lazdynėlis;BITUTĖS;5182241318;Taip;0;0;2;2
4369;Lazdynėlis;BITUTĖS;8008332680;Taip;0;0;1;1
4370;Lazdynėlis;BITUTĖS;1748260780;Taip;8;0;0;8
4371;Lazdynėlis;BITUTĖS;1574847460;Taip;13;0;0;13
4372;Lazdynėlis;BITUTĖS;8159928299;Taip;0;0;6;6
4373;Lazdynėlis;BITUTĖS;9761942869;Taip;9;1;0;10
4374;Lazdynėlis;BITUTĖS;7911328294;Taip;3;0;0;3
4375;Lazdynėlis;BITUTĖS;4142277927;Taip;5;0;0;5
4376;Lazdynėlis;BITUTĖS;4826167852;Taip;0;0;2;2
4377;Lazdynėlis;BITUTĖS;2586187455;Taip;13;2;0;15
4378;Lazdynėlis;BITUTĖS;7719697394;Taip;0;1;1;2
4379;Lazdynėlis;BITUTĖS;5562900372;Taip;19;0;3;22
4380;Lazdynėlis;EŽIUKAI;6559543013;Taip;16;0;0;16
4381;Lazdynėlis;EŽIUKAI;5256157552;Taip;1;2;0;3
4382;Lazdynėlis;EŽIUKAI;9477491360;Taip;0;0;2;2
4383;Lazdynėlis;EŽIUKAI;2514035189;Taip;0;0;10;10
4384;Lazdynėlis;EŽIUKAI;5889772626;Taip;0;1;0;1
4385;Lazdynėlis;EŽIUKAI;3365726271;Taip;9;0;0;9
4386;Lazdynėlis;EŽIUKAI;3779983775;Taip;3;0;0;3
4387;Lazdynėlis;EŽIUKAI;4550819172;Taip;0;1;0;1
4388;Lazdynėlis;EŽIUKAI;4771173060;Taip;10;0;3;13
4389;Lazdynėlis;EŽIUKAI;1335000592;Taip;0;2;0;2
4390;Lazdynėlis;EŽIUKAI;9231049001;Taip;0;2;1;3
4391;Lazdynėlis;EŽIUKAI;9886856760;Taip;6;0;0;6
4392;Lazdynėlis;EŽIUKAI;2998606948;Taip;8;0;0;8
4393;Lazdynėlis;EŽIUKAI;6164180360;Taip;0;8;1;9
4394;Lazdynėlis;EŽIUKAI;5796381191;Taip;1;4;2;7
4395;Lazdynėlis;EŽIUKAI;3062408541;Taip;0;2;0;2
4396;Lazdynėlis;EŽIUKAI;5557752248;Taip;0;11;0;11
4397;Lazdynėlis;EŽIUKAI;8314002741;Taip;3;2;0;5
4398;Lazdynėlis;EŽIUKAI;7941793866;Taip;0;9;1;10
4399;Lazdynėlis;EŽIUKAI;6415858184;Taip;0;8;1;9
4400;Lazdynėlis;EŽIUKAI;7910561870;Taip;0;22;0;22
4401;Lazdynėlis;EŽIUKAI;1355954767;Taip;9;0;0;9
4402;Lazdynėlis;BORUŽIUKAI;4961149717;Taip;0;2;0;2
4403;Lazdynėlis;BORUŽIUKAI;6156638726;Taip;0;22;0;22
4404;Lazdynėlis;BORUŽIUKAI;1055608079;Taip;0;2;0;2
4405;Lazdynėlis;BORUŽIUKAI;9570299877;Taip;0;22;0;22
4406;Lazdynėlis;BORUŽIUKAI;86740660262;Taip;0;1;2;3
4407;Lazdynėlis;BORUŽIUKAI;1207280684;Taip;0;1;1;2
4408;Lazdynėlis;BORUŽIUKAI;1789237348;Taip;0;13;0;13
4409;Lazdynėlis;BORUŽIUKAI;2007361692;Taip;3;0;0;3
4410;Lazdynėlis;BORUŽIUKAI;29288665418;Taip;12;1;0;13
4411;Lazdynėlis;BORUŽIUKAI;11379612306;Taip;0;3;2;5
4412;Lazdynėlis;BORUŽIUKAI;7237629135;Taip;0;2;0;2
4413;Lazdynėlis;BORUŽIUKAI;3863927885;Taip;0;0;1;1
4414;Lazdynėlis;BORUŽIUKAI;8945282683;Taip;0;1;1;2
4415;Lazdynėlis;BORUŽIUKAI;5838945434;Taip;0;18;0;18
4416;Lazdynėlis;BORUŽIUKAI;6230420677;Taip;0;8;0;8
4417;Lazdynėlis;KAČIUKAI;5068598385;Taip;0;1;4;5
4418;Lazdynėlis;KAČIUKAI;2491872016;Taip;0;1;3;4
4419;Lazdynėlis;KAČIUKAI;2740122426;Taip;4;1;2;7
4420;Lazdynėlis;KAČIUKAI;9881554733;Taip;0;5;1;6
4421;Lazdynėlis;KAČIUKAI;79583491543;Taip;0;1;1;2
4422;Lazdynėlis;KAČIUKAI;1878157118;Taip;0;0;1;1
4423;Lazdynėlis;KAČIUKAI;7737877729;Taip;3;9;0;12
4424;Lazdynėlis;KAČIUKAI;5888646355;Taip;0;13;2;15
4425;Lazdynėlis;KAČIUKAI;5708643953;Taip;0;0;3;3
4426;Lazdynėlis;KAČIUKAI;8295967906;Taip;0;7;1;8
4427;Lazdynėlis;KAČIUKAI;7076664657;Taip;0;11;0;11
4428;Lazdynėlis;KAČIUKAI;7864896721;Taip;0;2;1;3
4429;Lazdynėlis;KAČIUKAI;1424382629;Taip;11;1;1;13
4430;Lazdynėlis;KAČIUKAI;7313399153;Taip;7;0;0;7
4431;Lazdynėlis;KAČIUKAI;4842228703;Taip;0;0;5;5
4432;Lazdynėlis;KAČIUKAI;6542840562;Taip;0;10;1;11
4433;Lazdynėlis;KAČIUKAI;1265404063;Taip;5;1;0;6
4434;Lazdynėlis;KAČIUKAI;6086766393;Taip;0;0;2;2
4435;Lazdynėlis;KAČIUKAI;5301460250;Taip;0;11;0;11
4436;Lazdynėlis;KAČIUKAI;3091067158;Taip;0;0;4;4
4437;Lazdynėlis;KAČIUKAI;9186165264;Taip;0;1;4;5
4438;Lazdynėlis;VOVERIUKAI;4425724586;Taip;0;4;0;4
4439;Lazdynėlis;VOVERIUKAI;6684940385;Taip;0;3;0;3
4440;Lazdynėlis;VOVERIUKAI;9187681789;Taip;0;7;5;12
4441;Lazdynėlis;VOVERIUKAI;24978945607;Taip;9;7;0;16
4442;Lazdynėlis;VOVERIUKAI;18498032472;Taip;5;7;0;12
4443;Lazdynėlis;VOVERIUKAI;158059657;Taip;5;5;1;11
4444;Lazdynėlis;VOVERIUKAI;7789345652;Taip;5;1;0;6
4445;Lazdynėlis;VOVERIUKAI;3902772678;Taip;0;1;0;1
4446;Lazdynėlis;VOVERIUKAI;8822378464;Taip;5;0;0;5
4447;Lazdynėlis;VOVERIUKAI;6863715428;Taip;0;2;0;2
4448;Lazdynėlis;VOVERIUKAI;1386686123;Taip;3;4;2;9
4449;Lazdynėlis;VOVERIUKAI;2587142646;Taip;10;4;0;14
4450;Lazdynėlis;VOVERIUKAI;2603427970;Taip;0;32;0;32
4451;Lazdynėlis;VOVERIUKAI;3043350186;Taip;0;2;0;2
4452;Lazdynėlis;VOVERIUKAI;44510351979;Taip;10;0;0;10
4453;Lazdynėlis;VOVERIUKAI;7965433882;Taip;0;7;0;7
4454;Lazdynėlis;VOVERIUKAI;4779025603;Taip;0;10;7;17
4455;Lazdynėlis;RIEŠUTĖLIAI;3086059608;Taip;0;13;0;13
4456;Lazdynėlis;RIEŠUTĖLIAI;9693153118;Taip;6;1;0;7
4457;Lazdynėlis;RIEŠUTĖLIAI;5031826548;Taip;0;5;0;5
4458;Lazdynėlis;RIEŠUTĖLIAI;6056618348;Taip;0;22;0;22
4459;Lazdynėlis;RIEŠUTĖLIAI;2478218103;Taip;0;8;0;8
4460;Lazdynėlis;RIEŠUTĖLIAI;2453740823;Taip;0;3;0;3
4461;Lazdynėlis;RIEŠUTĖLIAI;4552505857;Taip;0;5;0;5
4462;Lazdynėlis;RIEŠUTĖLIAI;6276697479;Taip;2;12;0;14
4463;Lazdynėlis;RIEŠUTĖLIAI;7545621720;Taip;7;1;2;10
4464;Lazdynėlis;RIEŠUTĖLIAI;3239107488;Ne;0;1;0;1
4465;Lazdynėlis;RIEŠUTĖLIAI;4055450300;Taip;3;0;0;3
4466;Lazdynėlis;RIEŠUTĖLIAI;8942906327;Taip;9;8;0;17
4467;Lazdynėlis;RIEŠUTĖLIAI;3362193379;Taip;6;0;0;6
4468;Lazdynėlis;RIEŠUTĖLIAI;9582702244;Taip;5;1;0;6
4469;Lazdynėlis;RIEŠUTĖLIAI;3667994076;Taip;0;1;2;3
4470;Lazdynėlis;RIEŠUTĖLIAI;8248185061;Ne;0;3;0;3
4471;Lazdynėlis;RIEŠUTĖLIAI;1668899344;Taip;0;1;0;1
4472;Lazdynėlis;ANČIUKAI;6031442797;Taip;0;22;0;22
4473;Lazdynėlis;ANČIUKAI;7552873109;Taip;9;0;2;11
4474;Lazdynėlis;ANČIUKAI;7561833526;Taip;3;0;0;3
4475;Lazdynėlis;ANČIUKAI;6817162699;Taip;0;0;11;11
4476;Lazdynėlis;ANČIUKAI;2294873565;Taip;4;0;0;4
4477;Lazdynėlis;ANČIUKAI;1499729462;Taip;3;0;0;3
4478;Lazdynėlis;ANČIUKAI;7692056055;Taip;12;0;0;12
4479;Lazdynėlis;ANČIUKAI;4745610579;Taip;0;0;1;1
4480;Lazdynėlis;ANČIUKAI;8530159773;Taip;0;10;0;10
4481;Lazdynėlis;ANČIUKAI;3036055537;Taip;0;0;5;5
4482;Lazdynėlis;ANČIUKAI;2911152510;Taip;2;0;0;2
4483;Lazdynėlis;ANČIUKAI;8229454863;Taip;17;0;0;17
4484;Lazdynėlis;ANČIUKAI;2933025284;Taip;7;0;0;7
4485;Lazdynėlis;GUDRUČIAI;23295374356;Taip;0;3;1;4
4486;Lazdynėlis;GUDRUČIAI;9668839027;Taip;0;7;0;7
4487;Lazdynėlis;GUDRUČIAI;83586382037;Taip;0;0;6;6
4488;Lazdynėlis;GUDRUČIAI;7499322078;Ne;0;0;2;2
4489;Lazdynėlis;GUDRUČIAI;1479568714;Taip;0;0;3;3
4490;Lazdynėlis;GUDRUČIAI;65806780298;Taip;0;0;8;8
4491;Lazdynėlis;GUDRUČIAI;8271766964;Taip;0;5;0;5
4492;Lazdynėlis;GUDRUČIAI;2041709821;Taip;3;5;0;8
4493;Lazdynėlis;GUDRUČIAI;92889991874;Taip;0;4;0;4
4494;Lazdynėlis;GUDRUČIAI;1169424024;Taip;0;0;4;4
4495;Lazdynėlis;GUDRUČIAI;90528749634;Taip;0;9;0;9
4496;Lazdynėlis;GUDRUČIAI;7044338769;Taip;0;1;0;1
4497;Lazdynėlis;MEŠKIUKAI;8627994583;Taip;0;0;11;11
4498;Lazdynėlis;MEŠKIUKAI;8337458289;Taip;0;0;4;4
4499;Lazdynėlis;MEŠKIUKAI;3040417651;Taip;0;0;5;5
4500;Lazdynėlis;MEŠKIUKAI;2723284353;Taip;0;0;1;1
4501;Lazdynėlis;MEŠKIUKAI;1312649234;Taip;0;1;0;1
4502;Lazdynėlis;MEŠKIUKAI;2354549025;Taip;5;0;0;5
4503;Lazdynėlis;MEŠKIUKAI;7208223612;Taip;0;0;1;1
4504;Lazdynėlis;MEŠKIUKAI;8691777167;Taip;8;0;3;11
4505;Lazdynėlis;MEŠKIUKAI;4031719765;Taip;11;0;4;15
4506;Lazdynėlis;MEŠKIUKAI;3879017767;Taip;3;0;0;3
4507;Lazdynėlis;MEŠKIUKAI;6008610525;Taip;10;0;0;10
4508;Lazdynėlis;MEŠKIUKAI;5935345506;Taip;0;0;4;4
4509;Lazdynėlis;MEŠKIUKAI;2592852361;Taip;0;0;2;2
4510;Lazdynėlis;MEŠKIUKAI;4293473176;Taip;0;22;0;22
4511;Markučiai;Žirniukų;9522946712;Taip;0;0;4;4
4512;Markučiai;Žirniukų;3525681034;Taip;7;2;0;9
4513;Markučiai;Žirniukų;7312533881;Taip;7;2;0;9
4514;Markučiai;Žirniukų;8679791696;Taip;0;0;3;3
4515;Markučiai;Žirniukų;5269411010;Taip;16;0;3;19
4516;Markučiai;Žirniukų;5250815223;Taip;1;0;9;10
4517;Markučiai;Žirniukų;8934965409;Taip;5;1;0;6
4518;Markučiai;Žirniukų;8055783293;Taip;4;0;0;4
4519;Markučiai;Žirniukų;8360526946;Taip;0;16;3;19
4520;Markučiai;Žirniukų;7244815252;Taip;11;0;0;11
4521;Markučiai;Žirniukų;2096169972;Taip;8;0;4;12
4522;Markučiai;Žirniukų;6674351628;Taip;14;0;1;15
4523;Markučiai;Žirniukų;6029692121;Taip;19;0;3;22
4524;Markučiai;Žirniukų;5614488534;Taip;18;0;1;19
4525;Markučiai;Žirniukų;4918717178;Taip;0;0;1;1
4526;Markučiai;Nykštukų;7507551844;Taip;0;5;0;5
4527;Markučiai;Nykštukų;9545967631;Taip;0;0;2;2
4528;Markučiai;Nykštukų;6121911851;Taip;6;0;1;7
4529;Markučiai;Nykštukų;6898055631;Taip;5;0;2;7
4530;Markučiai;Nykštukų;3378749042;Taip;14;6;0;20
4531;Markučiai;Nykštukų;1884388847;Taip;6;0;0;6
4532;Markučiai;Nykštukų;4485929800;Taip;0;6;3;9
4533;Markučiai;Nykštukų;7624913025;Taip;0;12;0;12
4534;Markučiai;Nykštukų;4679710493;Taip;0;0;1;1
4535;Markučiai;Nykštukų;2994895532;Taip;9;0;0;9
4536;Markučiai;Pelėdžiukų;9180404247;Taip;0;4;10;14
4537;Markučiai;Pelėdžiukų;3386071459;Taip;0;1;5;6
4538;Markučiai;Pelėdžiukų;4653663237;Taip;16;10;2;28
4539;Markučiai;Pelėdžiukų;5727655114;Taip;0;6;0;6
4540;Markučiai;Pelėdžiukų;6740434675;Taip;8;1;1;10
4541;Markučiai;Pelėdžiukų;6707310242;Taip;0;8;4;12
4542;Markučiai;Pelėdžiukų;2256262371;Taip;12;0;0;12
4543;Markučiai;Pelėdžiukų;7947287013;Taip;5;0;1;6
4544;Markučiai;Pelėdžiukų;2543313198;Taip;3;2;3;8
4545;Markučiai;Pelėdžiukų;4418580273;Taip;0;1;2;3
4546;Markučiai;Pelėdžiukų;5522654429;Taip;0;10;2;12
4547;Markučiai;Pelėdžiukų;9219710045;Taip;0;0;3;3
4548;Markučiai;Pelėdžiukų;8888538915;Taip;10;10;0;20
4549;Markučiai;Pelėdžiukų;1623728091;Taip;0;8;1;9
4550;Markučiai;Pelėdžiukų;1799946177;Taip;8;3;1;12
4551;Markučiai;Pelėdžiukų;7809719827;Taip;0;7;3;10
4552;Markučiai;Pelėdžiukų;9576412366;Taip;4;4;0;8
4553;Markučiai;Pelėdžiukų;7642401516;Taip;8;10;0;18
4554;Markučiai;Pelėdžiukų;4860961508;Taip;9;7;1;17
4555;Markučiai;Boružėlių;9059302464;Taip;0;0;1;1
4556;Markučiai;Boružėlių;9220749889;Taip;5;0;0;5
4557;Markučiai;Boružėlių;2962530721;Taip;1;7;0;8
4558;Markučiai;Boružėlių;6574037877;Taip;1;0;0;1
4559;Markučiai;Boružėlių;4383421917;Taip;0;2;0;2
4560;Markučiai;Boružėlių;9789274040;Taip;0;9;0;9
4561;Markučiai;Boružėlių;1171899107;Taip;3;0;0;3
4562;Markučiai;Boružėlių;8078777204;Taip;8;0;1;9
4563;Markučiai;Boružėlių;8605357678;Taip;15;0;0;15
4564;Markučiai;Boružėlių;3755794133;Taip;0;1;1;2
4565;Markučiai;Boružėlių;5902165968;Taip;6;5;0;11
4566;Markučiai;Boružėlių;6055058096;Taip;0;0;2;2
4567;Markučiai;Boružėlių;5981692282;Taip;18;0;0;18
4568;Markučiai;Boružėlių;3739566642;Taip;8;0;0;8
4569;Markučiai;Boružėlių;6868394315;Taip;5;0;2;7
4570;Markučiai;Boružėlių;7634475536;Ne;3;0;5;8
4571;Markučiai;Boružėlių;5663147778;Taip;0;0;1;1
4572;Markučiai;Boružėlių;8271830626;Taip;3;0;1;4
4573;Markučiai;Bitučių;8792524832;Taip;0;8;0;8
4574;Markučiai;Bitučių;1717624510;Taip;4;0;0;4
4575;Markučiai;Bitučių;9518247571;Taip;0;8;6;14
4576;Markučiai;Bitučių;4836298058;Taip;0;8;9;17
4577;Markučiai;Bitučių;9027071539;Taip;0;1;0;1
4578;Markučiai;Bitučių;8748794886;Taip;0;0;1;1
4579;Markučiai;Bitučių;7387460586;Taip;1;1;0;2
4580;Markučiai;Bitučių;8950442843;Taip;22;8;0;30
4581;Markučiai;Bitučių;2840564082;Taip;0;9;2;11
4582;Markučiai;Bitučių;3926993383;Taip;0;5;6;11
4583;Markučiai;Bitučių;6530101961;Taip;8;10;0;18
4584;Markučiai;Bitučių;1908302738;Taip;0;6;5;11
4585;Markučiai;Bitučių;7056367646;Taip;22;10;0;32
4586;Markučiai;Bitučių;8195584468;Taip;4;4;0;8
4587;Markučiai;Bitučių;2049497686;Taip;6;13;0;19
4588;Markučiai;Bitučių;9303448709;Taip;0;5;11;16
4589;Markučiai;Bitučių;8541042547;Taip;0;2;5;7
4590;Markučiai;Bitučių;1447116821;Taip;0;1;3;4
4591;Markučiai;Bitučių;6600535396;Taip;7;1;3;11
4592;Markučiai;Drugelių;2851424931;Taip;15;0;1;16
4593;Markučiai;Drugelių;1719927769;Taip;2;0;2;4
4594;Markučiai;Drugelių;1411292558;Taip;3;0;5;8
4595;Markučiai;Drugelių;63211076619;Taip;0;2;2;4
4596;Markučiai;Drugelių;2608111078;Taip;4;3;1;8
4597;Markučiai;Drugelių;9428254633;Taip;0;3;1;4
4598;Markučiai;Drugelių;61666612833;Taip;0;2;1;3
4599;Markučiai;Drugelių;20261053601;Taip;0;2;1;3
4600;Markučiai;Drugelių;4573605085;Taip;0;0;1;1
4601;Markučiai;Drugelių;19415636420;Taip;4;2;1;7
4602;Markučiai;Drugelių;45698891062;Taip;0;0;1;1
4603;Markučiai;Drugelių;22197471483;Taip;0;2;1;3
4604;Markučiai;Drugelių;9028932081;Taip;5;0;6;11
4605;Markučiai;Drugelių;11203825718;Taip;0;0;1;1
4606;Markučiai;Drugelių;7194049189;Taip;0;2;3;5
4607;Markučiai;Drugelių;1964223995;Taip;5;0;1;6
4608;Markučiai;Drugelių;23081602011;Taip;0;0;1;1
4609;Markučiai;Drugelių;9295954145;Taip;0;0;10;10
4610;Markučiai;Drugelių;1989923269;Taip;0;0;7;7
4611;Markučiai;Skruzdėliukų;1471334430;Taip;7;0;2;9
4612;Markučiai;Skruzdėliukų;9825799013;Ne;0;6;0;6
4613;Markučiai;Skruzdėliukų;8803226424;Taip;0;0;3;3
4614;Markučiai;Skruzdėliukų;20702694553;Taip;5;0;0;5
4615;Markučiai;Skruzdėliukų;55093673733;Taip;0;0;4;4
4616;Markučiai;Skruzdėliukų;39971140989;Taip;5;0;0;5
4617;Markučiai;Skruzdėliukų;54732351634;Taip;0;0;8;8
4618;Markučiai;Skruzdėliukų;2939795063;Taip;0;0;1;1
4619;Markučiai;Skruzdėliukų;9285037135;Taip;0;0;3;3
4620;Markučiai;Skruzdėliukų;1699369138;Taip;5;0;5;10
4621;Markučiai;Skruzdėliukų;1881218133;Taip;15;0;0;15
4622;Markučiai;Skruzdėliukų;8863238710;Taip;0;10;0;10
4623;Markučiai;Skruzdėliukų;68193563408;Taip;0;0;6;6
4624;Markučiai;Skruzdėliukų;92854605649;Taip;8;0;0;8
4625;Markučiai;Skruzdėliukų;7114409929;Taip;0;0;3;3
4626;Markučiai;Skruzdėliukų;1529531638;Taip;0;0;3;3
4627;Markučiai;Skruzdėliukų;4186684938;Taip;0;0;3;3
4628;Markučiai;ZUIKUČIŲ;82320812575;Taip;0;4;0;4
4629;Markučiai;ZUIKUČIŲ;4861535057;Taip;0;1;0;1
4630;Markučiai;ZUIKUČIŲ;2045207175;Taip;5;8;0;13
4631;Markučiai;ZUIKUČIŲ;11751635395;Ne;0;9;0;9
4632;Markučiai;ZUIKUČIŲ;7729045227;Taip;0;2;1;3
4633;Markučiai;ZUIKUČIŲ;8061880631;Taip;3;0;0;3
4634;Markučiai;ZUIKUČIŲ;7691410556;Taip;5;1;0;6
4635;Markučiai;ZUIKUČIŲ;6453095915;Taip;9;4;1;14
4636;Markučiai;ZUIKUČIŲ;6808291628;Taip;10;13;0;23
4637;Markučiai;ZUIKUČIŲ;5387571295;Taip;0;3;2;5
4638;Markučiai;ZUIKUČIŲ;3794643964;Taip;0;5;0;5
4639;Markučiai;ZUIKUČIŲ;91228262895;Taip;8;0;9;17
4640;Markučiai;ZUIKUČIŲ;1025406111;Taip;0;18;0;18
4641;Markučiai;ZUIKUČIŲ;5749873170;Taip;0;4;7;11
4642;Markučiai;ŽIOGELIŲ;3163226803;Taip;5;1;2;8
4643;Markučiai;ŽIOGELIŲ;1244026489;Taip;0;5;0;5
4644;Markučiai;ŽIOGELIŲ;76025616287;Taip;3;1;0;4
4645;Markučiai;ŽIOGELIŲ;1323922187;Taip;0;1;0;1
4646;Markučiai;ŽIOGELIŲ;54892037118;Taip;0;1;5;6
4647;Markučiai;ŽIOGELIŲ;67074776419;Taip;0;0;1;1
4648;Markučiai;ŽIOGELIŲ;1007919702;Taip;0;11;0;11
4649;Markučiai;ŽIOGELIŲ;1923521405;Taip;0;3;0;3
4650;Markučiai;ŽIOGELIŲ;1164386108;Taip;0;3;0;3
4651;Markučiai;ŽIOGELIŲ;7850311496;Ne;1;3;0;4
4652;Markučiai;ŽIOGELIŲ;2169583290;Ne;0;7;0;7
4653;Markučiai;ŽIOGELIŲ;3340385503;Taip;1;2;0;3
4654;Markučiai;ŽIOGELIŲ;4152184290;Taip;0;0;2;2
4655;Markučiai;ŽIOGELIŲ;23267867195;Taip;0;9;3;12
4656;Markučiai;Ežiukių;1827829954;Taip;0;9;0;9
4657;Markučiai;Ežiukių;4925856706;Taip;0;9;0;9
4658;Markučiai;Ežiukių;6570638672;Taip;1;6;0;7
4659;Markučiai;Ežiukių;5975331223;Taip;0;5;1;6
4660;Markučiai;Ežiukių;2687320408;Taip;0;2;1;3
4661;Markučiai;Ežiukių;8990923872;Taip;0;11;0;11
4662;Markučiai;Ežiukių;5246980173;Taip;2;1;3;6
4663;Markučiai;Ežiukių;6308368050;Taip;0;2;3;5
4664;Markučiai;Ežiukių;4249158803;Taip;11;0;11;22
4665;Markučiai;Ežiukių;5958705106;Taip;0;0;1;1
4666;Markučiai;Ežiukių;1769984489;Taip;0;0;2;2
4667;Markučiai;Ežiukių;7791500322;Taip;0;1;0;1
4668;Markučiai;Ežiukių;3315824027;Taip;0;0;13;13
4669;Mažylis;"4 PRIEŠMOKYKLINĖ GR.";45148418456;Taip;0;0;1;1
4670;Mažylis;"4 PRIEŠMOKYKLINĖ GR.";90336289067;Taip;0;0;2;2
4671;Mažylis;"4 PRIEŠMOKYKLINĖ GR.";1021183555;Taip;0;0;6;6
4672;Mažylis;"4 PRIEŠMOKYKLINĖ GR.";86823456557;Taip;0;0;2;2
4673;Mažylis;"4 PRIEŠMOKYKLINĖ GR.";46239142395;Taip;0;0;1;1
4674;Mažylis;"4 PRIEŠMOKYKLINĖ GR.";1910064549;Taip;3;0;0;3
4675;Mažylis;"4 PRIEŠMOKYKLINĖ GR.";69238700097;Taip;0;0;1;1
4676;Mažylis;"4 PRIEŠMOKYKLINĖ GR.";2070067356;Taip;3;0;0;3
4677;Mažylis;"4 PRIEŠMOKYKLINĖ GR.";24303144913;Taip;10;0;0;10
4678;Mažylis;"4 PRIEŠMOKYKLINĖ GR.";9411559447;Taip;0;0;1;1
4679;Mažylis;"4 PRIEŠMOKYKLINĖ GR.";4252408251;Taip;13;0;5;18
4680;Mažylis;"4 PRIEŠMOKYKLINĖ GR.";6134051712;Taip;0;0;3;3
4681;Mažylis;"4 PRIEŠMOKYKLINĖ GR.";1116141616;Taip;0;0;1;1
4682;Mažylis;"2 LOPŠELIO GR.";6272047137;Taip;0;6;1;7
4683;Mažylis;"2 LOPŠELIO GR.";1219174313;Taip;0;0;11;11
4684;Mažylis;"2 LOPŠELIO GR.";7414398772;Taip;5;0;2;7
4685;Mažylis;"2 LOPŠELIO GR.";1058725505;Taip;3;3;0;6
4686;Mažylis;"2 LOPŠELIO GR.";6920171051;Taip;0;0;4;4
4687;Mažylis;"2 LOPŠELIO GR.";4880415881;Taip;5;0;0;5
4688;Mažylis;"2 LOPŠELIO GR.";1533948576;Taip;0;10;0;10
4689;Mažylis;"2 LOPŠELIO GR.";6728351360;Taip;0;0;3;3
4690;Mažylis;"2 LOPŠELIO GR.";7255856938;Taip;0;0;13;13
4691;Mažylis;"2 LOPŠELIO GR.";4987487972;Taip;7;9;4;20
4692;Mažylis;"2 LOPŠELIO GR.";9555408203;Taip;5;0;1;6
4693;Mažylis;"2 LOPŠELIO GR.";5165268747;Taip;8;0;2;10
4694;Mažylis;"2 LOPŠELIO GR.";2425437724;Taip;0;0;6;6
4695;Mažylis;"2 LOPŠELIO GR.";2723677422;Taip;4;0;18;22
4696;Mažylis;"2 LOPŠELIO GR.";9111101357;Taip;4;0;1;5
4697;Mažylis;"2 LOPŠELIO GR.";5990843024;Taip;0;0;9;9
4698;Mažylis;"3 DARŽELIO GR.";3081814579;Taip;0;0;8;8
4699;Mažylis;"3 DARŽELIO GR.";7106648054;Taip;0;0;1;1
4700;Mažylis;"3 DARŽELIO GR.";6809320247;Taip;0;0;2;2
4701;Mažylis;"3 DARŽELIO GR.";2006289999;Taip;0;0;1;1
4702;Mažylis;"3 DARŽELIO GR.";7652390515;Taip;0;0;5;5
4703;Mažylis;"3 DARŽELIO GR.";8639480781;Taip;0;0;1;1
4704;Mažylis;"3 DARŽELIO GR.";2656290898;Taip;0;0;3;3
4705;Mažylis;"3 DARŽELIO GR.";9341935211;Taip;0;2;1;3
4706;Mažylis;"3 DARŽELIO GR.";2989562406;Taip;0;0;2;2
4707;Mažylis;"3 DARŽELIO GR.";7642914458;Taip;0;1;1;2
4708;Mažylis;"3 DARŽELIO GR.";5938312001;Taip;0;0;5;5
4709;Mažylis;"3 DARŽELIO GR.";2119733659;Taip;0;2;3;5
4710;Mažylis;"3 DARŽELIO GR.";3126627913;Taip;0;0;15;15
4711;Mažylis;"3 DARŽELIO GR.";6904083734;Taip;0;0;2;2
4712;Mažylis;"3 DARŽELIO GR.";1420913875;Taip;0;5;0;5
4713;Mažylis;"3 DARŽELIO GR.";2319506343;Taip;0;0;11;11
4714;Mažylis;"3 DARŽELIO GR.";9416161833;Taip;8;0;4;12
4715;Mažylis;"6 DARŽELIO GR.";79181926145;Taip;0;5;0;5
4716;Mažylis;"6 DARŽELIO GR.";8352202912;Taip;0;0;3;3
4717;Mažylis;"6 DARŽELIO GR.";38277640135;Taip;0;0;1;1
4718;Mažylis;"6 DARŽELIO GR.";1663347167;Taip;14;1;2;17
4719;Mažylis;"6 DARŽELIO GR.";6920129837;Taip;0;0;2;2
4720;Mažylis;"6 DARŽELIO GR.";1460572347;Taip;0;5;0;5
4721;Mažylis;"6 DARŽELIO GR.";3860760654;Taip;0;0;1;1
4722;Mažylis;"6 DARŽELIO GR.";4486742281;Taip;0;5;0;5
4723;Mažylis;"6 DARŽELIO GR.";3217527771;Taip;0;0;2;2
4724;Mažylis;"6 DARŽELIO GR.";7416381505;Taip;18;0;0;18
4725;Mažylis;"6 DARŽELIO GR.";1002832487;Taip;0;0;1;1
4726;Mažylis;"6 DARŽELIO GR.";9608529135;Taip;0;0;6;6
4727;Mažylis;"6 DARŽELIO GR.";4645411379;Taip;3;0;1;4
4728;Mažylis;"6 DARŽELIO GR.";4104052524;Taip;0;2;4;6
4729;Mažylis;"6 DARŽELIO GR.";6854350717;Taip;0;0;4;4
4730;Mažylis;"6 DARŽELIO GR.";1663216529;Taip;5;0;0;5
4731;Mažylis;"6 DARŽELIO GR.";5870983755;Taip;0;0;5;5
4732;Mažylis;"1 NAUJA (LOPŠELIS)";3641990617;Taip;9;1;0;10
4733;Mažylis;"1 NAUJA (LOPŠELIS)";7754956214;Taip;0;0;2;2
4734;Mažylis;"1 NAUJA (LOPŠELIS)";8589124394;Taip;8;0;1;9
4735;Mažylis;"1 NAUJA (LOPŠELIS)";6500577246;Taip;11;0;0;11
4736;Mažylis;"1 NAUJA (LOPŠELIS)";7725286603;Taip;12;1;4;17
4737;Mažylis;"1 NAUJA (LOPŠELIS)";9894955253;Taip;0;0;7;7
4738;Mažylis;"1 NAUJA (LOPŠELIS)";3098913589;Taip;0;0;1;1
4739;Mažylis;"1 NAUJA (LOPŠELIS)";1381828313;Taip;5;0;4;9
4740;Mažylis;"1 NAUJA (LOPŠELIS)";5388105083;Taip;7;0;2;9
4741;Mažylis;"1 NAUJA (LOPŠELIS)";4100492642;Taip;9;0;6;15
4742;Mažylis;"1 NAUJA (LOPŠELIS)";9981751097;Taip;0;0;2;2
4743;Mažylis;"1 NAUJA (LOPŠELIS)";3615636349;Taip;0;10;0;10
4744;Mažylis;"1 NAUJA (LOPŠELIS)";9479398581;Taip;7;0;2;9
4745;Mažylis;"1 NAUJA (LOPŠELIS)";6270840529;Taip;6;0;6;12
4746;Mažylis;"1 NAUJA (LOPŠELIS)";8259994523;Taip;0;0;2;2
4747;Mažylis;"5 DARŽELIO GR.";2935175014;Taip;4;0;1;5
4748;Mažylis;"5 DARŽELIO GR.";2979849055;Taip;0;0;1;1
4749;Mažylis;"5 DARŽELIO GR.";4503734408;Taip;0;0;1;1
4750;Mažylis;"5 DARŽELIO GR.";6162880220;Taip;0;0;4;4
4751;Mažylis;"5 DARŽELIO GR.";2672500259;Taip;0;13;2;15
4752;Mažylis;"5 DARŽELIO GR.";8135596731;Taip;13;0;0;13
4753;Mažylis;"5 DARŽELIO GR.";8866980930;Taip;0;0;5;5
4754;Mažylis;"5 DARŽELIO GR.";4280547746;Taip;3;0;0;3
4755;Mažylis;"5 DARŽELIO GR.";9447747294;Taip;0;0;10;10
4756;Mažylis;"5 DARŽELIO GR.";4542742002;Taip;4;0;0;4
4757;Mažylis;"5 DARŽELIO GR.";2126108232;Taip;5;5;3;13
4758;Mažylis;"5 DARŽELIO GR.";4553092508;Taip;0;0;10;10
4759;Mažylis;"5 DARŽELIO GR.";4375683234;Taip;0;0;1;1
4760;Mažylis;"5 DARŽELIO GR.";8297427176;Taip;0;6;1;7
4761;Mažylis;"5 DARŽELIO GR.";6009637985;Taip;0;0;2;2
4762;Mažylis;"5 DARŽELIO GR.";5685988186;Taip;13;0;5;18
4763;Medynėlis;BITUTĖS;6107849795;Taip;5;0;1;6
4764;Medynėlis;BITUTĖS;4937709087;Taip;22;0;0;22
4765;Medynėlis;BITUTĖS;3674134340;Taip;0;4;3;7
4766;Medynėlis;BITUTĖS;2086963376;Taip;4;0;0;4
4767;Medynėlis;BITUTĖS;6826790492;Taip;4;2;0;6
4768;Medynėlis;BITUTĖS;2627655353;Taip;0;4;0;4
4769;Medynėlis;BITUTĖS;5267128750;Taip;3;0;0;3
4770;Medynėlis;BITUTĖS;7638618099;Taip;13;1;2;16
4771;Medynėlis;BITUTĖS;4488439037;Taip;0;0;3;3
4772;Medynėlis;BITUTĖS;6101613567;Taip;0;8;0;8
4773;Medynėlis;BITUTĖS;1056744101;Taip;6;0;6;12
4774;Medynėlis;BITUTĖS;7455041214;Ne;0;2;4;6
4775;Medynėlis;BITUTĖS;2234994999;Taip;0;9;0;9
4776;Medynėlis;BITUTĖS;3761845905;Taip;0;0;14;14
4777;Medynėlis;BITUTĖS;9825580191;Taip;3;0;0;3
4778;Medynėlis;BITUTĖS;3554823424;Taip;0;0;3;3
4779;Medynėlis;BITUTĖS;7272017225;Taip;0;1;0;1
4780;Medynėlis;BITUTĖS;7740591575;Taip;3;3;0;6
4781;Medynėlis;BITUTĖS;4092824377;Taip;0;7;2;9
4782;Medynėlis;BITUTĖS;1475701065;Taip;4;0;0;4
4783;Medynėlis;DRUGELIAI;1437000615;Taip;0;8;0;8
4784;Medynėlis;DRUGELIAI;76668029492;Taip;2;0;0;2
4785;Medynėlis;DRUGELIAI;1415208530;Taip;0;1;0;1
4786;Medynėlis;DRUGELIAI;1829338208;Taip;8;2;0;10
4787;Medynėlis;DRUGELIAI;88240380945;Ne;0;1;0;1
4788;Medynėlis;DRUGELIAI;7804751416;Ne;3;3;0;6
4789;Medynėlis;DRUGELIAI;6182500688;Taip;3;1;0;4
4790;Medynėlis;DRUGELIAI;7886801955;Taip;4;0;0;4
4791;Medynėlis;DRUGELIAI;1192592678;Taip;9;3;0;12
4792;Medynėlis;DRUGELIAI;88550635466;Taip;0;2;0;2
4793;Medynėlis;DRUGELIAI;5186367833;Taip;0;1;0;1
4794;Medynėlis;SKRUZDĖLIUKAI;4024866819;Taip;11;0;2;13
4795;Medynėlis;SKRUZDĖLIUKAI;1827495325;Taip;0;0;2;2
4796;Medynėlis;SKRUZDĖLIUKAI;9413309043;Taip;5;0;3;8
4797;Medynėlis;SKRUZDĖLIUKAI;4581683292;Taip;0;8;0;8
4798;Medynėlis;SKRUZDĖLIUKAI;9009316740;Taip;4;0;0;4
4799;Medynėlis;SKRUZDĖLIUKAI;1795479738;Taip;0;22;0;22
4800;Medynėlis;SKRUZDĖLIUKAI;5530782065;Taip;0;3;1;4
4801;Medynėlis;SKRUZDĖLIUKAI;5269927048;Taip;1;0;3;4
4802;Medynėlis;SKRUZDĖLIUKAI;7244497661;Taip;6;0;1;7
4803;Medynėlis;SKRUZDĖLIUKAI;8775219704;Taip;2;10;0;12
4804;Medynėlis;SKRUZDĖLIUKAI;1658457155;Taip;4;0;0;4
4805;Medynėlis;SKRUZDĖLIUKAI;33981260502;Taip;0;22;0;22
4806;Medynėlis;SKRUZDĖLIUKAI;3773215372;Taip;9;0;0;9
4807;Medynėlis;SKRUZDĖLIUKAI;6343851636;Taip;0;6;0;6
4808;Medynėlis;SKRUZDĖLIUKAI;5551121950;Taip;8;0;0;8
4809;Medynėlis;SKRUZDĖLIUKAI;3870665108;Ne;0;0;3;3
4810;Medynėlis;SKRUZDĖLIUKAI;9670396828;Taip;10;0;0;10
4811;Medynėlis;SKRUZDĖLIUKAI;2540325264;Taip;4;0;2;6
4812;Medynėlis;VOVERIUKAI;2310200034;Taip;0;8;0;8
4813;Medynėlis;VOVERIUKAI;90556319090;Taip;0;1;0;1
4814;Medynėlis;VOVERIUKAI;6999562417;Taip;17;0;0;17
4815;Medynėlis;VOVERIUKAI;5586407412;Taip;8;0;0;8
4816;Medynėlis;VOVERIUKAI;7108619017;Taip;0;4;0;4
4817;Medynėlis;VOVERIUKAI;8441104709;Taip;0;0;1;1
4818;Medynėlis;VOVERIUKAI;1820113382;Taip;0;3;0;3
4819;Medynėlis;VOVERIUKAI;9304002459;Taip;0;0;3;3
4820;Medynėlis;VOVERIUKAI;5982453884;Taip;11;0;0;11
4821;Medynėlis;VOVERIUKAI;1173510831;Taip;0;6;0;6
4822;Medynėlis;VOVERIUKAI;6406459222;Taip;12;1;0;13
4823;Medynėlis;VOVERIUKAI;2335108073;Taip;0;1;1;2
4824;Medynėlis;VOVERIUKAI;4985243068;Taip;22;0;0;22
4825;Medynėlis;VOVERIUKAI;2057309788;Taip;5;0;1;6
4826;Medynėlis;VOVERIUKAI;1750775033;Taip;3;0;0;3
4827;Medynėlis;VOVERIUKAI;9800678364;Taip;22;0;0;22
4828;Medynėlis;VOVERIUKAI;1237589979;Taip;0;0;5;5
4829;Medynėlis;VOVERIUKAI;9123873119;Taip;0;0;1;1
4830;Medynėlis;VOVERIUKAI;7140184593;Taip;5;0;4;9
4831;Medynėlis;VOVERIUKAI;5028189785;Taip;0;4;0;4
4832;Medynėlis;MEŠKIUKAI;1434648803;Taip;0;0;1;1
4833;Medynėlis;MEŠKIUKAI;1975763240;Taip;0;0;7;7
4834;Medynėlis;MEŠKIUKAI;1781906016;Taip;0;7;0;7
4835;Medynėlis;MEŠKIUKAI;46445461622;Taip;0;1;0;1
4836;Medynėlis;MEŠKIUKAI;5007624930;Taip;4;0;0;4
4837;Medynėlis;MEŠKIUKAI;9476336240;Taip;3;0;0;3
4838;Medynėlis;MEŠKIUKAI;8629622922;Taip;0;0;1;1
4839;Medynėlis;MEŠKIUKAI;1635649525;Taip;0;0;7;7
4840;Medynėlis;MEŠKIUKAI;2326848026;Taip;0;0;2;2
4841;Medynėlis;MEŠKIUKAI;8143370943;Taip;0;0;4;4
4842;Medynėlis;MEŠKIUKAI;32683798983;Taip;1;0;0;1
4843;Medynėlis;MEŠKIUKAI;1657676226;Taip;0;0;3;3
4844;Medynėlis;MEŠKIUKAI;7628899696;Taip;22;0;0;22
4845;Medynėlis;MEŠKIUKAI;96544597673;Taip;19;0;0;19
4846;Medynėlis;MEŠKIUKAI;1563329598;Ne;0;5;0;5
4847;Medynėlis;MEŠKIUKAI;48636516521;Taip;0;0;1;1
4848;Medynėlis;MEŠKIUKAI;1314163134;Taip;2;0;0;2
4849;Medynėlis;PELĖDŽIUKAI;5544663829;Taip;0;2;0;2
4850;Medynėlis;PELĖDŽIUKAI;2932544910;Taip;0;0;3;3
4851;Medynėlis;PELĖDŽIUKAI;9079900803;Taip;0;0;4;4
4852;Medynėlis;PELĖDŽIUKAI;8074251036;Taip;4;0;0;4
4853;Medynėlis;PELĖDŽIUKAI;9520409342;Taip;3;0;1;4
4854;Medynėlis;PELĖDŽIUKAI;2103255454;Taip;0;2;0;2
4855;Medynėlis;PELĖDŽIUKAI;9184868565;Taip;16;0;0;16
4856;Medynėlis;PELĖDŽIUKAI;8276864168;Taip;0;0;3;3
4857;Medynėlis;PELĖDŽIUKAI;6955467123;Taip;0;3;0;3
4858;Medynėlis;PELĖDŽIUKAI;6073797962;Taip;0;4;0;4
4859;Medynėlis;PELĖDŽIUKAI;5785463517;Taip;1;0;0;1
4860;Medynėlis;PELĖDŽIUKAI;4222917765;Taip;0;1;0;1
4861;Medynėlis;PELĖDŽIUKAI;1621499650;Taip;0;1;0;1
4862;Medynėlis;PELĖDŽIUKAI;6681155625;Taip;0;6;0;6
4863;Medynėlis;PELĖDŽIUKAI;9438854582;Taip;0;0;4;4
4864;Medynėlis;PELĖDŽIUKAI;3856908872;Taip;4;0;0;4
4865;Medynėlis;PELĖDŽIUKAI;4468967036;Taip;5;0;0;5
4866;Medynėlis;PELĖDŽIUKAI;2702814930;Taip;3;0;5;8
4867;Medynėlis;BORUŽIUKAI;3787172254;Taip;7;3;1;11
4868;Medynėlis;BORUŽIUKAI;7232396755;Taip;7;0;0;7
4869;Medynėlis;BORUŽIUKAI;7651663404;Taip;7;2;0;9
4870;Medynėlis;BORUŽIUKAI;1463263793;Taip;0;4;0;4
4871;Medynėlis;BORUŽIUKAI;1406029765;Taip;4;0;0;4
4872;Medynėlis;BORUŽIUKAI;9764215406;Taip;5;0;0;5
4873;Medynėlis;BORUŽIUKAI;8271170887;Taip;0;1;0;1
4874;Medynėlis;BORUŽIUKAI;5532880670;Taip;0;22;0;22
4875;Medynėlis;BORUŽIUKAI;1525185037;Taip;0;2;0;2
4876;Medynėlis;BORUŽIUKAI;1333848517;Taip;0;0;15;15
4877;Medynėlis;BORUŽIUKAI;9919108302;Taip;13;0;0;13
4878;Medynėlis;BORUŽIUKAI;1162859552;Ne;0;6;0;6
4879;Medynėlis;BORUŽIUKAI;6032067904;Taip;3;0;0;3
4880;Medynėlis;BORUŽIUKAI;4315717555;Taip;1;0;3;4
4881;Medynėlis;BORUŽIUKAI;5158507933;Taip;0;1;0;1
4882;Medynėlis;BORUŽIUKAI;4267654911;Taip;0;0;1;1
4883;Medynėlis;BORUŽIUKAI;2097758483;Taip;0;3;0;3
4884;Medynėlis;BORUŽIUKAI;7501831333;Taip;0;1;0;1
4885;Medynėlis;EŽIUKAI;9729505759;Taip;0;22;0;22
4886;Medynėlis;EŽIUKAI;8125271445;Taip;0;6;0;6
4887;Medynėlis;EŽIUKAI;9847006679;Taip;4;0;0;4
4888;Medynėlis;EŽIUKAI;7317307957;Taip;0;0;7;7
4889;Medynėlis;EŽIUKAI;7860869675;Taip;3;0;5;8
4890;Medynėlis;EŽIUKAI;4471168173;Taip;0;0;4;4
4891;Medynėlis;EŽIUKAI;1062269215;Taip;0;10;1;11
4892;Medynėlis;EŽIUKAI;5197757730;Taip;0;11;0;11
4893;Medynėlis;EŽIUKAI;5333502849;Taip;0;6;0;6
4894;Medynėlis;EŽIUKAI;6536626390;Taip;8;0;3;11
4895;Medynėlis;EŽIUKAI;8953622684;Taip;1;0;8;9
4896;Medynėlis;EŽIUKAI;3230747109;Taip;7;2;0;9
4897;Medynėlis;EŽIUKAI;9175884049;Taip;1;0;0;1
4898;Medynėlis;EŽIUKAI;8609650186;Taip;10;3;0;13
4899;Medynėlis;EŽIUKAI;6826409129;Taip;3;0;0;3
4900;Medynėlis;EŽIUKAI;2929100410;Taip;0;4;0;4
4901;Medynėlis;EŽIUKAI;6359536923;Taip;0;0;2;2
4902;Medynėlis;EŽIUKAI;2676262920;Taip;3;0;9;12
4903;Medynėlis;EŽIUKAI;5339084041;Taip;17;0;0;17
4904;Medynėlis;EŽIUKAI;8838774666;Taip;19;0;0;19
4905;Medynėlis;EŽIUKAI;6349817783;Taip;0;3;0;3
4906;Medynėlis;ZUIKUČIAI;6622963662;Taip;10;0;0;10
4907;Medynėlis;ZUIKUČIAI;4655266106;Taip;14;0;0;14
4908;Medynėlis;ZUIKUČIAI;4243521511;Taip;8;0;0;8
4909;Medynėlis;ZUIKUČIAI;9290099536;Taip;0;0;10;10
4910;Medynėlis;ZUIKUČIAI;1500986498;Taip;10;0;0;10
4911;Medynėlis;ZUIKUČIAI;6924524346;Taip;0;6;0;6
4912;Medynėlis;ZUIKUČIAI;4106792355;Taip;3;2;0;5
4913;Medynėlis;ZUIKUČIAI;6926408544;Taip;12;0;0;12
4914;Medynėlis;ZUIKUČIAI;6095795724;Taip;0;7;0;7
4915;Medynėlis;ZUIKUČIAI;7914358405;Taip;8;0;8;16
4916;Medynėlis;ZUIKUČIAI;9182653290;Taip;0;3;0;3
4917;Medynėlis;ZUIKUČIAI;3538656650;Taip;0;7;0;7
4918;Medynėlis;ZUIKUČIAI;9485498942;Taip;5;1;0;6
4919;Medynėlis;ZUIKUČIAI;7695626630;Taip;0;2;0;2
4920;Medynėlis;ZUIKUČIAI;5391199861;Taip;2;6;1;9
4921;Medynėlis;KAČIUKAI;3709984586;Taip;4;2;0;6
4922;Medynėlis;KAČIUKAI;9977590259;Taip;14;4;0;18
4923;Medynėlis;KAČIUKAI;4204366008;Taip;5;2;1;8
4924;Medynėlis;KAČIUKAI;4941353702;Taip;0;4;0;4
4925;Medynėlis;KAČIUKAI;9774213537;Taip;4;1;0;5
4926;Medynėlis;KAČIUKAI;8439619837;Taip;6;0;0;6
4927;Medynėlis;KAČIUKAI;8678054784;Taip;3;0;2;5
4928;Medynėlis;KAČIUKAI;7730737705;Taip;6;3;0;9
4929;Medynėlis;KAČIUKAI;7170801214;Taip;5;6;0;11
4930;Medynėlis;KAČIUKAI;7813766856;Taip;15;0;0;15
4931;Medynėlis;KAČIUKAI;2345349058;Ne;6;0;3;9
4932;Medynėlis;KAČIUKAI;5389909872;Taip;0;5;0;5
4933;Medynėlis;KAČIUKAI;4303234827;Taip;22;0;0;22
4934;Medynėlis;KAČIUKAI;9373849916;Taip;19;0;0;19
4935;Medynėlis;KAČIUKAI;6614028601;Taip;14;0;1;15
4936;Medynėlis;PELIUKAI;2993705115;Taip;0;0;2;2
4937;Medynėlis;PELIUKAI;1504612730;Taip;13;0;0;13
4938;Medynėlis;PELIUKAI;6576401514;Taip;0;2;2;4
4939;Medynėlis;PELIUKAI;4107846958;Taip;0;1;0;1
4940;Medynėlis;PELIUKAI;7296044569;Taip;0;1;0;1
4941;Medynėlis;PELIUKAI;4418330478;Taip;13;0;1;14
4942;Medynėlis;PELIUKAI;6815521895;Taip;0;0;2;2
4943;Medynėlis;PELIUKAI;4374464298;Taip;0;0;2;2
4944;Medynėlis;PELIUKAI;8877104963;Taip;0;22;0;22
4945;Medynėlis;PELIUKAI;4545707752;Taip;0;22;0;22
4946;Medynėlis;PELIUKAI;4419503239;Taip;6;0;0;6
4947;Medynėlis;PELIUKAI;7870261906;Taip;0;1;0;1
4948;Medynėlis;PELIUKAI;6466874318;Taip;9;13;0;22
4949;Medynėlis;PELIUKAI;2798305000;Taip;0;1;4;5
4950;Medynėlis;PELIUKAI;5440233814;Taip;0;0;2;2
4951;Medynėlis;PELIUKAI;4598267411;Taip;19;0;0;19
4952;Medynėlis;PELIUKAI;8711567312;Taip;8;0;3;11
4953;Medynėlis;PELIUKAI;8107171123;Taip;14;1;2;17
4954;Medynėlis;PELIUKAI;6238256156;Ne;0;4;0;4
4955;Medynėlis;ANČIUKAI;8275097931;Taip;22;0;0;22
4956;Medynėlis;ANČIUKAI;5302122600;Taip;11;0;0;11
4957;Medynėlis;ANČIUKAI;6609111216;Taip;8;0;0;8
4958;Medynėlis;ANČIUKAI;6624835214;Taip;11;0;0;11
4959;Medynėlis;ANČIUKAI;2160081492;Taip;12;2;0;14
4960;Medynėlis;ANČIUKAI;4035587227;Taip;6;0;0;6
4961;Medynėlis;ANČIUKAI;8162771849;Taip;3;0;6;9
4962;Medynėlis;ANČIUKAI;9725019515;Taip;12;0;0;12
4963;Medynėlis;ANČIUKAI;5610660982;Taip;10;0;0;10
4964;Medynėlis;ANČIUKAI;6282113738;Taip;8;0;5;13
4965;Medynėlis;ANČIUKAI;4153545500;Taip;9;0;1;10
4966;Medynėlis;ANČIUKAI;8299034970;Taip;3;0;8;11
4967;Medynėlis;ANČIUKAI;7675101600;Taip;13;0;0;13
4968;Medynėlis;ANČIUKAI;1668143166;Taip;11;0;0;11
4969;Medynėlis;ANČIUKAI;4010058673;Taip;3;5;0;8
4970;Medynėlis;ANČIUKAI;6502531749;Taip;6;0;3;9
4971;Medynėlis;ANČIUKAI;9076139419;Taip;0;4;3;7
4972;Molinukas;NYKŠTUKAI;6353165459;Taip;0;1;0;1
4973;Molinukas;NYKŠTUKAI;5876669121;Taip;0;0;5;5
4974;Molinukas;NYKŠTUKAI;2211909678;Taip;10;0;0;10
4975;Molinukas;NYKŠTUKAI;2348120316;Taip;0;8;0;8
4976;Molinukas;NYKŠTUKAI;8053608348;Taip;0;0;3;3
4977;Molinukas;NYKŠTUKAI;7623051674;Taip;0;1;0;1
4978;Molinukas;NYKŠTUKAI;9448910819;Taip;0;4;0;4
4979;Molinukas;NYKŠTUKAI;5580968328;Taip;5;7;0;12
4980;Molinukas;NYKŠTUKAI;7602239077;Taip;0;14;0;14
4981;Molinukas;NYKŠTUKAI;1849018608;Taip;0;5;3;8
4982;Molinukas;NYKŠTUKAI;4171978721;Taip;5;0;0;5
4983;Molinukas;NYKŠTUKAI;7134802574;Taip;0;0;2;2
4984;Molinukas;NYKŠTUKAI;8260101075;Taip;0;0;2;2
4985;Molinukas;NYKŠTUKAI;9293819449;Taip;0;16;0;16
4986;Molinukas;NYKŠTUKAI;5525772579;Taip;0;4;0;4
4987;Molinukas;NYKŠTUKAI;4475594896;Taip;3;0;4;7
4988;Molinukas;NYKŠTUKAI;7248705010;Taip;4;0;5;9
4989;Molinukas;NYKŠTUKAI;4101644021;Taip;3;3;0;6
4990;Molinukas;ZUIKUČIŲ;5387818175;Taip;0;0;1;1
4991;Molinukas;ZUIKUČIŲ;6326031969;Taip;0;0;3;3
4992;Molinukas;ZUIKUČIŲ;7398075402;Taip;3;0;2;5
4993;Molinukas;ZUIKUČIŲ;4534279257;Taip;6;3;1;10
4994;Molinukas;ZUIKUČIŲ;8688180482;Taip;8;0;0;8
4995;Molinukas;ZUIKUČIŲ;4918181437;Taip;0;7;3;10
4996;Molinukas;ZUIKUČIŲ;8604288346;Taip;0;1;4;5
4997;Molinukas;ZUIKUČIŲ;6636118069;Taip;0;2;0;2
4998;Molinukas;ZUIKUČIŲ;8913137310;Ne;0;2;3;5
4999;Molinukas;ZUIKUČIŲ;8416644024;Taip;3;0;0;3
5000;Molinukas;ZUIKUČIŲ;6681397435;Taip;16;0;5;21
5001;Molinukas;ZUIKUČIŲ;6084682084;Taip;0;0;2;2
5002;Molinukas;ZUIKUČIŲ;9948685221;Taip;0;4;2;6
5003;Molinukas;ZUIKUČIŲ;7451224160;Taip;10;2;0;12
5004;Molinukas;SRAIGIUKŲ;13856993048;Taip;3;0;2;5
5005;Molinukas;SRAIGIUKŲ;93528667925;Taip;0;0;3;3
5006;Molinukas;SRAIGIUKŲ;1538778372;Taip;0;0;1;1
5007;Molinukas;SRAIGIUKŲ;99537506556;Taip;0;4;0;4
5008;Molinukas;SRAIGIUKŲ;1151672597;Taip;0;3;0;3
5009;Molinukas;SRAIGIUKŲ;1880434477;Taip;0;0;8;8
5010;Molinukas;SRAIGIUKŲ;7987658567;Taip;0;0;1;1
5011;Molinukas;SRAIGIUKŲ;54948831792;Taip;0;0;1;1
5012;Molinukas;SRAIGIUKŲ;8674220663;Taip;0;2;0;2
5013;Molinukas;SRAIGIUKŲ;12208955611;Taip;0;5;0;5
5014;Molinukas;SRAIGIUKŲ;7991320348;Taip;0;1;0;1
5015;Molinukas;SRAIGIUKŲ;45801826827;Taip;0;1;0;1
5016;Molinukas;SRAIGIUKŲ;2931616290;Taip;0;0;2;2
5017;Molinukas;SRAIGIUKŲ;1878172874;Taip;0;3;0;3
5018;Molinukas;VOVERIUKAI;3469196411;Taip;0;0;1;1
5019;Molinukas;VOVERIUKAI;4583155940;Taip;0;5;3;8
5020;Molinukas;VOVERIUKAI;8541456847;Taip;0;3;2;5
5021;Molinukas;VOVERIUKAI;2286586693;Taip;9;1;2;12
5022;Molinukas;VOVERIUKAI;9413396859;Taip;0;1;0;1
5023;Molinukas;VOVERIUKAI;6898958282;Taip;6;0;0;6
5024;Molinukas;VOVERIUKAI;5685582215;Taip;0;2;6;8
5025;Molinukas;VOVERIUKAI;7446607510;Taip;9;5;0;14
5026;Molinukas;VOVERIUKAI;9667704959;Taip;0;0;15;15
5027;Molinukas;VOVERIUKAI;8516451290;Taip;5;0;0;5
5028;Molinukas;VOVERIUKAI;3030169626;Taip;0;0;2;2
5029;Molinukas;VOVERIUKAI;3207373459;Taip;6;0;3;9
5030;Molinukas;VOVERIUKAI;4209143136;Taip;9;6;0;15
5031;Molinukas;VOVERIUKAI;5648861702;Taip;9;6;0;15
5032;Molinukas;VOVERIUKAI;4957226547;Taip;0;0;3;3
5033;Molinukas;VOVERIUKAI;4950808381;Taip;0;21;1;22
5034;Molinukas;VOVERIUKAI;2779700726;Taip;0;1;6;7
5035;Molinukas;VOVERIUKAI;6832647220;Taip;0;0;4;4
5036;Molinukas;VOVERIUKAI;9318837973;Taip;0;0;2;2
5037;Molinukas;VOVERIUKAI;8247270556;Taip;6;3;1;10
5038;Molinukas;ŽVIRBLIUKŲ;8490020853;Taip;17;0;0;17
5039;Molinukas;ŽVIRBLIUKŲ;8582985479;Taip;18;0;0;18
5040;Molinukas;ŽVIRBLIUKŲ;6804127471;Taip;16;0;0;16
5041;Molinukas;ŽVIRBLIUKŲ;1605039166;Taip;16;0;0;16
5042;Molinukas;ŽVIRBLIUKŲ;9203375647;Taip;5;2;0;7
5043;Molinukas;ŽVIRBLIUKŲ;5302191209;Taip;16;0;5;21
5044;Molinukas;ŽVIRBLIUKŲ;7441251480;Taip;4;0;0;4
5045;Molinukas;ŽVIRBLIUKŲ;2651732418;Taip;0;12;0;12
5046;Molinukas;ŽVIRBLIUKŲ;2878262979;Taip;0;0;3;3
5047;Molinukas;ŽVIRBLIUKŲ;8988478990;Taip;0;2;0;2
5048;Molinukas;ŽVIRBLIUKŲ;8479427729;Taip;8;1;0;9
5049;Molinukas;ŽVIRBLIUKŲ;5597119459;Taip;13;0;2;15
5050;Molinukas;ŽVIRBLIUKŲ;8114735116;Taip;0;6;0;6
5051;Molinukas;ŽVIRBLIUKŲ;2982968605;Taip;4;0;0;4
5052;Molinukas;ŽVIRBLIUKŲ;1059002689;Taip;0;0;2;2
5053;Molinukas;ŽVIRBLIUKŲ;7825545164;Taip;5;0;0;5
5054;Molinukas;ŽVIRBLIUKŲ;2862680065;Taip;6;2;0;8
5055;Molinukas;ŽVIRBLIUKŲ;4225457772;Taip;17;0;0;17
5056;Molinukas;KAČIUKŲ;6638634402;Taip;0;0;1;1
5057;Molinukas;KAČIUKŲ;1907287249;Taip;0;0;5;5
5058;Molinukas;KAČIUKŲ;9972204424;Taip;13;1;0;14
5059;Molinukas;KAČIUKŲ;2789279432;Taip;13;0;0;13
5060;Molinukas;KAČIUKŲ;2706981559;Taip;0;0;2;2
5061;Molinukas;KAČIUKŲ;3419958136;Taip;3;5;1;9
5062;Molinukas;KAČIUKŲ;4733315902;Taip;3;0;0;3
5063;Molinukas;KAČIUKŲ;1292778118;Taip;3;1;1;5
5064;Molinukas;KAČIUKŲ;4718396549;Taip;4;0;0;4
5065;Molinukas;KAČIUKŲ;8313486714;Taip;13;7;0;20
5066;Molinukas;KAČIUKŲ;3043679624;Taip;15;0;0;15
5067;Molinukas;KAČIUKŲ;2030429825;Taip;11;0;0;11
5068;Molinukas;KAČIUKŲ;3577613732;Taip;0;0;1;1
5069;"Naminukas (Smėlio g. 13)";Drugeliai;6776805494;Taip;0;6;0;6
5070;"Naminukas (Smėlio g. 13)";Drugeliai;2395070574;Taip;0;4;0;4
5071;"Naminukas (Smėlio g. 13)";Drugeliai;5801695390;Taip;0;0;1;1
5072;"Naminukas (Smėlio g. 13)";Drugeliai;5534073614;Taip;4;0;0;4
5073;"Naminukas (Smėlio g. 13)";Drugeliai;7347998152;Taip;3;5;0;8
5074;"Naminukas (Smėlio g. 13)";Drugeliai;2132345627;Taip;3;6;0;9
5075;"Naminukas (Smėlio g. 13)";Drugeliai;1302119260;Taip;0;2;1;3
5076;"Naminukas (Smėlio g. 13)";Drugeliai;2864905392;Taip;9;3;0;12
5077;"Naminukas (Smėlio g. 13)";Drugeliai;7406775925;Taip;5;0;0;5
5078;"Naminukas (Smėlio g. 13)";Drugeliai;1333462200;Taip;8;0;4;12
5079;"Naminukas (Smėlio g. 13)";Drugeliai;6581925461;Taip;0;5;0;5
5080;"Naminukas (Smėlio g. 13)";Drugeliai;9312058190;Ne;5;2;0;7
5081;"Naminukas (Smėlio g. 13)";Drugeliai;3320805432;Taip;0;3;0;3
5082;"Naminukas (Smėlio g. 13)";Drugeliai;9689866363;Taip;4;0;1;5
5083;"Naminukas (Smėlio g. 13)";Drugeliai;2675777359;Taip;5;5;0;10
5084;"Naminukas (Smėlio g. 13)";Drugeliai;2198493034;Taip;0;2;0;2
5085;"Naminukas (Smėlio g. 13)";Drugeliai;8141324449;Taip;3;0;2;5
5086;"Naminukas (Smėlio g. 13)";Drugeliai;4599700492;Taip;1;0;6;7
5087;"Naminukas (Smėlio g. 13)";Drugeliai;8564586014;Taip;0;7;0;7
5088;"Naminukas (Smėlio g. 13)";Drugeliai;5574732283;Taip;10;0;0;10
5089;"Naminukas (Smėlio g. 13)";Bitutės;4419568254;Taip;0;0;3;3
5090;"Naminukas (Smėlio g. 13)";Bitutės;1956749138;Taip;0;10;0;10
5091;"Naminukas (Smėlio g. 13)";Bitutės;6503569633;Taip;0;11;6;17
5092;"Naminukas (Smėlio g. 13)";Bitutės;3192885665;Taip;12;0;1;13
5093;"Naminukas (Smėlio g. 13)";Bitutės;9530232649;Taip;0;0;10;10
5094;"Naminukas (Smėlio g. 13)";Bitutės;8131328042;Taip;0;21;1;22
5095;"Naminukas (Smėlio g. 13)";Bitutės;7176287699;Taip;0;3;3;6
5096;"Naminukas (Smėlio g. 13)";Bitutės;7888950723;Taip;0;3;0;3
5097;"Naminukas (Smėlio g. 13)";Bitutės;1710002948;Taip;7;4;0;11
5098;"Naminukas (Smėlio g. 13)";Bitutės;3994190066;Taip;0;3;0;3
5099;"Naminukas (Smėlio g. 13)";Bitutės;9600303816;Taip;0;8;0;8
5100;"Naminukas (Smėlio g. 13)";Bitutės;5244682030;Taip;0;8;0;8
5101;"Naminukas (Smėlio g. 13)";Bitutės;5195078101;Taip;4;0;0;4
5102;"Naminukas (Smėlio g. 13)";Bitutės;9541388086;Taip;3;2;0;5
5103;"Naminukas (Smėlio g. 13)";Bitutės;2424412518;Taip;7;14;0;21
5104;"Naminukas (Smėlio g. 13)";Bitutės;5493709688;Ne;0;0;9;9
5105;"Naminukas (Smėlio g. 13)";Bitutės;2769848640;Taip;0;3;1;4
5106;"Naminukas (Smėlio g. 13)";Bitutės;9501202207;Taip;5;8;0;13
5107;"Naminukas (Smėlio g. 13)";Bitutės;9821244713;Ne;0;0;5;5
5108;"Naminukas (Smėlio g. 13)";Bitutės;7847923107;Taip;5;0;2;7
5109;"Naminukas (Smėlio g. 13)";Bitutės;1480152104;Taip;4;0;1;5
5110;"Naminukas (Smėlio g. 13)";Paukšteliai;3501921619;Taip;0;5;0;5
5111;"Naminukas (Smėlio g. 13)";Paukšteliai;7297661383;Taip;0;0;5;5
5112;"Naminukas (Smėlio g. 13)";Paukšteliai;4998565160;Taip;0;7;0;7
5113;"Naminukas (Smėlio g. 13)";Paukšteliai;9405784626;Taip;0;0;9;9
5114;"Naminukas (Smėlio g. 13)";Paukšteliai;2583886896;Taip;6;0;1;7
5115;"Naminukas (Smėlio g. 13)";Paukšteliai;4778385421;Taip;6;0;2;8
5116;"Naminukas (Smėlio g. 13)";Paukšteliai;6178500478;Taip;0;0;2;2
5117;"Naminukas (Smėlio g. 13)";Paukšteliai;1406418130;Taip;0;4;0;4
5118;"Naminukas (Smėlio g. 13)";Paukšteliai;9891722891;Taip;9;0;13;22
5119;"Naminukas (Smėlio g. 13)";"NYKŠTUKAI ";1509433995;Taip;0;6;0;6
5120;"Naminukas (Smėlio g. 13)";"NYKŠTUKAI ";59020433000;Taip;0;13;0;13
5121;"Naminukas (Smėlio g. 13)";"NYKŠTUKAI ";3029310084;Taip;0;0;2;2
5122;"Naminukas (Smėlio g. 13)";"NYKŠTUKAI ";46665774314;Taip;0;8;0;8
5123;"Naminukas (Smėlio g. 13)";"NYKŠTUKAI ";1490712871;Taip;0;0;3;3
5124;"Naminukas (Smėlio g. 13)";"NYKŠTUKAI ";6501046678;Taip;5;4;0;9
5125;"Naminukas (Smėlio g. 13)";"NYKŠTUKAI ";74291965804;Taip;0;0;1;1
5126;"Naminukas (Smėlio g. 13)";"NYKŠTUKAI ";10563508139;Taip;0;0;2;2
5127;"Naminukas (Smėlio g. 13)";"NYKŠTUKAI ";6029194403;Taip;0;3;0;3
5128;"Naminukas (Smėlio g. 13)";"NYKŠTUKAI ";16946991001;Taip;9;0;0;9
5129;"Naminukas (Smėlio g. 13)";"NYKŠTUKAI ";3826149605;Taip;0;4;0;4
5130;"Naminukas (Smėlio g. 13)";"NYKŠTUKAI ";91883687974;Taip;13;0;1;14
5131;"Naminukas (Smėlio g. 13)";"NYKŠTUKAI ";38347825944;Taip;4;0;4;8
5132;"Naminukas (Smėlio g. 13)";"NYKŠTUKAI ";20358771509;Taip;0;2;0;2
5133;"Naminukas (Smėlio g. 13)";"NYKŠTUKAI ";19471902337;Taip;6;2;0;8
5134;Nykštukas;SMAGURIAI;8120626738;Taip;0;11;0;11
5135;Nykštukas;SMAGURIAI;9842748132;Ne;8;4;0;12
5136;Nykštukas;SMAGURIAI;4830484167;Taip;0;3;0;3
5137;Nykštukas;SMAGURIAI;1902253981;Taip;9;1;0;10
5138;Nykštukas;SMAGURIAI;4949895196;Taip;0;7;0;7
5139;Nykštukas;SMAGURIAI;9713859038;Ne;8;1;0;9
5140;Nykštukas;SMAGURIAI;7954996421;Taip;5;5;0;10
5141;Nykštukas;SMAGURIAI;4771072061;Taip;10;0;0;10
5142;Nykštukas;SMAGURIAI;6139988523;Taip;5;1;0;6
5143;Nykštukas;SMAGURIAI;5190754451;Taip;3;7;0;10
5144;Nykštukas;SMAGURIAI;8310484267;Taip;9;0;0;9
5145;Nykštukas;SMAGURIAI;1707956308;Taip;1;2;3;6
5146;Nykštukas;SMAGURIAI;8635571067;Taip;3;0;0;3
5147;Nykštukas;SMAGURIAI;9326131725;Taip;7;4;0;11
5148;Nykštukas;SMAGURIAI;2000207070;Taip;0;2;0;2
5149;Nykštukas;SMAGURIAI;2826079911;Taip;0;1;0;1
5150;Nykštukas;SMAGURIAI;7911842707;Taip;4;2;0;6
5151;Nykštukas;SMAGURIAI;6102907953;Taip;6;5;0;11
5152;Nykštukas;SMAGURIAI;7529677915;Taip;0;4;0;4
5153;Nykštukas;SMAGURIAI;4994727422;Taip;0;7;0;7
5154;Nykštukas;SMAGURIAI;3007541327;Taip;0;5;0;5
5155;Nykštukas;SMALSIUKAI;5121027981;Taip;12;0;0;12
5156;Nykštukas;SMALSIUKAI;6958596223;Taip;0;0;1;1
5157;Nykštukas;SMALSIUKAI;3002966681;Taip;0;3;0;3
5158;Nykštukas;SMALSIUKAI;4612171029;Taip;5;0;0;5
5159;Nykštukas;SMALSIUKAI;3120577264;Taip;0;1;0;1
5160;Nykštukas;SMALSIUKAI;3273579005;Taip;0;1;0;1
5161;Nykštukas;SMALSIUKAI;8948554271;Taip;0;2;0;2
5162;Nykštukas;SMALSIUKAI;4331906712;Taip;3;0;0;3
5163;Nykštukas;SMALSIUKAI;9100510105;Taip;0;4;0;4
5164;Nykštukas;SMALSIUKAI;2143857296;Taip;5;1;0;6
5165;Nykštukas;SMALSIUKAI;9779645295;Taip;11;0;0;11
5166;Nykštukas;SMALSIUKAI;9027355399;Taip;6;0;0;6
5167;Nykštukas;SMALSIUKAI;2571249434;Taip;0;14;0;14
5168;Nykštukas;AITVARIUKAI;1603960759;Taip;0;3;0;3
5169;Nykštukas;AITVARIUKAI;1643843455;Taip;0;8;0;8
5170;Nykštukas;POKŠTUKAI;7382271765;Taip;11;0;0;11
5171;Nykštukas;POKŠTUKAI;2649916049;Taip;0;5;0;5
5172;Nykštukas;POKŠTUKAI;1796016501;Taip;20;0;0;20
5173;Nykštukas;POKŠTUKAI;5958711585;Taip;9;1;0;10
5174;Nykštukas;POKŠTUKAI;3999004312;Taip;14;0;0;14
5175;Nykštukas;POKŠTUKAI;6719999304;Taip;18;0;0;18
5176;Nykštukas;POKŠTUKAI;8148163137;Taip;0;6;0;6
5177;Nykštukas;POKŠTUKAI;6253006221;Taip;19;0;0;19
5178;Nykštukas;POKŠTUKAI;5388581137;Taip;0;10;0;10
5179;Nykštukas;POKŠTUKAI;8708184278;Taip;0;8;0;8
5180;Nykštukas;POKŠTUKAI;3843163586;Taip;2;0;0;2
5181;Nykštukas;POKŠTUKAI;3507649457;Taip;4;7;0;11
5182;Nykštukas;POKŠTUKAI;3428031037;Taip;0;6;0;6
5183;Nykštukas;POKŠTUKAI;6698622575;Taip;0;4;0;4
5184;Nykštukas;POKŠTUKAI;2982662650;Taip;0;4;0;4
5185;Nykštukas;KODĖLČIUKAI;8662488739;Taip;8;0;0;8
5186;Nykštukas;KODĖLČIUKAI;7526936193;Ne;13;0;0;13
5187;Nykštukas;KODĖLČIUKAI;7730918105;Taip;3;9;0;12
5188;Nykštukas;KODĖLČIUKAI;8548820023;Taip;18;0;0;18
5189;Nykštukas;KODĖLČIUKAI;9545178064;Taip;9;0;0;9
5190;Nykštukas;KODĖLČIUKAI;6382293192;Taip;13;0;3;16
5191;Nykštukas;KODĖLČIUKAI;4177690371;Taip;0;0;1;1
5192;Nykštukas;KODĖLČIUKAI;4893494144;Taip;0;0;1;1
5193;Nykštukas;KODĖLČIUKAI;3561627809;Taip;0;13;0;13
5194;Nykštukas;KODĖLČIUKAI;5972246871;Ne;0;4;0;4
5195;Nykštukas;KODĖLČIUKAI;8940462785;Taip;0;4;0;4
5196;Nykštukas;KODĖLČIUKAI;5538446312;Ne;4;0;9;13
5197;Nykštukas;KODĖLČIUKAI;8475127245;Taip;3;0;1;4
5198;Nykštukas;KODĖLČIUKAI;4822304386;Taip;0;1;0;1
5199;Nykštukas;KODĖLČIUKAI;5292127770;Taip;9;0;0;9
5200;Nykštukas;KODĖLČIUKAI;8168579152;Taip;8;0;0;8
5201;Nykštukas;PASAKORIAI;2661110617;Taip;0;2;0;2
5202;Nykštukas;PASAKORIAI;3040001373;Taip;9;0;1;10
5203;Nykštukas;PASAKORIAI;1855278809;Taip;8;6;0;14
5204;Nykštukas;PASAKORIAI;8640715657;Taip;7;0;0;7
5205;Nykštukas;PASAKORIAI;5504584349;Taip;6;1;1;8
5206;Nykštukas;PASAKORIAI;7990462246;Taip;3;2;1;6
5207;Nykštukas;PASAKORIAI;1379378120;Taip;0;0;2;2
5208;Nykštukas;PASAKORIAI;9413198245;Taip;4;0;0;4
5209;Nykštukas;PASAKORIAI;2518342041;Taip;0;8;0;8
5210;Nykštukas;PASAKORIAI;7828733135;Taip;15;0;0;15
5211;Nykštukas;PASAKORIAI;4480184458;Taip;0;0;1;1
5212;Nykštukas;PASAKORIAI;4090494707;Taip;5;0;0;5
5213;Nykštukas;PASAKORIAI;3026598985;Taip;13;0;0;13
5214;Nykštukas;PASAKORIAI;9714310539;Taip;5;7;0;12
5215;Nykštukas;PASAKORIAI;4795301170;Taip;12;0;0;12
5216;Nykštukas;PASAKORIAI;6039661153;Taip;7;0;0;7
5217;Nykštukas;PASAKORIAI;1579064341;Taip;13;0;0;13
5218;Nykštukas;PASAKORIAI;4992654449;Taip;7;0;3;10
5219;Nykštukas;PASAKORIAI;5337728911;Taip;2;0;0;2
5220;Nykštukas;PASAKORIAI;1510338621;Taip;8;0;0;8
5221;Nykštukas;PASAKORIAI;9509051946;Taip;0;0;3;3
5222;Nykštukas;PASAKORIAI;2231375994;Taip;8;6;0;14
5223;Nykštukas;PASAKORIAI;8371081106;Taip;5;0;2;7
5224;Nykštukas;GUDRUČIAI;9871410323;Taip;7;2;0;9
5225;Nykštukas;GUDRUČIAI;4559818614;Taip;11;2;0;13
5226;Nykštukas;GUDRUČIAI;9250827058;Taip;0;3;0;3
5227;Nykštukas;GUDRUČIAI;7447202642;Taip;10;0;0;10
5228;Nykštukas;GUDRUČIAI;1714708754;Taip;5;0;2;7
5229;Nykštukas;GUDRUČIAI;5157799354;Taip;9;0;0;9
5230;Nykštukas;GUDRUČIAI;2800783215;Taip;15;0;0;15
5231;Nykštukas;GUDRUČIAI;4325369395;Taip;4;8;0;12
5232;Nykštukas;GUDRUČIAI;6630804505;Taip;8;0;0;8
5233;Nykštukas;GUDRUČIAI;8363202198;Taip;0;2;0;2
5234;Nykštukas;GUDRUČIAI;7326535810;Taip;4;5;0;9
5235;Nykštukas;GUDRUČIAI;9712596180;Taip;0;22;0;22
5236;Nykštukas;GUDRUČIAI;9941937734;Taip;5;0;0;5
5237;Nykštukas;GUDRUČIAI;2494482185;Taip;0;16;0;16
5238;Nykštukas;GUDRUČIAI;3619459404;Taip;5;1;0;6
5239;Nykštukas;GUDRUČIAI;2620150024;Taip;17;0;0;17
5240;Nykštukas;NAMINUKAI;7456007276;Taip;0;6;0;6
5241;Nykštukas;NAMINUKAI;7176519994;Taip;0;5;0;5
5242;Nykštukas;NAMINUKAI;2440574056;Taip;0;2;0;2
5243;Nykštukas;NAMINUKAI;4064016871;Taip;0;9;0;9
5244;Nykštukas;NAMINUKAI;6519078450;Taip;8;0;0;8
5245;Nykštukas;NAMINUKAI;6106373554;Ne;15;0;2;17
5246;Nykštukas;NAMINUKAI;4925214655;Taip;19;0;0;19
5247;Nykštukas;NAMINUKAI;5032283848;Taip;0;0;1;1
5248;Nykštukas;NAMINUKAI;7494444468;Taip;9;0;0;9
5249;Nykštukas;NAMINUKAI;3925958632;Taip;9;0;0;9
5250;Nykštukas;NAMINUKAI;6338717583;Taip;5;0;0;5
5251;Nykštukas;NAMINUKAI;7976689381;Taip;3;0;0;3
5252;Nykštukas;NAMINUKAI;9686815141;Taip;13;2;0;15
5253;Nykštukas;NAMINUKAI;9575291096;Taip;0;6;0;6
5254;Nykštukas;NAMINUKAI;4503830456;Taip;0;0;3;3
5255;Nykštukas;NAMINUKAI;4040123876;Taip;0;14;0;14
5256;Nykštukas;NAMINUKAI;5088668786;Taip;0;5;0;5
5257;Nykštukas;NAMINUKAI;8484617555;Taip;8;0;0;8
5258;Nykštukas;NAMINUKAI;2669525989;Taip;13;0;1;14
5259;Nykštukas;KŪLVERSTUKAI;9776630115;Taip;0;12;0;12
5260;Nykštukas;KŪLVERSTUKAI;1167614164;Taip;3;8;0;11
5261;Nykštukas;KŪLVERSTUKAI;1174618721;Taip;0;7;0;7
5262;Nykštukas;KŪLVERSTUKAI;9524639831;Ne;5;0;3;8
5263;Nykštukas;KŪLVERSTUKAI;1283453188;Taip;5;0;0;5
5264;Nykštukas;KŪLVERSTUKAI;6923345088;Taip;0;1;0;1
5265;Nykštukas;KŪLVERSTUKAI;3367348573;Taip;8;7;0;15
5266;Nykštukas;KŪLVERSTUKAI;5961945345;Taip;18;3;0;21
5267;Nykštukas;KŪLVERSTUKAI;1122600949;Taip;8;3;0;11
5268;Nykštukas;KŪLVERSTUKAI;6561696818;Taip;15;0;0;15
5269;Nykštukas;KŪLVERSTUKAI;7473124310;Taip;3;5;1;9
5270;Nykštukas;KŪLVERSTUKAI;5434220008;Taip;6;9;0;15
5271;Nykštukas;KŪLVERSTUKAI;5291104224;Taip;0;0;3;3
5272;Nykštukas;KŪLVERSTUKAI;3853935568;Taip;0;10;0;10
5273;Nykštukas;KŪLVERSTUKAI;6432531595;Taip;5;7;0;12
5274;Nykštukas;KŪLVERSTUKAI;8681884252;Taip;0;3;0;3
5275;Nykštukas;TREPSIUKAI;9894698453;Taip;0;2;0;2
5276;Nykštukas;TREPSIUKAI;9595654681;Taip;3;0;0;3
5277;Nykštukas;TREPSIUKAI;2270989478;Taip;22;0;0;22
5278;Nykštukas;TREPSIUKAI;9319066179;Taip;3;1;0;4
5279;Nykštukas;TREPSIUKAI;6750714866;Taip;6;0;0;6
5280;Nykštukas;TREPSIUKAI;2177539882;Taip;11;3;0;14
5281;Nykštukas;TREPSIUKAI;6351178752;Taip;0;4;0;4
5282;Nykštukas;TREPSIUKAI;2232317366;Taip;17;0;0;17
5283;Nykštukas;TREPSIUKAI;7896338372;Taip;12;0;0;12
5284;Nykštukas;TREPSIUKAI;1054008969;Taip;7;0;0;7
5285;Nykštukas;TREPSIUKAI;9216544103;Taip;3;0;2;5
5286;Nykštukas;TREPSIUKAI;7756618178;Taip;17;0;0;17
5287;Nykštukas;ŽIRNIUKAI;9661862689;Taip;0;4;0;4
5288;Nykštukas;ŽIRNIUKAI;1671340074;Taip;6;0;0;6
5289;Nykštukas;ŽIRNIUKAI;3339707558;Taip;0;2;0;2
5290;Nykštukas;ŽIRNIUKAI;7908029688;Taip;6;2;0;8
5291;Nykštukas;ŽIRNIUKAI;7299329150;Taip;3;5;0;8
5292;Nykštukas;ŽIRNIUKAI;7535385367;Taip;0;4;0;4
5293;Nykštukas;ŽIRNIUKAI;8109714321;Taip;14;0;0;14
5294;Nykštukas;ŽIRNIUKAI;3405633312;Taip;0;12;0;12
5295;Nykštukas;ŽIRNIUKAI;2670682135;Taip;4;1;0;5
5296;Nykštukas;ŽIRNIUKAI;1366524995;Taip;0;1;0;1
5297;Nykštukas;"NAUJA 2";2208319289;Taip;6;4;0;10
5298;Nykštukas;"NAUJA 3";2627736026;Taip;0;12;0;12
5299;Nykštukas;"NAUJA 3";4401103119;Taip;0;1;0;1
5300;Ozas;Smalsučiai;9227939420;Ne;0;0;1;1
5301;Ozas;Smalsučiai;7917100888;Taip;0;2;0;2
5302;Ozas;Smalsučiai;87218067796;Taip;0;1;0;1
5303;Ozas;Smalsučiai;4397034031;Taip;0;1;0;1
5304;Ozas;Smalsučiai;1974320330;Taip;0;9;0;9
5305;Ozas;Smalsučiai;67987032400;Taip;4;0;1;5
5306;Ozas;Smalsučiai;71695973592;Taip;0;0;2;2
5307;Ozas;Smalsučiai;57069047630;Taip;0;0;15;15
5308;Ozas;Smalsučiai;5150746885;Taip;0;4;1;5
5309;Ozas;Smalsučiai;1893257809;Taip;0;0;1;1
5310;Ozas;Smalsučiai;3286170280;Taip;0;0;1;1
5311;Ozas;Smalsučiai;9521048381;Taip;7;0;1;8
5312;Ozas;Smalsučiai;2053832360;Taip;5;6;0;11
5313;Ozas;Smalsučiai;5342394742;Taip;0;1;1;2
5314;Ozas;Drugeliai;6668470892;Taip;4;0;0;4
5315;Ozas;Drugeliai;2302999759;Taip;3;2;0;5
5316;Ozas;Drugeliai;8088330187;Taip;0;16;0;16
5317;Ozas;Drugeliai;9322806566;Taip;7;2;0;9
5318;Ozas;Drugeliai;2676747542;Taip;10;0;1;11
5319;Ozas;Drugeliai;8289643065;Taip;3;0;0;3
5320;Ozas;Drugeliai;4726019355;Taip;0;5;0;5
5321;Ozas;Drugeliai;9987863302;Taip;0;9;0;9
5322;Ozas;Drugeliai;2980799420;Taip;0;0;18;18
5323;Ozas;Drugeliai;1793692289;Taip;0;1;0;1
5324;Ozas;Drugeliai;8318380547;Taip;0;9;0;9
5325;Ozas;Drugeliai;4884054504;Taip;2;0;0;2
5326;Ozas;Drugeliai;43660054250;Taip;0;20;0;20
5327;Ozas;Drugeliai;7565002863;Taip;0;1;0;1
5328;Ozas;Drugeliai;1871542885;Taip;0;6;0;6
5329;Ozas;Drugeliai;15262583232;Taip;0;9;0;9
5330;Ozas;Drugeliai;1103685699;Taip;2;1;0;3
5331;Ozas;Boružėlės;1348960421;Taip;10;0;3;13
5332;Ozas;Boružėlės;1375643969;Ne;0;5;3;8
5333;Ozas;Boružėlės;63852147122;Taip;1;1;4;6
5334;Ozas;Boružėlės;8190314087;Taip;18;0;0;18
5335;Ozas;Boružėlės;3803998816;Taip;0;4;0;4
5336;Ozas;Boružėlės;1212358423;Taip;0;1;0;1
5337;Ozas;Boružėlės;7615907271;Ne;0;2;0;2
5338;Ozas;Boružėlės;1560342499;Taip;0;1;0;1
5339;Ozas;Boružėlės;7172573921;Taip;0;2;0;2
5340;Ozas;Boružėlės;2527574646;Taip;0;12;0;12
5341;Ozas;Boružėlės;9773251894;Taip;9;0;7;16
5342;Ozas;Boružėlės;36523514229;Taip;0;2;0;2
5343;Ozas;Boružėlės;1367050160;Taip;0;0;1;1
5344;Ozas;Boružėlės;68364031736;Taip;0;4;0;4
5345;Ozas;Boružėlės;2678629892;Taip;0;0;2;2
5346;Ozas;Boružėlės;6432357144;Taip;20;0;2;22
5347;Ozas;Boružėlės;1498656201;Taip;0;10;0;10
5348;Ozas;Boružėlės;1217496635;Taip;22;0;0;22
5349;Ozas;Boružėlės;9130645878;Taip;0;1;5;6
5350;Ozas;Žiogeliai;7461521320;Taip;0;1;0;1
5351;Ozas;Žiogeliai;3631049449;Taip;0;0;1;1
5352;Ozas;Žiogeliai;6257625501;Taip;0;1;0;1
5353;Ozas;Žiogeliai;7402290524;Taip;0;0;2;2
5354;Ozas;Žiogeliai;1562277866;Taip;0;3;6;9
5355;Ozas;Žiogeliai;4571583671;Taip;0;0;8;8
5356;Ozas;Žiogeliai;1837947633;Taip;3;11;0;14
5357;Ozas;Žiogeliai;5682027094;Taip;7;0;15;22
5358;Ozas;Žiogeliai;3770045761;Taip;0;0;2;2
5359;Ozas;Žiogeliai;9324647606;Taip;10;0;0;10
5360;Ozas;Žiogeliai;9392526836;Taip;0;4;0;4
5361;Ozas;Žiogeliai;4942550213;Taip;0;5;12;17
5362;Ozas;Žiogeliai;8676986286;Taip;0;2;8;10
5363;Ozas;Žiogeliai;2345112767;Taip;0;2;0;2
5364;Ozas;Žiogeliai;5420952391;Taip;0;11;3;14
5365;Ozas;Žiogeliai;5156383727;Taip;0;4;0;4
5366;Ozas;Žiogeliai;9929822317;Taip;0;4;3;7
5367;Ozas;Žiogeliai;2837228320;Taip;0;5;1;6
5368;Ozas;Žiogeliai;2617258206;Ne;0;7;1;8
5369;Ozas;Žiogeliai;9768754737;Ne;0;10;0;10
5370;Ozas;Bitutės;1161776624;Taip;0;13;0;13
5371;Ozas;Bitutės;4227555342;Taip;0;0;3;3
5372;Ozas;Bitutės;7499756171;Taip;0;6;4;10
5373;Ozas;Bitutės;7494307084;Taip;0;1;0;1
5374;Ozas;Bitutės;2705294874;Taip;0;0;1;1
5375;Ozas;Bitutės;2369544599;Taip;0;6;0;6
5376;Ozas;Bitutės;3329391600;Taip;0;3;0;3
5377;Ozas;Bitutės;4254601638;Taip;5;0;1;6
5378;Ozas;Bitutės;4699369567;Taip;0;0;1;1
5379;Ozas;Bitutės;8304671844;Taip;8;0;0;8
5380;Ozas;Bitutės;1895519949;Taip;0;10;2;12
5381;Ozas;Bitutės;9772085405;Taip;0;0;4;4
5382;Ozas;Bitutės;7051699003;Taip;11;2;2;15
5383;Ozas;Bitutės;5383877034;Taip;0;9;6;15
5384;Ozas;Bitutės;1117208248;Taip;0;1;3;4
5385;Ozas;Bitutės;6811181735;Ne;19;0;0;19
5386;Ozas;Bitutės;8622621570;Taip;4;0;0;4
5387;Ozas;Bitutės;4260123123;Taip;0;1;1;2
5388;Ozas;Aitvarėliai;1144679735;Taip;0;0;4;4
5389;Ozas;Aitvarėliai;2773182934;Taip;0;4;0;4
5390;Ozas;Aitvarėliai;5642468671;Taip;2;1;0;3
5391;Ozas;Aitvarėliai;1045890394;Taip;11;0;0;11
5392;Ozas;Aitvarėliai;8987796218;Taip;0;4;0;4
5393;Ozas;Aitvarėliai;7686706482;Taip;13;3;0;16
5394;Ozas;Aitvarėliai;2922370952;Taip;0;3;0;3
5395;Ozas;Aitvarėliai;5383739203;Taip;4;2;0;6
5396;Ozas;Aitvarėliai;4583818638;Taip;0;0;2;2
5397;Ozas;Aitvarėliai;2544858937;Taip;0;9;0;9
5398;Ozas;Aitvarėliai;5102704846;Taip;0;8;0;8
5399;Ozas;Aitvarėliai;1543683077;Taip;0;0;3;3
5400;Ozas;Aitvarėliai;2165291778;Taip;0;16;0;16
5401;Ozas;Aitvarėliai;8754244281;Taip;22;0;0;22
5402;Ozas;Aitvarėliai;9443843603;Taip;8;0;7;15
5403;Ozas;Aitvarėliai;3238019756;Taip;4;0;0;4
5404;Ozas;Aitvarėliai;8743467101;Taip;0;2;1;3
5405;Ozas;Aitvarėliai;3412369198;Ne;3;0;0;3
5406;Ozas;Voveraitės;8178298861;Taip;0;0;2;2
5407;Ozas;Voveraitės;6263062055;Taip;4;2;2;8
5408;Ozas;Voveraitės;9195536968;Taip;0;9;0;9
5409;Ozas;Voveraitės;6053885086;Taip;8;4;0;12
5410;Ozas;Voveraitės;5016547315;Taip;6;1;0;7
5411;Ozas;Voveraitės;1564826076;Taip;0;0;1;1
5412;Ozas;Voveraitės;2511477658;Taip;0;14;0;14
5413;Ozas;Voveraitės;1240233169;Ne;0;1;0;1
5414;Ozas;Voveraitės;6088757991;Taip;0;2;0;2
5415;Ozas;Voveraitės;5822871838;Taip;0;1;0;1
5416;Ozas;Voveraitės;2635045515;Taip;0;2;0;2
5417;Ozas;Voveraitės;6499549095;Taip;0;1;4;5
5418;Ozas;Voveraitės;6666591428;Taip;0;3;0;3
5419;Ozas;Voveraitės;7978092840;Taip;0;7;0;7
5420;Ozas;Voveraitės;2297650260;Taip;0;0;6;6
5421;Ozas;Voveraitės;9762737217;Taip;4;1;0;5
5422;Ozas;Voveraitės;7421484648;Taip;13;0;9;22
5423;Ozas;Voveraitės;6809992664;Taip;3;0;5;8
5424;Ozas;Voveraitės;6609446450;Taip;6;0;1;7
5425;Ozas;Kodelčiukai;2808066733;Taip;0;5;0;5
5426;Ozas;Kodelčiukai;13077342836;Taip;0;6;0;6
5427;Ozas;Kodelčiukai;1110232715;Taip;0;6;0;6
5428;Ozas;Kodelčiukai;28273919775;Taip;0;1;0;1
5429;Ozas;Kodelčiukai;88618151766;Taip;0;3;0;3
5430;Ozas;Kodelčiukai;3637786952;Taip;0;2;0;2
5431;Ozas;Kodelčiukai;39003781970;Taip;0;2;0;2
5432;Ozas;Kodelčiukai;1243205832;Taip;0;1;0;1
5433;Ozas;Kodelčiukai;1235925750;Taip;0;6;0;6
5434;Ozas;Kodelčiukai;69756875821;Taip;0;5;0;5
5435;Ozas;Kodelčiukai;19065860134;Taip;0;5;0;5
5436;Ozas;Kodelčiukai;1230455881;Taip;3;2;0;5
5437;Ozas;Kodelčiukai;9664748034;Taip;4;1;0;5
5438;Ozas;Kodelčiukai;1684454071;Taip;0;7;0;7
5439;Ozas;Kodelčiukai;1008366446;Taip;10;0;0;10
5440;Ozas;Kodelčiukai;1995302672;Taip;0;2;0;2
5441;Ozas;Kodelčiukai;1288477637;Ne;5;7;0;12
5442;Ozas;Kodelčiukai;82373453244;Taip;0;2;0;2
5443;Ozas;Kodelčiukai;94673981368;Taip;0;4;0;4
5444;Ozas;Kodelčiukai;19284606277;Taip;0;1;0;1
5445;Ozas;Kodelčiukai;59125596894;Taip;0;9;0;9
5446;Ozas;Pelėdžiukai;1462541264;Taip;0;3;0;3
5447;Ozas;Pelėdžiukai;3439351594;Taip;0;0;13;13
5448;Ozas;Pelėdžiukai;41795363180;Taip;4;0;1;5
5449;Ozas;Pelėdžiukai;60743195418;Taip;0;6;0;6
5450;Ozas;Pelėdžiukai;64778552590;Taip;0;0;2;2
5451;Ozas;Pelėdžiukai;1755283948;Taip;0;7;0;7
5452;Ozas;Pelėdžiukai;13375413701;Taip;0;6;0;6
5453;Ozas;Pelėdžiukai;16523707810;Taip;0;0;5;5
5454;Ozas;Pelėdžiukai;47291376629;Taip;0;4;0;4
5455;Ozas;Pelėdžiukai;2140385280;Taip;0;14;0;14
5456;Ozas;Pelėdžiukai;88159158596;Taip;0;8;1;9
5457;Ozas;Pelėdžiukai;4765249675;Taip;0;1;4;5
5458;Ozas;Pelėdžiukai;1814400303;Taip;4;0;8;12
5459;Ozas;Pelėdžiukai;1889249743;Taip;0;6;0;6
5460;Ozas;Pelėdžiukai;15885510365;Taip;2;2;0;4
5461;Ozas;Pelėdžiukai;2058548464;Taip;0;0;8;8
5462;Ozas;Pelėdžiukai;1862121693;Taip;0;4;0;4
5463;Ozas;"Kačiukai ";95179927759;Taip;5;2;1;8
5464;Ozas;"Kačiukai ";6618249243;Taip;0;0;3;3
5465;Ozas;"Kačiukai ";1151213934;Taip;4;0;0;4
5466;Ozas;"Kačiukai ";2114612776;Taip;0;4;4;8
5467;Ozas;"Kačiukai ";60155732637;Taip;0;2;0;2
5468;Ozas;"Kačiukai ";37159754070;Taip;0;0;5;5
5469;Ozas;"Kačiukai ";1580501935;Taip;0;1;0;1
5470;Ozas;"Kačiukai ";1210902341;Taip;1;0;0;1
5471;Ozas;"Kačiukai ";1316758924;Taip;0;0;4;4
5472;Ozas;"Kačiukai ";34196440412;Taip;0;0;3;3
5473;Ozas;"Kačiukai ";84277015523;Taip;0;0;2;2
5474;Ozas;"Kačiukai ";1822377180;Taip;0;0;8;8
5475;Ozas;"Kačiukai ";1551028882;Taip;8;0;0;8
5476;Ozas;"Kačiukai ";14760258125;Taip;4;0;1;5
5477;Ozas;"Kačiukai ";9345447142;Taip;3;0;6;9
5478;Ozas;"Kačiukai ";1681367373;Taip;0;0;4;4
5479;Ozas;"Kačiukai ";8248732706;Taip;0;6;0;6
5480;Ozas;"Kačiukai ";84845624912;Taip;0;0;4;4
5481;Ozas;Ančiukų;2824133388;Taip;0;2;0;2
5482;Ozas;Ančiukų;2637531106;Taip;7;10;0;17
5483;Ozas;Ančiukų;4886045470;Taip;0;5;0;5
5484;Ozas;Ančiukų;4601869799;Taip;8;0;4;12
5485;Ozas;Ančiukų;5950860889;Taip;5;0;0;5
5486;Ozas;Ančiukų;3212050416;Taip;6;0;3;9
5487;Ozas;Ančiukų;4640897674;Taip;5;0;0;5
5488;Ozas;Ančiukų;3037323341;Taip;4;9;0;13
5489;Ozas;Ančiukų;6819000895;Taip;8;1;0;9
5490;Ozas;Ančiukų;7287989663;Taip;16;0;0;16
5491;Ozas;Ančiukų;7125754645;Taip;6;0;0;6
5492;Ozas;Ančiukų;2281337233;Taip;5;0;0;5
5493;Ozas;Ančiukų;1856258542;Taip;2;7;0;9
5494;Ozas;Ančiukų;5922569280;Taip;7;0;0;7
5495;Ozas;Ančiukų;7640409923;Taip;15;2;0;17
5496;Ozas;Ančiukų;3725141591;Taip;6;0;0;6
5497;Ozas;Nykškukų;6783755555;Taip;0;2;2;4
5498;Ozas;Nykškukų;8779047802;Taip;11;0;1;12
5499;Ozas;Nykškukų;9306887706;Taip;4;0;2;6
5500;Ozas;Nykškukų;7305274617;Taip;8;0;0;8
5501;Ozas;Nykškukų;7433169909;Taip;10;3;9;22
5502;Ozas;Nykškukų;4516291572;Taip;0;6;0;6
5503;Ozas;Nykškukų;2573702751;Taip;12;0;0;12
5504;Ozas;Nykškukų;1348751454;Taip;7;7;2;16
5505;Ozas;Nykškukų;9496746778;Taip;22;0;0;22
5506;Ozas;Nykškukų;3139289643;Taip;0;6;1;7
5507;Ozas;Nykškukų;9084187344;Taip;8;1;0;9
5508;Ozas;Nykškukų;9620747099;Taip;0;1;0;1
5509;Ozas;Nykškukų;7585213159;Taip;0;1;0;1
5510;Ozas;Nykškukų;4287719751;Taip;0;6;0;6
5511;Ozas;Nykškukų;2951875705;Taip;2;1;0;3
5512;Pabiručiai;Voveriukų;2349337471;Taip;0;1;0;1
5513;Pabiručiai;Voveriukų;7278334800;Taip;3;1;0;4
5514;Pabiručiai;Voveriukų;4040533883;Taip;0;3;0;3
5515;Pabiručiai;Voveriukų;2514312233;Taip;0;1;0;1
5516;Pabiručiai;Voveriukų;7606274875;Taip;0;1;0;1
5517;Pabiručiai;Voveriukų;9356327400;Taip;0;1;0;1
5518;Pabiručiai;Voveriukų;7846758352;Taip;0;4;0;4
5519;Pabiručiai;Voveriukų;4312364951;Taip;13;3;0;16
5520;Pabiručiai;Voveriukų;4813206044;Taip;0;7;0;7
5521;Pabiručiai;Voveriukų;3936426174;Taip;0;0;2;2
5522;Pabiručiai;Voveriukų;7985360502;Taip;2;0;0;2
5523;Pabiručiai;Voveriukų;7403996266;Taip;12;1;0;13
5524;Pabiručiai;Voveriukų;9564303781;Taip;0;3;0;3
5525;Pabiručiai;Boružiukų;6401188653;Taip;0;0;4;4
5526;Pabiručiai;Boružiukų;1673473814;Taip;7;4;1;12
5527;Pabiručiai;Boružiukų;5686769648;Taip;0;5;0;5
5528;Pabiručiai;Boružiukų;7524993271;Taip;0;5;0;5
5529;Pabiručiai;Boružiukų;5708597471;Taip;0;1;0;1
5530;Pabiručiai;Boružiukų;4006783343;Ne;0;1;0;1
5531;Pabiručiai;Boružiukų;7046122545;Taip;0;0;1;1
5532;Pabiručiai;Boružiukų;4301904533;Taip;0;4;0;4
5533;Pabiručiai;Boružiukų;8175565139;Taip;0;1;0;1
5534;Pabiručiai;Boružiukų;8106446562;Taip;0;11;0;11
5535;Pabiručiai;Boružiukų;8236964683;Taip;0;1;0;1
5536;Pabiručiai;Boružiukų;1240057541;Taip;0;2;0;2
5537;Pabiručiai;Boružiukų;1671027282;Taip;0;1;0;1
5538;Pabiručiai;Boružiukų;3759350345;Taip;0;1;0;1
5539;Pabiručiai;Boružiukų;3151360288;Taip;0;1;0;1
5540;Pabiručiai;Boružiukų;9299393363;Taip;5;2;0;7
5541;Pabiručiai;Boružiukų;2771769336;Taip;0;1;0;1
5542;Pabiručiai;Boružiukų;2607840684;Taip;0;1;0;1
5543;Pabiručiai;Boružiukų;7050339198;Taip;8;2;0;10
5544;Pabiručiai;Boružiukų;4798503931;Taip;1;0;0;1
5545;Pabiručiai;Katinėlių;1670938208;Taip;0;0;3;3
5546;Pabiručiai;Katinėlių;6283372742;Taip;2;0;0;2
5547;Pabiručiai;Katinėlių;1749155319;Ne;0;0;8;8
5548;Pabiručiai;Katinėlių;34883375155;Taip;22;0;0;22
5549;Pabiručiai;Katinėlių;1705085006;Taip;0;10;4;14
5550;Pabiručiai;Katinėlių;58112415466;Taip;4;0;1;5
5551;Pabiručiai;Katinėlių;6285940478;Taip;0;3;0;3
5552;Pabiručiai;Katinėlių;8284711578;Taip;0;0;2;2
5553;Pabiručiai;Katinėlių;8710389714;Taip;0;3;0;3
5554;Pabiručiai;Katinėlių;8306688649;Taip;0;0;1;1
5555;Pabiručiai;Katinėlių;2572570925;Taip;6;0;6;12
5556;Pabiručiai;Katinėlių;4205107384;Taip;0;0;3;3
5557;Pabiručiai;Žiogelių;3272576627;Taip;10;0;0;10
5558;Pabiručiai;Žiogelių;5522447437;Taip;0;0;1;1
5559;Pabiručiai;Žiogelių;7974345478;Taip;5;6;0;11
5560;Pabiručiai;Žiogelių;8367889753;Taip;0;4;0;4
5561;Pabiručiai;Žiogelių;8421025940;Taip;0;1;4;5
5562;Pabiručiai;Žiogelių;3028063887;Taip;0;0;1;1
5563;Pabiručiai;Žiogelių;3206962828;Taip;0;0;6;6
5564;Pabiručiai;Žiogelių;3355875364;Taip;0;1;0;1
5565;Pabiručiai;Žiogelių;7085036701;Taip;0;3;0;3
5566;Pabiručiai;Žiogelių;8736658575;Taip;0;2;0;2
5567;Pabiručiai;Žiogelių;1311650644;Taip;0;6;0;6
5568;Pabiručiai;Žiogelių;5480714322;Taip;0;1;1;2
5569;Pabiručiai;Žiogelių;3585198013;Taip;0;1;0;1
5570;Pabiručiai;Žiogelių;5311762824;Taip;12;0;1;13
5571;Pabiručiai;Žiogelių;1587905929;Taip;0;4;0;4
5572;Pabiručiai;Žiogelių;5761888906;Ne;7;7;0;14
5573;Pabiručiai;Žiogelių;4667769378;Taip;4;4;0;8
5574;Pabiručiai;Smalsiukai;2869383175;Taip;0;1;0;1
5575;Pabiručiai;Smalsiukai;9676561758;Taip;0;3;0;3
5576;Pabiručiai;Smalsiukai;7632969321;Ne;0;5;0;5
5577;Pabiručiai;Smalsiukai;7090116276;Taip;0;0;2;2
5578;Pabiručiai;Smalsiukai;3700401383;Taip;0;18;0;18
5579;Pabiručiai;Smalsiukai;4408666547;Taip;0;3;0;3
5580;Pabiručiai;Smalsiukai;9093137227;Taip;0;5;0;5
5581;Pabiručiai;Smalsiukai;6935913132;Ne;0;8;0;8
5582;Pabiručiai;Smalsiukai;1344711015;Taip;0;7;0;7
5583;Pabiručiai;Smalsiukai;7663581089;Taip;0;8;0;8
5584;Pabiručiai;Smalsiukai;7248314871;Taip;1;0;0;1
5585;Pabiručiai;Smalsiukai;9610623364;Taip;0;3;0;3
5586;Pabiručiai;Smalsiukai;8897462614;Taip;0;1;0;1
5587;Pabiručiai;Smalsiukai;2332338995;Ne;19;0;0;19
5588;Pabiručiai;Smalsiukai;4258226042;Ne;4;4;0;8
5589;Pabiručiai;Smalsiukai;3511851810;Taip;5;1;2;8
5590;Pabiručiai;Smalsiukai;6686039601;Taip;3;0;13;16
5591;Pabiručiai;Smalsiukai;5420231066;Taip;0;1;0;1
5592;Pabiručiai;Smalsiukai;8840885039;Taip;0;0;1;1
5593;Pabiručiai;Smalsiukai;2771891999;Taip;9;2;0;11
5594;Pabiručiai;Kiškučiai;3368607302;Taip;10;0;0;10
5595;Pabiručiai;Kiškučiai;9589005897;Taip;0;4;0;4
5596;Pabiručiai;Kiškučiai;6648966721;Taip;0;1;0;1
5597;Pabiručiai;Kiškučiai;9353062804;Taip;8;4;0;12
5598;Pabiručiai;Kiškučiai;1582754284;Taip;0;5;0;5
5599;Pabiručiai;Kiškučiai;4462744848;Ne;0;20;0;20
5600;Pabiručiai;Kiškučiai;5621183663;Taip;0;4;0;4
5601;Pabiručiai;Kiškučiai;9417138573;Taip;7;0;0;7
5602;Pabiručiai;Kiškučiai;2688728915;Taip;0;10;0;10
5603;Pabiručiai;Kiškučiai;5166525832;Taip;0;2;0;2
5604;Pabiručiai;Kiškučiai;1028312285;Taip;0;1;0;1
5605;Pabiručiai;Kiškučiai;5717534175;Taip;0;1;0;1
5606;Pabiručiai;Kiškučiai;3408518493;Taip;0;6;0;6
5607;Pabiručiai;Kiškučiai;7653129291;Taip;7;1;0;8
5608;Pabiručiai;Kiškučiai;7073230645;Taip;0;2;0;2
5609;Pabiručiai;Kiškučiai;8820585407;Taip;0;12;0;12
5610;Pabiručiai;Kiškučiai;7572077461;Taip;0;3;0;3
5611;Pabiručiai;"Pėledžiukai ";7457099536;Taip;0;3;0;3
5612;Pabiručiai;"Pėledžiukai ";77273870334;Taip;0;5;0;5
5613;Pabiručiai;"Pėledžiukai ";80756439543;Taip;3;0;4;7
5614;Pabiručiai;"Pėledžiukai ";75098378597;Taip;0;0;2;2
5615;Pabiručiai;"Pėledžiukai ";90849312010;Taip;2;1;0;3
5616;Pabiručiai;"Pėledžiukai ";6112244077;Taip;0;0;2;2
5617;Pabiručiai;"Pėledžiukai ";18356992277;Taip;0;7;0;7
5618;Pabiručiai;"Pėledžiukai ";28121667845;Taip;0;5;0;5
5619;Pabiručiai;"Pėledžiukai ";1591342751;Taip;0;3;0;3
5620;Pabiručiai;"Pėledžiukai ";1701727758;Taip;0;1;0;1
5621;Pabiručiai;"Pėledžiukai ";1078387167;Taip;0;4;0;4
5622;Pabiručiai;"Pėledžiukai ";3733576400;Taip;0;6;0;6
5623;Pabiručiai;"Pėledžiukai ";4568554097;Taip;0;6;1;7
5624;Pabiručiai;"Pėledžiukai ";34215100257;Taip;0;1;0;1
5625;Pabiručiai;"Pėledžiukai ";2944433375;Taip;2;1;0;3
5626;Pabiručiai;"Kodelčiūkai ";1819457592;Taip;0;6;0;6
5627;Pabiručiai;"Kodelčiūkai ";62923769489;Ne;0;4;0;4
5628;Pabiručiai;"Kodelčiūkai ";65267728282;Taip;0;0;5;5
5629;Pabiručiai;"Kodelčiūkai ";81307674221;Taip;0;0;3;3
5630;Pabiručiai;"Kodelčiūkai ";15948930587;Taip;0;6;3;9
5631;Pabiručiai;"Kodelčiūkai ";61144974706;Taip;0;0;1;1
5632;Pabiručiai;"Kodelčiūkai ";78798062773;Taip;0;2;0;2
5633;Pabiručiai;"Kodelčiūkai ";1901455947;Taip;0;3;0;3
5634;Pabiručiai;"Kodelčiūkai ";1718014001;Ne;0;8;0;8
5635;Pabiručiai;"Kodelčiūkai ";2143676810;Taip;0;1;0;1
5636;Pabiručiai;"Kodelčiūkai ";46251218463;Taip;0;5;0;5
5637;Pabiručiai;"Kodelčiūkai ";1029743585;Taip;4;0;1;5
5638;Pabiručiai;"Kodelčiūkai ";1236499374;Taip;3;2;0;5
5639;Pabiručiai;"Kodelčiūkai ";8344476830;Taip;0;5;0;5
5640;Pabiručiai;"Kodelčiūkai ";4634305371;Taip;0;13;0;13
5641;Pabiručiai;"Kodelčiūkai ";4901977623;Taip;0;6;0;6
5642;Pabiručiai;"Peliukų ";8268101318;Taip;10;2;0;12
5643;Pabiručiai;"Peliukų ";2343561322;Taip;5;0;0;5
5644;Pabiručiai;"Peliukų ";4317656984;Taip;5;0;0;5
5645;Pabiručiai;"Peliukų ";2147165934;Taip;3;0;2;5
5646;Pabiručiai;"Peliukų ";4785878572;Taip;0;3;0;3
5647;Pabiručiai;"Peliukų ";1971996148;Taip;0;1;0;1
5648;Pabiručiai;"Peliukų ";9790360371;Taip;0;0;2;2
5649;Pabiručiai;"Peliukų ";3674583662;Taip;11;0;0;11
5650;Pabiručiai;"Peliukų ";9890225918;Taip;19;0;0;19
5651;Pabiručiai;"Peliukų ";1206012259;Taip;0;9;0;9
5652;Pabiručiai;"Peliukų ";5950654594;Taip;0;5;0;5
5653;Pabiručiai;"Peliukų ";7385149524;Taip;10;3;0;13
5654;Pabiručiai;"Peliukų ";6678717039;Taip;9;0;0;9
5655;Pabiručiai;"Peliukų ";1099080685;Taip;5;5;0;10
5656;Pabiručiai;"Viščiukų ";6386335808;Taip;0;0;22;22
5657;Pabiručiai;"Viščiukų ";5913022147;Taip;9;0;3;12
5658;Pabiručiai;"Viščiukų ";4595458527;Taip;10;1;0;11
5659;Pabiručiai;"Viščiukų ";1234230729;Taip;9;0;0;9
5660;Pabiručiai;"Viščiukų ";8716879106;Taip;5;0;1;6
5661;Pabiručiai;"Viščiukų ";8149732126;Taip;8;0;3;11
5662;Pabiručiai;"Viščiukų ";9538339883;Taip;10;1;2;13
5663;Pabiručiai;"Viščiukų ";3748657353;Taip;18;0;0;18
5664;Pabiručiai;"Viščiukų ";2295503584;Ne;0;14;0;14
5665;Pabiručiai;"Viščiukų ";6209553290;Taip;12;0;0;12
5666;Pabiručiai;"Viščiukų ";9067653417;Taip;0;9;0;9
5667;Pabiručiai;"Viščiukų ";5247780866;Taip;10;0;0;10
5668;Pabiručiai;"Viščiukų ";3433419710;Taip;7;10;1;18
5669;Pabiručiai;"Viščiukų ";7289131864;Taip;0;10;0;10
5670;Pabiručiai;"Viščiukų ";9437700329;Taip;5;0;1;6
5671;Pabiručiai;"Viščiukų ";5010271037;Taip;3;1;0;4
5672;Pabiručiai;"Drugelių ";8179285338;Taip;0;7;0;7
5673;Pabiručiai;"Drugelių ";6697518151;Taip;10;1;0;11
5674;Pabiručiai;"Drugelių ";3497466298;Taip;7;6;0;13
5675;Pabiručiai;"Drugelių ";3224195892;Taip;0;13;0;13
5676;Pabiručiai;"Drugelių ";6289025538;Taip;0;16;0;16
5677;Pabiručiai;"Drugelių ";1049154287;Taip;15;3;0;18
5678;Pabiručiai;"Drugelių ";9878655387;Taip;5;0;0;5
5679;Pabiručiai;"Drugelių ";4333645528;Taip;0;9;0;9
5680;Pabiručiai;"Drugelių ";2596301235;Taip;9;1;0;10
5681;Pabiručiai;"Drugelių ";6014791534;Taip;11;0;1;12
5682;Pabiručiai;"Drugelių ";2812291058;Taip;13;0;0;13
5683;Pabiručiai;"Drugelių ";8668524776;Taip;0;6;0;6
5684;Pabiručiai;"Drugelių ";3531292373;Taip;0;3;0;3
5685;Pabiručiai;"Drugelių ";9790322329;Taip;10;0;0;10
5686;Pabiručiai;"Drugelių ";5704073222;Taip;0;8;0;8
5687;Pabiručiai;Žirniukų;3318387567;Ne;0;0;1;1
5688;Pabiručiai;Žirniukų;8624671999;Ne;8;0;0;8
5689;Pabiručiai;Žirniukų;7203091216;Taip;5;0;1;6
5690;Pabiručiai;Žirniukų;9834824219;Taip;4;9;0;13
5691;Pabiručiai;Žirniukų;2507088490;Taip;11;5;0;16
5692;Pabiručiai;Žirniukų;1683369842;Ne;2;0;0;2
5693;Pabiručiai;Žirniukų;9651695086;Taip;3;8;0;11
5694;Pabiručiai;Žirniukų;5899880680;Taip;22;0;0;22
5695;Pagrandukas;Saulytės;6915087488;Taip;3;12;0;15
5696;Pagrandukas;Saulytės;7605508460;Taip;0;5;0;5
5697;Pagrandukas;Saulytės;6349387692;Taip;4;2;0;6
5698;Pagrandukas;Saulytės;8186092469;Taip;0;3;0;3
5699;Pagrandukas;Saulytės;2934300533;Taip;0;32;0;32
5700;Pagrandukas;Saulytės;1548697124;Taip;3;11;0;14
5701;Pagrandukas;Saulytės;6711830251;Taip;0;10;0;10
5702;Pagrandukas;Saulytės;7146697128;Taip;6;1;0;7
5703;Pagrandukas;Saulytės;3157676207;Taip;0;14;0;14
5704;Pagrandukas;Saulytės;7511097160;Taip;3;29;0;32
5705;Pagrandukas;Saulytės;3783160018;Taip;0;1;3;4
5706;Pagrandukas;Saulytės;7454863899;Taip;2;2;0;4
5707;Pagrandukas;Saulytės;5560372136;Taip;3;0;0;3
5708;Pagrandukas;Saulytės;1766912463;Taip;0;7;0;7
5709;Pagrandukas;Saulytės;9849054467;Taip;0;6;0;6
5710;Pagrandukas;Saulytės;8024910647;Taip;10;1;0;11
5711;Pagrandukas;Zuikučiai;7435609306;Taip;1;0;2;3
5712;Pagrandukas;Zuikučiai;5903416384;Taip;7;0;0;7
5713;Pagrandukas;Zuikučiai;2439891231;Taip;0;2;7;9
5714;Pagrandukas;Zuikučiai;6710887776;Taip;0;2;7;9
5715;Pagrandukas;Zuikučiai;7665811353;Taip;0;6;3;9
5716;Pagrandukas;Zuikučiai;2212787835;Taip;8;1;0;9
5717;Pagrandukas;Zuikučiai;2711590019;Taip;0;8;0;8
5718;Pagrandukas;Zuikučiai;6449029299;Taip;0;3;0;3
5719;Pagrandukas;Zuikučiai;1054107640;Taip;0;8;0;8
5720;Pagrandukas;Zuikučiai;1885539883;Taip;0;0;1;1
5721;Pagrandukas;Zuikučiai;1795582354;Taip;0;1;0;1
5722;Pagrandukas;Zuikučiai;2822538227;Taip;0;0;4;4
5723;Pagrandukas;Zuikučiai;1587839122;Taip;13;0;0;13
5724;Pagrandukas;Zuikučiai;2101505576;Taip;0;4;4;8
5725;Pagrandukas;Zuikučiai;6765346578;Taip;0;0;3;3
5726;Pagrandukas;Zuikučiai;5922595170;Taip;5;10;0;15
5727;Pagrandukas;Zuikučiai;5030928303;Taip;6;8;0;14
5728;Pagrandukas;Zuikučiai;9139212151;Taip;0;0;9;9
5729;Pagrandukas;Zuikučiai;8643993939;Taip;0;4;6;10
5730;Pagrandukas;Zuikučiai;3494047045;Taip;0;13;0;13
5731;Pagrandukas;Boružėlių;3888408459;Taip;1;1;0;2
5732;Pagrandukas;Boružėlių;5752454925;Taip;0;2;4;6
5733;Pagrandukas;Boružėlių;3587941684;Taip;6;2;0;8
5734;Pagrandukas;Boružėlių;6304701617;Taip;7;0;0;7
5735;Pagrandukas;Boružėlių;3953844737;Taip;0;3;0;3
5736;Pagrandukas;Boružėlių;7271589727;Taip;5;0;0;5
5737;Pagrandukas;Boružėlių;5640182548;Taip;0;5;0;5
5738;Pagrandukas;Boružėlių;1403569615;Taip;0;2;1;3
5739;Pagrandukas;Boružėlių;5511396314;Taip;0;7;0;7
5740;Pagrandukas;Boružėlių;9651789217;Taip;4;10;0;14
5741;Pagrandukas;Boružėlių;6911951786;Taip;0;19;0;19
5742;Pagrandukas;Boružėlių;2926077771;Taip;4;3;0;7
5743;Pagrandukas;Boružėlių;5741021524;Taip;2;0;3;5
5744;Pagrandukas;Boružėlių;8286183393;Taip;0;1;0;1
5745;Pagrandukas;Boružėlių;2549704540;Taip;0;2;1;3
5746;Pagrandukas;Bitutės;1707429884;Taip;0;2;1;3
5747;Pagrandukas;Bitutės;6585880191;Taip;0;0;1;1
5748;Pagrandukas;Bitutės;57471531440;Taip;4;2;0;6
5749;Pagrandukas;Bitutės;8529974367;Taip;0;2;5;7
5750;Pagrandukas;Bitutės;4079711515;Taip;0;6;0;6
5751;Pagrandukas;Bitutės;8625382465;Taip;0;0;13;13
5752;Pagrandukas;Bitutės;9188382746;Taip;0;0;9;9
5753;Pagrandukas;Bitutės;4603185679;Taip;0;0;2;2
5754;Pagrandukas;Bitutės;5613442667;Taip;10;0;2;12
5755;Pagrandukas;Bitutės;1451503127;Taip;0;1;0;1
5756;Pagrandukas;Bitutės;2923517578;Taip;0;12;0;12
5757;Pagrandukas;Bitutės;3875062228;Taip;0;0;2;2
5758;Pagrandukas;Bitutės;4405567649;Taip;0;11;0;11
5759;Pagrandukas;Bitutės;1583104760;Taip;0;2;3;5
5760;Pagrandukas;Bitutės;5649084353;Taip;5;1;2;8
5761;Pagrandukas;Bitutės;8719834064;Taip;0;1;5;6
5762;Pagrandukas;Bitutės;5821945401;Taip;0;0;8;8
5763;Pagrandukas;Pelėdžiukai;1590309916;Taip;0;3;0;3
5764;Pagrandukas;Pelėdžiukai;1964310988;Taip;0;3;0;3
5765;Pagrandukas;Pelėdžiukai;44044284874;Taip;0;1;0;1
5766;Pagrandukas;Pelėdžiukai;2066377478;Taip;0;3;0;3
5767;Pagrandukas;Pelėdžiukai;4391887554;Taip;9;0;0;9
5768;Pagrandukas;Pelėdžiukai;33909593470;Taip;5;1;0;6
5769;Pagrandukas;Pelėdžiukai;5818020587;Taip;0;0;1;1
5770;Pagrandukas;Pelėdžiukai;93036151205;Taip;0;1;0;1
5771;Pagrandukas;Pelėdžiukai;2461803626;Taip;0;5;0;5
5772;Pagrandukas;Pelėdžiukai;1511562720;Taip;0;1;0;1
5773;Pagrandukas;Pelėdžiukai;51692261484;Taip;0;3;0;3
5774;Pagrandukas;Pelėdžiukai;4224512979;Taip;0;5;0;5
5775;Pagrandukas;Žvaigždutė;7876029445;Taip;0;1;0;1
5776;Pagrandukas;Žvaigždutė;4724383814;Taip;8;0;0;8
5777;Pagrandukas;Žvaigždutė;1376514473;Taip;0;3;0;3
5778;Pakalnutė;Pagrandukai;7475119623;Taip;0;1;0;1
5779;Pakalnutė;Pagrandukai;2015778005;Taip;0;0;3;3
5780;Pakalnutė;Pagrandukai;5275833872;Taip;22;0;0;22
5781;Pakalnutė;Pagrandukai;2296079246;Taip;4;0;0;4
5782;Pakalnutė;Pagrandukai;3070652992;Taip;0;3;0;3
5783;Pakalnutė;Pagrandukai;7477188659;Taip;0;1;0;1
5784;Pakalnutė;Pagrandukai;2642359967;Taip;2;1;0;3
5785;Pakalnutė;Pagrandukai;7417131378;Taip;22;0;0;22
5786;Pakalnutė;"Pelėdžiukų ";7110858765;Taip;0;6;0;6
5787;Pakalnutė;"Pelėdžiukų ";8553182620;Taip;0;0;9;9
5788;Pakalnutė;"Pelėdžiukų ";3840499737;Taip;1;0;1;2
5789;Pakalnutė;"Pelėdžiukų ";4523766424;Taip;2;1;5;8
5790;Pakalnutė;"Pelėdžiukų ";7151877991;Taip;0;3;6;9
5791;Pakalnutė;"Pelėdžiukų ";2992768162;Taip;0;14;0;14
5792;Pakalnutė;"Pelėdžiukų ";9505524183;Taip;0;0;1;1
5793;Pakalnutė;"Pelėdžiukų ";8823232039;Taip;0;1;0;1
5794;Pakalnutė;"Pelėdžiukų ";7325137583;Taip;0;1;0;1
5795;Pakalnutė;"Pelėdžiukų ";1330092247;Taip;8;7;7;22
5796;Pakalnutė;"Pelėdžiukų ";3267680599;Ne;0;3;0;3
5797;Pakalnutė;"Pelėdžiukų ";4452372238;Taip;0;0;6;6
5798;Pakalnutė;Ežiukai;5058727058;Taip;4;0;0;4
5799;Pakalnutė;Ežiukai;1070172991;Taip;0;0;2;2
5800;Pakalnutė;Ežiukai;9323200833;Taip;4;0;0;4
5801;Pakalnutė;Ežiukai;9781993614;Taip;9;0;1;10
5802;Pakalnutė;Ežiukai;9256219647;Taip;4;0;0;4
5803;Pakalnutė;Ežiukai;7853479591;Taip;0;0;5;5
5804;Pakalnutė;Ežiukai;6029905101;Taip;3;0;0;3
5805;Pakalnutė;Ežiukai;7734657452;Taip;3;6;1;10
5806;Pakalnutė;Ežiukai;8081932074;Taip;0;0;1;1
5807;Pakalnutė;Ežiukai;9706455707;Taip;9;0;0;9
5808;Pakalnutė;Ežiukai;7881545979;Ne;0;0;2;2
5809;Pakalnutė;Ežiukai;8080989574;Taip;0;0;2;2
5810;Pakalnutė;Ežiukai;5911381706;Taip;8;1;0;9
5811;Pakalnutė;Ežiukai;2755412687;Taip;7;0;0;7
5812;Pakalnutė;Skruzdėliukų;3583094831;Taip;0;3;0;3
5813;Pakalnutė;Skruzdėliukų;4033813807;Taip;19;0;0;19
5814;Pakalnutė;Skruzdėliukų;5409476517;Taip;0;12;0;12
5815;Pakalnutė;Skruzdėliukų;7105369111;Taip;3;0;0;3
5816;Pakalnutė;Skruzdėliukų;1195872320;Taip;12;0;0;12
5817;Pakalnutė;Skruzdėliukų;4423348418;Taip;0;7;0;7
5818;Pakalnutė;Skruzdėliukų;9806590495;Taip;7;0;0;7
5819;Pakalnutė;Skruzdėliukų;5619262190;Taip;14;0;0;14
5820;Pakalnutė;Skruzdėliukų;9681515221;Taip;0;1;0;1
5821;Pakalnutė;Skruzdėliukų;8496839980;Ne;3;0;0;3
5822;Pakalnutė;Bitučių;8461220770;Ne;0;0;5;5
5823;Pakalnutė;Bitučių;2367683002;Taip;6;0;0;6
5824;Pakalnutė;Bitučių;2765220889;Taip;10;2;0;12
5825;Pakalnutė;Bitučių;5532458706;Taip;0;13;0;13
5826;Pakalnutė;Bitučių;7526989580;Taip;2;0;1;3
5827;Pakalnutė;Bitučių;5941955322;Taip;3;0;2;5
5828;Pakalnutė;Bitučių;3306334576;Taip;3;0;1;4
5829;Pakalnutė;Bitučių;2095540372;Taip;0;8;0;8
5830;Pakalnutė;Bitučių;5342592825;Taip;0;3;0;3
5831;Pakalnutė;Bitučių;2932205226;Taip;0;0;1;1
5832;Pakalnutė;Bitučių;5464143742;Taip;8;0;0;8
5833;Pakalnutė;Bitučių;6351193702;Taip;0;1;0;1
5834;Pakalnutė;Bitučių;3965390135;Taip;0;0;3;3
5835;Pakalnutė;Bitučių;5355198213;Taip;8;0;0;8
5836;Pakalnutė;Boružiukų;6798939288;Taip;0;4;1;5
5837;Pakalnutė;Boružiukų;7357431226;Taip;3;5;0;8
5838;Pakalnutė;Boružiukų;5039000154;Taip;0;2;0;2
5839;Pakalnutė;Boružiukų;2835611316;Taip;0;4;0;4
5840;Pakalnutė;Boružiukų;5134342817;Taip;0;13;8;21
5841;Pakalnutė;Boružiukų;4950195858;Taip;3;0;2;5
5842;Pakalnutė;Boružiukų;6557165567;Taip;0;0;2;2
5843;Pakalnutė;Boružiukų;3677709759;Taip;4;0;2;6
5844;Pakalnutė;Boružiukų;2597900983;Taip;0;2;0;2
5845;Pakalnutė;Boružiukų;2062721289;Taip;0;1;0;1
5846;Pakalnutė;Boružiukų;1340022702;Taip;20;0;0;20
5847;Pakalnutė;Boružiukų;6228196996;Taip;13;0;0;13
5848;Pakalnutė;Meškiukų;4256222944;Taip;0;11;0;11
5849;Pakalnutė;Meškiukų;7659209862;Taip;19;0;0;19
5850;Pakalnutė;Meškiukų;2101821362;Taip;0;7;0;7
5851;Pakalnutė;Meškiukų;4313652059;Taip;4;8;0;12
5852;Pakalnutė;Meškiukų;7084798190;Taip;0;11;0;11
5853;Pakalnutė;Meškiukų;3693337607;Taip;0;2;0;2
5854;Pakalnutė;Meškiukų;2923698853;Taip;12;6;0;18
5855;Pakalnutė;Meškiukų;1369906621;Taip;0;5;2;7
5856;Pakalnutė;Nykštukai;6769352325;Taip;0;1;0;1
5857;Pakalnutė;Nykštukai;72137985328;Taip;0;5;0;5
5858;Pakalnutė;Nykštukai;11183301096;Taip;2;1;0;3
5859;Pakalnutė;Nykštukai;19773872429;Taip;4;0;3;7
5860;Pakalnutė;Nykštukai;7389600659;Taip;0;0;2;2
5861;Pakalnutė;Nykštukai;5309195407;Taip;0;4;0;4
5862;Pakalnutė;Nykštukai;1849396954;Taip;0;0;1;1
5863;Pakalnutė;Nykštukai;76382908561;Taip;0;0;1;1
5864;Pakalnutė;Nykštukai;33667858388;Taip;0;5;0;5
5865;Pakalnutė;Nykštukai;2815093249;Taip;0;1;0;1
5866;Pakalnutė;Nykštukai;1372722843;Taip;0;6;0;6
5867;Pakalnutė;Nykštukai;61712002384;Taip;0;7;0;7
5868;Pakalnutė;Nykštukai;9647325689;Taip;0;1;0;1
5869;Pakalnutė;Nykštukai;2051737273;Taip;0;1;0;1
5870;Pakalnutė;Nykštukai;2075865543;Taip;0;2;0;2
5871;Pakalnutė;Nykštukai;6771510589;Taip;0;11;0;11
5872;Pakalnutė;Nykštukai;58670351468;Taip;0;0;1;1
5873;Pakalnutė;Nykštukai;4046820545;Taip;0;2;0;2
5874;Pakalnutė;Nykštukai;5102345686;Taip;0;0;5;5
5875;Pakalnutė;"Zuikučių ";3609982613;Taip;0;4;0;4
5876;Pakalnutė;"Zuikučių ";5958653847;Taip;0;1;1;2
5877;Pakalnutė;"Zuikučių ";2159430356;Ne;0;7;2;9
5878;Pakalnutė;"Zuikučių ";1583462733;Taip;0;0;5;5
5879;Pakalnutė;"Zuikučių ";8813262660;Taip;9;0;0;9
5880;Pakalnutė;"Zuikučių ";2002555659;Taip;2;0;1;3
5881;Pakalnutė;"Zuikučių ";4681267749;Taip;0;8;0;8
5882;Pakalnutė;"Zuikučių ";6884488772;Ne;4;1;0;5
5883;Pakalnutė;"Drugelių ";5441477374;Ne;0;0;1;1
5884;Pakalnutė;"Drugelių ";7369661890;Taip;9;0;3;12
5885;Pakalnutė;"Drugelių ";7766653114;Taip;0;13;0;13
5886;Pakalnutė;"Drugelių ";7709684372;Taip;3;2;1;6
5887;Pakalnutė;"Drugelių ";9620000116;Taip;0;0;1;1
5888;Pakalnutė;"Drugelių ";5502444590;Taip;11;0;0;11
5889;Pakalnutė;"Drugelių ";3730712580;Taip;10;0;0;10
5890;Pakalnutė;"Drugelių ";7805758264;Taip;0;1;2;3
5891;Pakalnutė;"Drugelių ";9461133636;Taip;8;0;1;9
5892;Pakalnutė;"Drugelių ";4220406978;Taip;0;0;2;2
5893;Pakalnutė;"Drugelių ";5069038636;Taip;4;0;5;9
5894;Pakalnutė;"Drugelių ";7047587606;Taip;7;8;0;15
5895;Pakalnutė;"Drugelių ";2653667596;Taip;0;0;1;1
5896;Pakalnutė;"Drugelių ";2026242407;Ne;0;0;6;6
5897;Pakalnutė;Žvirbliukų;7421275778;Taip;0;0;3;3
5898;Pakalnutė;Žvirbliukų;8329725085;Taip;0;0;2;2
5899;Pakalnutė;Žvirbliukų;8010667913;Taip;20;0;0;20
5900;Pakalnutė;Žvirbliukų;1662773049;Taip;14;0;0;14
5901;Pakalnutė;Žvirbliukų;3764854654;Taip;0;0;5;5
5902;Pakalnutė;Žvirbliukų;5531209454;Taip;0;0;4;4
5903;Pakalnutė;Žvirbliukų;3342793992;Taip;0;0;1;1
5904;Pakalnutė;Žvirbliukų;7258417347;Taip;22;0;0;22
5905;Pakalnutė;Žvirbliukų;4961361687;Taip;0;0;5;5
5906;Pakalnutė;Žvirbliukų;5878352514;Taip;10;0;0;10
5907;Pakalnutė;Žvirbliukų;5685361033;Taip;20;0;0;20
5908;Pakalnutė;Žvirbliukų;7782295402;Taip;0;10;0;10
5909;Pakalnutė;Žvirbliukų;9627134967;Taip;0;0;6;6
5910;Pakalnutė;Žvirbliukų;7547661599;Taip;15;0;0;15
5911;Panerių;Rūtelė;6227583229;Taip;0;0;4;4
5912;Panerių;Rūtelė;18963190527;Taip;0;0;1;1
5913;Panerių;Rūtelė;4689913361;Taip;0;0;14;14
5914;Panerių;Rūtelė;9604335101;Taip;11;0;7;18
5915;Panerių;Rūtelė;2571561865;Taip;0;4;0;4
5916;Panerių;Rūtelė;6908487075;Taip;0;0;9;9
5917;Panerių;Rūtelė;2608386063;Ne;0;0;13;13
5918;Panerių;Rūtelė;1066011221;Ne;0;0;12;12
5919;Panerių;Rūtelė;2189532651;Taip;0;0;1;1
5920;Panerių;Rūtelė;3346395516;Taip;0;0;1;1
5921;Panerių;Rūtelė;7805429137;Taip;0;0;3;3
5922;Panerių;Rūtelė;9268618414;Taip;0;0;1;1
5923;Panerių;Rūtelė;6411372006;Taip;0;15;0;15
5924;Panerių;Rūtelė;1419817211;Ne;0;1;0;1
5925;Panerių;Gėlytės;3913395809;Ne;0;0;7;7
5926;Panerių;Gėlytės;9631684972;Taip;0;0;1;1
5927;Panerių;Gėlytės;3190117304;Taip;0;7;0;7
5928;Panerių;Gėlytės;8693113275;Taip;13;0;1;14
5929;Panerių;Gėlytės;6468190149;Taip;0;0;2;2
5930;Panerių;Gėlytės;9506008651;Taip;0;0;11;11
5931;Panerių;Gėlytės;9630302749;Taip;13;0;1;14
5932;Panerių;Gėlytės;1339256258;Taip;4;0;0;4
5933;Panerių;Gėlytės;8109366029;Ne;0;0;5;5
5934;Panerių;Gėlytės;2235123048;Taip;3;0;2;5
5935;Panerių;Gėlytės;5861312413;Taip;0;3;0;3
5936;Panerių;Gėlytės;9729731866;Taip;0;1;0;1
5937;Panerių;Gėlytės;6583134855;Taip;0;0;1;1
5938;Panerių;Gėlytės;3948776877;Taip;5;0;7;12
5939;Panerių;Gėlytės;2751334281;Taip;0;0;1;1
5940;Panerių;Boružė;8447920373;Taip;6;0;9;15
5941;Panerių;Boružė;6304387432;Taip;6;0;1;7
5942;Panerių;Boružė;2035822976;Taip;0;8;2;10
5943;Panerių;Boružė;9004310393;Taip;15;0;4;19
5944;Panerių;Boružė;1861881782;Ne;17;0;3;20
5945;Panerių;Boružė;7166964095;Taip;12;0;0;12
5946;Panerių;Boružė;3882802840;Taip;0;1;0;1
5947;Panerių;Boružė;1717129076;Ne;11;0;0;11
5948;Panerių;Boružė;9432171719;Taip;11;1;0;12
5949;Panerių;Boružė;3112608087;Taip;10;0;2;12
5950;Panerių;Boružė;5100874548;Taip;5;0;1;6
5951;Panerių;Boružė;9955613696;Taip;8;0;1;9
5952;Panerių;Boružė;4161189870;Taip;0;6;8;14
5953;Panerių;BORUŽĖ;9014387764;Taip;0;1;0;1
5954;Papartis;ZUIKUČIAI;1219140467;Taip;0;7;1;8
5955;Papartis;ZUIKUČIAI;1260151691;Taip;3;2;0;5
5956;Papartis;ZUIKUČIAI;7703070601;Taip;0;9;4;13
5957;Papartis;ZUIKUČIAI;7902130389;Taip;3;0;0;3
5958;Papartis;ZUIKUČIAI;4992305227;Taip;6;1;0;7
5959;Papartis;ZUIKUČIAI;4346817695;Taip;6;0;1;7
5960;Papartis;ZUIKUČIAI;2447926422;Taip;0;20;0;20
5961;Papartis;ZUIKUČIAI;3182457453;Taip;22;0;0;22
5962;Papartis;ZUIKUČIAI;8952917454;Ne;0;0;10;10
5963;Papartis;ZUIKUČIAI;5410369044;Ne;0;2;0;2
5964;Papartis;ZUIKUČIAI;6126912448;Taip;0;8;0;8
5965;Papartis;ZUIKUČIAI;5675537250;Taip;0;8;0;8
5966;Papartis;ZUIKUČIAI;1065128993;Taip;0;8;3;11
5967;Papartis;ZUIKUČIAI;1527263538;Taip;0;7;0;7
5968;Papartis;ZUIKUČIAI;72182866449;Taip;0;0;1;1
5969;Papartis;DRUGELIAI;4508053349;Taip;0;8;0;8
5970;Papartis;DRUGELIAI;7387281720;Taip;0;1;0;1
5971;Papartis;DRUGELIAI;3243869451;Taip;0;2;0;2
5972;Papartis;DRUGELIAI;2778629398;Taip;0;0;9;9
5973;Papartis;DRUGELIAI;3475745012;Taip;3;0;5;8
5974;Papartis;DRUGELIAI;2535412635;Taip;0;0;2;2
5975;Papartis;DRUGELIAI;6797687614;Taip;0;0;2;2
5976;Papartis;DRUGELIAI;9719465384;Taip;5;3;0;8
5977;Papartis;DRUGELIAI;8148483438;Taip;0;0;3;3
5978;Papartis;DRUGELIAI;5265293240;Taip;11;1;3;15
5979;Papartis;DRUGELIAI;9134335737;Taip;4;1;8;13
5980;Papartis;DRUGELIAI;1836914270;Taip;0;0;5;5
5981;Papartis;DRUGELIAI;4935694347;Taip;0;2;4;6
5982;Papartis;DRUGELIAI;1672028156;Taip;0;1;1;2
5983;Papartis;DRUGELIAI;4634683589;Taip;13;5;0;18
5984;Papartis;DRUGELIAI;3267416367;Taip;0;3;0;3
5985;Papartis;DRUGELIAI;1205854439;Taip;6;0;0;6
5986;Papartis;DRUGELIAI;7067369268;Taip;0;0;2;2
5987;Papartis;DRUGELIAI;42803013754;Taip;0;7;0;7
5988;Papartis;DRUGELIAI;3408756311;Taip;0;0;14;14
5989;Papartis;DRUGELIAI;7102350653;Taip;0;1;0;1
5990;Papartis;DRUGELIAI;3295731801;Ne;7;4;0;11
5991;Papartis;ŽVIRBLIUKAI;50090482473;Taip;8;0;0;8
5992;Papartis;ŽVIRBLIUKAI;1246604915;Taip;0;1;4;5
5993;Papartis;ŽVIRBLIUKAI;67966766974;Taip;0;1;0;1
5994;Papartis;ŽVIRBLIUKAI;95139517078;Taip;0;3;0;3
5995;Papartis;ŽVIRBLIUKAI;50658624766;Taip;1;2;0;3
5996;Papartis;ŽVIRBLIUKAI;18124337938;Taip;0;9;0;9
5997;Papartis;ŽVIRBLIUKAI;30982681803;Taip;0;5;0;5
5998;Papartis;ŽVIRBLIUKAI;55573140983;Taip;0;1;0;1
5999;Papartis;ŽVIRBLIUKAI;48182233276;Taip;0;1;0;1
6000;Papartis;ŽVIRBLIUKAI;23218268605;Ne;4;1;0;5
6001;Papartis;ŽVIRBLIUKAI;10078570352;Taip;0;1;1;2
6002;Papartis;ŽVIRBLIUKAI;21963930874;Taip;0;4;0;4
6003;Papartis;ŽVIRBLIUKAI;15207322802;Taip;1;6;0;7
6004;Papartis;ŽVIRBLIUKAI;29789530287;Taip;9;0;1;10
6005;Papartis;ŽVIRBLIUKAI;38896771062;Taip;0;8;1;9
6006;Papartis;ŽVIRBLIUKAI;1703232380;Taip;0;0;2;2
6007;Papartis;ŽVIRBLIUKAI;44833872631;Taip;3;0;0;3
6008;Papartis;ŽVIRBLIUKAI;7590170146;Taip;0;1;1;2
6009;Papartis;ŽVIRBLIUKAI;2412700197;Taip;9;0;0;9
6010;Papartis;PELĖDŽIUKAI;2067304804;Taip;4;0;2;6
6011;Papartis;PELĖDŽIUKAI;1322826573;Taip;0;6;1;7
6012;Papartis;PELĖDŽIUKAI;4216398263;Taip;0;4;1;5
6013;Papartis;PELĖDŽIUKAI;2398385967;Taip;0;1;0;1
6014;Papartis;PELĖDŽIUKAI;68478260102;Ne;0;4;0;4
6015;Papartis;PELĖDŽIUKAI;89525856173;Taip;0;4;0;4
6016;Papartis;PELĖDŽIUKAI;2092191603;Taip;0;2;0;2
6017;Papartis;PELĖDŽIUKAI;88418552221;Taip;0;3;0;3
6018;Papartis;PELĖDŽIUKAI;63087155760;Taip;0;1;1;2
6019;Papartis;PELĖDŽIUKAI;74972133115;Taip;0;0;1;1
6020;Papartis;PELĖDŽIUKAI;7845277151;Taip;0;6;0;6
6021;Papartis;PELĖDŽIUKAI;86735273559;Taip;0;1;0;1
6022;Papartis;PELĖDŽIUKAI;53040207725;Taip;1;0;12;13
6023;Papartis;PELĖDŽIUKAI;12406782910;Taip;6;0;0;6
6024;Papartis;PELĖDŽIUKAI;51588027659;Taip;0;3;0;3
6025;Papartis;PELĖDŽIUKAI;3630377970;Taip;5;0;0;5
6026;Papartis;PELĖDŽIUKAI;7606939822;Taip;0;1;1;2
6027;Papartis;PELĖDŽIUKAI;22570313128;Taip;0;8;1;9
6028;Papartis;SAULUTĖS;2669085057;Ne;13;0;9;22
6029;Papartis;SAULUTĖS;6585372451;Taip;8;0;2;10
6030;Papartis;SAULUTĖS;6734567714;Taip;0;0;1;1
6031;Papartis;SAULUTĖS;4570512336;Taip;4;8;2;14
6032;Papartis;SAULUTĖS;3539507686;Taip;8;0;0;8
6033;Papartis;SAULUTĖS;3595627659;Taip;1;0;0;1
6034;Papartis;SAULUTĖS;5070767260;Taip;0;0;2;2
6035;Papartis;SAULUTĖS;9380951144;Taip;0;10;0;10
6036;Papartis;SAULUTĖS;4016297254;Taip;22;0;0;22
6037;Papartis;SAULUTĖS;5323875279;Taip;0;5;0;5
6038;Papartis;SAULUTĖS;5465955537;Taip;13;5;0;18
6039;Papartis;SAULUTĖS;2812347963;Taip;0;1;0;1
6040;Papartis;SAULUTĖS;4597039190;Taip;10;0;0;10
6041;Papartis;SAULUTĖS;2077861244;Ne;0;0;15;15
6042;Papartis;SAULUTĖS;8420752169;Taip;0;0;2;2
6043;Papartis;SAULUTĖS;6346776139;Taip;5;0;2;7
6044;Papartis;GANDRIUKAI;4878190663;Taip;0;0;3;3
6045;Papartis;GANDRIUKAI;9900023788;Taip;0;1;0;1
6046;Papartis;GANDRIUKAI;8946678515;Taip;3;0;1;4
6047;Papartis;GANDRIUKAI;6883101103;Taip;4;0;1;5
6048;Papartis;GANDRIUKAI;2868899342;Taip;7;0;2;9
6049;Papartis;GANDRIUKAI;7768672610;Taip;0;1;1;2
6050;Papartis;GANDRIUKAI;9384670351;Taip;0;2;0;2
6051;Papartis;GANDRIUKAI;9968072478;Taip;0;1;1;2
6052;Papartis;GANDRIUKAI;2215846642;Taip;0;1;2;3
6053;Papartis;GANDRIUKAI;3320524073;Taip;0;0;2;2
6054;Papartis;GANDRIUKAI;9704930584;Taip;0;5;0;5
6055;Papartis;GANDRIUKAI;9804863902;Taip;0;4;0;4
6056;Papartis;GANDRIUKAI;9072635586;Ne;3;0;1;4
6057;Papartis;GANDRIUKAI;5732853976;Taip;4;9;0;13
6058;Papartis;GANDRIUKAI;7859096984;Taip;0;2;0;2
6059;Papartis;GANDRIUKAI;7252265838;Taip;0;4;0;4
6060;Papartis;GANDRIUKAI;4279580382;Taip;2;2;0;4
6061;Papartis;GANDRIUKAI;9978625382;Taip;15;1;0;16
6062;Papartis;GANDRIUKAI;5883751305;Ne;7;10;0;17
6063;Papartis;AITVARELIAI;8891856856;Taip;3;2;1;6
6064;Papartis;AITVARELIAI;6889782462;Taip;8;2;4;14
6065;Papartis;AITVARELIAI;5736456872;Taip;1;0;0;1
6066;Papartis;AITVARELIAI;3040269026;Taip;1;0;0;1
6067;Papartis;AITVARELIAI;8532558577;Taip;0;8;0;8
6068;Papartis;AITVARELIAI;4918854899;Taip;0;2;0;2
6069;Papartis;AITVARELIAI;5252947502;Taip;0;3;0;3
6070;Papartis;AITVARELIAI;1916222143;Taip;3;0;0;3
6071;Papartis;AITVARELIAI;7018190169;Taip;0;7;0;7
6072;Papartis;AITVARELIAI;7803854703;Taip;0;4;0;4
6073;Papartis;AITVARELIAI;4261270064;Taip;3;0;0;3
6074;Papartis;AITVARELIAI;6416605464;Taip;2;0;1;3
6075;Papartis;AITVARELIAI;1266338760;Ne;0;0;1;1
6076;Papartis;AITVARELIAI;7504793827;Taip;7;0;0;7
6077;Papartis;AITVARELIAI;7156767639;Taip;3;1;0;4
6078;Papartis;AITVARELIAI;8626682787;Taip;5;0;2;7
6079;Papartis;AITVARELIAI;3896803048;Taip;0;0;7;7
6080;Papartis;AITVARELIAI;4138926711;Taip;0;1;0;1
6081;Papartis;AITVARELIAI;8989172483;Taip;0;11;0;11
6082;Papartis;AITVARELIAI;9384475270;Taip;0;3;0;3
6083;Papartis;SMALSUČIAI;3054883426;Taip;5;1;0;6
6084;Papartis;SMALSUČIAI;1191546794;Taip;0;6;1;7
6085;Papartis;SMALSUČIAI;8447326505;Taip;0;1;0;1
6086;Papartis;SMALSUČIAI;1919362027;Taip;7;0;0;7
6087;Papartis;SMALSUČIAI;9375751990;Taip;0;13;0;13
6088;Papartis;SMALSUČIAI;5786648402;Taip;0;3;0;3
6089;Papartis;SMALSUČIAI;5776038830;Taip;1;13;0;14
6090;Papartis;SMALSUČIAI;9358310527;Taip;0;9;0;9
6091;Papartis;SMALSUČIAI;4906248064;Taip;0;6;0;6
6092;Papartis;SMALSUČIAI;4640068595;Taip;2;0;1;3
6093;Papartis;SMALSUČIAI;5579899922;Taip;4;1;0;5
6094;Papartis;SMALSUČIAI;8874222586;Taip;4;0;0;4
6095;Papartis;SMALSUČIAI;8958880558;Taip;2;3;0;5
6096;Papartis;SMALSUČIAI;5796928317;Taip;0;6;0;6
6097;Papartis;SMALSUČIAI;5363926529;Taip;0;8;0;8
6098;Papartis;SMALSUČIAI;2446379598;Taip;0;10;0;10
6099;Papartis;SMALSUČIAI;7619963429;Taip;0;1;0;1
6100;Papartis;SMALSUČIAI;4380030213;Taip;11;0;0;11
6101;Papartis;SMALSUČIAI;5430993785;Taip;0;1;0;1
6102;Papartis;"ŽIRNIUKAI ";5886199823;Taip;0;0;1;1
6103;Papartis;"ŽIRNIUKAI ";8897061283;Taip;3;0;0;3
6104;Papartis;"ŽIRNIUKAI ";3310893254;Taip;3;0;0;3
6105;Papartis;"ŽIRNIUKAI ";1073755384;Taip;7;0;2;9
6106;Papartis;"ŽIRNIUKAI ";7647225316;Taip;8;0;1;9
6107;Papartis;"ŽIRNIUKAI ";1210592579;Taip;3;0;0;3
6108;Papartis;"ŽIRNIUKAI ";1519815331;Taip;0;2;2;4
6109;Papartis;"ŽIRNIUKAI ";4158525314;Taip;3;0;2;5
6110;Papartis;"ŽIRNIUKAI ";4978398085;Taip;3;13;5;21
6111;Papartis;"ŽIRNIUKAI ";9746397380;Taip;0;0;1;1
6112;Papartis;"ŽIRNIUKAI ";4952279543;Taip;0;2;0;2
6113;Papartis;"ŽIRNIUKAI ";5276806556;Taip;9;0;0;9
6114;Papartis;"ŽIRNIUKAI ";7617558492;Taip;3;0;5;8
6115;Papartis;"ŽIRNIUKAI ";1267981238;Taip;0;15;7;22
6116;Papartis;"ŽIRNIUKAI ";2772758899;Taip;3;0;3;6
6117;Papartis;"ŽIRNIUKAI ";1183123161;Taip;13;0;1;14
6118;Papartis;"ŽIRNIUKAI ";1150772988;Ne;0;10;7;17
6119;Papartis;BORUŽĖLĖS;6136213985;Taip;4;0;0;4
6120;Papartis;BORUŽĖLĖS;7107692314;Taip;4;0;0;4
6121;Papartis;BORUŽĖLĖS;6615368741;Taip;22;0;0;22
6122;Papartis;BORUŽĖLĖS;1722192450;Taip;13;1;0;14
6123;Papartis;BORUŽĖLĖS;8277830926;Taip;6;0;0;6
6124;Papartis;BORUŽĖLĖS;3576856223;Taip;0;8;0;8
6125;Papartis;BORUŽĖLĖS;7492923318;Taip;7;0;0;7
6126;Papartis;BORUŽĖLĖS;1759982543;Taip;0;5;0;5
6127;Papartis;BORUŽĖLĖS;1157298413;Taip;6;0;0;6
6128;Papartis;BORUŽĖLĖS;4689046394;Taip;2;0;0;2
6129;Papartis;BORUŽĖLĖS;1159418157;Taip;8;1;0;9
6130;Papartis;BORUŽĖLĖS;3490370261;Taip;20;0;0;20
6131;Papartis;BORUŽĖLĖS;7298032812;Taip;14;0;1;15
6132;Papartis;BORUŽĖLĖS;3107245976;Ne;4;0;0;4
6133;Papartis;BORUŽĖLĖS;1566259150;Ne;15;0;1;16
6134;Papartis;BORUŽĖLĖS;1352401881;Taip;0;2;0;2
6135;Papartis;BORUŽĖLĖS;9518392031;Taip;12;0;0;12
6136;Papartis;VARPELIAI;8782882575;Taip;0;3;0;3
6137;Papartis;VARPELIAI;2824078830;Taip;2;0;1;3
6138;Papartis;VARPELIAI;4778327620;Taip;15;1;0;16
6139;Papartis;VARPELIAI;8005876431;Taip;13;0;0;13
6140;Papartis;VARPELIAI;7486667034;Taip;9;0;0;9
6141;Papartis;VARPELIAI;7742769931;Taip;7;0;1;8
6142;Papartis;VARPELIAI;2432516496;Taip;22;0;0;22
6143;Papartis;VARPELIAI;7384518191;Taip;0;4;1;5
6144;Papartis;VARPELIAI;1405767603;Taip;0;5;8;13
6145;Papartis;VARPELIAI;7331682622;Taip;3;0;5;8
6146;Papartis;VARPELIAI;6435625940;Taip;0;1;5;6
6147;Papartis;VARPELIAI;1874865061;Taip;6;0;9;15
6148;Papartis;VARPELIAI;3411472740;Taip;20;0;0;20
6149;Papartis;VARPELIAI;6664178454;Taip;1;3;1;5
6150;Papartis;VARPELIAI;8305560946;Ne;3;0;2;5
6151;Papartis;VARPELIAI;7187797639;Taip;2;3;0;5
6152;Papartis;VARPELIAI;3209105694;Taip;3;0;0;3
6153;Papartis;NYKŠTUKAI;1566011843;Taip;7;0;1;8
6154;Papartis;NYKŠTUKAI;5652769035;Taip;7;0;0;7
6155;Papartis;NYKŠTUKAI;5942160584;Taip;0;0;7;7
6156;Papartis;NYKŠTUKAI;1680412204;Taip;8;0;0;8
6157;Papartis;NYKŠTUKAI;9285319899;Taip;0;0;3;3
6158;Papartis;NYKŠTUKAI;6949120693;Taip;0;8;0;8
6159;Papartis;NYKŠTUKAI;6794076631;Taip;8;2;0;10
6160;Papartis;NYKŠTUKAI;5608868738;Ne;0;5;0;5
6161;Papartis;NYKŠTUKAI;4203241118;Taip;0;1;0;1
6162;Papartis;NYKŠTUKAI;9939850340;Taip;0;2;0;2
6163;Papartis;NYKŠTUKAI;3324647852;Taip;7;8;0;15
6164;Papartis;NYKŠTUKAI;6423401656;Taip;2;0;0;2
6165;Papartis;NYKŠTUKAI;8932290803;Taip;0;4;0;4
6166;Papartis;NYKŠTUKAI;1559196767;Taip;4;9;2;15
6167;Papartis;NYKŠTUKAI;6360881137;Taip;8;1;0;9
6168;Papartis;NYKŠTUKAI;6941978169;Taip;4;5;0;9
6169;Papartis;NYKŠTUKAI;8768526171;Taip;19;3;0;22
6170;Papartis;NYKŠTUKAI;7080578299;Taip;14;8;0;22
6171;Pasaka;Drugelių;6794437566;Taip;6;0;1;7
6172;Pasaka;Drugelių;4071643754;Taip;0;13;0;13
6173;Pasaka;Drugelių;6893044575;Taip;0;12;0;12
6174;Pasaka;Drugelių;12951124853;Taip;0;2;0;2
6175;Pasaka;Drugelių;52135673503;Taip;0;1;0;1
6176;Pasaka;Drugelių;1188769609;Taip;0;0;3;3
6177;Pasaka;Drugelių;50319234551;Taip;11;0;0;11
6178;Pasaka;Drugelių;13944030346;Taip;0;1;0;1
6179;Pasaka;Drugelių;53523660848;Taip;0;2;0;2
6180;Pasaka;Drugelių;15051078156;Taip;6;0;0;6
6181;Pasaka;Drugelių;89376142045;Taip;0;2;0;2
6182;Pasaka;Drugelių;59491538033;Taip;0;0;3;3
6183;Pasaka;Drugelių;8122815158;Taip;6;1;0;7
6184;Pasaka;Drugelių;1268530885;Taip;5;1;0;6
6185;Pasaka;Drugelių;35718732394;Taip;0;2;0;2
6186;Pasaka;Drugelių;3150467744;Taip;6;0;1;7
6187;Pasaka;Nykštukų;91546084785;Taip;0;2;8;10
6188;Pasaka;Nykštukų;7040953491;Taip;0;2;5;7
6189;Pasaka;Nykštukų;7546205285;Taip;0;2;0;2
6190;Pasaka;Nykštukų;5687494160;Taip;10;0;0;10
6191;Pasaka;Nykštukų;3088081091;Taip;0;4;0;4
6192;Pasaka;Nykštukų;4773893970;Taip;9;1;0;10
6193;Pasaka;Nykštukų;5438303030;Taip;0;1;0;1
6194;Pasaka;Nykštukų;1300996831;Taip;0;2;0;2
6195;Pasaka;Nykštukų;1313576071;Taip;9;0;0;9
6196;Pasaka;Nykštukų;7455544922;Taip;8;2;0;10
6197;Pasaka;Nykštukų;5027755073;Taip;8;0;4;12
6198;Pasaka;Nykštukų;4082752808;Taip;6;0;1;7
6199;Pasaka;Nykštukų;9418332784;Taip;18;4;0;22
6200;Pasaka;Nykštukų;6788771605;Ne;0;1;0;1
6201;Pasaka;Nykštukų;5412931969;Taip;10;0;0;10
6202;Pasaka;Nykštukų;8963465320;Taip;10;2;7;19
6203;Pasaka;Nykštukų;1813068555;Taip;0;1;0;1
6204;Pasaka;Nykštukų;2621046003;Taip;0;1;0;1
6205;Pasaka;Nykštukų;3092993659;Taip;9;0;0;9
6206;Pasaka;Nykštukų;2797217440;Taip;0;4;0;4
6207;Pasaka;Montesori;81598865451;Taip;0;0;1;1
6208;Pasaka;Montesori;16974081144;Taip;0;0;1;1
6209;Pasaka;Montesori;8996941733;Taip;9;0;0;9
6210;Pasaka;Montesori;4608655313;Taip;0;0;3;3
6211;Pasaka;Montesori;5812041166;Taip;0;0;1;1
6212;Pasaka;Montesori;4305485747;Taip;0;0;2;2
6213;Pasaka;Montesori;79460661793;Taip;0;6;0;6
6214;Pasaka;Montesori;47140322803;Taip;0;0;2;2
6215;Pasaka;Montesori;7837662446;Taip;13;0;0;13
6216;Pasaka;Montesori;3047931231;Taip;3;0;0;3
6217;Pasaka;Montesori;5031538468;Taip;2;0;0;2
6218;Pasaka;Montesori;6625690696;Taip;5;0;0;5
6219;Pasaka;Montesori;4548601585;Taip;9;3;0;12
6220;Pasaka;Montesori;7887326763;Taip;5;0;1;6
6221;Pasaka;Montesori;4366930715;Taip;3;0;1;4
6222;Pasaka;Montesori;9850592463;Taip;7;0;0;7
6223;Pasaka;Montesori;2995831258;Taip;9;0;0;9
6224;Pasaka;Žirniukų;17931259433;Taip;0;4;3;7
6225;Pasaka;Žirniukų;9722435751;Taip;0;1;0;1
6226;Pasaka;Žirniukų;7648503006;Taip;0;2;0;2
6227;Pasaka;Žirniukų;2697014098;Taip;3;0;0;3
6228;Pasaka;Žirniukų;2018620389;Taip;0;2;1;3
6229;Pasaka;Žirniukų;6441884677;Taip;10;0;0;10
6230;Pasaka;Žirniukų;5651452381;Taip;10;1;0;11
6231;Pasaka;Žirniukų;2788679885;Taip;0;2;0;2
6232;Pasaka;Žirniukų;1565873178;Taip;2;2;1;5
6233;Pasaka;Žirniukų;79170702319;Taip;0;0;7;7
6234;Pasaka;Žirniukų;5973028582;Taip;0;5;3;8
6235;Pasaka;"Voveriukų ";3606141216;Taip;8;6;0;14
6236;Pasaka;"Voveriukų ";5217688848;Taip;6;6;0;12
6237;Pasaka;"Voveriukų ";8504575043;Taip;0;7;0;7
6238;Pasaka;"Voveriukų ";2854919649;Taip;0;0;1;1
6239;Pasaka;"Voveriukų ";1950145441;Taip;6;0;4;10
6240;Pasaka;"Voveriukų ";4466963221;Taip;8;2;0;10
6241;Pasaka;"Voveriukų ";4915357646;Taip;0;0;4;4
6242;Pasaka;"Voveriukų ";7176272684;Taip;9;3;0;12
6243;Pasaka;"Voveriukų ";9687385445;Taip;0;3;3;6
6244;Pasaka;"Voveriukų ";6684234474;Taip;6;0;0;6
6245;Pasaka;"Voveriukų ";9003508760;Taip;0;2;3;5
6246;Pasaka;"Voveriukų ";6925961600;Taip;0;1;0;1
6247;Pasaka;"Voveriukų ";8421404290;Taip;5;0;0;5
6248;Pasaka;"Voveriukų ";1745181416;Taip;3;0;2;5
6249;Pasaka;"Voveriukų ";7392667692;Taip;0;0;22;22
6250;Pasaka;"VALDOFRO 12";2141354232;Taip;0;9;0;9
6251;Pasaka;"VALDOFRO 12";8042135600;Taip;0;1;1;2
6252;Pasaka;"VALDOFRO 12";3367120837;Taip;0;0;9;9
6253;Pasaka;"VALDOFRO 12";7010681103;Taip;0;2;0;2
6254;Pasaka;"VALDOFRO 12";56766427323;Taip;0;0;2;2
6255;Pasaka;"VALDOFRO 12";2268625523;Taip;0;0;6;6
6256;Pasaka;"VALDOFRO 12";8976424908;Taip;0;0;2;2
6257;Pasaka;"VALDOFRO 12";8701112181;Taip;4;0;4;8
6258;Pasaka;"VALDOFRO 12";1305541319;Taip;0;0;8;8
6259;Pasaka;"VALDOFRO 12";7682903999;Taip;4;0;4;8
6260;Pasaka;"VALDOFRO 12";4325198579;Taip;0;0;1;1
6261;Pasaka;"VALDOFRO 12";6448940090;Taip;2;0;0;2
6262;Pasaka;"VALDOFRO 12";8411025450;Taip;0;0;1;1
6263;Pasaka;"VALDOFRO 12";1756831961;Taip;0;0;1;1
6264;Pasaka;"VALDOFRO 12";3840053722;Ne;0;10;0;10
6265;Pasaka;"VALDOFRO 12";8995205555;Taip;2;0;0;2
6266;Pasaka;"VALDOFRO 12";4548945364;Taip;0;0;5;5
6267;Pasaka;"VALDOFRO 12";4301573328;Taip;0;0;1;1
6268;Pasaka;"VALDOFRO 12";5244582148;Ne;4;0;0;4
6269;Pasaka;"VALDORFO 2";4752117533;Taip;0;3;0;3
6270;Pasaka;"VALDORFO 2";7950962252;Taip;0;0;2;2
6271;Pasaka;"VALDORFO 2";8590385693;Taip;0;14;4;18
6272;Pasaka;"VALDORFO 2";4620573687;Taip;0;3;0;3
6273;Pasaka;"VALDORFO 2";9462745431;Taip;0;14;4;18
6274;Pasaka;"VALDORFO 2";1799326151;Taip;0;0;5;5
6275;Pasaka;"VALDORFO 2";2273629510;Taip;0;0;5;5
6276;Pasaka;"VALDORFO 2";3778182691;Taip;0;3;0;3
6277;Pasaka;"VALDORFO 2";5742479853;Taip;0;0;1;1
6278;Pasaka;"VALDORFO 2";2963373430;Taip;0;5;0;5
6279;Pasaka;"VALDORFO 2";6497042042;Taip;3;0;1;4
6280;Pasaka;"VALDORFO 2";8822711006;Taip;0;0;4;4
6281;Pasaka;Gudručiai;1920564803;Taip;0;3;1;4
6282;Pasaka;Gudručiai;34897359060;Taip;0;0;1;1
6283;Pasaka;Gudručiai;62303770229;Taip;0;1;2;3
6284;Pasaka;Gudručiai;10055061537;Taip;0;0;4;4
6285;Pasaka;Gudručiai;9973758979;Taip;0;0;2;2
6286;Pasaka;Gudručiai;5021568651;Taip;4;0;1;5
6287;Pasaka;Gudručiai;1693530160;Taip;10;0;0;10
6288;Pasaka;Gudručiai;8615661704;Taip;0;1;0;1
6289;Pasaka;Gudručiai;4178679491;Taip;0;1;0;1
6290;Pasaka;Gudručiai;31896116591;Taip;0;0;5;5
6291;Pasaka;Gudručiai;23132755276;Taip;0;0;1;1
6292;Pasaka;Gudručiai;7082166681;Taip;0;0;1;1
6293;Pasaka;Gudručiai;51500606207;Taip;2;2;0;4
6294;Pasaka;Gudručiai;50456063454;Taip;0;1;1;2
6295;Pasaka;Gudručiai;56983167265;Taip;1;5;0;6
6296;Pasaka;Gudručiai;1630083619;Taip;0;2;2;4
6297;Pasaka;Gudručiai;2874308781;Taip;0;0;4;4
6298;Pasaka;Gudručiai;7694779970;Ne;0;4;4;8
6299;Pasaka;Bitelių;5351364328;Taip;15;0;0;15
6300;Pasaka;Bitelių;4635912654;Taip;15;0;0;15
6301;Pasaka;Bitelių;7248640367;Taip;0;5;0;5
6302;Pasaka;Bitelių;8277245475;Taip;0;0;4;4
6303;Pasaka;Bitelių;7103485358;Taip;0;0;1;1
6304;Pasaka;Bitelių;6868519179;Taip;0;3;0;3
6305;Pasaka;Bitelių;6759415053;Taip;0;3;0;3
6306;Pasaka;Bitelių;5723970763;Taip;4;1;0;5
6307;Pasaka;Bitelių;7685589423;Taip;7;2;0;9
6308;Pasaka;Bitelių;9737445077;Taip;0;2;0;2
6309;Pasaka;Bitelių;2638182985;Taip;5;1;0;6
6310;Pasaka;Bitelių;2293613528;Taip;0;18;0;18
6311;Pasaka;Bitelių;3367346582;Taip;5;0;3;8
6312;Pasaka;Bitelių;5371046207;Taip;8;0;0;8
6313;Pasaka;Bitelių;1335408890;Taip;6;1;0;7
6314;Pasaka;Bitelių;6139825302;Taip;0;4;0;4
6315;Pasaka;Bitelių;4970812899;Taip;3;0;0;3
6316;Pasaka;Bitelių;8873115041;Taip;10;0;0;10
6317;Pasaka;"Pabiručių ";3620395122;Taip;3;0;1;4
6318;Pasaka;"Pabiručių ";5689164477;Taip;4;0;2;6
6319;Pasaka;"Pabiručių ";4846146925;Taip;0;0;3;3
6320;Pasaka;"Pabiručių ";9770811826;Taip;0;0;3;3
6321;Pasaka;"Pabiručių ";6248810027;Taip;3;0;1;4
6322;Pasaka;"Pabiručių ";9136524816;Taip;0;0;5;5
6323;Pasaka;"Pabiručių ";2815348652;Taip;8;1;2;11
6324;Pasaka;"Pabiručių ";2422958320;Taip;7;0;2;9
6325;Pasaka;"Pabiručių ";9867183480;Taip;0;0;3;3
6326;Pasaka;"Pabiručių ";5230621839;Taip;0;0;1;1
6327;Pasaka;"Pabiručių ";9821858308;Taip;0;0;22;22
6328;Pasaka;"Pabiručių ";4770547514;Taip;10;0;0;10
6329;Pasaka;"Pabiručių ";7776247393;Taip;1;0;0;1
6330;Pasaka;"Pabiručių ";9471447977;Taip;5;0;1;6
6331;Pasaka;"Pabiručių ";7751618911;Taip;9;0;0;9
6332;Pasaka;Šnekučių;3709664132;Taip;8;0;0;8
6333;Pasaka;Šnekučių;1512874567;Taip;17;0;0;17
6334;Pasaka;Šnekučių;1793176485;Taip;0;2;0;2
6335;Pasaka;Šnekučių;4296539838;Taip;0;0;5;5
6336;Pasaka;Šnekučių;1590306118;Taip;8;2;0;10
6337;Pasaka;Šnekučių;6795580569;Taip;0;10;0;10
6338;Pasaka;Šnekučių;3240292756;Taip;0;18;0;18
6339;Pasaka;Šnekučių;4215568107;Taip;9;0;0;9
6340;Pasaka;Šnekučių;8365256755;Taip;6;0;0;6
6341;Pasaka;Šnekučių;1562771242;Taip;0;6;0;6
6342;Pasaka;Šnekučių;4816441219;Taip;4;0;7;11
6343;Pasaka;Šnekučių;1795497567;Taip;15;0;0;15
6344;Pasaka;Šnekučių;8347051587;Taip;0;1;0;1
6345;Pasaka;Šnekučių;8841669113;Taip;0;0;6;6
6346;Pasaka;Šnekučių;3854678845;Taip;1;0;2;3
6347;Pasaka;Šnekučių;3588073618;Taip;7;0;5;12
6348;Pasaka;Šnekučių;1194745876;Taip;0;0;2;2
6349;Pasaka;Šnekučių;1749821746;Taip;8;0;3;11
6350;Pasaka;Šnekučių;1723076060;Taip;5;0;2;7
6351;Pasaka;Šnekučių;8475365713;Taip;2;0;0;2
6352;Pasaka;Šnekučių;5656511105;Taip;3;14;0;17
6353;Pasaka;"VALDORFO 12";9065016148;Taip;0;0;1;1
6354;Paslaptis;Priešmokyklinė;1094068061;Taip;5;0;0;5
6355;Paslaptis;Priešmokyklinė;1195616749;Taip;3;1;2;6
6356;Paslaptis;Priešmokyklinė;8522925854;Taip;10;0;3;13
6357;Paslaptis;Priešmokyklinė;1868248793;Taip;13;1;1;15
6358;Paslaptis;Priešmokyklinė;3798754778;Taip;10;0;0;10
6359;Paslaptis;Priešmokyklinė;3093280943;Taip;5;1;0;6
6360;Paslaptis;Priešmokyklinė;2705751628;Taip;0;1;1;2
6361;Paslaptis;Priešmokyklinė;8280740387;Taip;6;1;1;8
6362;Paslaptis;Priešmokyklinė;2891547963;Taip;0;1;0;1
6363;Paslaptis;Priešmokyklinė;3415869190;Taip;5;1;6;12
6364;Paslaptis;Priešmokyklinė;1983773762;Taip;10;1;0;11
6365;Paslaptis;Priešmokyklinė;5557019619;Taip;3;1;0;4
6366;Paslaptis;Priešmokyklinė;1782398974;Taip;0;4;0;4
6367;Paslaptis;Priešmokyklinė;6375966771;Taip;0;2;2;4
6368;Paslaptis;Priešmokyklinė;8083478190;Taip;4;1;6;11
6369;Paslaptis;Priešmokyklinė;2089780119;Taip;0;1;12;13
6370;Paslaptis;Priešmokyklinė;1029321312;Taip;5;0;0;5
6371;Paslaptis;Priešmokyklinė;2879752620;Taip;0;13;0;13
6372;Paslaptis;Priešmokyklinė;3243226933;Taip;11;1;3;15
6373;Paslaptis;Priešmokyklinė;2693910134;Ne;0;1;1;2
6374;Paslaptis;Priešmokyklinė;8146824196;Taip;0;1;1;2
6375;Paslaptis;"Darželio mišraus amžiaus grupė";6131831325;Ne;9;1;0;10
6376;Paslaptis;"Darželio mišraus amžiaus grupė";5852939221;Taip;3;3;0;6
6377;Paslaptis;"Darželio mišraus amžiaus grupė";3104525540;Taip;12;0;0;12
6378;Paslaptis;"Darželio mišraus amžiaus grupė";8895770223;Taip;0;1;0;1
6379;Paslaptis;"Darželio mišraus amžiaus grupė";5206529350;Taip;13;0;0;13
6380;Paslaptis;"Darželio mišraus amžiaus grupė";3398729758;Taip;0;13;0;13
6381;Paslaptis;"Darželio mišraus amžiaus grupė";8296575784;Ne;3;0;0;3
6382;Paslaptis;"Darželio mišraus amžiaus grupė";9100003209;Ne;14;0;0;14
6383;Paslaptis;"Darželio mišraus amžiaus grupė";3984799090;Taip;5;0;0;5
6384;Paslaptis;"Darželio mišraus amžiaus grupė";5886364670;Taip;4;2;0;6
6385;Paslaptis;"Darželio mišraus amžiaus grupė";5406800599;Taip;4;4;0;8
6386;Paslaptis;"Darželio mišraus amžiaus grupė";2675089401;Taip;7;0;0;7
6387;Paslaptis;"Darželio mišraus amžiaus grupė";1557783684;Taip;6;5;0;11
6388;Paslaptis;"Darželio mišraus amžiaus grupė";5456011928;Taip;0;4;0;4
6389;Paslaptis;"Darželio mišraus amžiaus grupė";8717111488;Taip;5;3;0;8
6390;Paslaptis;"Darželio mišraus amžiaus grupė";5756338103;Taip;0;1;2;3
6391;Paslaptis;"Darželio mišraus amžiaus grupė";5646806136;Taip;1;1;0;2
6392;Paslaptis;"Darželio mišraus amžiaus grupė";6098345982;Taip;8;0;0;8
6393;Paslaptis;"Darželio mišraus amžiaus grupė";4810686225;Taip;0;1;0;1
6394;Paslaptis;"Darželio mišraus amžiaus grupė";1754621741;Taip;19;0;0;19
6395;Paslaptis;"Darželio mišraus amžiaus grupė";7638521198;Taip;9;0;0;9
6396;Paslaptis;"NAUJA (LOPŠELIS)";6686352764;Taip;3;0;13;16
6397;Paslaptis;"NAUJA (LOPŠELIS)";4130010071;Taip;0;10;0;10
6398;Paslaptis;"NAUJA (LOPŠELIS)";8453213193;Taip;2;0;0;2
6399;Paslaptis;"NAUJA (LOPŠELIS)";8909545951;Taip;1;1;0;2
6400;Paslaptis;"NAUJA (LOPŠELIS)";2105441745;Taip;5;1;0;6
6401;Paslaptis;"NAUJA (LOPŠELIS)";6513238386;Taip;0;0;2;2
6402;Paslaptis;"NAUJA (LOPŠELIS)";3963816472;Taip;0;3;0;3
6403;Paslaptis;"NAUJA (LOPŠELIS)";9497654214;Taip;3;0;1;4
6404;Paslaptis;"NAUJA (LOPŠELIS)";6860366087;Taip;4;0;0;4
6405;Paslaptis;"NAUJA (LOPŠELIS)";9929877115;Taip;9;1;0;10
6406;Paslaptis;"NAUJA (LOPŠELIS)";3572102816;Taip;14;0;0;14
6407;Paslaptis;"NAUJA (LOPŠELIS)";3241323665;Taip;6;2;0;8
6408;Paslaptis;"NAUJA (LOPŠELIS)";5809630456;Taip;0;1;1;2
6409;Paslaptis;"NAUJA (LOPŠELIS)";8352704616;Ne;8;0;0;8
6410;Pasakaitė;Vieversėlių;7685647972;Taip;9;10;0;19
6411;Pasakaitė;Vieversėlių;6459145539;Taip;0;8;0;8
6412;Pasakaitė;Vieversėlių;2194313054;Taip;1;6;1;8
6413;Pasakaitė;Vieversėlių;9587489514;Taip;10;3;0;13
6414;Pasakaitė;Vieversėlių;3444442287;Taip;4;9;2;15
6415;Pasakaitė;Vieversėlių;2563725297;Taip;7;2;0;9
6416;Pasakaitė;Vieversėlių;2849753418;Taip;0;4;0;4
6417;Pasakaitė;Vieversėlių;9543991684;Taip;0;19;0;19
6418;Pasakaitė;Vieversėlių;3680596008;Taip;0;0;1;1
6419;Pasakaitė;Vieversėlių;4882856664;Taip;0;10;0;10
6420;Pasakaitė;Vieversėlių;5953162958;Ne;0;0;1;1
6421;Pasakaitė;Vieversėlių;5948958906;Taip;0;1;0;1
6422;Pasakaitė;Vieversėlių;1060914693;Taip;10;1;0;11
6423;Pasakaitė;Vieversėlių;7761162338;Taip;5;1;0;6
6424;Pasakaitė;Vieversėlių;8463220257;Taip;0;13;0;13
6425;Pasakaitė;Vieversėlių;9018830962;Taip;5;12;2;19
6426;Pasakaitė;Vieversėlių;6736879757;Taip;0;4;7;11
6427;Pasakaitė;Vieversėlių;4191875802;Taip;0;0;1;1
6428;Pasakaitė;Vieversėlių;5020801150;Taip;5;0;1;6
6429;Pasakaitė;Vieversėlių;2331486690;Taip;14;0;0;14
6430;Pasakaitė;Spindulėlių;1220619991;Taip;0;9;0;9
6431;Pasakaitė;Spindulėlių;7526264241;Taip;0;1;0;1
6432;Pasakaitė;Spindulėlių;3606601644;Taip;0;6;0;6
6433;Pasakaitė;Spindulėlių;3541877287;Taip;3;5;0;8
6434;Pasakaitė;Spindulėlių;3579498202;Taip;0;11;0;11
6435;Pasakaitė;Spindulėlių;7790937149;Taip;6;4;0;10
6436;Pasakaitė;Spindulėlių;3400305768;Taip;0;5;0;5
6437;Pasakaitė;Spindulėlių;1962693480;Taip;0;14;0;14
6438;Pasakaitė;Spindulėlių;4758073190;Taip;4;2;0;6
6439;Pasakaitė;Spindulėlių;6714500298;Taip;8;3;0;11
6440;Pasakaitė;Spindulėlių;4974486850;Ne;0;9;0;9
6441;Pasakaitė;Spindulėlių;1056358241;Taip;0;4;0;4
6442;Pasakaitė;Spindulėlių;7607522887;Taip;5;5;0;10
6443;Pasakaitė;Spindulėlių;3231283338;Taip;0;6;0;6
6444;Pasakaitė;Spindulėlių;5791927811;Taip;0;27;0;27
6445;Pasakaitė;Spindulėlių;5094404397;Taip;0;27;0;27
6446;Pasakaitė;Spindulėlių;9870015737;Ne;0;27;0;27
6447;Pasakaitė;Spindulėlių;1449037968;Taip;0;8;0;8
6448;Pasakaitė;Spindulėlių;7474100735;Taip;5;1;0;6
6449;Pasakaitė;Spindulėlių;6015360076;Taip;10;3;0;13
6450;Pasakaitė;Pasagėlių;3165658822;Taip;0;16;0;16
6451;Pasakaitė;Pasagėlių;61230317080;Ne;0;1;0;1
6452;Pasakaitė;Pasagėlių;1740419218;Taip;18;2;0;20
6453;Pasakaitė;Pasagėlių;5378855541;Taip;17;0;1;18
6454;Pasakaitė;Pasagėlių;1019010454;Taip;0;3;0;3
6455;Pasakaitė;Pasagėlių;4959175420;Taip;0;6;0;6
6456;Pasakaitė;Pasagėlių;4013900094;Taip;11;0;0;11
6457;Pasakaitė;Pasagėlių;5605619860;Taip;0;15;0;15
6458;Pasakaitė;Pasagėlių;1791015854;Taip;9;0;1;10
6459;Pasakaitė;Pasagėlių;39853246609;Taip;10;0;0;10
6460;Pasakaitė;Pasagėlių;5467179333;Taip;0;5;0;5
6461;Pasakaitė;Pasagėlių;3345955615;Taip;0;4;0;4
6462;Pasakaitė;Pasagėlių;2810892060;Taip;5;0;0;5
6463;Pasakaitė;Švyturėlių;7702359586;Taip;0;10;0;10
6464;Pasakaitė;Švyturėlių;8469043564;Taip;17;0;1;18
6465;Pasakaitė;Švyturėlių;2721048424;Taip;0;2;0;2
6466;Pasakaitė;Švyturėlių;1513903341;Taip;13;0;0;13
6467;Pasakaitė;Švyturėlių;8390366303;Taip;0;10;0;10
6468;Pasakaitė;Švyturėlių;1278198989;Taip;15;0;7;22
6469;Pasakaitė;Švyturėlių;6847782430;Taip;0;10;0;10
6470;Pasakaitė;Švyturėlių;4728731352;Taip;10;0;0;10
6471;Pasakaitė;Švyturėlių;9821617981;Taip;13;0;4;17
6472;Pasakaitė;Švyturėlių;1184513606;Taip;0;7;4;11
6473;Pasakaitė;Švyturėlių;4864779439;Taip;0;0;1;1
6474;Pasakaitė;Švyturėlių;8223662339;Taip;15;0;1;16
6475;Pasakaitė;Švyturėlių;3710143250;Taip;4;0;0;4
6476;Pasakaitė;Švyturėlių;2329827275;Taip;0;0;2;2
6477;Pasakaitė;Švyturėlių;2933474317;Taip;18;0;0;18
6478;Pasakaitė;Kodėlčiukų;1854100959;Taip;0;0;1;1
6479;Pasakaitė;Kodėlčiukų;93907096625;Taip;8;7;0;15
6480;Pasakaitė;Kodėlčiukų;1270179754;Taip;3;4;1;8
6481;Pasakaitė;Kodėlčiukų;9746401498;Ne;0;3;0;3
6482;Pasakaitė;Kodėlčiukų;6839399035;Taip;0;2;0;2
6483;Pasakaitė;Kodėlčiukų;1809383469;Taip;8;17;0;25
6484;Pasakaitė;Kodėlčiukų;2742595829;Taip;9;2;0;11
6485;Pasakaitė;Kodėlčiukų;1592521766;Taip;0;4;1;5
6486;Pasakaitė;Kodėlčiukų;6983619733;Taip;0;8;0;8
6487;Pasakaitė;Kodėlčiukų;9506178305;Taip;4;2;1;7
6488;Pasakaitė;Kodėlčiukų;24096031951;Taip;0;0;4;4
6489;Pasakaitė;Kodėlčiukų;75785125455;Taip;0;6;0;6
6490;Pasakaitė;Kodėlčiukų;9914689534;Taip;0;13;0;13
6491;Pasakaitė;Kodėlčiukų;8225188274;Taip;0;6;0;6
6492;Pasakaitė;Kodėlčiukų;5436985035;Taip;3;5;1;9
6493;Pasakaitė;Kodėlčiukų;1940545723;Taip;0;12;0;12
6494;Pasakaitė;Kodėlčiukų;1070409611;Taip;0;0;4;4
6495;Pasakaitė;Kodėlčiukų;73957497029;Taip;0;1;0;1
6496;Pasakaitė;Kodėlčiukų;4008826950;Taip;6;19;0;25
6497;Pasakaitė;Kodėlčiukų;4648014383;Ne;7;7;2;16
6498;Pasakaitė;Kodėlčiukų;3778906698;Taip;0;0;5;5
6499;Pasakaitė;Kodėlčiukų;9031690002;Taip;0;8;4;12
6500;Pasakaitė;Gudručių;7706579585;Taip;0;0;2;2
6501;Pasakaitė;Gudručių;26031226748;Taip;0;14;0;14
6502;Pasakaitė;Gudručių;12092268542;Taip;0;4;0;4
6503;Pasakaitė;Gudručių;18105216772;Taip;0;12;0;12
6504;Pasakaitė;Gudručių;51040024089;Taip;0;0;1;1
6505;Pasakaitė;Gudručių;1407277414;Taip;0;4;1;5
6506;Pasakaitė;Gudručių;45157801238;Taip;0;0;11;11
6507;Pasakaitė;Gudručių;46873849992;Taip;0;6;0;6
6508;Pasakaitė;Gudručių;88885227604;Taip;5;13;0;18
6509;Pasakaitė;Gudručių;17218793370;Taip;0;5;0;5
6510;Pasakaitė;Gudručių;50537059387;Taip;0;5;6;11
6511;Pasakaitė;Gudručių;33418184802;Taip;0;11;0;11
6512;Pasakaitė;Gudručių;600641021;Taip;0;6;1;7
6513;Pasakaitė;Gudručių;2210519019;Taip;10;0;0;10
6514;Pasakaitė;Gudručių;46074425530;Ne;3;0;0;3
6515;Pasakaitė;Gudručių;82475369612;Taip;0;13;0;13
6516;Pasakaitė;Gudručių;96648719544;Taip;0;11;0;11
6517;Pasakaitė;Gudručių;5954676615;Taip;0;4;0;4
6518;Pasakaitė;Gudručių;4267488049;Taip;0;7;7;14
6519;Pasakaitė;Gudručių;6568538767;Ne;0;3;0;3
6520;Pasakaitė;Gudručių;1523034176;Taip;0;8;0;8
6521;Pasakaitė;Čiulbonėlių;27702516199;Taip;0;7;0;7
6522;Pasakaitė;Čiulbonėlių;46891856500;Taip;5;8;10;23
6523;Pasakaitė;Čiulbonėlių;1827070201;Taip;4;4;5;13
6524;Pasakaitė;Čiulbonėlių;21252086256;Taip;0;8;0;8
6525;Pasakaitė;Čiulbonėlių;1320898756;Taip;0;18;12;30
6526;Pasakaitė;Čiulbonėlių;26714845001;Taip;0;0;3;3
6527;Pasakaitė;Čiulbonėlių;2017275984;Taip;0;10;1;11
6528;Pasakaitė;Čiulbonėlių;3397132786;Taip;0;8;0;8
6529;Pasakaitė;Čiulbonėlių;1032113089;Taip;0;6;1;7
6530;Pasakaitė;Čiulbonėlių;6346678827;Ne;5;6;5;16
6531;Pasakaitė;Čiulbonėlių;1027136050;Taip;5;15;0;20
6532;Pasakaitė;Čiulbonėlių;9175612991;Taip;2;3;2;7
6533;Pasakaitė;Čiulbonėlių;1769070351;Taip;0;10;0;10
6534;Pasakaitė;Čiulbonėlių;1198248619;Taip;0;12;0;12
6535;Pasakaitė;Čiulbonėlių;75361056418;Taip;0;1;2;3
6536;Pasakaitė;Čiulbonėlių;99890448836;Taip;0;3;0;3
6537;Pasakaitė;Čiulbonėlių;8638071584;Taip;0;0;1;1
6538;Pasakaitė;Čiulbonėlių;29699532850;Taip;4;0;9;13
6539;Pasakaitė;Čiulbonėlių;4680949976;Taip;0;10;0;10
6540;Pasakaitė;Čiulbonėlių;7152349570;Taip;0;26;0;26
6541;Pasakaitė;Čiulbonėlių;3734935229;Ne;17;11;0;28
6542;Pasakaitė;"Verpstelių ";7621306769;Taip;0;8;0;8
6543;Pasakaitė;"Verpstelių ";4946855684;Taip;0;10;0;10
6544;Pasakaitė;"Verpstelių ";5556362727;Taip;8;4;3;15
6545;Pasakaitė;"Verpstelių ";7451624229;Ne;0;9;0;9
6546;Pasakaitė;"Verpstelių ";7759051761;Taip;0;10;0;10
6547;Pasakaitė;"Verpstelių ";8315840473;Taip;5;12;1;18
6548;Pasakaitė;"Verpstelių ";1744216870;Taip;0;5;4;9
6549;Pasakaitė;"Verpstelių ";1425166722;Taip;9;4;0;13
6550;Pasakaitė;"Verpstelių ";9166649594;Taip;0;1;1;2
6551;Pasakaitė;"Verpstelių ";4246461594;Taip;0;3;5;8
6552;Pasakaitė;"Verpstelių ";1963102227;Taip;0;6;2;8
6553;Pasakaitė;"Verpstelių ";8267725352;Taip;9;4;0;13
6554;Pasakaitė;"Verpstelių ";5866092980;Taip;0;2;0;2
6555;Pasakaitė;"Verpstelių ";8562284745;Taip;0;6;0;6
6556;Pasakaitė;"Verpstelių ";1041405418;Taip;0;15;0;15
6557;Pasakaitė;"Verpstelių ";7976921380;Taip;8;0;0;8
6558;Pasakaitė;"Verpstelių ";2505815026;Taip;12;9;0;21
6559;Pasakaitė;"Verpstelių ";5413457806;Taip;0;4;0;4
6560;Pasakaitė;"Verpstelių ";1115383380;Taip;3;1;3;7
6561;Pasakaitė;"Verpstelių ";9226989209;Taip;1;1;0;2
6562;Pasakaitė;"Verpstelių ";8927014508;Taip;3;3;2;8
6563;Pasakaitė;Smalsučiai;2476010561;Taip;5;0;5;10
6564;Pasakaitė;Smalsučiai;3925034196;Taip;0;0;4;4
6565;Pasakaitė;Smalsučiai;5732009054;Taip;0;5;0;5
6566;Pasakaitė;Smalsučiai;7539851375;Taip;1;0;0;1
6567;Pasakaitė;Smalsučiai;6755983130;Taip;13;0;0;13
6568;Pasakaitė;Smalsučiai;5970146724;Taip;10;6;2;18
6569;Pasakaitė;Smalsučiai;7666033916;Taip;0;0;3;3
6570;Pasakaitė;Smalsučiai;7219080600;Ne;0;4;0;4
6571;Pasakaitė;Smalsučiai;8264189678;Taip;3;0;0;3
6572;Pasakaitė;Smalsučiai;2341175137;Taip;9;3;3;15
6573;Pasakaitė;Smalsučiai;9114337491;Taip;4;0;0;4
6574;Pasakaitė;"Čiauškučiai ";5617173998;Taip;0;16;0;16
6575;Pasakaitė;"Čiauškučiai ";5705795568;Taip;9;0;5;14
6576;Pasakaitė;"Čiauškučiai ";4485053261;Taip;5;2;0;7
6577;Pasakaitė;"Čiauškučiai ";2303884875;Taip;22;0;0;22
6578;Pasakaitė;"Čiauškučiai ";7360801624;Taip;11;0;0;11
6579;Pasakaitė;"Čiauškučiai ";9543262464;Taip;8;0;0;8
6580;Pasakaitė;"Čiauškučiai ";8165055476;Taip;4;0;0;4
6581;Pasakaitė;"Čiauškučiai ";9351971114;Taip;0;5;2;7
6582;Pasakaitė;"Čiauškučiai ";7399335037;Taip;6;9;0;15
6583;Pasakaitė;"Čiauškučiai ";1564611671;Taip;14;0;0;14
6584;Pasakaitė;"Čiauškučiai ";4098119950;Taip;11;1;0;12
6585;Pasakaitė;"Čiauškučiai ";9512782063;Taip;0;0;1;1
6586;Pasakaitė;Pabiručiai;5589440439;Taip;10;3;0;13
6587;Pasakaitė;Pabiručiai;2994653871;Taip;0;4;1;5
6588;Pasakaitė;Pabiručiai;8905681529;Taip;0;6;2;8
6589;Pasakaitė;Pabiručiai;4881361200;Taip;14;7;3;24
6590;Pasakaitė;Pabiručiai;7071921456;Taip;4;1;0;5
6591;Pasakaitė;Pabiručiai;3652896053;Taip;14;0;5;19
6592;Pasakaitė;Pabiručiai;5959875562;Taip;0;0;2;2
6593;Pasakaitė;Pabiručiai;7265623955;Taip;17;6;0;23
6594;Pasakaitė;Pabiručiai;7138417196;Taip;8;3;0;11
6595;Pasakaitė;Pabiručiai;5581264184;Taip;0;2;0;2
6596;Pasakaitė;Pabiručiai;9409907631;Taip;1;8;12;21
6597;Pasakaitė;Pabiručiai;4328440534;Taip;6;4;1;11
6598;Pasakaitė;Pabiručiai;2389832646;Taip;0;15;0;15
6599;Pasakaitė;Pabiručiai;8037316673;Taip;9;0;1;10
6600;Pasakaitė;Pabiručiai;5180059311;Taip;0;7;3;10
6601;Pasakaitė;Linksmučiai;9441990175;Taip;0;20;0;20
6602;Pasakaitė;Linksmučiai;3355268509;Taip;11;7;0;18
6603;Pasakaitė;Linksmučiai;3417077517;Taip;0;1;1;2
6604;Pasakaitė;Linksmučiai;1793453325;Taip;5;1;1;7
6605;Pasakaitė;Linksmučiai;1588525307;Taip;6;6;0;12
6606;Pasakaitė;Linksmučiai;1959599606;Taip;16;6;0;22
6607;Pasakaitė;Linksmučiai;7440327561;Taip;5;10;0;15
6608;Pasakaitė;Linksmučiai;6256000265;Taip;4;2;0;6
6609;Pasakaitė;Linksmučiai;2891089579;Taip;4;2;0;6
6610;Pasakaitė;Linksmučiai;1384552110;Taip;0;4;0;4
6611;Pasakaitė;Linksmučiai;6325408070;Taip;1;22;0;23
6612;Pasakaitė;Linksmučiai;9238905834;Taip;3;11;0;14
6613;Pasakaitė;Linksmučiai;3381303531;Taip;0;8;0;8
6614;Pelėda;KIŠKUČIAI;5022388487;Taip;0;0;4;4
6615;Pelėda;KIŠKUČIAI;8480891793;Taip;3;0;1;4
6616;Pelėda;KIŠKUČIAI;1868472349;Taip;0;0;6;6
6617;Pelėda;KIŠKUČIAI;9895822499;Taip;0;0;1;1
6618;Pelėda;KIŠKUČIAI;5696737053;Taip;4;7;1;12
6619;Pelėda;KIŠKUČIAI;2970356332;Taip;22;0;0;22
6620;Pelėda;KIŠKUČIAI;4586098882;Taip;0;0;1;1
6621;Pelėda;KIŠKUČIAI;6866376827;Taip;4;2;0;6
6622;Pelėda;KIŠKUČIAI;1094266559;Taip;8;0;0;8
6623;Pelėda;KIŠKUČIAI;2461987245;Taip;0;0;5;5
6624;Pelėda;KIŠKUČIAI;4683105330;Taip;5;9;5;19
6625;Pelėda;KIŠKUČIAI;1648011796;Taip;5;0;0;5
6626;Pelėda;KIŠKUČIAI;1339850717;Taip;4;0;0;4
6627;Pelėda;KIŠKUČIAI;7471964981;Taip;8;0;0;8
6628;Pelėda;KIŠKUČIAI;2443856355;Taip;8;0;0;8
6629;Pelėda;PELIUKAI;9439898519;Taip;0;3;0;3
6630;Pelėda;PELIUKAI;9946001722;Taip;0;1;0;1
6631;Pelėda;PELIUKAI;6176234300;Taip;7;4;0;11
6632;Pelėda;PELIUKAI;7115170496;Taip;4;12;1;17
6633;Pelėda;PELIUKAI;8488014906;Taip;11;6;0;17
6634;Pelėda;PELIUKAI;5757204162;Taip;0;7;2;9
6635;Pelėda;PELIUKAI;9163028606;Taip;0;5;0;5
6636;Pelėda;PELIUKAI;5817759212;Taip;0;4;3;7
6637;Pelėda;PELIUKAI;2244645500;Ne;0;4;1;5
6638;Pelėda;PELIUKAI;8390806842;Taip;0;17;4;21
6639;Pelėda;PELIUKAI;7690864852;Taip;0;11;0;11
6640;Pelėda;PELIUKAI;6078692290;Taip;0;1;0;1
6641;Pelėda;PELIUKAI;9517601102;Taip;0;9;0;9
6642;Pelėda;PELIUKAI;2401684712;Taip;0;2;1;3
6643;Pelėda;PELIUKAI;3826393044;Taip;3;0;0;3
6644;Pelėda;PELIUKAI;1412127635;Taip;5;4;0;9
6645;Pelėda;PELIUKAI;9938442887;Taip;7;6;0;13
6646;Pelėda;PELIUKAI;4957538906;Taip;0;3;2;5
6647;Pelėda;PELIUKAI;9705883537;Taip;0;1;2;3
6648;Pelėda;GUDRUČIAI;1408094832;Taip;5;1;2;8
6649;Pelėda;GUDRUČIAI;6722322768;Taip;0;1;0;1
6650;Pelėda;GUDRUČIAI;2012499214;Taip;0;8;0;8
6651;Pelėda;GUDRUČIAI;3071845347;Taip;5;0;0;5
6652;Pelėda;GUDRUČIAI;1090988523;Taip;0;6;0;6
6653;Pelėda;GUDRUČIAI;9652297737;Taip;0;0;6;6
6654;Pelėda;GUDRUČIAI;1618410480;Taip;5;0;2;7
6655;Pelėda;GUDRUČIAI;1006197939;Taip;5;0;0;5
6656;Pelėda;GUDRUČIAI;5942764642;Taip;0;0;1;1
6657;Pelėda;GUDRUČIAI;7383726391;Taip;5;4;0;9
6658;Pelėda;GUDRUČIAI;7318584717;Taip;4;0;0;4
6659;Pelėda;GUDRUČIAI;6142353763;Taip;22;0;0;22
6660;Pelėda;GUDRUČIAI;3980392114;Taip;0;1;1;2
6661;Pelėda;GUDRUČIAI;5160896289;Taip;0;1;2;3
6662;Pelėda;GUDRUČIAI;4106247220;Taip;0;0;3;3
6663;Pelėda;GUDRUČIAI;1450711096;Taip;8;0;1;9
6664;Pelėda;GUDRUČIAI;29013496107;Taip;8;6;5;19
6665;Pelėda;ŽIRNIUKAI;5435997976;Taip;0;1;0;1
6666;Pelėda;ŽIRNIUKAI;3884970829;Taip;0;1;0;1
6667;Pelėda;ŽIRNIUKAI;1575799852;Taip;0;0;1;1
6668;Pelėda;ŽIRNIUKAI;94116080093;Taip;10;0;0;10
6669;Pelėda;ŽIRNIUKAI;4273955889;Taip;0;2;0;2
6670;Pelėda;ŽIRNIUKAI;9931106022;Taip;0;10;4;14
6671;Pelėda;ŽIRNIUKAI;7135083783;Taip;0;1;4;5
6672;Pelėda;ŽIRNIUKAI;78647595258;Taip;0;1;2;3
6673;Pelėda;ŽIRNIUKAI;1565051606;Taip;8;14;1;23
6674;Pelėda;ŽIRNIUKAI;4998906592;Taip;0;0;5;5
6675;Pelėda;ŽIRNIUKAI;2038465201;Taip;6;4;1;11
6676;Pelėda;ŽIRNIUKAI;8229808924;Taip;7;1;4;12
6677;Pelėda;ŽIRNIUKAI;3188782407;Taip;0;1;0;1
6678;Pelėda;ŽIRNIUKAI;8626054269;Ne;0;5;2;7
6679;Pelėda;ŽIRNIUKAI;3696943275;Taip;0;10;5;15
6680;Pelėda;ŽIRNIUKAI;8413768649;Taip;0;11;0;11
6681;Pelėda;ŽIRNIUKAI;9529273198;Taip;0;0;1;1
6682;Pelėda;ŽIRNIUKAI;9360684178;Taip;0;0;3;3
6683;Pelėda;ŽIRNIUKAI;2035408478;Taip;0;1;8;9
6684;Pelėda;KODĖLČIUKAI;1441913009;Taip;0;8;5;13
6685;Pelėda;KODĖLČIUKAI;58022074008;Taip;10;0;1;11
6686;Pelėda;KODĖLČIUKAI;85319820792;Taip;0;1;0;1
6687;Pelėda;KODĖLČIUKAI;50706154958;Taip;0;9;0;9
6688;Pelėda;KODĖLČIUKAI;1612122415;Taip;0;0;4;4
6689;Pelėda;KODĖLČIUKAI;1722466801;Taip;0;0;1;1
6690;Pelėda;KODĖLČIUKAI;1595642368;Taip;0;0;1;1
6691;Pelėda;KODĖLČIUKAI;45171588020;Taip;0;2;0;2
6692;Pelėda;KODĖLČIUKAI;1488187787;Taip;0;3;0;3
6693;Pelėda;KODĖLČIUKAI;1720311432;Taip;0;0;1;1
6694;Pelėda;KODĖLČIUKAI;1947350951;Taip;0;6;0;6
6695;Pelėda;KODĖLČIUKAI;1305342310;Taip;0;1;0;1
6696;Pelėda;KODĖLČIUKAI;43286772079;Taip;15;0;3;18
6697;Pelėda;KODĖLČIUKAI;83657151531;Taip;0;0;4;4
6698;Pelėda;KODĖLČIUKAI;7077543330;Taip;0;2;1;3
6699;Pelėda;KODĖLČIUKAI;25156659589;Taip;0;14;0;14
6700;Pelėda;KODĖLČIUKAI;9936818959;Taip;0;2;2;4
6701;Pelėda;KODĖLČIUKAI;39269336820;Taip;0;0;5;5
6702;Pelėda;ĄŽUOLIUKAI;4386614877;Taip;0;10;3;13
6703;Pelėda;ĄŽUOLIUKAI;4365144594;Taip;0;10;0;10
6704;Pelėda;ĄŽUOLIUKAI;6654045915;Taip;0;9;8;17
6705;Pelėda;ĄŽUOLIUKAI;3635776343;Taip;0;0;2;2
6706;Pelėda;ĄŽUOLIUKAI;7536639312;Ne;0;10;3;13
6707;Pelėda;ĄŽUOLIUKAI;1592854934;Taip;4;0;0;4
6708;Pelėda;ĄŽUOLIUKAI;5126021927;Taip;5;5;1;11
6709;Pelėda;ĄŽUOLIUKAI;5188673721;Taip;3;7;0;10
6710;Pelėda;ĄŽUOLIUKAI;6986971662;Taip;0;5;6;11
6711;Pelėda;ĄŽUOLIUKAI;7983602019;Taip;9;4;0;13
6712;Pelėda;ĄŽUOLIUKAI;7297186734;Taip;0;17;5;22
6713;Pelėda;ĄŽUOLIUKAI;1170566784;Taip;0;10;7;17
6714;Pelėda;ĄŽUOLIUKAI;2999378284;Taip;11;1;0;12
6715;Pelėda;ĄŽUOLIUKAI;5975604713;Taip;0;16;0;16
6716;Pelėda;ĄŽUOLIUKAI;1705030069;Taip;0;6;6;12
6717;Pelėda;ĄŽUOLIUKAI;9160773197;Taip;0;4;0;4
6718;Pelėda;NYKŠTUKAI;6541679509;Taip;9;0;3;12
6719;Pelėda;NYKŠTUKAI;2309259743;Taip;0;12;4;16
6720;Pelėda;NYKŠTUKAI;2886154457;Taip;0;1;1;2
6721;Pelėda;NYKŠTUKAI;3491420841;Taip;9;8;0;17
6722;Pelėda;NYKŠTUKAI;5274805168;Ne;11;0;1;12
6723;Pelėda;NYKŠTUKAI;9225814249;Taip;0;0;4;4
6724;Pelėda;NYKŠTUKAI;5101074374;Taip;0;0;8;8
6725;Pelėda;NYKŠTUKAI;1025126999;Taip;0;22;0;22
6726;Pelėda;NYKŠTUKAI;9247146082;Taip;4;0;4;8
6727;Pelėda;NYKŠTUKAI;3656600059;Taip;0;1;3;4
6728;Pelėda;NYKŠTUKAI;8810905912;Taip;0;3;0;3
6729;Pelėda;NYKŠTUKAI;2334234258;Taip;0;1;0;1
6730;Pelėda;NYKŠTUKAI;2738119814;Taip;0;1;3;4
6731;Pelėda;NYKŠTUKAI;2645521887;Taip;13;0;0;13
6732;Pelėda;NYKŠTUKAI;6903963241;Taip;7;0;5;12
6733;Pelėda;NYKŠTUKAI;6483015888;Taip;0;0;7;7
6734;Pelėda;NYKŠTUKAI;9405028368;Taip;0;0;4;4
6735;Pelėda;NYKŠTUKAI;8998410478;Ne;0;0;7;7
6736;Pelėda;NYKŠTUKAI;6464031842;Taip;9;0;0;9
6737;Pelėda;NYKŠTUKAI;7022011252;Taip;0;0;1;1
6738;Pelėda;BORUŽIUKŲ;5915126794;Taip;10;9;0;19
6739;Pelėda;BORUŽIUKŲ;3616720339;Taip;2;2;2;6
6740;Pelėda;BORUŽIUKŲ;4897863715;Taip;0;4;1;5
6741;Pelėda;BORUŽIUKŲ;7610873518;Taip;0;9;1;10
6742;Pelėda;BORUŽIUKŲ;8698605098;Taip;0;17;4;21
6743;Pelėda;BORUŽIUKŲ;4036088391;Taip;7;3;0;10
6744;Pelėda;BORUŽIUKŲ;5888109663;Taip;5;6;0;11
6745;Pelėda;BORUŽIUKŲ;1174170960;Taip;17;10;0;27
6746;Pelėda;BORUŽIUKŲ;7901350800;Taip;0;9;0;9
6747;Pelėda;BORUŽIUKŲ;8148826427;Taip;0;9;0;9
6748;Pelėda;BORUŽIUKŲ;7602062954;Taip;13;3;0;16
6749;Pelėda;BORUŽIUKŲ;9253550935;Ne;5;5;0;10
6750;Pelėda;BORUŽIUKŲ;3189487277;Taip;4;6;0;10
6751;Pelėda;BORUŽIUKŲ;8279365345;Taip;3;5;0;8
6752;Pelėda;BORUŽIUKŲ;2140680910;Taip;13;10;0;23
6753;Pelėda;BORUŽIUKŲ;8716979603;Taip;14;11;2;27
6754;Pelėda;BORUŽIUKŲ;6953400648;Taip;4;0;0;4
6755;Pelėda;DRUGELIAI;6304939435;Taip;6;0;5;11
6756;Pelėda;DRUGELIAI;7008368113;Taip;6;0;5;11
6757;Pelėda;DRUGELIAI;5109764898;Taip;0;10;0;10
6758;Pelėda;DRUGELIAI;9180562730;Ne;0;7;0;7
6759;Pelėda;DRUGELIAI;7539117117;Taip;0;3;0;3
6760;Pelėda;DRUGELIAI;2972697161;Taip;10;0;3;13
6761;Pelėda;DRUGELIAI;6412482189;Taip;8;1;0;9
6762;Pelėda;DRUGELIAI;2625798821;Taip;0;4;0;4
6763;Pelėda;DRUGELIAI;9265958605;Taip;7;1;1;9
6764;Pelėda;DRUGELIAI;9786523383;Taip;0;1;0;1
6765;Pelėda;DRUGELIAI;9891793986;Taip;0;5;0;5
6766;Pelėda;DRUGELIAI;2309411522;Taip;6;3;0;9
6767;Pelėda;DRUGELIAI;4392563768;Taip;0;9;0;9
6768;Pelėda;DRUGELIAI;2553026823;Taip;0;8;2;10
6769;Pelėda;DRUGELIAI;9707472269;Taip;3;0;0;3
6770;Pelėda;DRUGELIAI;4057233238;Taip;0;4;0;4
6771;Pelėda;DRUGELIAI;3211445851;Taip;0;9;11;20
6772;Pelėda;DRUGELIAI;9470036802;Taip;9;0;0;9
6773;Pelėda;DRUGELIAI;1290029676;Taip;14;0;0;14
6774;Pelėda;DRUGELIAI;1620206336;Taip;3;1;0;4
6775;Pelėda;OBUOLIUKAI;6350233313;Taip;4;0;0;4
6776;Pelėda;OBUOLIUKAI;5844613931;Taip;0;8;4;12
6777;Pelėda;OBUOLIUKAI;4473075270;Taip;22;0;0;22
6778;Pelėda;OBUOLIUKAI;4593471819;Taip;5;4;0;9
6779;Pelėda;OBUOLIUKAI;8387435290;Taip;2;0;0;2
6780;Pelėda;OBUOLIUKAI;4275072568;Taip;0;0;10;10
6781;Pelėda;OBUOLIUKAI;7441923956;Taip;4;1;0;5
6782;Pelėda;OBUOLIUKAI;3770650894;Taip;11;0;0;11
6783;Pelėda;OBUOLIUKAI;9784300108;Taip;11;0;1;12
6784;Pelėda;OBUOLIUKAI;3931942053;Taip;4;0;4;8
6785;Pelėda;OBUOLIUKAI;7990033419;Taip;3;0;1;4
6786;Pelėda;OBUOLIUKAI;7955805701;Taip;0;0;2;2
6787;Pelėda;OBUOLIUKAI;9175754279;Taip;9;0;1;10
6788;Pelėda;OBUOLIUKAI;2671545779;Taip;4;0;0;4
6789;Pelėda;OBUOLIUKAI;9979628576;Taip;0;0;4;4
6790;Pelėda;BITUTĖS;5092401235;Taip;5;7;4;16
6791;Pelėda;BITUTĖS;7202399026;Taip;4;4;0;8
6792;Pelėda;BITUTĖS;8383892842;Taip;7;2;0;9
6793;Pelėda;BITUTĖS;9528268855;Taip;8;5;0;13
6794;Pelėda;BITUTĖS;8448771456;Taip;8;2;0;10
6795;Pelėda;BITUTĖS;9150480625;Taip;5;0;0;5
6796;Pelėda;BITUTĖS;6731368316;Taip;2;10;0;12
6797;Pelėda;BITUTĖS;4561020945;Taip;19;4;0;23
6798;Pelėda;BITUTĖS;8095659089;Taip;0;3;0;3
6799;Pelėda;BITUTĖS;3650609128;Taip;0;8;16;24
6800;Pelėda;BITUTĖS;1180879915;Taip;9;8;0;17
6801;Pelėda;BITUTĖS;6830069179;Taip;3;7;0;10
6802;Pelėda;BITUTĖS;8524370231;Taip;17;8;0;25
6803;Pelėda;BITUTĖS;9448275148;Taip;13;8;4;25
6804;Pelėda;BITUTĖS;1614538332;Taip;14;2;2;18
6805;Pelėda;BITUTĖS;6541083913;Taip;7;5;0;12
6806;Pelėda;BITUTĖS;6403648176;Taip;6;0;3;9
6807;Pelėda;SMALSUČIAI;3300678252;Taip;10;1;1;12
6808;Pelėda;SMALSUČIAI;2659722758;Taip;22;0;0;22
6809;Pelėda;SMALSUČIAI;9981001823;Taip;22;10;0;32
6810;Pelėda;SMALSUČIAI;7855274428;Taip;4;3;5;12
6811;Pelėda;SMALSUČIAI;9174484624;Taip;7;1;0;8
6812;Pelėda;SMALSUČIAI;5875616604;Taip;0;2;6;8
6813;Pelėda;SMALSUČIAI;8445826983;Taip;6;0;0;6
6814;Pelėda;SMALSUČIAI;7771324023;Taip;3;0;0;3
6815;Pelėda;SMALSUČIAI;9243579706;Taip;9;0;0;9
6816;Pelėda;SMALSUČIAI;8715235444;Taip;0;0;1;1
6817;Pelėda;SMALSUČIAI;3335276613;Taip;22;8;0;30
6818;Pelėda;SMALSUČIAI;5984789325;Taip;10;0;1;11
6819;Pelėda;SMALSUČIAI;9528606894;Taip;6;0;0;6
6820;Pelėda;SMALSUČIAI;1112632514;Taip;8;0;0;8
6821;Pelėda;SMALSUČIAI;8775397229;Taip;0;16;0;16
6822;Pelėda;SMALSUČIAI;3789797271;Taip;23;6;0;29
6823;Pelėda;SMALSUČIAI;9464415942;Taip;10;1;4;15
6824;Pelenė;Varpelis;120966603;Taip;6;0;0;6
6825;Pelenė;Varpelis;3465518545;Taip;16;0;2;18
6826;Pelenė;Varpelis;6289619123;Ne;6;0;0;6
6827;Pelenė;Varpelis;1568123491;Taip;0;4;0;4
6828;Pelenė;Varpelis;14200374671;Taip;12;0;0;12
6829;Pelenė;Varpelis;1483843416;Taip;0;10;0;10
6830;Pelenė;Varpelis;2400806788;Taip;6;0;4;10
6831;Pelenė;Varpelis;42431378466;Taip;0;9;0;9
6832;Pelenė;Varpelis;17572291941;Taip;0;3;0;3
6833;Pelenė;Varpelis;2677995903;Taip;0;9;0;9
6834;Pelenė;Varpelis;28622286194;Taip;0;0;1;1
6835;Pelenė;Varpelis;1050272821;Ne;0;0;4;4
6836;Pelenė;Varpelis;51979406888;Taip;0;0;1;1
6837;Pelenė;Varpelis;89920419797;Taip;0;0;2;2
6838;Pelenė;Varpelis;26010775076;Taip;0;0;2;2
6839;Pelenė;Varpelis;7144616734;Taip;0;0;1;1
6840;Pelenė;Saulutės;7880284433;Taip;0;0;1;1
6841;Pelenė;Saulutės;2737277656;Taip;3;0;0;3
6842;Pelenė;Saulutės;1775717256;Taip;8;0;2;10
6843;Pelenė;Saulutės;4315677064;Taip;0;0;1;1
6844;Pelenė;Saulutės;7587887488;Taip;0;2;0;2
6845;Pelenė;Saulutės;5389865440;Taip;9;0;0;9
6846;Pelenė;Saulutės;8716395810;Taip;4;1;0;5
6847;Pelenė;Saulutės;6191899254;Taip;7;0;0;7
6848;Pelenė;Saulutės;1902314385;Taip;0;3;0;3
6849;Pelenė;Saulutės;6481466282;Taip;8;0;0;8
6850;Pelenė;Saulutės;6707167720;Taip;0;0;2;2
6851;Pelenė;Saulutės;8466974910;Taip;0;0;4;4
6852;Pelenė;Saulutės;2393964666;Taip;4;4;0;8
6853;Pelenė;Saulutės;9621197758;Taip;0;15;0;15
6854;Pelenė;Saulutės;5780697554;Taip;0;2;0;2
6855;Pelenė;Saulutės;4989239822;Taip;0;0;2;2
6856;Pelenė;Saulutės;6790396551;Taip;0;0;1;1
6857;Pelenė;Saulutės;6221703608;Taip;0;0;3;3
6858;Pelenė;Saulutės;1278011268;Taip;0;0;1;1
6859;Pelenė;Saulutės;7865562941;Ne;3;5;0;8
6860;Pelenė;Saulutės;2426412323;Taip;0;0;3;3
6861;Pelenė;Saulutės;6267178572;Taip;0;9;0;9
6862;Pelenė;Raktelis;9195113444;Taip;0;0;5;5
6863;Pelenė;Raktelis;4591637887;Taip;6;0;2;8
6864;Pelenė;Raktelis;4090532624;Ne;7;0;0;7
6865;Pelenė;Raktelis;8123162647;Taip;0;2;0;2
6866;Pelenė;Raktelis;9063588699;Taip;0;18;0;18
6867;Pelenė;Raktelis;3573543545;Taip;0;4;0;4
6868;Pelenė;Raktelis;7659625628;Taip;0;0;1;1
6869;Pelenė;Raktelis;6375060159;Taip;10;4;0;14
6870;Pelenė;Raktelis;6419661741;Taip;0;10;0;10
6871;Pelenė;Raktelis;4089199552;Taip;2;0;7;9
6872;Pelenė;Raktelis;6038229659;Taip;18;0;0;18
6873;Pelenė;Raktelis;1060619471;Taip;8;0;0;8
6874;Pelenė;Raktelis;5749399210;Taip;10;0;10;20
6875;Pelenė;Raktelis;4448592497;Taip;4;0;0;4
6876;Pelenė;Raktelis;5333802902;Taip;0;13;0;13
6877;Pelenė;Raktelis;5063098703;Taip;0;7;0;7
6878;Pelenė;Raktelis;1049199372;Taip;0;5;0;5
6879;Pelenė;Žvaigždutės;8404317146;Taip;9;0;2;11
6880;Pelenė;Žvaigždutės;1336431888;Taip;0;11;0;11
6881;Pelenė;Žvaigždutės;3497915398;Taip;3;10;0;13
6882;Pelenė;Žvaigždutės;2154553741;Taip;3;10;0;13
6883;Pelenė;Žvaigždutės;8598498275;Taip;0;8;0;8
6884;Pelenė;Žvaigždutės;69721118552;Taip;5;0;0;5
6885;Pelenė;Žvaigždutės;45410683361;Taip;0;0;2;2
6886;Pelenė;Žvaigždutės;1781704945;Taip;2;0;0;2
6887;Pelenė;Žvaigždutės;39705461573;Ne;0;9;0;9
6888;Pelenė;Žvaigždutės;6632188229;Taip;4;5;0;9
6889;Pelenė;Žvaigždutės;5356756237;Taip;0;0;2;2
6890;Pelenė;Žvaigždutės;9009271610;Ne;0;8;0;8
6891;Pelenė;Žvaigždutės;5325176433;Taip;0;4;1;5
6892;Pelenė;Žvaigždutės;3592878496;Taip;7;6;0;13
6893;Pelenė;Nykštukas;4541391191;Taip;13;0;0;13
6894;Pelenė;Nykštukas;3296147024;Taip;0;13;0;13
6895;Pelenė;Nykštukas;9584503078;Taip;0;0;3;3
6896;Pelenė;Nykštukas;10457480694;Taip;0;0;6;6
6897;Pelenė;Nykštukas;6181604926;Taip;0;6;1;7
6898;Pelenė;Nykštukas;7254981715;Taip;0;11;0;11
6899;Pelenė;Nykštukas;6579504852;Taip;0;5;0;5
6900;Pelenė;Nykštukas;6021833025;Taip;0;10;0;10
6901;Pelenė;Nykštukas;1978481168;Taip;11;0;0;11
6902;Pelenė;Nykštukas;3596386480;Taip;0;1;0;1
6903;Pelenė;Nykštukas;3385568839;Taip;0;5;0;5
6904;Pelenė;Nykštukas;7589978427;Taip;0;2;0;2
6905;Pelenė;Nykštukas;8770771520;Taip;0;0;4;4
6906;Pelenė;Nykštukas;1750366978;Taip;1;4;0;5
6907;Pelenė;Nykštukas;2092775878;Taip;0;7;0;7
6908;Pelenė;Nykštukas;8675348688;Taip;0;0;1;1
6909;Pelenė;Žirniukai;8529178313;Taip;0;0;6;6
6910;Pelenė;Žirniukai;6046921077;Taip;0;0;1;1
6911;Pelenė;Žirniukai;9601582419;Taip;15;0;0;15
6912;Pelenė;Žirniukai;7057752202;Taip;0;2;1;3
6913;Pelenė;Žirniukai;7399112026;Taip;8;0;2;10
6914;Pelenė;Žirniukai;3500358886;Taip;0;5;1;6
6915;Pelenė;Žirniukai;2443906444;Taip;6;0;0;6
6916;Pelenė;Žirniukai;5922348478;Taip;22;0;0;22
6917;Pelenė;Žirniukai;1313425695;Taip;0;5;1;6
6918;Pelenė;Žirniukai;1595627222;Taip;0;4;0;4
6919;Pelenė;Žirniukai;2438266396;Taip;0;15;0;15
6920;Pelenė;Žirniukai;2590035984;Taip;0;4;0;4
6921;Pelenė;Žirniukai;3863839750;Taip;5;3;0;8
6922;Pelenė;Žirniukai;6062471906;Ne;6;0;7;13
6923;Pelenė;Lašeliai;8807342148;Taip;0;1;2;3
6924;Pelenė;Lašeliai;2487632125;Taip;0;0;4;4
6925;Pelenė;Lašeliai;4777496709;Taip;0;0;1;1
6926;Pelenė;Lašeliai;2647876561;Taip;6;0;0;6
6927;Pelenė;Lašeliai;8194354176;Ne;0;3;0;3
6928;Pelenė;Lašeliai;5697826755;Taip;0;0;2;2
6929;Pelenė;Lašeliai;8239650471;Taip;3;0;3;6
6930;Pelenė;Lašeliai;4004975235;Taip;3;0;0;3
6931;Pelenė;Lašeliai;8790613872;Taip;4;0;0;4
6932;Pelenė;Lašeliai;5228983908;Taip;13;0;0;13
6933;Pelenė;Lašeliai;3174009848;Taip;0;1;0;1
6934;Pelenė;Lašeliai;6524101295;Taip;5;0;1;6
6935;Pelenė;Lašeliai;4376033711;Taip;8;3;0;11
6936;Pelenė;Lašeliai;9447223913;Taip;7;0;5;12
6937;Pelenė;Lašeliai;6894978459;Taip;9;5;0;14
6938;Pelenė;Lašeliai;4321705575;Taip;0;2;0;2
6939;Pelenė;Lašeliai;6864263698;Taip;8;0;0;8
6940;Pelenė;Lašeliai;7578318198;Taip;0;2;0;2
6941;Pelenė;Grūdelis;311074533;Taip;0;5;0;5
6942;Pelenė;Grūdelis;71274664713;Taip;0;1;0;1
6943;Pelenė;Grūdelis;78648474464;Taip;0;0;2;2
6944;Pelenė;Grūdelis;52690820;Taip;0;0;1;1
6945;Pelenė;Grūdelis;59244146880;Taip;0;1;0;1
6946;Pelenė;Grūdelis;4178071578;Taip;0;10;0;10
6947;Pelenė;Grūdelis;6937587856;Taip;0;4;0;4
6948;Pelenė;Grūdelis;8813044848;Taip;0;0;7;7
6949;Pelenė;Grūdelis;96840961754;Taip;2;4;0;6
6950;Pelenė;Grūdelis;61012202440;Taip;0;1;0;1
6951;Pelenė;Grūdelis;5804848640;Taip;0;6;0;6
6952;Pelenė;Grūdelis;34765342495;Taip;0;1;0;1
6953;Pelenė;Grūdelis;62484999314;Taip;0;1;0;1
6954;Pelenė;Grūdelis;1305335939;Taip;0;0;2;2
6955;Pelenė;Grūdelis;4386060612;Ne;0;0;2;2
6956;Pelenė;Grūdelis;1183026351;Taip;0;2;0;2
6957;Pelenė;Grūdelis;4624325473;Ne;0;3;0;3
6958;Pelenė;Braškytė;7158455528;Taip;7;9;0;16
6959;Pelenė;Braškytė;2303618074;Taip;0;0;1;1
6960;Pelenė;Braškytė;9473901831;Taip;6;0;1;7
6961;Pelenė;Braškytė;7602432318;Taip;11;0;1;12
6962;Pelenė;Braškytė;9162252512;Taip;0;0;5;5
6963;Pelenė;Braškytė;1711603372;Taip;7;12;0;19
6964;Pelenė;Braškytė;1944933777;Taip;7;4;0;11
6965;Pelenė;Braškytė;6316640679;Taip;0;0;7;7
6966;Pelenė;Braškytė;4431474395;Taip;0;11;0;11
6967;Pelenė;Braškytė;9097123374;Taip;0;2;0;2
6968;Pelenė;Braškytė;4695104609;Taip;0;2;0;2
6969;Pelenė;Braškytė;7148956863;Taip;0;2;0;2
6970;Pelenė;Braškytė;2765650058;Taip;2;0;1;3
6971;Pelenė;Braškytė;7383544475;Taip;0;9;0;9
6972;Pelenė;Boružėlės;5587759166;Taip;6;0;0;6
6973;Pelenė;Boružėlės;4056676361;Taip;0;0;3;3
6974;Pelenė;Boružėlės;4870187198;Taip;10;0;0;10
6975;Pelenė;Boružėlės;2476080951;Taip;0;8;0;8
6976;Pelenė;Boružėlės;5894429453;Taip;0;0;2;2
6977;Pelenė;Boružėlės;7614130590;Taip;9;0;0;9
6978;Pelenė;Boružėlės;2555464779;Taip;14;0;0;14
6979;Pelenė;Boružėlės;5548367924;Taip;0;0;22;22
6980;Pelenė;Boružėlės;7640768043;Taip;9;0;0;9
6981;Pelenė;Boružėlės;5031778158;Taip;0;2;0;2
6982;Pelenė;Boružėlės;8623480143;Ne;3;0;6;9
6983;Pelenė;Boružėlės;2040256240;Taip;10;0;0;10
6984;Pelenė;Boružėlės;6014571367;Taip;7;6;0;13
6985;Pelenė;Boružėlės;4602503400;Taip;0;0;1;1
6986;Pelenė;Boružėlės;9530531472;Ne;7;0;0;7
6987;Pelenė;Saldainiukai;5028095861;Taip;11;0;0;11
6988;Pelenė;Saldainiukai;9505945890;Taip;0;0;1;1
6989;Pelenė;Saldainiukai;8202196292;Taip;0;4;0;4
6990;Pelenė;Saldainiukai;5066227318;Taip;7;0;1;8
6991;Pelenė;Saldainiukai;4305733824;Taip;0;0;2;2
6992;Pelenė;Saldainiukai;2986690431;Taip;3;6;0;9
6993;Pelenė;Saldainiukai;4051874126;Taip;0;5;0;5
6994;Pelenė;Saldainiukai;4660385383;Ne;8;0;0;8
6995;Pelenė;Saldainiukai;1804898751;Taip;0;7;0;7
6996;Pelenė;Saldainiukai;8862429244;Taip;12;0;1;13
6997;Pelenė;Saldainiukai;9969975097;Ne;4;0;0;4
6998;Pelenė;Saldainiukai;5762403752;Taip;0;1;0;1
6999;Pelenė;Saldainiukai;5926700157;Taip;4;0;0;4
7000;Pelenė;Saldainiukai;8961082265;Taip;0;5;0;5
7001;Pelenė;Saldainiukai;2882716674;Taip;2;3;0;5
7002;Pelenė;Drugeliai;2540405047;Taip;7;0;3;10
7003;Pelenė;Drugeliai;3603352172;Taip;22;0;0;22
7004;Pelenė;Drugeliai;5084452088;Ne;0;9;0;9
7005;Pelenė;Drugeliai;9218868317;Taip;0;0;3;3
7006;Pelenė;Drugeliai;2628676128;Taip;4;0;0;4
7007;Pelenė;Drugeliai;6834792589;Taip;4;0;2;6
7008;Pelenė;Drugeliai;9810123679;Taip;0;16;0;16
7009;Pelenė;Drugeliai;2322908067;Taip;0;7;0;7
7010;Pelenė;Drugeliai;1048899958;Taip;0;0;1;1
7011;Pelenė;Drugeliai;3327213856;Taip;12;0;0;12
7012;Pelenė;Drugeliai;6252972353;Taip;10;0;1;11
7013;Pelenė;Drugeliai;1274729537;Taip;0;0;1;1
7014;Pelenė;Drugeliai;1584256570;Taip;0;0;3;3
7015;Pelenė;Drugeliai;3205331614;Taip;0;0;6;6
7016;Pelenė;Drugeliai;8414727016;Taip;19;0;3;22
7017;Pelenė;Drugeliai;5631629419;Ne;11;0;3;14
7018;Pelenė;Drugeliai;2163737781;Taip;0;8;0;8
7019;Pelenė;Drugeliai;9004080625;Ne;14;0;4;18
7020;Pelenė;Drugeliai;7565331966;Taip;11;4;0;15
7021;Pelenė;Drugeliai;5074054534;Taip;5;0;0;5
7022;Pipiras;EŽIUKAI;1485565125;Taip;3;0;0;3
7023;Pipiras;EŽIUKAI;3652741639;Taip;13;0;0;13
7024;Pipiras;EŽIUKAI;1751427121;Taip;4;2;0;6
7025;Pipiras;EŽIUKAI;1293250996;Taip;0;4;0;4
7026;Pipiras;EŽIUKAI;2061168407;Taip;0;2;0;2
7027;Pipiras;EŽIUKAI;8088285579;Taip;2;0;0;2
7028;Pipiras;EŽIUKAI;1082396096;Taip;0;7;0;7
7029;Pipiras;EŽIUKAI;71283505646;Taip;2;0;0;2
7030;Pipiras;EŽIUKAI;1324680675;Taip;0;2;0;2
7031;Pipiras;EŽIUKAI;1876870081;Taip;4;13;0;17
7032;Pipiras;EŽIUKAI;1114377378;Taip;0;5;0;5
7033;Pipiras;EŽIUKAI;1371141047;Taip;0;6;0;6
7034;Pipiras;EŽIUKAI;2096009051;Taip;22;0;0;22
7035;Pipiras;EŽIUKAI;1305696178;Taip;5;0;0;5
7036;Pipiras;EŽIUKAI;23600769349;Taip;0;1;0;1
7037;Pipiras;EŽIUKAI;9275905384;Taip;5;4;0;9
7038;Pipiras;BITUTĖS;5725956659;Taip;5;0;0;5
7039;Pipiras;BITUTĖS;7934365114;Taip;0;3;0;3
7040;Pipiras;BITUTĖS;2075041950;Taip;0;3;0;3
7041;Pipiras;BITUTĖS;9840040112;Ne;0;10;0;10
7042;Pipiras;BITUTĖS;3852848863;Taip;9;0;0;9
7043;Pipiras;BITUTĖS;5235868332;Taip;0;4;0;4
7044;Pipiras;BITUTĖS;7350131214;Taip;0;9;0;9
7045;Pipiras;BITUTĖS;7161727352;Taip;0;1;0;1
7046;Pipiras;BITUTĖS;5225533488;Taip;10;9;0;19
7047;Pipiras;BITUTĖS;5622119207;Taip;0;2;0;2
7048;Pipiras;BITUTĖS;6792777396;Taip;0;2;0;2
7049;Pipiras;BITUTĖS;1784839485;Taip;10;8;0;18
7050;Pipiras;BITUTĖS;3775916247;Ne;3;3;0;6
7051;Pipiras;BITUTĖS;5845498558;Taip;3;5;0;8
7052;Pipiras;BITUTĖS;3882437376;Taip;3;0;0;3
7053;Pipiras;BITUTĖS;9770780973;Taip;20;0;0;20
7054;Pipiras;BITUTĖS;6523189501;Taip;0;19;0;19
7055;Pipiras;BITUTĖS;6780333972;Taip;0;5;0;5
7056;Pipiras;BITUTĖS;1034182352;Taip;0;8;0;8
7057;Pipiras;NYKŠTUKAI;1045583136;Taip;8;4;0;12
7058;Pipiras;NYKŠTUKAI;4811029230;Taip;0;0;9;9
7059;Pipiras;NYKŠTUKAI;6791495556;Taip;0;4;0;4
7060;Pipiras;NYKŠTUKAI;6363349541;Taip;0;8;1;9
7061;Pipiras;NYKŠTUKAI;6685567970;Taip;0;2;1;3
7062;Pipiras;NYKŠTUKAI;4426479971;Taip;0;2;0;2
7063;Pipiras;NYKŠTUKAI;2267192782;Taip;0;12;0;12
7064;Pipiras;NYKŠTUKAI;4725221169;Taip;4;0;0;4
7065;Pipiras;NYKŠTUKAI;5059203266;Taip;5;7;0;12
7066;Pipiras;NYKŠTUKAI;5856735452;Taip;1;0;1;2
7067;Pipiras;NYKŠTUKAI;1353114929;Taip;0;2;0;2
7068;Pipiras;NYKŠTUKAI;8422419380;Taip;0;1;0;1
7069;Pipiras;NYKŠTUKAI;4017042461;Taip;0;16;0;16
7070;Pipiras;NYKŠTUKAI;7425654504;Taip;4;10;0;14
7071;Pipiras;PELĖDŽIUKAI;4428216634;Taip;0;3;0;3
7072;Pipiras;PELĖDŽIUKAI;6694920607;Taip;0;12;0;12
7073;Pipiras;PELĖDŽIUKAI;7870521230;Taip;0;3;0;3
7074;Pipiras;PELĖDŽIUKAI;5778300856;Taip;1;2;0;3
7075;Pipiras;PELĖDŽIUKAI;3888552150;Taip;0;4;0;4
7076;Pipiras;PELĖDŽIUKAI;1391682850;Taip;0;9;0;9
7077;Pipiras;PELĖDŽIUKAI;87924002679;Taip;0;8;0;8
7078;Pipiras;PELĖDŽIUKAI;6136423200;Taip;0;1;1;2
7079;Pipiras;PELĖDŽIUKAI;7912217889;Taip;4;1;0;5
7080;Pipiras;PELĖDŽIUKAI;5502001191;Taip;0;5;1;6
7081;Pipiras;PELĖDŽIUKAI;4496076326;Taip;0;7;0;7
7082;Pipiras;PELĖDŽIUKAI;3141822820;Taip;0;8;0;8
7083;Pipiras;PELĖDŽIUKAI;4456861303;Taip;0;12;0;12
7084;Pipiras;PELĖDŽIUKAI;2044498561;Taip;0;3;0;3
7085;Pipiras;PELĖDŽIUKAI;2240865490;Taip;2;4;0;6
7086;Pipiras;PELĖDŽIUKAI;1144813356;Taip;0;1;0;1
7087;Pipiras;DRUGELIAI;41585818819;Taip;0;2;0;2
7088;Pipiras;DRUGELIAI;7799786844;Taip;7;1;0;8
7089;Pipiras;DRUGELIAI;5014457985;Taip;0;4;0;4
7090;Pipiras;DRUGELIAI;4927845000;Taip;0;1;0;1
7091;Pipiras;DRUGELIAI;1904376366;Taip;0;16;0;16
7092;Pipiras;DRUGELIAI;1128674099;Taip;0;17;0;17
7093;Pipiras;DRUGELIAI;3422170541;Taip;7;2;0;9
7094;Pipiras;DRUGELIAI;1391958633;Taip;0;1;0;1
7095;Pipiras;DRUGELIAI;7784343130;Taip;0;5;0;5
7096;Pipiras;DRUGELIAI;3622164823;Taip;0;22;0;22
7097;Pipiras;DRUGELIAI;3008358842;Ne;0;5;0;5
7098;Pipiras;DRUGELIAI;2024777430;Taip;7;1;0;8
7099;Pipiras;DRUGELIAI;4959823035;Taip;0;1;0;1
7100;Pipiras;DRUGELIAI;6339186940;Taip;0;6;0;6
7101;Pipiras;DRUGELIAI;3314276870;Taip;4;2;0;6
7102;Pipiras;DRUGELIAI;5637557921;Taip;0;11;0;11
7103;Pipiras;DRUGELIAI;1050430252;Ne;4;2;0;6
7104;Pipiras;DRUGELIAI;2255644686;Taip;4;7;0;11
7105;Pipiras;DRUGELIAI;7736031786;Taip;0;6;0;6
7106;Pipiras;DRUGELIAI;6153579332;Taip;0;6;0;6
7107;Pipiras;DRUGELIAI;2402351134;Taip;0;3;0;3
7108;Pipiras;GĖLYTĖS;56325056631;Taip;0;2;0;2
7109;Pipiras;GĖLYTĖS;81335131932;Taip;2;2;0;4
7110;Pipiras;GĖLYTĖS;23377947863;Taip;5;3;0;8
7111;Pipiras;GĖLYTĖS;87831792882;Taip;0;7;0;7
7112;Pipiras;GĖLYTĖS;1417855241;Taip;0;2;0;2
7113;Pipiras;GĖLYTĖS;1791226869;Taip;0;21;0;21
7114;Pipiras;GĖLYTĖS;27808576289;Taip;0;2;0;2
7115;Pipiras;GĖLYTĖS;5114553619;Taip;4;2;0;6
7116;Pipiras;GĖLYTĖS;1780531222;Taip;0;2;2;4
7117;Pipiras;GĖLYTĖS;18211174874;Ne;2;2;0;4
7118;Pipiras;GĖLYTĖS;4246712256;Taip;0;6;0;6
7119;Pipiras;GĖLYTĖS;25000181631;Taip;0;2;2;4
7120;Pipiras;GĖLYTĖS;1650661825;Taip;0;1;0;1
7121;Pipiras;GĖLYTĖS;56822466210;Taip;0;2;1;3
7122;Pipiras;GĖLYTĖS;23663823688;Taip;0;5;0;5
7123;Pipiras;GĖLYTĖS;6481320053;Taip;0;1;0;1
7124;Pipiras;BORUŽĖLĖS;54633757340;Taip;0;2;0;2
7125;Pipiras;BORUŽĖLĖS;68636458010;Taip;0;14;0;14
7126;Pipiras;BORUŽĖLĖS;20456702162;Taip;0;2;1;3
7127;Pipiras;BORUŽĖLĖS;57459408180;Taip;0;22;0;22
7128;Pipiras;BORUŽĖLĖS;9423015002;Taip;0;4;0;4
7129;Pipiras;BORUŽĖLĖS;68235713574;Taip;0;2;0;2
7130;Pipiras;BORUŽĖLĖS;63605758339;Taip;0;0;3;3
7131;Pipiras;BORUŽĖLĖS;23794561369;Taip;0;20;0;20
7132;Pipiras;BORUŽĖLĖS;92764472620;Taip;0;4;0;4
7133;Pipiras;BORUŽĖLĖS;6804964469;Taip;4;0;0;4
7134;Pipiras;BORUŽĖLĖS;7448924569;Taip;0;2;0;2
7135;Pipiras;BORUŽĖLĖS;1676986127;Taip;0;8;0;8
7136;Pipiras;BORUŽĖLĖS;1334584865;Ne;0;0;12;12
7137;Pipiras;BORUŽĖLĖS;9673674008;Taip;4;1;0;5
7138;Pipiras;BORUŽĖLĖS;1657721144;Taip;5;0;3;8
7139;Pipiras;BORUŽĖLĖS;6766596656;Taip;0;7;0;7
7140;Pipiras;SKRUZDĖLIUKAI;7969837759;Taip;0;3;0;3
7141;Pipiras;SKRUZDĖLIUKAI;2483867901;Taip;0;1;0;1
7142;Pipiras;SKRUZDĖLIUKAI;1315372873;Taip;0;6;0;6
7143;Pipiras;SKRUZDĖLIUKAI;9372109848;Taip;0;8;3;11
7144;Pipiras;SKRUZDĖLIUKAI;8296425777;Taip;0;1;0;1
7145;Pipiras;SKRUZDĖLIUKAI;9968182443;Ne;0;2;0;2
7146;Pipiras;SKRUZDĖLIUKAI;8819018248;Taip;0;6;0;6
7147;Pipiras;SKRUZDĖLIUKAI;3768825314;Taip;15;1;0;16
7148;Pipiras;SKRUZDĖLIUKAI;5888429623;Taip;0;3;3;6
7149;Pipiras;SKRUZDĖLIUKAI;4309096743;Taip;5;12;0;17
7150;Pipiras;SKRUZDĖLIUKAI;2399588759;Taip;0;1;0;1
7151;Pipiras;SKRUZDĖLIUKAI;3935474148;Taip;3;2;0;5
7152;Pipiras;SKRUZDĖLIUKAI;8081343184;Taip;8;0;2;10
7153;Pipiras;SKRUZDĖLIUKAI;9852475056;Taip;22;6;0;28
7154;Pipiras;SKRUZDĖLIUKAI;6176818802;Taip;12;1;1;14
7155;Pipiras;SKRUZDĖLIUKAI;6570068615;Taip;0;7;0;7
7156;Pipiras;SKRUZDĖLIUKAI;1215623527;Taip;0;3;0;3
7157;Pipiras;SKRUZDĖLIUKAI;1998249512;Taip;0;0;1;1
7158;Pipiras;SKRUZDĖLIUKAI;9625933545;Taip;0;3;0;3
7159;Pipiras;SKRUZDĖLIUKAI;7211189491;Taip;0;8;0;8
7160;Pipiras;ŽVIRBLIUKŲ;70940029154;Taip;0;2;0;2
7161;Pipiras;ŽVIRBLIUKŲ;1232620336;Taip;0;11;0;11
7162;Pipiras;ŽVIRBLIUKŲ;1549121029;Taip;0;1;0;1
7163;Pipiras;ŽVIRBLIUKŲ;37087220885;Taip;0;5;0;5
7164;Pipiras;ŽVIRBLIUKŲ;1700856741;Taip;5;1;0;6
7165;Pipiras;ŽVIRBLIUKŲ;1757192919;Taip;0;2;5;7
7166;Pipiras;ŽVIRBLIUKŲ;1417086043;Taip;0;8;3;11
7167;Pipiras;ŽVIRBLIUKŲ;1008228932;Taip;4;1;0;5
7168;Pipiras;ŽVIRBLIUKŲ;2030665851;Taip;0;7;0;7
7169;Pipiras;ŽVIRBLIUKŲ;1182415963;Taip;0;0;12;12
7170;Pipiras;ŽVIRBLIUKŲ;8657924258;Taip;0;8;0;8
7171;Pipiras;ŽVIRBLIUKŲ;66816368717;Taip;0;2;0;2
7172;Pipiras;ŽVIRBLIUKŲ;6340323302;Ne;0;0;2;2
7173;Pipiras;ŽVIRBLIUKŲ;22190236403;Taip;0;3;1;4
7174;Pipiras;ŽVIRBLIUKŲ;5445858240;Taip;0;5;0;5
7175;Pipiras;ŽVIRBLIUKŲ;1242260242;Taip;0;2;0;2
7176;Pipiras;ŽVIRBLIUKŲ;4266424785;Taip;0;7;0;7
7177;Pipiras;ŽVIRBLIUKŲ;3421769229;Taip;0;7;0;7
7178;Pipiras;ŽVIRBLIUKŲ;8520454289;Taip;0;6;0;6
7179;Pipiras;ŽVIRBLIUKŲ;5422547144;Taip;0;8;0;8
7180;Pipiras;ZUIKUČIŲ;1146369304;Taip;0;0;5;5
7181;Pipiras;ZUIKUČIŲ;6310054093;Taip;5;3;0;8
7182;Pipiras;ZUIKUČIŲ;5137132420;Taip;3;4;0;7
7183;Pipiras;ZUIKUČIŲ;6034298583;Taip;0;6;2;8
7184;Pipiras;ZUIKUČIŲ;5968015502;Taip;0;4;0;4
7185;Pipiras;ZUIKUČIŲ;4086728233;Taip;3;0;1;4
7186;Pipiras;ZUIKUČIŲ;8508292428;Taip;0;2;0;2
7187;Pipiras;ZUIKUČIŲ;1210940213;Taip;4;1;0;5
7188;Pipiras;ZUIKUČIŲ;3531862496;Taip;0;1;2;3
7189;Pipiras;ZUIKUČIŲ;8959946514;Taip;9;0;1;10
7190;Pipiras;ZUIKUČIŲ;8260680662;Taip;0;7;0;7
7191;Pipiras;ZUIKUČIŲ;9396979045;Taip;7;0;0;7
7192;Pipiras;VARLIUKŲ;8675473349;Taip;0;4;0;4
7193;Pipiras;VARLIUKŲ;4945164161;Taip;10;11;0;21
7194;Pipiras;VARLIUKŲ;6453274205;Taip;0;1;0;1
7195;Pipiras;VARLIUKŲ;7157187063;Taip;6;8;0;14
7196;Pipiras;VARLIUKŲ;4021613243;Taip;0;6;0;6
7197;Pipiras;VARLIUKŲ;1611488078;Taip;0;1;0;1
7198;Pipiras;VARLIUKŲ;4236597883;Taip;0;0;1;1
7199;Pipiras;VARLIUKŲ;4289497197;Taip;0;3;0;3
7200;Pipiras;VARLIUKŲ;2474548836;Taip;5;6;0;11
7201;Pipiras;VARLIUKŲ;5738334591;Taip;0;6;0;6
7202;Pipiras;VARLIUKŲ;6428525902;Taip;0;1;0;1
7203;Pipiras;VARLIUKŲ;4559954910;Taip;0;4;4;8
7204;Pipiras;VARLIUKŲ;8553422709;Taip;7;0;0;7
7205;Pipiras;VARLIUKŲ;3755824911;Taip;0;2;1;3
7206;Pipiras;VARLIUKŲ;5150723052;Taip;0;1;0;1
7207;Pipiras;ŽIOGELIŲ;6696824728;Taip;2;1;0;3
7208;Pipiras;ŽIOGELIŲ;4510888337;Taip;0;12;0;12
7209;Pipiras;ŽIOGELIŲ;3980950261;Taip;0;1;4;5
7210;Pipiras;ŽIOGELIŲ;5908707752;Ne;0;1;0;1
7211;Pipiras;ŽIOGELIŲ;6775489564;Taip;6;0;0;6
7212;Pipiras;ŽIOGELIŲ;9892201598;Taip;0;4;0;4
7213;Pipiras;ŽIOGELIŲ;1019753152;Taip;6;1;0;7
7214;Pipiras;ŽIOGELIŲ;4198534687;Taip;2;0;0;2
7215;Pipiras;ŽIOGELIŲ;7371386368;Taip;3;1;2;6
7216;Pipiras;ŽIOGELIŲ;7747049622;Taip;11;0;0;11
7217;Pipiras;ŽIOGELIŲ;8689174023;Taip;8;0;0;8
7218;Pipiras;ŽIOGELIŲ;4458730479;Taip;8;1;1;10
7219;Pipiras;ŽIOGELIŲ;9248925267;Taip;6;1;0;7
7220;Pipiras;ŽIOGELIŲ;7828638329;Taip;0;0;4;4
7221;Pipiras;ŽIOGELIŲ;1169481984;Taip;18;1;0;19
7222;"Prie pasakų parko";ZUIKUČIAI;6606867989;Taip;4;0;1;5
7223;"Prie pasakų parko";ZUIKUČIAI;8685140364;Taip;0;15;0;15
7224;"Prie pasakų parko";ZUIKUČIAI;1734916661;Ne;8;0;0;8
7225;"Prie pasakų parko";ZUIKUČIAI;2206221105;Taip;0;0;2;2
7226;"Prie pasakų parko";ZUIKUČIAI;3038164555;Taip;3;0;0;3
7227;"Prie pasakų parko";ZUIKUČIAI;4183640714;Taip;6;0;3;9
7228;"Prie pasakų parko";ZUIKUČIAI;4380468764;Taip;15;0;3;18
7229;"Prie pasakų parko";ZUIKUČIAI;9225775914;Taip;2;0;0;2
7230;"Prie pasakų parko";ZUIKUČIAI;8493622886;Taip;5;2;0;7
7231;"Prie pasakų parko";ZUIKUČIAI;4457827262;Taip;8;0;1;9
7232;"Prie pasakų parko";PAUKŠČIUKŲ;6700916147;Taip;9;2;1;12
7233;"Prie pasakų parko";PAUKŠČIUKŲ;3381053227;Taip;10;0;1;11
7234;"Prie pasakų parko";PAUKŠČIUKŲ;6733793491;Taip;22;0;0;22
7235;"Prie pasakų parko";PAUKŠČIUKŲ;4726737519;Taip;7;9;6;22
7236;"Prie pasakų parko";PAUKŠČIUKŲ;1811994592;Taip;0;0;1;1
7237;"Prie pasakų parko";PAUKŠČIUKŲ;2515928623;Taip;4;0;0;4
7238;"Prie pasakų parko";PAUKŠČIUKŲ;2654978735;Taip;14;0;6;20
7239;"Prie pasakų parko";PAUKŠČIUKŲ;3202292611;Ne;0;6;0;6
7240;"Prie pasakų parko";PAUKŠČIUKŲ;7739970115;Taip;8;0;4;12
7241;"Prie pasakų parko";NYKŠTUKŲ;6992830082;Taip;0;6;0;6
7242;"Prie pasakų parko";NYKŠTUKŲ;1588062393;Taip;0;0;4;4
7243;"Prie pasakų parko";NYKŠTUKŲ;1278065349;Taip;0;0;1;1
7244;"Prie pasakų parko";NYKŠTUKŲ;8574432191;Taip;0;0;2;2
7245;"Prie pasakų parko";NYKŠTUKŲ;8189217660;Taip;0;3;0;3
7246;"Prie pasakų parko";NYKŠTUKŲ;8215830508;Ne;0;4;0;4
7247;"Prie pasakų parko";NYKŠTUKŲ;4548803933;Taip;0;0;1;1
7248;"Prie pasakų parko";NYKŠTUKŲ;5304082676;Taip;2;0;20;22
7249;"Prie pasakų parko";NYKŠTUKŲ;6250610187;Taip;11;2;0;13
7250;"Prie pasakų parko";NYKŠTUKŲ;3504938510;Taip;7;9;0;16
7251;"Prie pasakų parko";NYKŠTUKŲ;9190379838;Taip;0;0;9;9
7252;"Prie pasakų parko";NYKŠTUKŲ;2825614921;Taip;14;0;0;14
7253;"Prie pasakų parko";LAŠELIŲ;8205731591;Taip;0;0;8;8
7254;"Prie pasakų parko";LAŠELIŲ;34800098950;Taip;0;0;1;1
7255;"Prie pasakų parko";LAŠELIŲ;8618280811;Taip;21;0;0;21
7256;"Prie pasakų parko";LAŠELIŲ;7844351275;Taip;0;0;1;1
7257;"Prie pasakų parko";LAŠELIŲ;6273733995;Taip;4;2;0;6
7258;"Prie pasakų parko";LAŠELIŲ;1369637618;Taip;0;0;2;2
7259;"Prie pasakų parko";"KAČIUKAI (SPEC)";6772736175;Taip;3;0;2;5
7260;"Prie pasakų parko";"KAČIUKAI (SPEC)";9715586563;Ne;0;0;8;8
7261;"Prie pasakų parko";"KAČIUKAI (SPEC)";5847625697;Taip;2;0;7;9
7262;"Prie pasakų parko";"KAČIUKAI (SPEC)";6215345468;Ne;0;0;3;3
7263;"Prie pasakų parko";"KAČIUKAI (SPEC)";2590693851;Taip;0;0;1;1
7264;"Prie pasakų parko";"KAČIUKAI (SPEC)";3949671257;Taip;4;0;0;4
7265;"Prie pasakų parko";"KAČIUKAI (SPEC)";1621710265;Ne;0;0;2;2
7266;"Prie pasakų parko";"ŽVAIGŽDUTĖS  (SPEC)";1828638638;Taip;8;0;1;9
7267;"Prie pasakų parko";"ŽVAIGŽDUTĖS  (SPEC)";5356005675;Taip;7;12;0;19
7268;"Prie pasakų parko";"ŽVAIGŽDUTĖS  (SPEC)";5641148690;Taip;0;14;0;14
7269;"Prie pasakų parko";"ŽVAIGŽDUTĖS  (SPEC)";7216751216;Taip;3;0;2;5
7270;"Prie pasakų parko";"ŽVAIGŽDUTĖS  (SPEC)";4037594669;Taip;0;4;0;4
7271;"Prie pasakų parko";"ŽVAIGŽDUTĖS  (SPEC)";9594976173;Ne;8;0;1;9
7272;"Prie pasakų parko";"ŽVAIGŽDUTĖS  (SPEC)";9072312203;Taip;1;0;0;1
7273;"Prie pasakų parko";"ŽVAIGŽDUTĖS  (SPEC)";1480630298;Taip;0;0;3;3
7274;"Prie pasakų parko";"ŽVAIGŽDUTĖS  (SPEC)";5006152810;Taip;2;0;0;2
7275;"Prie pasakų parko";"ANČIUKAI (SPEC)";9469871636;Ne;4;0;2;6
7276;"Prie pasakų parko";"ANČIUKAI (SPEC)";6245610875;Taip;0;2;0;2
7277;"Prie pasakų parko";"ANČIUKAI (SPEC)";8339335908;Taip;9;0;4;13
7278;"Prie pasakų parko";"ANČIUKAI (SPEC)";1602034295;Taip;0;0;15;15
7279;"Prie pasakų parko";"ANČIUKAI (SPEC)";5518041213;Taip;0;0;1;1
7280;"Prie pasakų parko";"ANČIUKAI (SPEC)";6802898184;Taip;0;0;1;1
7281;"Prie pasakų parko";"ANČIUKAI (SPEC)";9529949992;Taip;0;22;0;22
7282;"Prie pasakų parko";"ANČIUKAI (SPEC)";6431918357;Taip;0;0;9;9
7283;"Prie pasakų parko";"ANČIUKAI (SPEC)";1190509858;Taip;0;0;9;9
7284;"Prie pasakų parko";"ANČIUKAI (SPEC)";5504180016;Ne;0;0;10;10
7285;"Prie pasakų parko";TIGRIUKAI;7858530013;Taip;0;12;0;12
7286;"Prie pasakų parko";TIGRIUKAI;4521556853;Taip;0;0;2;2
7287;"Prie pasakų parko";TIGRIUKAI;2641473764;Taip;0;6;1;7
7288;"Prie pasakų parko";TIGRIUKAI;3918269702;Taip;19;0;2;21
7289;"Prie pasakų parko";TIGRIUKAI;2516448580;Taip;3;10;0;13
7290;"Prie pasakų parko";TIGRIUKAI;6446562388;Taip;16;2;0;18
7291;"Prie pasakų parko";TIGRIUKAI;2168919559;Taip;3;8;0;11
7292;"Prie pasakų parko";TIGRIUKAI;6710735721;Taip;5;0;0;5
7293;"Prie pasakų parko";TIGRIUKAI;2898016639;Taip;0;0;1;1
7294;"Prie pasakų parko";TIGRIUKAI;6561145380;Taip;8;0;0;8
7295;"Prie pasakų parko";TIGRIUKAI;8029428034;Taip;0;7;0;7
7296;"Prie pasakų parko";TIGRIUKAI;8715851643;Taip;15;0;0;15
7297;"Prie pasakų parko";TIGRIUKAI;3617673265;Taip;0;0;3;3
7298;"Prie pasakų parko";"EŽIUKŲ (SPEC)";7851357992;Ne;9;0;8;17
7299;"Prie pasakų parko";"EŽIUKŲ (SPEC)";2820889357;Ne;6;10;0;16
7300;"Prie pasakų parko";"EŽIUKŲ (SPEC)";1549137154;Taip;0;0;1;1
7301;"Prie pasakų parko";"EŽIUKŲ (SPEC)";7545372781;Ne;0;0;4;4
7302;"Prie pasakų parko";"EŽIUKŲ (SPEC)";29445903073;Taip;0;7;0;7
7303;"Prie pasakų parko";"EŽIUKŲ (SPEC)";7327208141;Ne;22;0;0;22
7304;"Prie pasakų parko";"EŽIUKŲ (SPEC)";7115825217;Taip;0;0;2;2
7305;"Prie pasakų parko";"EŽIUKŲ (SPEC)";2952868428;Taip;4;0;3;7
7306;"Prie pasakų parko";"EŽIUKŲ (SPEC)";8738488104;Taip;0;0;2;2
7307;"Prie pasakų parko";"BORUŽIUKŲ (SPEC)";8817950372;Taip;0;1;0;1
7308;"Prie pasakų parko";"BORUŽIUKŲ (SPEC)";4203385836;Taip;0;2;0;2
7309;"Prie pasakų parko";"BORUŽIUKŲ (SPEC)";92307951922;Taip;3;6;0;9
7310;"Prie pasakų parko";"BORUŽIUKŲ (SPEC)";1212865434;Ne;0;4;0;4
7311;"Prie pasakų parko";"BORUŽIUKŲ (SPEC)";2864615561;Ne;5;0;1;6
7312;"Prie pasakų parko";SAULYTĖS;6361878877;Taip;14;0;0;14
7313;"Prie pasakų parko";SAULYTĖS;6762267582;Taip;8;0;1;9
7314;"Prie pasakų parko";SAULYTĖS;5494350183;Taip;0;3;0;3
7315;"Prie pasakų parko";SAULYTĖS;5102718403;Taip;0;0;7;7
7316;"Prie pasakų parko";SAULYTĖS;8285260113;Taip;0;0;7;7
7317;"Prie pasakų parko";SAULYTĖS;7459673719;Taip;2;4;2;8
7318;"Prie pasakų parko";SAULYTĖS;4351705573;Taip;0;0;2;2
7319;"Prie pasakų parko";SAULYTĖS;7390391804;Taip;0;1;0;1
7320;"Prie pasakų parko";SAULYTĖS;4589130143;Taip;0;0;7;7
7321;"Prie pasakų parko";SAULYTĖS;2731544174;Taip;2;0;0;2
7322;Pumpurėlis;RAMUNĖLIŲ;7610949816;Taip;0;0;3;3
7323;Pumpurėlis;RAMUNĖLIŲ;6165833101;Taip;0;2;0;2
7324;Pumpurėlis;RAMUNĖLIŲ;6977710645;Taip;9;0;0;9
7325;Pumpurėlis;RAMUNĖLIŲ;9431295796;Taip;4;0;3;7
7326;Pumpurėlis;RAMUNĖLIŲ;1395380236;Taip;0;6;8;14
7327;Pumpurėlis;RAMUNĖLIŲ;9424449290;Taip;0;13;0;13
7328;Pumpurėlis;RAMUNĖLIŲ;6955168163;Taip;0;0;8;8
7329;Pumpurėlis;RAMUNĖLIŲ;5171198109;Taip;0;0;3;3
7330;Pumpurėlis;RAMUNĖLIŲ;9726028397;Taip;0;0;1;1
7331;Pumpurėlis;RAMUNĖLIŲ;7229289985;Taip;0;0;8;8
7332;Pumpurėlis;RAMUNĖLIŲ;2969734731;Taip;0;0;2;2
7333;Pumpurėlis;RAMUNĖLIŲ;7559071945;Taip;0;0;1;1
7334;Pumpurėlis;RAMUNĖLIŲ;3953103488;Taip;0;0;2;2
7335;Pumpurėlis;RAMUNĖLIŲ;3838705973;Taip;13;0;4;17
7336;Pumpurėlis;RAMUNĖLIŲ;6726875853;Taip;0;6;0;6
7337;Pumpurėlis;RAMUNĖLIŲ;7996736781;Taip;3;10;0;13
7338;Pumpurėlis;RAMUNĖLIŲ;8667762689;Taip;1;7;0;8
7339;Pumpurėlis;RAMUNĖLIŲ;3874188848;Taip;0;0;10;10
7340;Pumpurėlis;RAMUNĖLIŲ;2233224512;Taip;0;0;11;11
7341;Pumpurėlis;RAMUNĖLIŲ;7619709360;Taip;0;0;9;9
7342;Pumpurėlis;VARPELIŲ;3101133244;Taip;12;0;0;12
7343;Pumpurėlis;VARPELIŲ;3893768713;Taip;0;17;0;17
7344;Pumpurėlis;VARPELIŲ;5023658988;Taip;0;1;3;4
7345;Pumpurėlis;VARPELIŲ;2668855786;Taip;0;5;9;14
7346;Pumpurėlis;VARPELIŲ;8258560345;Taip;0;7;0;7
7347;Pumpurėlis;VARPELIŲ;9612924972;Taip;0;1;0;1
7348;Pumpurėlis;VARPELIŲ;9884099545;Taip;3;6;1;10
7349;Pumpurėlis;VARPELIŲ;3733509497;Taip;13;0;0;13
7350;Pumpurėlis;VARPELIŲ;4508966729;Taip;4;0;4;8
7351;Pumpurėlis;VARPELIŲ;9552913910;Taip;12;0;4;16
7352;Pumpurėlis;VARPELIŲ;5196733185;Taip;15;0;1;16
7353;Pumpurėlis;VARPELIŲ;4928495108;Taip;0;0;3;3
7354;Pumpurėlis;VARPELIŲ;8886730333;Taip;3;6;0;9
7355;Pumpurėlis;VARPELIŲ;2247300456;Taip;5;3;0;8
7356;Pumpurėlis;VARPELIŲ;5564680653;Taip;0;0;6;6
7357;Pumpurėlis;VARPELIŲ;1411232443;Taip;0;4;3;7
7358;Pumpurėlis;VARPELIŲ;8525537588;Ne;0;1;1;2
7359;Pumpurėlis;VARPELIŲ;2103139845;Taip;7;0;0;7
7360;Pumpurėlis;VARPELIŲ;6780042929;Taip;0;15;0;15
7361;Pumpurėlis;VARPELIŲ;7182107790;Taip;0;0;3;3
7362;Pumpurėlis;DRUGELIŲ;1230058211;Ne;0;3;0;3
7363;Pumpurėlis;DRUGELIŲ;1053338730;Taip;4;0;2;6
7364;Pumpurėlis;DRUGELIŲ;1397924008;Taip;0;10;0;10
7365;Pumpurėlis;DRUGELIŲ;6230500803;Taip;0;0;5;5
7366;Pumpurėlis;DRUGELIŲ;2129779614;Taip;0;6;0;6
7367;Pumpurėlis;DRUGELIŲ;2102427499;Taip;0;1;1;2
7368;Pumpurėlis;DRUGELIŲ;9724549899;Taip;0;0;3;3
7369;Pumpurėlis;DRUGELIŲ;9317495169;Taip;0;12;0;12
7370;Pumpurėlis;DRUGELIŲ;6535398274;Ne;0;1;0;1
7371;Pumpurėlis;DRUGELIŲ;9078991043;Ne;0;0;7;7
7372;Pumpurėlis;DRUGELIŲ;9733380187;Taip;0;0;2;2
7373;Pumpurėlis;DRUGELIŲ;83388662869;Taip;0;4;0;4
7374;Pumpurėlis;DRUGELIŲ;7123915287;Taip;0;0;1;1
7375;Pumpurėlis;DRUGELIŲ;1690424790;Taip;0;2;2;4
7376;Pumpurėlis;DRUGELIŲ;1306102772;Taip;7;0;3;10
7377;Pumpurėlis;KODĖLČIUKŲ;9224879966;Taip;9;0;2;11
7378;Pumpurėlis;KODĖLČIUKŲ;2468796972;Taip;0;3;0;3
7379;Pumpurėlis;KODĖLČIUKŲ;8830261792;Taip;0;1;0;1
7380;Pumpurėlis;KODĖLČIUKŲ;9583257172;Taip;3;2;3;8
7381;Pumpurėlis;KODĖLČIUKŲ;7533555059;Taip;0;0;4;4
7382;Pumpurėlis;KODĖLČIUKŲ;6669327226;Taip;0;6;0;6
7383;Pumpurėlis;KODĖLČIUKŲ;13952236905;Taip;0;1;0;1
7384;Pumpurėlis;KODĖLČIUKŲ;87061817106;Taip;0;1;0;1
7385;Pumpurėlis;KODĖLČIUKŲ;1835168438;Taip;0;1;1;2
7386;Pumpurėlis;KODĖLČIUKŲ;5615260965;Taip;0;2;1;3
7387;Pumpurėlis;KODĖLČIUKŲ;4344595328;Taip;0;17;0;17
7388;Pumpurėlis;KODĖLČIUKŲ;8806961007;Taip;0;0;11;11
7389;Pumpurėlis;KODĖLČIUKŲ;5964953923;Taip;0;2;3;5
7390;Pumpurėlis;KODĖLČIUKŲ;1492810528;Taip;8;0;8;16
7391;Pumpurėlis;KODĖLČIUKŲ;7566451857;Ne;0;14;0;14
7392;Pumpurėlis;KODĖLČIUKŲ;8747439652;Taip;0;0;2;2
7393;Pumpurėlis;KODĖLČIUKŲ;2629702959;Taip;0;6;0;6
7394;Pumpurėlis;LINELIS;98061041685;Taip;11;10;0;21
7395;Pumpurėlis;LINELIS;1307929787;Taip;2;1;0;3
7396;Pumpurėlis;LINELIS;1921332565;Taip;0;3;4;7
7397;Pumpurėlis;LINELIS;40267078306;Taip;0;7;0;7
7398;Pumpurėlis;LINELIS;1273831078;Taip;7;1;0;8
7399;Pumpurėlis;LINELIS;1439043505;Taip;0;1;1;2
7400;Pumpurėlis;LINELIS;1055683170;Taip;3;0;0;3
7401;Pumpurėlis;LINELIS;94636926281;Taip;0;1;0;1
7402;Pumpurėlis;LINELIS;51793437519;Taip;0;2;0;2
7403;Pumpurėlis;LINELIS;1287902351;Taip;0;1;0;1
7404;Pumpurėlis;LINELIS;1511761574;Taip;0;1;0;1
7405;Pumpurėlis;LINELIS;1027125361;Taip;0;0;2;2
7406;Pumpurėlis;LINELIS;1620037477;Taip;0;6;0;6
7407;Pumpurėlis;LINELIS;1867989314;Taip;6;0;0;6
7408;Pumpurėlis;LINELIS;13358453137;Taip;0;0;1;1
7409;Pumpurėlis;LINELIS;1209654095;Taip;0;5;0;5
7410;Pumpurėlis;LINELIS;88732170322;Taip;0;1;5;6
7411;Pumpurėlis;SAULUTĖS;8230735535;Ne;15;0;0;15
7412;Pumpurėlis;SAULUTĖS;14529305564;Taip;0;0;1;1
7413;Pumpurėlis;SAULUTĖS;1910114048;Taip;0;0;2;2
7414;Pumpurėlis;SAULUTĖS;1274293175;Taip;0;4;0;4
7415;Pumpurėlis;SAULUTĖS;1298302188;Taip;10;4;0;14
7416;Pumpurėlis;SAULUTĖS;3231167303;Taip;5;0;0;5
7417;Pumpurėlis;SAULUTĖS;1333429949;Taip;5;0;0;5
7418;Pumpurėlis;SAULUTĖS;1255753542;Taip;16;0;0;16
7419;Pumpurėlis;SAULUTĖS;71979455611;Taip;0;1;0;1
7420;Pumpurėlis;SAULUTĖS;1527144198;Taip;0;1;0;1
7421;Pumpurėlis;SAULUTĖS;2028515310;Taip;0;1;0;1
7422;Pumpurėlis;SAULUTĖS;74144468541;Taip;0;6;0;6
7423;Pumpurėlis;SAULUTĖS;7786926187;Taip;4;0;0;4
7424;Pumpurėlis;SAULUTĖS;26859673794;Taip;3;10;0;13
7425;Pumpurėlis;SAULUTĖS;57949968899;Taip;0;0;4;4
7426;Pumpurėlis;BITUTĖS;4419940231;Taip;0;16;0;16
7427;Pumpurėlis;BITUTĖS;4985045047;Taip;13;0;1;14
7428;Pumpurėlis;BITUTĖS;2651037375;Ne;3;0;1;4
7429;Pumpurėlis;BITUTĖS;1768239820;Taip;0;0;1;1
7430;Pumpurėlis;BITUTĖS;2566557351;Taip;16;0;0;16
7431;Pumpurėlis;BITUTĖS;4426697956;Taip;3;0;7;10
7432;Pumpurėlis;BITUTĖS;7363814444;Taip;0;6;0;6
7433;Pumpurėlis;BITUTĖS;3405169131;Taip;7;2;1;10
7434;Pumpurėlis;BITUTĖS;3951445693;Taip;9;0;4;13
7435;Pumpurėlis;BITUTĖS;8505655534;Taip;0;1;9;10
7436;Pumpurėlis;BITUTĖS;9612924316;Taip;8;1;0;9
7437;Pumpurėlis;BITUTĖS;5194285627;Taip;0;1;0;1
7438;Pumpurėlis;BITUTĖS;8655389224;Taip;10;1;0;11
7439;Pumpurėlis;BITUTĖS;1674341906;Taip;0;3;0;3
7440;Pumpurėlis;BITUTĖS;1130280140;Taip;0;0;16;16
7441;Pumpurėlis;BITUTĖS;3842632260;Taip;0;4;0;4
7442;Pumpurėlis;DOBILIUKAI;1839505206;Taip;0;10;0;10
7443;Pumpurėlis;DOBILIUKAI;3970253545;Taip;0;0;7;7
7444;Pumpurėlis;DOBILIUKAI;1808734330;Taip;11;0;0;11
7445;Pumpurėlis;DOBILIUKAI;6968264923;Taip;9;3;0;12
7446;Pumpurėlis;DOBILIUKAI;7038597556;Taip;0;10;0;10
7447;Pumpurėlis;DOBILIUKAI;4130539703;Ne;0;1;0;1
7448;Pumpurėlis;DOBILIUKAI;3374174445;Taip;3;4;0;7
7449;Pumpurėlis;DOBILIUKAI;1961282282;Taip;3;0;0;3
7450;Pumpurėlis;DOBILIUKAI;5438584331;Taip;0;1;0;1
7451;Pumpurėlis;DOBILIUKAI;7276322999;Taip;8;0;0;8
7452;Pumpurėlis;DOBILIUKAI;9058493247;Taip;5;1;1;7
7453;Pumpurėlis;DOBILIUKAI;2028068230;Taip;0;0;2;2
7454;Pumpurėlis;DOBILIUKAI;5444879430;Taip;5;0;0;5
7455;Pumpurėlis;DOBILIUKAI;7825190756;Taip;4;0;3;7
7456;Pumpurėlis;DOBILIUKAI;1438740562;Taip;6;0;0;6
7457;Pumpurėlis;PUPYČIŲ;2368226822;Taip;9;1;0;10
7458;Pumpurėlis;PUPYČIŲ;7078621340;Taip;12;0;0;12
7459;Pumpurėlis;PUPYČIŲ;9417688597;Taip;0;0;1;1
7460;Pumpurėlis;PUPYČIŲ;5835115428;Taip;0;0;1;1
7461;Pumpurėlis;PUPYČIŲ;2132563531;Taip;0;5;0;5
7462;Pumpurėlis;PUPYČIŲ;1538548768;Taip;0;0;22;22
7463;Pumpurėlis;PUPYČIŲ;7832408524;Taip;9;6;0;15
7464;Pumpurėlis;PUPYČIŲ;8644853849;Taip;2;0;2;4
7465;Pumpurėlis;PUPYČIŲ;9996789041;Taip;0;0;3;3
7466;Pumpurėlis;PUPYČIŲ;9640790401;Taip;11;0;4;15
7467;Pumpurėlis;PUPYČIŲ;9032255874;Taip;13;0;4;17
7468;Pumpurėlis;PUPYČIŲ;5928552565;Taip;5;0;1;6
7469;Pumpurėlis;PUPYČIŲ;7055989095;Taip;0;16;0;16
7470;Pumpurėlis;PUPYČIŲ;3088476130;Taip;4;0;0;4
7471;Pumpurėlis;ŽIRNIUKŲ;6004234378;Taip;7;0;3;10
7472;Pumpurėlis;ŽIRNIUKŲ;3534133061;Taip;9;0;0;9
7473;Pumpurėlis;ŽIRNIUKŲ;6978091765;Taip;13;0;0;13
7474;Pumpurėlis;ŽIRNIUKŲ;8070486897;Taip;3;0;1;4
7475;Pumpurėlis;ŽIRNIUKŲ;9839285886;Taip;0;7;0;7
7476;Pumpurėlis;ŽIRNIUKŲ;6702744879;Taip;4;0;5;9
7477;Pumpurėlis;ŽIRNIUKŲ;6117720533;Taip;7;0;0;7
7478;Pumpurėlis;ŽIRNIUKŲ;2890596967;Taip;11;0;0;11
7479;Pumpurėlis;ŽIRNIUKŲ;7685203905;Taip;0;0;8;8
7480;Pumpurėlis;ŽIRNIUKŲ;3328647987;Taip;0;0;4;4
7481;Pumpurėlis;ŽIRNIUKŲ;9650395309;Taip;4;0;0;4
7482;Pumpurėlis;ŽIRNIUKŲ;4196409137;Taip;6;0;1;7
7483;Pumpurėlis;ŽIRNIUKŲ;3563609848;Taip;22;0;0;22
7484;Pumpurėlis;BORUŽĖLIŲ;49767198843;Taip;0;0;1;1
7485;Pumpurėlis;BORUŽĖLIŲ;68035717481;Taip;8;0;0;8
7486;Pumpurėlis;BORUŽĖLIŲ;1594436797;Taip;0;0;2;2
7487;Pumpurėlis;BORUŽĖLIŲ;1568701327;Taip;7;6;0;13
7488;Pumpurėlis;BORUŽĖLIŲ;1842097360;Taip;0;0;1;1
7489;Pumpurėlis;BORUŽĖLIŲ;82659096039;Taip;0;3;0;3
7490;Pumpurėlis;BORUŽĖLIŲ;1098875585;Taip;0;2;1;3
7491;Pumpurėlis;BORUŽĖLIŲ;1034745510;Taip;3;0;1;4
7492;Pumpurėlis;BORUŽĖLIŲ;5364345261;Taip;0;0;2;2
7493;Pumpurėlis;BORUŽĖLIŲ;1617303626;Taip;0;1;0;1
7494;Pumpurėlis;BORUŽĖLIŲ;1508245418;Taip;3;0;4;7
7495;Pumpurėlis;BORUŽĖLIŲ;81595634697;Taip;6;0;0;6
7496;Pumpurėlis;BORUŽĖLIŲ;1061975374;Taip;0;9;0;9
7497;Pumpurėlis;BORUŽĖLIŲ;5013491568;Taip;0;10;0;10
7498;Pumpurėlis;BORUŽĖLIŲ;7488342792;Taip;4;0;3;7
7499;Pumpurėlis;BORUŽĖLIŲ;6412442729;Taip;22;0;0;22
7500;Pumpurėlis;"NAUJA DARŽELIS";6604801631;Taip;0;0;3;3
7501;Pumpurėlis;"NAUJA DARŽELIS";6212212516;Taip;0;11;2;13
7502;Pumpurėlis;"NAUJA DARŽELIS";6614797909;Taip;4;0;1;5
7503;Pumpurėlis;"NAUJA DARŽELIS";3871151401;Taip;6;0;0;6
7504;Pumpurėlis;"NAUJA DARŽELIS";3085309902;Taip;0;0;3;3
7505;Pumpurėlis;"NAUJA DARŽELIS";5212827184;Taip;2;0;1;3
7506;Pumpurėlis;"NAUJA DARŽELIS";6557857672;Taip;10;0;3;13
7507;Pumpurėlis;"NAUJA DARŽELIS";7813696919;Taip;0;2;3;5
7508;Pumpurėlis;"NAUJA DARŽELIS";5278250113;Taip;0;1;7;8
7509;Pumpurėlis;"NAUJA DARŽELIS";3492977569;Taip;4;0;2;6
7510;Pumpurėlis;"NAUJA DARŽELIS";9363610488;Taip;0;6;0;6
7511;Pumpurėlis;"NAUJA DARŽELIS";6959214331;Taip;0;3;0;3
7512;Pumpurėlis;"NAUJA DARŽELIS";2905797053;Taip;0;8;4;12
7513;Pumpurėlis;"NAUJA DARŽELIS";2026021360;Taip;7;0;3;10
7514;Pumpurėlis;"NAUJA DARŽELIS";8380689261;Taip;0;0;5;5
7515;Pumpurėlis;"NAUJA DARŽELIS";4964949574;Taip;1;8;4;13
7516;Pumpurėlis;"NAUJA DARŽELIS";6483338028;Taip;0;0;2;2
7517;Puriena;Ančiukų;1758690169;Taip;2;4;0;6
7518;Puriena;Ančiukų;25112307864;Taip;0;2;0;2
7519;Puriena;Ančiukų;1240190350;Taip;0;4;0;4
7520;Puriena;Ančiukų;1557814435;Taip;0;0;5;5
7521;Puriena;Ančiukų;87523460146;Taip;0;1;0;1
7522;Puriena;Ančiukų;61241768982;Taip;0;5;0;5
7523;Puriena;Ančiukų;26980342372;Ne;0;1;0;1
7524;Puriena;Ančiukų;4260334053;Taip;0;7;0;7
7525;Puriena;Ančiukų;71778035373;Taip;8;5;0;13
7526;Puriena;Ančiukų;1184946421;Taip;0;13;0;13
7527;Puriena;Ančiukų;59193676476;Taip;0;2;0;2
7528;Puriena;Ančiukų;61117212576;Taip;0;0;4;4
7529;Puriena;Ančiukų;1418776789;Taip;0;0;3;3
7530;Puriena;Ančiukų;3327714361;Taip;0;3;0;3
7531;Puriena;Ančiukų;9684727228;Taip;0;0;4;4
7532;Puriena;Ančiukų;1318752282;Taip;0;0;4;4
7533;Puriena;Drugeliai;2966464432;Taip;5;2;0;7
7534;Puriena;Drugeliai;4760827000;Taip;4;0;0;4
7535;Puriena;Drugeliai;8881337164;Taip;6;1;0;7
7536;Puriena;Drugeliai;6914613438;Taip;0;6;0;6
7537;Puriena;Drugeliai;1121312813;Taip;0;2;5;7
7538;Puriena;Drugeliai;2321753665;Taip;0;0;2;2
7539;Puriena;Drugeliai;7021756459;Taip;4;0;0;4
7540;Puriena;Drugeliai;1564155036;Taip;0;0;3;3
7541;Puriena;Drugeliai;9098291788;Taip;0;4;0;4
7542;Puriena;Drugeliai;6613654824;Taip;3;4;3;10
7543;Puriena;Drugeliai;3738277048;Ne;0;12;0;12
7544;Puriena;Drugeliai;3579008577;Taip;0;7;0;7
7545;Puriena;Drugeliai;4248701232;Taip;0;0;14;14
7546;Puriena;Drugeliai;7477278612;Taip;0;2;0;2
7547;Puriena;Drugeliai;9847768390;Taip;5;4;1;10
7548;Puriena;Drugeliai;1455237224;Taip;0;0;1;1
7549;Puriena;Pelėdžiukai;8874823029;Taip;4;4;0;8
7550;Puriena;Pelėdžiukai;3149718901;Taip;0;2;4;6
7551;Puriena;Pelėdžiukai;3175917649;Ne;0;0;2;2
7552;Puriena;Pelėdžiukai;8061605125;Taip;17;0;2;19
7553;Puriena;Pelėdžiukai;2579402981;Taip;0;0;1;1
7554;Puriena;Pelėdžiukai;3671297035;Taip;0;3;0;3
7555;Puriena;Pelėdžiukai;2267225709;Taip;0;5;0;5
7556;Puriena;Pelėdžiukai;6413337915;Taip;4;0;1;5
7557;Puriena;Pelėdžiukai;6197840105;Taip;11;1;0;12
7558;Puriena;Pelėdžiukai;1417566073;Taip;0;0;1;1
7559;Puriena;Pelėdžiukai;6463129806;Taip;0;7;0;7
7560;Puriena;Pelėdžiukai;4501239330;Taip;0;0;4;4
7561;Puriena;Pelėdžiukai;5341228269;Taip;13;1;0;14
7562;Puriena;Pelėdžiukai;6352605894;Ne;0;0;1;1
7563;Puriena;Pelėdžiukai;6786694796;Taip;0;0;4;4
7564;Puriena;Pelėdžiukai;8952508230;Taip;0;0;2;2
7565;Puriena;Pelėdžiukai;5080805225;Taip;3;0;0;3
7566;Puriena;Voveriukai;3826282438;Taip;0;1;0;1
7567;Puriena;Voveriukai;9453994213;Taip;4;0;0;4
7568;Puriena;Voveriukai;8497070167;Taip;0;5;17;22
7569;Puriena;Voveriukai;4517020977;Taip;0;3;0;3
7570;Puriena;Voveriukai;7811667336;Taip;0;0;2;2
7571;Puriena;Voveriukai;4283608124;Taip;0;1;0;1
7572;Puriena;Voveriukai;8144488922;Taip;22;0;0;22
7573;Puriena;Voveriukai;8476986855;Taip;0;5;2;7
7574;Puriena;Voveriukai;3627403517;Taip;0;6;0;6
7575;Puriena;Voveriukai;2813562677;Taip;1;1;0;2
7576;Puriena;Voveriukai;7120683581;Taip;0;9;0;9
7577;Puriena;Voveriukai;4653085762;Taip;0;4;0;4
7578;Puriena;Voveriukai;3542374463;Taip;0;2;0;2
7579;Puriena;Voveriukai;1933733714;Taip;0;3;0;3
7580;Puriena;Voveriukai;6150437624;Taip;0;1;3;4
7581;Puriena;Voveriukai;8772936125;Taip;0;0;3;3
7582;Puriena;Voveriukai;6428413592;Ne;13;0;2;15
7583;Puriena;Voveriukai;8242140541;Taip;0;3;0;3
7584;Puriena;Voveriukai;4498919764;Taip;10;0;0;10
7585;Puriena;Voveriukai;9729644429;Ne;6;0;0;6
7586;Puriena;Bitučių;71773966341;Taip;0;0;4;4
7587;Puriena;Bitučių;1945542034;Taip;0;7;0;7
7588;Puriena;Bitučių;1116529845;Taip;0;0;3;3
7589;Puriena;Bitučių;98967026878;Taip;0;5;1;6
7590;Puriena;Bitučių;5284316470;Taip;8;0;0;8
7591;Puriena;Bitučių;84527348236;Ne;0;0;1;1
7592;Puriena;Bitučių;8719239663;Taip;3;1;0;4
7593;Puriena;Bitučių;63944407195;Taip;0;0;1;1
7594;Puriena;Bitučių;95153406240;Taip;1;0;3;4
7595;Puriena;Bitučių;9666714143;Taip;0;0;1;1
7596;Puriena;Bitučių;1376708741;Taip;0;0;1;1
7597;Puriena;Bitučių;1507059980;Taip;0;1;0;1
7598;Puriena;Bitučių;85334594528;Taip;0;0;5;5
7599;Puriena;Bitučių;1206969296;Taip;0;0;3;3
7600;Puriena;Bitučių;22643920380;Taip;0;0;1;1
7601;Puriena;Zylutės;5891404983;Taip;0;15;0;15
7602;Puriena;Zylutės;63196502622;Taip;3;2;0;5
7603;Puriena;Zylutės;9239618299;Taip;0;20;0;20
7604;Puriena;Zylutės;2083071198;Taip;10;0;0;10
7605;Puriena;Zylutės;1443945321;Taip;2;4;0;6
7606;Puriena;Zylutės;20286870431;Taip;0;4;0;4
7607;Puriena;Zylutės;8618298134;Taip;0;7;0;7
7608;Puriena;Zylutės;1748337587;Taip;0;3;0;3
7609;Puriena;Zylutės;1820719083;Taip;9;0;0;9
7610;Puriena;Zylutės;2089174669;Taip;3;2;0;5
7611;Puriena;Zylutės;11497629767;Taip;0;9;0;9
7612;Puriena;Zylutės;2146036332;Taip;8;0;0;8
7613;Puriena;Zylutės;2378865002;Taip;5;0;0;5
7614;Puriena;Zylutės;48468411549;Taip;0;11;0;11
7615;Puriena;Zylutės;1703078658;Taip;0;19;0;19
7616;Puriena;Zylutės;1756611673;Taip;0;1;0;1
7617;Puriena;Zylutės;6416145396;Ne;5;1;0;6
7618;Puriena;Zylutės;3031725530;Taip;2;0;0;2
7619;Puriena;Meškučių;1030958414;Taip;0;0;2;2
7620;Puriena;Meškučių;7967288875;Taip;0;1;3;4
7621;Puriena;Meškučių;6158842119;Taip;0;1;0;1
7622;Puriena;Meškučių;3557013127;Taip;0;1;0;1
7623;Puriena;Meškučių;3681811493;Taip;10;0;0;10
7624;Puriena;Meškučių;4060087185;Taip;0;0;3;3
7625;Puriena;Meškučių;3033562627;Taip;0;9;2;11
7626;Puriena;Meškučių;5777076971;Taip;0;9;2;11
7627;Puriena;Meškučių;8310231540;Taip;0;1;1;2
7628;Puriena;Meškučių;4460575818;Taip;0;9;0;9
7629;Puriena;Meškučių;4605662701;Taip;0;5;0;5
7630;Puriena;Meškučių;1819876614;Taip;0;0;1;1
7631;Puriena;Meškučių;4776745276;Taip;0;1;1;2
7632;Puriena;Meškučių;7769252165;Taip;0;1;0;1
7633;Puriena;Meškučių;2170025682;Taip;5;0;0;5
7634;Puriena;Meškučių;3772941726;Taip;0;8;0;8
7635;Puriena;Meškučių;1428098802;Taip;0;8;0;8
7636;Puriena;Meškučių;4100466337;Taip;8;0;14;22
7637;Puriena;Meškučių;6280465748;Taip;0;1;8;9
7638;Puriena;Meškučių;1907429094;Taip;0;0;3;3
7639;Puriena;Meškučių;6496291933;Taip;0;0;1;1
7640;Puriena;Meškučių;1658720269;Taip;0;0;1;1
7641;Puriena;Nykštukų;2624283930;Taip;5;5;0;10
7642;Puriena;Nykštukų;6001659356;Taip;12;0;0;12
7643;Puriena;Nykštukų;5539708916;Taip;13;4;0;17
7644;Puriena;Nykštukų;3204824116;Taip;6;0;0;6
7645;Puriena;Nykštukų;4954787474;Taip;10;0;1;11
7646;Puriena;Nykštukų;7720549981;Taip;12;4;0;16
7647;Puriena;Nykštukų;6372465987;Taip;6;0;0;6
7648;Puriena;Nykštukų;5555076926;Taip;10;0;0;10
7649;Puriena;Nykštukų;2312297583;Taip;0;15;0;15
7650;Puriena;Nykštukų;3232981406;Taip;17;0;0;17
7651;Puriena;Nykštukų;5374864513;Taip;10;3;0;13
7652;Puriena;Nykštukų;1737249860;Taip;0;2;0;2
7653;Puriena;Nykštukų;7335537384;Taip;10;3;0;13
7654;Puriena;Nykštukų;9228372078;Taip;9;1;0;10
7655;Puriena;Ežiukai;9413672989;Taip;5;0;0;5
7656;Puriena;Ežiukai;5224135638;Taip;0;0;1;1
7657;Puriena;Ežiukai;1175665781;Taip;0;4;2;6
7658;Puriena;Ežiukai;6853706997;Taip;5;1;2;8
7659;Puriena;Ežiukai;9543884311;Taip;0;1;0;1
7660;Puriena;Ežiukai;6656013805;Taip;0;0;1;1
7661;Puriena;Ežiukai;8022809059;Taip;8;0;0;8
7662;Puriena;Ežiukai;5395382717;Taip;0;3;0;3
7663;Puriena;Ežiukai;8237149969;Taip;0;1;2;3
7664;Puriena;Ežiukai;4444523140;Taip;0;4;2;6
7665;Puriena;Ežiukai;8512814466;Taip;5;1;0;6
7666;Puriena;Ežiukai;7622407056;Taip;3;0;0;3
7667;Puriena;Ežiukai;6813480086;Taip;8;1;0;9
7668;Puriena;Ežiukai;4017644414;Taip;0;1;8;9
7669;Puriena;Ežiukai;8416003733;Taip;0;4;2;6
7670;Puriena;Ežiukai;8199607793;Taip;0;11;2;13
7671;Puriena;Ežiukai;9854244405;Taip;7;1;0;8
7672;Puriena;Ežiukai;6780164845;Taip;0;0;2;2
7673;Puriena;"Boružiukų ";4608801156;Taip;6;2;0;8
7674;Puriena;"Boružiukų ";6234132927;Taip;2;2;0;4
7675;Puriena;"Boružiukų ";9500729561;Taip;0;2;4;6
7676;Puriena;"Boružiukų ";5591189546;Taip;0;2;10;12
7677;Puriena;"Boružiukų ";5323549829;Taip;3;0;0;3
7678;Puriena;"Boružiukų ";7466163131;Taip;4;0;0;4
7679;Puriena;"Boružiukų ";8359978283;Taip;22;0;0;22
7680;Puriena;"Boružiukų ";2466609635;Taip;10;2;0;12
7681;Puriena;"Boružiukų ";5176663365;Taip;3;0;0;3
7682;Puriena;"Boružiukų ";2029981617;Taip;9;1;0;10
7683;Puriena;"Boružiukų ";6185080390;Taip;15;0;5;20
7684;Puriena;"Boružiukų ";3309219271;Taip;0;6;0;6
7685;Puriena;"Boružiukų ";9748726934;Taip;3;6;0;9
7686;Puriena;"Boružiukų ";3153330970;Taip;0;1;0;1
7687;Puriena;"Boružiukų ";8284860687;Taip;6;0;0;6
7688;Puriena;"Zuikučių ";6451492815;Taip;0;0;1;1
7689;Puriena;"Zuikučių ";4563681164;Taip;0;2;0;2
7690;Puriena;"Zuikučių ";3526684967;Taip;3;14;0;17
7691;Puriena;"Zuikučių ";7913847170;Taip;0;5;0;5
7692;Puriena;"Zuikučių ";8089081251;Taip;3;5;0;8
7693;Puriena;"Zuikučių ";9294208012;Taip;4;0;1;5
7694;Puriena;"Zuikučių ";3252190329;Taip;0;0;6;6
7695;Puriena;"Zuikučių ";9961074983;Taip;0;1;2;3
7696;Puriena;"Zuikučių ";9106644834;Taip;10;0;1;11
7697;Puriena;"Zuikučių ";2830409862;Ne;5;0;5;10
7698;Puriena;"Zuikučių ";5550321808;Taip;0;0;3;3
7699;Puriena;"Zuikučių ";8038573068;Taip;0;6;3;9
7700;Puriena;"Zuikučių ";4165800035;Taip;3;0;10;13
7701;Puriena;"Zuikučių ";7634536770;Taip;10;2;0;12
7702;Puriena;"Zuikučių ";6612468095;Taip;4;1;0;5
7703;Puriena;"Zuikučių ";9423229931;Taip;0;3;0;3
7704;Puriena;Skruzdėliukai;2203259310;Taip;0;0;2;2
7705;Puriena;Skruzdėliukai;7429832136;Taip;2;5;0;7
7706;Puriena;Skruzdėliukai;8478901457;Ne;2;5;0;7
7707;Puriena;Skruzdėliukai;4647433927;Taip;0;13;0;13
7708;Puriena;Skruzdėliukai;5257713434;Taip;0;13;0;13
7709;Puriena;Skruzdėliukai;11242620566;Taip;3;2;1;6
7710;Puriena;Skruzdėliukai;6285846517;Taip;4;0;1;5
7711;Puriena;Skruzdėliukai;5999564879;Taip;0;9;0;9
7712;Puriena;Skruzdėliukai;5501308683;Taip;0;2;3;5
7713;Puriena;Skruzdėliukai;2663832596;Taip;0;0;5;5
7714;Puriena;Skruzdėliukai;40573980976;Taip;2;9;0;11
7715;Puriena;Skruzdėliukai;6057477307;Taip;3;0;0;3
7716;Puriena;Skruzdėliukai;92604925140;Taip;0;0;3;3
7717;Puriena;Skruzdėliukai;1290962809;Taip;0;1;0;1
7718;Puriena;Skruzdėliukai;23746358787;Taip;0;1;0;1
7719;Puriena;Skruzdėliukai;1263637124;Taip;5;1;0;6
7720;Puriena;Skruzdėliukai;1290933817;Taip;5;7;0;12
7721;Pušaitė;Kodėlčiukai;8702361596;Taip;0;1;1;2
7722;Pušaitė;Kodėlčiukai;3832434608;Taip;5;3;0;8
7723;Pušaitė;Kodėlčiukai;4838345510;Taip;0;1;2;3
7724;Pušaitė;Kodėlčiukai;7068451014;Taip;0;2;2;4
7725;Pušaitė;Kodėlčiukai;2253477550;Taip;5;2;0;7
7726;Pušaitė;Kodėlčiukai;6275090953;Taip;0;9;0;9
7727;Pušaitė;Kodėlčiukai;8750774616;Taip;0;1;0;1
7728;Pušaitė;Kodėlčiukai;4198571222;Taip;0;7;4;11
7729;Pušaitė;Kodėlčiukai;2004615252;Taip;15;1;0;16
7730;Pušaitė;Kodėlčiukai;4743105731;Taip;0;0;1;1
7731;Pušaitė;Kodėlčiukai;9391350218;Taip;1;8;0;9
7732;Pušaitė;Kodėlčiukai;1935059739;Taip;5;4;2;11
7733;Pušaitė;Kodėlčiukai;3698808100;Taip;0;4;0;4
7734;Pušaitė;Kodėlčiukai;2793941689;Taip;8;4;0;12
7735;Pušaitė;Kodėlčiukai;4326967247;Taip;0;3;10;13
7736;Pušaitė;Kodėlčiukai;4473930703;Taip;0;2;0;2
7737;Pušaitė;Kodėlčiukai;1996544496;Taip;7;0;0;7
7738;Pušaitė;Kodėlčiukai;6775428321;Taip;3;0;0;3
7739;Pušaitė;Kodėlčiukai;4615270419;Taip;0;2;0;2
7740;Pušaitė;Kodėlčiukai;7117784038;Taip;5;10;2;17
7741;Pušaitė;Saulutės;8343949011;Taip;3;0;0;3
7742;Pušaitė;Saulutės;4101285889;Taip;0;0;9;9
7743;Pušaitė;Saulutės;1395577340;Taip;0;0;5;5
7744;Pušaitė;Saulutės;3694667637;Taip;0;0;3;3
7745;Pušaitė;Saulutės;5563772495;Taip;0;0;4;4
7746;Pušaitė;Saulutės;1534764228;Taip;0;1;1;2
7747;Pušaitė;Saulutės;5839824399;Taip;0;0;7;7
7748;Pušaitė;Saulutės;4511258460;Taip;0;0;10;10
7749;Pušaitė;Saulutės;5949199046;Taip;0;22;0;22
7750;Pušaitė;Saulutės;5422616450;Taip;0;0;8;8
7751;Pušaitė;Saulutės;5328083339;Taip;0;0;1;1
7752;Pušaitė;Saulutės;6356263503;Taip;5;0;1;6
7753;Pušaitė;Saulutės;7237345427;Taip;8;0;3;11
7754;Pušaitė;Saulutės;5819186055;Taip;0;22;0;22
7755;Pušaitė;Zuikučiai;2115591523;Taip;0;4;8;12
7756;Pušaitė;Zuikučiai;8738827821;Taip;0;1;5;6
7757;Pušaitė;Zuikučiai;2181510181;Taip;0;13;3;16
7758;Pušaitė;Zuikučiai;7477429922;Taip;5;1;0;6
7759;Pušaitė;Zuikučiai;6306133416;Taip;6;2;0;8
7760;Pušaitė;Zuikučiai;2099169654;Taip;0;0;1;1
7761;Pušaitė;Zuikučiai;6355379926;Taip;3;1;0;4
7762;Pušaitė;Zuikučiai;80743691769;Taip;0;0;1;1
7763;Pušaitė;Zuikučiai;1296700534;Taip;0;1;2;3
7764;Pušaitė;Zuikučiai;51500717235;Taip;5;1;1;7
7765;Pušaitė;Zuikučiai;5398532705;Taip;0;8;0;8
7766;Pušaitė;Zuikučiai;4881689337;Taip;0;9;0;9
7767;Pušaitė;Zuikučiai;1295203136;Taip;10;0;2;12
7768;Pušaitė;Zuikučiai;6259961070;Taip;0;1;0;1
7769;Pušaitė;Zuikučiai;2944418714;Taip;0;0;8;8
7770;Pušaitė;Zuikučiai;3813761666;Taip;9;0;13;22
7771;Pušaitė;Zuikučiai;4762094720;Taip;5;0;0;5
7772;Pušaitė;Zuikučiai;2130767942;Taip;0;9;0;9
7773;Pušaitė;Vėžliukai;1326581025;Taip;0;8;0;8
7774;Pušaitė;Vėžliukai;8135552679;Taip;0;12;0;12
7775;Pušaitė;Vėžliukai;3485234259;Taip;10;0;0;10
7776;Pušaitė;Vėžliukai;9470667227;Taip;18;0;0;18
7777;Pušaitė;Vėžliukai;1978339054;Taip;0;6;0;6
7778;Pušaitė;Vėžliukai;6739253961;Taip;0;4;0;4
7779;Pušaitė;Vėžliukai;3014180020;Ne;0;5;0;5
7780;Pušaitė;Vėžliukai;7890577174;Taip;0;2;0;2
7781;Pušaitė;Vėžliukai;7652706756;Taip;0;1;0;1
7782;Pušaitė;Vėžliukai;5318602924;Taip;4;6;0;10
7783;Pušaitė;Vėžliukai;5296435012;Taip;4;0;1;5
7784;Pušaitė;Vėžliukai;5512786073;Taip;13;5;0;18
7785;Pušaitė;Vėžliukai;8399589954;Taip;0;2;0;2
7786;Pušaitė;Vėžliukai;4281125486;Taip;0;7;0;7
7787;Pušaitė;Vėžliukai;2777222076;Taip;0;1;0;1
7788;Pušaitė;Vėžliukai;8459530338;Taip;0;4;0;4
7789;Pušaitė;"Linksmieji nykštukai";9265357004;Taip;0;1;0;1
7790;Pušaitė;"Linksmieji nykštukai";3150144924;Taip;5;0;0;5
7791;Pušaitė;"Linksmieji nykštukai";7520393710;Taip;0;0;5;5
7792;Pušaitė;"Linksmieji nykštukai";4517181474;Taip;0;2;0;2
7793;Pušaitė;"Linksmieji nykštukai";9033615485;Ne;0;5;0;5
7794;Pušaitė;"Linksmieji nykštukai";3130824742;Taip;0;9;0;9
7795;Pušaitė;"Linksmieji nykštukai";4605161267;Taip;0;7;0;7
7796;Pušaitė;"Linksmieji nykštukai";6160825713;Taip;1;3;0;4
7797;Pušaitė;"Linksmieji nykštukai";1024996364;Taip;3;5;1;9
7798;Pušaitė;"Linksmieji nykštukai";4662871524;Taip;4;3;0;7
7799;Pušaitė;"Linksmieji nykštukai";8438652029;Taip;0;0;1;1
7800;Pušaitė;"Linksmieji nykštukai";6578483902;Taip;13;0;1;14
7801;Pušaitė;"Linksmieji nykštukai";9327636862;Taip;2;4;0;6
7802;Pušaitė;"Linksmieji nykštukai";4175909754;Taip;0;0;2;2
7803;Pušaitė;"Linksmieji nykštukai";3788392895;Taip;0;2;1;3
7804;Pušaitė;"Linksmieji nykštukai";3195191374;Taip;0;3;0;3
7805;Pušaitė;"Linksmieji nykštukai";9127444013;Taip;0;2;4;6
7806;Pušaitė;"Linksmieji nykštukai";5422784898;Taip;0;2;0;2
7807;Pušaitė;"Linksmieji nykštukai";5104111840;Taip;0;0;1;1
7808;Pušaitė;"Linksmieji nykštukai";9866431097;Taip;0;1;0;1
7809;Pušaitė;"Linksmieji nykštukai";4564478833;Taip;3;0;0;3
7810;Pušaitė;"Linksmieji nykštukai";4374232593;Taip;11;2;0;13
7811;Pušaitė;"Kačiukų trobelė";3695016765;Taip;0;0;1;1
7812;Pušaitė;"Kačiukų trobelė";7983115812;Taip;0;1;0;1
7813;Pušaitė;"Kačiukų trobelė";1122112207;Taip;0;6;1;7
7814;Pušaitė;"Kačiukų trobelė";1635528919;Taip;0;7;3;10
7815;Pušaitė;"Kačiukų trobelė";2837439334;Taip;5;0;0;5
7816;Pušaitė;"Kačiukų trobelė";7014914682;Taip;0;8;0;8
7817;Pušaitė;"Kačiukų trobelė";8793102437;Taip;6;12;0;18
7818;Pušaitė;"Kačiukų trobelė";9056933586;Taip;0;4;0;4
7819;Pušaitė;"Kačiukų trobelė";7898355721;Taip;0;0;2;2
7820;Pušaitė;"Kačiukų trobelė";5191894075;Taip;6;2;4;12
7821;Pušaitė;"Kačiukų trobelė";1161519408;Taip;0;2;0;2
7822;Pušaitė;"Kačiukų trobelė";8822285103;Taip;0;6;0;6
7823;Pušaitė;"Kačiukų trobelė";9313564235;Taip;5;11;0;16
7824;Pušaitė;"Kačiukų trobelė";5564338170;Taip;0;1;1;2
7825;Pušaitė;"Kačiukų trobelė";2865062081;Taip;0;5;0;5
7826;Pušaitė;"Kačiukų trobelė";8155746120;Taip;5;0;0;5
7827;Pušaitė;"Kačiukų trobelė";7251064118;Taip;5;0;3;8
7828;Pušaitė;Ežiukai;2090143259;Taip;0;2;0;2
7829;Pušaitė;Ežiukai;2951618391;Taip;0;2;2;4
7830;Pušaitė;Ežiukai;9524002395;Taip;0;2;1;3
7831;Pušaitė;Ežiukai;1111143593;Taip;0;0;1;1
7832;Pušaitė;Ežiukai;15270671089;Taip;0;1;0;1
7833;Pušaitė;Ežiukai;3359574190;Taip;4;1;0;5
7834;Pušaitė;Ežiukai;1143122778;Taip;0;5;0;5
7835;Pušaitė;Ežiukai;9461292576;Taip;0;12;0;12
7836;Pušaitė;Ežiukai;5185787803;Taip;2;0;0;2
7837;Pušaitė;Ežiukai;8958364766;Taip;0;1;0;1
7838;Pušaitė;Ežiukai;7575143890;Taip;0;0;1;1
7839;Pušaitė;Ežiukai;7808186865;Taip;0;3;0;3
7840;Pušaitė;Ežiukai;4842783897;Taip;0;0;2;2
7841;Pušaitė;Ežiukai;6472169278;Taip;0;1;0;1
7842;Pušaitė;Ežiukai;8021494509;Taip;5;0;1;6
7843;Pušaitė;Ežiukai;2172342063;Taip;8;6;0;14
7844;Pušaitė;Ežiukai;8309000712;Taip;0;12;0;12
7845;Pušaitė;"Gudručių šalis";24768657107;Taip;5;0;0;5
7846;Pušaitė;"Gudručių šalis";55304000825;Taip;0;0;1;1
7847;Pušaitė;"Gudručių šalis";15550007793;Taip;0;1;7;8
7848;Pušaitė;"Gudručių šalis";4386242143;Taip;0;1;4;5
7849;Pušaitė;"Gudručių šalis";9997642887;Taip;0;1;0;1
7850;Pušaitė;"Gudručių šalis";15546035138;Taip;0;1;1;2
7851;Pušaitė;"Gudručių šalis";79097991060;Taip;0;0;3;3
7852;Pušaitė;"Gudručių šalis";1275885492;Taip;0;1;1;2
7853;Pušaitė;"Gudručių šalis";90178990466;Taip;0;0;1;1
7854;Pušaitė;"Gudručių šalis";89985930634;Taip;0;2;2;4
7855;Pušaitė;"Gudručių šalis";4266368627;Taip;0;1;0;1
7856;Pušaitė;"Gudručių šalis";49973513385;Taip;0;2;0;2
7857;Pušaitė;"Gudručių šalis";89212112638;Taip;0;5;3;8
7858;Pušaitė;"Gudručių šalis";11297426946;Taip;5;2;0;7
7859;Pušaitė;"Gudručių šalis";67365323950;Taip;0;1;0;1
7860;Pušaitė;"Gudručių šalis";35947321028;Taip;0;22;0;22
7861;Pušaitė;"Gudručių šalis";1459628106;Taip;0;2;3;5
7862;Pušaitė;"Gudručių šalis";87504481892;Taip;5;2;4;11
7863;Pušaitė;"Gudručių šalis";6915619931;Taip;0;1;0;1
7864;Pušaitė;"Gudručių šalis";41026183089;Taip;0;1;1;2
7865;Pušaitė;"Gudručių šalis";3577616212;Taip;0;2;0;2
7866;Pušaitė;"Gudručių šalis";1569413876;Taip;0;1;0;1
7867;Pušaitė;"Lapučių mokyklėlė";1102988768;Taip;0;0;2;2
7868;Pušaitė;"Lapučių mokyklėlė";53211427399;Taip;0;2;1;3
7869;Pušaitė;"Lapučių mokyklėlė";40417586835;Taip;0;7;0;7
7870;Pušaitė;"Lapučių mokyklėlė";85343380637;Taip;0;8;0;8
7871;Pušaitė;"Lapučių mokyklėlė";2044213583;Taip;0;0;1;1
7872;Pušaitė;"Lapučių mokyklėlė";7408224942;Taip;0;2;3;5
7873;Pušaitė;"Lapučių mokyklėlė";77082825248;Taip;0;7;0;7
7874;Pušaitė;"Lapučių mokyklėlė";1487637695;Taip;3;1;0;4
7875;Pušaitė;"Lapučių mokyklėlė";53766202712;Taip;0;7;0;7
7876;Pušaitė;"Lapučių mokyklėlė";3231637165;Taip;0;1;0;1
7877;Pušaitė;"Lapučių mokyklėlė";6542917863;Ne;0;22;0;22
7878;Pušaitė;"Lapučių mokyklėlė";9179757395;Taip;0;14;8;22
7879;Pušaitė;"Lapučių mokyklėlė";54748538980;Taip;0;11;0;11
7880;Pušaitė;"Lapučių mokyklėlė";8592426606;Taip;0;0;4;4
7881;Pušaitė;"Lapučių mokyklėlė";2892138891;Ne;0;0;1;1
7882;Pušaitė;"Lapučių mokyklėlė";6752676513;Taip;0;6;1;7
7883;Pušaitė;"Lapučių mokyklėlė";3745881982;Taip;0;10;0;10
7884;Pušaitė;"VOVERIUKAI ";8763667682;Taip;0;22;0;22
7885;Pušaitė;"VOVERIUKAI ";7891007708;Taip;3;9;0;12
7886;Pušaitė;"VOVERIUKAI ";6767281906;Taip;0;8;0;8
7887;Pušaitė;"VOVERIUKAI ";2078734161;Taip;0;8;0;8
7888;Pušaitė;"VOVERIUKAI ";5488507646;Taip;10;0;0;10
7889;Pušaitė;"VOVERIUKAI ";8790959900;Taip;7;0;0;7
7890;Pušaitė;"VOVERIUKAI ";6288526291;Taip;8;9;0;17
7891;Pušaitė;"VOVERIUKAI ";3380836598;Taip;8;1;0;9
7892;Pušaitė;"VOVERIUKAI ";3732377309;Taip;0;10;1;11
7893;Pušaitė;"VOVERIUKAI ";2321256048;Taip;8;0;0;8
7894;Pušaitė;"VOVERIUKAI ";1807432967;Taip;8;0;1;9
7895;Pušaitė;"VOVERIUKAI ";6205900423;Taip;0;22;0;22
7896;Pušaitė;"VOVERIUKAI ";5270528758;Taip;1;0;0;1
7897;Pušaitė;"VOVERIUKAI ";1305526154;Taip;11;0;1;12
7898;Pušaitė;"VOVERIUKAI ";2397106198;Taip;0;1;0;1
7899;Pušaitė;"VOVERIUKAI ";4344634837;Taip;0;22;0;22
7900;Pušaitė;MEŠKUČIAI;6186545163;Taip;0;11;0;11
7901;Pušaitė;MEŠKUČIAI;5281161835;Taip;0;1;0;1
7902;Pušaitė;MEŠKUČIAI;4747611989;Taip;0;7;0;7
7903;Pušaitė;MEŠKUČIAI;6576647982;Taip;4;0;0;4
7904;Pušaitė;MEŠKUČIAI;3387165403;Taip;0;1;0;1
7905;Pušaitė;MEŠKUČIAI;7992567219;Taip;14;0;0;14
7906;Pušaitė;MEŠKUČIAI;4626055123;Taip;3;2;0;5
7907;Pušaitė;MEŠKUČIAI;2333176054;Taip;4;3;0;7
7908;Pušaitė;MEŠKUČIAI;7066207306;Taip;0;22;0;22
7909;Pušaitė;MEŠKUČIAI;6734504906;Taip;7;9;0;16
7910;Pušaitė;MEŠKUČIAI;5339878948;Taip;8;4;0;12
7911;Pušaitė;MEŠKUČIAI;3610256789;Taip;9;2;11;22
7912;Pušaitė;MEŠKUČIAI;9460661690;Taip;11;3;0;14
7913;Pušaitė;MEŠKUČIAI;5002710062;Taip;10;4;5;19
7914;Pušaitė;PELIUKAI;2969514918;Taip;0;1;14;15
7915;Pušaitė;PELIUKAI;6851908671;Taip;7;0;0;7
7916;Pušaitė;PELIUKAI;2666541612;Taip;5;0;0;5
7917;Pušaitė;PELIUKAI;4857214952;Taip;4;0;0;4
7918;Pušaitė;PELIUKAI;9337726482;Taip;0;6;0;6
7919;Pušaitė;PELIUKAI;7210529114;Taip;11;0;5;16
7920;Pušaitė;PELIUKAI;8343225451;Taip;9;2;0;11
7921;Pušaitė;PELIUKAI;8551426938;Taip;18;0;0;18
7922;Pušaitė;PELIUKAI;4444972517;Taip;6;2;0;8
7923;Pušaitė;PELIUKAI;7615253880;Taip;0;22;0;22
7924;Pušaitė;PELIUKAI;4508356130;Taip;10;1;0;11
7925;Pušaitė;PELIUKAI;4138386134;Taip;6;2;2;10
7926;Pušaitė;PELIUKAI;5139525557;Taip;0;2;1;3
7927;Pušaitė;PELIUKAI;1994898058;Taip;0;22;0;22
7928;"Pušynėlis (Miglos g. 53)";PUMPURĖLIAI;3100230874;Taip;0;22;0;22
7929;"Pušynėlis (Miglos g. 53)";PUMPURĖLIAI;8451160808;Ne;7;0;0;7
7930;"Pušynėlis (Miglos g. 53)";PUMPURĖLIAI;6036296660;Taip;0;0;2;2
7931;"Pušynėlis (Miglos g. 53)";PUMPURĖLIAI;7177725663;Taip;0;20;0;20
7932;"Pušynėlis (Miglos g. 53)";PUMPURĖLIAI;2718421498;Taip;0;1;0;1
7933;"Pušynėlis (Miglos g. 53)";PUMPURĖLIAI;7401066252;Taip;0;0;4;4
7934;"Pušynėlis (Miglos g. 53)";PUMPURĖLIAI;1164201286;Taip;0;2;0;2
7935;"Pušynėlis (Miglos g. 53)";PUMPURĖLIAI;3882064516;Taip;0;2;2;4
7936;"Pušynėlis (Miglos g. 53)";PUMPURĖLIAI;9081582524;Taip;0;2;2;4
7937;"Pušynėlis (Miglos g. 53)";PUMPURĖLIAI;1251787066;Ne;0;3;1;4
7938;"Pušynėlis (Miglos g. 53)";PUMPURĖLIAI;4526807309;Taip;0;0;2;2
7939;"Pušynėlis (Miglos g. 53)";PUMPURĖLIAI;6709692748;Taip;1;1;0;2
7940;"Pušynėlis (Miglos g. 53)";PUMPURĖLIAI;8799095053;Taip;0;5;0;5
7941;"Pušynėlis (Miglos g. 53)";PUMPURĖLIAI;5318223378;Taip;8;0;2;10
7942;"Pušynėlis (Miglos g. 53)";PUMPURĖLIAI;7787646910;Taip;0;0;2;2
7943;"Pušynėlis (Miglos g. 53)";PUMPURĖLIAI;7896617995;Taip;3;0;3;6
7944;"Pušynėlis (Miglos g. 53)";PUMPURĖLIAI;5897839636;Taip;0;1;0;1
7945;"Pušynėlis (Miglos g. 53)";PUMPURĖLIAI;1034336110;Taip;0;0;1;1
7946;"Pušynėlis (Miglos g. 53)";PUMPURĖLIAI;8218331977;Taip;0;3;0;3
7947;"Pušynėlis (Miglos g. 53)";SAULUTĖS;3037031809;Taip;0;2;1;3
7948;"Pušynėlis (Miglos g. 53)";SAULUTĖS;3510202379;Taip;0;0;9;9
7949;"Pušynėlis (Miglos g. 53)";SAULUTĖS;2765869141;Taip;0;3;0;3
7950;"Pušynėlis (Miglos g. 53)";SAULUTĖS;3483007385;Taip;0;3;0;3
7951;"Pušynėlis (Miglos g. 53)";SAULUTĖS;9154108688;Taip;0;0;3;3
7952;"Pušynėlis (Miglos g. 53)";SAULUTĖS;7729392498;Taip;0;0;1;1
7953;"Pušynėlis (Miglos g. 53)";SAULUTĖS;6077698697;Taip;0;0;1;1
7954;"Pušynėlis (Miglos g. 53)";SAULUTĖS;4668634909;Taip;0;2;0;2
7955;"Pušynėlis (Miglos g. 53)";SAULUTĖS;1891728904;Taip;0;7;0;7
7956;"Pušynėlis (Miglos g. 53)";SAULUTĖS;6560054869;Taip;0;8;4;12
7957;"Pušynėlis (Miglos g. 53)";SAULUTĖS;4030500100;Taip;0;2;0;2
7958;"Pušynėlis (Miglos g. 53)";SAULUTĖS;2019210609;Taip;0;3;1;4
7959;"Pušynėlis (Miglos g. 53)";SAULUTĖS;2793982816;Taip;8;0;6;14
7960;"Pušynėlis (Miglos g. 53)";SAULUTĖS;7046421581;Taip;0;0;14;14
7961;"Pušynėlis (Miglos g. 53)";SAULUTĖS;5236219294;Taip;0;2;1;3
7962;"Pušynėlis (Miglos g. 53)";SAULUTĖS;4052132379;Taip;0;1;0;1
7963;"Pušynėlis (Miglos g. 53)";SAULUTĖS;2141785580;Taip;0;3;0;3
7964;"Pušynėlis (Miglos g. 53)";PRIEŠMOKYKLINĖ;1415916851;Taip;4;0;0;4
7965;"Pušynėlis (Miglos g. 53)";PRIEŠMOKYKLINĖ;68068847689;Taip;3;0;0;3
7966;"Pušynėlis (Miglos g. 53)";PRIEŠMOKYKLINĖ;40407279179;Taip;0;0;2;2
7967;"Pušynėlis (Miglos g. 53)";PRIEŠMOKYKLINĖ;1610449906;Taip;0;0;2;2
7968;"Pušynėlis (Miglos g. 53)";PRIEŠMOKYKLINĖ;25261143142;Taip;0;1;0;1
7969;"Pušynėlis (Miglos g. 53)";PRIEŠMOKYKLINĖ;48050606382;Taip;0;0;1;1
7970;"Pušynėlis (Miglos g. 53)";PRIEŠMOKYKLINĖ;2048377076;Taip;10;0;0;10
7971;"Pušynėlis (Miglos g. 53)";PRIEŠMOKYKLINĖ;2012089695;Taip;0;5;0;5
7972;"Pušynėlis (Miglos g. 53)";PRIEŠMOKYKLINĖ;1817179601;Taip;0;3;0;3
7973;"Pušynėlis (Miglos g. 53)";PRIEŠMOKYKLINĖ;74952593070;Taip;0;0;1;1
7974;"Pušynėlis (Miglos g. 53)";PRIEŠMOKYKLINĖ;6716726918;Taip;4;0;0;4
7975;"Pušynėlis (Miglos g. 53)";PRIEŠMOKYKLINĖ;9665845150;Taip;0;3;0;3
7976;"Pušynėlis (Miglos g. 53)";LOPŠELIS;8803766149;Taip;9;0;0;9
7977;"Pušynėlis (Miglos g. 53)";LOPŠELIS;4962270317;Ne;3;0;0;3
7978;"Pušynėlis (Miglos g. 53)";LOPŠELIS;9465619945;Taip;5;0;0;5
7979;"Pušynėlis (Miglos g. 53)";LOPŠELIS;4603625624;Taip;4;0;0;4
7980;"Pušynėlis (Miglos g. 53)";LOPŠELIS;2509111066;Taip;0;2;0;2
7981;"Pušynėlis (Miglos g. 53)";LOPŠELIS;5802582694;Taip;4;1;0;5
7982;"Pušynėlis (Miglos g. 53)";LOPŠELIS;8462742834;Taip;8;2;0;10
7983;"Pušynėlis (Miglos g. 53)";LOPŠELIS;2861000826;Taip;0;3;0;3
7984;"Pušynėlis (Miglos g. 53)";LOPŠELIS;6962705842;Taip;0;21;0;21
7985;"Pušynėlis (Miglos g. 53)";LOPŠELIS;7438923710;Taip;13;0;0;13
7986;"Pušynėlis (Miglos g. 53)";LOPŠELIS;8902047615;Taip;0;0;1;1
7987;"Pušynėlis (Miglos g. 53)";LOPŠELIS;5568838550;Taip;1;0;0;1
7988;"Pušynėlis (Miglos g. 53)";LOPŠELIS;2744665477;Taip;5;0;0;5
7989;"Pušynėlis (Miglos g. 53)";LOPŠELIS;8845728723;Taip;3;0;0;3
7990;"Pušynėlis (Miglos g. 53)";LOPŠELIS;3682719098;Taip;3;0;2;5
7991;"Pušynėlis (Miglos g. 53)";LOPŠELIS;5038740377;Taip;0;13;0;13
7992;"Pušynėlis (Miglos g. 53)";LOPŠELIS;3483639540;Taip;0;7;0;7
7993;"Pušynėlis (Miglos g. 53)";LOPŠELIS;2553444832;Taip;3;0;0;3
7994;"Pušynėlis (Miglos g. 53)";LOPŠELIS;9883505094;Taip;0;1;0;1
7995;Raktelis;LAŠIUKAI;5663304735;Ne;0;1;0;1
7996;Raktelis;LAŠIUKAI;1544882634;Taip;0;11;0;11
7997;Raktelis;LAŠIUKAI;1455550617;Taip;0;7;0;7
7998;Raktelis;LAŠIUKAI;9774706725;Taip;0;2;2;4
7999;Raktelis;LAŠIUKAI;7048022562;Taip;0;2;0;2
8000;Raktelis;LAŠIUKAI;37587869107;Taip;0;2;7;9
8001;Raktelis;LAŠIUKAI;2143998936;Taip;0;3;0;3
8002;Raktelis;LAŠIUKAI;1957572199;Taip;0;1;0;1
8003;Raktelis;LAŠIUKAI;1468915955;Taip;0;1;0;1
8004;Raktelis;LAŠIUKAI;8579864696;Taip;0;2;0;2
8005;Raktelis;LAŠIUKAI;86883305675;Taip;4;1;0;5
8006;Raktelis;LAŠIUKAI;4906678347;Taip;7;1;0;8
8007;Raktelis;LAŠIUKAI;3180109604;Taip;13;0;1;14
8008;Raktelis;LAŠIUKAI;26727657814;Taip;0;1;1;2
8009;Raktelis;LAŠIUKAI;1063413424;Ne;0;11;0;11
8010;Raktelis;LAŠIUKAI;1567546511;Taip;0;3;0;3
8011;Raktelis;LAŠIUKAI;87211875672;Taip;0;3;0;3
8012;Raktelis;LAŠIUKAI;30092089456;Taip;0;4;0;4
8013;Raktelis;LAŠIUKAI;4449411816;Taip;3;0;3;6
8014;Raktelis;LAŠIUKAI;1378192491;Taip;0;1;0;1
8015;Raktelis;BITUTĖS;8559758812;Taip;0;11;0;11
8016;Raktelis;BITUTĖS;7265543701;Taip;9;2;0;11
8017;Raktelis;BITUTĖS;5627179884;Taip;0;7;2;9
8018;Raktelis;BITUTĖS;5405322552;Taip;22;0;0;22
8019;Raktelis;BITUTĖS;5492437864;Ne;0;2;2;4
8020;Raktelis;BITUTĖS;53034039807;Taip;0;19;0;19
8021;Raktelis;BITUTĖS;5711863758;Taip;0;2;1;3
8022;Raktelis;BITUTĖS;5000264125;Taip;0;2;6;8
8023;Raktelis;BITUTĖS;5802689482;Taip;11;2;0;13
8024;Raktelis;BITUTĖS;9139322116;Taip;0;9;2;11
8025;Raktelis;BITUTĖS;9965855682;Taip;11;1;0;12
8026;Raktelis;BITUTĖS;4319176525;Taip;7;0;1;8
8027;Raktelis;BITUTĖS;4317705126;Taip;3;0;1;4
8028;Raktelis;BITUTĖS;4187804340;Ne;0;0;5;5
8029;Raktelis;BITUTĖS;1457880868;Taip;10;2;0;12
8030;Raktelis;BITUTĖS;5820028619;Taip;11;1;0;12
8031;Raktelis;BITUTĖS;7248631013;Taip;0;2;0;2
8032;Raktelis;BITUTĖS;2652125338;Taip;0;0;2;2
8033;Raktelis;BORUŽĖLĖS;8117871963;Taip;0;0;13;13
8034;Raktelis;BORUŽĖLĖS;5031703240;Taip;0;7;0;7
8035;Raktelis;BORUŽĖLĖS;9313156299;Taip;0;3;0;3
8036;Raktelis;BORUŽĖLĖS;54221331553;Taip;8;0;0;8
8037;Raktelis;BORUŽĖLĖS;1192775994;Taip;9;2;0;11
8038;Raktelis;BORUŽĖLĖS;3345708690;Taip;0;1;0;1
8039;Raktelis;BORUŽĖLĖS;7487507324;Taip;3;0;0;3
8040;Raktelis;BORUŽĖLĖS;9584164290;Taip;5;1;0;6
8041;Raktelis;BORUŽĖLĖS;8410301417;Taip;14;0;0;14
8042;Raktelis;BORUŽĖLĖS;6854111162;Taip;8;2;0;10
8043;Raktelis;BORUŽĖLĖS;5818899732;Taip;0;3;0;3
8044;Raktelis;BORUŽĖLĖS;9348898875;Taip;0;8;0;8
8045;Raktelis;BORUŽĖLĖS;3713386556;Taip;6;5;0;11
8046;Raktelis;BORUŽĖLĖS;9230053040;Ne;0;3;2;5
8047;Raktelis;KAČIUKAI;5270430511;Taip;17;0;0;17
8048;Raktelis;KAČIUKAI;8600632097;Taip;0;1;0;1
8049;Raktelis;KAČIUKAI;7630501672;Taip;13;0;0;13
8050;Raktelis;KAČIUKAI;6007823584;Taip;0;7;2;9
8051;Raktelis;KAČIUKAI;3733786043;Taip;3;4;0;7
8052;Raktelis;KAČIUKAI;4676213966;Taip;13;7;0;20
8053;Raktelis;KAČIUKAI;4160091258;Taip;10;0;0;10
8054;Raktelis;KAČIUKAI;3775306030;Taip;2;4;0;6
8055;Raktelis;KAČIUKAI;6550851582;Taip;4;2;0;6
8056;Raktelis;KAČIUKAI;4009105487;Taip;8;0;2;10
8057;Raktelis;KAČIUKAI;1843086151;Ne;0;7;0;7
8058;Raktelis;KAČIUKAI;1983808547;Taip;9;0;0;9
8059;Raktelis;KAČIUKAI;5042538956;Taip;0;0;1;1
8060;Raktelis;KAČIUKAI;7260767942;Taip;0;1;1;2
8061;Raktelis;KAČIUKAI;6323223256;Taip;5;0;0;5
8062;Raktelis;KAČIUKAI;1123693990;Taip;14;0;0;14
8063;Raktelis;KAČIUKAI;4979657165;Taip;0;0;2;2
8064;Raktelis;KIŠKUČIAI;5046450478;Taip;4;6;0;10
8065;Raktelis;KIŠKUČIAI;6974263764;Taip;0;12;0;12
8066;Raktelis;KIŠKUČIAI;7807341574;Taip;18;0;0;18
8067;Raktelis;KIŠKUČIAI;4059286631;Taip;5;3;0;8
8068;Raktelis;KIŠKUČIAI;8385770827;Taip;0;10;5;15
8069;Raktelis;KIŠKUČIAI;4962251215;Taip;5;6;0;11
8070;Raktelis;KIŠKUČIAI;8282429202;Taip;9;1;0;10
8071;Raktelis;KIŠKUČIAI;5705825231;Taip;7;4;0;11
8072;Raktelis;KIŠKUČIAI;6932820066;Taip;5;0;0;5
8073;Raktelis;KIŠKUČIAI;9114203596;Ne;6;3;0;9
8074;Raktelis;KIŠKUČIAI;4615337759;Taip;2;1;0;3
8075;Raktelis;KIŠKUČIAI;5913060415;Taip;0;4;0;4
8076;Raktelis;KIŠKUČIAI;2410682193;Taip;10;0;0;10
8077;Raktelis;KIŠKUČIAI;3308623522;Ne;14;5;0;19
8078;Raktelis;NYKŠTUKAI;5150954686;Taip;19;0;1;20
8079;Raktelis;NYKŠTUKAI;4442395100;Taip;22;0;0;22
8080;Raktelis;NYKŠTUKAI;1618225282;Taip;11;0;0;11
8081;Raktelis;NYKŠTUKAI;4936637343;Taip;5;1;0;6
8082;Raktelis;NYKŠTUKAI;4529213150;Taip;3;0;0;3
8083;Raktelis;NYKŠTUKAI;4333191842;Taip;16;0;0;16
8084;Raktelis;NYKŠTUKAI;2698820718;Taip;0;0;1;1
8085;Raktelis;NYKŠTUKAI;2599670832;Taip;2;10;1;13
8086;Raktelis;NYKŠTUKAI;1757601091;Taip;5;9;0;14
8087;Raktelis;NYKŠTUKAI;9529797517;Taip;6;2;0;8
8088;Raktelis;NYKŠTUKAI;5404673733;Taip;7;0;0;7
8089;Raktelis;NYKŠTUKAI;1314972335;Taip;0;0;1;1
8090;Raktelis;NYKŠTUKAI;7459272209;Taip;3;0;0;3
8091;Raktelis;NYKŠTUKAI;3343352568;Taip;0;12;0;12
8092;Raktelis;NYKŠTUKAI;7990626447;Taip;9;0;0;9
8093;Raktelis;NYKŠTUKAI;5865484633;Ne;10;0;0;10
8094;Raktelis;NYKŠTUKAI;3490428062;Taip;7;2;0;9
8095;Raktelis;NYKŠTUKAI;7865593006;Ne;7;0;0;7
8096;Raktelis;PELIUKAI;8146076115;Taip;5;0;0;5
8097;Raktelis;PELIUKAI;2731096860;Taip;0;0;1;1
8098;Raktelis;PELIUKAI;9599034285;Taip;3;0;0;3
8099;Raktelis;PELIUKAI;1604357851;Taip;0;0;5;5
8100;Raktelis;PELIUKAI;6393143566;Taip;10;4;0;14
8101;Raktelis;PELIUKAI;4353473162;Taip;9;0;0;9
8102;Raktelis;PELIUKAI;4014822452;Taip;12;0;0;12
8103;Raktelis;PELIUKAI;5758873229;Taip;8;1;0;9
8104;Raktelis;PELIUKAI;2141128125;Taip;0;0;1;1
8105;Raktelis;PELIUKAI;5688795147;Taip;4;2;0;6
8106;Raktelis;PELIUKAI;9497620710;Taip;13;0;1;14
8107;Raktelis;PELIUKAI;4502236264;Taip;19;1;0;20
8108;Raktelis;PELIUKAI;6822021176;Taip;8;0;0;8
8109;Raktelis;PELIUKAI;3517484891;Taip;0;5;0;5
8110;Raktelis;PELIUKAI;8700012974;Taip;0;7;0;7
8111;Raktelis;PELIUKAI;8035618134;Ne;8;0;0;8
8112;Raktelis;PELIUKAI;1445359221;Taip;9;0;0;9
8113;Raktelis;PELIUKAI;1263150004;Taip;7;1;0;8
8114;Raktelis;PELIUKAI;4834301832;Taip;6;1;0;7
8115;Raktelis;AGUONOS;6199212999;Taip;0;7;0;7
8116;Raktelis;AGUONOS;6281687751;Taip;0;1;0;1
8117;Raktelis;AGUONOS;1975411457;Taip;8;0;0;8
8118;Raktelis;AGUONOS;6367875352;Taip;0;4;0;4
8119;Raktelis;AGUONOS;7170546710;Taip;9;7;0;16
8120;Raktelis;AGUONOS;4905982507;Taip;0;2;0;2
8121;Raktelis;AGUONOS;9593639791;Taip;0;1;0;1
8122;Raktelis;AGUONOS;1392036584;Taip;6;9;0;15
8123;Raktelis;AGUONOS;6608224825;Taip;2;5;0;7
8124;Raktelis;AGUONOS;4658530212;Taip;5;1;0;6
8125;Raktelis;AGUONOS;8873203690;Taip;4;0;0;4
8126;Raktelis;AGUONOS;9357757604;Taip;0;9;0;9
8127;Raktelis;AGUONOS;8459980712;Taip;8;2;4;14
8128;Raktelis;AGUONOS;7973137015;Taip;7;7;0;14
8129;Raktelis;AGUONOS;9591285702;Taip;0;2;0;2
8130;Raktelis;AGUONOS;9210856228;Taip;3;0;0;3
8131;Raktelis;AGUONOS;8767785444;Taip;0;10;0;10
8132;Raktelis;AGUONOS;9355380341;Taip;0;0;3;3
8133;Raktelis;LAPIUKŲ;8869030487;Taip;11;0;0;11
8134;Raktelis;LAPIUKŲ;9130613710;Taip;5;8;0;13
8135;Raktelis;LAPIUKŲ;6385127914;Taip;0;5;0;5
8136;Raktelis;LAPIUKŲ;5925441742;Taip;1;2;2;5
8137;Raktelis;LAPIUKŲ;8207675881;Taip;0;3;0;3
8138;Raktelis;LAPIUKŲ;2282754345;Taip;0;3;0;3
8139;Raktelis;LAPIUKŲ;6894769625;Taip;11;1;0;12
8140;Raktelis;LAPIUKŲ;9048412613;Taip;0;1;0;1
8141;Raktelis;LAPIUKŲ;3380295375;Ne;12;5;0;17
8142;Raktelis;LAPIUKŲ;7142823740;Taip;0;1;0;1
8143;Raktelis;LAPIUKŲ;3395720463;Taip;0;12;0;12
8144;Raktelis;LAPIUKŲ;7055894770;Taip;0;1;0;1
8145;Raktelis;LAPIUKŲ;4167194960;Taip;3;0;0;3
8146;Raktelis;LAPIUKŲ;1322912585;Taip;0;3;0;3
8147;Raktelis;LAPIUKŲ;2809458453;Taip;0;2;0;2
8148;Raktelis;LAPIUKŲ;9151796053;Taip;17;0;0;17
8149;Raktelis;LAPIUKŲ;2967941870;Taip;14;0;0;14
8150;Raktelis;LAPIUKŲ;6892006495;Taip;0;7;0;7
8151;Raktelis;LAPIUKŲ;4228614834;Ne;0;4;0;4
8152;Raktelis;LAPIUKŲ;3884068578;Taip;0;4;0;4
8153;Raktelis;LAPIUKŲ;4755892641;Taip;5;6;0;11
8154;Raktelis;LAPIUKŲ;7869495911;Taip;8;1;0;9
8155;Raktelis;LAPIUKŲ;6877934219;Taip;0;22;0;22
8156;Raktelis;PELĖDŽIUKAI;25141529581;Taip;0;13;0;13
8157;Raktelis;PELĖDŽIUKAI;43500434912;Taip;0;7;0;7
8158;Raktelis;PELĖDŽIUKAI;95357638985;Taip;4;0;1;5
8159;Raktelis;PELĖDŽIUKAI;5275588088;Taip;0;3;0;3
8160;Raktelis;PELĖDŽIUKAI;3602722744;Taip;10;0;0;10
8161;Raktelis;PELĖDŽIUKAI;54341630847;Taip;0;3;0;3
8162;Raktelis;PELĖDŽIUKAI;4583377785;Taip;6;5;0;11
8163;Raktelis;PELĖDŽIUKAI;8320696048;Taip;2;0;0;2
8164;Raktelis;PELĖDŽIUKAI;1453677708;Ne;9;2;1;12
8165;Raktelis;PELĖDŽIUKAI;67304194087;Taip;3;2;0;5
8166;Raktelis;PELĖDŽIUKAI;2753402906;Taip;0;6;0;6
8167;Raktelis;PELĖDŽIUKAI;5768653399;Taip;11;1;0;12
8168;Raktelis;PELĖDŽIUKAI;7962509432;Taip;0;6;0;6
8169;Raktelis;PELĖDŽIUKAI;9053427316;Taip;0;2;0;2
8170;Raktelis;PELĖDŽIUKAI;63051817818;Taip;0;2;0;2
8171;Raktelis;PELĖDŽIUKAI;17270742947;Taip;0;5;0;5
8172;Raktelis;PELĖDŽIUKAI;3004895246;Ne;8;0;2;10
8173;Raktelis;"NAUJA (LOPŠELIS)";4578445282;Taip;0;4;0;4
8174;Raktelis;"NAUJA (LOPŠELIS)";7058612493;Taip;4;0;0;4
8175;Raktelis;"NAUJA (LOPŠELIS)";3968555691;Taip;0;13;0;13
8176;Raktelis;"NAUJA (LOPŠELIS)";4252867688;Taip;6;0;4;10
8177;Raktelis;"NAUJA (LOPŠELIS)";8817859592;Taip;9;0;0;9
8178;Raktelis;"NAUJA (LOPŠELIS)";3890474241;Taip;14;0;0;14
8179;Raktelis;"NAUJA (LOPŠELIS)";3456093273;Taip;0;4;0;4
8180;Raktelis;"NAUJA (LOPŠELIS)";4147382341;Taip;5;0;0;5
8181;Raktelis;"NAUJA (LOPŠELIS)";9164539135;Taip;10;2;0;12
8182;Raktelis;"NAUJA (LOPŠELIS)";4226277600;Ne;13;0;0;13
8183;Raktelis;"NAUJA (LOPŠELIS)";2361477092;Taip;19;1;0;20
8184;Rasa;Nykštukai;5176175108;Taip;0;1;6;7
8185;Rasa;Nykštukai;3979273111;Taip;0;10;0;10
8186;Rasa;Nykštukai;4847544355;Taip;0;10;2;12
8187;Rasa;Nykštukai;9723040721;Taip;0;9;0;9
8188;Rasa;Nykštukai;7004232909;Taip;0;10;3;13
8189;Rasa;Nykštukai;1223962374;Taip;0;0;2;2
8190;Rasa;Nykštukai;3200377629;Taip;0;11;1;12
8191;Rasa;Nykštukai;1336291828;Taip;0;9;0;9
8192;Rasa;Nykštukai;5861229664;Taip;12;10;0;22
8193;Rasa;Nykštukai;1386880644;Taip;0;6;1;7
8194;Rasa;Nykštukai;7228037580;Taip;3;3;0;6
8195;Rasa;Nykštukai;2093263887;Taip;0;8;0;8
8196;Rasa;Nykštukai;2540124793;Taip;0;6;0;6
8197;Rasa;Nykštukai;5363748728;Taip;0;31;0;31
8198;Rasa;Nykštukai;2977737634;Taip;13;0;0;13
8199;Rasa;Nykštukai;8310400946;Taip;0;10;1;11
8200;Rasa;Nykštukai;7520665472;Taip;0;7;0;7
8201;Rasa;Nykštukai;7534306402;Taip;0;9;0;9
8202;Rasa;Nykštukai;1991693486;Taip;12;0;0;12
8203;Rasa;Meškiukai;8052120247;Taip;5;4;0;9
8204;Rasa;Meškiukai;2110008545;Taip;7;2;0;9
8205;Rasa;Meškiukai;72772661373;Taip;0;4;0;4
8206;Rasa;Meškiukai;63673920646;Taip;5;2;0;7
8207;Rasa;Meškiukai;5932187584;Taip;0;14;0;14
8208;Rasa;Meškiukai;5145978804;Taip;22;10;0;32
8209;Rasa;Meškiukai;6356448094;Taip;0;6;0;6
8210;Rasa;Meškiukai;2683897055;Taip;0;26;0;26
8211;Rasa;Meškiukai;4790859112;Taip;4;1;0;5
8212;Rasa;Meškiukai;7534548604;Taip;4;5;0;9
8213;Rasa;Meškiukai;5606722133;Taip;0;14;0;14
8214;Rasa;Meškiukai;7565880116;Taip;0;13;0;13
8215;Rasa;Meškiukai;7544963724;Taip;0;21;0;21
8216;Rasa;Meškiukai;3567565920;Taip;0;16;0;16
8217;Rasa;Meškiukai;6734478649;Taip;0;2;0;2
8218;Rasa;Meškiukai;4837280374;Ne;0;11;0;11
8219;Rasa;Meškiukai;6879558965;Taip;8;0;0;8
8220;Rasa;Meškiukai;8818450386;Taip;6;4;0;10
8221;Rasa;Meškiukai;4260142706;Taip;0;3;0;3
8222;Rasa;Meškiukai;2982016133;Taip;0;6;0;6
8223;Rasa;Sauliukai;2233964230;Taip;0;22;0;22
8224;Rasa;Sauliukai;6154208507;Taip;0;1;4;5
8225;Rasa;Sauliukai;7413825519;Taip;0;3;0;3
8226;Rasa;Sauliukai;7575833127;Taip;0;1;5;6
8227;Rasa;Sauliukai;9438727789;Taip;0;3;3;6
8228;Rasa;Sauliukai;1049242346;Taip;0;5;3;8
8229;Rasa;Sauliukai;34934099958;Taip;0;8;0;8
8230;Rasa;Sauliukai;27131705540;Taip;0;1;0;1
8231;Rasa;Sauliukai;71420694152;Ne;0;6;6;12
8232;Rasa;Sauliukai;83227920971;Ne;0;1;0;1
8233;Rasa;Sauliukai;1214055260;Taip;0;4;0;4
8234;Rasa;Sauliukai;1210203141;Taip;0;3;0;3
8235;Rasa;Sauliukai;5072204356;Taip;0;2;7;9
8236;Rasa;Smalsučiai;2133989183;Taip;0;5;0;5
8237;Rasa;Smalsučiai;1176606744;Taip;0;9;0;9
8238;Rasa;Smalsučiai;3884105235;Taip;0;0;1;1
8239;Rasa;Smalsučiai;1726266997;Taip;0;1;0;1
8240;Rasa;Smalsučiai;2041098301;Taip;0;7;0;7
8241;Rasa;Smalsučiai;2158444381;Taip;0;2;3;5
8242;Rasa;Smalsučiai;2980868154;Taip;0;8;0;8
8243;Rasa;Smalsučiai;1728275988;Taip;0;9;0;9
8244;Rasa;Smalsučiai;56016538926;Taip;0;9;1;10
8245;Rasa;Smalsučiai;2349860704;Taip;0;9;6;15
8246;Rasa;Smalsučiai;5589971159;Taip;0;1;0;1
8247;Rasa;Smalsučiai;15257986685;Taip;0;12;0;12
8248;Rasa;Smalsučiai;6198612392;Taip;0;5;2;7
8249;Rasa;Smalsučiai;1093723298;Ne;0;5;1;6
8250;Rasa;Smalsučiai;1900027524;Taip;7;2;2;11
8251;Rasa;Smalsučiai;74744565967;Taip;3;7;1;11
8252;Rasa;"Pelėdžiukai ";6345614521;Taip;0;4;0;4
8253;Rasa;"Pelėdžiukai ";2121070882;Ne;0;12;0;12
8254;Rasa;"Pelėdžiukai ";1457384318;Taip;0;5;7;12
8255;Rasa;"Pelėdžiukai ";6704162447;Taip;0;2;0;2
8256;Rasa;"Pelėdžiukai ";7558966891;Taip;8;3;3;14
8257;Rasa;"Pelėdžiukai ";6773004268;Taip;6;5;0;11
8258;Rasa;"Pelėdžiukai ";3023088027;Taip;0;8;0;8
8259;Rasa;"Pelėdžiukai ";5325275053;Ne;0;4;0;4
8260;Rasa;"Pelėdžiukai ";4758605343;Taip;0;5;22;27
8261;Rasa;"Pelėdžiukai ";4084236196;Taip;0;0;3;3
8262;Rasa;"Pelėdžiukai ";3091012313;Taip;0;16;0;16
8263;Rasa;"Pelėdžiukai ";4995388517;Taip;0;1;1;2
8264;Rasa;"Pelėdžiukai ";1823276800;Taip;0;5;0;5
8265;Rasa;"Pelėdžiukai ";4603188598;Taip;0;9;2;11
8266;Rasa;"Pelėdžiukai ";1651905746;Taip;0;2;0;2
8267;Rasa;Katinėliai;5885520521;Taip;1;7;3;11
8268;Rasa;Katinėliai;5426981046;Taip;0;1;0;1
8269;Rasa;Katinėliai;3657956842;Ne;4;3;0;7
8270;Rasa;Katinėliai;6891623055;Ne;0;7;3;10
8271;Rasa;Katinėliai;9010812748;Taip;0;1;2;3
8272;Rasa;Katinėliai;7220007488;Taip;4;2;0;6
8273;Rasa;Katinėliai;8235869241;Taip;3;0;0;3
8274;Rasa;Katinėliai;2984661168;Taip;2;5;0;7
8275;Rasa;Katinėliai;4913483444;Taip;1;4;0;5
8276;Rasa;Katinėliai;4734775151;Ne;0;21;0;21
8277;Rasa;Katinėliai;4758138905;Taip;0;1;0;1
8278;Rasa;Katinėliai;9447346901;Taip;9;20;0;29
8279;Rasa;Katinėliai;3631124501;Taip;2;14;0;16
8280;Rasa;Katinėliai;9343039995;Taip;1;1;0;2
8281;Rasa;Ančiukai;7637404588;Taip;8;0;4;12
8282;Rasa;Ančiukai;6755131948;Taip;9;0;0;9
8283;Rasa;Ančiukai;7265752821;Taip;0;0;7;7
8284;Rasa;Ančiukai;1477018184;Taip;7;0;4;11
8285;Rasa;Ančiukai;4018241056;Taip;14;0;0;14
8286;Rasa;Ančiukai;1736903037;Taip;10;0;4;14
8287;Rasa;Ančiukai;4762348187;Taip;5;0;4;9
8288;Rasa;Ančiukai;8027532547;Taip;0;11;1;12
8289;Rasa;Ančiukai;7502435359;Taip;3;0;6;9
8290;Rasa;Ančiukai;8841534992;Taip;0;4;0;4
8291;Rasa;Ančiukai;7568880413;Taip;0;0;3;3
8292;Rasa;"Vyturiukai ";7028605422;Taip;4;9;0;13
8293;Rasa;"Vyturiukai ";9599510902;Taip;0;1;0;1
8294;Rasa;"Vyturiukai ";2800420481;Taip;0;6;0;6
8295;Rasa;"Vyturiukai ";5869253167;Taip;4;10;3;17
8296;Rasa;"Vyturiukai ";7037958994;Taip;0;10;0;10
8297;Rasa;"Vyturiukai ";8236785255;Taip;0;11;2;13
8298;Rasa;"Vyturiukai ";6887471189;Taip;0;5;0;5
8299;Rasa;"Vyturiukai ";9668538340;Taip;0;13;0;13
8300;Rasa;"Vyturiukai ";4694111253;Taip;0;3;1;4
8301;Rasa;"Vyturiukai ";6011243039;Taip;0;4;12;16
8302;Rasa;"Vyturiukai ";2347639286;Taip;0;2;2;4
8303;Rasa;"Vyturiukai ";1206005039;Taip;0;1;2;3
8304;Rasa;"Vyturiukai ";9788282861;Taip;2;6;4;12
8305;Rasa;"Vyturiukai ";2711923397;Taip;8;10;1;19
8306;Rasa;"Vyturiukai ";2769096357;Taip;11;10;0;21
8307;Rasa;"Vyturiukai ";5668878259;Taip;16;6;2;24
8308;Rasa;"Vyturiukai ";6883073764;Taip;2;6;8;16
8309;Rasa;Voveriukai;4111850024;Taip;3;2;0;5
8310;Rasa;Voveriukai;2190948879;Taip;9;3;0;12
8311;Rasa;Voveriukai;1978999728;Ne;3;2;2;7
8312;Rasa;Voveriukai;3546684695;Taip;5;10;0;15
8313;Rasa;Voveriukai;4010262461;Taip;0;0;1;1
8314;Rasa;Voveriukai;5740754301;Taip;0;1;2;3
8315;Rasa;Voveriukai;1355729894;Ne;8;6;0;14
8316;Rasa;Voveriukai;5977524939;Taip;10;8;0;18
8317;Rasa;Voveriukai;1592174114;Taip;7;11;0;18
8318;Rasa;Voveriukai;1564194649;Taip;0;2;0;2
8319;Rasa;Voveriukai;1764959761;Taip;7;7;2;16
8320;Rasa;Voveriukai;1765617605;Taip;0;11;1;12
8321;Rasa;Voveriukai;7226105624;Taip;2;2;4;8
8322;Rasa;Voveriukai;8232576658;Taip;0;0;2;2
8323;Rasa;Voveriukai;1733179752;Taip;6;4;0;10
8324;Rasa;Voveriukai;2895124729;Taip;3;10;2;15
8325;Rasa;Voveriukai;8469342353;Taip;3;1;0;4
8326;Rasa;Voveriukai;3470054190;Taip;12;5;1;18
8327;Rasa;Voveriukai;9367108308;Taip;21;6;0;27
8328;Rasa;"DRUGELIAI ";3073804713;Taip;0;2;0;2
8329;Rasa;"DRUGELIAI ";5165588335;Taip;3;1;1;5
8330;Rasa;"DRUGELIAI ";6691161322;Taip;0;1;0;1
8331;Rasa;"DRUGELIAI ";6874601830;Taip;11;10;0;21
8332;Rasa;"DRUGELIAI ";4127921417;Taip;0;1;3;4
8333;Rasa;"DRUGELIAI ";3548008659;Taip;0;22;0;22
8334;Rasa;"DRUGELIAI ";3773600344;Taip;22;0;0;22
8335;Rasa;"DRUGELIAI ";2371282781;Taip;22;0;0;22
8336;Rasa;"DRUGELIAI ";2555108465;Taip;14;0;0;14
8337;Rasa;"DRUGELIAI ";1992726664;Taip;0;3;0;3
8338;Rasa;"DRUGELIAI ";6134386879;Taip;0;22;0;22
8339;Rasa;"DRUGELIAI ";7843789214;Taip;0;0;2;2
8340;Rasa;"DRUGELIAI ";8314522373;Taip;0;9;0;9
8341;Rasa;"DRUGELIAI ";8740659600;Taip;0;22;0;22
8342;Rasa;"DRUGELIAI ";7357915584;Taip;0;10;0;10
8343;Rasa;"DRUGELIAI ";8378755600;Taip;11;0;2;13
8344;Rasa;Zuikučiai;4554377449;Taip;0;11;0;11
8345;Rasa;Zuikučiai;2137321989;Taip;0;6;0;6
8346;Rasa;Zuikučiai;1993471951;Taip;14;9;0;23
8347;Rasa;Zuikučiai;1860462451;Taip;8;3;0;11
8348;Rasa;Zuikučiai;42609897431;Taip;0;15;0;15
8349;Rasa;Zuikučiai;55374082940;Taip;0;2;0;2
8350;Rasa;Zuikučiai;7397794681;Taip;0;8;0;8
8351;Rasa;Zuikučiai;1131418692;Taip;4;0;0;4
8352;Rasa;Zuikučiai;9432880035;Taip;13;0;0;13
8353;Rasa;Zuikučiai;33479419656;Taip;0;5;0;5
8354;Rasa;Zuikučiai;2840872613;Taip;0;4;0;4
8355;Rasa;Zuikučiai;91931863004;Taip;0;13;0;13
8356;Rasa;Zuikučiai;58858081077;Taip;6;2;0;8
8357;Rasa;Zuikučiai;1210340955;Taip;0;5;0;5
8358;Rasa;Zuikučiai;8909888927;Taip;0;1;0;1
8359;Rasa;Širdelė;8424049317;Taip;8;10;0;18
8360;Rasa;Širdelė;5599182715;Taip;0;11;0;11
8361;Rasa;Širdelė;9648034081;Taip;3;13;0;16
8362;Rasa;Širdelė;8236464670;Taip;0;9;0;9
8363;Rasa;Širdelė;2626361958;Taip;0;8;0;8
8364;Rasa;Širdelė;6976298054;Taip;0;13;0;13
8365;Rasa;Širdelė;3668598028;Taip;0;13;0;13
8366;Rasa;Širdelė;2132535297;Taip;5;11;0;16
8367;Rasa;Širdelė;8866896989;Taip;0;26;0;26
8368;Rasa;Širdelė;9938280570;Taip;0;10;0;10
8369;Rasa;Širdelė;2333938367;Taip;0;12;0;12
8370;Rasa;Širdelė;9560289781;Taip;0;9;0;9
8371;Rasa;Širdelė;5719253028;Taip;8;10;0;18
8372;Rasa;Širdelė;9140875020;Ne;14;12;0;26
8373;Rasa;Širdelė;4694382836;Taip;9;13;0;22
8374;Rasa;Širdelė;7065597550;Taip;0;9;0;9
8375;Rasa;Širdelė;1690518970;Taip;5;9;0;14
8376;Rasa;Širdelė;1796573723;Taip;0;5;0;5
8377;Rasa;Širdelė;3535655117;Taip;0;8;0;8
8378;Rasa;Širdelė;2830296197;Taip;7;4;0;11
8379;Riešutėlis;Viščiukų;8498902448;Taip;9;0;2;11
8380;Riešutėlis;Viščiukų;2498093110;Taip;6;0;0;6
8381;Riešutėlis;Viščiukų;3931422170;Taip;4;0;2;6
8382;Riešutėlis;Viščiukų;7608622330;Taip;0;2;20;22
8383;Riešutėlis;Viščiukų;6815804556;Taip;5;0;0;5
8384;Riešutėlis;Viščiukų;3475897400;Taip;0;0;2;2
8385;Riešutėlis;Viščiukų;5407487415;Taip;0;0;22;22
8386;Riešutėlis;Viščiukų;4591910912;Taip;0;6;4;10
8387;Riešutėlis;Viščiukų;3592271009;Taip;11;1;2;14
8388;Riešutėlis;Viščiukų;6092611227;Taip;0;22;0;22
8389;Riešutėlis;Viščiukų;9285782325;Taip;0;0;11;11
8390;Riešutėlis;Viščiukų;6783817706;Ne;0;0;6;6
8391;Riešutėlis;Viščiukų;7473054556;Taip;1;1;0;2
8392;Riešutėlis;"Riešutėliai ";3800733442;Taip;3;1;3;7
8393;Riešutėlis;"Riešutėliai ";7342985744;Taip;8;0;6;14
8394;Riešutėlis;"Riešutėliai ";5915019363;Taip;0;0;6;6
8395;Riešutėlis;"Riešutėliai ";2207907790;Taip;10;1;4;15
8396;Riešutėlis;"Riešutėliai ";9699503472;Taip;0;0;1;1
8397;Riešutėlis;"Riešutėliai ";2098369052;Taip;0;0;4;4
8398;Riešutėlis;"Riešutėliai ";1426700414;Taip;0;4;0;4
8399;Riešutėlis;"Riešutėliai ";8539906445;Taip;0;1;0;1
8400;Riešutėlis;"Riešutėliai ";5873443383;Taip;0;9;1;10
8401;Riešutėlis;"Riešutėliai ";2301247729;Taip;0;10;0;10
8402;Riešutėlis;"Riešutėliai ";3602707130;Taip;7;8;0;15
8403;Riešutėlis;"Riešutėliai ";8991963843;Taip;0;1;3;4
8404;Riešutėlis;"Riešutėliai ";4293402095;Taip;0;3;0;3
8405;Riešutėlis;"Riešutėliai ";8917451081;Taip;0;4;0;4
8406;Riešutėlis;"Riešutėliai ";4698338374;Taip;5;1;0;6
8407;Riešutėlis;"Riešutėliai ";3345064565;Taip;6;0;0;6
8408;Riešutėlis;Ežiukai;7030346495;Taip;0;16;3;19
8409;Riešutėlis;Ežiukai;9750713954;Taip;7;2;0;9
8410;Riešutėlis;Ežiukai;7601776182;Taip;3;2;0;5
8411;Riešutėlis;Ežiukai;7381623086;Taip;0;5;3;8
8412;Riešutėlis;Ežiukai;9964688413;Taip;0;0;2;2
8413;Riešutėlis;Ežiukai;1548585448;Taip;0;10;0;10
8414;Riešutėlis;Ežiukai;8954127616;Taip;16;1;1;18
8415;Riešutėlis;Ežiukai;2092933906;Taip;0;15;2;17
8416;Riešutėlis;Ežiukai;6813024366;Taip;0;2;0;2
8417;Riešutėlis;Ežiukai;7913381005;Taip;5;6;0;11
8418;Riešutėlis;Ežiukai;3460145784;Taip;0;2;0;2
8419;Riešutėlis;Ežiukai;8480059272;Taip;3;3;0;6
8420;Riešutėlis;Ežiukai;5728858361;Taip;1;1;0;2
8421;Riešutėlis;Ežiukai;5327627748;Taip;5;5;1;11
8422;Riešutėlis;Ežiukai;6259158270;Taip;0;0;11;11
8423;Riešutėlis;Ežiukai;6194259707;Taip;0;3;0;3
8424;Riešutėlis;Ežiukai;2837471235;Taip;0;16;0;16
8425;Riešutėlis;Ežiukai;2699984170;Taip;0;1;0;1
8426;Riešutėlis;Ežiukai;7050440691;Taip;6;1;1;8
8427;Riešutėlis;Pelėdžiukai;6303767779;Taip;5;0;2;7
8428;Riešutėlis;Pelėdžiukai;8018914251;Taip;0;2;0;2
8429;Riešutėlis;Pelėdžiukai;8012201566;Taip;0;9;0;9
8430;Riešutėlis;Pelėdžiukai;8751571852;Taip;14;0;2;16
8431;Riešutėlis;Pelėdžiukai;5479780116;Taip;0;3;0;3
8432;Riešutėlis;Pelėdžiukai;9839084885;Taip;0;0;8;8
8433;Riešutėlis;Pelėdžiukai;6928558714;Taip;5;0;0;5
8434;Riešutėlis;Pelėdžiukai;9040123535;Taip;0;6;0;6
8435;Riešutėlis;Pelėdžiukai;6405116059;Taip;3;0;3;6
8436;Riešutėlis;Pelėdžiukai;5995176001;Taip;0;3;0;3
8437;Riešutėlis;Pelėdžiukai;2430518637;Taip;0;2;0;2
8438;Riešutėlis;Pelėdžiukai;4451419273;Ne;0;13;3;16
8439;Riešutėlis;Pelėdžiukai;1638021880;Taip;10;2;0;12
8440;Riešutėlis;Pelėdžiukai;4581184004;Taip;18;0;0;18
8441;Riešutėlis;Pelėdžiukai;5598052531;Taip;0;1;4;5
8442;Riešutėlis;Meškiukai;92159110899;Taip;0;10;0;10
8443;Riešutėlis;Meškiukai;1526573984;Taip;0;2;1;3
8444;Riešutėlis;Meškiukai;4464545735;Taip;0;1;0;1
8445;Riešutėlis;Meškiukai;2163433983;Taip;0;2;1;3
8446;Riešutėlis;Meškiukai;35876952602;Taip;0;2;4;6
8447;Riešutėlis;Meškiukai;6149891188;Taip;0;2;0;2
8448;Riešutėlis;Meškiukai;8864100655;Taip;0;2;0;2
8449;Riešutėlis;Meškiukai;2973908247;Taip;0;0;3;3
8450;Riešutėlis;Meškiukai;1748738558;Taip;0;2;0;2
8451;Riešutėlis;Meškiukai;9205961122;Taip;0;0;3;3
8452;Riešutėlis;Meškiukai;96066602684;Taip;0;3;0;3
8453;Riešutėlis;Meškiukai;49061132665;Taip;0;1;0;1
8454;Riešutėlis;Meškiukai;1250209796;Taip;0;6;0;6
8455;Riešutėlis;Meškiukai;93192056557;Taip;0;1;0;1
8456;Riešutėlis;Meškiukai;1747328573;Taip;0;1;0;1
8457;Riešutėlis;Meškiukai;18310744085;Taip;0;1;0;1
8458;Riešutėlis;Meškiukai;1623455993;Taip;0;2;4;6
8459;Riešutėlis;Meškiukai;50338275044;Taip;0;10;0;10
8460;Riešutėlis;Meškiukai;90088217854;Taip;0;1;0;1
8461;Riešutėlis;Meškiukai;5537309549;Taip;9;2;0;11
8462;Riešutėlis;Meškiukai;1091941952;Taip;0;8;1;9
8463;Riešutėlis;Meškiukai;8271632629;Taip;0;0;3;3
8464;Riešutėlis;Meškiukai;4898775561;Taip;0;8;0;8
8465;Riešutėlis;Meškiukai;2097580659;Taip;0;3;0;3
8466;Riešutėlis;Kiškučiai;9297835044;Taip;3;2;0;5
8467;Riešutėlis;Kiškučiai;9086474785;Taip;16;0;1;17
8468;Riešutėlis;Kiškučiai;3363757821;Ne;13;1;0;14
8469;Riešutėlis;Kiškučiai;2581250615;Taip;0;2;7;9
8470;Riešutėlis;Kiškučiai;8445984114;Taip;0;0;22;22
8471;Riešutėlis;Kiškučiai;1168433014;Taip;0;2;0;2
8472;Riešutėlis;Kiškučiai;5266946070;Taip;4;0;0;4
8473;Riešutėlis;Kiškučiai;9357375649;Taip;4;4;0;8
8474;Riešutėlis;Kiškučiai;9548551553;Taip;7;0;0;7
8475;Riešutėlis;Kiškučiai;9500744921;Ne;7;0;0;7
8476;Riešutėlis;Kiškučiai;4851336076;Taip;3;5;0;8
8477;Riešutėlis;Kiškučiai;6705754238;Taip;0;7;0;7
8478;Riešutėlis;Kiškučiai;2915358934;Taip;11;2;0;13
8479;Riešutėlis;Kiškučiai;9964105252;Taip;10;0;0;10
8480;Riešutėlis;Kiškučiai;6693197006;Taip;5;0;1;6
8481;Riešutėlis;Voveriukų;9023304543;Taip;0;2;0;2
8482;Riešutėlis;Voveriukų;6097581240;Taip;0;2;0;2
8483;Riešutėlis;Voveriukų;8077135868;Taip;0;2;0;2
8484;Riešutėlis;Voveriukų;4404544549;Taip;0;2;0;2
8485;Riešutėlis;Voveriukų;11913461630;Taip;0;5;0;5
8486;Riešutėlis;Voveriukų;55620350407;Taip;10;2;0;12
8487;Riešutėlis;Voveriukų;3806836220;Taip;0;2;2;4
8488;Riešutėlis;Voveriukų;1160573638;Taip;0;8;0;8
8489;Riešutėlis;Voveriukų;24776322315;Taip;4;0;2;6
8490;Riešutėlis;Voveriukų;2112179980;Ne;0;1;0;1
8491;Riešutėlis;Voveriukų;5717194707;Taip;0;4;0;4
8492;Riešutėlis;Voveriukų;6402032861;Taip;0;6;0;6
8493;Riešutėlis;Voveriukų;8749505821;Taip;0;12;0;12
8494;Riešutėlis;Voveriukų;9198963882;Taip;0;1;0;1
8495;Riešutėlis;Voveriukų;1056034480;Taip;0;7;0;7
8496;Riešutėlis;Saulutės;4004669930;Taip;0;15;0;15
8497;Riešutėlis;Saulutės;7177632315;Taip;0;2;0;2
8498;Riešutėlis;Saulutės;6721758785;Taip;0;7;0;7
8499;Riešutėlis;Saulutės;1748151109;Taip;0;10;2;12
8500;Riešutėlis;Saulutės;8504832383;Taip;5;0;0;5
8501;Riešutėlis;Saulutės;6292679662;Taip;9;0;1;10
8502;Riešutėlis;Saulutės;8738716660;Taip;0;2;4;6
8503;Riešutėlis;Saulutės;4828635362;Taip;0;2;0;2
8504;Riešutėlis;Saulutės;1196740726;Taip;0;7;0;7
8505;Riešutėlis;Saulutės;8415858895;Taip;0;0;3;3
8506;Riešutėlis;Saulutės;4498718519;Taip;0;6;16;22
8507;Riešutėlis;Saulutės;5753609922;Taip;0;4;0;4
8508;Riešutėlis;Saulutės;1860995033;Taip;0;2;1;3
8509;Riešutėlis;Saulutės;5013754772;Taip;5;0;0;5
8510;Riešutėlis;Saulutės;7154361660;Taip;15;5;0;20
8511;Riešutėlis;Saulutės;2572642260;Taip;0;0;2;2
8512;Riešutėlis;"Boruželės ";16561622902;Taip;9;2;2;13
8513;Riešutėlis;"Boruželės ";1936519033;Taip;0;2;4;6
8514;Riešutėlis;"Boruželės ";2611705234;Taip;10;2;0;12
8515;Riešutėlis;"Boruželės ";4131218911;Taip;4;2;0;6
8516;Riešutėlis;"Boruželės ";1455509576;Taip;0;2;4;6
8517;Riešutėlis;"Boruželės ";3577669231;Taip;0;2;4;6
8518;Riešutėlis;"Boruželės ";9670912357;Taip;8;2;2;12
8519;Riešutėlis;"Boruželės ";26781529460;Taip;0;0;5;5
8520;Riešutėlis;"Boruželės ";5097410462;Taip;0;2;4;6
8521;Riešutėlis;"Boruželės ";8087180983;Taip;11;0;7;18
8522;Riešutėlis;"Boruželės ";2566084613;Taip;0;0;22;22
8523;Riešutėlis;"Boruželės ";1640383686;Taip;0;0;3;3
8524;Riešutėlis;"Boruželės ";3851000866;Taip;0;1;0;1
8525;Riešutėlis;"Boruželės ";1623681835;Taip;1;2;0;3
8526;Riešutėlis;"Boruželės ";1818130297;Taip;0;6;0;6
8527;Riešutėlis;"Boruželės ";6594928740;Ne;6;0;0;6
8528;Riešutėlis;"Boruželės ";4276034784;Taip;0;2;0;2
8529;Riešutėlis;"Bitutės ";1000408690;Taip;0;1;5;6
8530;Riešutėlis;"Bitutės ";3149710709;Taip;0;1;0;1
8531;Riešutėlis;"Bitutės ";1918857028;Taip;0;1;0;1
8532;Riešutėlis;"Bitutės ";1686215195;Taip;0;1;0;1
8533;Riešutėlis;"Bitutės ";4366097328;Taip;4;1;0;5
8534;Riešutėlis;"Bitutės ";2395648260;Taip;11;4;0;15
8535;Riešutėlis;"Bitutės ";59796628656;Taip;0;2;0;2
8536;Riešutėlis;"Bitutės ";6852846350;Taip;3;6;0;9
8537;Riešutėlis;"Bitutės ";13815744901;Taip;0;5;1;6
8538;Riešutėlis;"Bitutės ";91430094368;Taip;0;1;0;1
8539;Riešutėlis;"Bitutės ";65873300738;Taip;0;6;0;6
8540;Riešutėlis;"Bitutės ";8313605541;Taip;0;1;2;3
8541;Riešutėlis;"Bitutės ";1921241349;Taip;0;1;4;5
8542;Riešutėlis;"Bitutės ";7987368969;Taip;0;4;0;4
8543;Riešutėlis;"Bitutės ";85564700996;Taip;3;0;4;7
8544;Riešutėlis;"Bitutės ";85356230208;Taip;0;9;5;14
8545;Riešutėlis;"Bitutės ";1674871670;Ne;0;1;9;10
8546;Riešutėlis;"Bitutės ";49061075792;Taip;0;11;0;11
8547;Riešutėlis;"Bitutės ";1853283967;Taip;3;0;2;5
8548;Riešutėlis;"Bitutės ";1858221034;Taip;0;1;2;3
8549;Riešutėlis;Drugelių;8266735624;Taip;0;3;0;3
8550;Riešutėlis;Drugelių;4776231497;Taip;0;3;0;3
8551;Riešutėlis;Drugelių;8578903763;Taip;0;11;0;11
8552;Riešutėlis;Drugelių;7769079730;Taip;0;2;0;2
8553;Riešutėlis;Drugelių;5811657782;Taip;0;4;0;4
8554;Riešutėlis;Drugelių;1075842434;Taip;0;0;3;3
8555;Riešutėlis;Drugelių;8845709386;Taip;0;10;0;10
8556;Riešutėlis;Drugelių;8128352818;Taip;3;0;0;3
8557;Riešutėlis;Drugelių;8180618419;Taip;4;1;0;5
8558;Riešutėlis;Drugelių;5412882446;Taip;0;1;7;8
8559;Riešutėlis;Drugelių;8020533200;Taip;0;5;0;5
8560;Riešutėlis;Drugelių;1164273595;Taip;5;1;0;6
8561;Riešutėlis;Drugelių;8918753084;Taip;3;1;0;4
8562;Riešutėlis;Drugelių;3836374000;Taip;0;2;0;2
8563;Riešutėlis;Drugelių;8016820352;Taip;1;2;0;3
8564;Riešutėlis;Drugelių;3975091711;Taip;0;4;0;4
8565;Riešutėlis;Drugelių;3071643137;Taip;0;2;0;2
8566;Riešutėlis;Drugelių;2599147931;Taip;0;1;0;1
8567;Riešutėlis;Drugelių;3151689985;Taip;10;0;0;10
8568;Riešutėlis;Drugelių;4845447863;Taip;0;0;13;13
8569;Riešutėlis;"NAUJA (LOPŠELIS)";1705599429;Taip;2;2;0;4
8570;Riešutėlis;"NAUJA (LOPŠELIS)";6147780439;Taip;3;0;0;3
8571;Riešutėlis;"NAUJA (LOPŠELIS)";3251066115;Taip;0;7;0;7
8572;Riešutėlis;"NAUJA (LOPŠELIS)";2467739101;Taip;0;0;2;2
8573;Riešutėlis;"NAUJA (LOPŠELIS)";2587460110;Taip;3;0;1;4
8574;Riešutėlis;"NAUJA (LOPŠELIS)";6121386391;Taip;4;0;2;6
8575;Riešutėlis;"NAUJA (LOPŠELIS)";3287685792;Taip;0;2;3;5
8576;Riešutėlis;"NAUJA (LOPŠELIS)";4897581681;Taip;20;0;0;20
8577;Riešutėlis;"NAUJA (LOPŠELIS)";4116506453;Taip;3;0;0;3
8578;Riešutėlis;"NAUJA (LOPŠELIS)";4448024452;Taip;10;0;0;10
8579;Riešutėlis;"NAUJA (LOPŠELIS)";4866613045;Taip;0;22;0;22
8580;Riešutėlis;"NAUJA (LOPŠELIS)";1811701628;Taip;14;0;1;15
8581;Riešutėlis;"NAUJA (LOPŠELIS)";7256075146;Taip;4;6;0;10
8582;Riešutėlis;"NAUJA (LOPŠELIS)";5183264581;Taip;0;8;0;8
8583;Riešutėlis;"NAUJA (LOPŠELIS)";4808684145;Taip;0;2;0;2
8584;Riešutėlis;"NAUJA (LOPŠELIS)";5443448616;Taip;0;4;0;4
8585;Riešutėlis;"NAUJA (LOPŠELIS)";9598824163;Taip;5;0;0;5
8586;Riešutėlis;"NAUJA (LOPŠELIS)";8839482370;Taip;12;5;1;18
8587;Riešutėlis;"NAUJA (LOPŠELIS)";3975540383;Taip;0;0;1;1
8588;Ramunėlė;SAULUTĖS;1192743154;Taip;0;12;0;12
8589;Ramunėlė;SAULUTĖS;5562960498;Ne;0;14;0;14
8590;Ramunėlė;SAULUTĖS;5714771643;Taip;0;2;0;2
8591;Ramunėlė;SAULUTĖS;1483391590;Taip;5;2;0;7
8592;Ramunėlė;SAULUTĖS;4209191105;Taip;0;10;0;10
8593;Ramunėlė;SAULUTĖS;9927068798;Taip;8;2;3;13
8594;Ramunėlė;SAULUTĖS;7219400182;Taip;0;2;0;2
8595;Ramunėlė;SAULUTĖS;3779769727;Taip;9;5;0;14
8596;Ramunėlė;SAULUTĖS;5605444408;Taip;1;1;0;2
8597;Ramunėlė;SAULUTĖS;5465647281;Taip;0;11;0;11
8598;Ramunėlė;SAULUTĖS;8912978935;Taip;0;11;0;11
8599;Ramunėlė;SAULUTĖS;7902931560;Taip;0;1;0;1
8600;Ramunėlė;SAULUTĖS;1618282165;Taip;0;1;0;1
8601;Ramunėlė;SAULUTĖS;9568886284;Taip;0;6;10;16
8602;Ramunėlė;SAULUTĖS;9533155706;Taip;12;2;0;14
8603;Ramunėlė;SAULUTĖS;5117135860;Taip;5;7;0;12
8604;Ramunėlė;ŽIBUTĖ;2127262855;Taip;0;16;0;16
8605;Ramunėlė;ŽIBUTĖ;71451001033;Taip;0;1;0;1
8606;Ramunėlė;ŽIBUTĖ;8943746426;Taip;12;1;0;13
8607;Ramunėlė;ŽIBUTĖ;57697488265;Taip;0;6;0;6
8608;Ramunėlė;ŽIBUTĖ;4103951942;Taip;0;8;0;8
8609;Ramunėlė;ŽIBUTĖ;37227575121;Taip;2;6;0;8
8610;Ramunėlė;ŽIBUTĖ;9615607625;Taip;0;10;0;10
8611;Ramunėlė;ŽIBUTĖ;24395304267;Taip;0;4;0;4
8612;Ramunėlė;ŽIBUTĖ;41210974793;Ne;0;4;0;4
8613;Ramunėlė;ŽIBUTĖ;78632810141;Taip;0;14;0;14
8614;Ramunėlė;ŽIBUTĖ;8826277893;Taip;0;7;0;7
8615;Ramunėlė;ŽIBUTĖ;573414969;Taip;0;7;0;7
8616;Ramunėlė;ŽIBUTĖ;1383896021;Taip;0;1;0;1
8617;Ramunėlė;ŽIBUTĖ;1898089064;Taip;0;3;0;3
8618;Ramunėlė;ŽIBUTĖ;6126971384;Taip;0;9;0;9
8619;Ramunėlė;ŽIBUTĖ;21178777924;Taip;0;3;1;4
8620;Ramunėlė;ŽIBUTĖ;1845973626;Taip;0;11;0;11
8621;Ramunėlė;ŽIBUTĖ;1575204445;Taip;0;10;0;10
8622;Ramunėlė;ŽIBUTĖ;2069380818;Taip;15;1;0;16
8623;Ramunėlė;ŽIBUTĖ;1511271386;Taip;0;3;0;3
8624;Ramunėlė;ŽIBUTĖ;1077068878;Taip;0;8;0;8
8625;Ramunėlė;ŽIBUTĖ;1891454355;Taip;0;17;0;17
8626;Ramunėlė;ŽIBUTĖ;1690268842;Taip;0;9;0;9
8627;Ramunėlė;ŽIRNIUKAI;11512621396;Taip;0;3;0;3
8628;Ramunėlė;ŽIRNIUKAI;3973083939;Taip;9;2;2;13
8629;Ramunėlė;ŽIRNIUKAI;53748116108;Taip;0;4;0;4
8630;Ramunėlė;ŽIRNIUKAI;1028730863;Taip;0;4;1;5
8631;Ramunėlė;ŽIRNIUKAI;1085668968;Taip;0;3;0;3
8632;Ramunėlė;ŽIRNIUKAI;2075485387;Taip;0;2;0;2
8633;Ramunėlė;ŽIRNIUKAI;2036562086;Taip;0;3;0;3
8634;Ramunėlė;ŽIRNIUKAI;85179822339;Taip;0;2;1;3
8635;Ramunėlė;ŽIRNIUKAI;57963557951;Taip;4;0;0;4
8636;Ramunėlė;ŽIRNIUKAI;1485876800;Taip;4;1;0;5
8637;Ramunėlė;ŽIRNIUKAI;1386186515;Taip;0;3;0;3
8638;Ramunėlė;ŽIRNIUKAI;1364997950;Taip;0;15;0;15
8639;Ramunėlė;ŽIRNIUKAI;1171170929;Taip;0;2;2;4
8640;Ramunėlė;ŽIRNIUKAI;10677635919;Taip;5;8;0;13
8641;Ramunėlė;ŽIRNIUKAI;1157861595;Taip;0;0;1;1
8642;Ramunėlė;ŽIRNIUKAI;1397784717;Taip;7;0;8;15
8643;Ramunėlė;ŽIRNIUKAI;17292085814;Taip;0;10;0;10
8644;Ramunėlė;ŽIRNIUKAI;1500685962;Taip;0;8;0;8
8645;Ramunėlė;ŽIRNIUKAI;4814208279;Taip;0;6;0;6
8646;Ramunėlė;ŽIRNIUKAI;8254302108;Taip;0;11;0;11
8647;Ramunėlė;ŽIRNIUKAI;9448369796;Taip;0;1;1;2
8648;Ramunėlė;BITUTĖS;1343249939;Taip;0;8;1;9
8649;Ramunėlė;BITUTĖS;8098492540;Taip;0;19;0;19
8650;Ramunėlė;BITUTĖS;6329943991;Taip;0;21;0;21
8651;Ramunėlė;BITUTĖS;7307307882;Taip;0;12;0;12
8652;Ramunėlė;BITUTĖS;2225787182;Taip;9;2;0;11
8653;Ramunėlė;BITUTĖS;6166192468;Taip;0;7;0;7
8654;Ramunėlė;BITUTĖS;5865482869;Taip;0;16;0;16
8655;Ramunėlė;BITUTĖS;8940763540;Taip;0;19;0;19
8656;Ramunėlė;BITUTĖS;6843262303;Taip;0;1;1;2
8657;Ramunėlė;BITUTĖS;7692958269;Taip;0;3;1;4
8658;Ramunėlė;BITUTĖS;8086994543;Taip;9;6;0;15
8659;Ramunėlė;BITUTĖS;5822045625;Taip;0;5;0;5
8660;Ramunėlė;DRUGELIAI;67836032797;Taip;0;11;0;11
8661;Ramunėlė;DRUGELIAI;9017349382;Taip;3;3;0;6
8662;Ramunėlė;DRUGELIAI;1376538015;Taip;0;14;0;14
8663;Ramunėlė;DRUGELIAI;1783572058;Taip;0;6;0;6
8664;Ramunėlė;DRUGELIAI;30907738272;Taip;0;1;0;1
8665;Ramunėlė;DRUGELIAI;1814199950;Taip;0;1;0;1
8666;Ramunėlė;DRUGELIAI;1199690327;Taip;0;0;3;3
8667;Ramunėlė;DRUGELIAI;1988109236;Taip;1;10;0;11
8668;Ramunėlė;DRUGELIAI;52168460247;Taip;0;0;4;4
8669;Ramunėlė;DRUGELIAI;66630134164;Taip;3;0;0;3
8670;Ramunėlė;DRUGELIAI;9584620339;Taip;0;0;1;1
8671;Ramunėlė;DRUGELIAI;6930505887;Taip;11;1;0;12
8672;Ramunėlė;DRUGELIAI;8402889872;Taip;5;2;6;13
8673;Ramunėlė;DRUGELIAI;1745170057;Taip;4;2;1;7
8674;Ramunėlė;DRUGELIAI;7228065409;Taip;0;7;0;7
8675;Ramunėlė;DRUGELIAI;5170325023;Taip;0;3;0;3
8676;Ramunėlė;DRUGELIAI;3617897977;Taip;5;2;0;7
8677;Ramunėlė;DRUGELIAI;8768539595;Taip;4;9;0;13
8678;Ramunėlė;DRUGELIAI;2055332353;Taip;0;9;0;9
8679;Ramunėlė;DRUGELIAI;1078618047;Taip;0;10;0;10
8680;Ramunėlė;NEUŽMIRŠTUOLĖS;2558296296;Taip;12;6;0;18
8681;Ramunėlė;NEUŽMIRŠTUOLĖS;1797997937;Taip;2;0;0;2
8682;Ramunėlė;NEUŽMIRŠTUOLĖS;9326288662;Taip;9;6;0;15
8683;Ramunėlė;NEUŽMIRŠTUOLĖS;6892481929;Taip;0;11;0;11
8684;Ramunėlė;NEUŽMIRŠTUOLĖS;9928703066;Taip;0;3;0;3
8685;Ramunėlė;NEUŽMIRŠTUOLĖS;9327730190;Taip;18;6;4;28
8686;Ramunėlė;NEUŽMIRŠTUOLĖS;4756689520;Taip;9;14;0;23
8687;Ramunėlė;NEUŽMIRŠTUOLĖS;2070729684;Taip;15;10;0;25
8688;Ramunėlė;NEUŽMIRŠTUOLĖS;9789690425;Taip;0;17;0;17
8689;Ramunėlė;NEUŽMIRŠTUOLĖS;7220407572;Taip;0;4;0;4
8690;Ramunėlė;NEUŽMIRŠTUOLĖS;6342801407;Taip;0;4;1;5
8691;Ramunėlė;NEUŽMIRŠTUOLĖS;1916520056;Taip;13;10;0;23
8692;Ramunėlė;NEUŽMIRŠTUOLĖS;8942483792;Taip;0;25;0;25
8693;Ramunėlė;NEUŽMIRŠTUOLĖS;6870110390;Taip;7;2;0;9
8694;Ramunėlė;NEUŽMIRŠTUOLĖS;2245564567;Taip;7;3;0;10
8695;Ramunėlė;NEUŽMIRŠTUOLĖS;6881228078;Taip;0;7;0;7
8696;Ramunėlė;NEUŽMIRŠTUOLĖS;1182350830;Taip;8;16;0;24
8697;Ramunėlė;NEUŽMIRŠTUOLĖS;4329292281;Taip;3;13;2;18
8698;Ramunėlė;NEUŽMIRŠTUOLĖS;6613469006;Taip;9;6;0;15
8699;Ramunėlė;NEUŽMIRŠTUOLĖS;3742982547;Taip;0;9;0;9
8700;Ramunėlė;NEUŽMIRŠTUOLĖS;3106987206;Taip;10;1;0;11
8701;Ramunėlė;NEUŽMIRŠTUOLĖS;2281370785;Taip;4;1;0;5
8702;Ramunėlė;NEUŽMIRŠTUOLĖS;4022818032;Taip;10;7;0;17
8703;Ramunėlė;NEUŽMIRŠTUOLĖS;4022818032;Taip;10;7;0;17
8704;Ramunėlė;OBUOLIUKAI;2555810841;Taip;0;0;2;2
8705;Ramunėlė;OBUOLIUKAI;6348171102;Taip;0;2;0;2
8706;Ramunėlė;OBUOLIUKAI;3683181174;Taip;0;6;0;6
8707;Ramunėlė;OBUOLIUKAI;7364976547;Taip;0;0;4;4
8708;Ramunėlė;OBUOLIUKAI;6156792400;Taip;0;11;0;11
8709;Ramunėlė;OBUOLIUKAI;4233978236;Taip;9;2;0;11
8710;Ramunėlė;OBUOLIUKAI;9984243153;Taip;3;2;0;5
8711;Ramunėlė;OBUOLIUKAI;2983986428;Taip;11;0;0;11
8712;Ramunėlė;OBUOLIUKAI;7622952406;Taip;0;22;0;22
8713;Ramunėlė;OBUOLIUKAI;6184872126;Taip;5;0;2;7
8714;Ramunėlė;OBUOLIUKAI;2422656007;Taip;0;0;6;6
8715;Ramunėlė;OBUOLIUKAI;6809164145;Taip;0;2;0;2
8716;Ramunėlė;OBUOLIUKAI;7829765488;Taip;2;5;0;7
8717;Ramunėlė;OBUOLIUKAI;8460527225;Taip;0;2;0;2
8718;Ramunėlė;SAULĖGRĄŽA;7593855877;Taip;2;5;1;8
8719;Ramunėlė;SAULĖGRĄŽA;2177200537;Taip;0;4;1;5
8720;Ramunėlė;SAULĖGRĄŽA;5581693652;Ne;5;3;0;8
8721;Ramunėlė;SAULĖGRĄŽA;7859959104;Taip;0;22;0;22
8722;Ramunėlė;SAULĖGRĄŽA;4269170508;Taip;0;9;3;12
8723;Ramunėlė;SAULĖGRĄŽA;4076525701;Taip;0;6;4;10
8724;Ramunėlė;SAULĖGRĄŽA;4139935502;Taip;5;5;1;11
8725;Ramunėlė;SAULĖGRĄŽA;1833069020;Taip;13;6;9;28
8726;Ramunėlė;SAULĖGRĄŽA;4084046207;Taip;0;19;0;19
8727;Ramunėlė;SAULĖGRĄŽA;2276657044;Taip;0;4;7;11
8728;Ramunėlė;SAULĖGRĄŽA;5017020616;Taip;0;9;0;9
8729;Ramunėlė;SAULĖGRĄŽA;6458458913;Taip;0;2;0;2
8730;Ramunėlė;SAULĖGRĄŽA;4805808663;Ne;0;3;9;12
8731;Ramunėlė;SAULĖGRĄŽA;7026935746;Taip;3;3;0;6
8732;Ramunėlė;SAULĖGRĄŽA;6225605784;Taip;0;6;5;11
8733;Ramunėlė;SAULĖGRĄŽA;6674467484;Taip;0;15;0;15
8734;Ramunėlė;SAULĖGRĄŽA;2383861394;Taip;0;19;0;19
8735;Ramunėlė;BORUŽĖLĖS;7825538259;Ne;10;8;0;18
8736;Ramunėlė;BORUŽĖLĖS;8496322672;Taip;5;1;0;6
8737;Ramunėlė;BORUŽĖLĖS;58028743912;Taip;4;3;0;7
8738;Ramunėlė;BORUŽĖLĖS;7750405604;Taip;0;9;0;9
8739;Ramunėlė;BORUŽĖLĖS;1216101539;Taip;5;15;0;20
8740;Ramunėlė;BORUŽĖLĖS;2499280049;Taip;6;1;0;7
8741;Ramunėlė;BORUŽĖLĖS;4677819736;Taip;0;1;3;4
8742;Ramunėlė;BORUŽĖLĖS;4349250416;Taip;3;4;4;11
8743;Ramunėlė;BORUŽĖLĖS;3554787356;Taip;0;1;0;1
8744;Ramunėlė;BORUŽĖLĖS;6310921755;Taip;0;7;0;7
8745;Ramunėlė;BORUŽĖLĖS;3685786758;Taip;0;1;0;1
8746;Ramunėlė;BORUŽĖLĖS;3566074517;Taip;0;10;0;10
8747;Ramunėlė;BORUŽĖLĖS;6837072361;Taip;0;15;0;15
8748;Ramunėlė;BORUŽĖLĖS;1534723406;Taip;3;5;5;13
8749;Ramunėlė;BORUŽĖLĖS;8323020864;Taip;0;0;2;2
8750;Ramunėlė;BORUŽĖLĖS;10704826206;Taip;0;3;3;6
8751;Ramunėlė;BORUŽĖLĖS;3065727741;Taip;20;0;1;21
8752;Ramunėlė;BORUŽĖLĖS;9924675250;Taip;0;8;2;10
8753;Ramunėlė;NYKŠTUKAS;6135381472;Taip;6;1;0;7
8754;Ramunėlė;NYKŠTUKAS;3239532336;Taip;3;2;2;7
8755;Ramunėlė;NYKŠTUKAS;8617271247;Taip;5;6;0;11
8756;Ramunėlė;NYKŠTUKAS;1811931985;Taip;0;2;0;2
8757;Ramunėlė;NYKŠTUKAS;9012749913;Taip;13;2;0;15
8758;Ramunėlė;NYKŠTUKAS;6604244856;Taip;4;5;0;9
8759;Ramunėlė;NYKŠTUKAS;7250951221;Taip;5;0;0;5
8760;Ramunėlė;NYKŠTUKAS;3166386231;Taip;5;3;2;10
8761;Ramunėlė;NYKŠTUKAS;6413888803;Taip;2;2;0;4
8762;Ramunėlė;NYKŠTUKAS;5610672420;Ne;18;5;0;23
8763;Ramunėlė;NYKŠTUKAS;4400154355;Taip;0;0;1;1
8764;Ramunėlė;NYKŠTUKAS;3802924434;Taip;10;6;0;16
8765;Ramunėlė;NYKŠTUKAS;8045080504;Taip;3;8;6;17
8766;Ramunėlė;NYKŠTUKAS;1208171285;Ne;0;0;1;1
8767;Ramunėlė;NYKŠTUKAS;7599491698;Taip;22;0;0;22
8768;Ramunėlė;NYKŠTUKAS;9292235402;Taip;5;5;1;11
8769;Ramunėlė;UOGELĖ;1818513881;Taip;0;1;4;5
8770;Ramunėlė;UOGELĖ;8310875815;Taip;2;2;0;4
8771;Ramunėlė;UOGELĖ;6347893013;Taip;0;0;4;4
8772;Ramunėlė;UOGELĖ;3735308599;Taip;0;7;0;7
8773;Ramunėlė;UOGELĖ;9934852622;Taip;0;4;2;6
8774;Ramunėlė;UOGELĖ;4968998913;Taip;8;13;0;21
8775;Ramunėlė;UOGELĖ;3272747656;Taip;12;0;0;12
8776;Ramunėlė;UOGELĖ;6433856416;Taip;0;7;0;7
8777;Ramunėlė;UOGELĖ;3996453947;Taip;0;2;2;4
8778;Ramunėlė;UOGELĖ;1491688322;Taip;7;3;0;10
8779;Ramunėlė;UOGELĖ;5703289545;Taip;20;0;1;21
8780;Ramunėlė;UOGELĖ;3474578046;Taip;7;8;0;15
8781;Ramunėlė;UOGELĖ;3461269451;Taip;4;3;0;7
8782;Ramunėlė;UOGELĖ;7544671346;Taip;0;6;0;6
8783;Ramunėlė;UOGELĖ;3542912372;Taip;23;0;0;23
8784;Ramunėlė;UOGELĖ;4581826404;Taip;5;0;0;5
8785;Ramunėlė;UOGELĖ;5544992493;Taip;0;14;0;14
8786;Ramunėlė;VARPELIAI;8726443989;Taip;5;10;2;17
8787;Ramunėlė;VARPELIAI;4715809064;Taip;0;5;0;5
8788;Ramunėlė;VARPELIAI;5315953299;Taip;0;7;0;7
8789;Ramunėlė;VARPELIAI;6627399830;Taip;0;2;11;13
8790;Ramunėlė;VARPELIAI;5801760033;Taip;0;6;0;6
8791;Ramunėlė;VARPELIAI;6389008823;Taip;0;9;0;9
8792;Ramunėlė;VARPELIAI;9136437288;Taip;0;9;0;9
8793;Ramunėlė;VARPELIAI;2605941371;Taip;0;2;1;3
8794;Ramunėlė;VARPELIAI;2446375037;Taip;0;6;1;7
8795;Ramunėlė;VARPELIAI;1671759939;Taip;6;0;0;6
8796;Ramunėlė;VARPELIAI;5304803880;Taip;0;5;0;5
8797;Ramunėlė;VARPELIAI;6347164708;Taip;3;5;0;8
8798;Ramunėlė;VARPELIAI;3525444906;Taip;0;4;1;5
8799;Ramunėlė;VARPELIAI;8055844166;Taip;9;3;0;12
8800;Ramunėlė;VARPELIAI;7010828978;Taip;0;1;13;14
8801;Ramunėlė;VARPELIAI;6606802660;Taip;15;0;0;15
8802;Ramunėlė;VARPELIAI;6040461460;Taip;0;6;1;7
8803;Ramunėlė;VARPELIAI;2686455030;Taip;5;0;0;5
8804;Ramunėlė;VARPELIAI;3879563193;Taip;5;0;13;18
8805;Rūta;SMALSUČIAI;7649756034;Taip;7;0;2;9
8806;Rūta;SMALSUČIAI;5899860543;Taip;0;10;0;10
8807;Rūta;SMALSUČIAI;1543099858;Taip;14;0;8;22
8808;Rūta;SMALSUČIAI;4728904136;Taip;0;4;0;4
8809;Rūta;SMALSUČIAI;8378318357;Taip;0;13;0;13
8810;Rūta;SMALSUČIAI;1951202550;Taip;0;0;2;2
8811;Rūta;SMALSUČIAI;4962272621;Taip;0;0;1;1
8812;Rūta;SMALSUČIAI;9603105651;Taip;0;0;22;22
8813;Rūta;SMALSUČIAI;9911151238;Taip;0;0;3;3
8814;Rūta;SMALSUČIAI;7434152435;Taip;5;5;0;10
8815;Rūta;SMALSUČIAI;3843325181;Taip;0;0;7;7
8816;Rūta;SMALSUČIAI;6316768460;Taip;4;0;7;11
8817;Rūta;SMALSUČIAI;8182243701;Taip;0;1;1;2
8818;Rūta;SMALSUČIAI;9386595365;Taip;0;0;14;14
8819;Rūta;SMALSUČIAI;7680605199;Taip;4;0;7;11
8820;Rūta;KŪLVERSTUKAI;4423305209;Taip;0;4;0;4
8821;Rūta;KŪLVERSTUKAI;9736567509;Taip;0;4;0;4
8822;Rūta;KŪLVERSTUKAI;7222494215;Taip;0;1;0;1
8823;Rūta;KŪLVERSTUKAI;7519931138;Taip;0;2;0;2
8824;Rūta;KŪLVERSTUKAI;4880804625;Taip;0;2;0;2
8825;Rūta;KŪLVERSTUKAI;3055345528;Taip;0;2;0;2
8826;Rūta;KŪLVERSTUKAI;3499727608;Taip;5;0;3;8
8827;Rūta;KŪLVERSTUKAI;9765301038;Taip;5;0;3;8
8828;Rūta;KŪLVERSTUKAI;9638495757;Taip;0;13;0;13
8829;Rūta;KŪLVERSTUKAI;8605070655;Taip;0;2;1;3
8830;Rūta;KŪLVERSTUKAI;7553844890;Taip;0;10;0;10
8831;Rūta;KŪLVERSTUKAI;3964922552;Taip;0;7;0;7
8832;Rūta;KŪLVERSTUKAI;8395765508;Taip;0;1;0;1
8833;Rūta;KŪLVERSTUKAI;9400586178;Taip;0;0;7;7
8834;Rūta;KŪLVERSTUKAI;2890569107;Taip;0;1;16;17
8835;Rūta;KŪLVERSTUKAI;2474991135;Taip;0;0;11;11
8836;Rūta;KŪLVERSTUKAI;1216786487;Taip;0;3;0;3
8837;Rūta;KŪLVERSTUKAI;9245618776;Taip;8;6;6;20
8838;Rūta;KŪLVERSTUKAI;5109138407;Taip;6;1;0;7
8839;Rūta;KODĖLČIUKAI;7762509383;Taip;0;0;2;2
8840;Rūta;KODĖLČIUKAI;2263820829;Taip;13;0;3;16
8841;Rūta;KODĖLČIUKAI;6186413364;Taip;3;0;4;7
8842;Rūta;KODĖLČIUKAI;6585842434;Taip;11;0;2;13
8843;Rūta;KODĖLČIUKAI;6620957022;Taip;2;0;0;2
8844;Rūta;KODĖLČIUKAI;5512946296;Taip;0;1;0;1
8845;Rūta;KODĖLČIUKAI;7422059414;Taip;22;0;0;22
8846;Rūta;KODĖLČIUKAI;9014433476;Taip;3;7;0;10
8847;Rūta;KODĖLČIUKAI;8571905994;Taip;4;2;0;6
8848;Rūta;KODĖLČIUKAI;9322322737;Taip;4;0;6;10
8849;Rūta;KODĖLČIUKAI;2685515977;Taip;18;1;3;22
8850;Rūta;KODĖLČIUKAI;8479424939;Taip;8;9;0;17
8851;Rūta;KODĖLČIUKAI;1207463357;Taip;2;0;3;5
8852;Rūta;KODĖLČIUKAI;8320521011;Taip;0;10;0;10
8853;Rūta;KODĖLČIUKAI;3765741047;Taip;0;9;0;9
8854;Rūta;KODĖLČIUKAI;9308127402;Taip;0;1;0;1
8855;Rūta;KODĖLČIUKAI;8806743371;Taip;9;0;3;12
8856;Rūta;KODĖLČIUKAI;2391120026;Taip;0;0;2;2
8857;Rūta;KODĖLČIUKAI;5962981130;Taip;3;0;4;7
8858;Rūta;BORUŽĖLĖS;1623968580;Taip;0;1;2;3
8859;Rūta;BORUŽĖLĖS;3043164521;Taip;0;1;0;1
8860;Rūta;BORUŽĖLĖS;3044976169;Taip;0;0;2;2
8861;Rūta;BORUŽĖLĖS;8273644943;Taip;0;2;1;3
8862;Rūta;BORUŽĖLĖS;4293920701;Taip;0;1;0;1
8863;Rūta;BORUŽĖLĖS;9419809946;Taip;0;1;0;1
8864;Rūta;BORUŽĖLĖS;3454881685;Taip;0;9;2;11
8865;Rūta;BORUŽĖLĖS;1811055786;Taip;0;1;0;1
8866;Rūta;BORUŽĖLĖS;2702537976;Taip;0;2;0;2
8867;Rūta;BORUŽĖLĖS;4044349935;Taip;0;17;0;17
8868;Rūta;BORUŽĖLĖS;7936198171;Taip;13;0;1;14
8869;Rūta;BORUŽĖLĖS;8963959004;Taip;0;8;0;8
8870;Rūta;BORUŽĖLĖS;3462986405;Taip;0;2;9;11
8871;Rūta;BORUŽĖLĖS;8592528906;Taip;0;0;4;4
8872;Rūta;BORUŽĖLĖS;1182222976;Taip;0;3;0;3
8873;Rūta;BORUŽĖLĖS;3998791775;Taip;12;0;4;16
8874;Rūta;BORUŽĖLĖS;4473591998;Taip;10;3;0;13
8875;Rūta;BORUŽĖLĖS;6814051598;Taip;0;5;0;5
8876;Rūta;BORUŽĖLĖS;2546023973;Taip;0;0;3;3
8877;Rūta;VYTURĖLIAI;1489564914;Taip;0;12;0;12
8878;Rūta;VYTURĖLIAI;2084379688;Taip;6;1;0;7
8879;Rūta;VYTURĖLIAI;88159609117;Taip;0;2;0;2
8880;Rūta;VYTURĖLIAI;1703148668;Taip;0;0;3;3
8881;Rūta;VYTURĖLIAI;1971925569;Taip;0;10;0;10
8882;Rūta;VYTURĖLIAI;56171468735;Taip;0;12;0;12
8883;Rūta;VYTURĖLIAI;2079429418;Taip;0;6;0;6
8884;Rūta;VYTURĖLIAI;1043614414;Taip;0;7;0;7
8885;Rūta;VYTURĖLIAI;1150292834;Taip;3;0;0;3
8886;Rūta;VYTURĖLIAI;1080628212;Taip;0;4;0;4
8887;Rūta;VYTURĖLIAI;99777522247;Taip;8;0;0;8
8888;Rūta;VYTURĖLIAI;17349566042;Taip;0;3;0;3
8889;Rūta;VYTURĖLIAI;6982618655;Taip;0;2;2;4
8890;Rūta;VYTURĖLIAI;3247709788;Taip;3;0;6;9
8891;Rūta;"PABIRUČIAI (LOGOPEDINĖ)";1035527190;Taip;0;0;1;1
8892;Rūta;"PABIRUČIAI (LOGOPEDINĖ)";6221528830;Taip;0;1;0;1
8893;Rūta;"PABIRUČIAI (LOGOPEDINĖ)";4911219947;Taip;6;4;0;10
8894;Rūta;"PABIRUČIAI (LOGOPEDINĖ)";8763382361;Taip;0;0;14;14
8895;Rūta;"PABIRUČIAI (LOGOPEDINĖ)";4858914868;Taip;15;0;0;15
8896;Rūta;"PABIRUČIAI (LOGOPEDINĖ)";9171781646;Taip;0;11;1;12
8897;Rūta;GUDRUČIAI;1967141665;Taip;0;4;3;7
8898;Rūta;GUDRUČIAI;3873876608;Taip;0;9;0;9
8899;Rūta;GUDRUČIAI;8851591109;Ne;0;0;3;3
8900;Rūta;GUDRUČIAI;1180144866;Taip;0;0;1;1
8901;Rūta;GUDRUČIAI;8889388348;Taip;4;0;0;4
8902;Rūta;GUDRUČIAI;4363571135;Taip;4;0;5;9
8903;Rūta;GUDRUČIAI;6006094035;Taip;4;0;0;4
8904;Rūta;GUDRUČIAI;1521231573;Taip;0;0;3;3
8905;Rūta;GUDRUČIAI;7552644990;Taip;0;0;20;20
8906;Rūta;GUDRUČIAI;1092908255;Taip;0;0;2;2
8907;Rūta;GUDRUČIAI;8673942478;Taip;0;0;4;4
8908;Rūta;GUDRUČIAI;4078957924;Ne;0;0;3;3
8909;Rūta;GUDRUČIAI;4754142240;Taip;0;0;2;2
8910;Rūta;GUDRUČIAI;1565896222;Taip;0;0;1;1
8911;Rūta;GUDRUČIAI;8704594038;Taip;0;0;1;1
8912;Rūta;GUDRUČIAI;7631229177;Taip;5;0;0;5
8913;Rūta;GUDRUČIAI;1276704331;Taip;13;5;0;18
8914;Rūta;SEKLYTĖLĖ;4823677957;Taip;0;10;0;10
8915;Rūta;SEKLYTĖLĖ;78953568121;Taip;0;4;0;4
8916;Rūta;SEKLYTĖLĖ;50814418724;Taip;0;9;0;9
8917;Rūta;SEKLYTĖLĖ;77285178781;Taip;0;2;0;2
8918;Rūta;SEKLYTĖLĖ;1364470800;Taip;0;1;0;1
8919;Rūta;SEKLYTĖLĖ;1937805277;Taip;0;1;0;1
8920;Rūta;SEKLYTĖLĖ;1996690514;Taip;0;5;0;5
8921;Rūta;SEKLYTĖLĖ;14391882157;Taip;0;1;0;1
8922;Rūta;SEKLYTĖLĖ;8604212304;Taip;0;4;0;4
8923;Rūta;SEKLYTĖLĖ;1323253379;Taip;0;0;2;2
8924;Rūta;SEKLYTĖLĖ;59694891781;Taip;3;9;0;12
8925;Rūta;SEKLYTĖLĖ;26152518052;Taip;0;0;8;8
8926;Rūta;SEKLYTĖLĖ;2986201324;Taip;7;0;3;10
8927;Rūta;SEKLYTĖLĖ;87692898919;Taip;0;4;0;4
8928;Rūta;SEKLYTĖLĖ;38837808144;Taip;0;0;1;1
8929;Rūta;"VARPELIAI (LOGOPEDINĖ)";3055294324;Taip;0;0;3;3
8930;Rūta;"VARPELIAI (LOGOPEDINĖ)";3810636967;Taip;0;1;0;1
8931;Rūta;"VARPELIAI (LOGOPEDINĖ)";8992775168;Taip;0;0;7;7
8932;Rūta;"VARPELIAI (LOGOPEDINĖ)";8026402652;Ne;6;1;0;7
8933;Rūta;"VARPELIAI (LOGOPEDINĖ)";2584812163;Taip;4;3;0;7
8934;Rūta;"VARPELIAI (LOGOPEDINĖ)";6032985748;Taip;0;5;0;5
8935;Rūta;"VARPELIAI (LOGOPEDINĖ)";1301573542;Taip;0;2;0;2
8936;Rūta;KIŠKUČIŲ;7837861265;Taip;0;0;3;3
8937;Rūta;KIŠKUČIŲ;2601011765;Taip;12;0;3;15
8938;Rūta;KIŠKUČIŲ;5579794648;Taip;22;0;0;22
8939;Rūta;KIŠKUČIŲ;4165080541;Taip;6;0;6;12
8940;Rūta;KIŠKUČIŲ;3877807687;Taip;12;0;0;12
8941;Rūta;KIŠKUČIŲ;9429856388;Taip;4;0;1;5
8942;Rūta;KIŠKUČIŲ;8483916287;Taip;19;0;0;19
8943;Rūta;KIŠKUČIŲ;7724451685;Taip;7;0;0;7
8944;Rūta;KIŠKUČIŲ;8138816581;Taip;0;2;17;19
8945;Rūta;KIŠKUČIŲ;2733932207;Taip;0;16;0;16
8946;Rūta;KIŠKUČIŲ;5902965224;Taip;0;5;0;5
8947;Rūta;KIŠKUČIŲ;9471291067;Taip;0;11;0;11
8948;Rūta;KIŠKUČIŲ;8012225409;Taip;0;0;1;1
8949;Rūta;KIŠKUČIŲ;1290867375;Taip;0;9;0;9
8950;Rūta;KIŠKUČIŲ;4780828296;Taip;0;7;0;7
8951;Rūta;KIŠKUČIŲ;2084935094;Taip;0;0;7;7
8952;Rūta;ŽVIRBLIUKAI;3352007694;Taip;0;2;1;3
8953;Rūta;ŽVIRBLIUKAI;1059126758;Taip;0;6;0;6
8954;Rūta;ŽVIRBLIUKAI;6417693659;Taip;0;1;8;9
8955;Rūta;ŽVIRBLIUKAI;4090915728;Taip;0;5;0;5
8956;Rūta;ŽVIRBLIUKAI;4466522924;Taip;5;5;6;16
8957;Rūta;ŽVIRBLIUKAI;7905893575;Taip;11;0;7;18
8958;Rūta;ŽVIRBLIUKAI;4436482805;Taip;0;5;0;5
8959;Rūta;ŽVIRBLIUKAI;1260386759;Taip;4;1;0;5
8960;Rūta;ŽVIRBLIUKAI;8935780480;Taip;0;8;4;12
8961;Rūta;ŽVIRBLIUKAI;4208678278;Taip;5;0;0;5
8962;Rūta;ŽVIRBLIUKAI;6044060646;Taip;5;0;2;7
8963;Rūta;ŽVIRBLIUKAI;9220661972;Taip;7;5;0;12
8964;Rūta;ŽVIRBLIUKAI;5109026000;Taip;5;5;0;10
8965;Rūta;ŽVIRBLIUKAI;4776631890;Taip;3;1;1;5
8966;Rūta;ŽVIRBLIUKAI;4440148328;Taip;10;0;5;15
8967;Rūta;ŽVIRBLIUKAI;5464058893;Taip;0;0;8;8
8968;Rūta;SAULUTĖS;1671913833;Taip;0;4;0;4
8969;Rūta;SAULUTĖS;1186493111;Taip;0;6;0;6
8970;Rūta;SAULUTĖS;9675482322;Taip;0;8;0;8
8971;Rūta;SAULUTĖS;1415664888;Taip;0;0;11;11
8972;Rūta;SAULUTĖS;5114985659;Taip;0;1;0;1
8973;Rūta;SAULUTĖS;4282074540;Taip;0;8;0;8
8974;Rūta;SAULUTĖS;8607455403;Taip;0;1;0;1
8975;Rūta;SAULUTĖS;4168356825;Taip;0;4;2;6
8976;Rūta;SAULUTĖS;9569447586;Taip;0;2;0;2
8977;Rūta;SAULUTĖS;1579573872;Taip;0;0;5;5
8978;Rūta;SAULUTĖS;2677062861;Taip;3;0;4;7
8979;Rūta;SAULUTĖS;1390207547;Taip;0;2;0;2
8980;Rūta;SAULUTĖS;32004750783;Taip;0;0;1;1
8981;Rūta;SAULUTĖS;5866619097;Taip;0;2;1;3
8982;Rūta;SAULUTĖS;3820689725;Taip;3;0;0;3
8983;Rūta;SAULUTĖS;6075632046;Taip;3;0;1;4
8984;Rūta;SAULUTĖS;8277677952;Taip;0;5;0;5
8985;Sadutė;Kiškučiai;38918375280;Taip;0;2;0;2
8986;Sadutė;Kiškučiai;42447771280;Taip;0;2;0;2
8987;Sadutė;Kiškučiai;62408324442;Taip;0;10;0;10
8988;Sadutė;Kiškučiai;67439547513;Taip;0;1;2;3
8989;Sadutė;Kiškučiai;62077575922;Taip;0;1;3;4
8990;Sadutė;Kiškučiai;75149739907;Taip;1;0;0;1
8991;Sadutė;Kiškučiai;48298497;Taip;6;0;0;6
8992;Sadutė;Kiškučiai;69988140413;Taip;0;1;0;1
8993;Sadutė;Kiškučiai;1433422421;Taip;0;6;3;9
8994;Sadutė;Kiškučiai;73649870571;Taip;0;5;0;5
8995;Sadutė;Kiškučiai;1092421263;Taip;0;1;1;2
8996;Sadutė;Kiškučiai;5586949339;Taip;0;0;8;8
8997;Sadutė;Kiškučiai;9883685724;Taip;5;7;0;12
8998;Sadutė;Kiškučiai;4525909977;Taip;3;4;0;7
8999;Sadutė;Kiškučiai;1533081218;Taip;4;0;0;4
9000;Sadutė;Kiškučiai;3400524440;Taip;0;1;0;1
9001;Sadutė;Kiškučiai;1084400276;Taip;8;2;0;10
9002;Sadutė;Kiškučiai;1946228564;Taip;0;1;1;2
9003;Sadutė;Boružėlės;9115304973;Taip;0;4;1;5
9004;Sadutė;Boružėlės;8442967732;Taip;0;0;3;3
9005;Sadutė;Boružėlės;1273355194;Taip;13;0;0;13
9006;Sadutė;Boružėlės;3119547420;Taip;13;0;0;13
9007;Sadutė;Boružėlės;7504712544;Taip;0;22;0;22
9008;Sadutė;Boružėlės;8987528237;Taip;0;0;2;2
9009;Sadutė;Boružėlės;6994383907;Taip;5;1;1;7
9010;Sadutė;Boružėlės;8914509685;Taip;0;0;7;7
9011;Sadutė;Boružėlės;7242188081;Taip;4;0;0;4
9012;Sadutė;Boružėlės;3875265137;Taip;14;0;1;15
9013;Sadutė;Boružėlės;5992119777;Taip;0;2;1;3
9014;Sadutė;Boružėlės;5682745869;Taip;0;0;2;2
9015;Sadutė;Boružėlės;7072437339;Taip;2;0;0;2
9016;Sadutė;Boružėlės;5579040052;Taip;4;5;0;9
9017;Sadutė;Boružėlės;3362830536;Taip;5;0;3;8
9018;Sadutė;Boružėlės;5395676303;Taip;0;0;5;5
9019;Sadutė;Bitutės;1759479328;Ne;0;4;0;4
9020;Sadutė;Bitutės;1975767401;Taip;3;0;0;3
9021;Sadutė;Bitutės;4245873513;Taip;0;1;0;1
9022;Sadutė;Bitutės;1873928395;Taip;10;1;0;11
9023;Sadutė;Bitutės;5866461096;Taip;3;3;0;6
9024;Sadutė;Bitutės;4883934480;Taip;9;1;0;10
9025;Sadutė;Bitutės;7097653016;Taip;0;1;0;1
9026;Sadutė;Bitutės;2020766695;Taip;0;22;0;22
9027;Sadutė;Bitutės;5011320850;Taip;0;7;2;9
9028;Sadutė;Bitutės;4161502667;Taip;9;0;0;9
9029;Sadutė;Bitutės;5973513916;Taip;0;7;0;7
9030;Sadutė;Bitutės;3361904803;Taip;4;0;2;6
9031;Sadutė;Bitutės;1231048342;Taip;8;2;0;10
9032;Sadutė;Bitutės;6066145909;Taip;19;0;0;19
9033;Sadutė;Bitutės;5142566738;Taip;12;1;4;17
9034;Sadutė;Bitutės;2526605022;Taip;6;10;0;16
9035;Sadutė;Bitutės;8662375739;Taip;3;6;0;9
9036;Sadutė;Drugeliai;1552350084;Taip;0;9;0;9
9037;Sadutė;Drugeliai;2467800545;Taip;8;0;0;8
9038;Sadutė;Drugeliai;4402558234;Taip;0;3;0;3
9039;Sadutė;Drugeliai;8713575864;Taip;1;0;0;1
9040;Sadutė;Drugeliai;1782594187;Taip;3;2;0;5
9041;Sadutė;Drugeliai;5816844295;Taip;5;4;0;9
9042;Sadutė;Drugeliai;8803249656;Taip;0;3;0;3
9043;Sadutė;Drugeliai;4901634532;Taip;0;1;1;2
9044;Sadutė;Drugeliai;6196282159;Taip;22;0;0;22
9045;Sadutė;Drugeliai;8953107298;Taip;0;0;6;6
9046;Sadutė;Drugeliai;5139219626;Taip;3;0;1;4
9047;Sadutė;Drugeliai;1735450955;Taip;0;1;0;1
9048;Sadutė;Drugeliai;2064784580;Taip;0;1;0;1
9049;Sadutė;Drugeliai;2883991326;Taip;0;9;0;9
9050;Sadutė;Drugeliai;7731164484;Taip;0;10;0;10
9051;Sadutė;Drugeliai;6124376554;Taip;4;12;3;19
9052;Sadutė;Drugeliai;36769610742;Taip;0;0;3;3
9053;Sadutė;Drugeliai;1956224017;Taip;0;4;0;4
9054;Sadutė;Drugeliai;4623727349;Taip;0;1;3;4
9055;Sadutė;Pėledžiukai;50662732693;Taip;4;0;1;5
9056;Sadutė;Pėledžiukai;26761581977;Taip;0;1;0;1
9057;Sadutė;Pėledžiukai;1885941594;Taip;0;3;0;3
9058;Sadutė;Pėledžiukai;4933574100;Taip;0;7;0;7
9059;Sadutė;Pėledžiukai;6105924871;Taip;0;8;0;8
9060;Sadutė;Pėledžiukai;8870465478;Taip;0;0;3;3
9061;Sadutė;Pėledžiukai;64835095908;Taip;5;0;0;5
9062;Sadutė;Pėledžiukai;92111253012;Taip;0;0;1;1
9063;Sadutė;Pėledžiukai;1594844154;Taip;10;0;1;11
9064;Sadutė;Pėledžiukai;1005751811;Taip;10;0;0;10
9065;Sadutė;Pėledžiukai;9946417453;Taip;0;0;3;3
9066;Sadutė;Pėledžiukai;1190667513;Taip;0;2;4;6
9067;Sadutė;Pėledžiukai;1985946393;Taip;0;0;1;1
9068;Sadutė;Pėledžiukai;6301749078;Taip;0;0;13;13
9069;Sadutė;Pėledžiukai;21138396996;Taip;0;0;7;7
9070;Sadutė;Pėledžiukai;8943620706;Taip;0;0;13;13
9071;Sadutė;Kačiukų;1507052440;Taip;0;0;3;3
9072;Sadutė;Kačiukų;1903961488;Taip;0;0;3;3
9073;Sadutė;Kačiukų;2890916313;Taip;0;0;5;5
9074;Sadutė;Kačiukų;2733633163;Taip;0;0;1;1
9075;Sadutė;Kačiukų;3993181500;Taip;0;10;0;10
9076;Sadutė;Kačiukų;8835627470;Taip;3;4;0;7
9077;Sadutė;Kačiukų;2466024649;Taip;0;1;1;2
9078;Sadutė;Kačiukų;6253351299;Taip;0;5;0;5
9079;Sadutė;Kačiukų;8974374101;Taip;5;0;2;7
9080;Sadutė;Kačiukų;4401870028;Taip;0;0;1;1
9081;Sadutė;Kačiukų;8714168144;Taip;0;0;2;2
9082;Sadutė;Kačiukų;3927044011;Taip;0;5;0;5
9083;Sadutė;Kačiukų;8974225608;Taip;0;0;6;6
9084;Sadutė;Kačiukų;8770727233;Taip;18;0;0;18
9085;Sadutė;Kačiukų;6218165554;Taip;0;0;3;3
9086;Sadutė;Kačiukų;8556218971;Taip;0;0;1;1
9087;Sadutė;Kačiukų;5267093203;Taip;0;0;21;21
9088;Sadutė;Kačiukų;6538356822;Taip;6;0;0;6
9089;Sakalėlis;GIRINUKŲ;9566176151;Taip;0;0;2;2
9090;Sakalėlis;GIRINUKŲ;8606714134;Taip;0;5;0;5
9091;Sakalėlis;GIRINUKŲ;5405669698;Taip;0;2;0;2
9092;Sakalėlis;GIRINUKŲ;2474164013;Taip;0;0;5;5
9093;Sakalėlis;GIRINUKŲ;9493905856;Taip;9;0;5;14
9094;Sakalėlis;GIRINUKŲ;5496044442;Taip;5;0;0;5
9095;Sakalėlis;GIRINUKŲ;6603105354;Taip;0;0;2;2
9096;Sakalėlis;GIRINUKŲ;3418702674;Taip;4;0;5;9
9097;Sakalėlis;GIRINUKŲ;3748865437;Taip;0;6;0;6
9098;Sakalėlis;GIRINUKŲ;3333037807;Taip;8;0;0;8
9099;Sakalėlis;GIRINUKŲ;8667155756;Taip;0;1;0;1
9100;Sakalėlis;GIRINUKŲ;4596727938;Taip;0;3;0;3
9101;Sakalėlis;GIRINUKŲ;6706466627;Taip;3;0;7;10
9102;Sakalėlis;GIRINUKŲ;8790189865;Taip;0;2;0;2
9103;Sakalėlis;GIRINUKŲ;4458071075;Taip;0;7;0;7
9104;Sakalėlis;GIRINUKŲ;4209146744;Taip;0;9;0;9
9105;Sakalėlis;GIRINUKŲ;2780141413;Taip;0;19;0;19
9106;Sakalėlis;GIRINUKŲ;1347171934;Taip;0;1;0;1
9107;Sakalėlis;GIRINUKŲ;9250470549;Taip;0;0;3;3
9108;Sakalėlis;VYTURIUKŲ;9976735354;Taip;0;0;7;7
9109;Sakalėlis;VYTURIUKŲ;3927487265;Taip;6;0;1;7
9110;Sakalėlis;VYTURIUKŲ;2352118061;Taip;3;0;1;4
9111;Sakalėlis;VYTURIUKŲ;3680732318;Taip;0;9;0;9
9112;Sakalėlis;VYTURIUKŲ;4862004373;Taip;6;0;0;6
9113;Sakalėlis;VYTURIUKŲ;8422299669;Taip;0;0;5;5
9114;Sakalėlis;VYTURIUKŲ;6579827280;Taip;10;5;2;17
9115;Sakalėlis;VYTURIUKŲ;8381310908;Taip;7;0;6;13
9116;Sakalėlis;VYTURIUKŲ;6840368824;Taip;10;0;2;12
9117;Sakalėlis;VYTURIUKŲ;5795250727;Taip;4;0;1;5
9118;Sakalėlis;VYTURIUKŲ;3351218789;Taip;0;0;2;2
9119;Sakalėlis;VYTURIUKŲ;9120873899;Ne;19;0;0;19
9120;Sakalėlis;VYTURIUKŲ;5991029760;Taip;18;0;0;18
9121;Sakalėlis;VYTURIUKŲ;8091400240;Taip;16;0;2;18
9122;Sakalėlis;VYTURIUKŲ;6378711142;Taip;2;0;1;3
9123;Sakalėlis;VYTURIUKŲ;7280513854;Taip;0;0;2;2
9124;Sakalėlis;VYTURIUKŲ;5641979969;Taip;4;0;1;5
9125;Sakalėlis;DRUGELIŲ;8095359035;Taip;19;0;0;19
9126;Sakalėlis;DRUGELIŲ;5911341542;Taip;14;3;1;18
9127;Sakalėlis;DRUGELIŲ;9272347788;Taip;7;0;0;7
9128;Sakalėlis;DRUGELIŲ;9416737436;Taip;0;0;2;2
9129;Sakalėlis;DRUGELIŲ;8331612396;Taip;0;0;1;1
9130;Sakalėlis;DRUGELIŲ;7542322748;Taip;9;0;0;9
9131;Sakalėlis;DRUGELIŲ;4918228191;Taip;0;0;1;1
9132;Sakalėlis;DRUGELIŲ;1201086815;Taip;0;0;6;6
9133;Sakalėlis;DRUGELIŲ;3934295338;Taip;3;1;0;4
9134;Sakalėlis;DRUGELIŲ;1117800518;Taip;11;6;0;17
9135;Sakalėlis;DRUGELIŲ;2515169899;Taip;0;9;0;9
9136;Sakalėlis;DRUGELIŲ;8160589611;Taip;0;2;0;2
9137;Sakalėlis;DRUGELIŲ;4004006771;Taip;0;3;0;3
9138;Sakalėlis;DRUGELIŲ;1833573491;Taip;0;0;1;1
9139;Sakalėlis;DRUGELIŲ;8713298648;Taip;0;15;0;15
9140;Sakalėlis;DRUGELIŲ;2889638745;Taip;0;0;4;4
9141;Sakalėlis;DRUGELIŲ;2873487714;Taip;0;22;0;22
9142;Sakalėlis;GENIUKŲ;4763858893;Taip;0;3;9;12
9143;Sakalėlis;GENIUKŲ;43677485606;Taip;0;0;3;3
9144;Sakalėlis;GENIUKŲ;5717022080;Taip;0;0;2;2
9145;Sakalėlis;GENIUKŲ;1027765680;Taip;0;2;0;2
9146;Sakalėlis;GENIUKŲ;96053733139;Taip;6;1;0;7
9147;Sakalėlis;GENIUKŲ;4612388683;Taip;0;3;0;3
9148;Sakalėlis;GENIUKŲ;7159705304;Taip;0;1;0;1
9149;Sakalėlis;GENIUKŲ;4775685174;Taip;7;0;0;7
9150;Sakalėlis;GENIUKŲ;69916351348;Taip;13;0;1;14
9151;Sakalėlis;GENIUKŲ;1552929452;Taip;0;0;10;10
9152;Sakalėlis;GENIUKŲ;8936933971;Taip;0;0;7;7
9153;Sakalėlis;GENIUKŲ;7085108710;Taip;7;1;1;9
9154;Sakalėlis;GENIUKŲ;2902195855;Taip;0;0;2;2
9155;Sakalėlis;GENIUKŲ;4364341933;Taip;0;0;4;4
9156;Sakalėlis;VOVERIUKŲ;4430763418;Taip;0;8;3;11
9157;Sakalėlis;VOVERIUKŲ;6190741162;Taip;0;0;3;3
9158;Sakalėlis;VOVERIUKŲ;1702964714;Taip;0;10;0;10
9159;Sakalėlis;VOVERIUKŲ;1839096675;Taip;2;3;0;5
9160;Sakalėlis;VOVERIUKŲ;3962436122;Taip;0;2;0;2
9161;Sakalėlis;VOVERIUKŲ;2796230671;Taip;9;0;0;9
9162;Sakalėlis;VOVERIUKŲ;1912068116;Taip;0;1;0;1
9163;Sakalėlis;VOVERIUKŲ;1104881142;Taip;0;0;3;3
9164;Sakalėlis;VOVERIUKŲ;3678172501;Taip;0;9;0;9
9165;Sakalėlis;VOVERIUKŲ;1133377117;Taip;0;0;5;5
9166;Sakalėlis;VOVERIUKŲ;5782214279;Taip;5;0;0;5
9167;Sakalėlis;VOVERIUKŲ;34464485043;Taip;8;0;1;9
9168;Sakalėlis;VOVERIUKŲ;30987215315;Taip;0;0;3;3
9169;Sakalėlis;VOVERIUKŲ;7567476424;Taip;5;0;0;5
9170;Sakalėlis;VOVERIUKŲ;6180987643;Taip;0;0;4;4
9171;Sakalėlis;VOVERIUKŲ;8852001037;Taip;0;0;2;2
9172;Sakalėlis;VOVERIUKŲ;6321575268;Taip;0;1;0;1
9173;Sakalėlis;PĖLEDŽIUKŲ;1974955778;Taip;0;0;7;7
9174;Sakalėlis;PĖLEDŽIUKŲ;69254656227;Taip;0;9;0;9
9175;Sakalėlis;PĖLEDŽIUKŲ;4573623341;Taip;0;0;3;3
9176;Sakalėlis;PĖLEDŽIUKŲ;3781188811;Taip;0;0;2;2
9177;Sakalėlis;PĖLEDŽIUKŲ;58113060986;Taip;0;9;0;9
9178;Sakalėlis;PĖLEDŽIUKŲ;89579043958;Taip;0;2;0;2
9179;Sakalėlis;PĖLEDŽIUKŲ;54902207576;Taip;0;3;0;3
9180;Sakalėlis;PĖLEDŽIUKŲ;33825546706;Taip;4;1;0;5
9181;Sakalėlis;PĖLEDŽIUKŲ;81361557297;Taip;0;0;16;16
9182;Sakalėlis;PĖLEDŽIUKŲ;39504139934;Taip;0;0;4;4
9183;Sakalėlis;PĖLEDŽIUKŲ;67193921335;Taip;0;0;3;3
9184;Sakalėlis;PĖLEDŽIUKŲ;37201848270;Taip;0;0;4;4
9185;Sakalėlis;PĖLEDŽIUKŲ;49947049847;Taip;0;0;1;1
9186;Sakalėlis;PĖLEDŽIUKŲ;79413947806;Taip;0;0;1;1
9187;Sakalėlis;PĖLEDŽIUKŲ;1139467130;Taip;0;1;0;1
9188;Sakalėlis;PĖLEDŽIUKŲ;60747121226;Taip;0;5;0;5
9189;Sakalėlis;PĖLEDŽIUKŲ;1359444361;Taip;0;0;5;5
9190;Sakalėlis;PĖLEDŽIUKŲ;90977017998;Taip;0;0;3;3
9191;Sakalėlis;PĖLEDŽIUKŲ;46481555688;Taip;7;0;2;9
9192;Sakalėlis;"BITUČIŲ (LOGOPEDINĖ)";4716949191;Taip;0;0;5;5
9193;Sakalėlis;"BITUČIŲ (LOGOPEDINĖ)";4857211754;Taip;0;4;0;4
9194;Sakalėlis;"BITUČIŲ (LOGOPEDINĖ)";8610668395;Taip;7;0;2;9
9195;Sakalėlis;"BITUČIŲ (LOGOPEDINĖ)";1384225025;Taip;5;0;2;7
9196;Sakalėlis;"BITUČIŲ (LOGOPEDINĖ)";6259640492;Taip;1;0;0;1
9197;Sakalėlis;"BITUČIŲ (LOGOPEDINĖ)";1723436498;Taip;9;2;0;11
9198;Sakalėlis;"BITUČIŲ (LOGOPEDINĖ)";3938470708;Taip;0;0;4;4
9199;Sakalėlis;"BORUŽIUKŲ (LOGOPEDINĖ)";68146506860;Taip;0;0;2;2
9200;Sakalėlis;"BORUŽIUKŲ (LOGOPEDINĖ)";4514546151;Taip;0;5;0;5
9201;Sakalėlis;"BORUŽIUKŲ (LOGOPEDINĖ)";2074868084;Taip;22;0;0;22
9202;Sakalėlis;"BORUŽIUKŲ (LOGOPEDINĖ)";4495453007;Taip;0;0;1;1
9203;Sakalėlis;"BORUŽIUKŲ (LOGOPEDINĖ)";8668671325;Taip;0;1;0;1
9204;Sakalėlis;"BORUŽIUKŲ (LOGOPEDINĖ)";3972897839;Taip;9;0;0;9
9205;Sakalėlis;"BORUŽIUKŲ (LOGOPEDINĖ)";2124857941;Taip;0;1;0;1
9206;Sakalėlis;"BORUŽIUKŲ (LOGOPEDINĖ)";9823633774;Taip;3;0;0;3
9207;Sakalėlis;"BORUŽIUKŲ (LOGOPEDINĖ)";6727251397;Taip;8;3;0;11
9208;Sakalėlis;"BORUŽIUKŲ (LOGOPEDINĖ)";6250400609;Taip;11;0;0;11
9209;Sakalėlis;"BORUŽIUKŲ (LOGOPEDINĖ)";6222204020;Taip;10;0;1;11
9210;Sakalėlis;MEŠKUČIŲ;5233697077;Taip;0;0;2;2
9211;Sakalėlis;MEŠKUČIŲ;6806170544;Taip;0;2;1;3
9212;Sakalėlis;MEŠKUČIŲ;3927363997;Taip;13;3;0;16
9213;Sakalėlis;MEŠKUČIŲ;9592852011;Taip;0;3;0;3
9214;Sakalėlis;MEŠKUČIŲ;6414564366;Taip;16;0;6;22
9215;Sakalėlis;MEŠKUČIŲ;1953356983;Taip;15;0;2;17
9216;Sakalėlis;MEŠKUČIŲ;4358313171;Taip;0;0;1;1
9217;Sakalėlis;MEŠKUČIŲ;2531146677;Taip;3;0;17;20
9218;Sakalėlis;MEŠKUČIŲ;8133985842;Taip;10;0;4;14
9219;Sakalėlis;MEŠKUČIŲ;3574956316;Taip;2;5;0;7
9220;Sakalėlis;MEŠKUČIŲ;1403384561;Taip;3;0;0;3
9221;Sakalėlis;MEŠKUČIŲ;6778987483;Taip;21;0;0;21
9222;Sakalėlis;MEŠKUČIŲ;7602249339;Taip;0;0;7;7
9223;Sakalėlis;MEŠKUČIŲ;2699844937;Taip;2;0;3;5
9224;Sakalėlis;MEŠKUČIŲ;2557089391;Taip;8;0;2;10
9225;Sakalėlis;MEŠKUČIŲ;6293226507;Taip;16;0;0;16
9226;Sakalėlis;MEŠKUČIŲ;9546779717;Taip;12;2;0;14
9227;Sakalėlis;MEŠKUČIŲ;5172421763;Taip;0;0;2;2
9228;Sakalėlis;MEŠKUČIŲ;4968216193;Taip;7;0;0;7
9229;Sakalėlis;MEŠKUČIŲ;5376872141;Taip;15;0;0;15
9230;Sakalėlis;KIŠKUČIŲ;2672429406;Taip;10;0;0;10
9231;Sakalėlis;KIŠKUČIŲ;2250828607;Taip;10;0;0;10
9232;Sakalėlis;KIŠKUČIŲ;9776767584;Taip;22;0;0;22
9233;Sakalėlis;KIŠKUČIŲ;2537030533;Taip;0;0;2;2
9234;Sakalėlis;KIŠKUČIŲ;5500248048;Taip;7;0;0;7
9235;Sakalėlis;KIŠKUČIŲ;1253452975;Taip;0;0;9;9
9236;Sakalėlis;KIŠKUČIŲ;8328069876;Taip;0;0;6;6
9237;Sakalėlis;KIŠKUČIŲ;8501785305;Taip;0;0;4;4
9238;Sakalėlis;KIŠKUČIŲ;3719351129;Taip;12;0;0;12
9239;Sakalėlis;KIŠKUČIŲ;6597274376;Taip;6;0;0;6
9240;Sakalėlis;KIŠKUČIŲ;6851247779;Taip;5;0;0;5
9241;Sakalėlis;KIŠKUČIŲ;8562164673;Taip;0;0;5;5
9242;Sakalėlis;KIŠKUČIŲ;3570413330;Taip;6;0;0;6
9243;Sakalėlis;KIŠKUČIŲ;7852255204;Taip;0;22;0;22
9244;Sakalėlis;KIŠKUČIŲ;9926328835;Taip;5;0;0;5
9245;Sakalėlis;KIŠKUČIŲ;6889888573;Taip;0;12;4;16
9246;Sakalėlis;KIŠKUČIŲ;7480286509;Taip;0;1;0;1
9247;Sakalėlis;SVIRPLIUKŲ;3092760315;Taip;0;2;0;2
9248;Sakalėlis;SVIRPLIUKŲ;8506013777;Taip;0;0;9;9
9249;Sakalėlis;SVIRPLIUKŲ;5189603013;Taip;0;5;0;5
9250;Sakalėlis;SVIRPLIUKŲ;7154383856;Taip;12;0;1;13
9251;Sakalėlis;SVIRPLIUKŲ;5961207419;Taip;0;0;4;4
9252;Sakalėlis;SVIRPLIUKŲ;7285230768;Taip;0;7;0;7
9253;Sakalėlis;SVIRPLIUKŲ;5677280944;Taip;5;0;2;7
9254;Sakalėlis;SVIRPLIUKŲ;7839893402;Taip;0;0;3;3
9255;Sakalėlis;SVIRPLIUKŲ;4063074948;Taip;6;0;7;13
9256;Sakalėlis;SVIRPLIUKŲ;8535457018;Taip;22;0;0;22
9257;Sakalėlis;SVIRPLIUKŲ;8108456923;Taip;7;0;0;7
9258;Sakalėlis;SVIRPLIUKŲ;2389541483;Taip;14;2;0;16
9259;Sakalėlis;SVIRPLIUKŲ;5082756444;Taip;0;10;0;10
9260;Sakalėlis;SVIRPLIUKŲ;3524545708;Taip;0;6;0;6
9261;Sakalėlis;SVIRPLIUKŲ;4813561523;Taip;5;0;2;7
9262;Sakalėlis;GANDRIUKŲ;8502289806;Taip;3;5;0;8
9263;Sakalėlis;GANDRIUKŲ;5292978341;Taip;17;0;0;17
9264;Sakalėlis;GANDRIUKŲ;9368758708;Taip;11;0;0;11
9265;Sakalėlis;GANDRIUKŲ;8326977226;Taip;5;0;0;5
9266;Sakalėlis;GANDRIUKŲ;7384400795;Taip;0;19;0;19
9267;Sakalėlis;GANDRIUKŲ;3644413861;Taip;0;0;1;1
9268;Sakalėlis;GANDRIUKŲ;4576495786;Taip;0;1;7;8
9269;Sakalėlis;GANDRIUKŲ;4230762388;Taip;14;0;0;14
9270;Sakalėlis;GANDRIUKŲ;3228617971;Taip;0;0;3;3
9271;Sakalėlis;GANDRIUKŲ;1545323439;Taip;8;0;0;8
9272;Sakalėlis;GANDRIUKŲ;5748438461;Taip;0;14;8;22
9273;Sakalėlis;GANDRIUKŲ;5884781964;Taip;13;0;1;14
9274;Salininkų;BORUŽIUKAI;6885580632;Taip;0;11;0;11
9275;Salininkų;BORUŽIUKAI;8095820690;Taip;5;0;0;5
9276;Salininkų;BORUŽIUKAI;9896357816;Taip;0;0;1;1
9277;Salininkų;BORUŽIUKAI;8552427446;Taip;0;0;1;1
9278;Salininkų;BORUŽIUKAI;7643665643;Taip;0;5;0;5
9279;Salininkų;BORUŽIUKAI;9198411540;Taip;11;0;0;11
9280;Salininkų;BORUŽIUKAI;7409604480;Taip;13;0;0;13
9281;Salininkų;BORUŽIUKAI;3677558828;Taip;13;1;0;14
9282;Salininkų;BORUŽIUKAI;1380797788;Taip;0;7;0;7
9283;Salininkų;BORUŽIUKAI;9137783249;Taip;0;22;0;22
9284;Salininkų;BORUŽIUKAI;8524400656;Taip;0;22;0;22
9285;Salininkų;BORUŽIUKAI;1111197633;Taip;10;1;0;11
9286;Salininkų;BORUŽIUKAI;2495782496;Taip;0;0;6;6
9287;Salininkų;BORUŽIUKAI;4568462071;Taip;5;0;0;5
9288;Salininkų;BORUŽIUKAI;6143967744;Taip;14;0;1;15
9289;Salininkų;BORUŽIUKAI;6586988786;Taip;0;9;0;9
9290;Salininkų;BORUŽIUKAI;7463713798;Taip;4;5;2;11
9291;Salininkų;GĖLYTĖS;8602489420;Taip;0;12;0;12
9292;Salininkų;GĖLYTĖS;2895782373;Taip;0;2;0;2
9293;Salininkų;GĖLYTĖS;4971070998;Taip;5;0;0;5
9294;Salininkų;GĖLYTĖS;9893985732;Taip;22;0;0;22
9295;Salininkų;GĖLYTĖS;3686372180;Taip;2;0;3;5
9296;Salininkų;GĖLYTĖS;3703729963;Taip;2;2;2;6
9297;Salininkų;GĖLYTĖS;6506819265;Taip;0;1;0;1
9298;Salininkų;GĖLYTĖS;6510096414;Taip;0;2;0;2
9299;Salininkų;GĖLYTĖS;2491796874;Taip;3;0;0;3
9300;Salininkų;GĖLYTĖS;3464228778;Taip;0;9;0;9
9301;Salininkų;GĖLYTĖS;8141168894;Taip;0;22;0;22
9302;Salininkų;GĖLYTĖS;1453214735;Taip;0;4;0;4
9303;Salininkų;GĖLYTĖS;2440831687;Taip;7;3;0;10
9304;Salininkų;GĖLYTĖS;1284909139;Taip;1;6;0;7
9305;Salininkų;GĖLYTĖS;5164367382;Taip;0;1;0;1
9306;Salininkų;GĖLYTĖS;2798153926;Taip;0;2;0;2
9307;Salininkų;DRUGELIAI;8911016037;Taip;4;0;1;5
9308;Salininkų;DRUGELIAI;9018366347;Taip;3;0;0;3
9309;Salininkų;DRUGELIAI;2684868661;Taip;8;0;0;8
9310;Salininkų;DRUGELIAI;8063397588;Taip;5;0;0;5
9311;Salininkų;DRUGELIAI;4333027447;Taip;5;2;0;7
9312;Salininkų;DRUGELIAI;3115232507;Taip;7;0;0;7
9313;Salininkų;DRUGELIAI;2009246885;Taip;3;0;3;6
9314;Salininkų;DRUGELIAI;3420217477;Taip;6;0;0;6
9315;Salininkų;DRUGELIAI;3890914603;Taip;0;8;0;8
9316;Salininkų;DRUGELIAI;3181932118;Taip;3;10;0;13
9317;Salininkų;DRUGELIAI;2208607684;Taip;0;1;0;1
9318;Salininkų;DRUGELIAI;9853754621;Taip;0;22;0;22
9319;Salininkų;DRUGELIAI;3963410827;Taip;22;0;0;22
9320;Salininkų;DRUGELIAI;5539560359;Taip;4;0;4;8
9321;Salininkų;DRUGELIAI;5587577036;Ne;11;0;2;13
9322;Salininkų;DRUGELIAI;5583804491;Taip;0;22;0;22
9323;Salininkų;ŽIRNIUKAI;1544346282;Taip;0;2;0;2
9324;Salininkų;ŽIRNIUKAI;16967442608;Ne;0;2;0;2
9325;Salininkų;PAUKŠČIUKAI;5427013789;Taip;0;0;3;3
9326;Salininkų;PAUKŠČIUKAI;3100499807;Taip;4;0;3;7
9327;Salininkų;PAUKŠČIUKAI;6850925495;Taip;0;3;0;3
9328;Salininkų;PAUKŠČIUKAI;5867676844;Taip;0;0;13;13
9329;Salininkų;PAUKŠČIUKAI;3585435095;Taip;0;0;2;2
9330;Salininkų;PAUKŠČIUKAI;2760231414;Taip;0;2;0;2
9331;Salininkų;PAUKŠČIUKAI;7665409499;Taip;9;0;0;9
9332;Salininkų;PAUKŠČIUKAI;1658695150;Taip;13;0;4;17
9333;Salininkų;PAUKŠČIUKAI;7383557807;Taip;5;8;0;13
9334;Salininkų;PAUKŠČIUKAI;9344614003;Taip;0;2;0;2
9335;Salininkų;PAUKŠČIUKAI;2808778763;Taip;4;6;0;10
9336;Salininkų;PAUKŠČIUKAI;6656578271;Taip;0;2;1;3
9337;Salininkų;PAUKŠČIUKAI;7737045952;Taip;4;0;1;5
9338;Salininkų;PAUKŠČIUKAI;9890660815;Taip;1;0;5;6
9339;Salininkų;PAUKŠČIUKAI;8995565864;Taip;10;1;0;11
9340;Salininkų;PAUKŠČIUKAI;7782972361;Taip;0;1;0;1
9341;Salininkų;PAUKŠČIUKAI;8394582546;Taip;0;10;0;10
9342;Salininkų;PAUKŠČIUKAI;4323257798;Taip;0;1;0;1
9343;Salininkų;PAUKŠČIUKAI;6327046935;Taip;0;1;0;1
9344;Salininkų;PAUKŠČIUKAI;4425748908;Taip;3;5;0;8
9345;Salininkų;PAUKŠČIUKAI;1832393272;Ne;0;2;0;2
9346;Salininkų;BITUTĖS;3252151974;Taip;17;0;0;17
9347;Salininkų;BITUTĖS;6845471044;Taip;0;0;6;6
9348;Salininkų;BITUTĖS;7253347059;Taip;5;0;1;6
9349;Salininkų;BITUTĖS;2467926286;Taip;8;0;0;8
9350;Salininkų;BITUTĖS;6125152143;Taip;0;0;1;1
9351;Salininkų;BITUTĖS;6551489987;Taip;0;2;0;2
9352;Salininkų;BITUTĖS;1928897962;Taip;0;0;1;1
9353;Salininkų;BITUTĖS;7639362434;Taip;0;0;4;4
9354;Salininkų;BITUTĖS;3527495230;Taip;0;0;3;3
9355;Salininkų;BITUTĖS;5582091833;Taip;7;0;0;7
9356;Salininkų;BITUTĖS;2073939432;Taip;0;0;1;1
9357;Salininkų;BITUTĖS;9996809930;Taip;0;0;4;4
9358;Salininkų;BITUTĖS;2370778977;Taip;0;0;3;3
9359;Salininkų;BITUTĖS;1020073382;Taip;0;0;3;3
9360;Salininkų;BITUTĖS;4480303856;Taip;7;0;0;7
9361;Salvija;Daigelis(šatil);3856351749;Taip;5;3;0;8
9362;Salvija;Daigelis(šatil);3487446998;Taip;0;6;0;6
9363;Salvija;Daigelis(šatil);1062662192;Taip;7;0;0;7
9364;Salvija;Daigelis(šatil);4373711097;Taip;0;0;3;3
9365;Salvija;Daigelis(šatil);7477171133;Taip;8;4;1;13
9366;Salvija;Daigelis(šatil);8853389268;Taip;0;8;0;8
9367;Salvija;Daigelis(šatil);7862619996;Ne;0;0;1;1
9368;Salvija;Daigelis(šatil);4577248630;Taip;0;22;0;22
9369;Salvija;Daigelis(šatil);9978634888;Taip;12;0;0;12
9370;Salvija;Daigelis(šatil);1676795179;Taip;0;0;3;3
9371;Salvija;Daigelis(šatil);6509829735;Taip;3;0;0;3
9372;Salvija;Daigelis(šatil);1511271658;Taip;4;0;0;4
9373;Salvija;Daigelis(šatil);3345231579;Taip;9;2;0;11
9374;Salvija;Daigelis(šatil);3640213912;Taip;0;5;1;6
9375;Salvija;"Pienė (savjon)";5494438837;Taip;0;0;2;2
9376;Salvija;"Pienė (savjon)";1103379012;Taip;4;0;0;4
9377;Salvija;"Pienė (savjon)";1777783229;Taip;7;6;0;13
9378;Salvija;"Pienė (savjon)";1478775998;Taip;0;0;17;17
9379;Salvija;"Pienė (savjon)";8802891478;Ne;0;0;4;4
9380;Salvija;"Pienė (savjon)";12326049516;Taip;0;1;0;1
9381;Salvija;"Pienė (savjon)";9908473681;Taip;0;0;3;3
9382;Salvija;"Pienė (savjon)";1910653135;Taip;3;16;0;19
9383;Salvija;"Pienė (savjon)";8023422294;Taip;0;0;1;1
9384;Salvija;"Pienė (savjon)";4152602039;Taip;4;0;0;4
9385;Salvija;"Pienė (savjon)";8981331532;Taip;0;4;0;4
9386;Salvija;"Pienė (savjon)";8306404275;Taip;9;7;0;16
9387;Salvija;"Pienė (savjon)";1653831148;Taip;0;2;0;2
9388;Salvija;"Pienė (savjon)";4325636377;Taip;0;0;1;1
9389;Saulėtekis;BERŽELIS;3493175211;Taip;5;5;0;10
9390;Saulėtekis;BERŽELIS;8086451893;Taip;8;0;1;9
9391;Saulėtekis;BERŽELIS;2935641362;Taip;0;0;2;2
9392;Saulėtekis;BERŽELIS;4676218435;Taip;0;0;2;2
9393;Saulėtekis;BERŽELIS;7598254324;Taip;7;0;0;7
9394;Saulėtekis;BERŽELIS;9351122147;Taip;3;0;1;4
9395;Saulėtekis;BERŽELIS;9737568538;Taip;3;1;0;4
9396;Saulėtekis;BERŽELIS;1852180633;Taip;1;8;0;9
9397;Saulėtekis;BERŽELIS;5468364505;Taip;1;0;1;2
9398;Saulėtekis;BERŽELIS;4704426104;Taip;5;0;1;6
9399;Saulėtekis;BERŽELIS;6181992249;Taip;0;0;2;2
9400;Saulėtekis;BERŽELIS;7407540257;Taip;0;0;1;1
9401;Saulėtekis;BERŽELIS;7436158953;Taip;0;0;4;4
9402;Saulėtekis;BERŽELIS;6920619390;Taip;0;8;0;8
9403;Saulėtekis;BERŽELIS;7698241758;Taip;6;0;1;7
9404;Saulėtekis;BERŽELIS;5194925689;Taip;18;0;0;18
9405;Saulėtekis;BERŽELIS;2177470008;Taip;12;5;0;17
9406;Saulėtekis;BERŽELIS;6026600803;Taip;0;3;0;3
9407;Saulėtekis;BERŽELIS;1241071413;Taip;13;0;0;13
9408;Saulėtekis;BERŽELIS;4736430248;Taip;11;0;2;13
9409;Saulėtekis;ŠYPSENA;1720125332;Ne;7;0;0;7
9410;Saulėtekis;ŠYPSENA;9972687066;Taip;8;1;0;9
9411;Saulėtekis;ŠYPSENA;7346852524;Taip;4;2;0;6
9412;Saulėtekis;ŠYPSENA;1902333363;Taip;11;0;0;11
9413;Saulėtekis;ŠYPSENA;7505040675;Taip;0;1;1;2
9414;Saulėtekis;ŠYPSENA;6501250875;Taip;10;0;0;10
9415;Saulėtekis;ŠYPSENA;9791926936;Taip;3;0;3;6
9416;Saulėtekis;ŠYPSENA;8143793642;Taip;12;4;0;16
9417;Saulėtekis;ŠYPSENA;7673965242;Taip;17;0;1;18
9418;Saulėtekis;ŠYPSENA;3166959569;Taip;5;6;0;11
9419;Saulėtekis;ŠYPSENA;9661075465;Taip;3;7;0;10
9420;Saulėtekis;ŠYPSENA;9383567339;Taip;12;0;0;12
9421;Saulėtekis;ŠYPSENA;4610536784;Ne;7;9;0;16
9422;Saulėtekis;ŠYPSENA;6608831217;Taip;3;1;0;4
9423;Saulėtekis;ŠYPSENA;8239855620;Taip;3;0;0;3
9424;Saulėtekis;ŠYPSENA;7730889108;Taip;0;0;3;3
9425;Saulėtekis;ŠYPSENA;7435424899;Taip;4;0;3;7
9426;Saulėtekis;ŠYPSENA;8231869593;Taip;0;18;0;18
9427;Saulėtekis;ŠYPSENA;7803735686;Taip;8;0;2;10
9428;Saulėtekis;ŠYPSENA;9694119292;Taip;8;0;0;8
9429;Saulėtekis;NYKŠTUKAI;8881524909;Taip;5;3;0;8
9430;Saulėtekis;NYKŠTUKAI;2686041419;Taip;0;5;3;8
9431;Saulėtekis;NYKŠTUKAI;1060784180;Taip;0;1;0;1
9432;Saulėtekis;NYKŠTUKAI;7849181976;Taip;2;0;0;2
9433;Saulėtekis;NYKŠTUKAI;5748816813;Taip;5;0;1;6
9434;Saulėtekis;NYKŠTUKAI;6482182524;Taip;13;1;0;14
9435;Saulėtekis;NYKŠTUKAI;7555273745;Taip;11;0;0;11
9436;Saulėtekis;NYKŠTUKAI;1416983683;Taip;0;10;0;10
9437;Saulėtekis;NYKŠTUKAI;4758423356;Taip;0;2;0;2
9438;Saulėtekis;NYKŠTUKAI;9270109327;Taip;0;9;0;9
9439;Saulėtekis;NYKŠTUKAI;8273890475;Taip;12;0;1;13
9440;Saulėtekis;NYKŠTUKAI;5183297420;Taip;0;4;0;4
9441;Saulėtekis;NYKŠTUKAI;5518726567;Taip;9;0;0;9
9442;Saulėtekis;NYKŠTUKAI;8007704080;Taip;10;3;0;13
9443;Saulėtekis;NYKŠTUKAI;8683571534;Taip;1;3;0;4
9444;Saulėtekis;NYKŠTUKAI;9481578412;Taip;8;0;0;8
9445;Saulėtekis;PAGRANDUKAS;8102360466;Taip;0;0;12;12
9446;Saulėtekis;PAGRANDUKAS;4152255439;Taip;2;0;2;4
9447;Saulėtekis;PAGRANDUKAS;2209156661;Taip;0;9;1;10
9448;Saulėtekis;PAGRANDUKAS;3220993253;Taip;0;7;1;8
9449;Saulėtekis;PAGRANDUKAS;5552614092;Ne;3;0;1;4
9450;Saulėtekis;PAGRANDUKAS;9497129509;Taip;0;0;2;2
9451;Saulėtekis;PAGRANDUKAS;9918219913;Taip;5;0;5;10
9452;Saulėtekis;PAGRANDUKAS;8517049464;Taip;3;0;0;3
9453;Saulėtekis;PAGRANDUKAS;7186085219;Taip;2;0;0;2
9454;Saulėtekis;PAGRANDUKAS;1020209414;Taip;5;3;1;9
9455;Saulėtekis;PAGRANDUKAS;8745921541;Taip;0;0;1;1
9456;Saulėtekis;PAGRANDUKAS;2728836108;Taip;0;0;7;7
9457;Saulėtekis;PAGRANDUKAS;2656659133;Taip;6;1;3;10
9458;Saulėtekis;PAGRANDUKAS;7164579375;Ne;0;17;1;18
9459;Saulėtekis;PAGRANDUKAS;3366064429;Taip;0;0;3;3
9460;Saulėtekis;PAGRANDUKAS;8574702901;Taip;6;0;3;9
9461;Saulėtekis;PAGRANDUKAS;9941731250;Taip;3;0;0;3
9462;Saulėtekis;PAGRANDUKAS;4038684284;Taip;17;0;0;17
9463;Saulėtekis;PAGRANDUKAS;8603952810;Taip;5;0;0;5
9464;Saulėtekis;RAMUNĖLIŲ;6711773127;Taip;7;0;0;7
9465;Saulėtekis;RAMUNĖLIŲ;8739919774;Taip;0;0;1;1
9466;Saulėtekis;RAMUNĖLIŲ;4681031693;Taip;0;0;8;8
9467;Saulėtekis;RAMUNĖLIŲ;3987535802;Taip;3;0;0;3
9468;Saulėtekis;RAMUNĖLIŲ;5297650157;Taip;8;0;0;8
9469;Saulėtekis;RAMUNĖLIŲ;6979741482;Taip;15;0;0;15
9470;Saulėtekis;RAMUNĖLIŲ;8348456528;Taip;6;0;0;6
9471;Saulėtekis;RAMUNĖLIŲ;1866452425;Taip;0;12;6;18
9472;Saulėtekis;RAMUNĖLIŲ;3430209353;Taip;0;0;4;4
9473;Saulėtekis;RAMUNĖLIŲ;2786112846;Taip;8;0;0;8
9474;Saulėtekis;RAMUNĖLIŲ;8876580678;Taip;8;0;0;8
9475;Saulėtekis;RAMUNĖLIŲ;1427323748;Taip;0;0;3;3
9476;Saulėtekis;RAMUNĖLIŲ;3224110585;Taip;12;7;0;19
9477;Saulėtekis;RAMUNĖLIŲ;2002180753;Taip;21;0;0;21
9478;Saulėtekis;RAMUNĖLIŲ;5685176596;Taip;2;0;0;2
9479;Saulėtekis;RAMUNĖLIŲ;3555868198;Taip;6;0;1;7
9480;Saulėtekis;RAMUNĖLIŲ;9668125862;Taip;3;0;1;4
9481;Saulėtekis;RAMUNĖLIŲ;9743690247;Taip;10;0;1;11
9482;Saulėtekis;PASAKAITĖ;8033763960;Taip;9;0;0;9
9483;Saulėtekis;PASAKAITĖ;9428709415;Taip;10;0;0;10
9484;Saulėtekis;PASAKAITĖ;5086871001;Taip;8;5;0;13
9485;Saulėtekis;PASAKAITĖ;2446282019;Taip;9;1;0;10
9486;Saulėtekis;PASAKAITĖ;8572701238;Taip;10;0;0;10
9487;Saulėtekis;PASAKAITĖ;4437540996;Taip;5;0;0;5
9488;Saulėtekis;PASAKAITĖ;7407451018;Taip;0;18;0;18
9489;Saulėtekis;PASAKAITĖ;9226317303;Taip;0;2;0;2
9490;Saulėtekis;PASAKAITĖ;9267790598;Taip;0;2;3;5
9491;Saulėtekis;PASAKAITĖ;6670590135;Taip;7;1;0;8
9492;Saulėtekis;PASAKAITĖ;6720758829;Taip;0;8;0;8
9493;Saulėtekis;PASAKAITĖ;7966714585;Taip;8;0;0;8
9494;Saulėtekis;PASAKAITĖ;3224883243;Taip;7;0;0;7
9495;Saulėtekis;PASAKAITĖ;1809105604;Taip;0;13;0;13
9496;Saulėtekis;PASAKAITĖ;9382031144;Taip;0;10;0;10
9497;Saulėtekis;PASAKAITĖ;3371914339;Taip;0;1;0;1
9498;Saulėtekis;PASAKAITĖ;6214539956;Taip;16;1;1;18
9499;Saulėtekis;PASAKAITĖ;9584556476;Taip;6;1;3;10
9500;Saulėtekis;PASAKAITĖ;9799880235;Taip;0;1;0;1
9501;Saulėtekis;PASAKAITĖ;2469458604;Taip;0;3;0;3
9502;Saulėtekis;PASAKAITĖ;3499575148;Taip;5;1;0;6
9503;Saulėtekis;PASAKAITĖ;8090571664;Taip;12;0;0;12
9504;Saulėtekis;VARPELIAI;94326821425;Taip;8;6;0;14
9505;Saulėtekis;VARPELIAI;6984530386;Taip;0;1;1;2
9506;Saulėtekis;VARPELIAI;1069782559;Taip;4;1;0;5
9507;Saulėtekis;VARPELIAI;1339984127;Taip;0;0;4;4
9508;Saulėtekis;VARPELIAI;68563453302;Taip;5;0;6;11
9509;Saulėtekis;VARPELIAI;77901730057;Taip;0;0;2;2
9510;Saulėtekis;VARPELIAI;74713390994;Taip;0;1;1;2
9511;Saulėtekis;VARPELIAI;43127755042;Taip;0;3;0;3
9512;Saulėtekis;VARPELIAI;1154284625;Taip;0;0;1;1
9513;Saulėtekis;VARPELIAI;1335149249;Taip;0;1;0;1
9514;Saulėtekis;VARPELIAI;1108321396;Taip;0;1;1;2
9515;Saulėtekis;VARPELIAI;891603633;Taip;0;1;5;6
9516;Saulėtekis;VARPELIAI;36605502570;Taip;0;0;3;3
9517;Saulėtekis;VARPELIAI;2075281680;Taip;0;1;2;3
9518;Saulėtekis;VARPELIAI;1213567219;Taip;8;0;2;10
9519;Saulėtekis;VARPELIAI;61118132521;Taip;0;0;2;2
9520;Saulėtekis;VARPELIAI;7464965841;Taip;0;1;1;2
9521;Saulėtekis;VARPELIAI;6671771491;Taip;0;3;0;3
9522;Saulėtekis;VARPELIAI;20534872540;Taip;0;0;1;1
9523;Saulėtekis;VARPELIAI;49053923177;Taip;0;7;2;9
9524;Saulėtekis;VARPELIAI;21376960952;Taip;0;0;1;1
9525;Saulėtekis;VARPELIAI;3337160930;Taip;0;1;1;2
9526;Saulėtekis;GRŪDELIS;3706398395;Taip;0;7;1;8
9527;Saulėtekis;GRŪDELIS;1864236745;Taip;0;0;3;3
9528;Saulėtekis;GRŪDELIS;7494641077;Taip;13;0;0;13
9529;Saulėtekis;GRŪDELIS;1577609727;Taip;13;0;0;13
9530;Saulėtekis;GRŪDELIS;3434815790;Taip;3;0;0;3
9531;Saulėtekis;GRŪDELIS;2672108464;Taip;0;0;9;9
9532;Saulėtekis;GRŪDELIS;6779891385;Taip;12;0;2;14
9533;Saulėtekis;GRŪDELIS;9579088485;Taip;1;0;0;1
9534;Saulėtekis;GRŪDELIS;2568544418;Taip;5;0;0;5
9535;Saulėtekis;GRŪDELIS;7171048750;Taip;0;0;2;2
9536;Saulėtekis;GRŪDELIS;9734188792;Taip;17;0;0;17
9537;Saulėtekis;GRŪDELIS;6535620172;Taip;10;0;2;12
9538;Saulėtekis;GRŪDELIS;8252953405;Taip;0;0;6;6
9539;Saulėtekis;GRŪDELIS;5161940030;Taip;3;0;0;3
9540;Saulėtekis;GRŪDELIS;5218345414;Taip;9;5;0;14
9541;Saulėtekis;GRŪDELIS;9646060606;Taip;10;0;0;10
9542;Saulėtekis;GRŪDELIS;1934900185;Ne;8;2;0;10
9543;Saulėtekis;JONVABALIS;5003645081;Taip;4;0;3;7
9544;Saulėtekis;JONVABALIS;1715634399;Taip;0;4;0;4
9545;Saulėtekis;JONVABALIS;1897872021;Taip;0;5;0;5
9546;Saulėtekis;JONVABALIS;1010906684;Taip;2;0;0;2
9547;Saulėtekis;JONVABALIS;7227802003;Taip;0;1;0;1
9548;Saulėtekis;JONVABALIS;84492261206;Ne;7;5;0;12
9549;Saulėtekis;JONVABALIS;72559769416;Taip;0;4;0;4
9550;Saulėtekis;JONVABALIS;1611009868;Taip;7;4;0;11
9551;Saulėtekis;JONVABALIS;4613040294;Taip;11;1;0;12
9552;Saulėtekis;JONVABALIS;1655720839;Taip;15;0;0;15
9553;Saulėtekis;JONVABALIS;3166181835;Taip;0;4;0;4
9554;Saulėtekis;JONVABALIS;6599452886;Taip;0;5;0;5
9555;Saulėtekis;JONVABALIS;8896065807;Taip;9;5;0;14
9556;Saulėtekis;JONVABALIS;1702638461;Taip;8;10;0;18
9557;Saulėtekis;JONVABALIS;3207128776;Taip;0;1;0;1
9558;Saulėtekis;JONVABALIS;2311184444;Taip;0;3;0;3
9559;Saulėtekis;JONVABALIS;1267706132;Taip;0;2;0;2
9560;Saulėtekis;JONVABALIS;1066191639;Taip;1;11;0;12
9561;Saulėtekis;JONVABALIS;98936544904;Taip;0;2;0;2
9562;Saulėtekis;JONVABALIS;22570044589;Taip;0;4;0;4
9563;Saulėtekis;JONVABALIS;97771948184;Taip;0;7;0;7
9564;Saulėtekis;JONVABALIS;8752857993;Taip;0;6;0;6
9565;Saulėtekis;SMALSUČIAI;40877542045;Taip;0;1;0;1
9566;Saulėtekis;SMALSUČIAI;86524549051;Taip;2;4;2;8
9567;Saulėtekis;SMALSUČIAI;7030227903;Taip;4;1;0;5
9568;Saulėtekis;SMALSUČIAI;32771808648;Taip;0;5;0;5
9569;Saulėtekis;SMALSUČIAI;1808644850;Taip;22;0;0;22
9570;Saulėtekis;SMALSUČIAI;1642031589;Taip;0;4;0;4
9571;Saulėtekis;SMALSUČIAI;7621094096;Taip;0;0;2;2
9572;Saulėtekis;SMALSUČIAI;13451381485;Taip;6;1;0;7
9573;Saulėtekis;SMALSUČIAI;19605249139;Taip;0;1;0;1
9574;Saulėtekis;SMALSUČIAI;1619134034;Taip;0;5;0;5
9575;Saulėtekis;SMALSUČIAI;8673024996;Taip;6;0;0;6
9576;Saulėtekis;SMALSUČIAI;1456865685;Taip;0;5;0;5
9577;Saulėtekis;SMALSUČIAI;32658647272;Taip;8;0;1;9
9578;Saulėtekis;SMALSUČIAI;4180984076;Taip;7;2;0;9
9579;Saulėtekis;SMALSUČIAI;4027823257;Taip;0;0;5;5
9580;Saulėtekis;SMALSUČIAI;53906058088;Taip;4;0;1;5
9581;Saulėtekis;SMALSUČIAI;86804497954;Taip;7;4;0;11
9582;Saulėtekis;BITUTĖS;7766084857;Taip;0;0;1;1
9583;Saulėtekis;BITUTĖS;4537254306;Taip;4;0;1;5
9584;Saulėtekis;BITUTĖS;60462712074;Taip;0;0;1;1
9585;Saulėtekis;BITUTĖS;9945647968;Taip;8;0;2;10
9586;Saulėtekis;BITUTĖS;1962914764;Taip;4;0;16;20
9587;Saulėtekis;BITUTĖS;1481503733;Taip;0;0;3;3
9588;Saulėtekis;BITUTĖS;8302260087;Taip;0;4;1;5
9589;Saulėtekis;BITUTĖS;2593106154;Taip;0;0;7;7
9590;Saulėtekis;BITUTĖS;2813949848;Taip;7;0;1;8
9591;Saulėtekis;BITUTĖS;3058991890;Taip;6;2;0;8
9592;Saulėtekis;BITUTĖS;7986712728;Taip;0;8;0;8
9593;Saulėtekis;BITUTĖS;6087170055;Taip;0;0;6;6
9594;Saulėtekis;BITUTĖS;7027103276;Taip;0;0;1;1
9595;Saulėtekis;BITUTĖS;7758268674;Taip;8;5;2;15
9596;Saulėtekis;BITUTĖS;2077976415;Taip;0;0;5;5
9597;Saulėtekis;BITUTĖS;9605052795;Taip;0;0;9;9
9598;Saulėtekis;BITUTĖS;7075757274;Taip;0;0;9;9
9599;Saulėtekis;BITUTĖS;2639872637;Taip;0;0;4;4
9600;Saulėtekis;RIEŠUTĖLIAI;2021901593;Taip;0;1;0;1
9601;Saulėtekis;RIEŠUTĖLIAI;7842280836;Taip;0;0;1;1
9602;Saulėtekis;RIEŠUTĖLIAI;6102064617;Taip;0;0;2;2
9603;Saulėtekis;RIEŠUTĖLIAI;2238947856;Taip;3;0;2;5
9604;Saulėtekis;RIEŠUTĖLIAI;84982517658;Taip;9;0;0;9
9605;Saulėtekis;RIEŠUTĖLIAI;3541535891;Taip;0;0;7;7
9606;Saulėtekis;RIEŠUTĖLIAI;36003078842;Taip;3;3;0;6
9607;Saulėtekis;RIEŠUTĖLIAI;4663268649;Taip;3;2;0;5
9608;Saulėtekis;RIEŠUTĖLIAI;25199011812;Taip;0;0;6;6
9609;Saulėtekis;RIEŠUTĖLIAI;7051608858;Taip;10;4;0;14
9610;Saulėtekis;RIEŠUTĖLIAI;9634949452;Taip;0;0;2;2
9611;Saulėtekis;RIEŠUTĖLIAI;4338502152;Taip;1;0;0;1
9612;Saulėtekis;RIEŠUTĖLIAI;8002806189;Taip;0;4;0;4
9613;Saulėtekis;RIEŠUTĖLIAI;9657195627;Taip;0;7;0;7
9614;Saulėtekis;RIEŠUTĖLIAI;2474900044;Taip;4;1;0;5
9615;Saulėtekis;RIEŠUTĖLIAI;3450907715;Ne;0;11;6;17
9616;Saulėtekis;RIEŠUTĖLIAI;2546789906;Taip;19;0;0;19
9617;Saulėtekis;RIEŠUTĖLIAI;5678858566;Taip;4;0;5;9
9618;Skroblinukas;SVIRPLIUKŲ;2195112297;Taip;8;6;1;15
9619;Skroblinukas;SVIRPLIUKŲ;4198512202;Taip;15;9;3;27
9620;Skroblinukas;SVIRPLIUKŲ;7750501815;Taip;13;5;2;20
9621;Skroblinukas;SVIRPLIUKŲ;4960825597;Taip;4;1;1;6
9622;Skroblinukas;SVIRPLIUKŲ;1544598440;Taip;7;2;0;9
9623;Skroblinukas;SVIRPLIUKŲ;6574558658;Taip;0;4;7;11
9624;Skroblinukas;SVIRPLIUKŲ;1669610397;Taip;22;0;0;22
9625;Skroblinukas;SVIRPLIUKŲ;6254811026;Taip;1;7;20;28
9626;Skroblinukas;SVIRPLIUKŲ;4861971439;Taip;5;2;3;10
9627;Skroblinukas;SVIRPLIUKŲ;7817632987;Taip;0;15;1;16
9628;Skroblinukas;SVIRPLIUKŲ;7675772872;Taip;0;2;1;3
9629;Skroblinukas;SVIRPLIUKŲ;8283516422;Taip;2;6;0;8
9630;Skroblinukas;SVIRPLIUKŲ;4266945644;Taip;3;1;5;9
9631;Skroblinukas;SVIRPLIUKŲ;9003855190;Taip;0;14;0;14
9632;Skroblinukas;SVIRPLIUKŲ;7216760382;Taip;12;7;0;19
9633;Skroblinukas;SVIRPLIUKŲ;8622930871;Taip;0;7;2;9
9634;Skroblinukas;SVIRPLIUKŲ;9661609284;Taip;0;4;0;4
9635;Skroblinukas;GANDRIUKŲ;2197158518;Taip;0;4;1;5
9636;Skroblinukas;GANDRIUKŲ;2406619611;Taip;2;7;0;9
9637;Skroblinukas;GANDRIUKŲ;9572912046;Taip;0;15;0;15
9638;Skroblinukas;GANDRIUKŲ;5646847921;Taip;0;2;0;2
9639;Skroblinukas;GANDRIUKŲ;1851920334;Taip;0;7;0;7
9640;Skroblinukas;GANDRIUKŲ;9377215921;Taip;11;1;0;12
9641;Skroblinukas;GANDRIUKŲ;6266609965;Taip;0;2;0;2
9642;Skroblinukas;GANDRIUKŲ;6235844690;Taip;0;6;0;6
9643;Skroblinukas;GANDRIUKŲ;6489976163;Taip;7;2;0;9
9644;Skroblinukas;GANDRIUKŲ;1159546580;Taip;0;2;1;3
9645;Skroblinukas;GANDRIUKŲ;2630699296;Taip;0;2;0;2
9646;Skroblinukas;GANDRIUKŲ;2310750833;Taip;0;11;0;11
9647;Skroblinukas;GANDRIUKŲ;9888115079;Ne;0;2;0;2
9648;Skroblinukas;GANDRIUKŲ;9475514959;Ne;0;9;1;10
9649;Skroblinukas;GANDRIUKŲ;9031598603;Taip;5;3;1;9
9650;Skroblinukas;GANDRIUKŲ;5251903769;Ne;0;26;0;26
9651;Skroblinukas;VYTURIUKŲ;3954228349;Taip;1;1;2;4
9652;Skroblinukas;VYTURIUKŲ;6879979868;Taip;0;1;0;1
9653;Skroblinukas;VYTURIUKŲ;4560580022;Taip;0;8;0;8
9654;Skroblinukas;VYTURIUKŲ;3065235192;Taip;3;5;0;8
9655;Skroblinukas;VYTURIUKŲ;5902713448;Taip;5;9;0;14
9656;Skroblinukas;VYTURIUKŲ;3594000419;Taip;0;6;0;6
9657;Skroblinukas;VYTURIUKŲ;3512297435;Taip;0;5;0;5
9658;Skroblinukas;VYTURIUKŲ;6293879765;Taip;0;7;1;8
9659;Skroblinukas;VYTURIUKŲ;9725125130;Taip;0;1;0;1
9660;Skroblinukas;VYTURIUKŲ;2978284436;Taip;0;3;1;4
9661;Skroblinukas;VYTURIUKŲ;7068452970;Taip;0;2;0;2
9662;Skroblinukas;VYTURIUKŲ;3292517112;Taip;0;1;2;3
9663;Skroblinukas;VYTURIUKŲ;3461165182;Taip;0;7;14;21
9664;Skroblinukas;VYTURIUKŲ;4129726208;Taip;8;0;0;8
9665;Skroblinukas;GENIUKŲ;48655837755;Taip;0;7;1;8
9666;Skroblinukas;GENIUKŲ;2323980730;Taip;0;6;0;6
9667;Skroblinukas;GENIUKŲ;1325903217;Taip;0;11;0;11
9668;Skroblinukas;GENIUKŲ;8380073853;Taip;15;1;0;16
9669;Skroblinukas;GENIUKŲ;4436698905;Taip;0;11;0;11
9670;Skroblinukas;GENIUKŲ;1905085978;Taip;3;6;4;13
9671;Skroblinukas;GENIUKŲ;1557733803;Taip;0;10;0;10
9672;Skroblinukas;GENIUKŲ;9433465007;Taip;0;9;0;9
9673;Skroblinukas;GENIUKŲ;1395950886;Ne;0;6;0;6
9674;Skroblinukas;GENIUKŲ;1696303051;Taip;0;5;0;5
9675;Skroblinukas;GENIUKŲ;9846569195;Taip;0;2;1;3
9676;Skroblinukas;GENIUKŲ;4773576465;Taip;0;1;0;1
9677;Skroblinukas;GENIUKŲ;2704157855;Taip;0;1;0;1
9678;Skroblinukas;GENIUKŲ;9564385215;Taip;0;2;0;2
9679;Skroblinukas;GENIUKŲ;6129591146;Taip;0;14;0;14
9680;Skroblinukas;GENIUKŲ;3128337104;Taip;5;2;0;7
9681;Skroblinukas;GENIUKŲ;4272941994;Taip;0;1;0;1
9682;Skroblinukas;GENIUKŲ;3864043251;Taip;0;6;0;6
9683;Skroblinukas;GENIUKŲ;1064449916;Taip;0;1;0;1
9684;Skroblinukas;BITUČIŲ;1934804499;Taip;4;1;0;5
9685;Skroblinukas;BITUČIŲ;2134821488;Taip;7;0;1;8
9686;Skroblinukas;BITUČIŲ;2071447940;Taip;6;0;0;6
9687;Skroblinukas;BITUČIŲ;6604496585;Taip;4;3;0;7
9688;Skroblinukas;BITUČIŲ;3736883850;Taip;0;1;0;1
9689;Skroblinukas;BITUČIŲ;7191689856;Taip;0;8;0;8
9690;Skroblinukas;BITUČIŲ;8778072326;Taip;3;0;1;4
9691;Skroblinukas;BITUČIŲ;2032621707;Taip;5;1;4;10
9692;Skroblinukas;BITUČIŲ;8374103872;Taip;0;1;0;1
9693;Skroblinukas;BITUČIŲ;8618587013;Taip;0;2;0;2
9694;Skroblinukas;BITUČIŲ;4945107862;Ne;0;0;1;1
9695;Skroblinukas;BITUČIŲ;9594078223;Taip;0;4;0;4
9696;Skroblinukas;BITUČIŲ;1688990637;Taip;12;0;0;12
9697;Skroblinukas;BITUČIŲ;1957488412;Taip;0;1;6;7
9698;Skroblinukas;BITUČIŲ;1000804920;Taip;11;0;0;11
9699;Skroblinukas;BITUČIŲ;1711568129;Ne;0;0;4;4
9700;Skroblinukas;BORUŽĖLIŲ;2887161771;Taip;0;3;1;4
9701;Skroblinukas;BORUŽĖLIŲ;4831370981;Taip;0;7;0;7
9702;Skroblinukas;BORUŽĖLIŲ;8305867345;Taip;0;1;3;4
9703;Skroblinukas;BORUŽĖLIŲ;8715188878;Taip;11;12;0;23
9704;Skroblinukas;BORUŽĖLIŲ;4688496560;Taip;5;6;4;15
9705;Skroblinukas;BORUŽĖLIŲ;2772360168;Taip;0;3;0;3
9706;Skroblinukas;BORUŽĖLIŲ;5957417413;Taip;5;6;0;11
9707;Skroblinukas;BORUŽĖLIŲ;3889890374;Taip;0;9;0;9
9708;Skroblinukas;BORUŽĖLIŲ;9481718833;Taip;5;0;0;5
9709;Skroblinukas;BORUŽĖLIŲ;7407601996;Taip;1;1;0;2
9710;Skroblinukas;BORUŽĖLIŲ;2215428081;Taip;0;6;0;6
9711;Skroblinukas;BORUŽĖLIŲ;8864594520;Taip;0;2;0;2
9712;Skroblinukas;BORUŽĖLIŲ;4737605061;Ne;0;16;1;17
9713;Skroblinukas;BORUŽĖLIŲ;7255510731;Taip;0;1;4;5
9714;Skroblinukas;BORUŽĖLIŲ;7400908711;Ne;0;26;2;28
9715;Skroblinukas;SKRUZDĖLIUKŲ;5688453546;Taip;0;2;2;4
9716;Skroblinukas;SKRUZDĖLIUKŲ;6890306112;Taip;0;9;0;9
9717;Skroblinukas;SKRUZDĖLIUKŲ;6445065388;Taip;0;3;0;3
9718;Skroblinukas;SKRUZDĖLIUKŲ;9448253468;Taip;3;0;1;4
9719;Skroblinukas;SKRUZDĖLIUKŲ;3771045336;Taip;0;4;0;4
9720;Skroblinukas;SKRUZDĖLIUKŲ;4424763028;Taip;0;4;0;4
9721;Skroblinukas;SKRUZDĖLIUKŲ;9353353289;Taip;0;2;2;4
9722;Skroblinukas;SKRUZDĖLIUKŲ;5157913924;Taip;0;8;0;8
9723;Skroblinukas;SKRUZDĖLIUKŲ;9368764758;Taip;0;1;0;1
9724;Skroblinukas;SKRUZDĖLIUKŲ;9958188318;Taip;0;3;0;3
9725;Skroblinukas;SKRUZDĖLIUKŲ;8576448571;Taip;3;0;3;6
9726;Skroblinukas;SKRUZDĖLIUKŲ;1002570367;Taip;0;1;0;1
9727;Skroblinukas;SKRUZDĖLIUKŲ;9813249677;Taip;0;5;0;5
9728;Skroblinukas;SKRUZDĖLIUKŲ;2101748012;Taip;0;0;1;1
9729;Skroblinukas;SKRUZDĖLIUKŲ;2706526326;Ne;0;0;1;1
9730;Skroblinukas;SKRUZDĖLIUKŲ;5915278745;Taip;0;1;0;1
9731;Skroblinukas;SKRUZDĖLIUKŲ;6640062847;Taip;0;2;0;2
9732;Skroblinukas;ŽVIRBLIUKŲ;7480611069;Ne;0;2;0;2
9733;Skroblinukas;ŽVIRBLIUKŲ;2071093890;Taip;0;0;4;4
9734;Skroblinukas;ŽVIRBLIUKŲ;3532258904;Taip;1;0;2;3
9735;Skroblinukas;ŽVIRBLIUKŲ;9553242594;Taip;0;10;0;10
9736;Skroblinukas;ŽVIRBLIUKŲ;1758987652;Taip;0;10;0;10
9737;Skroblinukas;ŽVIRBLIUKŲ;1453029732;Taip;0;11;0;11
9738;Skroblinukas;ŽVIRBLIUKŲ;9523720873;Taip;0;0;19;19
9739;Skroblinukas;ŽVIRBLIUKŲ;9162582460;Taip;3;0;2;5
9740;Skroblinukas;ŽVIRBLIUKŲ;7489143683;Taip;0;6;0;6
9741;Skroblinukas;ŽVIRBLIUKŲ;6717008836;Taip;0;0;5;5
9742;Skroblinukas;ŽVIRBLIUKŲ;1232121301;Taip;8;0;0;8
9743;Skroblinukas;ŽVIRBLIUKŲ;1014993354;Taip;11;4;0;15
9744;Skroblinukas;ŽVIRBLIUKŲ;4802801867;Taip;0;0;3;3
9745;Skroblinukas;ŽVIRBLIUKŲ;7920117036;Taip;4;0;1;5
9746;Skroblinukas;ŽIOGELIŲ;9629502585;Taip;3;1;0;4
9747;Skroblinukas;ŽIOGELIŲ;7761972818;Taip;4;3;0;7
9748;Skroblinukas;ŽIOGELIŲ;8286842648;Taip;4;0;0;4
9749;Skroblinukas;ŽIOGELIŲ;6461678336;Taip;3;0;1;4
9750;Skroblinukas;ŽIOGELIŲ;3046542264;Taip;0;4;0;4
9751;Skroblinukas;ŽIOGELIŲ;2885814517;Taip;0;6;0;6
9752;Skroblinukas;ŽIOGELIŲ;2363368201;Taip;0;0;1;1
9753;Skroblinukas;ŽIOGELIŲ;8390240445;Taip;0;4;0;4
9754;Skroblinukas;ŽIOGELIŲ;2987938909;Taip;5;4;0;9
9755;Skroblinukas;ŽIOGELIŲ;5912771080;Taip;0;0;2;2
9756;Skroblinukas;ŽIOGELIŲ;2948231687;Taip;6;0;2;8
9757;Skroblinukas;STRAZDELIŲ;8312341293;Taip;0;14;0;14
9758;Skroblinukas;STRAZDELIŲ;8958893525;Taip;0;1;1;2
9759;Skroblinukas;STRAZDELIŲ;4168542339;Taip;0;3;0;3
9760;Skroblinukas;STRAZDELIŲ;1009065470;Taip;0;10;13;23
9761;Skroblinukas;STRAZDELIŲ;8815319607;Taip;21;6;0;27
9762;Skroblinukas;STRAZDELIŲ;5418212729;Taip;3;9;0;12
9763;Skroblinukas;STRAZDELIŲ;3658815079;Taip;9;2;0;11
9764;Skroblinukas;STRAZDELIŲ;9699407871;Taip;0;1;0;1
9765;Skroblinukas;STRAZDELIŲ;8202855376;Taip;0;9;20;29
9766;Skroblinukas;STRAZDELIŲ;3646325903;Taip;0;15;0;15
9767;Skroblinukas;STRAZDELIŲ;8953844650;Taip;2;1;0;3
9768;Skroblinukas;STRAZDELIŲ;1820748152;Taip;0;1;0;1
9769;Skroblinukas;STRAZDELIŲ;7940196450;Taip;0;4;0;4
9770;Skroblinukas;STRAZDELIŲ;9292990596;Taip;0;1;1;2
9771;Skroblinukas;STRAZDELIŲ;5946356374;Taip;4;2;0;6
9772;Skroblinukas;STRAZDELIŲ;5274898590;Taip;13;5;0;18
9773;Skroblinukas;DRUGELIŲ;1792672886;Taip;0;2;3;5
9774;Skroblinukas;DRUGELIŲ;1979723351;Taip;0;7;0;7
9775;Skroblinukas;DRUGELIŲ;1964529755;Taip;0;9;0;9
9776;Skroblinukas;DRUGELIŲ;23687553212;Taip;0;7;0;7
9777;Skroblinukas;DRUGELIŲ;86542450905;Taip;0;3;0;3
9778;Skroblinukas;DRUGELIŲ;54750454175;Taip;0;1;3;4
9779;Skroblinukas;DRUGELIŲ;2019575002;Taip;0;1;0;1
9780;Skroblinukas;DRUGELIŲ;3636028890;Taip;13;8;0;21
9781;Skroblinukas;DRUGELIŲ;2079452635;Taip;0;2;5;7
9782;Skroblinukas;DRUGELIŲ;1510927547;Taip;0;2;5;7
9783;Skroblinukas;DRUGELIŲ;2325940694;Taip;0;11;0;11
9784;Skroblinukas;DRUGELIŲ;15977832913;Taip;0;1;0;1
9785;Skroblinukas;DRUGELIŲ;5068339590;Taip;5;3;0;8
9786;Skroblinukas;DRUGELIŲ;3580045988;Taip;0;10;0;10
9787;Skroblinukas;DRUGELIŲ;1005726705;Taip;0;0;4;4
9788;Skroblinukas;DRUGELIŲ;1388763405;Taip;0;0;2;2
9789;Skroblinukas;DRUGELIŲ;1791669956;Taip;0;2;0;2
9790;Skroblinukas;DRUGELIŲ;7184817010;Taip;0;15;0;15
9791;Skroblinukas;DRUGELIŲ;1109895463;Taip;0;7;0;7
9792;Skroblinukas;DRUGELIŲ;2116630768;Taip;0;9;0;9
9793;Skroblinukas;DRUGELIŲ;18955401411;Taip;4;0;0;4
9794;Skroblinukas;PELĖDŽIUKŲ;63514584063;Taip;0;17;0;17
9795;Skroblinukas;PELĖDŽIUKŲ;1000422430;Taip;0;0;3;3
9796;Skroblinukas;PELĖDŽIUKŲ;7666122737;Taip;7;2;0;9
9797;Skroblinukas;PELĖDŽIUKŲ;1759830058;Taip;0;10;0;10
9798;Skroblinukas;PELĖDŽIUKŲ;1471842192;Taip;0;0;1;1
9799;Skroblinukas;PELĖDŽIUKŲ;29908502973;Taip;0;1;2;3
9800;Skroblinukas;PELĖDŽIUKŲ;1220311458;Taip;0;1;0;1
9801;Skroblinukas;PELĖDŽIUKŲ;95946607624;Taip;0;7;0;7
9802;Skroblinukas;PELĖDŽIUKŲ;8150037173;Taip;0;13;0;13
9803;Skroblinukas;PELĖDŽIUKŲ;1898486832;Taip;7;2;0;9
9804;Skroblinukas;PELĖDŽIUKŲ;4221501092;Taip;0;5;0;5
9805;Skroblinukas;PELĖDŽIUKŲ;1515227489;Taip;0;13;2;15
9806;Skroblinukas;PELĖDŽIUKŲ;76523308405;Taip;11;11;0;22
9807;Skroblinukas;PELĖDŽIUKŲ;1602978649;Taip;0;1;0;1
9808;Skroblinukas;PELĖDŽIUKŲ;1258044022;Taip;4;4;0;8
9809;Skroblinukas;PELĖDŽIUKŲ;4914479407;Taip;0;0;2;2
9810;Skroblinukas;PELĖDŽIUKŲ;1847074960;Ne;11;3;1;15
9811;Skroblinukas;PELĖDŽIUKŲ;3858891097;Taip;0;7;4;11
9812;Skroblinukas;PELĖDŽIUKŲ;9777300890;Taip;0;3;0;3
9813;Skroblinukas;PELĖDŽIUKŲ;6002038732;Taip;0;11;1;12
9814;Smalsučiai;Žibuoklės;1668692281;Taip;0;0;1;1
9815;Smalsučiai;Žibuoklės;1181574676;Taip;0;9;0;9
9816;Smalsučiai;Žibuoklės;1599488035;Taip;0;3;0;3
9817;Smalsučiai;Žibuoklės;4727475042;Taip;3;0;6;9
9818;Smalsučiai;Žibuoklės;8520753848;Taip;0;12;1;13
9819;Smalsučiai;Žibuoklės;22791221635;Taip;0;1;0;1
9820;Smalsučiai;Žibuoklės;3607226859;Taip;0;7;0;7
9821;Smalsučiai;Žibuoklės;1467603676;Taip;0;3;0;3
9822;Smalsučiai;Žibuoklės;19592364606;Taip;0;16;0;16
9823;Smalsučiai;Žibuoklės;1824321380;Taip;0;0;1;1
9824;Smalsučiai;Žibuoklės;4145769042;Taip;0;4;0;4
9825;Smalsučiai;Žibuoklės;6529889121;Taip;0;3;0;3
9826;Smalsučiai;Žibuoklės;7713078413;Taip;0;2;0;2
9827;Smalsučiai;Žibuoklės;5730866119;Taip;0;5;2;7
9828;Smalsučiai;Žibuoklės;5611487967;Taip;0;1;0;1
9829;Smalsučiai;Žibuoklės;5159799570;Taip;0;0;5;5
9830;Smalsučiai;Žibuoklės;1673246147;Taip;0;19;0;19
9831;Smalsučiai;Žibuoklės;4379645417;Taip;0;0;6;6
9832;Smalsučiai;Aitvarų;2638709634;Taip;3;0;0;3
9833;Smalsučiai;Aitvarų;5441966713;Taip;0;1;0;1
9834;Smalsučiai;Aitvarų;8306946163;Taip;0;6;0;6
9835;Smalsučiai;Aitvarų;6469044880;Taip;7;3;0;10
9836;Smalsučiai;Aitvarų;2136420967;Taip;10;0;0;10
9837;Smalsučiai;Aitvarų;2059832436;Ne;0;1;0;1
9838;Smalsučiai;Aitvarų;1316590100;Taip;0;5;0;5
9839;Smalsučiai;Aitvarų;1997966082;Taip;0;5;0;5
9840;Smalsučiai;Aitvarų;4585930202;Taip;8;0;0;8
9841;Smalsučiai;Aitvarų;8810690546;Taip;5;7;0;12
9842;Smalsučiai;Aitvarų;1775539505;Taip;0;4;0;4
9843;Smalsučiai;Aitvarų;4909226602;Taip;0;0;3;3
9844;Smalsučiai;Aitvarų;6536165801;Taip;5;5;1;11
9845;Smalsučiai;Aitvarų;3644256220;Taip;0;2;1;3
9846;Smalsučiai;Aitvarų;9481692900;Ne;1;0;2;3
9847;Smalsučiai;Aitvarų;9703726869;Taip;1;2;0;3
9848;Smalsučiai;Sraigiukų;7933302912;Taip;0;11;0;11
9849;Smalsučiai;Sraigiukų;1471941426;Taip;0;9;0;9
9850;Smalsučiai;Sraigiukų;1458544456;Taip;0;1;0;1
9851;Smalsučiai;Sraigiukų;5406430393;Taip;0;7;0;7
9852;Smalsučiai;Sraigiukų;9604182559;Taip;0;6;0;6
9853;Smalsučiai;Sraigiukų;6469604093;Taip;0;6;0;6
9854;Smalsučiai;Sraigiukų;4364810458;Taip;0;5;0;5
9855;Smalsučiai;Sraigiukų;4566816316;Taip;0;4;0;4
9856;Smalsučiai;Sraigiukų;4629526320;Taip;5;0;0;5
9857;Smalsučiai;Sraigiukų;4134975456;Taip;3;0;0;3
9858;Smalsučiai;Sraigiukų;6899040199;Taip;0;12;0;12
9859;Smalsučiai;Sraigiukų;6358800570;Taip;15;2;0;17
9860;Smalsučiai;Sraigiukų;2327930850;Taip;0;12;0;12
9861;Smalsučiai;Sraigiukų;3787937467;Taip;0;11;0;11
9862;Smalsučiai;Sraigiukų;4824786207;Taip;0;3;0;3
9863;Smalsučiai;Sraigiukų;2953239027;Taip;0;11;0;11
9864;Smalsučiai;Sraigiukų;3825610986;Taip;6;14;0;20
9865;Smalsučiai;Saulučių;1776385691;Taip;0;0;2;2
9866;Smalsučiai;Saulučių;2259361924;Taip;7;0;4;11
9867;Smalsučiai;Saulučių;1162964613;Taip;3;0;5;8
9868;Smalsučiai;Saulučių;9934952886;Taip;5;4;7;16
9869;Smalsučiai;Saulučių;9556433086;Taip;13;3;0;16
9870;Smalsučiai;Saulučių;1904973393;Taip;0;2;0;2
9871;Smalsučiai;Saulučių;3252901131;Taip;5;0;3;8
9872;Smalsučiai;Saulučių;9743116843;Taip;11;0;2;13
9873;Smalsučiai;Saulučių;2392217952;Taip;13;0;1;14
9874;Smalsučiai;Saulučių;1447512509;Taip;6;0;16;22
9875;Smalsučiai;Saulučių;7774766882;Taip;0;5;0;5
9876;Smalsučiai;Saulučių;2034284973;Taip;4;5;0;9
9877;Smalsučiai;Saulučių;7423419934;Taip;4;0;0;4
9878;Smalsučiai;Saulučių;7049101015;Taip;5;0;2;7
9879;Smalsučiai;Saulučių;9183519167;Taip;3;0;3;6
9880;Smalsučiai;Saulučių;5708986552;Taip;11;0;3;14
9881;Smalsučiai;Saulučių;4889923629;Taip;0;5;1;6
9882;Smalsučiai;Saulučių;5541908981;Taip;0;0;3;3
9883;Smalsučiai;Saulučių;1213476648;Taip;3;0;4;7
9884;Smalsučiai;Viščiukų;6006832443;Taip;0;3;0;3
9885;Smalsučiai;Viščiukų;9864518144;Taip;0;3;0;3
9886;Smalsučiai;Viščiukų;8128348060;Taip;3;10;0;13
9887;Smalsučiai;Viščiukų;4847584492;Taip;4;0;0;4
9888;Smalsučiai;Viščiukų;9732075162;Taip;0;0;1;1
9889;Smalsučiai;Viščiukų;2034528872;Taip;10;0;2;12
9890;Smalsučiai;Viščiukų;8259056296;Taip;12;0;0;12
9891;Smalsučiai;Viščiukų;9637877396;Taip;0;4;6;10
9892;Smalsučiai;Viščiukų;2958335372;Taip;0;8;0;8
9893;Smalsučiai;Viščiukų;3582805599;Taip;0;1;0;1
9894;Smalsučiai;Viščiukų;3757955200;Taip;0;9;5;14
9895;Smalsučiai;Viščiukų;4288788194;Taip;0;3;0;3
9896;Smalsučiai;Boružėlių;1703679877;Taip;0;5;1;6
9897;Smalsučiai;Boružėlių;2208462326;Taip;0;22;0;22
9898;Smalsučiai;Boružėlių;1473016908;Taip;2;0;0;2
9899;Smalsučiai;Boružėlių;7226242747;Taip;0;2;1;3
9900;Smalsučiai;Boružėlių;6085020049;Taip;0;7;0;7
9901;Smalsučiai;Boružėlių;8340768848;Taip;0;5;0;5
9902;Smalsučiai;Boružėlių;69450514879;Taip;8;14;0;22
9903;Smalsučiai;Boružėlių;4740303929;Taip;0;7;0;7
9904;Smalsučiai;Boružėlių;2694575252;Taip;1;0;1;2
9905;Smalsučiai;Boružėlių;3063127699;Taip;0;2;0;2
9906;Smalsučiai;Boružėlių;2737886714;Taip;0;8;0;8
9907;Smalsučiai;Boružėlių;8523742213;Taip;22;0;0;22
9908;Smalsučiai;Boružėlių;5325706638;Taip;0;22;0;22
9909;Smalsučiai;Boružėlių;9314811354;Taip;0;5;0;5
9910;Smalsučiai;Boružėlių;9196634595;Taip;3;0;0;3
9911;Smalsučiai;Zuikių;63575906792;Taip;0;2;4;6
9912;Smalsučiai;Zuikių;66603023493;Taip;0;5;0;5
9913;Smalsučiai;Zuikių;26787916874;Taip;0;0;1;1
9914;Smalsučiai;Zuikių;1514166474;Taip;0;1;0;1
9915;Smalsučiai;Zuikių;4732277124;Taip;0;4;0;4
9916;Smalsučiai;Zuikių;2802867649;Taip;0;2;0;2
9917;Smalsučiai;Zuikių;18717627431;Taip;0;1;0;1
9918;Smalsučiai;Zuikių;66281706978;Taip;0;1;0;1
9919;Smalsučiai;Zuikių;37702522563;Taip;0;1;2;3
9920;Smalsučiai;Zuikių;1893910089;Taip;0;3;0;3
9921;Smalsučiai;Zuikių;55385713527;Taip;5;0;0;5
9922;Smalsučiai;Zuikių;30464130912;Taip;0;0;4;4
9923;Smalsučiai;Zuikių;4041918712;Taip;0;0;2;2
9924;Smalsučiai;Nykštukų;9181601713;Taip;12;1;0;13
9925;Smalsučiai;Nykštukų;7637630200;Taip;0;8;0;8
9926;Smalsučiai;Nykštukų;1247774684;Taip;0;0;1;1
9927;Smalsučiai;Nykštukų;2375360937;Taip;17;0;0;17
9928;Smalsučiai;Nykštukų;2015172985;Taip;6;2;0;8
9929;Smalsučiai;Nykštukų;8893480054;Taip;6;0;0;6
9930;Smalsučiai;Nykštukų;6996192450;Taip;3;0;3;6
9931;Smalsučiai;Nykštukų;9378696084;Taip;6;0;1;7
9932;Smalsučiai;Nykštukų;7267389695;Taip;8;14;0;22
9933;Smalsučiai;Nykštukų;6996901033;Taip;6;0;1;7
9934;Smalsučiai;Nykštukų;4847212069;Taip;0;0;1;1
9935;Smalsučiai;Nykštukų;1344461213;Taip;5;0;2;7
9936;Smalsučiai;Nykštukų;1224857159;Taip;0;7;0;7
9937;Smalsučiai;Nykštukų;8690626891;Taip;0;1;0;1
9938;Smalsučiai;Nykštukų;5719056997;Taip;7;0;0;7
9939;Smalsučiai;Nykštukų;6747286787;Taip;14;2;0;16
9940;Smalsučiai;Nykštukų;3646740184;Taip;3;0;0;3
9941;Smalsučiai;Katinėlių;4760366724;Taip;0;3;0;3
9942;Smalsučiai;Katinėlių;2045283348;Taip;16;0;0;16
9943;Smalsučiai;Katinėlių;9710944054;Taip;7;0;0;7
9944;Smalsučiai;Katinėlių;5213319192;Taip;5;0;0;5
9945;Smalsučiai;Katinėlių;3782502443;Taip;1;2;0;3
9946;Smalsučiai;Katinėlių;6358968221;Taip;0;9;0;9
9947;Smalsučiai;Katinėlių;9984878984;Taip;0;5;0;5
9948;Smalsučiai;Katinėlių;2369569130;Taip;7;1;0;8
9949;Smalsučiai;Katinėlių;2662588310;Taip;11;1;3;15
9950;Smalsučiai;Katinėlių;2668720481;Taip;5;7;0;12
9951;Smalsučiai;Katinėlių;4030955447;Ne;5;0;1;6
9952;Smalsučiai;Katinėlių;2926560092;Taip;4;0;0;4
9953;Smalsučiai;Katinėlių;8210141253;Taip;0;12;0;12
9954;Smalsučiai;PELĖDŽIUKAI;3809523690;Taip;5;1;0;6
9955;Smalsučiai;PELĖDŽIUKAI;1567576834;Taip;0;3;0;3
9956;Smalsučiai;PELĖDŽIUKAI;50085798686;Taip;4;6;1;11
9957;Smalsučiai;PELĖDŽIUKAI;1760728524;Ne;6;2;0;8
9958;Smalsučiai;PELĖDŽIUKAI;4042979105;Taip;3;1;0;4
9959;Smalsučiai;PELĖDŽIUKAI;1504060488;Taip;0;5;0;5
9960;Smalsučiai;PELĖDŽIUKAI;2112871055;Taip;0;4;0;4
9961;Smalsučiai;PELĖDŽIUKAI;52829213579;Taip;3;3;0;6
9962;Smalsučiai;PELĖDŽIUKAI;62387945180;Taip;0;7;0;7
9963;Smalsučiai;PELĖDŽIUKAI;1594035039;Taip;0;1;0;1
9964;Smalsučiai;PELĖDŽIUKAI;4655599359;Taip;0;1;2;3
9965;Smalsučiai;PELĖDŽIUKAI;1965194010;Taip;0;2;0;2
9966;Smalsučiai;Pingvinukai;6535494814;Taip;8;0;0;8
9967;Smalsučiai;Pingvinukai;3309134310;Taip;5;9;0;14
9968;Smalsučiai;Pingvinukai;5402027714;Taip;0;8;1;9
9969;Smalsučiai;Pingvinukai;4094037708;Taip;0;0;2;2
9970;Smalsučiai;Pingvinukai;5482692473;Taip;0;1;0;1
9971;Smalsučiai;Pingvinukai;7070240693;Taip;0;11;0;11
9972;Smalsučiai;Pingvinukai;7726086066;Taip;0;4;0;4
9973;Smalsučiai;Pingvinukai;1380214235;Taip;0;0;1;1
9974;Smalsučiai;Pingvinukai;8644849194;Taip;5;2;0;7
9975;Smalsučiai;Pingvinukai;3071594259;Taip;0;5;0;5
9976;Smalsučiai;Pingvinukai;7107126092;Taip;0;5;0;5
9977;Smalsučiai;Pingvinukai;3877274360;Taip;9;0;0;9
9978;Smalsučiai;Pingvinukai;5536697307;Taip;15;0;5;20
9979;Smalsučiai;Pingvinukai;9988599126;Taip;0;0;1;1
9980;Smalsučiai;Pingvinukai;4506058735;Taip;7;0;3;10
9981;Smalsučiai;Pingvinukai;6299355505;Taip;0;1;0;1
9982;Smalsučiai;Pingvinukai;5900294530;Taip;0;0;1;1
9983;Smalsučiai;Pingvinukai;2742992400;Taip;0;0;4;4
9984;Smalsučiai;Pingvinukai;5489140006;Taip;0;4;0;4
9985;Smalsučiai;Voverikų;3888093640;Taip;0;0;1;1
9986;Smalsučiai;Voverikų;8284740122;Taip;3;6;0;9
9987;Smalsučiai;Voverikų;1309254661;Taip;0;0;5;5
9988;Smalsučiai;Voverikų;8985656809;Taip;5;0;2;7
9989;Smalsučiai;Voverikų;6032887449;Taip;17;0;0;17
9990;Smalsučiai;Voverikų;9821259659;Taip;0;0;5;5
9991;Smalsučiai;Voverikų;4054278651;Ne;10;0;0;10
9992;Smalsučiai;Voverikų;6232068532;Taip;7;1;4;12
9993;Smalsučiai;Voverikų;3157534923;Taip;12;0;0;12
9994;Smalsučiai;Voverikų;6825499095;Taip;0;6;8;14
9995;Smalsučiai;Voverikų;4832292565;Taip;0;0;2;2
9996;Smalsučiai;Voverikų;2610753472;Taip;6;0;1;7
9997;Smalsučiai;Voverikų;6090244401;Taip;4;0;2;6
9998;Smalsučiai;Voverikų;2835117069;Taip;3;1;3;7
9999;Smalsučiai;Voverikų;4154327720;Taip;7;0;0;7
10000;Spragtukas;NYKŠTUKAI;8551195766;Taip;5;0;1;6
10001;Spragtukas;NYKŠTUKAI;8623311748;Taip;3;8;0;11
10002;Spragtukas;NYKŠTUKAI;9595221494;Taip;5;2;3;10
10003;Spragtukas;NYKŠTUKAI;6185016824;Taip;0;13;0;13
10004;Spragtukas;NYKŠTUKAI;8715073512;Taip;0;5;0;5
10005;Spragtukas;NYKŠTUKAI;1710184531;Taip;4;0;0;4
10006;Spragtukas;NYKŠTUKAI;2076126173;Ne;3;1;0;4
10007;Spragtukas;NYKŠTUKAI;3012345413;Taip;0;2;0;2
10008;Spragtukas;NYKŠTUKAI;8698492694;Taip;5;10;0;15
10009;Spragtukas;NYKŠTUKAI;1150002524;Taip;0;4;0;4
10010;Spragtukas;NYKŠTUKAI;8288793522;Taip;3;13;0;16
10011;Spragtukas;NYKŠTUKAI;6986034864;Taip;0;9;0;9
10012;Spragtukas;NYKŠTUKAI;9665371858;Ne;0;9;0;9
10013;Spragtukas;SAULUTĖ;3337355440;Taip;0;0;1;1
10014;Spragtukas;SAULUTĖ;4669257062;Taip;0;1;0;1
10015;Spragtukas;SAULUTĖ;3692960591;Taip;3;1;0;4
10016;Spragtukas;SAULUTĖ;4586034709;Taip;5;6;0;11
10017;Spragtukas;SAULUTĖ;2305568596;Taip;0;0;5;5
10018;Spragtukas;SAULUTĖ;1150727381;Taip;13;0;1;14
10019;Spragtukas;SAULUTĖ;3948232692;Taip;4;1;0;5
10020;Spragtukas;SAULUTĖ;9149954373;Taip;0;13;0;13
10021;Spragtukas;SAULUTĖ;7511680722;Taip;0;0;1;1
10022;Spragtukas;SAULUTĖ;8235791891;Taip;7;3;0;10
10023;Spragtukas;SAULUTĖ;2987638580;Taip;0;10;0;10
10024;Spragtukas;SAULUTĖ;3189741449;Taip;7;0;0;7
10025;Spragtukas;SAULUTĖ;5687853390;Taip;0;0;1;1
10026;Spragtukas;SAULUTĖ;6679886985;Taip;0;0;3;3
10027;Spragtukas;SAULUTĖ;4344537391;Taip;0;8;5;13
10028;Spragtukas;SAULUTĖ;2879077913;Ne;0;8;0;8
10029;Spragtukas;SAULUTĖ;1998148708;Taip;9;0;5;14
10030;Spragtukas;SAULUTĖ;8227086854;Taip;0;17;0;17
10031;Spragtukas;SAULUTĖ;5697451914;Taip;4;5;0;9
10032;Spragtukas;SAULUTĖ;3086399458;Taip;0;0;12;12
10033;Spragtukas;SAULUTĖ;2879614195;Taip;0;18;0;18
10034;Spragtukas;SPINDULĖLIAI;1983906683;Taip;0;1;0;1
10035;Spragtukas;SPINDULĖLIAI;4675031453;Taip;0;14;0;14
10036;Spragtukas;SPINDULĖLIAI;9781727236;Taip;5;0;1;6
10037;Spragtukas;SPINDULĖLIAI;1029392579;Taip;0;0;3;3
10038;Spragtukas;SPINDULĖLIAI;70413855110;Taip;0;9;0;9
10039;Spragtukas;SPINDULĖLIAI;65692358082;Taip;0;0;1;1
10040;Spragtukas;SPINDULĖLIAI;6052538605;Taip;3;0;7;10
10041;Spragtukas;SPINDULĖLIAI;2138152514;Taip;3;0;0;3
10042;Spragtukas;SPINDULĖLIAI;1305123801;Taip;0;1;0;1
10043;Spragtukas;SPINDULĖLIAI;4485715299;Taip;4;5;0;9
10044;Spragtukas;SPINDULĖLIAI;4224693184;Taip;0;0;5;5
10045;Spragtukas;SPINDULĖLIAI;2493749424;Taip;0;5;2;7
10046;Spragtukas;SPINDULĖLIAI;3411349574;Taip;2;0;0;2
10047;Spragtukas;SPINDULĖLIAI;1306663967;Taip;0;11;0;11
10048;Spragtukas;SPINDULĖLIAI;3798118695;Taip;9;2;0;11
10049;Spragtukas;SPINDULĖLIAI;2909322678;Taip;0;3;0;3
10050;Spragtukas;SPINDULĖLIAI;1323065222;Taip;0;0;4;4
10051;Spragtukas;SPINDULĖLIAI;1945068716;Taip;3;0;0;3
10052;Spragtukas;SPINDULĖLIAI;1827458781;Taip;4;0;0;4
10053;Spragtukas;SPINDULĖLIAI;4764295850;Taip;0;0;1;1
10054;Spragtukas;GINTARĖLIAI;8339926929;Taip;4;0;0;4
10055;Spragtukas;GINTARĖLIAI;5724874569;Taip;0;0;1;1
10056;Spragtukas;GINTARĖLIAI;1430632638;Taip;10;0;0;10
10057;Spragtukas;GINTARĖLIAI;8625143071;Taip;5;1;0;6
10058;Spragtukas;GINTARĖLIAI;2255007161;Taip;0;0;3;3
10059;Spragtukas;GINTARĖLIAI;5427116799;Taip;0;0;3;3
10060;Spragtukas;GINTARĖLIAI;9664130733;Taip;0;7;0;7
10061;Spragtukas;GINTARĖLIAI;2316071393;Taip;16;0;0;16
10062;Spragtukas;GINTARĖLIAI;8698469979;Taip;0;8;0;8
10063;Spragtukas;GINTARĖLIAI;1747417905;Taip;0;0;5;5
10064;Spragtukas;GINTARĖLIAI;6388163866;Taip;6;0;4;10
10065;Spragtukas;GINTARĖLIAI;8191270443;Taip;0;0;1;1
10066;Spragtukas;GINTARĖLIAI;3684183344;Taip;0;4;0;4
10067;Spragtukas;GINTARĖLIAI;9930330487;Taip;5;0;2;7
10068;Spragtukas;GINTARĖLIAI;7806145224;Taip;0;0;6;6
10069;Spragtukas;GINTARĖLIAI;3170388518;Taip;0;2;12;14
10070;Spragtukas;GINTARĖLIAI;2992201984;Taip;8;0;0;8
10071;Spragtukas;GINTARĖLIAI;7313963137;Taip;10;0;0;10
10072;Spragtukas;ČIPOLINO;2371848091;Taip;0;3;0;3
10073;Spragtukas;ČIPOLINO;6582680700;Taip;3;3;0;6
10074;Spragtukas;ČIPOLINO;1599958343;Taip;8;1;0;9
10075;Spragtukas;ČIPOLINO;1547670082;Taip;0;6;0;6
10076;Spragtukas;ČIPOLINO;7504632314;Taip;0;3;0;3
10077;Spragtukas;ČIPOLINO;1597988501;Taip;0;2;0;2
10078;Spragtukas;ČIPOLINO;6526633051;Taip;0;3;0;3
10079;Spragtukas;ČIPOLINO;1058970799;Taip;0;5;0;5
10080;Spragtukas;ČIPOLINO;45661532130;Taip;0;1;0;1
10081;Spragtukas;ČIPOLINO;3045382299;Taip;0;2;1;3
10082;Spragtukas;ČIPOLINO;7640805299;Taip;0;15;0;15
10083;Spragtukas;ČIPOLINO;1365907314;Taip;5;1;0;6
10084;Spragtukas;ČIPOLINO;4941531443;Taip;3;0;0;3
10085;Spragtukas;ČIPOLINO;2902550587;Taip;0;2;0;2
10086;Spragtukas;ČIPOLINO;69114720307;Taip;0;7;0;7
10087;Spragtukas;ČIPOLINO;9789977863;Taip;0;4;0;4
10088;Spragtukas;ČIPOLINO;1044112039;Taip;0;16;0;16
10089;Spragtukas;ČIPOLINO;5707084920;Taip;2;9;0;11
10090;Spragtukas;ČIPOLINO;1482803930;Taip;1;10;0;11
10091;Spragtukas;BORUŽĖLĖS;8614890958;Taip;0;8;0;8
10092;Spragtukas;BORUŽĖLĖS;6548270099;Taip;12;0;0;12
10093;Spragtukas;BORUŽĖLĖS;2356476212;Taip;0;0;5;5
10094;Spragtukas;BORUŽĖLĖS;8287102733;Taip;0;9;0;9
10095;Spragtukas;BORUŽĖLĖS;5844437769;Taip;3;0;0;3
10096;Spragtukas;BORUŽĖLĖS;6584145176;Taip;0;10;0;10
10097;Spragtukas;BORUŽĖLĖS;9860876807;Taip;0;10;0;10
10098;Spragtukas;BORUŽĖLĖS;9965087132;Taip;0;3;0;3
10099;Spragtukas;BORUŽĖLĖS;5150028968;Taip;0;2;0;2
10100;Spragtukas;BORUŽĖLĖS;9754594384;Taip;0;11;0;11
10101;Spragtukas;BORUŽĖLĖS;1756340613;Taip;0;3;0;3
10102;Spragtukas;BORUŽĖLĖS;6824861247;Taip;0;4;0;4
10103;Spragtukas;BORUŽĖLĖS;7264683147;Taip;20;0;0;20
10104;Spragtukas;BORUŽĖLĖS;5556920140;Taip;9;3;0;12
10105;Spragtukas;BORUŽĖLĖS;6547167325;Taip;3;0;0;3
10106;Spragtukas;BORUŽĖLĖS;4347275614;Taip;11;0;0;11
10107;Spragtukas;BORUŽĖLĖS;7073092344;Taip;18;0;0;18
10108;Spragtukas;BORUŽĖLĖS;7042345781;Taip;3;0;6;9
10109;Spragtukas;DRUGELIAI;1138975383;Taip;0;2;0;2
10110;Spragtukas;DRUGELIAI;91794949460;Taip;0;0;1;1
10111;Spragtukas;DRUGELIAI;2118272247;Taip;0;3;0;3
10112;Spragtukas;DRUGELIAI;46794033116;Taip;0;2;0;2
10113;Spragtukas;DRUGELIAI;1418494757;Taip;0;0;3;3
10114;Spragtukas;DRUGELIAI;60980580078;Taip;0;1;0;1
10115;Spragtukas;DRUGELIAI;82801263312;Taip;0;0;1;1
10116;Spragtukas;DRUGELIAI;2032107153;Taip;3;0;0;3
10117;Spragtukas;DRUGELIAI;19580966465;Taip;0;2;1;3
10118;Spragtukas;DRUGELIAI;67679737675;Taip;0;0;1;1
10119;Spragtukas;DRUGELIAI;1953368351;Taip;0;8;0;8
10120;Spragtukas;DRUGELIAI;271958429;Taip;5;0;0;5
10121;Spragtukas;DRUGELIAI;1030688447;Taip;0;5;2;7
10122;Spragtukas;DRUGELIAI;38120721944;Taip;0;0;2;2
10123;Spragtukas;DRUGELIAI;20279570129;Taip;0;2;0;2
10124;Spragtukas;DRUGELIAI;1336973131;Taip;0;2;1;3
10125;Spragtukas;GAIDELIAI;54099559107;Taip;0;0;6;6
10126;Spragtukas;GAIDELIAI;19453957982;Taip;0;0;1;1
10127;Spragtukas;GAIDELIAI;1203266608;Taip;10;0;1;11
10128;Spragtukas;GAIDELIAI;11849369985;Taip;0;0;2;2
10129;Spragtukas;GAIDELIAI;2042294168;Taip;0;12;0;12
10130;Spragtukas;GAIDELIAI;1030566027;Taip;0;13;0;13
10131;Spragtukas;GAIDELIAI;8150653485;Taip;0;0;2;2
10132;Spragtukas;GAIDELIAI;2061441977;Taip;0;5;0;5
10133;Spragtukas;GAIDELIAI;9644808747;Taip;0;2;12;14
10134;Spragtukas;GAIDELIAI;1210698072;Taip;4;0;3;7
10135;Spragtukas;GAIDELIAI;9235972927;Taip;0;0;4;4
10136;Spragtukas;GAIDELIAI;2277960395;Taip;0;0;8;8
10137;Spragtukas;GAIDELIAI;5692820402;Ne;0;9;0;9
10138;Spragtukas;ŽUVELĖS;9078163633;Taip;0;2;0;2
10139;Spragtukas;ŽUVELĖS;8652973900;Taip;0;2;0;2
10140;Spragtukas;ŽUVELĖS;3261213140;Taip;0;1;0;1
10141;Spragtukas;ŽUVELĖS;5689392663;Taip;0;0;5;5
10142;Spragtukas;ŽUVELĖS;9592271053;Taip;0;4;0;4
10143;Spragtukas;ŽUVELĖS;1272075883;Taip;3;0;0;3
10144;Spragtukas;ŽUVELĖS;6465991136;Taip;10;0;0;10
10145;Spragtukas;ŽUVELĖS;9282940430;Taip;10;0;0;10
10146;Spragtukas;ŽUVELĖS;6503842956;Taip;8;1;0;9
10147;Spragtukas;ŽUVELĖS;6757604305;Taip;10;0;0;10
10148;Spragtukas;ŽUVELĖS;3139748724;Taip;13;0;0;13
10149;Spragtukas;ŽUVELĖS;8640877497;Taip;3;2;3;8
10150;Spragtukas;ŽUVELĖS;4848647219;Ne;0;5;1;6
10151;Spragtukas;ŽUVELĖS;3491418162;Taip;0;11;0;11
10152;Spragtukas;ŽUVELĖS;5836788916;Taip;0;2;0;2
10153;Spragtukas;ŽUVELĖS;5704941595;Taip;0;16;0;16
10154;Spragtukas;ŽUVELĖS;3286456855;Taip;0;1;0;1
10155;Spragtukas;ŽUVELĖS;9662188102;Taip;3;2;0;5
10156;Spragtukas;ŽUVELĖS;2539660577;Taip;0;7;0;7
10157;Spragtukas;ŽUVELĖS;6836232179;Taip;0;3;0;3
10158;Spragtukas;RIEŠUTĖLIAI;4131998934;Taip;0;1;0;1
10159;Spragtukas;RIEŠUTĖLIAI;6419503965;Taip;0;2;0;2
10160;Spragtukas;RIEŠUTĖLIAI;8246512283;Taip;0;10;0;10
10161;Spragtukas;RIEŠUTĖLIAI;1627243902;Taip;0;4;0;4
10162;Spragtukas;RIEŠUTĖLIAI;1326603216;Taip;8;1;0;9
10163;Spragtukas;RIEŠUTĖLIAI;72636559695;Taip;3;1;0;4
10164;Spragtukas;RIEŠUTĖLIAI;6573750143;Taip;0;2;0;2
10165;Spragtukas;RIEŠUTĖLIAI;5306883933;Taip;3;1;0;4
10166;Spragtukas;RIEŠUTĖLIAI;3654640843;Taip;0;7;0;7
10167;Spragtukas;RIEŠUTĖLIAI;9045185920;Taip;4;1;0;5
10168;Spragtukas;RIEŠUTĖLIAI;1514277186;Taip;0;1;0;1
10169;Spragtukas;RIEŠUTĖLIAI;6322121173;Taip;0;0;1;1
10170;Spragtukas;RIEŠUTĖLIAI;4929866385;Taip;1;2;0;3
10171;Spragtukas;VIŠČIUKAI;7911124524;Taip;8;2;1;11
10172;Spragtukas;VIŠČIUKAI;8473814776;Taip;4;1;0;5
10173;Spragtukas;VIŠČIUKAI;3216796441;Taip;0;17;0;17
10174;Spragtukas;VIŠČIUKAI;4535021524;Taip;0;8;1;9
10175;Spragtukas;VIŠČIUKAI;4676052255;Taip;13;3;0;16
10176;Spragtukas;VIŠČIUKAI;7108640957;Taip;5;0;0;5
10177;Spragtukas;VIŠČIUKAI;5981384992;Taip;0;22;0;22
10178;Spragtukas;VIŠČIUKAI;2541126095;Taip;9;0;1;10
10179;Spragtukas;VIŠČIUKAI;4097458544;Taip;0;0;2;2
10180;Spragtukas;VIŠČIUKAI;8440836721;Taip;12;4;0;16
10181;Spragtukas;VIŠČIUKAI;1326714513;Taip;2;7;0;9
10182;Spragtukas;VIŠČIUKAI;8957903306;Taip;6;8;0;14
10183;Spragtukas;VIŠČIUKAI;2679834328;Taip;6;0;0;6
10184;Spragtukas;VIŠČIUKAI;6370760287;Taip;7;0;0;7
10185;Spragtukas;VIŠČIUKAI;9509296936;Taip;10;0;0;10
10186;Spragtukas;VIŠČIUKAI;1046613540;Taip;10;2;1;13
10187;Spragtukas;VIŠČIUKAI;3187815703;Taip;16;0;1;17
10188;Spragtukas;MEŠKIUKAI;8684246143;Taip;9;0;0;9
10189;Spragtukas;MEŠKIUKAI;7615522850;Taip;0;15;0;15
10190;Spragtukas;MEŠKIUKAI;6797841737;Taip;5;0;0;5
10191;Spragtukas;MEŠKIUKAI;8342098575;Taip;7;0;0;7
10192;Spragtukas;MEŠKIUKAI;6158327941;Taip;0;1;0;1
10193;Spragtukas;MEŠKIUKAI;1946493379;Taip;22;0;0;22
10194;Spragtukas;MEŠKIUKAI;3009567338;Taip;8;1;0;9
10195;Spragtukas;MEŠKIUKAI;2648358901;Taip;20;0;0;20
10196;Spragtukas;MEŠKIUKAI;7767940027;Taip;0;7;0;7
10197;Spragtukas;MEŠKIUKAI;4625065223;Taip;0;0;4;4
10198;Spragtukas;MEŠKIUKAI;6963190259;Taip;0;4;2;6
10199;Spragtukas;MEŠKIUKAI;8732886749;Taip;5;0;0;5
10200;Spragtukas;MEŠKIUKAI;4134127256;Taip;3;0;0;3
10201;Spragtukas;MEŠKIUKAI;1992850470;Taip;4;0;0;4
10202;Spragtukas;MEŠKIUKAI;5440632023;Taip;14;0;0;14
10203;Spragtukas;MEŠKIUKAI;3822599790;Taip;4;1;0;5
10204;Strazdelis;Žiogelių;9933042249;Taip;0;10;0;10
10205;Strazdelis;Žiogelių;8581533423;Taip;14;2;0;16
10206;Strazdelis;Žiogelių;8209625399;Taip;18;0;0;18
10207;Strazdelis;Žiogelių;1141752802;Taip;10;0;6;16
10208;Strazdelis;Žiogelių;7425818775;Taip;0;2;0;2
10209;Strazdelis;Žiogelių;9567476872;Taip;10;0;0;10
10210;Strazdelis;Žiogelių;1228651165;Taip;0;8;0;8
10211;Strazdelis;Žiogelių;7768700192;Taip;0;1;0;1
10212;Strazdelis;Žiogelių;6651360492;Taip;0;11;0;11
10213;Strazdelis;Žiogelių;1194918926;Taip;0;5;0;5
10214;Strazdelis;Žiogelių;3596394112;Taip;5;1;5;11
10215;Strazdelis;Žiogelių;4516288199;Taip;0;4;0;4
10216;Strazdelis;Žiogelių;8493572399;Taip;5;0;1;6
10217;Strazdelis;Žiogelių;4563247013;Taip;22;0;0;22
10218;Strazdelis;Žiogelių;6437928004;Taip;0;2;0;2
10219;Strazdelis;Žiogelių;5600979545;Taip;6;13;0;19
10220;Strazdelis;Žiogelių;8971395173;Taip;9;0;0;9
10221;Strazdelis;Žiogelių;4955907851;Taip;3;5;0;8
10222;Strazdelis;Šeimynėlės;3662217925;Ne;0;5;0;5
10223;Strazdelis;Šeimynėlės;8274897977;Taip;7;2;0;9
10224;Strazdelis;Šeimynėlės;43314069648;Taip;0;1;0;1
10225;Strazdelis;Šeimynėlės;4697537943;Taip;0;4;0;4
10226;Strazdelis;Šeimynėlės;3943578036;Taip;5;1;0;6
10227;Strazdelis;Šeimynėlės;2802486859;Taip;0;2;0;2
10228;Strazdelis;Šeimynėlės;7215063033;Taip;0;5;0;5
10229;Strazdelis;Šeimynėlės;1665134387;Taip;6;2;0;8
10230;Strazdelis;Šeimynėlės;1481671624;Taip;0;4;0;4
10231;Strazdelis;Šeimynėlės;6014213362;Taip;0;1;0;1
10232;Strazdelis;Šeimynėlės;45083023033;Taip;8;0;0;8
10233;Strazdelis;Šeimynėlės;4454199703;Taip;4;10;0;14
10234;Strazdelis;Šeimynėlės;4698566091;Taip;0;10;0;10
10235;Strazdelis;Šeimynėlės;9835716116;Taip;0;4;0;4
10236;Strazdelis;Šeimynėlės;7149827850;Taip;10;1;0;11
10237;Strazdelis;Šeimynėlės;8938997208;Ne;0;1;0;1
10238;Strazdelis;Šeimynėlės;7900362267;Taip;0;2;0;2
10239;Strazdelis;Šeimynėlės;5749300013;Taip;0;3;0;3
10240;Strazdelis;Šeimynėlės;4929828091;Taip;4;0;0;4
10241;Strazdelis;Šeimynėlės;3482802557;Taip;0;1;0;1
10242;Strazdelis;Genelio;8038163444;Taip;0;5;0;5
10243;Strazdelis;Genelio;8754275576;Taip;0;6;0;6
10244;Strazdelis;Genelio;7216768880;Taip;0;8;0;8
10245;Strazdelis;Genelio;7120717682;Taip;0;1;0;1
10246;Strazdelis;Genelio;50350281905;Taip;7;0;0;7
10247;Strazdelis;Genelio;1187534672;Taip;0;8;0;8
10248;Strazdelis;Genelio;2871673641;Taip;0;6;0;6
10249;Strazdelis;Genelio;6147183190;Taip;13;1;0;14
10250;Strazdelis;Genelio;2078150337;Taip;0;1;0;1
10251;Strazdelis;Genelio;9904719582;Taip;0;6;0;6
10252;Strazdelis;Genelio;7308925265;Taip;14;2;0;16
10253;Strazdelis;Genelio;4655931716;Taip;0;6;0;6
10254;Strazdelis;Genelio;8182994112;Taip;0;7;0;7
10255;Strazdelis;Genelio;4990421186;Ne;0;14;0;14
10256;Strazdelis;Genelio;1847733888;Taip;0;1;2;3
10257;Strazdelis;Genelio;8686828982;Taip;0;8;0;8
10258;Strazdelis;Genelio;8277333786;Taip;8;0;0;8
10259;Strazdelis;Genelio;7913526787;Taip;0;5;0;5
10260;Strazdelis;Genelio;7823110477;Taip;0;10;0;10
10261;Strazdelis;Vikruolių;3729497908;Taip;0;3;0;3
10262;Strazdelis;Vikruolių;1140100663;Taip;0;1;0;1
10263;Strazdelis;Vikruolių;24669852216;Taip;3;3;0;6
10264;Strazdelis;Vikruolių;51702469375;Taip;3;2;0;5
10265;Strazdelis;Vikruolių;59837435595;Taip;0;4;0;4
10266;Strazdelis;Vikruolių;34644143572;Taip;0;8;0;8
10267;Strazdelis;Vikruolių;90089166514;Taip;3;8;0;11
10268;Strazdelis;Vikruolių;1785962711;Taip;3;4;0;7
10269;Strazdelis;Vikruolių;2090154632;Taip;3;0;0;3
10270;Strazdelis;Vikruolių;61820727992;Taip;0;3;0;3
10271;Strazdelis;Vikruolių;1735868807;Taip;2;1;0;3
10272;Strazdelis;Vikruolių;68605763183;Taip;0;7;0;7
10273;Strazdelis;Vikruolių;7812253305;Taip;4;1;0;5
10274;Strazdelis;Vikruolių;1257686463;Taip;3;2;1;6
10275;Strazdelis;Vikruolių;18461074207;Taip;11;1;0;12
10276;Strazdelis;Vikruolių;8801420992;Taip;0;7;0;7
10277;Strazdelis;Vyturėlių;12739940649;Ne;5;1;0;6
10278;Strazdelis;Vyturėlių;1858519255;Taip;0;2;0;2
10279;Strazdelis;Vyturėlių;53114476996;Taip;1;0;2;3
10280;Strazdelis;Vyturėlių;20510560289;Taip;7;1;0;8
10281;Strazdelis;Vyturėlių;84548133061;Taip;0;8;0;8
10282;Strazdelis;Vyturėlių;48052363003;Taip;0;2;0;2
10283;Strazdelis;Vyturėlių;20845810823;Taip;0;2;0;2
10284;Strazdelis;Vyturėlių;64076729200;Taip;0;6;0;6
10285;Strazdelis;Vyturėlių;57514782479;Taip;0;2;0;2
10286;Strazdelis;Vyturėlių;50984917126;Taip;4;0;0;4
10287;Strazdelis;Vyturėlių;79443961061;Taip;0;5;0;5
10288;Strazdelis;Vyturėlių;59969322783;Taip;0;1;0;1
10289;Strazdelis;Vyturėlių;2086723106;Taip;5;1;0;6
10290;Strazdelis;Vyturėlių;90936509570;Taip;4;0;0;4
10291;Strazdelis;Vyturėlių;43128715501;Ne;3;9;0;12
10292;Strazdelis;Vyturėlių;2110092578;Taip;0;6;0;6
10293;Strazdelis;Vyturėlių;14459771394;Taip;0;4;0;4
10294;Strazdelis;Vyturėlių;96077591556;Taip;0;4;0;4
10295;Strazdelis;Varpelio;4159072583;Taip;0;10;0;10
10296;Strazdelis;Varpelio;9621022918;Ne;0;15;0;15
10297;Strazdelis;Varpelio;8415383526;Taip;0;2;0;2
10298;Strazdelis;Varpelio;2580733127;Taip;0;1;0;1
10299;Strazdelis;Varpelio;2662549392;Taip;0;1;0;1
10300;Strazdelis;Varpelio;9502341478;Taip;0;5;0;5
10301;Strazdelis;Varpelio;1955166372;Taip;4;1;0;5
10302;Strazdelis;Varpelio;4873707286;Taip;0;4;0;4
10303;Strazdelis;Varpelio;6527855940;Taip;0;7;0;7
10304;Strazdelis;Varpelio;4076266466;Taip;6;12;0;18
10305;Strazdelis;Varpelio;2824416350;Taip;0;1;0;1
10306;Strazdelis;Varpelio;3610250359;Taip;0;6;0;6
10307;Strazdelis;Varpelio;2766970956;Taip;0;3;0;3
10308;Strazdelis;Varpelio;1173067724;Taip;0;3;0;3
10309;Strazdelis;Varpelio;7393083827;Taip;0;1;0;1
10310;Strazdelis;Varpelio;6555803164;Taip;0;1;0;1
10311;Strazdelis;Varpelio;1021364759;Taip;12;0;0;12
10312;Strazdelis;Varpelio;1706026100;Taip;0;2;1;3
10313;Strazdelis;Varpelio;1841285441;Taip;0;10;0;10
10314;Strazdelis;Varpelio;2789987994;Taip;0;2;0;2
10315;Strazdelis;Varpelio;7469848482;Taip;0;10;0;10
10316;Strazdelis;Varpelio;8035603341;Taip;0;1;0;1
10317;Strazdelis;Pelėdžiukų;5892430004;Taip;0;22;0;22
10318;Strazdelis;Pelėdžiukų;1901641517;Taip;0;1;0;1
10319;Strazdelis;Pelėdžiukų;8637386316;Taip;0;4;0;4
10320;Strazdelis;Pelėdžiukų;1704292727;Taip;0;1;0;1
10321;Strazdelis;Pelėdžiukų;4617237063;Taip;0;2;0;2
10322;Strazdelis;Pelėdžiukų;3036380561;Taip;0;2;0;2
10323;Strazdelis;Pelėdžiukų;8371999002;Taip;0;4;0;4
10324;Strazdelis;Pelėdžiukų;8287554571;Taip;0;9;0;9
10325;Strazdelis;Pelėdžiukų;5580738386;Taip;0;3;0;3
10326;Strazdelis;Pelėdžiukų;4448556404;Taip;4;1;0;5
10327;Strazdelis;Pelėdžiukų;8854150040;Taip;0;1;0;1
10328;Strazdelis;Pelėdžiukų;2238875354;Taip;0;2;0;2
10329;Strazdelis;Pelėdžiukų;4004930488;Taip;0;2;0;2
10330;Strazdelis;Pelėdžiukų;5768674837;Taip;10;0;0;10
10331;Strazdelis;Pelėdžiukų;7349106795;Taip;0;4;0;4
10332;Strazdelis;Pelėdžiukų;9761595867;Taip;3;8;0;11
10333;Strazdelis;Pelėdžiukų;2848984531;Taip;0;1;0;1
10334;Strazdelis;Pelėdžiukų;7471890377;Taip;0;1;0;1
10335;Strazdelis;Pelėdžiukų;1420438624;Taip;0;1;0;1
10336;Strazdelis;Saulutės;1474503932;Taip;0;2;1;3
10337;Strazdelis;Saulutės;27177757900;Taip;0;2;0;2
10338;Strazdelis;Saulutės;40932140069;Taip;0;6;0;6
10339;Strazdelis;Saulutės;1523471662;Taip;0;11;0;11
10340;Strazdelis;Saulutės;2854642875;Taip;0;0;7;7
10341;Strazdelis;Saulutės;6614184499;Taip;0;2;0;2
10342;Strazdelis;Saulutės;3425430317;Taip;0;2;0;2
10343;Strazdelis;Saulutės;7081517417;Taip;0;1;0;1
10344;Strazdelis;Saulutės;67641340859;Taip;0;4;0;4
10345;Strazdelis;Saulutės;15298412755;Taip;13;1;0;14
10346;Strazdelis;Saulutės;1802092125;Taip;3;0;0;3
10347;Strazdelis;Saulutės;1391009140;Taip;1;12;0;13
10348;Strazdelis;Saulutės;6113491562;Taip;0;7;0;7
10349;Strazdelis;Saulutės;8808299050;Taip;0;2;0;2
10350;Strazdelis;Saulutės;3753612757;Taip;0;3;0;3
10351;Strazdelis;Saulutės;3270413614;Taip;5;4;0;9
10352;Strazdelis;Saulutės;3316451889;Taip;0;2;0;2
10353;Strazdelis;Bitutės;8485509145;Taip;0;10;0;10
10354;Strazdelis;Bitutės;6508933324;Taip;0;1;0;1
10355;Strazdelis;Bitutės;2589303722;Taip;0;1;0;1
10356;Strazdelis;Bitutės;4020547762;Taip;0;9;0;9
10357;Strazdelis;Bitutės;8753316532;Taip;0;1;0;1
10358;Strazdelis;Bitutės;3149930355;Taip;0;0;1;1
10359;Strazdelis;Bitutės;5232064496;Taip;0;1;0;1
10360;Strazdelis;Bitutės;9435593972;Taip;0;3;0;3
10361;Strazdelis;Bitutės;9555240419;Taip;4;0;0;4
10362;Strazdelis;Bitutės;2081538505;Taip;0;12;0;12
10363;Strazdelis;Bitutės;3043580835;Taip;0;8;0;8
10364;Strazdelis;Bitutės;1539984888;Taip;0;3;0;3
10365;Strazdelis;Bitutės;4784401449;Taip;0;1;0;1
10366;Strazdelis;Bitutės;7890064837;Taip;0;6;0;6
10367;Strazdelis;Bitutės;1881071425;Taip;8;4;0;12
10368;Strazdelis;Bitutės;2908567982;Taip;13;0;0;13
10369;Strazdelis;Bitutės;9548465554;Taip;22;0;0;22
10370;Strazdelis;Bitutės;7466648222;Taip;0;6;0;6
10371;Strazdelis;Bitutės;4463378251;Taip;0;5;0;5
10372;Strazdelis;Bitutės;4369569609;Taip;0;11;0;11
10373;Strazdelis;Bitutės;8443837176;Taip;3;7;0;10
10374;Strazdelis;Mažylių;6271193831;Taip;0;9;0;9
10375;Strazdelis;Mažylių;9586256979;Taip;0;1;0;1
10376;Strazdelis;Mažylių;3084249678;Taip;0;9;0;9
10377;Strazdelis;Mažylių;8333151969;Taip;0;12;0;12
10378;Strazdelis;Mažylių;7083940713;Taip;0;6;0;6
10379;Strazdelis;Mažylių;6480803618;Taip;10;2;8;20
10380;Strazdelis;Mažylių;6071502600;Taip;0;8;0;8
10381;Strazdelis;Mažylių;3713797440;Taip;0;8;0;8
10382;Strazdelis;Mažylių;2483283363;Taip;3;0;0;3
10383;Strazdelis;Mažylių;5714581201;Taip;0;2;1;3
10384;Strazdelis;Mažylių;8956634754;Taip;4;4;0;8
10385;Strazdelis;Mažylių;2306665561;Taip;0;2;0;2
10386;Strazdelis;Mažylių;7680242840;Taip;0;2;0;2
10387;Strazdelis;Mažylių;4545538133;Taip;0;1;0;1
10388;Strazdelis;Mažylių;8762859576;Taip;0;5;1;6
10389;Strazdelis;Mažylių;9490861272;Taip;4;4;0;8
10390;Strazdelis;Pabiručių;9806107189;Taip;5;2;0;7
10391;Strazdelis;Pabiručių;6570504154;Taip;0;6;0;6
10392;Strazdelis;Pabiručių;3848288765;Taip;3;3;0;6
10393;Strazdelis;Pabiručių;5033799225;Taip;3;3;0;6
10394;Strazdelis;Pabiručių;2990771887;Taip;0;7;0;7
10395;Strazdelis;Pabiručių;2185364583;Taip;0;10;0;10
10396;Strazdelis;Pabiručių;4501391298;Taip;3;8;0;11
10397;Strazdelis;Pabiručių;9057914477;Taip;5;2;0;7
10398;Strazdelis;Pabiručių;1277844969;Taip;0;4;0;4
10399;Strazdelis;Pabiručių;1012692326;Taip;17;0;0;17
10400;Strazdelis;Pabiručių;8899530711;Taip;17;0;0;17
10401;Strazdelis;Pabiručių;8336759173;Taip;6;2;0;8
10402;Strazdelis;Pabiručių;1017838338;Taip;14;8;0;22
10403;Strazdelis;Pabiručių;2068793184;Taip;4;1;0;5
10404;Strazdelis;Pabiručių;1754106518;Taip;0;2;0;2
10405;Strazdelis;Pabiručių;3897248010;Taip;0;2;0;2
10406;Strazdelis;Pabiručių;5296218650;Taip;6;0;0;6
10407;Strazdelis;Pabiručių;7905687363;Taip;0;4;0;4
10408;Šermukšnėlė;MOLINUKAI;68060386099;Taip;0;0;1;1
10409;Šermukšnėlė;MOLINUKAI;60863269031;Taip;0;3;0;3
10410;Šermukšnėlė;MOLINUKAI;54312555311;Taip;0;0;1;1
10411;Šermukšnėlė;MOLINUKAI;3873114056;Taip;0;0;5;5
10412;Šermukšnėlė;MOLINUKAI;1561527473;Taip;0;0;6;6
10413;Šermukšnėlė;MOLINUKAI;841268127;Taip;0;0;1;1
10414;Šermukšnėlė;MOLINUKAI;7830792252;Taip;0;0;4;4
10415;Šermukšnėlė;MOLINUKAI;1756161106;Taip;0;0;2;2
10416;Šermukšnėlė;MOLINUKAI;2561033248;Taip;0;2;0;2
10417;Šermukšnėlė;MOLINUKAI;6548853578;Taip;0;22;0;22
10418;Šermukšnėlė;MOLINUKAI;26715691626;Taip;3;0;5;8
10419;Šermukšnėlė;MOLINUKAI;1573326752;Taip;4;0;6;10
10420;Šermukšnėlė;MOLINUKAI;2555177886;Taip;0;0;4;4
10421;Šermukšnėlė;MOLINUKAI;3713203910;Taip;9;0;1;10
10422;Šermukšnėlė;ŠIAUDINUKAI;7249568196;Taip;0;2;0;2
10423;Šermukšnėlė;ŠIAUDINUKAI;7002917737;Taip;11;0;0;11
10424;Šermukšnėlė;ŠIAUDINUKAI;7785671936;Taip;3;0;0;3
10425;Šermukšnėlė;ŠIAUDINUKAI;3637882900;Taip;0;2;0;2
10426;Šermukšnėlė;ŠIAUDINUKAI;1159472154;Taip;0;1;0;1
10427;Šermukšnėlė;ŠIAUDINUKAI;4956414941;Taip;5;0;0;5
10428;Šermukšnėlė;ŠIAUDINUKAI;3499394539;Taip;14;3;0;17
10429;Šermukšnėlė;ŠIAUDINUKAI;1157979179;Taip;0;4;0;4
10430;Šermukšnėlė;ŠIAUDINUKAI;3701053997;Taip;14;0;0;14
10431;Šermukšnėlė;ŠIAUDINUKAI;8048598135;Taip;2;5;0;7
10432;Šermukšnėlė;ŠIAUDINUKAI;7917101921;Taip;7;0;0;7
10433;Šermukšnėlė;ŠIAUDINUKAI;3082272196;Taip;0;0;1;1
10434;Šermukšnėlė;ŠIAUDINUKAI;9012757607;Taip;3;0;0;3
10435;Šermukšnėlė;ŠIAUDINUKAI;3550736579;Taip;14;0;0;14
10436;Šermukšnėlė;ŠIAUDINUKAI;5993599994;Taip;3;2;1;6
10437;Šermukšnėlė;ŠIAUDINUKAI;3522028983;Taip;0;0;4;4
10438;Šermukšnėlė;ŠIAUDINUKAI;2351386211;Taip;16;0;0;16
10439;Šermukšnėlė;TOŠINUKAI;2160616078;Taip;8;0;4;12
10440;Šermukšnėlė;TOŠINUKAI;1661977128;Taip;5;0;5;10
10441;Šermukšnėlė;TOŠINUKAI;3994316729;Taip;0;1;1;2
10442;Šermukšnėlė;TOŠINUKAI;1459253197;Taip;0;3;1;4
10443;Šermukšnėlė;TOŠINUKAI;78341448188;Taip;8;0;0;8
10444;Šermukšnėlė;TOŠINUKAI;8279692394;Taip;0;0;2;2
10445;Šermukšnėlė;TOŠINUKAI;5096946133;Taip;0;0;2;2
10446;Šermukšnėlė;TOŠINUKAI;2380988728;Ne;4;0;2;6
10447;Šermukšnėlė;TOŠINUKAI;8956573129;Taip;10;0;0;10
10448;Šermukšnėlė;TOŠINUKAI;4981204674;Taip;0;6;0;6
10449;Šermukšnėlė;TOŠINUKAI;7229632099;Taip;8;0;1;9
10450;Šermukšnėlė;TOŠINUKAI;2529526401;Taip;0;0;4;4
10451;Šermukšnėlė;TOŠINUKAI;7038705221;Taip;0;3;0;3
10452;Šermukšnėlė;TOŠINUKAI;6413821285;Taip;0;10;0;10
10453;Šermukšnėlė;TOŠINUKAI;9035625467;Taip;0;0;5;5
10454;Šermukšnėlė;TOŠINUKAI;3081548524;Taip;2;0;0;2
10455;Šermukšnėlė;TOŠINUKAI;5832072195;Taip;0;16;0;16
10456;Šermukšnėlė;TOŠINUKAI;3222466449;Ne;0;0;3;3
10457;Šermukšnėlė;TOŠINUKAI;1753169856;Taip;0;0;1;1
10458;Šermukšnėlė;TOŠINUKAI;6430627501;Taip;4;0;2;6
10459;Šermukšnėlė;TOŠINUKAI;9442514813;Taip;0;0;1;1
10460;Šermukšnėlė;ODINUKAI;4422415026;Taip;0;0;9;9
10461;Šermukšnėlė;ODINUKAI;5545018656;Taip;0;0;2;2
10462;Šermukšnėlė;ODINUKAI;2176788727;Taip;0;1;3;4
10463;Šermukšnėlė;ODINUKAI;5733540837;Taip;0;0;1;1
10464;Šermukšnėlė;ODINUKAI;5159461963;Taip;0;3;0;3
10465;Šermukšnėlė;ODINUKAI;5354978646;Taip;0;3;1;4
10466;Šermukšnėlė;ODINUKAI;1882432812;Taip;0;3;1;4
10467;Šermukšnėlė;ODINUKAI;5151843494;Taip;0;0;1;1
10468;Šermukšnėlė;ODINUKAI;3949629658;Taip;1;7;1;9
10469;Šermukšnėlė;ODINUKAI;4201283154;Taip;0;0;2;2
10470;Šermukšnėlė;ODINUKAI;9742208172;Taip;5;2;0;7
10471;Šermukšnėlė;ODINUKAI;7667114310;Taip;0;0;3;3
10472;Šermukšnėlė;ODINUKAI;7245206247;Taip;0;0;4;4
10473;Šermukšnėlė;ODINUKAI;5397385093;Taip;0;0;2;2
10474;Šermukšnėlė;ODINUKAI;6718242890;Taip;11;0;1;12
10475;Šermukšnėlė;ODINUKAI;9664249364;Taip;1;1;0;2
10476;Šermukšnėlė;ODINUKAI;1064222922;Taip;2;0;4;6
10477;Šermukšnėlė;ODINUKAI;7770630580;Taip;0;0;1;1
10478;Šermukšnėlė;ODINUKAI;6194188831;Taip;0;0;4;4
10479;Šermukšnėlė;KRIAUKLELĖS;3639954786;Taip;0;0;13;13
10480;Šermukšnėlė;KRIAUKLELĖS;5678559268;Taip;0;0;3;3
10481;Šermukšnėlė;KRIAUKLELĖS;7843128263;Taip;4;1;0;5
10482;Šermukšnėlė;KRIAUKLELĖS;6067298318;Taip;0;3;0;3
10483;Šermukšnėlė;KRIAUKLELĖS;5660238634;Taip;5;0;0;5
10484;Šermukšnėlė;KRIAUKLELĖS;8479230675;Taip;0;7;0;7
10485;Šermukšnėlė;KRIAUKLELĖS;3613456202;Taip;0;0;5;5
10486;Šermukšnėlė;KRIAUKLELĖS;8541743148;Taip;2;0;0;2
10487;Šermukšnėlė;KRIAUKLELĖS;8709426669;Taip;0;6;0;6
10488;Šermukšnėlė;KRIAUKLELĖS;6585484701;Taip;7;0;4;11
10489;Šermukšnėlė;KRIAUKLELĖS;6599779539;Taip;0;8;0;8
10490;Šermukšnėlė;KRIAUKLELĖS;9876533442;Taip;0;0;3;3
10491;Šermukšnėlė;KRIAUKLELĖS;3653792683;Taip;0;0;1;1
10492;Šermukšnėlė;KRIAUKLELĖS;9805841777;Taip;0;5;0;5
10493;Šermukšnėlė;KRIAUKLELĖS;6162830167;Taip;11;0;0;11
10494;Šermukšnėlė;KRIAUKLELĖS;7266947985;Taip;5;0;0;5
10495;Šermukšnėlė;VYTINUKAI;97906920174;Taip;0;0;2;2
10496;Šermukšnėlė;VYTINUKAI;1523361932;Taip;0;0;5;5
10497;Šermukšnėlė;VYTINUKAI;25189813939;Taip;7;0;0;7
10498;Šermukšnėlė;VYTINUKAI;83123267733;Taip;0;5;0;5
10499;Šermukšnėlė;VYTINUKAI;20028832329;Taip;0;1;0;1
10500;Šermukšnėlė;VYTINUKAI;3959795064;Taip;9;1;0;10
10501;Šermukšnėlė;VYTINUKAI;8498288021;Taip;0;3;0;3
10502;Šermukšnėlė;VYTINUKAI;5905000902;Ne;0;0;6;6
10503;Šermukšnėlė;VYTINUKAI;83882579952;Taip;0;4;0;4
10504;Šermukšnėlė;VYTINUKAI;60840526220;Taip;0;3;0;3
10505;Šermukšnėlė;VYTINUKAI;1025787925;Taip;0;1;0;1
10506;Šermukšnėlė;VYTINUKAI;1519623099;Taip;0;1;1;2
10507;Šermukšnėlė;VYTINUKAI;5757405893;Taip;0;0;1;1
10508;Šermukšnėlė;VYTINUKAI;7106405983;Taip;0;0;1;1
10509;Šermukšnėlė;VYTINUKAI;1670047548;Taip;8;0;0;8
10510;Šermukšnėlė;VYTINUKAI;1685592290;Taip;4;0;0;4
10511;Šermukšnėlė;GINTARĖLIAI;85062380771;Taip;0;3;2;5
10512;Šermukšnėlė;GINTARĖLIAI;35389950541;Taip;0;0;3;3
10513;Šermukšnėlė;GINTARĖLIAI;1944687724;Taip;0;5;0;5
10514;Šermukšnėlė;GINTARĖLIAI;1013698297;Taip;8;3;0;11
10515;Šermukšnėlė;GINTARĖLIAI;2094932013;Taip;3;0;0;3
10516;Šermukšnėlė;GINTARĖLIAI;1851549466;Taip;0;4;0;4
10517;Šermukšnėlė;GINTARĖLIAI;3697936074;Taip;1;0;1;2
10518;Šermukšnėlė;GINTARĖLIAI;27183547828;Taip;0;0;1;1
10519;Šermukšnėlė;GINTARĖLIAI;10728235594;Taip;0;1;0;1
10520;Šermukšnėlė;GINTARĖLIAI;42477406335;Taip;0;0;1;1
10521;Šermukšnėlė;GINTARĖLIAI;61300763004;Taip;0;8;0;8
10522;Šermukšnėlė;GINTARĖLIAI;1425285365;Taip;0;0;8;8
10523;Šermukšnėlė;GINTARĖLIAI;6279210465;Taip;0;0;4;4
10524;Šermukšnėlė;GINTARĖLIAI;4601810772;Taip;0;0;1;1
10525;Šermukšnėlė;GINTARĖLIAI;1562494176;Taip;0;0;3;3
10526;Šermukšnėlė;AKMENUKAI;9658469152;Taip;7;0;0;7
10527;Šermukšnėlė;AKMENUKAI;98850511500;Taip;4;1;0;5
10528;Šermukšnėlė;AKMENUKAI;26775257484;Taip;0;8;0;8
10529;Šermukšnėlė;AKMENUKAI;82028252228;Taip;0;0;5;5
10530;Šermukšnėlė;AKMENUKAI;23434568160;Taip;2;3;0;5
10531;Šermukšnėlė;AKMENUKAI;3543061360;Taip;9;3;0;12
10532;Šermukšnėlė;AKMENUKAI;6255671190;Taip;0;10;0;10
10533;Šermukšnėlė;AKMENUKAI;7564745299;Taip;0;6;0;6
10534;Šermukšnėlė;AKMENUKAI;9617044855;Taip;0;5;0;5
10535;Šermukšnėlė;AKMENUKAI;1856012121;Taip;0;0;3;3
10536;Šermukšnėlė;AKMENUKAI;8407947566;Taip;7;0;0;7
10537;Šermukšnėlė;AKMENUKAI;8123096990;Taip;1;0;1;2
10538;Šermukšnėlė;AKMENUKAI;8859731179;Taip;3;0;0;3
10539;Šermukšnėlė;AKMENUKAI;1902848560;Taip;0;6;0;6
10540;Šermukšnėlė;AKMENUKAI;7548637091;Ne;14;4;0;18
10541;Šermukšnėlė;AKMENUKAI;3513568460;Taip;0;0;2;2
10542;Šermukšnėlė;AKMENUKAI;6896990721;Taip;0;0;1;1
10543;Šermukšnėlė;AKMENUKAI;4230698872;Taip;0;2;0;2
10544;Šermukšnėlė;AKMENUKAI;8511421692;Taip;0;0;3;3
10545;Šermukšnėlė;AKMENUKAI;8669676262;Taip;0;9;0;9
10546;Šermukšnėlė;AKMENUKAI;3148857617;Taip;0;14;0;14
10547;Šermukšnėlė;SIŪLINUKAI;32417473492;Taip;2;1;0;3
10548;Šermukšnėlė;SIŪLINUKAI;35508499818;Taip;2;1;0;3
10549;Šermukšnėlė;SIŪLINUKAI;30853722796;Taip;0;1;0;1
10550;Šermukšnėlė;SIŪLINUKAI;62420710883;Taip;5;0;0;5
10551;Šermukšnėlė;SIŪLINUKAI;57211490716;Taip;0;0;1;1
10552;Šermukšnėlė;SIŪLINUKAI;61911120798;Taip;0;5;0;5
10553;Šermukšnėlė;SIŪLINUKAI;3089008915;Taip;0;3;0;3
10554;Šermukšnėlė;SIŪLINUKAI;20160146304;Taip;5;0;0;5
10555;Šermukšnėlė;SIŪLINUKAI;1127786451;Taip;1;4;0;5
10556;Šermukšnėlė;SIŪLINUKAI;18799838453;Taip;0;1;1;2
10557;Šermukšnėlė;SIŪLINUKAI;1891818706;Taip;0;0;2;2
10558;Šermukšnėlė;SIŪLINUKAI;78916223877;Taip;15;0;1;16
10559;Šermukšnėlė;SIŪLINUKAI;7766292005;Taip;0;1;0;1
10560;Šermukšnėlė;SIŪLINUKAI;2397776116;Taip;4;0;1;5
10561;Šermukšnėlė;SIŪLINUKAI;3883861823;Taip;6;6;0;12
10562;Šermukšnėlė;MEDINUKAi;5172187141;Taip;0;7;0;7
10563;Šermukšnėlė;MEDINUKAi;4176986876;Taip;0;4;0;4
10564;Šermukšnėlė;MEDINUKAi;5886893562;Taip;0;11;0;11
10565;Šermukšnėlė;MEDINUKAi;3688946505;Taip;1;0;0;1
10566;Šermukšnėlė;MEDINUKAi;5069572637;Taip;3;0;1;4
10567;Šermukšnėlė;MEDINUKAi;2989011150;Taip;13;1;0;14
10568;Šermukšnėlė;MEDINUKAi;3747531232;Ne;3;2;0;5
10569;Šermukšnėlė;MEDINUKAi;1994737857;Taip;0;15;0;15
10570;Šermukšnėlė;MEDINUKAi;4619811264;Taip;0;15;0;15
10571;Šermukšnėlė;MEDINUKAi;4783726095;Taip;0;3;0;3
10572;Šermukšnėlė;MEDINUKAi;1636944853;Taip;0;10;0;10
10573;Šermukšnėlė;MEDINUKAi;7053319091;Taip;0;0;2;2
10574;Šermukšnėlė;MEDINUKAi;6351841889;Taip;18;0;0;18
10575;Šermukšnėlė;MEDINUKAi;7305013368;Taip;0;2;0;2
10576;Šermukšnėlė;MEDINUKAi;7036078780;Taip;0;8;0;8
10577;Šermukšnėlė;MEDINUKAi;9714566919;Taip;0;0;2;2
10578;Šermukšnėlė;MEDINUKAi;6698650179;Taip;21;0;0;21
10579;Šermukšnėlė;SKUDURINUKAI;5835100042;Taip;0;0;1;1
10580;Šermukšnėlė;SKUDURINUKAI;9337047371;Taip;5;0;0;5
10581;Šermukšnėlė;SKUDURINUKAI;2098090763;Taip;0;0;1;1
10582;Šermukšnėlė;SKUDURINUKAI;2714018690;Taip;0;0;3;3
10583;Šermukšnėlė;SKUDURINUKAI;3342919832;Taip;4;1;1;6
10584;Šermukšnėlė;SKUDURINUKAI;7661182825;Taip;0;1;0;1
10585;Šermukšnėlė;SKUDURINUKAI;4861799571;Taip;0;1;0;1
10586;Šermukšnėlė;SKUDURINUKAI;5733048755;Taip;0;0;4;4
10587;Šermukšnėlė;SKUDURINUKAI;5262882873;Taip;5;1;0;6
10588;Šermukšnėlė;SKUDURINUKAI;6608458145;Taip;0;6;0;6
10589;Šermukšnėlė;SKUDURINUKAI;9329824053;Taip;0;0;1;1
10590;Šermukšnėlė;PAGRANDUKAI;1312471779;Taip;0;0;1;1
10591;Šermukšnėlė;PAGRANDUKAI;8201447350;Taip;0;8;0;8
10592;Šermukšnėlė;PAGRANDUKAI;8117261716;Taip;0;0;1;1
10593;Šermukšnėlė;PAGRANDUKAI;5408843906;Taip;0;1;0;1
10594;Šermukšnėlė;PAGRANDUKAI;3245643086;Taip;4;4;0;8
10595;Šermukšnėlė;PAGRANDUKAI;7458930634;Taip;6;0;0;6
10596;Šermukšnėlė;PAGRANDUKAI;8748166398;Taip;5;0;1;6
10597;Šermukšnėlė;PAGRANDUKAI;9908568127;Taip;0;2;0;2
10598;Šypsena;NYKŠTUKAI;3429836513;Taip;0;7;22;29
10599;Šypsena;NYKŠTUKAI;7160466766;Ne;0;0;15;15
10600;Šypsena;NYKŠTUKAI;3823623458;Ne;0;2;0;2
10601;Šypsena;NYKŠTUKAI;6713182218;Taip;0;9;0;9
10602;Šypsena;NYKŠTUKAI;1287205292;Taip;1;0;2;3
10603;Šypsena;NYKŠTUKAI;7537442618;Taip;0;1;0;1
10604;Šypsena;NYKŠTUKAI;7877396588;Taip;10;5;0;15
10605;Šypsena;NYKŠTUKAI;7898387398;Taip;0;1;8;9
10606;Šypsena;NYKŠTUKAI;7120597034;Taip;0;1;2;3
10607;Šypsena;NYKŠTUKAI;5879506651;Taip;0;6;0;6
10608;Šypsena;NYKŠTUKAI;8215278033;Taip;0;4;2;6
10609;Šypsena;NYKŠTUKAI;5906001927;Taip;5;4;4;13
10610;Šypsena;NYKŠTUKAI;6951845385;Taip;0;2;0;2
10611;Šypsena;NYKŠTUKAI;4520148322;Taip;6;4;0;10
10612;Šypsena;NYKŠTUKAI;1324902555;Taip;0;4;0;4
10613;Šypsena;NYKŠTUKAI;9704350208;Ne;0;3;3;6
10614;Šypsena;SPINDULIUKAI;1114341518;Taip;3;9;3;15
10615;Šypsena;SPINDULIUKAI;1558614852;Taip;0;4;0;4
10616;Šypsena;SPINDULIUKAI;1897176871;Taip;0;2;0;2
10617;Šypsena;SPINDULIUKAI;8715718525;Taip;0;13;1;14
10618;Šypsena;SPINDULIUKAI;2312828770;Taip;2;0;0;2
10619;Šypsena;SPINDULIUKAI;1181590127;Taip;13;13;0;26
10620;Šypsena;SPINDULIUKAI;4808041625;Taip;0;9;3;12
10621;Šypsena;SPINDULIUKAI;1422418997;Taip;0;1;0;1
10622;Šypsena;SPINDULIUKAI;4038279267;Taip;3;15;0;18
10623;Šypsena;SPINDULIUKAI;1515803985;Taip;0;4;0;4
10624;Šypsena;SPINDULIUKAI;3809171499;Taip;0;1;0;1
10625;Šypsena;SPINDULIUKAI;4344780723;Taip;9;9;8;26
10626;Šypsena;SPINDULIUKAI;5504570516;Taip;0;7;1;8
10627;Šypsena;SPINDULIUKAI;1893123775;Taip;0;15;0;15
10628;Šypsena;SPINDULIUKAI;1063834589;Taip;0;6;0;6
10629;Šypsena;SPINDULIUKAI;2798819321;Taip;0;8;0;8
10630;Šypsena;SPINDULIUKAI;3506046076;Ne;0;9;3;12
10631;Šypsena;SPINDULIUKAI;7519967594;Taip;0;5;0;5
10632;Šypsena;SPINDULIUKAI;5369445077;Taip;0;16;2;18
10633;Šypsena;SPINDULIUKAI;5611440056;Ne;0;1;0;1
10634;Šypsena;SKRUZDELIUKAI;3387625466;Taip;0;10;2;12
10635;Šypsena;SKRUZDELIUKAI;4766170132;Ne;0;1;0;1
10636;Šypsena;SKRUZDELIUKAI;7569495879;Taip;3;1;0;4
10637;Šypsena;SKRUZDELIUKAI;6832433711;Taip;0;7;0;7
10638;Šypsena;SKRUZDELIUKAI;2248628927;Taip;0;7;0;7
10639;Šypsena;SKRUZDELIUKAI;2995753269;Taip;8;10;0;18
10640;Šypsena;SKRUZDELIUKAI;1796837022;Taip;0;7;3;10
10641;Šypsena;SKRUZDELIUKAI;4677405885;Taip;0;3;0;3
10642;Šypsena;SKRUZDELIUKAI;6590285866;Taip;0;10;0;10
10643;Šypsena;SKRUZDELIUKAI;3063226692;Ne;0;3;1;4
10644;Šypsena;SKRUZDELIUKAI;5985974927;Taip;0;4;0;4
10645;Šypsena;SKRUZDELIUKAI;1669768648;Ne;4;1;0;5
10646;Šypsena;SKRUZDELIUKAI;1575413188;Taip;0;8;0;8
10647;Šypsena;SKRUZDELIUKAI;2005543016;Ne;0;11;0;11
10648;Šypsena;SKRUZDELIUKAI;5568502083;Taip;6;5;0;11
10649;Šypsena;Bitutės;5642959574;Ne;0;10;0;10
10650;Šypsena;Bitutės;1917246860;Ne;9;10;0;19
10651;Šypsena;Bitutės;46569341613;Taip;0;6;0;6
10652;Šypsena;Bitutės;7538681006;Taip;4;1;0;5
10653;Šypsena;Bitutės;42130115068;Taip;0;18;0;18
10654;Šypsena;Bitutės;1712017606;Ne;0;2;0;2
10655;Šypsena;Bitutės;4017777389;Taip;0;2;1;3
10656;Šypsena;Bitutės;76332370575;Taip;0;0;1;1
10657;Šypsena;Bitutės;1906529989;Taip;0;9;0;9
10658;Šypsena;Bitutės;2099216049;Taip;0;16;0;16
10659;Šypsena;Bitutės;89503728819;Ne;0;10;0;10
10660;Šypsena;Bitutės;38995939952;Taip;0;0;1;1
10661;Šypsena;Bitutės;1387130727;Taip;0;2;0;2
10662;Šypsena;Bitutės;3025437080;Ne;0;7;0;7
10663;Šypsena;Bitutės;93678429536;Taip;0;5;1;6
10664;Šypsena;Bitutės;8197460768;Taip;0;10;0;10
10665;Šypsena;Bitutės;1133113196;Ne;0;8;1;9
10666;Šypsena;MEŠKIUKAI;9363618080;Taip;0;8;0;8
10667;Šypsena;MEŠKIUKAI;1431850136;Taip;0;9;0;9
10668;Šypsena;MEŠKIUKAI;3724645162;Taip;2;0;0;2
10669;Šypsena;MEŠKIUKAI;2900195046;Taip;0;1;0;1
10670;Šypsena;MEŠKIUKAI;3663446767;Taip;0;5;0;5
10671;Šypsena;MEŠKIUKAI;2182189246;Taip;5;0;0;5
10672;Šypsena;MEŠKIUKAI;5142969776;Taip;9;4;1;14
10673;Šypsena;MEŠKIUKAI;7332307199;Taip;5;9;0;14
10674;Šypsena;MEŠKIUKAI;8439694239;Taip;0;10;0;10
10675;Šypsena;MEŠKIUKAI;6028006499;Taip;0;0;4;4
10676;Šypsena;MEŠKIUKAI;3733757483;Taip;0;0;1;1
10677;Šypsena;MEŠKIUKAI;2179657619;Ne;0;6;0;6
10678;Šypsena;MEŠKIUKAI;3003901966;Taip;0;11;0;11
10679;Šypsena;MEŠKIUKAI;6377979434;Taip;0;1;1;2
10680;Šypsena;MEŠKIUKAI;9862387726;Taip;5;0;0;5
10681;Šypsena;MEŠKIUKAI;9702364620;Ne;0;5;0;5
10682;Šypsena;BORUŽĖLĖS;5446516798;Taip;0;5;1;6
10683;Šypsena;BORUŽĖLĖS;4496704989;Taip;0;4;8;12
10684;Šypsena;BORUŽĖLĖS;8665786789;Taip;19;8;0;27
10685;Šypsena;BORUŽĖLĖS;8913058656;Taip;0;1;8;9
10686;Šypsena;BORUŽĖLĖS;9465174636;Taip;7;0;0;7
10687;Šypsena;BORUŽĖLĖS;6724776618;Taip;0;10;11;21
10688;Šypsena;BORUŽĖLĖS;5818211923;Taip;0;5;1;6
10689;Šypsena;BORUŽĖLĖS;7074211876;Taip;0;1;0;1
10690;Šypsena;BORUŽĖLĖS;8508569167;Taip;0;7;0;7
10691;Šypsena;BORUŽĖLĖS;1716274053;Ne;0;1;0;1
10692;Šypsena;BORUŽĖLĖS;7071209465;Taip;12;0;0;12
10693;Šypsena;BORUŽĖLĖS;1912921785;Ne;0;5;0;5
10694;Šnekutis;DRUGELIŲ;2092637040;Taip;11;0;0;11
10695;Šnekutis;DRUGELIŲ;9051956302;Taip;0;0;19;19
10696;Šnekutis;DRUGELIŲ;5521822696;Ne;0;0;4;4
10697;Šnekutis;DRUGELIŲ;7307895397;Taip;0;0;1;1
10698;Šnekutis;DRUGELIŲ;3371393656;Taip;0;0;1;1
10699;Šnekutis;DRUGELIŲ;9131937590;Taip;5;17;0;22
10700;Šnekutis;DRUGELIŲ;2779793970;Taip;0;6;0;6
10701;Šnekutis;DRUGELIŲ;7514753023;Taip;17;0;0;17
10702;Šnekutis;DRUGELIŲ;54532738133;Taip;9;0;0;9
10703;Šnekutis;DRUGELIŲ;2876837284;Ne;0;3;0;3
10704;Šnekutis;DRUGELIŲ;8458769051;Taip;0;6;0;6
10705;Šnekutis;DRUGELIŲ;2144568225;Taip;4;0;1;5
10706;Šnekutis;DRUGELIŲ;3356307067;Taip;0;5;1;6
10707;Šnekutis;DRUGELIŲ;1284567777;Taip;19;0;0;19
10708;Šnekutis;Kačiukų;3281475303;Taip;0;4;0;4
10709;Šnekutis;Kačiukų;8531521901;Taip;0;2;0;2
10710;Šnekutis;Kačiukų;9670205249;Taip;0;3;2;5
10711;Šnekutis;Kačiukų;7615716438;Taip;0;10;0;10
10712;Šnekutis;Kačiukų;9780684867;Taip;0;1;0;1
10713;Šnekutis;Kačiukų;3271262071;Taip;0;0;4;4
10714;Šnekutis;Kačiukų;3166309530;Taip;0;0;1;1
10715;Šnekutis;Kačiukų;9312935803;Taip;0;0;12;12
10716;Šnekutis;Kačiukų;4992188525;Taip;0;6;0;6
10717;Šnekutis;Kačiukų;7638626055;Taip;0;0;3;3
10718;Šnekutis;Kačiukų;9157136735;Taip;0;7;0;7
10719;Šnekutis;Kačiukų;4920263429;Taip;0;10;0;10
10720;Šnekutis;Kačiukų;2914145045;Ne;12;0;3;15
10721;Šnekutis;Kačiukų;8340697546;Taip;4;0;5;9
10722;Šnekutis;Kačiukų;9896249776;Taip;0;0;2;2
10723;Šnekutis;Kačiukų;2656152037;Taip;0;2;0;2
10724;Šnekutis;Pėlėdžiukų;5188035949;Taip;0;7;0;7
10725;Šnekutis;Pėlėdžiukų;3068754741;Taip;2;0;0;2
10726;Šnekutis;Pėlėdžiukų;77534335117;Taip;0;0;7;7
10727;Šnekutis;Pėlėdžiukų;3312928478;Taip;3;6;0;9
10728;Šnekutis;Pėlėdžiukų;8866360301;Taip;11;0;0;11
10729;Šnekutis;Pėlėdžiukų;8745465796;Taip;13;0;8;21
10730;Šnekutis;Pėlėdžiukų;3170928052;Taip;6;0;0;6
10731;Šnekutis;Pėlėdžiukų;5321817615;Taip;0;0;4;4
10732;Šnekutis;Pėlėdžiukų;3578045341;Taip;5;0;1;6
10733;Šnekutis;Pėlėdžiukų;5615869149;Taip;0;10;0;10
10734;Šnekutis;Pėlėdžiukų;1329958641;Taip;0;0;2;2
10735;Šnekutis;Pėlėdžiukų;1369660223;Taip;0;1;0;1
10736;Šnekutis;Pėlėdžiukų;1682748852;Taip;0;10;1;11
10737;Šnekutis;Pėlėdžiukų;8219465079;Taip;0;10;0;10
10738;Šnekutis;Pėlėdžiukų;1504945841;Taip;0;17;0;17
10739;Šnekutis;Boružėlių;4835202527;Taip;7;1;0;8
10740;Šnekutis;Boružėlių;9326455786;Taip;4;0;0;4
10741;Šnekutis;Boružėlių;9054899440;Taip;0;8;0;8
10742;Šnekutis;Boružėlių;9862362744;Taip;3;0;0;3
10743;Šnekutis;Boružėlių;7089000987;Taip;8;0;0;8
10744;Šnekutis;Boružėlių;2843483435;Taip;1;0;0;1
10745;Šnekutis;Boružėlių;5906320006;Taip;4;0;1;5
10746;Šnekutis;Boružėlių;6405894763;Ne;0;3;0;3
10747;Šnekutis;Boružėlių;3889176018;Taip;0;1;1;2
10748;Šnekutis;Boružėlių;6749848086;Taip;3;0;0;3
10749;Šnekutis;Boružėlių;6544973632;Taip;0;3;0;3
10750;Šnekutis;Boružėlių;6146988521;Taip;0;9;0;9
10751;Šnekutis;Boružėlių;5519015388;Taip;1;0;0;1
10752;Šnekutis;Boružėlių;3628210526;Taip;3;2;0;5
10753;Šnekutis;Boružėlių;7344776758;Taip;0;8;4;12
10754;Šnekutis;Boružėlių;9956077693;Ne;6;1;2;9
10755;Šnekutis;Boružėlių;5970951526;Taip;2;0;0;2
10756;Šnekutis;Boružėlių;3344425033;Ne;6;0;0;6
10757;Šnekutis;Boružėlių;3937465849;Taip;0;1;0;1
10758;Šnekutis;Meškučių;3136349573;Taip;0;1;0;1
10759;Šnekutis;Meškučių;7680962037;Taip;5;0;0;5
10760;Šnekutis;Meškučių;3096125224;Taip;0;9;0;9
10761;Šnekutis;Meškučių;7089148766;Taip;9;2;1;12
10762;Šnekutis;Meškučių;3214549246;Taip;3;0;0;3
10763;Šnekutis;Meškučių;6305168453;Taip;0;0;3;3
10764;Šnekutis;Meškučių;2626247219;Taip;17;0;0;17
10765;Šnekutis;Meškučių;9543014297;Taip;5;0;0;5
10766;Šnekutis;Meškučių;3386995244;Taip;5;4;0;9
10767;Šnekutis;Meškučių;1902486846;Taip;0;5;0;5
10768;Šnekutis;Meškučių;8984597121;Taip;0;5;0;5
10769;Šnekutis;Meškučių;8810371475;Taip;0;0;1;1
10770;Šnekutis;Meškučių;7707897830;Taip;8;1;0;9
10771;Šnekutis;Meškučių;2042842873;Taip;8;0;1;9
10772;Šnekutis;Meškučių;2140099519;Taip;0;2;1;3
10773;Šnekutis;Viščiukų;3177449195;Taip;7;0;0;7
10774;Šnekutis;Viščiukų;6071004512;Taip;9;0;2;11
10775;Šnekutis;Viščiukų;4204642378;Taip;5;0;3;8
10776;Šnekutis;Viščiukų;4380966487;Taip;0;0;1;1
10777;Šnekutis;Viščiukų;8570372260;Taip;0;2;0;2
10778;Šnekutis;Viščiukų;3611064172;Taip;0;0;1;1
10779;Šnekutis;Viščiukų;9790241725;Taip;3;0;0;3
10780;Šnekutis;Viščiukų;8036600501;Taip;0;8;0;8
10781;Šnekutis;Viščiukų;2179736991;Taip;0;3;0;3
10782;Šnekutis;Viščiukų;1556960616;Taip;0;0;5;5
10783;Šnekutis;Viščiukų;8076487157;Taip;0;0;1;1
10784;Šnekutis;Viščiukų;6330033887;Taip;0;0;4;4
10785;Šnekutis;Viščiukų;9322106995;Taip;0;0;5;5
10786;Šnekutis;Viščiukų;3842436406;Taip;10;2;0;12
10787;Šnekutis;Viščiukų;3079202929;Taip;0;0;5;5
10788;Užupiukas;VYTURĖLIŲ;5116564840;Taip;11;0;0;11
10789;Užupiukas;VYTURĖLIŲ;3861173268;Taip;0;0;14;14
10790;Užupiukas;VYTURĖLIŲ;7443013255;Taip;7;0;0;7
10791;Užupiukas;VYTURĖLIŲ;3656400244;Taip;0;6;5;11
10792;Užupiukas;VYTURĖLIŲ;3829013911;Taip;0;0;11;11
10793;Užupiukas;VYTURĖLIŲ;9212428150;Taip;0;0;2;2
10794;Užupiukas;VYTURĖLIŲ;8549733697;Taip;0;1;0;1
10795;Užupiukas;VYTURĖLIŲ;8001099421;Taip;10;0;0;10
10796;Užupiukas;VYTURĖLIŲ;4401569800;Taip;5;0;5;10
10797;Užupiukas;VYTURĖLIŲ;1391826582;Taip;5;0;4;9
10798;Užupiukas;VYTURĖLIŲ;5021163099;Taip;0;0;11;11
10799;Užupiukas;VYTURĖLIŲ;8960813016;Taip;5;4;2;11
10800;Užupiukas;VYTURĖLIŲ;6406285034;Taip;10;0;1;11
10801;Užupiukas;VYTURĖLIŲ;7532497390;Taip;9;0;0;9
10802;Užupiukas;VYTURĖLIŲ;5168946019;Taip;0;0;4;4
10803;Užupiukas;VYTURĖLIŲ;5718382826;Taip;0;5;0;5
10804;Užupiukas;VYTURĖLIŲ;9209209113;Taip;0;0;2;2
10805;Užupiukas;VYTURĖLIŲ;9070732925;Taip;0;4;0;4
10806;Užupiukas;VYTURĖLIŲ;1146968021;Taip;0;3;0;3
10807;Užupiukas;KAČIUKŲ;3567963511;Taip;0;8;2;10
10808;Užupiukas;KAČIUKŲ;1809036046;Taip;0;5;6;11
10809;Užupiukas;KAČIUKŲ;1102468034;Taip;0;4;1;5
10810;Užupiukas;KAČIUKŲ;2931958829;Taip;6;4;2;12
10811;Užupiukas;KAČIUKŲ;1102293237;Taip;0;9;0;9
10812;Užupiukas;KAČIUKŲ;9386211193;Taip;0;10;0;10
10813;Užupiukas;KAČIUKŲ;1388346927;Taip;0;6;0;6
10814;Užupiukas;KAČIUKŲ;9333587467;Taip;0;0;7;7
10815;Užupiukas;KAČIUKŲ;7574528186;Taip;10;0;2;12
10816;Užupiukas;KAČIUKŲ;7092857844;Taip;0;4;0;4
10817;Užupiukas;KAČIUKŲ;2606742144;Taip;0;0;3;3
10818;Užupiukas;DRUGELIŲ;3579499796;Taip;0;0;1;1
10819;Užupiukas;DRUGELIŲ;7140606152;Taip;9;0;0;9
10820;Užupiukas;DRUGELIŲ;5406866873;Taip;13;0;0;13
10821;Užupiukas;DRUGELIŲ;9655636851;Taip;0;0;1;1
10822;Užupiukas;DRUGELIŲ;9863097416;Taip;8;0;0;8
10823;Užupiukas;DRUGELIŲ;7298322865;Taip;20;0;0;20
10824;Užupiukas;DRUGELIŲ;8734960045;Taip;2;0;4;6
10825;Užupiukas;DRUGELIŲ;8724566014;Taip;5;0;1;6
10826;Užupiukas;DRUGELIŲ;8341598147;Taip;3;0;18;21
10827;Užupiukas;DRUGELIŲ;9782972949;Taip;0;0;1;1
10828;Užupiukas;DRUGELIŲ;2348243399;Taip;0;0;2;2
10829;Užupiukas;DRUGELIŲ;8870229834;Taip;0;0;2;2
10830;Užupiukas;DRUGELIŲ;1679324943;Taip;0;3;1;4
10831;Užupiukas;DRUGELIŲ;1772019951;Taip;7;5;6;18
10832;Užupiukas;DRUGELIŲ;9617597828;Taip;0;0;2;2
10833;Užupiukas;DRUGELIŲ;1554333137;Taip;0;3;17;20
10834;Užupiukas;DRUGELIŲ;14139543365;Taip;0;0;2;2
10835;Užupiukas;DRUGELIŲ;3231001225;Taip;13;0;0;13
10836;Užupiukas;DRUGELIŲ;3958071677;Taip;12;0;0;12
10837;Užupiukas;DRUGELIŲ;9723966502;Taip;0;0;1;1
10838;Užupiukas;DRUGELIŲ;8915159672;Taip;0;4;0;4
10839;Užupiukas;EŽIUKŲ;1526296386;Taip;0;1;2;3
10840;Užupiukas;EŽIUKŲ;9774124589;Taip;0;0;1;1
10841;Užupiukas;EŽIUKŲ;1718518621;Taip;0;0;4;4
10842;Užupiukas;EŽIUKŲ;2724216446;Taip;4;10;0;14
10843;Užupiukas;EŽIUKŲ;9446562736;Taip;0;9;1;10
10844;Užupiukas;EŽIUKŲ;5072363435;Taip;0;9;1;10
10845;Užupiukas;EŽIUKŲ;3171528288;Taip;0;6;4;10
10846;Užupiukas;EŽIUKŲ;7860601571;Taip;0;0;1;1
10847;Užupiukas;EŽIUKŲ;3611922301;Taip;0;0;2;2
10848;Užupiukas;EŽIUKŲ;8020138690;Taip;0;0;5;5
10849;Užupiukas;EŽIUKŲ;6823724962;Taip;0;3;0;3
10850;Užupiukas;EŽIUKŲ;3057147440;Taip;8;8;0;16
10851;Užupiukas;EŽIUKŲ;6370918943;Taip;0;0;2;2
10852;Užupiukas;EŽIUKŲ;9357101972;Taip;0;3;1;4
10853;Užupiukas;EŽIUKŲ;6512355340;Taip;0;6;0;6
10854;Užupiukas;BORUŽĖLIŲ;4781598862;Taip;9;0;1;10
10855;Užupiukas;BORUŽĖLIŲ;12787288319;Taip;0;0;4;4
10856;Užupiukas;BORUŽĖLIŲ;6526550727;Taip;2;0;1;3
10857;Užupiukas;BORUŽĖLIŲ;1582921323;Taip;0;0;4;4
10858;Užupiukas;BORUŽĖLIŲ;6828175620;Taip;0;3;1;4
10859;Užupiukas;BORUŽĖLIŲ;1503714343;Taip;3;0;6;9
10860;Užupiukas;BORUŽĖLIŲ;9906475253;Taip;0;0;10;10
10861;Užupiukas;BORUŽĖLIŲ;9677572224;Taip;2;0;0;2
10862;Užupiukas;BORUŽĖLIŲ;2445335267;Taip;8;0;0;8
10863;Užupiukas;BORUŽĖLIŲ;1514268763;Taip;15;0;0;15
10864;Užupiukas;BORUŽĖLIŲ;7555702944;Taip;0;1;1;2
10865;Užupiukas;BORUŽĖLIŲ;2307600884;Taip;0;0;2;2
10866;Užupiukas;BORUŽĖLIŲ;6073039842;Taip;6;0;5;11
10867;Užupiukas;BORUŽĖLIŲ;3038973312;Taip;1;0;0;1
10868;Užupiukas;BORUŽĖLIŲ;6601099182;Ne;0;0;22;22
10869;Užupiukas;BORUŽĖLIŲ;3940264504;Taip;0;0;1;1
10870;Užupiukas;BORUŽĖLIŲ;2704243085;Taip;0;1;0;1
10871;Užupiukas;SPINDULIUKŲ;9948288546;Taip;6;0;1;7
10872;Užupiukas;SPINDULIUKŲ;87017671664;Taip;0;0;17;17
10873;Užupiukas;SPINDULIUKŲ;31471265444;Taip;3;0;1;4
10874;Užupiukas;SPINDULIUKŲ;1158250810;Ne;0;8;0;8
10875;Užupiukas;SPINDULIUKŲ;36820708170;Taip;0;0;1;1
10876;Užupiukas;SPINDULIUKŲ;64774033504;Ne;0;0;4;4
10877;Užupiukas;SPINDULIUKŲ;1656658765;Taip;0;0;6;6
10878;Užupiukas;SPINDULIUKŲ;2499414724;Taip;0;0;6;6
10879;Užupiukas;SPINDULIUKŲ;89338828452;Taip;0;0;4;4
10880;Užupiukas;SPINDULIUKŲ;48886679788;Taip;0;2;0;2
10881;Užupiukas;SPINDULIUKŲ;1592276956;Taip;0;0;2;2
10882;Užupiukas;SPINDULIUKŲ;15815468617;Taip;0;0;5;5
10883;Užupiukas;SPINDULIUKŲ;52600923918;Taip;0;0;3;3
10884;Užupiukas;SPINDULIUKŲ;6467238027;Taip;0;0;2;2
10885;Užupiukas;SPINDULIUKŲ;2740412091;Taip;0;0;3;3
10886;Užupiukas;SPINDULIUKŲ;6169887781;Taip;8;0;1;9
10887;Užupiukas;ŽVIRBLIUKŲ;8519118225;Taip;9;3;2;14
10888;Užupiukas;ŽVIRBLIUKŲ;7549628277;Taip;3;9;2;14
10889;Užupiukas;ŽVIRBLIUKŲ;5085660507;Taip;0;3;0;3
10890;Užupiukas;ŽVIRBLIUKŲ;3528581949;Taip;2;1;4;7
10891;Užupiukas;ŽVIRBLIUKŲ;2273766308;Taip;3;0;1;4
10892;Užupiukas;ŽVIRBLIUKŲ;7530856195;Taip;0;4;3;7
10893;Užupiukas;ŽVIRBLIUKŲ;9925592494;Taip;5;0;0;5
10894;Užupiukas;ŽVIRBLIUKŲ;7345579721;Taip;0;3;0;3
10895;Užupiukas;ŽVIRBLIUKŲ;4710910251;Taip;0;11;0;11
10896;Užupiukas;ŽVIRBLIUKŲ;4054724625;Taip;3;3;0;6
10897;Užupiukas;ŽVIRBLIUKŲ;2210437775;Taip;0;2;1;3
10898;Užupiukas;ŽVIRBLIUKŲ;1995228207;Taip;0;0;2;2
10899;Užupiukas;ŽVIRBLIUKŲ;1496541880;Taip;5;9;2;16
10900;Užupiukas;ŽVIRBLIUKŲ;1684901495;Taip;3;0;0;3
10901;Užupiukas;ŽVIRBLIUKŲ;2390955083;Taip;8;0;0;8
10902;Užupiukas;ŽVIRBLIUKŲ;6001766518;Taip;3;0;1;4
10903;Užupiukas;ŽVIRBLIUKŲ;3768945773;Taip;0;0;1;1
10904;Užupiukas;ŽVIRBLIUKŲ;3224193396;Taip;1;0;0;1
10905;Užupiukas;ŽVIRBLIUKŲ;1843171673;Taip;4;0;1;5
10906;Užupiukas;ŽVIRBLIUKŲ;6308141378;Taip;0;1;0;1
10907;Užupiukas;ŽVIRBLIUKŲ;4785494419;Taip;0;13;0;13
10908;Užupiukas;ŽVIRBLIUKŲ;3745080560;Taip;0;10;1;11
10909;Užupiukas;PELĖDŽIUKŲ;40704768956;Taip;0;3;0;3
10910;Užupiukas;PELĖDŽIUKŲ;5665323444;Ne;4;0;0;4
10911;Užupiukas;PELĖDŽIUKŲ;4880828482;Taip;0;0;6;6
10912;Užupiukas;PELĖDŽIUKŲ;6478702476;Taip;0;0;10;10
10913;Užupiukas;PELĖDŽIUKŲ;6110869303;Taip;0;0;4;4
10914;Užupiukas;PELĖDŽIUKŲ;3205769002;Taip;0;3;3;6
10915;Užupiukas;PELĖDŽIUKŲ;4608233152;Taip;5;0;1;6
10916;Užupiukas;PELĖDŽIUKŲ;5498369850;Taip;0;0;4;4
10917;Užupiukas;PELĖDŽIUKŲ;2821350355;Taip;0;0;3;3
10918;Užupiukas;PELĖDŽIUKŲ;3309195572;Taip;0;14;3;17
10919;Užupiukas;PELĖDŽIUKŲ;22401995674;Taip;8;0;0;8
10920;Užupiukas;PELĖDŽIUKŲ;6236652118;Taip;0;0;3;3
10921;Užupiukas;PELĖDŽIUKŲ;3774364829;Taip;8;0;0;8
10922;Užupiukas;PELĖDŽIUKŲ;9197242545;Taip;0;4;2;6
10923;Užupiukas;PELĖDŽIUKŲ;5357731534;Taip;0;0;2;2
10924;Užupiukas;PELĖDŽIUKŲ;5046355276;Taip;0;5;1;6
10925;Užupiukas;VARPELIŲ;23723147269;Taip;3;4;0;7
10926;Užupiukas;VARPELIŲ;51243697666;Taip;0;0;3;3
10927;Užupiukas;VARPELIŲ;17651645880;Taip;0;0;2;2
10928;Užupiukas;VARPELIŲ;98428714407;Taip;0;0;4;4
10929;Užupiukas;VARPELIŲ;5079596604;Taip;0;0;1;1
10930;Užupiukas;VARPELIŲ;1294561841;Taip;0;0;4;4
10931;Užupiukas;VARPELIŲ;2031306814;Taip;0;0;1;1
10932;Užupiukas;VARPELIŲ;79092366287;Taip;0;0;2;2
10933;Užupiukas;VARPELIŲ;6188599930;Taip;0;0;1;1
10934;Užupiukas;VARPELIŲ;8358242714;Taip;0;0;7;7
10935;Užupiukas;VARPELIŲ;1103878937;Taip;0;0;1;1
10936;Užupiukas;VARPELIŲ;81986379983;Taip;0;0;9;9
10937;Užupiukas;VARPELIŲ;77950386276;Taip;0;0;15;15
10938;Užupiukas;VARPELIŲ;48032538853;Taip;9;8;2;19
10939;Užupiukas;VARPELIŲ;6274937037;Taip;0;0;1;1
10940;Užupiukas;VARPELIŲ;3079228156;Taip;0;0;1;1
10941;Užupiukas;VARPELIŲ;8454703111;Taip;0;0;2;2
10942;Užupiukas;SAULUČIŲ;5704945892;Taip;0;0;6;6
10943;Užupiukas;SAULUČIŲ;2681679016;Taip;10;0;5;15
10944;Užupiukas;SAULUČIŲ;3684774901;Taip;0;0;1;1
10945;Užupiukas;SAULUČIŲ;8163092636;Taip;10;0;2;12
10946;Užupiukas;SAULUČIŲ;1976775494;Taip;4;3;0;7
10947;Užupiukas;SAULUČIŲ;5874450724;Taip;0;0;9;9
10948;Užupiukas;SAULUČIŲ;3341292382;Taip;0;12;1;13
10949;Užupiukas;SAULUČIŲ;7450368045;Taip;0;0;8;8
10950;Užupiukas;SAULUČIŲ;5570569874;Taip;9;0;1;10
10951;Užupiukas;SAULUČIŲ;7643286183;Taip;0;0;1;1
10952;Užupiukas;SAULUČIŲ;2814556305;Taip;0;0;4;4
10953;Užupiukas;SAULUČIŲ;7209853233;Taip;4;0;1;5
10954;Užupiukas;SAULUČIŲ;9953994943;Taip;0;9;3;12
10955;Užupiukas;SAULUČIŲ;7956550754;Taip;0;0;8;8
10956;Užupiukas;SAULUČIŲ;5469735455;Taip;0;1;2;3
10957;Užupiukas;SAULUČIŲ;8489545569;Taip;0;0;10;10
10958;Užupiukas;SAULUČIŲ;7990479988;Taip;10;0;1;11
10959;Užupiukas;SAULUČIŲ;4691413468;Taip;0;4;0;4
10960;Užupiukas;SAULUČIŲ;7423292334;Taip;0;8;2;10
10961;Užupiukas;SAULUČIŲ;9216626936;Taip;0;1;0;1
10962;Užupiukas;SAULUČIŲ;9962455415;Taip;0;0;2;2
10963;Užupiukas;LAPIUKŲ;9833934299;Taip;4;2;0;6
10964;Užupiukas;LAPIUKŲ;4963679583;Taip;0;4;10;14
10965;Užupiukas;LAPIUKŲ;2679915982;Taip;7;9;1;17
10966;Užupiukas;LAPIUKŲ;6004467875;Taip;6;1;1;8
10967;Užupiukas;LAPIUKŲ;1718048938;Taip;0;1;0;1
10968;Užupiukas;LAPIUKŲ;7986962850;Taip;0;1;2;3
10969;Užupiukas;LAPIUKŲ;2517606394;Taip;0;0;5;5
10970;Užupiukas;LAPIUKŲ;5965564175;Taip;0;3;0;3
10971;Užupiukas;LAPIUKŲ;5680350014;Taip;0;1;0;1
10972;Užupiukas;LAPIUKŲ;7559183263;Taip;0;12;0;12
10973;Užupiukas;LAPIUKŲ;7161001771;Taip;0;0;8;8
10974;Užupiukas;LAPIUKŲ;6967184410;Taip;0;0;4;4
10975;Užupiukas;LAPIUKŲ;4900699267;Taip;0;1;1;2
10976;Užupiukas;LAPIUKŲ;1178152392;Taip;3;3;0;6
10977;Užupiukas;LAPIUKŲ;7029091978;Taip;0;1;1;2
10978;Užupiukas;LAPIUKŲ;3311694266;Taip;3;1;1;5
10979;Užupiukas;LAPIUKŲ;1627996663;Taip;5;5;0;10
10980;Užupiukas;LAPIUKŲ;8252575784;Taip;5;1;3;9
10981;Užupiukas;LAPIUKŲ;3333547785;Taip;0;0;10;10
10982;Užupiukas;NYKŠTUKŲ;4811619739;Taip;0;5;0;5
10983;Užupiukas;NYKŠTUKŲ;3575209839;Taip;0;0;3;3
10984;Užupiukas;NYKŠTUKŲ;5941280824;Taip;13;0;9;22
10985;Užupiukas;NYKŠTUKŲ;7919242126;Taip;3;0;2;5
10986;Užupiukas;NYKŠTUKŲ;2767523129;Taip;0;0;9;9
10987;Užupiukas;NYKŠTUKŲ;9310238442;Taip;10;0;1;11
10988;Užupiukas;NYKŠTUKŲ;2485426055;Taip;10;0;0;10
10989;Užupiukas;NYKŠTUKŲ;4106614478;Taip;5;3;1;9
10990;Užupiukas;NYKŠTUKŲ;1407429980;Taip;0;0;6;6
10991;Užupiukas;NYKŠTUKŲ;7837545732;Taip;7;0;5;12
10992;Užupiukas;NYKŠTUKŲ;7314085267;Taip;4;5;0;9
10993;Užupiukas;NYKŠTUKŲ;7105857162;Taip;14;0;0;14
10994;Užupiukas;NYKŠTUKŲ;2752139377;Taip;0;0;4;4
10995;Užupiukas;NYKŠTUKŲ;9752408693;Ne;0;0;7;7
10996;Užupiukas;NYKŠTUKŲ;2769924857;Taip;4;0;11;15
10997;Užupiukas;NYKŠTUKŲ;6538402680;Taip;10;2;0;12
10998;Užupiukas;NYKŠTUKŲ;1037307190;Taip;4;0;3;7
10999;Vaidilutė;Žiogelis;3220471656;Taip;0;0;3;3
11000;Vaidilutė;Žiogelis;17497609539;Taip;0;0;1;1
11001;Vaidilutė;Žiogelis;44867291232;Taip;3;0;1;4
11002;Vaidilutė;Žiogelis;1405802722;Taip;0;9;0;9
11003;Vaidilutė;Žiogelis;8543285470;Taip;7;0;8;15
11004;Vaidilutė;Žiogelis;1941081703;Taip;0;0;3;3
11005;Vaidilutė;Žiogelis;76613866916;Taip;5;3;1;9
11006;Vaidilutė;Žiogelis;38698526742;Taip;0;0;2;2
11007;Vaidilutė;Žiogelis;3243266869;Taip;0;2;6;8
11008;Vaidilutė;Žiogelis;83887347923;Taip;0;0;1;1
11009;Vaidilutė;Žiogelis;3962268551;Taip;0;0;3;3
11010;Vaidilutė;Žiogelis;1942402815;Taip;4;2;0;6
11011;Vaidilutė;Žiogelis;13133501690;Taip;0;0;2;2
11012;Vaidilutė;Žiogelis;69452750985;Taip;0;0;1;1
11013;Vaidilutė;Žiogelis;67830476121;Taip;0;0;1;1
11014;Vaidilutė;Žiogelis;87621682081;Taip;0;3;0;3
11015;Vaidilutė;Žiogelis;1664595920;Taip;3;0;2;5
11016;Vaidilutė;Žiogelis;1986162951;Taip;0;0;1;1
11017;Vaidilutė;Žiogelis;1083096707;Taip;5;7;1;13
11018;Vaidilutė;Žiogelis;1347860031;Taip;0;0;4;4
11019;Vaidilutė;Rūtelė;2131127298;Taip;0;0;1;1
11020;Vaidilutė;Rūtelė;7319037375;Taip;0;0;3;3
11021;Vaidilutė;Rūtelė;4838951446;Taip;0;5;0;5
11022;Vaidilutė;Rūtelė;5500950179;Taip;2;7;2;11
11023;Vaidilutė;Rūtelė;1140011879;Taip;0;16;0;16
11024;Vaidilutė;Rūtelė;9652684068;Taip;0;0;11;11
11025;Vaidilutė;Rūtelė;2024078532;Taip;10;0;0;10
11026;Vaidilutė;Rūtelė;5482030284;Taip;0;0;3;3
11027;Vaidilutė;Rūtelė;8505156287;Taip;0;0;2;2
11028;Vaidilutė;Rūtelė;9568450630;Taip;13;0;0;13
11029;Vaidilutė;Rūtelė;7306768961;Taip;0;0;4;4
11030;Vaidilutė;Rūtelė;7532115462;Taip;0;9;3;12
11031;Vaidilutė;Rūtelė;3059654988;Taip;8;6;0;14
11032;Vaidilutė;Rūtelė;1341696594;Taip;0;0;3;3
11033;Vaidilutė;Rūtelė;1141947715;Taip;14;0;0;14
11034;Vaidilutė;Voveraitė;1993403692;Taip;0;0;5;5
11035;Vaidilutė;Voveraitė;42503303158;Taip;0;1;0;1
11036;Vaidilutė;Voveraitė;9869134464;Taip;0;1;0;1
11037;Vaidilutė;Voveraitė;3069613102;Taip;0;5;3;8
11038;Vaidilutė;Voveraitė;5177060346;Taip;0;0;6;6
11039;Vaidilutė;Voveraitė;4671287016;Taip;8;0;2;10
11040;Vaidilutė;Voveraitė;7419525100;Taip;8;0;0;8
11041;Vaidilutė;Voveraitė;1363913645;Taip;0;3;0;3
11042;Vaidilutė;Voveraitė;5252637701;Taip;0;0;1;1
11043;Vaidilutė;Voveraitė;1139332221;Taip;0;0;4;4
11044;Vaidilutė;Voveraitė;1297817018;Taip;0;0;3;3
11045;Vaidilutė;Voveraitė;3202508790;Taip;5;0;0;5
11046;Vaidilutė;Voveraitė;1315347184;Taip;0;5;0;5
11047;Vaidilutė;Voveraitė;2346018814;Taip;22;0;0;22
11048;Vaidilutė;Saulutė;8492055287;Taip;7;0;2;9
11049;Vaidilutė;Saulutė;6844372910;Taip;12;0;1;13
11050;Vaidilutė;Saulutė;4972645715;Taip;6;0;6;12
11051;Vaidilutė;Saulutė;1355005114;Taip;9;0;2;11
11052;Vaidilutė;Saulutė;4680645841;Taip;6;0;0;6
11053;Vaidilutė;Saulutė;2662468804;Taip;0;0;3;3
11054;Vaidilutė;Saulutė;5217609332;Taip;1;6;0;7
11055;Vaidilutė;Saulutė;2864731541;Taip;18;0;0;18
11056;Vaidilutė;Saulutė;2468220275;Taip;7;3;1;11
11057;Vaidilutė;Saulutė;1610262589;Taip;0;0;6;6
11058;Vaidilutė;Saulutė;2356037175;Taip;11;0;1;12
11059;Vaidilutė;Saulutė;5054640268;Taip;6;0;3;9
11060;Vaidilutė;Saulutė;6885473308;Taip;2;6;0;8
11061;Vaidilutė;Saulutė;7826111890;Taip;2;0;1;3
11062;Vaidilutė;Saulutė;5945744595;Taip;10;3;0;13
11063;Vaidilutė;Saulutė;6674238265;Taip;0;1;2;3
11064;Vaidilutė;Saulutė;2495112045;Taip;5;0;7;12
11065;Vaidilutė;Žibutė;5686463470;Taip;0;14;7;21
11066;Vaidilutė;Žibutė;2041126370;Taip;0;1;1;2
11067;Vaidilutė;Žibutė;45949026707;Taip;6;2;0;8
11068;Vaidilutė;Žibutė;4259585225;Taip;0;1;1;2
11069;Vaidilutė;Žibutė;4334934114;Taip;3;1;3;7
11070;Vaidilutė;Žibutė;3152118407;Taip;0;1;1;2
11071;Vaidilutė;Žibutė;5203062837;Taip;0;1;1;2
11072;Vaidilutė;Žibutė;1266927367;Taip;0;1;2;3
11073;Vaidilutė;Žibutė;2941550026;Taip;0;4;0;4
11074;Vaidilutė;Žibutė;4362797606;Taip;0;11;0;11
11075;Vaidilutė;Žibutė;6322986820;Taip;3;0;1;4
11076;Vaidilutė;Žibutė;5620009051;Taip;0;0;2;2
11077;Vaidilutė;Žibutė;1853463568;Taip;0;0;2;2
11078;Vaidilutė;Žibutė;9556632708;Taip;0;3;0;3
11079;Vaidilutė;Žibutė;7779630805;Taip;0;4;0;4
11080;Vaidilutė;Žibutė;5991149222;Taip;11;2;0;13
11081;Vaidilutė;Žibutė;3112025222;Taip;2;0;0;2
11082;Vaidilutė;Žibutė;1786022030;Taip;3;0;4;7
11083;Vaidilutė;Žibutė;9876388990;Taip;0;6;0;6
11084;Vaidilutė;"Ąžuoliukas ";3463112472;Taip;0;0;8;8
11085;Vaidilutė;"Ąžuoliukas ";3730573432;Taip;0;0;1;1
11086;Vaidilutė;"Ąžuoliukas ";6586072228;Taip;0;3;0;3
11087;Vaidilutė;"Ąžuoliukas ";5988376676;Taip;5;4;1;10
11088;Vaidilutė;"Ąžuoliukas ";5439973183;Taip;8;0;0;8
11089;Vaidilutė;"Ąžuoliukas ";4761992071;Taip;0;0;1;1
11090;Vaidilutė;"Ąžuoliukas ";1440819171;Taip;8;3;0;11
11091;Vaidilutė;"Ąžuoliukas ";2668758195;Taip;0;0;1;1
11092;Vaidilutė;"Ąžuoliukas ";4901387311;Taip;0;4;0;4
11093;Vaidilutė;"Ąžuoliukas ";2997948252;Taip;10;0;2;12
11094;Vaidilutė;"Ąžuoliukas ";9723156071;Taip;0;0;2;2
11095;Vaidilutė;"Žemuogėlė ";6758078068;Taip;0;4;1;5
11096;Vaidilutė;"Žemuogėlė ";48928174623;Taip;0;3;0;3
11097;Vaidilutė;"Žemuogėlė ";1556646493;Taip;0;22;0;22
11098;Vaidilutė;"Žemuogėlė ";25071409492;Taip;0;21;0;21
11099;Vaidilutė;"Žemuogėlė ";94210720777;Taip;0;3;0;3
11100;Vaidilutė;"Žemuogėlė ";79694144428;Ne;0;0;3;3
11101;Vaidilutė;"Žemuogėlė ";83944413409;Taip;0;1;1;2
11102;Vaidilutė;"Žemuogėlė ";24445906930;Taip;0;0;1;1
11103;Vaidilutė;"Žemuogėlė ";79964507480;Taip;0;0;5;5
11104;Vaidilutė;"Žemuogėlė ";1692795486;Taip;5;5;0;10
11105;Vaidilutė;"Žemuogėlė ";5116482125;Taip;0;1;3;4
11106;Vaidilutė;"Žemuogėlė ";34492341585;Taip;0;2;0;2
11107;Vaidilutė;"Žemuogėlė ";87401758633;Taip;5;0;0;5
11108;Vaidilutė;"Žemuogėlė ";25654419755;Taip;0;0;7;7
11109;Vaidilutė;"Vyturėlis ";9558983004;Taip;0;5;1;6
11110;Vaidilutė;"Vyturėlis ";5326935037;Taip;9;0;1;10
11111;Vaidilutė;"Vyturėlis ";2189753894;Taip;0;0;4;4
11112;Vaidilutė;"Vyturėlis ";9689388330;Taip;0;1;0;1
11113;Vaidilutė;"Vyturėlis ";9584702487;Taip;0;1;0;1
11114;Vaidilutė;"Vyturėlis ";2081959307;Taip;3;0;0;3
11115;Vaidilutė;"Vyturėlis ";8882402632;Taip;0;4;5;9
11116;Vaidilutė;"Vyturėlis ";1539700521;Taip;0;4;0;4
11117;Vaidilutė;"Vyturėlis ";8628545847;Taip;0;0;3;3
11118;Vaidilutė;"Vyturėlis ";2058071219;Taip;8;0;1;9
11119;Vaidilutė;"Vyturėlis ";4388069915;Taip;0;1;0;1
11120;Vaidilutė;"Vyturėlis ";1417828163;Taip;0;0;1;1
11121;Vaidilutė;"Vyturėlis ";5651628204;Ne;0;1;0;1
11122;Vaidilutė;"Vyturėlis ";2251608691;Taip;0;0;1;1
11123;Vaidilutė;"Vyturėlis ";7914006128;Taip;11;0;3;14
11124;Vaidilutė;"Varpelis ";6250831269;Taip;0;0;1;1
11125;Vaidilutė;"Varpelis ";6037349527;Taip;0;0;2;2
11126;Vaidilutė;"Varpelis ";5867501558;Taip;0;1;5;6
11127;Vaidilutė;"Varpelis ";3832349858;Taip;0;0;1;1
11128;Vaidilutė;"Varpelis ";9317774960;Taip;0;0;5;5
11129;Vaidilutė;"Varpelis ";5448014291;Taip;0;5;2;7
11130;Vaidilutė;"Varpelis ";3497795848;Taip;0;0;1;1
11131;Vaidilutė;"Varpelis ";1385914020;Taip;0;0;12;12
11132;Vaidilutė;"Varpelis ";3453045619;Taip;0;0;6;6
11133;Vaidilutė;"Varpelis ";6022130248;Taip;3;0;1;4
11134;Vaidilutė;"Varpelis ";5101104226;Taip;0;0;2;2
11135;Vaidilutė;"Varpelis ";5594121340;Taip;4;0;0;4
11136;Vaidilutė;"Varpelis ";1882829340;Taip;0;0;7;7
11137;Vaidilutė;"Varpelis ";6097229427;Taip;0;0;1;1
11138;Vaidilutė;"Varpelis ";3353827105;Ne;0;0;3;3
11139;Vaidilutė;"Boružėlių ";3087959868;Taip;9;5;0;14
11140;Vaidilutė;"Boružėlių ";7940581813;Taip;0;3;0;3
11141;Vaidilutė;"Boružėlių ";7400197367;Taip;0;3;0;3
11142;Vaidilutė;"Boružėlių ";2767482145;Taip;0;9;0;9
11143;Vaidilutė;"Boružėlių ";3980894528;Taip;10;5;0;15
11144;Vaidilutė;"Boružėlių ";1362256314;Taip;0;12;0;12
11145;Vaidilutė;"Boružėlių ";6928815317;Taip;18;0;0;18
11146;Vaidilutė;"Boružėlių ";5415279154;Taip;11;1;0;12
11147;Vaidilutė;"Boružėlių ";7429825620;Taip;4;0;0;4
11148;Vaidilutė;"Boružėlių ";8836178193;Taip;4;0;0;4
11149;Vaidilutė;"Boružėlių ";7765298370;Taip;0;4;0;4
11150;Vaidilutė;"Boružėlių ";7903242996;Taip;9;0;0;9
11151;Vaidilutė;"Boružėlių ";1726638921;Taip;10;6;0;16
11152;Vaidilutė;"Boružėlių ";1377015807;Taip;6;0;0;6
11153;Vaidilutė;"Malūnelis ";8177787790;Taip;3;0;0;3
11154;Vaidilutė;"Malūnelis ";5855762068;Taip;0;1;1;2
11155;Vaidilutė;"Malūnelis ";7327131165;Taip;0;4;0;4
11156;Vaidilutė;"Malūnelis ";9429544108;Taip;10;10;0;20
11157;Vaidilutė;"Malūnelis ";2318578603;Taip;0;0;7;7
11158;Vaidilutė;"Malūnelis ";3634285869;Taip;9;3;0;12
11159;Vaidilutė;"Malūnelis ";3150642420;Taip;10;0;0;10
11160;Vaidilutė;"Malūnelis ";1608646909;Taip;16;0;0;16
11161;Vaidilutė;"Malūnelis ";8377824920;Taip;0;7;0;7
11162;Vaidilutė;"Malūnelis ";5296146822;Taip;4;0;0;4
11163;Vaidilutė;"Malūnelis ";9372280434;Taip;4;1;0;5
11164;Vaidilutė;"Malūnelis ";1372767364;Ne;10;0;0;10
11165;Vaidilutė;"Malūnelis ";3299081380;Taip;8;0;0;8
11166;Vaidilutė;"Malūnelis ";7703578508;Taip;7;0;4;11
11167;Vaidilutė;"Riešutėlis ";3605988018;Taip;0;0;1;1
11168;Vaidilutė;"Riešutėlis ";1161455376;Taip;0;0;3;3
11169;Vaidilutė;"Riešutėlis ";4518002596;Taip;3;0;2;5
11170;Vaidilutė;"Riešutėlis ";4657952465;Taip;10;0;2;12
11171;Vaidilutė;"Riešutėlis ";8756807918;Taip;0;0;10;10
11172;Vaidilutė;"Riešutėlis ";9782176726;Taip;7;0;1;8
11173;Vaidilutė;"Riešutėlis ";1206696843;Taip;0;0;3;3
11174;Vaidilutė;"Riešutėlis ";9872915544;Taip;4;6;2;12
11175;Vaidilutė;"Riešutėlis ";2976615414;Taip;15;0;3;18
11176;Vaidilutė;"Riešutėlis ";4709977896;Taip;3;0;0;3
11177;Vaidilutė;"Riešutėlis ";2409760986;Taip;3;0;4;7
11178;Vaidilutė;"Riešutėlis ";2564536281;Taip;2;0;0;2
11179;Vaidilutė;"Riešutėlis ";4051575845;Taip;0;0;2;2
11180;Vaidilutė;"Riešutėlis ";9025469107;Taip;4;0;10;14
11181;Vaidilutė;"Riešutėlis ";3862444839;Taip;4;0;6;10
11182;Vaidilutė;"Riešutėlis ";9567786222;Taip;17;0;0;17
11183;Vaidilutė;"Riešutėlis ";3321127541;Taip;0;0;4;4
11184;Vaidilutė;"Riešutėlis ";7713772984;Taip;0;0;22;22
11185;Vaidilutė;"Riešutėlis ";3064988592;Taip;0;0;1;1
11186;Vaidilutė;"Riešutėlis ";7043895152;Taip;0;0;6;6
11187;Vaidilutė;"Riešutėlis ";8296567629;Taip;6;0;2;8
11188;Vandenis;ŽUVĖDRŲ;5362078687;Taip;0;10;0;10
11189;Vandenis;ŽUVĖDRŲ;6784010746;Taip;0;2;2;4
11190;Vandenis;ŽUVĖDRŲ;2238926097;Taip;10;1;0;11
11191;Vandenis;ŽUVĖDRŲ;9334958945;Taip;3;2;0;5
11192;Vandenis;ŽUVĖDRŲ;7447487403;Taip;6;3;0;9
11193;Vandenis;ŽUVĖDRŲ;4303303483;Taip;5;7;0;12
11194;Vandenis;ŽUVĖDRŲ;2325465812;Taip;2;3;2;7
11195;Vandenis;ŽUVĖDRŲ;2649542586;Taip;1;4;0;5
11196;Vandenis;ŽUVĖDRŲ;1144490168;Taip;5;2;0;7
11197;Vandenis;ŽUVĖDRŲ;7391206543;Taip;0;2;0;2
11198;Vandenis;ŽUVĖDRŲ;9335319713;Taip;8;0;0;8
11199;Vandenis;ŽUVĖDRŲ;6068154206;Taip;0;1;0;1
11200;Vandenis;ŽUVĖDRŲ;7296608892;Taip;0;8;0;8
11201;Vandenis;ŽUVĖDRŲ;5408971428;Taip;0;1;0;1
11202;Vandenis;ŽUVĖDRŲ;2276497021;Taip;6;6;0;12
11203;Vandenis;ŽUVĖDRŲ;6063181697;Taip;0;2;0;2
11204;Vandenis;RUONIUKŲ;2422642232;Taip;0;12;0;12
11205;Vandenis;RUONIUKŲ;1051281257;Taip;0;12;0;12
11206;Vandenis;RUONIUKŲ;7565308536;Taip;7;2;0;9
11207;Vandenis;RUONIUKŲ;9518434896;Taip;0;8;0;8
11208;Vandenis;RUONIUKŲ;1120907086;Taip;0;1;0;1
11209;Vandenis;RUONIUKŲ;1563710105;Taip;0;0;1;1
11210;Vandenis;RUONIUKŲ;7702272913;Taip;3;13;1;17
11211;Vandenis;RUONIUKŲ;6476051751;Taip;0;1;0;1
11212;Vandenis;RUONIUKŲ;4713395766;Taip;4;2;0;6
11213;Vandenis;RUONIUKŲ;6986724058;Taip;0;1;0;1
11214;Vandenis;RUONIUKŲ;7754158588;Taip;0;0;1;1
11215;Vandenis;RUONIUKŲ;9731729915;Taip;2;6;0;8
11216;Vandenis;RUONIUKŲ;9527253920;Taip;5;0;0;5
11217;Vandenis;RUONIUKŲ;6330187732;Taip;1;8;0;9
11218;Vandenis;RUONIUKŲ;9688954631;Taip;0;1;0;1
11219;Vandenis;RUONIUKŲ;8729351613;Taip;0;1;0;1
11220;Vandenis;RUONIUKŲ;4971165639;Taip;0;5;0;5
11221;Vandenis;RUONIUKŲ;6158299885;Taip;0;3;0;3
11222;Vandenis;RUONIUKŲ;3664560833;Taip;0;1;0;1
11223;Vandenis;RUONIUKŲ;5535901447;Taip;0;2;0;2
11224;Vandenis;ŽUVYČIŲ;91774614891;Taip;0;5;0;5
11225;Vandenis;ŽUVYČIŲ;1944730492;Taip;0;11;0;11
11226;Vandenis;ŽUVYČIŲ;44800276421;Taip;0;7;0;7
11227;Vandenis;ŽUVYČIŲ;94273730058;Taip;0;1;0;1
11228;Vandenis;ŽUVYČIŲ;26193472997;Taip;0;4;0;4
11229;Vandenis;ŽUVYČIŲ;75077443996;Taip;0;1;0;1
11230;Vandenis;ŽUVYČIŲ;84636435681;Taip;4;1;0;5
11231;Vandenis;ŽUVYČIŲ;43295720034;Taip;7;0;0;7
11232;Vandenis;ŽUVYČIŲ;58997790744;Taip;0;2;0;2
11233;Vandenis;ŽUVYČIŲ;3740778932;Taip;0;3;0;3
11234;Vandenis;ŽUVYČIŲ;1245031666;Taip;0;4;1;5
11235;Vandenis;ŽUVYČIŲ;2073785910;Taip;0;4;1;5
11236;Vandenis;ŽUVYČIŲ;3823382249;Taip;0;1;0;1
11237;Vandenis;ŽUVYČIŲ;86947904365;Taip;0;4;0;4
11238;Vandenis;ŽUVYČIŲ;1854498462;Taip;0;2;0;2
11239;Vandenis;ŽUVYČIŲ;81817138188;Taip;0;1;0;1
11240;Vandenis;ŽUVYČIŲ;7467699979;Taip;0;5;0;5
11241;Vandenis;ŽUVYČIŲ;1395272045;Taip;3;0;0;3
11242;Vandenis;ŽUVYČIŲ;1958929302;Taip;0;2;0;2
11243;Vandenis;ŽUVYČIŲ;39973189502;Taip;3;0;1;4
11244;Vandenis;PERLIUKŲ;8678508812;Taip;0;1;0;1
11245;Vandenis;PERLIUKŲ;2645775090;Taip;0;4;0;4
11246;Vandenis;PERLIUKŲ;5844576485;Taip;4;0;0;4
11247;Vandenis;PERLIUKŲ;6295009202;Taip;0;2;0;2
11248;Vandenis;PERLIUKŲ;7598257845;Taip;0;4;0;4
11249;Vandenis;PERLIUKŲ;7473692892;Taip;5;1;0;6
11250;Vandenis;PERLIUKŲ;5323428164;Taip;0;8;0;8
11251;Vandenis;PERLIUKŲ;6073002418;Taip;0;1;0;1
11252;Vandenis;PERLIUKŲ;1511740350;Taip;0;2;0;2
11253;Vandenis;PERLIUKŲ;2576575249;Taip;0;7;0;7
11254;Vandenis;PERLIUKŲ;7832674282;Taip;0;4;0;4
11255;Vandenis;PERLIUKŲ;9798192239;Taip;0;5;0;5
11256;Vandenis;PERLIUKŲ;1975385430;Taip;0;3;0;3
11257;Vandenis;PERLIUKŲ;3061606138;Taip;0;3;0;3
11258;Vandenis;PERLIUKŲ;8117385209;Taip;0;3;0;3
11259;Vandenis;PERLIUKŲ;5613067534;Taip;0;2;6;8
11260;Vandenis;PERLIUKŲ;2321919298;Taip;18;0;0;18
11261;Vandenis;PERLIUKŲ;5963181638;Taip;5;3;0;8
11262;Vandenis;PERLIUKŲ;5609737826;Taip;10;0;5;15
11263;Vandenis;PERLIUKŲ;3239754791;Taip;0;14;0;14
11264;Vandenis;PERLIUKŲ;5129492284;Taip;0;1;0;1
11265;Vandenis;ANČIUKŲ;8233407105;Taip;0;6;0;6
11266;Vandenis;ANČIUKŲ;1282499654;Taip;0;5;0;5
11267;Vandenis;ANČIUKŲ;3578947540;Taip;0;7;0;7
11268;Vandenis;ANČIUKŲ;3243079651;Taip;0;5;0;5
11269;Vandenis;ANČIUKŲ;1314724267;Taip;0;2;0;2
11270;Vandenis;ANČIUKŲ;8251169901;Ne;0;1;0;1
11271;Vandenis;ANČIUKŲ;4750141780;Taip;5;2;0;7
11272;Vandenis;ANČIUKŲ;6181866272;Taip;0;2;0;2
11273;Vandenis;ANČIUKŲ;3067868099;Taip;0;1;0;1
11274;Vandenis;ANČIUKŲ;8511948282;Taip;11;3;0;14
11275;Vandenis;ANČIUKŲ;33317650043;Taip;0;1;0;1
11276;Vandenis;ANČIUKŲ;1739780612;Taip;11;11;0;22
11277;Vandenis;ANČIUKŲ;2489776665;Taip;8;0;0;8
11278;Vandenis;ANČIUKŲ;1621481561;Taip;0;1;0;1
11279;Vandenis;ANČIUKŲ;33782837791;Taip;0;1;0;1
11280;Vandenis;ANČIUKŲ;2096950367;Taip;0;2;1;3
11281;Vandenis;ANČIUKŲ;61120985165;Taip;0;1;0;1
11282;Vandenis;ANČIUKŲ;7168910452;Taip;0;1;0;1
11283;Vandenis;VĖŽLIUKŲ;2309166304;Taip;13;3;0;16
11284;Vandenis;VĖŽLIUKŲ;5454049563;Taip;0;2;0;2
11285;Vandenis;VĖŽLIUKŲ;9805578141;Taip;0;2;0;2
11286;Vandenis;VĖŽLIUKŲ;8921666108;Taip;0;1;0;1
11287;Vandenis;VĖŽLIUKŲ;8116532445;Taip;0;7;0;7
11288;Vandenis;VĖŽLIUKŲ;7069369080;Taip;0;8;0;8
11289;Vandenis;VĖŽLIUKŲ;7924399684;Taip;0;12;0;12
11290;Vandenis;VĖŽLIUKŲ;1187395353;Taip;0;5;0;5
11291;Vandenis;VĖŽLIUKŲ;7091356848;Taip;0;3;0;3
11292;Vandenis;VĖŽLIUKŲ;1081385111;Ne;5;4;0;9
11293;Vandenis;VĖŽLIUKŲ;5126732658;Taip;0;5;0;5
11294;Vandenis;VĖŽLIUKŲ;7059385610;Taip;0;2;0;2
11295;Vandenis;VĖŽLIUKŲ;1707354287;Taip;0;1;0;1
11296;Vandenis;VĖŽLIUKŲ;4177166475;Taip;0;2;0;2
11297;Vandenis;VĖŽLIUKŲ;5218101579;Taip;0;4;0;4
11298;Vandenis;VĖŽLIUKŲ;8416839037;Taip;0;6;0;6
11299;Vandenis;VĖŽLIUKŲ;2936885357;Taip;22;0;0;22
11300;Vandenis;VĖŽLIUKŲ;8879608849;Taip;0;10;0;10
11301;Vandenis;AŠTUNKOJŲ;1505353673;Taip;4;0;0;4
11302;Vandenis;AŠTUNKOJŲ;18417531508;Taip;0;1;0;1
11303;Vandenis;AŠTUNKOJŲ;1217508516;Taip;4;2;1;7
11304;Vandenis;AŠTUNKOJŲ;53658866238;Taip;0;6;0;6
11305;Vandenis;AŠTUNKOJŲ;1286716632;Taip;0;2;0;2
11306;Vandenis;AŠTUNKOJŲ;7333587583;Taip;0;2;0;2
11307;Vandenis;AŠTUNKOJŲ;25459674313;Taip;0;2;0;2
11308;Vandenis;AŠTUNKOJŲ;78917527699;Taip;0;1;0;1
11309;Vandenis;AŠTUNKOJŲ;1155423158;Taip;0;2;0;2
11310;Vandenis;AŠTUNKOJŲ;46916815441;Taip;0;8;0;8
11311;Vandenis;AŠTUNKOJŲ;65840410497;Taip;0;1;0;1
11312;Vandenis;AŠTUNKOJŲ;1397125827;Taip;0;1;0;1
11313;Vandenis;AŠTUNKOJŲ;2812520834;Taip;0;3;0;3
11314;Vandenis;GANDRIUKŲ;4753416316;Taip;6;1;0;7
11315;Vandenis;GANDRIUKŲ;8264797886;Taip;3;0;2;5
11316;Vandenis;GANDRIUKŲ;9936940067;Ne;0;3;0;3
11317;Vandenis;GANDRIUKŲ;6153669587;Taip;15;0;0;15
11318;Vandenis;GANDRIUKŲ;6260893699;Taip;14;0;0;14
11319;Vandenis;GANDRIUKŲ;1919577714;Taip;0;11;11;22
11320;Vandenis;GANDRIUKŲ;7019646962;Taip;0;1;0;1
11321;Vandenis;GANDRIUKŲ;2078767085;Taip;19;0;0;19
11322;Vandenis;GANDRIUKŲ;2976505868;Taip;15;0;0;15
11323;Vandenis;GANDRIUKŲ;6691874473;Taip;0;6;2;8
11324;Vandenis;GANDRIUKŲ;6483030616;Taip;4;0;0;4
11325;Vandenis;GANDRIUKŲ;1621497786;Taip;0;0;2;2
11326;Vandenis;GANDRIUKŲ;8144830789;Taip;0;10;1;11
11327;Vandenis;GANDRIUKŲ;5899846599;Taip;3;0;0;3
11328;Vandenis;GANDRIUKŲ;8127873607;Taip;3;0;1;4
11329;Vandenis;GANDRIUKŲ;1606103904;Taip;13;0;0;13
11330;Vandenis;GANDRIUKŲ;7303512055;Taip;0;0;2;2
11331;Vandenis;GANDRIUKŲ;3231434944;Taip;0;0;21;21
11332;Vandenis;GANDRIUKŲ;6327478049;Taip;14;8;0;22
11333;Vandenis;ŽĄSIUKAI;9937317687;Taip;5;1;0;6
11334;Vandenis;ŽĄSIUKAI;4984723792;Taip;5;0;0;5
11335;Vandenis;ŽĄSIUKAI;8014569725;Taip;7;0;0;7
11336;Vandenis;ŽĄSIUKAI;7071349847;Taip;10;0;0;10
11337;Vandenis;ŽĄSIUKAI;7070234429;Taip;6;5;3;14
11338;Vandenis;ŽĄSIUKAI;4072405890;Taip;13;0;0;13
11339;Vandenis;ŽĄSIUKAI;5684262347;Taip;13;0;2;15
11340;Vandenis;ŽĄSIUKAI;4349464804;Taip;4;1;0;5
11341;Vandenis;ŽĄSIUKAI;7596199296;Taip;0;2;0;2
11342;Vandenis;ŽĄSIUKAI;5607412408;Taip;10;2;1;13
11343;Vandenis;ŽĄSIUKAI;1925178245;Taip;7;1;0;8
11344;Vandenis;ŽĄSIUKAI;7525611399;Taip;12;1;0;13
11345;Vandenis;ŽĄSIUKAI;5641929490;Taip;7;2;0;9
11346;Vandenis;PURIENŲ;6851178154;Taip;0;4;0;4
11347;Vandenis;PURIENŲ;5440027798;Taip;0;5;0;5
11348;Vandenis;PURIENŲ;4455886780;Taip;8;0;0;8
11349;Vandenis;PURIENŲ;1031451445;Taip;0;0;2;2
11350;Vandenis;PURIENŲ;4815210197;Taip;2;6;3;11
11351;Vandenis;PURIENŲ;3337286021;Taip;5;14;0;19
11352;Vandenis;PURIENŲ;7020534318;Taip;0;5;0;5
11353;Vandenis;PURIENŲ;6027680514;Taip;6;1;2;9
11354;Vandenis;PURIENŲ;2960005490;Taip;0;0;4;4
11355;Vandenis;PURIENŲ;1180322026;Taip;0;0;4;4
11356;Vandenis;PURIENŲ;7959438279;Taip;15;0;0;15
11357;Vandenis;PURIENŲ;1788652447;Taip;0;1;0;1
11358;Vandenis;PURIENŲ;6332179750;Taip;0;3;0;3
11359;Vandenis;PURIENŲ;2719678617;Taip;1;0;0;1
11360;Vandenis;PURIENŲ;7171302906;Taip;10;1;0;11
11361;Vandenis;PURIENŲ;8085633453;Taip;10;1;0;11
11362;Vandenis;PURIENŲ;5764809162;Taip;2;0;0;2
11363;Vandenis;PURIENŲ;1244502945;Taip;4;1;0;5
11364;Vandenis;VARLIUKAI;6189862061;Taip;0;4;0;4
11365;Vandenis;VARLIUKAI;4345021061;Taip;0;4;0;4
11366;Vandenis;VARLIUKAI;9763300020;Taip;15;5;0;20
11367;Vandenis;VARLIUKAI;9968877035;Taip;0;2;0;2
11368;Vandenis;VARLIUKAI;3639160500;Taip;0;6;0;6
11369;Vandenis;VARLIUKAI;9458613523;Taip;0;2;3;5
11370;Vandenis;VARLIUKAI;4607196473;Taip;10;0;3;13
11371;Vandenis;VARLIUKAI;1213743099;Taip;0;1;0;1
11372;Vandenis;VARLIUKAI;4954121871;Taip;5;0;0;5
11373;Vandenis;VARLIUKAI;8751355814;Taip;0;1;0;1
11374;Vandenis;VARLIUKAI;4983424940;Taip;0;1;0;1
11375;Vandenis;VARLIUKAI;4978712442;Taip;3;1;0;4
11376;Vandenis;VARLIUKAI;7631982912;Taip;3;2;0;5
11377;Vandenis;VARLIUKAI;7581114286;Taip;0;5;0;5
11378;Vandenis;VARLIUKAI;9679010239;Taip;3;7;0;10
11379;Vandenis;PINGVINAI;3544717790;Taip;0;2;1;3
11380;Vandenis;PINGVINAI;1568158992;Taip;0;3;0;3
11381;Vandenis;PINGVINAI;71513217054;Taip;0;2;0;2
11382;Vandenis;PINGVINAI;55421695186;Taip;0;2;0;2
11383;Vandenis;PINGVINAI;24217366528;Taip;7;1;0;8
11384;Vandenis;PINGVINAI;5549292096;Taip;0;4;0;4
11385;Vandenis;PINGVINAI;4643267945;Taip;4;4;0;8
11386;Vandenis;PINGVINAI;8430706407;Taip;0;2;0;2
11387;Vandenis;PINGVINAI;1535450614;Taip;0;4;0;4
11388;Vandenis;PINGVINAI;27409922803;Taip;8;0;0;8
11389;Vandenis;PINGVINAI;1598122777;Taip;4;2;0;6
11390;Vandenis;PINGVINAI;1815765498;Taip;0;8;1;9
11391;Vandenis;PINGVINAI;8705188652;Taip;13;0;0;13
11392;Varpelis;NYKŠTUKAI;7043067458;Taip;0;0;7;7
11393;Varpelis;NYKŠTUKAI;3840270467;Taip;9;0;8;17
11394;Varpelis;NYKŠTUKAI;5940144949;Taip;0;3;1;4
11395;Varpelis;NYKŠTUKAI;6345239868;Taip;0;6;0;6
11396;Varpelis;NYKŠTUKAI;3603149779;Taip;0;0;4;4
11397;Varpelis;NYKŠTUKAI;1591999024;Ne;0;0;3;3
11398;Varpelis;NYKŠTUKAI;5322766823;Taip;4;0;3;7
11399;Varpelis;NYKŠTUKAI;1081800670;Taip;13;0;7;20
11400;Varpelis;NYKŠTUKAI;6455435982;Taip;0;4;6;10
11401;Varpelis;NYKŠTUKAI;6834427885;Taip;6;6;0;12
11402;Varpelis;NYKŠTUKAI;2060301158;Taip;5;0;0;5
11403;Varpelis;NYKŠTUKAI;5155733224;Taip;5;0;18;23
11404;Varpelis;NYKŠTUKAI;2339010385;Taip;5;10;6;21
11405;Varpelis;NYKŠTUKAI;9372121923;Taip;4;2;6;12
11406;Varpelis;NYKŠTUKAI;4553345643;Taip;0;0;6;6
11407;Varpelis;NYKŠTUKAI;1730570091;Taip;2;0;5;7
11408;Varpelis;NYKŠTUKAI;5985806014;Taip;13;0;1;14
11409;Varpelis;NYKŠTUKAI;8269062925;Taip;10;0;8;18
11410;Varpelis;NYKŠTUKAI;3268141759;Taip;0;0;4;4
11411;Varpelis;NYKŠTUKAI;4215058265;Taip;0;5;6;11
11412;Varpelis;NYKŠTUKAI;9430776477;Taip;0;0;3;3
11413;Varpelis;NYKŠTUKAI;2000963283;Taip;11;0;3;14
11414;Varpelis;"SPINDULIUKŲ su Valdorfo elementais";2112606094;Taip;0;3;1;4
11415;Varpelis;"SPINDULIUKŲ su Valdorfo elementais";1331085640;Taip;0;0;6;6
11416;Varpelis;"SPINDULIUKŲ su Valdorfo elementais";8339972333;Taip;0;0;8;8
11417;Varpelis;"SPINDULIUKŲ su Valdorfo elementais";25949740589;Taip;0;1;0;1
11418;Varpelis;"SPINDULIUKŲ su Valdorfo elementais";5612986372;Taip;0;4;2;6
11419;Varpelis;"SPINDULIUKŲ su Valdorfo elementais";8433933260;Taip;1;0;3;4
11420;Varpelis;"SPINDULIUKŲ su Valdorfo elementais";2707029719;Taip;0;4;21;25
11421;Varpelis;"SPINDULIUKŲ su Valdorfo elementais";5709007350;Taip;16;0;15;31
11422;Varpelis;"SPINDULIUKŲ su Valdorfo elementais";3245779018;Taip;0;0;21;21
11423;Varpelis;"SPINDULIUKŲ su Valdorfo elementais";7878525896;Taip;0;0;5;5
11424;Varpelis;"SPINDULIUKŲ su Valdorfo elementais";1173244728;Taip;18;0;13;31
11425;Varpelis;"SPINDULIUKŲ su Valdorfo elementais";1653573934;Taip;0;6;3;9
11426;Varpelis;"SPINDULIUKŲ su Valdorfo elementais";1346770075;Ne;0;0;9;9
11427;Varpelis;"SPINDULIUKŲ su Valdorfo elementais";7595060467;Taip;0;0;3;3
11428;Varpelis;"SPINDULIUKŲ su Valdorfo elementais";9262345926;Taip;0;14;11;25
11429;Varpelis;"SPINDULIUKŲ su Valdorfo elementais";2087489370;Taip;0;0;4;4
11430;Varpelis;"SPINDULIUKŲ su Valdorfo elementais";6449284856;Taip;3;5;1;9
11431;Varpelis;"SPINDULIUKŲ su Valdorfo elementais";7936861650;Taip;0;0;2;2
11432;Varpelis;"SPINDULIUKŲ su Valdorfo elementais";8089585177;Taip;0;1;3;4
11433;Varpelis;"SPINDULIUKŲ su Valdorfo elementais";6436892919;Taip;0;1;8;9
11434;Varpelis;"SPINDULIUKŲ su Valdorfo elementais";4534924841;Taip;0;0;2;2
11435;Varpelis;"SPINDULIUKŲ su Valdorfo elementais";9045708140;Taip;0;1;6;7
11436;Varpelis;GINTARĖLIAI;7324486026;Taip;3;0;4;7
11437;Varpelis;GINTARĖLIAI;3935604801;Taip;0;0;1;1
11438;Varpelis;GINTARĖLIAI;4809757370;Taip;14;0;2;16
11439;Varpelis;GINTARĖLIAI;9550088985;Taip;3;0;1;4
11440;Varpelis;GINTARĖLIAI;3700689519;Taip;0;10;5;15
11441;Varpelis;GINTARĖLIAI;8407888084;Taip;0;0;6;6
11442;Varpelis;GINTARĖLIAI;1107774262;Taip;7;3;0;10
11443;Varpelis;GINTARĖLIAI;3678496820;Taip;0;0;6;6
11444;Varpelis;GINTARĖLIAI;4924654232;Taip;3;0;5;8
11445;Varpelis;GINTARĖLIAI;6204554058;Taip;0;7;0;7
11446;Varpelis;GINTARĖLIAI;4481209885;Taip;3;0;0;3
11447;Varpelis;GINTARĖLIAI;2199422694;Taip;0;0;9;9
11448;Varpelis;GINTARĖLIAI;4315014085;Taip;0;0;2;2
11449;Varpelis;PELĖDŽIUKAI;5262773747;Taip;0;0;9;9
11450;Varpelis;PELĖDŽIUKAI;6089254928;Taip;0;0;8;8
11451;Varpelis;PELĖDŽIUKAI;9896632781;Taip;0;0;8;8
11452;Varpelis;PELĖDŽIUKAI;4490849959;Ne;0;0;1;1
11453;Varpelis;PELĖDŽIUKAI;4732652755;Taip;0;0;9;9
11454;Varpelis;PELĖDŽIUKAI;4739862178;Taip;0;0;7;7
11455;Varpelis;PELĖDŽIUKAI;6468535724;Taip;0;0;5;5
11456;Varpelis;PELĖDŽIUKAI;9854077382;Taip;0;0;5;5
11457;Varpelis;PELĖDŽIUKAI;8939331969;Ne;0;0;9;9
11458;Varpelis;PELĖDŽIUKAI;4100828035;Taip;0;0;9;9
11459;Varpelis;PELĖDŽIUKAI;1998060813;Taip;0;0;1;1
11460;Varpelis;PELĖDŽIUKAI;5797702202;Taip;0;0;5;5
11461;Varpelis;PELĖDŽIUKAI;1596721999;Taip;0;0;6;6
11462;Varpelis;PELĖDŽIUKAI;8138104918;Taip;0;0;9;9
11463;Varpelis;PELĖDŽIUKAI;6903057774;Taip;0;0;5;5
11464;Varpelis;PELĖDŽIUKAI;6692168722;Taip;0;0;4;4
11465;Varpelis;PELĖDŽIUKAI;6903390732;Taip;0;0;1;1
11466;Varpelis;PELĖDŽIUKAI;3322053946;Taip;0;0;6;6
11467;Varpelis;AITVARIUKŲ;1400448277;Ne;0;1;3;4
11468;Varpelis;AITVARIUKŲ;6881642069;Taip;0;0;1;1
11469;Varpelis;AITVARIUKŲ;2071258071;Taip;0;0;2;2
11470;Varpelis;AITVARIUKŲ;81074770412;Taip;0;2;1;3
11471;Varpelis;AITVARIUKŲ;26628916017;Taip;4;0;0;4
11472;Varpelis;AITVARIUKŲ;1674256372;Taip;0;0;2;2
11473;Varpelis;AITVARIUKŲ;89651734240;Taip;8;0;1;9
11474;Varpelis;AITVARIUKŲ;1302039063;Taip;0;0;4;4
11475;Varpelis;AITVARIUKŲ;1466287692;Taip;3;0;3;6
11476;Varpelis;AITVARIUKŲ;27956002156;Taip;8;0;2;10
11477;Varpelis;AITVARIUKŲ;20476328528;Taip;0;0;1;1
11478;Varpelis;AITVARIUKŲ;81911931409;Taip;0;0;3;3
11479;Varpelis;AITVARIUKŲ;1282020676;Taip;0;0;4;4
11480;Varpelis;AITVARIUKŲ;1155586072;Taip;0;0;1;1
11481;Varpelis;AITVARIUKŲ;8921296001;Taip;0;0;3;3
11482;Varpelis;AITVARIUKŲ;1122407343;Taip;0;0;3;3
11483;Varpelis;AITVARIUKŲ;1847933922;Taip;0;9;2;11
11484;Varpelis;AITVARIUKŲ;2077024797;Taip;0;0;1;1
11485;Varpelis;AITVARIUKŲ;62973174874;Taip;0;5;0;5
11486;Varpelis;AITVARIUKŲ;17285044154;Taip;0;0;3;3
11487;Varpelis;BITUTĖS;1005905322;Taip;0;5;1;6
11488;Varpelis;BITUTĖS;8224083250;Taip;0;14;1;15
11489;Varpelis;BITUTĖS;7639156840;Taip;0;1;1;2
11490;Varpelis;BITUTĖS;7894929066;Taip;0;10;0;10
11491;Varpelis;BITUTĖS;6004580752;Taip;0;11;0;11
11492;Varpelis;BITUTĖS;3225870950;Taip;0;5;1;6
11493;Varpelis;BITUTĖS;2975306188;Taip;0;0;1;1
11494;Varpelis;BITUTĖS;3216171217;Taip;0;6;1;7
11495;Varpelis;BITUTĖS;9795677397;Taip;0;3;0;3
11496;Varpelis;BITUTĖS;9025614369;Taip;0;0;6;6
11497;Varpelis;BITUTĖS;7137400798;Taip;15;11;0;26
11498;Varpelis;BITUTĖS;6272649584;Taip;7;0;0;7
11499;Varpelis;BITUTĖS;7497169351;Taip;0;6;4;10
11500;Varpelis;BITUTĖS;6325113387;Taip;0;17;11;28
11501;Varpelis;BITUTĖS;8910195286;Taip;0;9;0;9
11502;Varpelis;BITUTĖS;3557362927;Taip;6;0;0;6
11503;Varpelis;BITUTĖS;5994436441;Taip;6;2;0;8
11504;Varpelis;BITUTĖS;9295853884;Taip;0;10;0;10
11505;Varpelis;BITUTĖS;7462297990;Taip;0;1;0;1
11506;Varpelis;BITUTĖS;4811186406;Taip;10;4;1;15
11507;Varpelis;BITUTĖS;9598844152;Taip;0;0;2;2
11508;Varpelis;BITUTĖS;3315895028;Taip;0;0;6;6
11509;Varpelis;BITUTĖS;9539132116;Taip;18;3;0;21
11510;Varpelis;DRUGELIAI;9480364901;Taip;0;0;7;7
11511;Varpelis;DRUGELIAI;4806552843;Taip;19;0;0;19
11512;Varpelis;DRUGELIAI;1339590141;Taip;0;0;18;18
11513;Varpelis;DRUGELIAI;3680663621;Taip;10;0;6;16
11514;Varpelis;DRUGELIAI;3055411665;Taip;3;5;0;8
11515;Varpelis;DRUGELIAI;8177777797;Taip;22;0;0;22
11516;Varpelis;DRUGELIAI;7097450882;Ne;0;0;4;4
11517;Varpelis;DRUGELIAI;7472071198;Taip;7;0;0;7
11518;Varpelis;DRUGELIAI;6397377742;Taip;3;0;0;3
11519;Varpelis;DRUGELIAI;8279318849;Ne;0;7;0;7
11520;Varpelis;DRUGELIAI;5421445517;Taip;0;0;15;15
11521;Varpelis;DRUGELIAI;3533283690;Taip;22;0;0;22
11522;Varpelis;DRUGELIAI;9031908204;Ne;0;0;2;2
11523;Varpelis;DRUGELIAI;1809892533;Taip;20;0;1;21
11524;Varpelis;DRUGELIAI;5721776638;Taip;0;0;6;6
11525;Varpelis;DRUGELIAI;2087032775;Taip;0;0;18;18
11526;Varpelis;ŽIRNIUKŲ;5357387099;Taip;0;5;3;8
11527;Varpelis;ŽIRNIUKŲ;4969180325;Taip;0;0;1;1
11528;Varpelis;ŽIRNIUKŲ;5978994702;Taip;9;0;13;22
11529;Varpelis;ŽIRNIUKŲ;7097909712;Taip;18;0;1;19
11530;Varpelis;ŽIRNIUKŲ;9560973046;Taip;5;0;3;8
11531;Varpelis;ŽIRNIUKŲ;3767484917;Taip;8;0;14;22
11532;Varpelis;ŽIRNIUKŲ;5437400032;Taip;0;0;2;2
11533;Varpelis;ŽIRNIUKŲ;6469177026;Taip;18;0;1;19
11534;Varpelis;ŽIRNIUKŲ;9374503688;Taip;1;0;1;2
11535;Varpelis;ŽIRNIUKŲ;2275090267;Taip;13;0;1;14
11536;Varpelis;ŽIRNIUKŲ;5530898751;Taip;0;0;4;4
11537;Varpelis;ŽIRNIUKŲ;6328135238;Taip;0;0;3;3
11538;Varpelis;ŽIRNIUKŲ;8881790248;Taip;0;0;16;16
11539;Varpelis;ŽIRNIUKŲ;7411776733;Taip;0;0;3;3
11540;Varpelis;ŽIRNIUKŲ;1251914675;Taip;17;0;9;26
11541;Varpelis;ŽIRNIUKŲ;8835279420;Taip;0;0;9;9
11542;Varpelis;ŽIRNIUKŲ;8502345965;Taip;18;0;1;19
11543;Vėjelis;Pumpurėliai;2541077369;Taip;17;0;0;17
11544;Vėjelis;Pumpurėliai;3125815427;Taip;12;0;0;12
11545;Vėjelis;Pumpurėliai;5516672613;Taip;4;2;2;8
11546;Vėjelis;Pumpurėliai;2866394056;Taip;15;0;0;15
11547;Vėjelis;Pumpurėliai;1084415930;Taip;9;0;0;9
11548;Vėjelis;Pumpurėliai;9071878406;Taip;8;0;0;8
11549;Vėjelis;Pumpurėliai;3206025676;Taip;0;1;2;3
11550;Vėjelis;Pumpurėliai;5611813359;Taip;0;1;1;2
11551;Vėjelis;Pumpurėliai;1057586168;Taip;10;1;0;11
11552;Vėjelis;Pumpurėliai;9583495324;Taip;0;2;1;3
11553;Vėjelis;Pumpurėliai;7539681314;Taip;11;1;0;12
11554;Vėjelis;Pumpurėliai;3081923183;Taip;7;0;0;7
11555;Vėjelis;Pumpurėliai;9003601108;Taip;8;0;0;8
11556;Vėjelis;Pumpurėliai;6168648640;Taip;0;1;0;1
11557;Vėjelis;Pumpurėliai;1876663813;Taip;0;6;0;6
11558;Vėjelis;Pumpurėliai;6840643273;Ne;8;4;0;12
11559;Vėjelis;Pumpurėliai;9824130744;Taip;5;5;0;10
11560;Vėjelis;Pumpurėliai;1842552329;Taip;0;22;0;22
11561;Vėjelis;Drugeliai;1978952781;Taip;3;0;0;3
11562;Vėjelis;Drugeliai;8353084814;Taip;0;0;1;1
11563;Vėjelis;Drugeliai;2416832899;Taip;0;0;1;1
11564;Vėjelis;Drugeliai;1494531065;Taip;0;0;3;3
11565;Vėjelis;Drugeliai;2734024890;Taip;20;2;0;22
11566;Vėjelis;Drugeliai;7981032872;Taip;0;22;0;22
11567;Vėjelis;Drugeliai;2000277444;Taip;0;0;2;2
11568;Vėjelis;Drugeliai;7752923796;Taip;0;0;3;3
11569;Vėjelis;Drugeliai;7697394469;Taip;11;0;1;12
11570;Vėjelis;Drugeliai;4066956765;Taip;6;0;2;8
11571;Vėjelis;Drugeliai;2788205363;Taip;0;11;2;13
11572;Vėjelis;Drugeliai;1331334220;Taip;0;2;2;4
11573;Vėjelis;Drugeliai;2151737048;Taip;0;4;0;4
11574;Vėjelis;Drugeliai;3276062426;Taip;8;0;0;8
11575;Vėjelis;Drugeliai;4132824111;Taip;11;0;1;12
11576;Vėjelis;Drugeliai;4473677352;Taip;0;4;0;4
11577;Vėjelis;Malūnėlis;44482585723;Taip;0;2;0;2
11578;Vėjelis;Malūnėlis;12087873516;Taip;0;3;0;3
11579;Vėjelis;Malūnėlis;2282796452;Taip;0;11;0;11
11580;Vėjelis;Malūnėlis;1551143643;Taip;0;4;0;4
11581;Vėjelis;Malūnėlis;41268510292;Taip;0;1;0;1
11582;Vėjelis;Malūnėlis;3910688753;Taip;10;2;0;12
11583;Vėjelis;Malūnėlis;7794899167;Taip;0;1;13;14
11584;Vėjelis;Malūnėlis;1934426525;Taip;5;2;0;7
11585;Vėjelis;Malūnėlis;77205958956;Taip;0;10;0;10
11586;Vėjelis;Malūnėlis;86128256406;Taip;0;8;0;8
11587;Vėjelis;Malūnėlis;44153389025;Taip;0;2;2;4
11588;Vėjelis;Malūnėlis;75596757609;Taip;0;0;9;9
11589;Vėjelis;Malūnėlis;57285479257;Taip;0;1;0;1
11590;Vėjelis;Malūnėlis;64339770365;Taip;0;5;0;5
11591;Vėjelis;Malūnėlis;8198463045;Taip;0;1;0;1
11592;Vėjelis;Malūnėlis;7400967836;Taip;0;2;0;2
11593;Vėjelis;Žvaigždutės;98588113289;Taip;0;9;0;9
11594;Vėjelis;Žvaigždutės;2363974247;Taip;6;0;1;7
11595;Vėjelis;Žvaigždutės;8379298947;Taip;6;0;1;7
11596;Vėjelis;Žvaigždutės;5396347620;Taip;3;3;0;6
11597;Vėjelis;Žvaigždutės;50124109589;Taip;0;2;0;2
11598;Vėjelis;Žvaigždutės;9492690970;Taip;4;0;0;4
11599;Vėjelis;Žvaigždutės;1436893015;Taip;8;1;0;9
11600;Vėjelis;Žvaigždutės;1205392813;Taip;0;10;0;10
11601;Vėjelis;Žvaigždutės;2117924725;Taip;13;0;0;13
11602;Vėjelis;Žvaigždutės;8866974952;Taip;8;1;0;9
11603;Vėjelis;Žvaigždutės;5031781196;Taip;3;0;1;4
11604;Vėjelis;Žvaigždutės;4219672982;Taip;9;0;1;10
11605;Vėjelis;Žvaigždutės;4853650350;Taip;4;4;0;8
11606;Vėjelis;Žvaigždutės;60890519853;Taip;10;1;0;11
11607;Vėjelis;Žvaigždutės;1549518622;Taip;0;15;0;15
11608;Vėjelis;Žvaigždutės;6386092350;Taip;0;16;0;16
11609;Vėjelis;Žvaigždutės;8684461171;Taip;0;10;0;10
11610;Vėjelis;Žvaigždutės;8386409466;Taip;9;11;0;20
11611;Vėjelis;Žvaigždutės;7133454882;Taip;0;8;0;8
11612;Vėjelis;Žvaigždutės;4353239658;Taip;4;0;0;4
11613;Vėjelis;Žvaigždutės;4521161684;Taip;0;6;0;6
11614;Vėjelis;Žvaigždutės;3315240387;Taip;6;0;2;8
11615;Vėjelis;Varpeliai;8389094301;Taip;0;4;1;5
11616;Vėjelis;Varpeliai;90103717718;Taip;0;4;0;4
11617;Vėjelis;Varpeliai;90647333398;Taip;2;0;0;2
11618;Vėjelis;Varpeliai;47143492836;Taip;1;0;2;3
11619;Vėjelis;Varpeliai;56520156825;Taip;0;0;5;5
11620;Vėjelis;Varpeliai;47986392996;Taip;0;0;9;9
11621;Vėjelis;Varpeliai;1990674632;Taip;0;0;1;1
11622;Vėjelis;Varpeliai;4230144743;Taip;0;10;0;10
11623;Vėjelis;Varpeliai;6002719498;Taip;3;9;0;12
11624;Vėjelis;Varpeliai;8973530484;Taip;0;2;6;8
11625;Vėjelis;Varpeliai;3255066035;Taip;11;0;0;11
11626;Vėjelis;Varpeliai;76305473353;Taip;0;0;3;3
11627;Vėjelis;Varpeliai;3485366651;Taip;0;7;0;7
11628;Vėjelis;Varpeliai;69341469387;Ne;0;5;0;5
11629;Vėjelis;Varpeliai;78490601352;Taip;2;0;0;2
11630;Vėjelis;Varpeliai;8949760376;Taip;0;0;6;6
11631;Vėjelis;Varpeliai;86337749074;Taip;0;4;0;4
11632;Vėjelis;Varpeliai;9190085358;Taip;0;15;1;16
11633;Vėjelis;Varpeliai;5139323880;Taip;0;2;0;2
11634;Vėjelis;Varpeliai;41673970488;Taip;0;1;0;1
11635;Vėjelis;Varpeliai;9000966115;Taip;0;10;0;10
11636;Vėjelis;Varpeliai;9395929106;Taip;0;6;0;6
11637;Vėjelis;Pelėdžiukų;1454662113;Taip;2;0;0;2
11638;Vėjelis;Pelėdžiukų;4024898537;Taip;4;0;2;6
11639;Vėjelis;Pelėdžiukų;24011371444;Taip;0;5;1;6
11640;Vėjelis;Pelėdžiukų;1783878104;Taip;8;0;2;10
11641;Vėjelis;Pelėdžiukų;1510415602;Taip;3;9;1;13
11642;Vėjelis;Pelėdžiukų;2042863944;Taip;0;5;0;5
11643;Vėjelis;Pelėdžiukų;5992665537;Ne;0;8;0;8
11644;Vėjelis;Pelėdžiukų;1347855869;Taip;0;0;1;1
11645;Vėjelis;Pelėdžiukų;1518855620;Taip;0;5;0;5
11646;Vėjelis;Pelėdžiukų;4930807661;Taip;0;0;2;2
11647;Vėjelis;Pelėdžiukų;2039179508;Taip;0;1;3;4
11648;Vėjelis;Pelėdžiukų;2128818222;Taip;0;0;6;6
11649;Vėjelis;Pelėdžiukų;1603377234;Taip;3;2;1;6
11650;Vėjelis;Pelėdžiukų;1425008833;Taip;0;1;3;4
11651;Vėjelis;Pelėdžiukų;1359019646;Taip;0;0;5;5
11652;Vėjelis;Pelėdžiukų;2721810040;Taip;0;3;2;5
11653;Vėjelis;Pelėdžiukų;1343084840;Taip;0;4;0;4
11654;Vėjelis;Skruzdeliukų;2167025998;Taip;10;0;3;13
11655;Vėjelis;Skruzdeliukų;2467377103;Taip;0;0;1;1
11656;Vėjelis;Skruzdeliukų;8470977526;Taip;0;0;4;4
11657;Vėjelis;Skruzdeliukų;9434737088;Taip;4;0;2;6
11658;Vėjelis;Skruzdeliukų;1952141664;Taip;7;0;5;12
11659;Vėjelis;Skruzdeliukų;1534169381;Taip;0;8;0;8
11660;Vėjelis;Skruzdeliukų;4992783345;Taip;10;3;0;13
11661;Vėjelis;Skruzdeliukų;2957105835;Ne;0;1;1;2
11662;Vėjelis;Skruzdeliukų;4997987762;Taip;9;0;0;9
11663;Vėjelis;Skruzdeliukų;4412135676;Taip;7;4;2;13
11664;Vėjelis;Skruzdeliukų;8356715925;Ne;0;17;0;17
11665;Vėjelis;Skruzdeliukų;4946988585;Taip;7;1;0;8
11666;Vėjelis;Skruzdeliukų;6408918277;Taip;15;4;0;19
11667;Vėjelis;Skruzdeliukų;7240155487;Taip;13;0;3;16
11668;Vėjelis;Skruzdeliukų;7695719991;Ne;0;0;7;7
11669;Vėjelis;Skruzdeliukų;6618114389;Taip;7;0;3;10
11670;Vėjelis;Skruzdeliukų;1381923971;Taip;0;6;0;6
11671;Vėjelis;Skruzdeliukų;8630131152;Taip;9;0;5;14
11672;Vėjelis;Skruzdeliukų;6431589805;Taip;4;0;0;4
11673;Vėjelis;Pieštukų;4868574574;Taip;0;1;0;1
11674;Vėjelis;Pieštukų;7748975870;Taip;8;0;0;8
11675;Vėjelis;Pieštukų;1956418258;Taip;0;3;0;3
11676;Vėjelis;Pieštukų;9135807341;Taip;5;0;0;5
11677;Vėjelis;Pieštukų;7860576967;Taip;7;0;0;7
11678;Vėjelis;Pieštukų;9546928491;Taip;7;0;2;9
11679;Vėjelis;Pieštukų;8300497094;Taip;0;1;0;1
11680;Vėjelis;Pieštukų;9675488924;Taip;7;0;2;9
11681;Vėjelis;Pieštukų;4884057836;Taip;0;0;8;8
11682;Vėjelis;Pieštukų;3898751303;Taip;10;12;0;22
11683;Vėjelis;Pieštukų;5662728912;Taip;0;0;22;22
11684;Vėjelis;Pieštukų;4101161670;Taip;0;2;0;2
11685;Vėjelis;Pieštukų;3495322620;Taip;0;11;0;11
11686;Vėjelis;Pieštukų;8281508498;Taip;0;0;3;3
11687;Vėjelis;Pieštukų;7046938604;Taip;0;0;1;1
11688;Vėjelis;Pieštukų;7203026860;Taip;10;5;0;15
11689;Vėjelis;Pieštukų;6909799367;Taip;22;0;0;22
11690;Vėjelis;Ramunėlių;5987294293;Taip;0;5;0;5
11691;Vėjelis;Ramunėlių;8047799576;Taip;0;1;0;1
11692;Vėjelis;Ramunėlių;7178844364;Taip;0;5;0;5
11693;Vėjelis;Ramunėlių;2386927970;Taip;11;5;0;16
11694;Vėjelis;Ramunėlių;6996900411;Taip;0;9;0;9
11695;Vėjelis;Ramunėlių;2289954824;Taip;11;4;0;15
11696;Vėjelis;Ramunėlių;4733227215;Taip;1;1;0;2
11697;Vėjelis;Ramunėlių;5909697341;Taip;0;3;0;3
11698;Vėjelis;Ramunėlių;6451722893;Taip;0;12;0;12
11699;Vėjelis;Ramunėlių;3584347608;Taip;3;0;0;3
11700;Vėjelis;Ramunėlių;1381191703;Taip;0;5;0;5
11701;Vėjelis;Ramunėlių;9042329808;Taip;0;1;0;1
11702;Vėjelis;Ramunėlių;4906958328;Taip;15;0;0;15
11703;Vėjelis;Ramunėlių;3453119286;Taip;10;1;0;11
11704;Vėjelis;Nykštukai;1022888418;Taip;5;0;0;5
11705;Vėjelis;Nykštukai;6660799519;Taip;16;0;0;16
11706;Vėjelis;Nykštukai;2522750651;Taip;8;1;0;9
11707;Vėjelis;Nykštukai;4433799070;Taip;0;11;0;11
11708;Vėjelis;Nykštukai;1235788079;Taip;16;0;0;16
11709;Vėjelis;Nykštukai;9625857378;Taip;4;1;0;5
11710;Vėjelis;Nykštukai;8054114720;Taip;0;9;0;9
11711;Vėjelis;Nykštukai;7790713917;Taip;4;1;0;5
11712;Vėjelis;Nykštukai;4745262277;Taip;2;2;0;4
11713;Vėjelis;Nykštukai;6777528441;Taip;0;1;0;1
11714;Vėjelis;Nykštukai;6891260701;Taip;0;3;0;3
11715;Vėjelis;Nykštukai;6889825160;Taip;12;0;0;12
11716;Vėjelis;Nykštukai;4095860464;Taip;0;4;0;4
11717;Vėjelis;Nykštukai;8415686253;Taip;3;0;6;9
11718;Vėjelis;Nykštukai;8986581196;Taip;6;2;8;16
11719;Vėjelis;Nykštukai;1116238331;Taip;0;8;0;8
11720;Vėjelis;Nykštukai;8286070405;Taip;8;1;0;9
11721;Vėjelis;Nykštukai;1674810054;Taip;17;0;0;17
11722;Vėjelis;Nykštukai;2373132607;Taip;3;1;0;4
11723;Vėjelis;BITUTĖS;6824919005;Taip;14;1;0;15
11724;Vėjelis;BITUTĖS;4276237884;Taip;0;17;0;17
11725;Vėjelis;BITUTĖS;3772706363;Taip;0;1;0;1
11726;Vėjelis;BITUTĖS;1834203833;Taip;0;2;4;6
11727;Vėjelis;BITUTĖS;8452132066;Taip;18;0;0;18
11728;Vėjelis;BITUTĖS;9274287800;Taip;3;0;1;4
11729;Vėjelis;BITUTĖS;6283428333;Taip;6;0;0;6
11730;Vėjelis;BITUTĖS;1112394040;Taip;5;0;0;5
11731;Vėjelis;BITUTĖS;6569848405;Taip;0;2;0;2
11732;Vėjelis;BITUTĖS;5619026707;Taip;4;2;1;7
11733;Vėjelis;BITUTĖS;1457373815;Taip;15;0;3;18
11734;Vėjelis;BITUTĖS;8571757635;Taip;0;2;0;2
11735;Vėjelis;BITUTĖS;2656895893;Taip;7;0;0;7
11736;Vėjelis;BITUTĖS;3935611907;Taip;13;2;1;16
11737;Vėjelis;Boruželės;5325081841;Taip;3;0;0;3
11738;Vėjelis;Boruželės;5381588565;Taip;4;4;0;8
11739;Vėjelis;Boruželės;1863210064;Taip;0;7;0;7
11740;Vėjelis;Boruželės;1588345134;Taip;0;16;3;19
11741;Vėjelis;Boruželės;1429496839;Taip;3;2;3;8
11742;Vėjelis;Boruželės;1931659200;Taip;0;12;0;12
11743;Vėjelis;Boruželės;8666759391;Taip;0;2;0;2
11744;Vėjelis;Boruželės;3844131154;Taip;0;0;2;2
11745;Vėjelis;Boruželės;4747466651;Taip;4;4;0;8
11746;Vėjelis;Boruželės;8141198449;Taip;6;2;2;10
11747;Vėjelis;Boruželės;8121537795;Taip;3;4;0;7
11748;Vėjelis;Boruželės;8938491367;Taip;0;6;0;6
11749;Vėjelis;Boruželės;4506243333;Taip;2;1;0;3
11750;Vėjelis;Boruželės;6061966626;Taip;0;5;0;5
11751;Vėjelis;Boruželės;3524350131;Taip;0;1;0;1
11752;Vėjelis;Boruželės;6108049183;Taip;0;2;0;2
11753;Vėtrungė;Debesėlių;3655025938;Taip;5;0;0;5
11754;Vėtrungė;Debesėlių;2825732654;Taip;0;2;0;2
11755;Vėtrungė;Debesėlių;8956375453;Taip;10;0;0;10
11756;Vėtrungė;Debesėlių;7863176604;Taip;2;0;0;2
11757;Vėtrungė;Debesėlių;3179715496;Taip;2;0;0;2
11758;Vėtrungė;Debesėlių;6439014588;Taip;3;6;4;13
11759;Vėtrungė;Debesėlių;9423361592;Taip;0;2;0;2
11760;Vėtrungė;Debesėlių;1191007983;Taip;0;1;0;1
11761;Vėtrungė;Debesėlių;3745680607;Taip;4;0;2;6
11762;Vėtrungė;Debesėlių;9359012317;Taip;10;0;0;10
11763;Vėtrungė;Debesėlių;1807742144;Taip;0;0;3;3
11764;Vėtrungė;Debesėlių;9893842192;Taip;8;0;0;8
11765;Vėtrungė;Debesėlių;3433811829;Taip;0;8;0;8
11766;Vėtrungė;Debesėlių;2136966687;Taip;0;5;0;5
11767;Vėtrungė;Debesėlių;5246813735;Taip;0;0;1;1
11768;Vėtrungė;Debesėlių;5836190044;Taip;0;0;1;1
11769;Vėtrungė;Debesėlių;8957071345;Taip;3;1;0;4
11770;Vėtrungė;Debesėlių;7185104341;Taip;0;0;9;9
11771;Vėtrungė;Zuikių;9332362038;Taip;8;5;0;13
11772;Vėtrungė;Zuikių;9407558097;Taip;3;12;0;15
11773;Vėtrungė;Zuikių;2985829593;Taip;3;2;0;5
11774;Vėtrungė;Zuikių;4121886031;Taip;0;1;0;1
11775;Vėtrungė;Zuikių;7573021445;Taip;0;7;0;7
11776;Vėtrungė;Zuikių;3335047815;Ne;0;6;0;6
11777;Vėtrungė;Zuikių;8157356569;Ne;0;6;0;6
11778;Vėtrungė;Zuikių;9742099165;Taip;0;3;0;3
11779;Vėtrungė;Zuikių;1215953192;Taip;4;12;2;18
11780;Vėtrungė;Zuikių;3908259010;Ne;4;5;0;9
11781;Vėtrungė;Zuikių;1729819557;Taip;0;3;2;5
11782;Vėtrungė;Zuikių;4916692634;Taip;0;10;0;10
11783;Vėtrungė;Zuikių;4197321604;Taip;5;0;0;5
11784;Vėtrungė;Zuikių;1007578933;Taip;12;1;1;14
11785;Vėtrungė;Zuikių;7558548846;Taip;13;1;1;15
11786;Vėtrungė;Zuikių;8742161467;Taip;0;3;2;5
11787;Vėtrungė;Zuikių;2537221101;Taip;25;0;0;25
11788;Vėtrungė;Zuikių;7342250921;Taip;0;13;0;13
11789;Vėtrungė;Zuikių;9248113268;Taip;8;1;2;11
11790;Vėtrungė;Zuikių;7435005821;Ne;0;11;0;11
11791;Vėtrungė;Zuikių;1280823326;Ne;10;10;0;20
11792;Vėtrungė;Drugelių;5366256528;Ne;1;0;0;1
11793;Vėtrungė;Drugelių;5622109033;Taip;6;5;1;12
11794;Vėtrungė;Drugelių;8744050633;Taip;8;0;0;8
11795;Vėtrungė;Drugelių;9444188699;Ne;0;16;0;16
11796;Vėtrungė;Drugelių;7476984763;Taip;3;11;0;14
11797;Vėtrungė;Drugelių;2124476787;Taip;5;5;0;10
11798;Vėtrungė;Drugelių;2970067995;Taip;11;5;0;16
11799;Vėtrungė;Drugelių;4578835070;Taip;17;9;0;26
11800;Vėtrungė;Drugelių;5939537473;Taip;0;30;0;30
11801;Vėtrungė;Drugelių;5251308945;Taip;5;10;0;15
11802;Vėtrungė;Drugelių;9812496068;Taip;0;1;0;1
11803;Vėtrungė;Drugelių;8753387108;Taip;3;0;9;12
11804;Vėtrungė;Drugelių;5289730914;Taip;31;0;0;31
11805;Vėtrungė;Do-re-mi;3278452234;Taip;0;2;2;4
11806;Vėtrungė;Do-re-mi;9324733839;Taip;11;0;0;11
11807;Vėtrungė;Do-re-mi;2287044278;Taip;0;3;0;3
11808;Vėtrungė;Do-re-mi;2928868412;Taip;0;1;1;2
11809;Vėtrungė;Do-re-mi;9518734260;Taip;0;1;2;3
11810;Vėtrungė;Do-re-mi;5430818470;Taip;0;0;4;4
11811;Vėtrungė;Do-re-mi;5832298824;Ne;0;1;0;1
11812;Vėtrungė;Do-re-mi;7895027909;Taip;0;8;0;8
11813;Vėtrungė;Do-re-mi;7483624989;Taip;8;2;0;10
11814;Vėtrungė;Do-re-mi;7807708310;Taip;0;6;4;10
11815;Vėtrungė;Do-re-mi;3200251047;Taip;0;4;0;4
11816;Vėtrungė;Do-re-mi;3369970611;Taip;0;4;0;4
11817;Vėtrungė;Do-re-mi;1808699695;Taip;3;0;8;11
11818;Vėtrungė;Do-re-mi;5217297849;Ne;13;1;0;14
11819;Vėtrungė;Do-re-mi;9079483362;Taip;3;2;0;5
11820;Vėtrungė;Do-re-mi;9271869305;Taip;4;0;6;10
11821;Vėtrungė;Do-re-mi;4709068324;Taip;10;0;1;11
11822;Vėtrungė;Smalsučių;5198153485;Taip;5;5;0;10
11823;Vėtrungė;Smalsučių;9606769599;Ne;14;1;0;15
11824;Vėtrungė;Smalsučių;87686013986;Taip;0;0;1;1
11825;Vėtrungė;Smalsučių;2529102855;Taip;5;0;0;5
11826;Vėtrungė;Smalsučių;1611274573;Taip;0;8;0;8
11827;Vėtrungė;Smalsučių;1529226569;Taip;0;1;0;1
11828;Vėtrungė;Smalsučių;1744400765;Taip;4;2;1;7
11829;Vėtrungė;Smalsučių;7792694801;Ne;11;0;0;11
11830;Vėtrungė;Smalsučių;68628872682;Taip;0;2;0;2
11831;Vėtrungė;Smalsučių;1630866223;Taip;0;0;6;6
11832;Vėtrungė;Smalsučių;78016704795;Taip;0;5;0;5
11833;Vėtrungė;Smalsučių;54494917364;Taip;0;3;1;4
11834;Vėtrungė;Smalsučių;29699317546;Taip;0;0;1;1
11835;Vėtrungė;Smalsučių;1754493671;Ne;5;0;2;7
11836;Vėtrungė;Smalsučių;1360031121;Taip;0;9;0;9
11837;Vėtrungė;Smalsučių;2145081325;Taip;0;0;4;4
11838;Vėtrungė;Smalsučių;1279678980;Taip;0;1;0;1
11839;Vėtrungė;Smalsučių;70610257897;Taip;0;1;0;1
11840;Vėtrungė;Smalsučių;1474010989;Taip;11;5;0;16
11841;Vėtrungė;Gudručių;1662123237;Taip;0;2;0;2
11842;Vėtrungė;Gudručių;1366458234;Taip;3;7;0;10
11843;Vėtrungė;Gudručių;49220186521;Taip;7;1;0;8
11844;Vėtrungė;Gudručių;8857763201;Taip;0;10;0;10
11845;Vėtrungė;Gudručių;1487142899;Taip;0;6;0;6
11846;Vėtrungė;Gudručių;1021458176;Taip;0;2;0;2
11847;Vėtrungė;Gudručių;1267104594;Taip;0;3;0;3
11848;Vėtrungė;Gudručių;6563805572;Taip;0;5;0;5
11849;Vėtrungė;Gudručių;41508942219;Taip;0;8;0;8
11850;Vėtrungė;Gudručių;56266349747;Taip;0;8;0;8
11851;Vėtrungė;Gudručių;1283685496;Taip;0;6;0;6
11852;Vėtrungė;Gudručių;1395153496;Taip;0;12;0;12
11853;Vėtrungė;Gudručių;9395706055;Taip;3;2;0;5
11854;Vėtrungė;Gudručių;1022530443;Taip;0;3;0;3
11855;Vėtrungė;Gudručių;3980104822;Taip;0;7;0;7
11856;Vėtrungė;Gudručių;8080668755;Taip;0;14;0;14
11857;Vėtrungė;Gudručių;1456877681;Taip;22;0;0;22
11858;Vėtrungė;Gudručių;63512524250;Ne;3;10;0;13
11859;Vėtrungė;Kodėlčių;9172488122;Taip;0;4;0;4
11860;Vėtrungė;Kodėlčių;2739382736;Taip;0;19;0;19
11861;Vėtrungė;Kodėlčių;3903604247;Taip;7;0;1;8
11862;Vėtrungė;Kodėlčių;3500551575;Taip;0;2;0;2
11863;Vėtrungė;Kodėlčių;9852609222;Taip;3;8;0;11
11864;Vėtrungė;Kodėlčių;8465132902;Taip;0;9;0;9
11865;Vėtrungė;Kodėlčių;8859592174;Taip;18;0;0;18
11866;Vėtrungė;Kodėlčių;7862615352;Taip;0;6;0;6
11867;Vėtrungė;Kodėlčių;1540045675;Taip;0;17;0;17
11868;Vėtrungė;Kodėlčių;5385880910;Taip;13;2;0;15
11869;Vėtrungė;Kodėlčių;9211406129;Taip;0;3;0;3
11870;Vėtrungė;Kodėlčių;1032730549;Taip;0;2;0;2
11871;Vėtrungė;Kodėlčių;7511121411;Taip;0;7;1;8
11872;Vėtrungė;Kodėlčių;5830221727;Taip;8;4;0;12
11873;Vėtrungė;Kodėlčių;4756863295;Taip;0;15;0;15
11874;Vėtrungė;Kodėlčių;6807838878;Taip;7;1;1;9
11875;Vėtrungė;Paukštelių;7921863675;Taip;0;2;0;2
11876;Vėtrungė;Paukštelių;4091719904;Taip;0;3;0;3
11877;Vėtrungė;Paukštelių;4347810256;Taip;0;2;0;2
11878;Vėtrungė;Paukštelių;2482436192;Taip;3;0;1;4
11879;Vėtrungė;Paukštelių;6732632515;Taip;0;2;0;2
11880;Vėtrungė;Paukštelių;8897558066;Taip;0;8;0;8
11881;Vėtrungė;Paukštelių;3404120492;Taip;0;1;0;1
11882;Vėtrungė;Paukštelių;5994465833;Taip;0;3;0;3
11883;Vėtrungė;Paukštelių;8721035192;Taip;0;11;0;11
11884;Vėtrungė;Paukštelių;6964225210;Taip;0;1;0;1
11885;Vėtrungė;Paukštelių;1970034012;Ne;13;0;0;13
11886;Vėtrungė;Paukštelių;9962435598;Taip;7;2;0;9
11887;Vėtrungė;Paukštelių;4092242233;Taip;0;2;0;2
11888;Vėtrungė;Paukštelių;1522141057;Taip;0;10;0;10
11889;Vėtrungė;Paukštelių;8154023892;Ne;5;4;0;9
11890;Vėtrungė;Viščiukų;3922749661;Taip;0;11;0;11
11891;Vėtrungė;Viščiukų;3744377479;Taip;0;0;8;8
11892;Vėtrungė;Viščiukų;3634995652;Taip;0;0;6;6
11893;Vėtrungė;Viščiukų;5950287989;Taip;11;0;1;12
11894;Vėtrungė;Viščiukų;5539872851;Taip;7;0;0;7
11895;Vėtrungė;Viščiukų;8985054558;Taip;5;0;0;5
11896;Vėtrungė;Viščiukų;2933312366;Taip;5;9;0;14
11897;Vėtrungė;Viščiukų;8013249618;Taip;8;5;0;13
11898;Vėtrungė;Viščiukų;7740260264;Taip;0;0;1;1
11899;Vėtrungė;Viščiukų;2123410772;Taip;14;0;0;14
11900;Vėtrungė;Viščiukų;8905533826;Taip;6;0;0;6
11901;Vėtrungė;Viščiukų;7186353024;Taip;0;0;1;1
11902;Vėtrungė;Viščiukų;5021830780;Taip;0;0;1;1
11903;Vėtrungė;Viščiukų;7958767219;Taip;6;6;0;12
11904;Vėtrungė;Viščiukų;7627170933;Taip;0;22;0;22
11905;Vėtrungė;Nykštukų;9696984346;Taip;0;16;0;16
11906;Vėtrungė;Nykštukų;7819147751;Taip;0;1;0;1
11907;Vėtrungė;Nykštukų;6990506209;Taip;3;0;0;3
11908;Vėtrungė;Nykštukų;2348557463;Taip;3;0;0;3
11909;Vėtrungė;Nykštukų;7733472482;Taip;13;0;0;13
11910;Vėtrungė;Nykštukų;2364156362;Taip;0;9;0;9
11911;Vėtrungė;Nykštukų;8059553343;Taip;17;2;0;19
11912;Vėtrungė;Nykštukų;4020987532;Taip;0;1;0;1
11913;Vėtrungė;Nykštukų;9569555731;Taip;6;2;0;8
11914;Vėtrungė;Nykštukų;7699392279;Taip;0;18;0;18
11915;Vėtrungė;Nykštukų;9773838651;Taip;8;10;0;18
11916;Vėtrungė;Nykštukų;6866720274;Taip;0;4;0;4
11917;Vėtrungė;Meškiukų;2510763357;Taip;3;0;0;3
11918;Vėtrungė;Meškiukų;4713420194;Taip;3;0;0;3
11919;Vėtrungė;Meškiukų;2226654309;Taip;0;3;0;3
11920;Vėtrungė;Meškiukų;9207846866;Taip;2;0;0;2
11921;Vėtrungė;Meškiukų;9065848425;Taip;0;4;0;4
11922;Vėtrungė;Meškiukų;3328447991;Taip;0;8;0;8
11923;Vėtrungė;Meškiukų;9685389270;Ne;0;14;0;14
11924;Vėtrungė;Meškiukų;9313438768;Taip;0;6;0;6
11925;Vėtrungė;Meškiukų;3122948974;Taip;0;8;0;8
11926;Vėtrungė;Meškiukų;2880342138;Taip;0;3;0;3
11927;Vėtrungė;Meškiukų;2520926439;Taip;17;0;0;17
11928;Vėtrungė;Meškiukų;7704497739;Taip;4;7;0;11
11929;Vėtrungė;Meškiukų;7143997258;Taip;0;0;1;1
11930;Vėtrungė;Meškiukų;8961791293;Taip;0;5;0;5
11931;Vėtrungė;Meškiukų;2809555356;Taip;8;0;1;9
11932;Vėtrungė;Meškiukų;4624264759;Taip;2;0;0;2
11933;Vėtrungė;Meškiukų;1766599777;Ne;14;0;0;14
11934;Vėtrungė;Meškiukų;4394100006;Taip;12;0;2;14
11935;Vėtrungė;Ąžuoliukų;2471926240;Taip;0;5;0;5
11936;Vėtrungė;Ąžuoliukų;3249689008;Taip;0;1;0;1
11937;Vėtrungė;Ąžuoliukų;7295216791;Taip;0;6;0;6
11938;Vėtrungė;Ąžuoliukų;2440001662;Taip;0;7;0;7
11939;Vėtrungė;Ąžuoliukų;7803736567;Taip;5;1;0;6
11940;Vėtrungė;Ąžuoliukų;1042333710;Ne;0;18;0;18
11941;Vėtrungė;Ąžuoliukų;16216365941;Taip;0;5;0;5
11942;Vėtrungė;Ąžuoliukų;2636219826;Taip;5;6;0;11
11943;Vėtrungė;Ąžuoliukų;4000379945;Taip;0;8;0;8
11944;Vėtrungė;Ąžuoliukų;1789419548;Ne;0;16;0;16
11945;Vėtrungė;Ąžuoliukų;6599281163;Taip;0;5;0;5
11946;Vilnelė;Lakštutė;1720695615;Taip;0;1;0;1
11947;Vilnelė;Lakštutė;2121071276;Taip;0;10;0;10
11948;Vilnelė;Lakštutė;85074719873;Taip;3;4;0;7
11949;Vilnelė;Lakštutė;8820091584;Taip;6;0;0;6
11950;Vilnelė;Lakštutė;8270866998;Taip;0;16;0;16
11951;Vilnelė;Lakštutė;2990112955;Taip;4;0;0;4
11952;Vilnelė;Lakštutė;8593060923;Taip;0;0;5;5
11953;Vilnelė;Lakštutė;9369955153;Taip;0;21;1;22
11954;Vilnelė;Lakštutė;6155522893;Taip;10;0;0;10
11955;Vilnelė;Lakštutė;6318246517;Taip;13;0;0;13
11956;Vilnelė;Lakštutė;7387394504;Taip;0;9;0;9
11957;Vilnelė;Lakštutė;1882520335;Taip;6;1;0;7
11958;Vilnelė;Lakštutė;5558584030;Taip;0;1;1;2
11959;Vilnelė;Lakštutė;1151879281;Taip;10;2;1;13
11960;Vilnelė;Lakštutė;8843094480;Taip;11;0;0;11
11961;Vilnelė;Lakštutė;2339319344;Taip;3;12;0;15
11962;Vilnelė;Vyturėlis;5091272908;Taip;3;2;1;6
11963;Vilnelė;Vyturėlis;1133945467;Ne;6;0;5;11
11964;Vilnelė;Vyturėlis;6132739519;Ne;0;5;0;5
11965;Vilnelė;Vyturėlis;1674551092;Taip;0;3;0;3
11966;Vilnelė;Vyturėlis;2131599015;Taip;0;8;0;8
11967;Vilnelė;Vyturėlis;18740103706;Taip;5;4;0;9
11968;Vilnelė;Vyturėlis;7057183482;Taip;5;0;0;5
11969;Vilnelė;Vyturėlis;8725191514;Taip;3;2;1;6
11970;Vilnelė;Vyturėlis;6308015852;Taip;0;1;0;1
11971;Vilnelė;Vyturėlis;7963783957;Taip;3;0;0;3
11972;Vilnelė;Vyturėlis;1545570307;Taip;0;1;0;1
11973;Vilnelė;Vyturėlis;5540359276;Taip;0;2;6;8
11974;Vilnelė;Vyturėlis;1966090625;Taip;0;1;0;1
11975;Vilnelė;Vyturėlis;8740717061;Taip;6;5;0;11
11976;Vilnelė;Vyturėlis;3772263873;Taip;0;10;0;10
11977;Vilnelė;Vyturėlis;9183391434;Taip;4;3;0;7
11978;Vilnelė;Vyturėlis;2159103903;Taip;0;4;0;4
11979;Vilnelė;Vyturėlis;4210511566;Taip;16;0;0;16
11980;Vilnelė;Vyturėlis;2891787022;Taip;3;0;0;3
11981;Vilnelė;Pagrandukas;5508759323;Taip;13;1;1;15
11982;Vilnelė;Pagrandukas;2144925171;Taip;4;0;0;4
11983;Vilnelė;Pagrandukas;4295816753;Taip;0;3;0;3
11984;Vilnelė;Pagrandukas;3844066232;Taip;0;3;0;3
11985;Vilnelė;Pagrandukas;6659537454;Taip;0;20;0;20
11986;Vilnelė;Pagrandukas;5953205533;Taip;0;22;0;22
11987;Vilnelė;Pagrandukas;4448413194;Taip;2;2;1;5
11988;Vilnelė;Pagrandukas;6830433856;Taip;0;1;0;1
11989;Vilnelė;Pagrandukas;4664946923;Taip;3;0;0;3
11990;Vilnelė;Pagrandukas;6982847450;Taip;0;1;0;1
11991;Vilnelė;Pagrandukas;7560124407;Taip;0;1;7;8
11992;Vilnelė;Pagrandukas;3685294539;Taip;4;0;0;4
11993;Vilnelė;Pagrandukas;7348404699;Taip;0;7;0;7
11994;Vilnelė;Pagrandukas;3323738649;Taip;0;2;0;2
11995;Vilnelė;Pagrandukas;8116613831;Taip;0;2;0;2
11996;Vilnelė;Pagrandukas;9489760844;Taip;12;0;0;12
11997;Vilnelė;Pagrandukas;6466321228;Taip;0;7;0;7
11998;Vilnelė;Pagrandukas;4478847902;Taip;0;11;0;11
11999;Vilnelė;Bitutė;7442249956;Ne;5;5;1;11
12000;Vilnelė;Bitutė;5790420711;Taip;0;2;0;2
12001;Vilnelė;Bitutė;1321202650;Taip;0;10;0;10
12002;Vilnelė;Bitutė;8889469645;Taip;3;10;0;13
12003;Vilnelė;Bitutė;9331404812;Taip;0;15;0;15
12004;Vilnelė;Bitutė;2696565855;Taip;0;8;0;8
12005;Vilnelė;Bitutė;11702051319;Taip;0;4;0;4
12006;Vilnelė;Bitutė;20639648308;Taip;0;1;0;1
12007;Vilnelė;Bitutė;64066480740;Taip;0;6;0;6
12008;Vilnelė;Bitutė;71906228270;Ne;0;2;0;2
12009;Vilnelė;Bitutė;41536662155;Taip;0;3;0;3
12010;Vilnelė;Bitutė;7916632244;Taip;0;3;0;3
12011;Vilnelė;Bitutė;85568332595;Taip;0;4;0;4
12012;Vilnelė;Bitutė;16272480270;Taip;0;7;6;13
12013;Vilnelė;Bitutė;1450994872;Taip;0;2;4;6
12014;Vilnelė;Bitutė;67561845041;Taip;0;5;0;5
12015;Vilnelė;Bitutė;69413564937;Taip;0;5;0;5
12016;Vilnelė;Bitutė;22516605873;Taip;0;6;0;6
12017;Vilnelė;Bitutė;1859757115;Taip;0;2;3;5
12018;Vilnelė;Bitutė;55974182996;Taip;0;8;0;8
12019;Vilnelė;Bitutė;73658263243;Taip;0;17;0;17
12020;Vilnelė;Bitutė;1607330769;Taip;0;8;0;8
12021;Vilnelė;Šaltinėlis;1783854203;Taip;3;0;1;4
12022;Vilnelė;Šaltinėlis;5013418313;Taip;0;3;0;3
12023;Vilnelė;Šaltinėlis;42835212158;Taip;14;8;0;22
12024;Vilnelė;Šaltinėlis;98028664140;Taip;0;10;0;10
12025;Vilnelė;Šaltinėlis;7292043157;Taip;0;15;0;15
12026;Vilnelė;Šaltinėlis;2130482375;Taip;0;9;0;9
12027;Vilnelė;Šaltinėlis;4480175299;Taip;0;6;0;6
12028;Vilnelė;Šaltinėlis;9058632601;Taip;0;8;0;8
12029;Vilnelė;Šaltinėlis;5932200003;Taip;0;0;7;7
12030;Vilnelė;Šaltinėlis;1507865281;Taip;0;16;0;16
12031;Vilnelė;Šaltinėlis;39494954188;Taip;0;8;0;8
12032;Vilnelė;Šaltinėlis;8615257084;Taip;0;2;1;3
12033;Vilnelė;Šaltinėlis;6146514112;Taip;0;7;0;7
12034;Vilnelė;Šaltinėlis;9016832316;Taip;0;0;8;8
12035;Vilnelė;Šaltinėlis;1281521052;Taip;18;10;0;28
12036;Vilnelė;Šaltinėlis;8162191913;Ne;0;1;0;1
12037;Vilnelė;Šaltinėlis;3031790547;Ne;0;2;0;2
12038;Vilnelė;Šaltinėlis;8774842903;Taip;4;1;0;5
12039;Vilnelė;Šaltinėlis;7592040226;Taip;0;10;0;10
12040;Vilnelė;Riešutėllis;1027463000;Taip;0;3;1;4
12041;Vilnelė;Riešutėllis;7020707723;Taip;22;10;0;32
12042;Vilnelė;Riešutėllis;1960860528;Taip;1;0;0;1
12043;Vilnelė;Riešutėllis;4203549404;Taip;11;10;4;25
12044;Vilnelė;Riešutėllis;3290952017;Taip;0;10;0;10
12045;Vilnelė;Riešutėllis;8588430578;Taip;0;12;0;12
12046;Vilnelė;Riešutėllis;7957695470;Taip;0;10;1;11
12047;Vilnelė;Riešutėllis;8750705826;Taip;6;10;0;16
12048;Vilnelė;Riešutėllis;4780827432;Taip;0;7;0;7
12049;Vilnelė;Riešutėllis;4455099179;Taip;0;7;0;7
12050;Vilnelė;Riešutėllis;2367127222;Taip;0;8;0;8
12051;Vilnelė;Riešutėllis;5306723959;Taip;3;12;0;15
12052;Vilnelė;Riešutėllis;3670613082;Taip;0;7;6;13
12053;Vilnelė;Riešutėllis;6417545510;Taip;9;5;0;14
12054;Vilnelė;Riešutėllis;7085972543;Taip;3;0;0;3
12055;Vilnelė;Riešutėllis;3211657057;Taip;0;3;0;3
12056;Vilnelė;Riešutėllis;9016866597;Taip;0;20;0;20
12057;Vilnelė;Riešutėllis;7087798406;Taip;5;10;0;15
12058;Vilnelė;Riešutėllis;4254744025;Ne;0;22;0;22
12059;Vilnelė;Riešutėllis;3730997665;Taip;6;8;0;14
12060;Vilnelė;Riešutėllis;2706699572;Taip;7;5;0;12
12061;Vilnelė;Nykštukas;1336497125;Taip;0;5;3;8
12062;Vilnelė;Nykštukas;34859308729;Taip;0;7;2;9
12063;Vilnelė;Nykštukas;32988468324;Taip;0;12;0;12
12064;Vilnelė;Nykštukas;89748262997;Taip;3;0;0;3
12065;Vilnelė;Nykštukas;87406093438;Taip;3;0;0;3
12066;Vilnelė;Nykštukas;13583637193;Taip;0;8;0;8
12067;Vilnelė;Nykštukas;23442711820;Taip;11;6;0;17
12068;Vilnelė;Nykštukas;47863474499;Taip;0;10;0;10
12069;Vilnelė;Nykštukas;13231410969;Taip;0;1;1;2
12070;Vilnelė;Nykštukas;62208863766;Taip;0;5;0;5
12071;Vilnelė;Nykštukas;36905818484;Taip;0;5;0;5
12072;Vilnelė;Nykštukas;1845336128;Taip;0;5;0;5
12073;Vilnelė;Nykštukas;87094375121;Taip;10;6;0;16
12074;Vilnelė;Nykštukas;42526993637;Taip;1;6;1;8
12075;Vilnelė;Nykštukas;58422521907;Taip;0;4;1;5
12076;Vilnelė;Nykštukas;15265621906;Taip;0;12;0;12
12077;Vilnelė;Nykštukas;5198859945;Taip;0;2;0;2
12078;Vilnelė;Nykštukas;2131603460;Taip;0;22;0;22
12079;Vilnelė;Nykštukas;2097945353;Ne;0;6;0;6
12080;Vilnelė;Nykštukas;1957418704;Taip;0;17;0;17
12081;Vilnelė;Nykštukas;1572818047;Taip;0;3;0;3
12082;Vilnelė;Nykštukas;9542826636;Ne;0;1;0;1
12083;Vilnelė;Nykštukas;66992481918;Taip;0;10;0;10
12084;Vilnelė;Pieštukas;9879688569;Taip;0;2;0;2
12085;Vilnelė;Pieštukas;5473379559;Taip;5;2;0;7
12086;Vilnelė;Pieštukas;1462397783;Taip;0;7;0;7
12087;Vilnelė;Pieštukas;1792586468;Taip;4;1;0;5
12088;Vilnelė;Pieštukas;3781595939;Taip;0;9;0;9
12089;Vilnelė;Pieštukas;9884955712;Taip;2;0;0;2
12090;Vilnelė;Pieštukas;2479090686;Taip;0;11;0;11
12091;Vilnelė;Pieštukas;3945921490;Taip;0;10;0;10
12092;Vilnelė;Pieštukas;1975954784;Ne;0;2;0;2
12093;Vilnelė;Pieštukas;1730149127;Taip;0;1;0;1
12094;Vilnelė;Pieštukas;6355912551;Taip;4;0;0;4
12095;Vilnelė;Pieštukas;7976798775;Taip;0;2;0;2
12096;Vilnelė;Pieštukas;3811289758;Taip;3;5;0;8
12097;Vilnelė;Pieštukas;3529718234;Taip;0;6;0;6
12098;Vilnelė;Pieštukas;1880318663;Taip;0;9;0;9
12099;Vilnelė;Pieštukas;9589410276;Taip;0;9;0;9
12100;Vilnelė;Pieštukas;4718994967;Taip;0;14;0;14
12101;Vilnelė;Pieštukas;8092642447;Ne;0;1;0;1
12102;Vilnelė;Pieštukas;3856917286;Taip;0;20;0;20
12103;Vilnelė;Voverytė;7536603663;Ne;0;2;3;5
12104;Vilnelė;Voverytė;7388336851;Taip;0;2;0;2
12105;Vilnelė;Voverytė;8667403338;Taip;14;2;0;16
12106;Vilnelė;Voverytė;7883724600;Taip;0;10;0;10
12107;Vilnelė;Voverytė;1351798589;Taip;0;5;0;5
12108;Vilnelė;Voverytė;6342242777;Taip;0;3;0;3
12109;Vilnelė;Voverytė;3843064564;Taip;0;1;0;1
12110;Vilnelė;Voverytė;3558073399;Taip;0;9;0;9
12111;Vilnelė;Voverytė;2841315531;Taip;0;0;4;4
12112;Vilnelė;Voverytė;9804772168;Taip;0;0;1;1
12113;Vilnelė;Voverytė;1596625263;Taip;7;0;0;7
12114;Vilnelė;Voverytė;7338573817;Taip;11;0;1;12
12115;Vilnelė;Voverytė;8121075430;Taip;0;6;0;6
12116;Vilnelė;Voverytė;1574809879;Taip;11;2;2;15
12117;Vilnelė;Voverytė;6083082959;Taip;0;2;0;2
12118;Vilnelė;Voverytė;2788449626;Taip;0;1;0;1
12119;Vilnelė;Kodėlčiukas;4642378600;Taip;0;1;0;1
12120;Vilnelė;Kodėlčiukas;8415801333;Taip;5;5;0;10
12121;Vilnelė;Kodėlčiukas;6618109352;Taip;0;20;0;20
12122;Vilnelė;Kodėlčiukas;6715997340;Taip;5;5;0;10
12123;Vilnelė;Kodėlčiukas;9482133396;Taip;8;1;1;10
12124;Vilnelė;Kodėlčiukas;8620789304;Taip;10;0;0;10
12125;Vilnelė;Kodėlčiukas;8439505238;Taip;0;2;0;2
12126;Vilnelė;Kodėlčiukas;1580287517;Taip;0;3;0;3
12127;Vilnelė;Kodėlčiukas;4328263940;Taip;3;2;0;5
12128;Vilnelė;Kodėlčiukas;3056845279;Taip;0;18;0;18
12129;Vilnelė;Kodėlčiukas;9537740492;Taip;11;1;3;15
12130;Vilnelė;Kodėlčiukas;9640330864;Taip;10;3;3;16
12131;Vilnelė;Kodėlčiukas;3848720970;Taip;0;0;3;3
12132;Vilnelė;Kodėlčiukas;7833531435;Taip;0;2;0;2
12133;Vilnelė;Kodėlčiukas;5961910077;Taip;0;0;1;1
12134;Vilnelė;Kodėlčiukas;3115242919;Taip;0;5;0;5
12135;Vilnelė;Kodėlčiukas;8543995029;Taip;13;3;4;20
12136;Vilnelė;Kodėlčiukas;1933660272;Taip;0;22;0;22
12137;Vilnelė;Kodėlčiukas;4986079102;Taip;0;1;0;1
12138;Vilnelė;Kodėlčiukas;5398303580;Taip;5;0;0;5
12139;Vilnelė;Kodėlčiukas;9418661965;Taip;0;2;0;2
12140;Vilnelė;Žirniukas;1547117566;Taip;2;5;0;7
12141;Vilnelė;Žirniukas;4427383755;Taip;2;5;0;7
12142;Vilnelė;Žirniukas;1554473199;Taip;0;2;1;3
12143;Vilnelė;Žirniukas;6249731759;Taip;0;16;0;16
12144;Vilnelė;Žirniukas;5554451335;Taip;14;0;0;14
12145;Vilnelė;Žirniukas;1762024490;Taip;0;5;0;5
12146;Vilnelė;Žirniukas;4060927733;Taip;14;0;0;14
12147;Vilnelė;Žirniukas;2299381653;Taip;0;21;0;21
12148;Vilnelė;Žirniukas;4516818999;Taip;3;11;0;14
12149;Vilnelė;Žirniukas;8579294202;Taip;0;16;0;16
12150;Vilnelė;Žirniukas;7702217893;Taip;4;0;0;4
12151;Vilnelė;Žirniukas;2157793186;Taip;6;0;1;7
12152;Vilnelė;Žirniukas;8201829887;Taip;3;6;0;9
12153;Vilnelė;Pipiras;6686896190;Taip;4;2;0;6
12154;Vilnelė;Pipiras;6054488692;Taip;4;0;0;4
12155;Vilnelė;Pipiras;2872732978;Taip;14;1;0;15
12156;Vilnelė;Pipiras;3900484348;Taip;2;0;0;2
12157;Vilnelė;Pipiras;3221157300;Taip;0;22;0;22
12158;Vilnelė;Pipiras;7161529969;Taip;10;0;0;10
12159;Vilnelė;Pipiras;3720979747;Taip;0;1;0;1
12160;Vilnelė;Pipiras;5173602064;Taip;4;2;0;6
12161;Vilnelė;Pipiras;3142594542;Taip;4;1;0;5
12162;Vilnelė;Pipiras;3032273912;Taip;7;10;0;17
12163;Vilnelė;Pipiras;1734277231;Taip;0;5;0;5
12164;Vilnelė;Pipiras;5498574366;Taip;0;9;0;9
12165;Vilnelė;Pipiras;1500899512;Taip;4;0;0;4
12166;Vilnelė;Pipiras;8837662451;Taip;22;0;0;22
12167;Vilnelė;Pipiras;8630048961;Ne;0;8;0;8
12168;Vėrinėlis;GAIDELIAI;2529641529;Taip;0;10;0;10
12169;Vėrinėlis;GAIDELIAI;4390098560;Taip;0;17;1;18
12170;Vėrinėlis;GAIDELIAI;4666918175;Taip;0;0;1;1
12171;Vėrinėlis;GAIDELIAI;2774618380;Ne;0;4;0;4
12172;Vėrinėlis;GAIDELIAI;5429955166;Taip;0;14;0;14
12173;Vėrinėlis;GAIDELIAI;6136232912;Taip;0;18;0;18
12174;Vėrinėlis;GAIDELIAI;7092421890;Taip;0;4;0;4
12175;Vėrinėlis;GAIDELIAI;6058712578;Taip;0;10;0;10
12176;Vėrinėlis;GAIDELIAI;1164396960;Taip;0;2;0;2
12177;Vėrinėlis;GAIDELIAI;2857591912;Taip;0;5;0;5
12178;Vėrinėlis;GAIDELIAI;6413701823;Taip;0;1;1;2
12179;Vėrinėlis;GAIDELIAI;7963866641;Taip;0;18;0;18
12180;Vėrinėlis;GAIDELIAI;2467700639;Taip;9;10;0;19
12181;Vėrinėlis;GAIDELIAI;5720076968;Taip;7;6;1;14
12182;Vėrinėlis;GAIDELIAI;4183077476;Taip;0;20;0;20
12183;Vėrinėlis;GAIDELIAI;2364117224;Taip;0;2;2;4
12184;Vėrinėlis;GAIDELIAI;4856589410;Taip;9;14;0;23
12185;Vėrinėlis;GAIDELIAI;1339847370;Taip;5;21;0;26
12186;Vėrinėlis;GAIDELIAI;5429372946;Taip;22;10;0;32
12187;Vėrinėlis;SAULUTĖ;6866592245;Taip;6;0;0;6
12188;Vėrinėlis;SAULUTĖ;2732572235;Taip;0;7;3;10
12189;Vėrinėlis;SAULUTĖ;1386916991;Taip;5;0;3;8
12190;Vėrinėlis;SAULUTĖ;7224418233;Taip;3;10;0;13
12191;Vėrinėlis;SAULUTĖ;3130841241;Taip;0;5;0;5
12192;Vėrinėlis;SAULUTĖ;6435612222;Taip;0;9;0;9
12193;Vėrinėlis;SAULUTĖ;3316897176;Taip;0;11;0;11
12194;Vėrinėlis;SAULUTĖ;3810261864;Taip;1;0;0;1
12195;Vėrinėlis;SAULUTĖ;4191386053;Taip;0;1;0;1
12196;Vėrinėlis;SAULUTĖ;9798993200;Taip;0;1;0;1
12197;Vėrinėlis;SAULUTĖ;9612956692;Taip;0;9;0;9
12198;Vėrinėlis;SAULUTĖ;8238013636;Taip;8;5;0;13
12199;Vėrinėlis;SAULUTĖ;7273090217;Taip;0;1;1;2
12200;Vėrinėlis;SAULUTĖ;2337883071;Taip;10;0;1;11
12201;Vėrinėlis;SAULUTĖ;6913001318;Taip;0;5;0;5
12202;Vėrinėlis;SAULUTĖ;4728119881;Taip;7;0;0;7
12203;Vėrinėlis;SAULUTĖ;3882915774;Taip;0;7;0;7
12204;Vėrinėlis;SAULUTĖ;2090334618;Taip;5;5;0;10
12205;Vėrinėlis;SAULUTĖ;7440020169;Taip;0;12;0;12
12206;Vėrinėlis;NYKŠTUKAI;8755231814;Taip;0;3;0;3
12207;Vėrinėlis;NYKŠTUKAI;9604483237;Taip;0;0;4;4
12208;Vėrinėlis;NYKŠTUKAI;6220653152;Taip;0;2;0;2
12209;Vėrinėlis;NYKŠTUKAI;7981261038;Taip;0;8;0;8
12210;Vėrinėlis;NYKŠTUKAI;1395590011;Taip;0;0;3;3
12211;Vėrinėlis;NYKŠTUKAI;19865450007;Taip;8;0;0;8
12212;Vėrinėlis;NYKŠTUKAI;3975934329;Taip;0;3;2;5
12213;Vėrinėlis;NYKŠTUKAI;5511584499;Taip;0;14;0;14
12214;Vėrinėlis;NYKŠTUKAI;4958359640;Taip;8;0;0;8
12215;Vėrinėlis;NYKŠTUKAI;3562371502;Taip;7;0;0;7
12216;Vėrinėlis;NYKŠTUKAI;9751037428;Taip;0;8;0;8
12217;Vėrinėlis;NYKŠTUKAI;8579819581;Taip;0;9;0;9
12218;Vėrinėlis;NYKŠTUKAI;7371908331;Taip;8;1;4;13
12219;Vėrinėlis;NYKŠTUKAI;6392625405;Ne;4;4;0;8
12220;Vėrinėlis;NYKŠTUKAI;5209398043;Taip;0;7;0;7
12221;Vėrinėlis;BURATINAS;4067153819;Taip;0;13;0;13
12222;Vėrinėlis;BURATINAS;9119967823;Taip;7;1;0;8
12223;Vėrinėlis;BURATINAS;5712568063;Taip;9;0;1;10
12224;Vėrinėlis;BURATINAS;1467899937;Taip;0;7;1;8
12225;Vėrinėlis;BURATINAS;7634939364;Taip;0;6;0;6
12226;Vėrinėlis;BURATINAS;6108187043;Taip;2;4;0;6
12227;Vėrinėlis;BURATINAS;3049346950;Taip;13;0;4;17
12228;Vėrinėlis;BURATINAS;8652292752;Taip;0;10;0;10
12229;Vėrinėlis;BURATINAS;4039903678;Taip;0;0;2;2
12230;Vėrinėlis;BURATINAS;7167034587;Taip;0;0;1;1
12231;Vėrinėlis;BURATINAS;7093959212;Taip;0;0;5;5
12232;Vėrinėlis;BURATINAS;3729926575;Taip;8;0;9;17
12233;Vėrinėlis;BURATINAS;8728166391;Taip;8;0;2;10
12234;Vėrinėlis;BURATINAS;7078114492;Taip;0;2;0;2
12235;Vėrinėlis;BURATINAS;6280508974;Taip;0;1;0;1
12236;Vėrinėlis;BURATINAS;3369668445;Taip;0;12;0;12
12237;Vėrinėlis;BURATINAS;9511678036;Taip;0;0;1;1
12238;Vėrinėlis;GINTARĖLIAI;1465052758;Taip;3;0;0;3
12239;Vėrinėlis;GINTARĖLIAI;97559214584;Taip;0;13;0;13
12240;Vėrinėlis;GINTARĖLIAI;8197177876;Taip;8;0;0;8
12241;Vėrinėlis;GINTARĖLIAI;22535431362;Taip;0;1;0;1
12242;Vėrinėlis;GINTARĖLIAI;1029210296;Taip;0;6;0;6
12243;Vėrinėlis;GINTARĖLIAI;1791124205;Taip;0;2;0;2
12244;Vėrinėlis;GINTARĖLIAI;92480758419;Taip;0;2;0;2
12245;Vėrinėlis;GINTARĖLIAI;8955109359;Taip;0;1;0;1
12246;Vėrinėlis;GINTARĖLIAI;63333257753;Taip;0;2;0;2
12247;Vėrinėlis;GINTARĖLIAI;38428514086;Taip;0;4;0;4
12248;Vėrinėlis;GINTARĖLIAI;7436873997;Taip;0;5;0;5
12249;Vėrinėlis;GINTARĖLIAI;41029899086;Taip;0;1;0;1
12250;Vėrinėlis;GINTARĖLIAI;27431479888;Taip;6;0;0;6
12251;Vėrinėlis;GINTARĖLIAI;1592544116;Taip;0;9;0;9
12252;Vėrinėlis;GINTARĖLIAI;11459693163;Taip;0;4;0;4
12253;Vėrinėlis;GINTARĖLIAI;1261337457;Taip;0;9;0;9
12254;Vėrinėlis;GINTARĖLIAI;2001903188;Taip;0;1;0;1
12255;Vėrinėlis;GINTARĖLIAI;1518907235;Taip;0;7;0;7
12256;Vėrinėlis;GINTARĖLIAI;3563944204;Taip;0;2;0;2
12257;Vėrinėlis;RAMUNĖLĖS;68073702260;Taip;0;0;1;1
12258;Vėrinėlis;RAMUNĖLĖS;1803838403;Taip;0;0;1;1
12259;Vėrinėlis;RAMUNĖLĖS;71830611159;Taip;0;1;0;1
12260;Vėrinėlis;RAMUNĖLĖS;39153716711;Taip;2;2;0;4
12261;Vėrinėlis;RAMUNĖLĖS;1086306523;Ne;0;0;4;4
12262;Vėrinėlis;RAMUNĖLĖS;6148700823;Taip;0;9;0;9
12263;Vėrinėlis;RAMUNĖLĖS;4415030161;Taip;0;11;0;11
12264;Vėrinėlis;RAMUNĖLĖS;8620836106;Taip;14;0;1;15
12265;Vėrinėlis;RAMUNĖLĖS;84391578139;Taip;9;0;0;9
12266;Vėrinėlis;RAMUNĖLĖS;5003344894;Taip;6;0;3;9
12267;Vėrinėlis;RAMUNĖLĖS;9500715949;Ne;0;1;0;1
12268;Vėrinėlis;RAMUNĖLĖS;9391697537;Taip;3;0;2;5
12269;Vėrinėlis;RAMUNĖLĖS;5434506594;Taip;7;0;0;7
12270;Vėrinėlis;RAMUNĖLĖS;5041189990;Taip;0;4;0;4
12271;Vėrinėlis;RAMUNĖLĖS;1047139776;Taip;0;10;0;10
12272;Vėrinėlis;KODELČIUKŲ;95040879760;Taip;0;0;3;3
12273;Vėrinėlis;KODELČIUKŲ;7070058961;Taip;0;6;0;6
12274;Vėrinėlis;KODELČIUKŲ;3308843618;Taip;0;4;0;4
12275;Vėrinėlis;KODELČIUKŲ;79317384797;Taip;0;4;0;4
12276;Vėrinėlis;KODELČIUKŲ;1535567719;Taip;10;5;0;15
12277;Vėrinėlis;KODELČIUKŲ;54666417396;Taip;4;0;0;4
12278;Vėrinėlis;KODELČIUKŲ;65408541019;Taip;0;2;0;2
12279;Vėrinėlis;KODELČIUKŲ;67987598880;Taip;0;1;0;1
12280;Vėrinėlis;KODELČIUKŲ;7431541945;Taip;0;2;0;2
12281;Vėrinėlis;KODELČIUKŲ;3703886468;Taip;5;0;2;7
12282;Vėrinėlis;KODELČIUKŲ;1028568095;Taip;0;5;0;5
12283;Vėrinėlis;KODELČIUKŲ;54361215161;Taip;0;0;1;1
12284;Vėrinėlis;KODELČIUKŲ;8755941866;Taip;3;1;0;4
12285;Vėrinėlis;KODELČIUKŲ;9686481278;Taip;0;0;1;1
12286;Vėrinėlis;KODELČIUKŲ;42298331453;Taip;0;1;0;1
12287;Vėrinėlis;KODELČIUKŲ;8709714647;Taip;0;0;3;3
12288;Vėrinėlis;ŽIRNIUKAI;3074835599;Taip;0;4;2;6
12289;Vėrinėlis;ŽIRNIUKAI;1769852084;Taip;6;1;1;8
12290;Vėrinėlis;ŽIRNIUKAI;4718732261;Taip;0;5;0;5
12291;Vėrinėlis;ŽIRNIUKAI;2815770695;Taip;0;4;2;6
12292;Vėrinėlis;ŽIRNIUKAI;8329989952;Taip;8;5;0;13
12293;Vėrinėlis;ŽIRNIUKAI;8824435889;Taip;3;5;3;11
12294;Vėrinėlis;ŽIRNIUKAI;4752902173;Taip;0;8;0;8
12295;Vėrinėlis;ŽIRNIUKAI;7237945125;Taip;0;5;0;5
12296;Vėrinėlis;ŽIRNIUKAI;5600815908;Taip;7;0;4;11
12297;Vėrinėlis;ŽIRNIUKAI;6779005350;Taip;0;2;1;3
12298;Vėrinėlis;ŽIRNIUKAI;1736733257;Taip;0;2;5;7
12299;Vėrinėlis;ŽIRNIUKAI;2687583764;Taip;0;3;0;3
12300;Vėrinėlis;ŽIRNIUKAI;2633143128;Taip;0;6;4;10
12301;Vėrinėlis;ŽIRNIUKAI;9419245081;Taip;0;6;0;6
12302;Vėrinėlis;ŽIRNIUKAI;7573209012;Taip;0;1;2;3
12303;Vėrinėlis;ŽIRNIUKAI;7817387800;Taip;10;1;2;13
12304;Vėrinėlis;ŽIRNIUKAI;6377447141;Ne;14;6;0;20
12305;Vėrinėlis;VARPELIAI;9009344779;Taip;0;5;0;5
12306;Vėrinėlis;VARPELIAI;9289003583;Taip;0;2;0;2
12307;Vėrinėlis;VARPELIAI;1684203955;Taip;0;2;0;2
12308;Vėrinėlis;VARPELIAI;3291922401;Taip;0;2;1;3
12309;Vėrinėlis;VARPELIAI;5942475043;Taip;5;0;2;7
12310;Vėrinėlis;VARPELIAI;7364698713;Taip;11;0;2;13
12311;Vėrinėlis;VARPELIAI;7416041207;Taip;5;1;0;6
12312;Vėrinėlis;VARPELIAI;8655158155;Taip;0;6;0;6
12313;Vėrinėlis;VARPELIAI;2369434537;Taip;4;0;0;4
12314;Vėrinėlis;VARPELIAI;3829146401;Taip;5;0;0;5
12315;Vėrinėlis;VARPELIAI;6177784856;Taip;4;0;1;5
12316;Vėrinėlis;VARPELIAI;9967737864;Taip;0;3;0;3
12317;Vėrinėlis;VARPELIAI;9310629340;Taip;13;0;1;14
12318;Vėrinėlis;VARPELIAI;4059906525;Taip;22;0;0;22
12319;Vėrinėlis;VARPELIAI;3832662507;Taip;0;9;0;9
12320;Vėrinėlis;VARPELIAI;1007705906;Taip;10;0;0;10
12321;Vėrinėlis;VARPELIAI;7913975075;Taip;0;7;0;7
12322;Vėrinėlis;VARPELIAI;6362125404;Ne;5;4;0;9
12323;Vėrinėlis;VARPELIAI;9599724421;Taip;5;0;1;6
12324;Vėrinėlis;VARPELIAI;7216867683;Taip;0;12;0;12
12325;Vėrinėlis;BORUŽĖLĖS;2467242845;Taip;0;8;0;8
12326;Vėrinėlis;BORUŽĖLĖS;8759487574;Taip;0;1;0;1
12327;Vėrinėlis;BORUŽĖLĖS;4819016753;Ne;6;0;1;7
12328;Vėrinėlis;BORUŽĖLĖS;1910385020;Taip;0;3;0;3
12329;Vėrinėlis;BORUŽĖLĖS;2078857084;Taip;4;0;0;4
12330;Vėrinėlis;BORUŽĖLĖS;3934652683;Taip;5;0;1;6
12331;Vėrinėlis;BORUŽĖLĖS;6904733283;Taip;0;0;11;11
12332;Vėrinėlis;BORUŽĖLĖS;4446546335;Taip;0;0;3;3
12333;Vėrinėlis;BORUŽĖLĖS;8904833339;Taip;11;1;0;12
12334;Vėrinėlis;BORUŽĖLĖS;3312501759;Taip;11;1;0;12
12335;Vėrinėlis;BORUŽĖLĖS;9217188911;Taip;0;21;0;21
12336;Vėrinėlis;BORUŽĖLĖS;7414937335;Taip;0;13;0;13
12337;Vėrinėlis;BORUŽĖLĖS;2574507205;Taip;0;3;0;3
12338;Vėrinėlis;BORUŽĖLĖS;6671382987;Taip;3;0;0;3
12339;Vėrinėlis;BORUŽĖLĖS;3200007674;Taip;0;0;1;1
12340;Vėrinėlis;BORUŽĖLĖS;4852563692;Taip;0;1;0;1
12341;Vėrinėlis;BORUŽĖLĖS;7953446502;Taip;0;0;1;1
12342;Vėrinėlis;BORUŽĖLĖS;5865529907;Taip;15;0;0;15
12343;Vėrinėlis;BORUŽĖLĖS;9613642664;Taip;0;1;0;1
12344;Vėrinėlis;BORUŽĖLĖS;5821107898;Taip;10;0;0;10
12345;Vėrinėlis;SVEIKUOLIAI;1909742394;Taip;8;0;2;10
12346;Vėrinėlis;SVEIKUOLIAI;6176308531;Taip;4;2;0;6
12347;Vėrinėlis;SVEIKUOLIAI;3070965434;Taip;0;1;0;1
12348;Vėrinėlis;SVEIKUOLIAI;6154618103;Taip;0;1;0;1
12349;Vėrinėlis;SVEIKUOLIAI;3563114419;Taip;12;2;0;14
12350;Vėrinėlis;SVEIKUOLIAI;8716965452;Taip;12;1;0;13
12351;Vėrinėlis;SVEIKUOLIAI;7584124339;Taip;11;0;1;12
12352;Vėrinėlis;SVEIKUOLIAI;9352630743;Taip;19;0;0;19
12353;Vėrinėlis;SVEIKUOLIAI;8543081245;Taip;0;9;0;9
12354;Vėrinėlis;SVEIKUOLIAI;1800434426;Taip;0;1;1;2
12355;Vėrinėlis;SVEIKUOLIAI;5456922203;Taip;3;0;0;3
12356;Vėrinėlis;SVEIKUOLIAI;3958551159;Taip;0;7;0;7
12357;Vėrinėlis;SVEIKUOLIAI;5614185158;Taip;0;2;1;3
12358;Vėrinėlis;SVEIKUOLIAI;2516474825;Taip;18;0;0;18
12359;Vėrinėlis;SVEIKUOLIAI;9058127692;Taip;0;5;0;5
12360;Vėrinėlis;SVEIKUOLIAI;1278914183;Taip;14;0;0;14
12361;Vėrinėlis;ŠIRDELĖS;7734163541;Ne;0;0;1;1
12362;Vėrinėlis;ŠIRDELĖS;7811024382;Taip;2;0;3;5
12363;Vėrinėlis;ŠIRDELĖS;4378592116;Taip;0;6;1;7
12364;Vėrinėlis;ŠIRDELĖS;7517113022;Taip;7;0;0;7
12365;Vėrinėlis;ŠIRDELĖS;7017031073;Taip;4;0;1;5
12366;Vėrinėlis;ŠIRDELĖS;1841277321;Taip;2;1;0;3
12367;Vėrinėlis;ŠIRDELĖS;5588658517;Taip;0;1;0;1
12368;Vėrinėlis;ŠIRDELĖS;5653635907;Taip;8;0;3;11
12369;Vėrinėlis;ŠIRDELĖS;1152010178;Taip;9;0;4;13
12370;Vėrinėlis;ŠIRDELĖS;2038169885;Taip;15;6;0;21
12371;Vėrinėlis;ŠIRDELĖS;9375922889;Taip;17;2;0;19
12372;Vėrinėlis;ŠIRDELĖS;5813009126;Taip;0;1;0;1
12373;Vėrinėlis;ŠIRDELĖS;1026312967;Taip;10;1;0;11
12374;Vėrinėlis;ŠIRDELĖS;3511809411;Taip;11;3;0;14
12375;Vėrinėlis;ŠIRDELĖS;3084117432;Taip;7;0;0;7
12376;Vėrinėlis;ŠIRDELĖS;3535652648;Taip;11;0;1;12
12377;Vėrinėlis;ŠIRDELĖS;9217815657;Taip;9;7;0;16
12378;Vėrinėlis;ŠIRDELĖS;4403875733;Taip;10;0;0;10
12379;Vėrinėlis;ŠIRDELĖS;4700093328;Taip;11;0;0;11
12380;Viltenė;Drugeliai;3625763429;Taip;4;0;0;4
12381;Viltenė;Drugeliai;2392304909;Taip;9;5;0;14
12382;Viltenė;Drugeliai;5781655552;Taip;4;7;0;11
12383;Viltenė;Drugeliai;2410868015;Taip;0;20;0;20
12384;Viltenė;Drugeliai;8679787688;Taip;8;0;0;8
12385;Viltenė;Drugeliai;4616047113;Ne;7;0;0;7
12386;Viltenė;Drugeliai;6810811656;Taip;7;0;0;7
12387;Viltenė;Drugeliai;9228677568;Taip;0;5;0;5
12388;Viltenė;Drugeliai;3905014810;Taip;4;8;0;12
12389;Viltenė;Drugeliai;4121448859;Taip;7;0;0;7
12390;Viltenė;Drugeliai;9157616307;Taip;7;0;0;7
12391;Viltenė;Drugeliai;9476132305;Taip;9;2;0;11
12392;Viltenė;Drugeliai;3052677157;Taip;6;0;0;6
12393;Viltenė;Drugeliai;5522245968;Taip;15;0;0;15
12394;Viltenė;Drugeliai;7401460248;Taip;7;4;0;11
12395;Viltenė;Drugeliai;9820462941;Taip;4;0;0;4
12396;Viltenė;Drugeliai;5552217000;Taip;8;0;0;8
12397;Viltenė;Drugeliai;9756519374;Taip;9;1;0;10
12398;Viltenė;Drugeliai;7928894276;Taip;6;2;0;8
12399;Viltenė;Drugeliai;8527270437;Taip;7;0;0;7
12400;Viltenė;Drugeliai;4195708756;Taip;8;1;0;9
12401;Viltenė;Bitučių;7158824421;Taip;3;0;0;3
12402;Viltenė;Bitučių;2936670828;Ne;0;5;0;5
12403;Viltenė;Bitučių;5611839058;Taip;0;11;0;11
12404;Viltenė;Bitučių;2483760198;Ne;0;10;0;10
12405;Viltenė;Bitučių;2846574130;Taip;8;9;0;17
12406;Viltenė;Bitučių;8336855920;Ne;2;0;0;2
12407;Viltenė;Bitučių;8341211836;Taip;4;4;0;8
12408;Viltenė;Bitučių;6954065006;Taip;4;4;0;8
12409;Viltenė;Bitučių;5816623708;Taip;4;0;0;4
12410;Viltenė;Bitučių;2656363650;Taip;7;1;0;8
12411;Viltenė;Bitučių;4414192600;Taip;0;12;0;12
12412;Viltenė;Bitučių;6741521720;Taip;0;13;0;13
12413;Viltenė;Bitučių;6888346135;Taip;0;15;0;15
12414;Viltenė;Bitučių;4030891958;Taip;6;0;1;7
12415;Viltenė;Bitučių;7810374329;Taip;4;2;0;6
12416;Viltenė;Boružėlių;6642790962;Taip;9;1;0;10
12417;Viltenė;Boružėlių;9572407405;Taip;6;0;0;6
12418;Viltenė;Boružėlių;3738838707;Taip;0;3;0;3
12419;Viltenė;Boružėlių;8473588098;Taip;5;7;0;12
12420;Viltenė;Boružėlių;3995418079;Taip;0;8;0;8
12421;Viltenė;Boružėlių;1399653129;Taip;13;6;0;19
12422;Viltenė;Boružėlių;7526555727;Ne;3;3;0;6
12423;Viltenė;Boružėlių;1936628249;Taip;4;5;0;9
12424;Viltenė;Boružėlių;4003018966;Taip;0;4;0;4
12425;Viltenė;Boružėlių;7912396297;Taip;6;1;0;7
12426;Viltenė;Boružėlių;4036109404;Taip;5;4;0;9
12427;Viltenė;Boružėlių;4604298036;Taip;9;6;0;15
12428;Viltenė;Boružėlių;9242034622;Taip;3;0;0;3
12429;Viltenė;Boružėlių;6621273812;Taip;7;0;0;7
12430;Viltenė;Boružėlių;2383607612;Taip;0;14;0;14
12431;Viltenė;Boružėlių;1496943250;Taip;0;4;0;4
12432;Viltenė;Boružėlių;1081603034;Taip;22;0;0;22
12433;Viltenė;Gandriukų;6481491422;Taip;15;0;1;16
12434;Viltenė;Gandriukų;1126409020;Taip;0;3;0;3
12435;Viltenė;Gandriukų;2884698447;Taip;5;2;0;7
12436;Viltenė;Gandriukų;6060648988;Taip;0;6;0;6
12437;Viltenė;Gandriukų;1840626621;Taip;9;13;0;22
12438;Viltenė;Gandriukų;8549631247;Taip;5;0;0;5
12439;Viltenė;Gandriukų;6511850468;Taip;4;3;0;7
12440;Viltenė;Gandriukų;4945108189;Taip;6;3;0;9
12441;Viltenė;Gandriukų;5850652322;Taip;8;3;0;11
12442;Viltenė;Gandriukų;8110413064;Taip;7;1;0;8
12443;Viltenė;Gandriukų;1243595112;Taip;5;1;0;6
12444;Viltenė;Gandriukų;3073228245;Ne;21;0;0;21
12445;Viltenė;Gandriukų;4468743044;Taip;0;10;0;10
12446;Viltenė;Gandriukų;6355857716;Taip;3;0;0;3
12447;Viltenė;Aitvariukai;5083515613;Ne;5;0;0;5
12448;Viltenė;Aitvariukai;2137929911;Taip;10;0;0;10
12449;Viltenė;Aitvariukai;9185054066;Taip;4;0;0;4
12450;Viltenė;Aitvariukai;2502099784;Taip;14;0;0;14
12451;Viltenė;Aitvariukai;2036902795;Taip;9;5;0;14
12452;Viltenė;Aitvariukai;5599943846;Taip;0;16;0;16
12453;Viltenė;Aitvariukai;6721689684;Taip;4;1;0;5
12454;Viltenė;Aitvariukai;6296509460;Taip;0;8;0;8
12455;Viltenė;Aitvariukai;9101795131;Taip;0;4;0;4
12456;Viltenė;Aitvariukai;2702489251;Taip;3;19;0;22
12457;Viltenė;Aitvariukai;3908574248;Taip;0;8;0;8
12458;Viltenė;Aitvariukai;8439859449;Taip;22;0;0;22
12459;Viltenė;Aitvariukai;2976705872;Taip;5;0;0;5
12460;Viltenė;Aitvariukai;7914803006;Taip;3;15;0;18
12461;Viltenė;Aitvariukai;6786504670;Taip;0;4;0;4
12462;Viltenė;Aitvariukai;2192086488;Taip;3;3;0;6
12463;Viltenė;Aitvariukai;2026654467;Taip;0;8;0;8
12464;Viltenė;Aitvariukai;4641365031;Taip;5;1;0;6
12465;Viltenė;Aitvariukai;7277455268;Taip;0;11;0;11
12466;Viltenė;Aitvariukai;3245284852;Taip;5;2;0;7
12467;Viltenė;Aitvariukai;2786572522;Taip;4;1;0;5
12468;Viltenė;Aitvariukai;6171399579;Taip;3;6;0;9
12469;Viltenė;Geniukų;5604263567;Taip;0;4;0;4
12470;Viltenė;Geniukų;1822220265;Taip;0;3;0;3
12471;Viltenė;Geniukų;6349032936;Taip;0;7;0;7
12472;Viltenė;Geniukų;1423254631;Taip;0;2;0;2
12473;Viltenė;Geniukų;3002690526;Taip;13;0;0;13
12474;Viltenė;Geniukų;6276349499;Taip;0;4;0;4
12475;Viltenė;Geniukų;3711956659;Taip;0;5;0;5
12476;Viltenė;Geniukų;1054469254;Taip;20;0;0;20
12477;Viltenė;Geniukų;6063181025;Taip;0;5;0;5
12478;Viltenė;Geniukų;1672091332;Taip;0;3;0;3
12479;Viltenė;Geniukų;3018271511;Taip;0;10;0;10
12480;Viltenė;Geniukų;49998813869;Taip;0;5;0;5
12481;Viltenė;Geniukų;3389110405;Taip;8;1;0;9
12482;Viltenė;Geniukų;8125023386;Taip;0;2;0;2
12483;Viltenė;Geniukų;9035687504;Taip;0;4;0;4
12484;Viltenė;Saulutės;2044754943;Ne;4;0;0;4
12485;Viltenė;Saulutės;1615415742;Taip;0;3;0;3
12486;Viltenė;Saulutės;7994367286;Taip;0;10;0;10
12487;Viltenė;Saulutės;9935236068;Taip;3;1;0;4
12488;Viltenė;Saulutės;6664059418;Taip;0;1;0;1
12489;Viltenė;Saulutės;2141002432;Taip;0;12;0;12
12490;Viltenė;Saulutės;5024192785;Taip;0;1;0;1
12491;Viltenė;Saulutės;1918867591;Taip;0;10;0;10
12492;Viltenė;Saulutės;7559243300;Taip;0;15;0;15
12493;Viltenė;Saulutės;3560474943;Taip;3;6;0;9
12494;Viltenė;Saulutės;1252657362;Taip;7;2;0;9
12495;Viltenė;Saulutės;7726650894;Taip;0;10;0;10
12496;Viltenė;Saulutės;3709362712;Taip;0;4;0;4
12497;Viltenė;Saulutės;1841732416;Taip;6;3;0;9
12498;Viltenė;Lapiukų;2016636764;Taip;0;5;0;5
12499;Viltenė;Lapiukų;1650304982;Taip;0;5;0;5
12500;Viltenė;Lapiukų;89844531860;Taip;0;1;0;1
12501;Viltenė;Lapiukų;8261531943;Taip;0;8;0;8
12502;Viltenė;Lapiukų;60092202534;Taip;0;6;0;6
12503;Viltenė;Lapiukų;22318027000;Taip;0;2;0;2
12504;Viltenė;Lapiukų;1559623914;Taip;0;2;0;2
12505;Viltenė;Lapiukų;1042196397;Taip;0;4;0;4
12506;Viltenė;Lapiukų;1210824560;Taip;0;5;0;5
12507;Viltenė;Lapiukų;2065651722;Taip;8;0;0;8
12508;Viltenė;Lapiukų;87698700338;Taip;3;0;0;3
12509;Viltenė;Lapiukų;3526237179;Taip;0;13;0;13
12510;Viltenė;Lapiukų;1662950901;Taip;8;3;0;11
12511;Viltenė;Lapiukų;1350487577;Taip;0;1;0;1
12512;Viltenė;Lapiukų;1592077335;Taip;0;20;0;20
12513;Viltenė;Lapiukų;1281808784;Taip;6;0;0;6
12514;Viltenė;Lapiukų;93894985640;Taip;0;10;0;10
12515;Viltenė;Lapiukų;3057761137;Taip;4;0;0;4
12516;Viltenė;Lapiukų;92968672028;Taip;12;0;0;12
12517;Viltenė;Voveriukai;8732323660;Taip;0;2;7;9
12518;Viltenė;Voveriukai;13795858727;Taip;0;2;0;2
12519;Viltenė;Voveriukai;1306624353;Taip;0;1;0;1
12520;Viltenė;Voveriukai;1262222404;Taip;0;7;0;7
12521;Viltenė;Voveriukai;7245395388;Taip;0;5;0;5
12522;Viltenė;Voveriukai;92175043385;Taip;0;1;0;1
12523;Viltenė;Voveriukai;35466181637;Taip;0;5;0;5
12524;Viltenė;Voveriukai;68243828276;Taip;0;2;0;2
12525;Viltenė;Voveriukai;1615151982;Taip;0;4;0;4
12526;Viltenė;Voveriukai;87296434240;Taip;6;0;0;6
12527;Viltenė;Voveriukai;51997485918;Taip;0;9;0;9
12528;Viltenė;Voveriukai;1872042290;Taip;0;7;0;7
12529;Viltenė;Voveriukai;1926586646;Ne;0;11;0;11
12530;Viltenė;Voveriukai;2008408325;Ne;0;9;0;9
12531;Viltenė;Voveriukai;4441280059;Taip;4;2;0;6
12532;Viltenė;Voveriukai;6160715081;Ne;5;2;0;7
12533;Viltenė;Voveriukai;1712349973;Taip;4;0;0;4
12534;Viltenė;Voveriukai;1532633795;Taip;9;0;0;9
12535;Viltenė;Kiškučiai;1888167096;Taip;6;2;0;8
12536;Viltenė;Kiškučiai;2013415571;Taip;6;1;0;7
12537;Viltenė;Kiškučiai;2642080849;Taip;0;20;0;20
12538;Viltenė;Kiškučiai;2894570917;Taip;0;1;0;1
12539;Viltenė;Kiškučiai;6595715908;Taip;0;1;0;1
12540;Viltenė;Kiškučiai;3347380524;Taip;6;0;0;6
12541;Viltenė;Kiškučiai;1641406030;Taip;0;4;0;4
12542;Viltenė;Kiškučiai;7322841332;Taip;10;1;0;11
12543;Viltenė;Kiškučiai;2192673126;Taip;0;2;0;2
12544;Viltenė;Kiškučiai;3157417614;Taip;11;0;0;11
12545;Viltenė;Kiškučiai;3291926243;Taip;13;3;0;16
12546;Viltenė;Kiškučiai;9578037239;Taip;19;1;0;20
12547;Viltenė;Kiškučiai;2903596382;Taip;2;1;0;3
12548;Viltenė;Nykštukų;5818645490;Taip;6;0;0;6
12549;Viltenė;Nykštukų;3679704404;Taip;0;12;0;12
12550;Viltenė;Nykštukų;1507287948;Taip;0;5;0;5
12551;Viltenė;Nykštukų;4243501722;Taip;5;4;0;9
12552;Viltenė;Nykštukų;9063994291;Taip;0;3;0;3
12553;Viltenė;Nykštukų;7993258845;Taip;8;0;0;8
12554;Viltenė;Nykštukų;6429905246;Taip;3;2;2;7
12555;Viltenė;Nykštukų;6070264006;Taip;0;1;2;3
12556;Viltenė;Nykštukų;1890096287;Taip;22;0;0;22
12557;Viltenė;Nykštukų;8187712849;Taip;12;0;0;12
12558;Viltenė;Nykštukų;9846205631;Taip;0;8;0;8
12559;Viltenė;Nykštukų;9424773418;Taip;13;0;0;13
12560;Viltenė;Nykštukų;5677284428;Taip;5;0;0;5
12561;Viltenė;Nykštukų;3343045604;Taip;14;1;0;15
12562;Viltenė;Triušiukai;8696698257;Taip;0;1;0;1
12563;Viltenė;Triušiukai;2660622296;Taip;7;0;0;7
12564;Viltenė;Triušiukai;4550915388;Taip;5;4;0;9
12565;Viltenė;Triušiukai;8122878153;Taip;6;2;0;8
12566;Viltenė;Triušiukai;2034259692;Taip;0;0;2;2
12567;Viltenė;Triušiukai;3473533533;Taip;0;15;0;15
12568;Viltenė;Triušiukai;6379567497;Taip;3;0;0;3
12569;Viltenė;Triušiukai;8248514570;Taip;7;0;0;7
12570;Viltenė;Triušiukai;2878124826;Taip;1;0;0;1
12571;Viltenė;Triušiukai;8278572246;Taip;4;1;0;5
12572;Viltenė;Triušiukai;1587868835;Taip;0;7;0;7
12573;Viltenė;Triušiukai;6671311193;Taip;0;1;0;1
12574;Viltenė;Triušiukai;9573891616;Taip;19;0;0;19
12575;Viltenė;Triušiukai;9819729046;Taip;0;16;0;16
12576;Viltenė;Triušiukai;8258247750;Taip;0;15;0;15
12577;Viltenė;Triušiukai;7356950897;Taip;11;1;0;12
12578;Voveraitė;ŽVIRBLIUKŲ;6684234832;Taip;6;9;0;15
12579;Voveraitė;ŽVIRBLIUKŲ;8119493388;Taip;0;1;0;1
12580;Voveraitė;ŽVIRBLIUKŲ;9715405072;Taip;0;6;0;6
12581;Voveraitė;ŽVIRBLIUKŲ;5510544648;Taip;2;16;0;18
12582;Voveraitė;ŽVIRBLIUKŲ;6959751328;Taip;4;0;0;4
12583;Voveraitė;ŽVIRBLIUKŲ;8803052781;Taip;3;5;0;8
12584;Voveraitė;ŽVIRBLIUKŲ;8257748589;Taip;0;2;0;2
12585;Voveraitė;ŽVIRBLIUKŲ;3811230983;Taip;2;1;0;3
12586;Voveraitė;ŽVIRBLIUKŲ;2142507659;Taip;9;1;0;10
12587;Voveraitė;ŽVIRBLIUKŲ;5395915359;Taip;6;0;0;6
12588;Voveraitė;ŽVIRBLIUKŲ;3247101840;Taip;7;0;0;7
12589;Voveraitė;ŽVIRBLIUKŲ;6643600680;Taip;1;4;0;5
12590;Voveraitė;ŽVIRBLIUKŲ;4460047281;Taip;0;1;0;1
12591;Voveraitė;ŽVIRBLIUKŲ;3877673172;Taip;0;1;0;1
12592;Voveraitė;ŽVIRBLIUKŲ;7008576999;Taip;2;0;0;2
12593;Voveraitė;ŽVIRBLIUKŲ;2716400502;Taip;2;4;1;7
12594;Voveraitė;VOVERIUKŲ;1515087924;Taip;3;3;0;6
12595;Voveraitė;VOVERIUKŲ;9195700962;Taip;10;8;0;18
12596;Voveraitė;VOVERIUKŲ;5138855000;Taip;5;0;0;5
12597;Voveraitė;VOVERIUKŲ;1340379090;Taip;5;1;0;6
12598;Voveraitė;VOVERIUKŲ;9912862474;Taip;0;7;0;7
12599;Voveraitė;VOVERIUKŲ;1960385335;Taip;17;2;0;19
12600;Voveraitė;VOVERIUKŲ;2594535017;Taip;3;0;0;3
12601;Voveraitė;VOVERIUKŲ;8373093305;Taip;2;3;0;5
12602;Voveraitė;VOVERIUKŲ;9514425475;Taip;0;7;0;7
12603;Voveraitė;VOVERIUKŲ;6017698476;Taip;3;2;0;5
12604;Voveraitė;VOVERIUKŲ;6891841301;Taip;0;12;0;12
12605;Voveraitė;VOVERIUKŲ;5935777154;Taip;18;0;0;18
12606;Voveraitė;VOVERIUKŲ;6113913885;Taip;0;1;0;1
12607;Voveraitė;VOVERIUKŲ;6007396459;Taip;15;0;0;15
12608;Voveraitė;VOVERIUKŲ;4054841724;Taip;1;13;0;14
12609;Voveraitė;VOVERIUKŲ;2304604061;Taip;17;4;0;21
12610;Voveraitė;VOVERIUKŲ;5956830012;Taip;0;3;0;3
12611;Voveraitė;VOVERIUKŲ;8344323109;Taip;0;2;0;2
12612;Voveraitė;VOVERIUKŲ;1141304286;Taip;2;0;0;2
12613;Voveraitė;KIŠKUČIŲ;9537862791;Taip;9;0;0;9
12614;Voveraitė;KIŠKUČIŲ;4478984171;Taip;0;2;0;2
12615;Voveraitė;KIŠKUČIŲ;3736638759;Taip;5;1;0;6
12616;Voveraitė;KIŠKUČIŲ;9011096222;Taip;3;0;19;22
12617;Voveraitė;KIŠKUČIŲ;3058377539;Taip;0;4;0;4
12618;Voveraitė;KIŠKUČIŲ;8507818993;Taip;0;3;0;3
12619;Voveraitė;KIŠKUČIŲ;8746008166;Taip;4;4;0;8
12620;Voveraitė;KIŠKUČIŲ;8084986328;Taip;0;1;0;1
12621;Voveraitė;KIŠKUČIŲ;6261152304;Taip;5;2;0;7
12622;Voveraitė;KIŠKUČIŲ;8220437514;Taip;4;0;0;4
12623;Voveraitė;KIŠKUČIŲ;5069929376;Taip;10;0;0;10
12624;Voveraitė;KIŠKUČIŲ;7379045686;Taip;3;2;0;5
12625;Voveraitė;KIŠKUČIŲ;1961699588;Taip;22;0;0;22
12626;Voveraitė;KIŠKUČIŲ;1979839656;Taip;4;0;0;4
12627;Voveraitė;KIŠKUČIŲ;9599137158;Taip;0;18;0;18
12628;Voveraitė;KIŠKUČIŲ;8121423914;Taip;6;5;0;11
12629;Voveraitė;KIŠKUČIŲ;4379372200;Taip;14;0;0;14
12630;Voveraitė;KIŠKUČIŲ;8528435385;Taip;7;0;0;7
12631;Voveraitė;KIŠKUČIŲ;8937070276;Taip;8;0;0;8
12632;Voveraitė;KODĖLČIUKŲ;9117809080;Taip;0;4;0;4
12633;Voveraitė;KODĖLČIUKŲ;46205148458;Taip;0;2;0;2
12634;Voveraitė;KODĖLČIUKŲ;51213803814;Taip;0;3;0;3
12635;Voveraitė;KODĖLČIUKŲ;36749754999;Taip;0;1;0;1
12636;Voveraitė;KODĖLČIUKŲ;6653141009;Taip;3;2;2;7
12637;Voveraitė;KODĖLČIUKŲ;4045121781;Taip;6;1;0;7
12638;Voveraitė;KODĖLČIUKŲ;2208396431;Taip;0;2;0;2
12639;Voveraitė;KODĖLČIUKŲ;5296850349;Taip;0;0;4;4
12640;Voveraitė;KODĖLČIUKŲ;4468214107;Taip;5;0;4;9
12641;Voveraitė;KODĖLČIUKŲ;9921313716;Taip;3;2;2;7
12642;Voveraitė;KODĖLČIUKŲ;5449490074;Taip;0;6;11;17
12643;Voveraitė;KODĖLČIUKŲ;7786378018;Taip;4;1;0;5
12644;Voveraitė;KODĖLČIUKŲ;6819742525;Taip;0;2;1;3
12645;Voveraitė;KODĖLČIUKŲ;5517458323;Taip;3;2;1;6
12646;Voveraitė;MEŠKIUKŲ;4079618555;Taip;4;4;0;8
12647;Voveraitė;MEŠKIUKŲ;3987058753;Taip;0;7;0;7
12648;Voveraitė;MEŠKIUKŲ;3381417855;Taip;0;4;0;4
12649;Voveraitė;MEŠKIUKŲ;1058273156;Taip;4;3;0;7
12650;Voveraitė;MEŠKIUKŲ;5576058454;Taip;4;3;0;7
12651;Voveraitė;MEŠKIUKŲ;1629942114;Taip;0;1;0;1
12652;Voveraitė;MEŠKIUKŲ;1592633500;Taip;0;12;0;12
12653;Voveraitė;MEŠKIUKŲ;7797966139;Taip;4;11;0;15
12654;Voveraitė;MEŠKIUKŲ;3029983180;Taip;0;4;0;4
12655;Voveraitė;MEŠKIUKŲ;6886337758;Taip;0;15;0;15
12656;Voveraitė;MEŠKIUKŲ;7861722125;Taip;8;11;0;19
12657;Voveraitė;BORUŽĖLIŲ;1022447432;Taip;0;13;0;13
12658;Voveraitė;BORUŽĖLIŲ;4562962568;Taip;0;3;0;3
12659;Voveraitė;BORUŽĖLIŲ;8659850691;Taip;0;3;0;3
12660;Voveraitė;BORUŽĖLIŲ;107968318;Taip;5;3;0;8
12661;Voveraitė;BORUŽĖLIŲ;1704834744;Taip;0;1;0;1
12662;Voveraitė;BORUŽĖLIŲ;2902148527;Taip;0;1;0;1
12663;Voveraitė;BORUŽĖLIŲ;2762066479;Taip;0;2;1;3
12664;Voveraitė;BORUŽĖLIŲ;27132982320;Taip;0;5;0;5
12665;Voveraitė;BORUŽĖLIŲ;2051732666;Taip;0;5;0;5
12666;Voveraitė;BORUŽĖLIŲ;82642244788;Taip;0;1;0;1
12667;Voveraitė;BORUŽĖLIŲ;59346262217;Taip;0;6;0;6
12668;Voveraitė;BORUŽĖLIŲ;13173711840;Taip;0;2;0;2
12669;Voveraitė;BORUŽĖLIŲ;35549553867;Taip;0;3;0;3
12670;Voveraitė;BORUŽĖLIŲ;67851579200;Taip;0;1;0;1
12671;Voveraitė;BORUŽĖLIŲ;41221846403;Taip;0;8;0;8
12672;Voveraitė;BORUŽĖLIŲ;3292830298;Taip;0;1;4;5
12673;Voveraitė;BORUŽĖLIŲ;7671966977;Taip;0;0;8;8
12674;Voveraitė;PELĖDŽIUKŲ;9491132884;Taip;0;5;0;5
12675;Voveraitė;PELĖDŽIUKŲ;1775800865;Taip;0;4;0;4
12676;Voveraitė;PELĖDŽIUKŲ;1959958256;Ne;6;0;3;9
12677;Voveraitė;PELĖDŽIUKŲ;6649068571;Taip;0;3;0;3
12678;Voveraitė;PELĖDŽIUKŲ;54408671673;Taip;10;1;0;11
12679;Voveraitė;PELĖDŽIUKŲ;72154318379;Taip;0;1;0;1
12680;Voveraitė;PELĖDŽIUKŲ;3113780055;Taip;0;0;2;2
12681;Voveraitė;PELĖDŽIUKŲ;9007031372;Taip;8;3;0;11
12682;Voveraitė;PELĖDŽIUKŲ;7069780513;Taip;3;0;2;5
12683;Voveraitė;PELĖDŽIUKŲ;9933037872;Taip;0;2;2;4
12684;Voveraitė;PELĖDŽIUKŲ;6369860178;Taip;13;0;5;18
12685;Voveraitė;PELĖDŽIUKŲ;3615729576;Taip;0;1;0;1
12686;Voveraitė;PELĖDŽIUKŲ;2693544600;Ne;0;1;0;1
12687;Voveraitė;PELĖDŽIUKŲ;65926130735;Taip;3;4;0;7
12688;Voveraitė;PELĖDŽIUKŲ;6433760749;Taip;0;1;0;1
12689;Voveraitė;PELĖDŽIUKŲ;6460834118;Taip;0;2;19;21
12690;Voveraitė;PELĖDŽIUKŲ;4338861332;Taip;0;2;0;2
12691;Voveraitė;PELĖDŽIUKŲ;7314148938;Taip;0;2;2;4
12692;Voveraitė;PELĖDŽIUKŲ;4511771924;Taip;0;2;2;4
12693;Voveraitė;PELĖDŽIUKŲ;602726070;Taip;0;2;0;2
12694;Voveraitė;PELĖDŽIUKŲ;4163635632;Taip;0;4;5;9
12695;Voveraitė;PELĖDŽIUKŲ;1397274691;Taip;0;6;0;6
12696;Voveraitė;DRUGELIŲ;7531020548;Taip;0;4;2;6
12697;Voveraitė;DRUGELIŲ;4300235743;Taip;9;0;1;10
12698;Voveraitė;DRUGELIŲ;1510853268;Taip;8;0;0;8
12699;Voveraitė;DRUGELIŲ;3388547792;Taip;0;12;0;12
12700;Voveraitė;DRUGELIŲ;8719547570;Taip;0;2;0;2
12701;Voveraitė;DRUGELIŲ;3475601049;Taip;3;0;1;4
12702;Voveraitė;DRUGELIŲ;4017408873;Taip;0;0;5;5
12703;Voveraitė;DRUGELIŲ;7533728486;Taip;3;2;0;5
12704;Voveraitė;DRUGELIŲ;1550830434;Taip;0;3;0;3
12705;Voveraitė;DRUGELIŲ;5114768009;Taip;5;0;0;5
12706;Voveraitė;DRUGELIŲ;4605007814;Taip;0;1;0;1
12707;Voveraitė;DRUGELIŲ;4911291891;Taip;10;5;0;15
12708;Voveraitė;DRUGELIŲ;2482908027;Taip;5;3;0;8
12709;Voveraitė;DRUGELIŲ;4782336282;Taip;0;3;0;3
12710;Voveraitė;DRUGELIŲ;6415024059;Taip;10;0;1;11
12711;Voveraitė;DRUGELIŲ;4350450125;Taip;0;1;0;1
12712;Voveraitė;DRUGELIŲ;8913940646;Taip;0;2;0;2
12713;Voveraitė;DRUGELIŲ;1201270622;Ne;0;2;10;12
12714;Voveraitė;NYKŠTUKŲ;7281753415;Taip;5;4;8;17
12715;Voveraitė;NYKŠTUKŲ;8692155848;Taip;0;10;0;10
12716;Voveraitė;NYKŠTUKŲ;1040007977;Taip;0;3;1;4
12717;Voveraitė;NYKŠTUKŲ;8534405352;Taip;9;0;13;22
12718;Voveraitė;NYKŠTUKŲ;8940421826;Taip;11;0;0;11
12719;Voveraitė;NYKŠTUKŲ;1813440087;Taip;0;0;1;1
12720;Voveraitė;NYKŠTUKŲ;9332936763;Taip;0;0;2;2
12721;Voveraitė;NYKŠTUKŲ;6206817227;Taip;0;0;4;4
12722;Voveraitė;NYKŠTUKŲ;8206634977;Taip;6;0;4;10
12723;Voveraitė;NYKŠTUKŲ;3068683904;Taip;0;4;5;9
12724;Voveraitė;NYKŠTUKŲ;1294012085;Ne;0;0;1;1
12725;Voveraitė;GENIUKŲ;2505264721;Taip;0;4;0;4
12726;Voveraitė;GENIUKŲ;1508705709;Ne;0;7;0;7
12727;Voveraitė;GENIUKŲ;8443005812;Taip;0;4;0;4
12728;Voveraitė;GENIUKŲ;6729475469;Taip;4;9;0;13
12729;Voveraitė;GENIUKŲ;1753442884;Taip;0;1;0;1
12730;Voveraitė;GENIUKŲ;81628846458;Taip;0;2;0;2
12731;Voveraitė;GENIUKŲ;9623406874;Taip;9;3;0;12
12732;Voveraitė;GENIUKŲ;1612322367;Taip;0;1;0;1
12733;Voveraitė;GENIUKŲ;7974406524;Taip;0;11;0;11
12734;Voveraitė;GENIUKŲ;2044914624;Taip;0;6;0;6
12735;Voveraitė;GENIUKŲ;6847620019;Taip;0;2;0;2
12736;Voveraitė;GENIUKŲ;63032690186;Taip;0;2;5;7
12737;Voveraitė;GENIUKŲ;8538259157;Taip;0;10;0;10
12738;Voveraitė;GENIUKŲ;1780573926;Taip;0;1;0;1
12739;Voveraitė;GENIUKŲ;1668695462;Taip;0;13;5;18
12740;Voveraitė;GENIUKŲ;1616662586;Taip;0;4;0;4
12741;Voveraitė;GENIUKŲ;1167124464;Taip;0;2;0;2
12742;Voveraitė;LAPIUKŲ;3217609712;Taip;0;3;0;3
12743;Voveraitė;LAPIUKŲ;5598685365;Taip;0;6;0;6
12744;Voveraitė;LAPIUKŲ;7605427741;Taip;0;1;0;1
12745;Voveraitė;LAPIUKŲ;3432886020;Taip;0;1;0;1
12746;Voveraitė;LAPIUKŲ;8438808999;Taip;6;1;3;10
12747;Voveraitė;LAPIUKŲ;9397887760;Taip;3;2;1;6
12748;Voveraitė;LAPIUKŲ;4151144278;Taip;8;1;0;9
12749;Voveraitė;LAPIUKŲ;1482908802;Taip;2;0;1;3
12750;Voveraitė;LAPIUKŲ;3344886524;Taip;0;8;0;8
12751;Voveraitė;LAPIUKŲ;1046297151;Taip;0;2;0;2
12752;Voveraitė;LAPIUKŲ;4996778855;Taip;0;3;0;3
12753;Voveraitė;LAPIUKŲ;8818603905;Taip;13;0;0;13
12754;Voveraitė;LAPIUKŲ;9887747925;Taip;6;0;2;8
12755;Voveraitė;LAPIUKŲ;9816971493;Taip;0;8;1;9
12756;Voveraitė;EŽIUKŲ;4207949414;Taip;10;0;0;10
12757;Voveraitė;EŽIUKŲ;3088866739;Taip;10;0;0;10
12758;Voveraitė;EŽIUKŲ;7474214701;Taip;4;0;0;4
12759;Voveraitė;EŽIUKŲ;8154347030;Taip;0;1;0;1
12760;Voveraitė;EŽIUKŲ;6853358062;Taip;7;0;0;7
12761;Voveraitė;EŽIUKŲ;3159659638;Taip;0;2;0;2
12762;Voveraitė;EŽIUKŲ;3532178114;Taip;0;2;0;2
12763;Voveraitė;EŽIUKŲ;6609235703;Taip;0;3;0;3
12764;Voveraitė;EŽIUKŲ;1528968162;Taip;14;0;1;15
12765;Voveraitė;EŽIUKŲ;3539069705;Taip;0;1;0;1
12766;Voveraitė;EŽIUKŲ;7304789836;Taip;0;0;10;10
12767;Voveraitė;EŽIUKŲ;4547087565;Taip;0;0;1;1
12768;"Trakų Vokė";Voveriukų;8783922678;Taip;0;0;1;1
12769;"Trakų Vokė";Voveriukų;3333979364;Taip;4;0;0;4
12770;"Trakų Vokė";Voveriukų;9928767253;Taip;0;14;0;14
12771;"Trakų Vokė";Voveriukų;5031669549;Taip;6;0;5;11
12772;"Trakų Vokė";Voveriukų;8703806519;Taip;22;0;0;22
12773;"Trakų Vokė";Voveriukų;4531294784;Taip;4;0;0;4
12774;"Trakų Vokė";Voveriukų;1252962923;Taip;16;0;0;16
12775;"Trakų Vokė";Voveriukų;2133793458;Taip;9;0;0;9
12776;"Trakų Vokė";Voveriukų;5720994041;Taip;7;0;1;8
12777;"Trakų Vokė";Voveriukų;6428645462;Taip;4;0;0;4
12778;"Trakų Vokė";Voveriukų;7459132887;Taip;6;0;0;6
12779;"Trakų Vokė";Voveriukų;9514298829;Taip;0;0;15;15
12780;"Trakų Vokė";Voveriukų;1808420447;Taip;0;10;0;10
12781;"Trakų Vokė";Voveriukų;6402002961;Taip;0;0;1;1
12782;"Trakų Vokė";Voveriukų;3536227018;Taip;3;0;2;5
12783;"Trakų Vokė";Voveriukų;6076083379;Taip;0;3;0;3
12784;"Trakų Vokė";Voveriukų;6787506848;Taip;7;2;0;9
12785;"Trakų Vokė";Voveriukų;3372734352;Taip;0;5;0;5
12786;"Trakų Vokė";Voveriukų;1000323267;Taip;4;0;1;5
12787;"Trakų Vokė";Voveriukų;1359519176;Taip;0;16;0;16
12788;"Trakų Vokė";Boružėlių;6732422645;Taip;0;12;0;12
12789;"Trakų Vokė";Boružėlių;5338798362;Taip;8;0;3;11
12790;"Trakų Vokė";Boružėlių;3319243283;Taip;4;0;0;4
12791;"Trakų Vokė";Boružėlių;2516219363;Taip;0;0;4;4
12792;"Trakų Vokė";Boružėlių;7858812338;Taip;0;0;2;2
12793;"Trakų Vokė";Boružėlių;1088928094;Taip;0;0;1;1
12794;"Trakų Vokė";Boružėlių;6908913934;Taip;4;0;1;5
12795;"Trakų Vokė";Boružėlių;7909596435;Taip;12;1;0;13
12796;"Trakų Vokė";Boružėlių;6751625456;Taip;2;0;0;2
12797;"Trakų Vokė";Boružėlių;7752786907;Taip;5;12;1;18
12798;"Trakų Vokė";Boružėlių;2475068032;Ne;0;4;6;10
12799;"Trakų Vokė";Boružėlių;4601374629;Ne;4;2;0;6
12800;"Trakų Vokė";Boružėlių;4014027030;Taip;0;6;2;8
12801;"Trakų Vokė";Boružėlių;7660240598;Taip;0;10;0;10
12802;"Trakų Vokė";Boružėlių;4438127190;Ne;4;0;5;9
12803;"Trakų Vokė";Boružėlių;2388817616;Taip;0;11;1;12
12804;"Trakų Vokė";Boružėlių;9453317084;Taip;0;0;2;2
12805;"Trakų Vokė";Boružėlių;1080300137;Taip;0;7;1;8
12806;"Trakų Vokė";Boružėlių;3913623741;Taip;0;0;1;1
12807;"Trakų Vokė";KIŠKUČIŲ;9094930495;Taip;13;0;0;13
12808;"Trakų Vokė";KIŠKUČIŲ;2503382218;Taip;3;0;0;3
12809;"Trakų Vokė";KIŠKUČIŲ;8605461082;Taip;0;7;0;7
12810;"Trakų Vokė";KIŠKUČIŲ;6369848950;Taip;0;0;3;3
12811;"Trakų Vokė";KIŠKUČIŲ;4535167417;Taip;0;1;0;1
12812;"Trakų Vokė";KIŠKUČIŲ;4854440884;Taip;21;0;0;21
12813;"Trakų Vokė";KIŠKUČIŲ;2761614687;Taip;21;0;0;21
12814;"Trakų Vokė";KIŠKUČIŲ;9233090228;Ne;3;0;4;7
12815;"Trakų Vokė";KIŠKUČIŲ;2880299812;Taip;5;0;1;6
12816;"Trakų Vokė";KIŠKUČIŲ;1360046096;Taip;2;2;1;5
12817;"Trakų Vokė";KIŠKUČIŲ;3278842582;Ne;5;6;0;11
12818;"Trakų Vokė";KIŠKUČIŲ;3611639112;Taip;0;5;1;6
12819;"Trakų Vokė";KIŠKUČIŲ;3328527700;Taip;0;0;1;1
12820;"Trakų Vokė";KIŠKUČIŲ;2869217654;Taip;0;1;0;1
12821;"Trakų Vokė";KIŠKUČIŲ;1324720234;Taip;0;1;0;1
12822;"Trakų Vokė";KIŠKUČIŲ;5206616285;Taip;3;0;0;3
12823;"Trakų Vokė";BITUČIŲ;7792654474;Taip;17;0;1;18
12824;"Trakų Vokė";BITUČIŲ;4914675622;Taip;0;1;0;1
12825;"Trakų Vokė";BITUČIŲ;3373764541;Taip;0;2;0;2
12826;"Trakų Vokė";BITUČIŲ;1623166260;Taip;0;0;5;5
12827;"Trakų Vokė";BITUČIŲ;9268558715;Taip;13;0;1;14
12828;"Trakų Vokė";BITUČIŲ;1940148622;Ne;3;0;8;11
12829;Zylutė;Katerok;8749296671;Taip;8;11;0;19
12830;Zylutė;Katerok;1621772702;Taip;0;20;0;20
12831;Zylutė;Katerok;4592825972;Taip;0;14;0;14
12832;Zylutė;Katerok;8747721198;Taip;5;7;0;12
12833;Zylutė;Katerok;8212030518;Taip;0;17;0;17
12834;Zylutė;Katerok;7706833089;Taip;8;7;0;15
12835;Zylutė;Katerok;3115223229;Taip;0;13;0;13
12836;Zylutė;Katerok;2968625045;Taip;0;3;0;3
12837;Zylutė;Katerok;5687201052;Taip;0;2;0;2
12838;Zylutė;Katerok;3055559237;Taip;0;8;0;8
12839;Zylutė;Katerok;2792217953;Taip;0;9;0;9
12840;Zylutė;Katerok;7851423851;Taip;9;11;0;20
12841;Zylutė;Katerok;2945894661;Taip;4;4;5;13
12842;Zylutė;Katerok;9986289837;Taip;1;4;0;5
12843;Zylutė;Katerok;1164530815;Taip;0;8;0;8
12844;Zylutė;Katerok;1423890598;Taip;13;19;0;32
12845;Zylutė;Katerok;2558354198;Taip;0;6;0;6
12846;Zylutė;Katerok;8618778936;Taip;0;3;0;3
12847;Zylutė;"Vesole misiaki";3332865242;Taip;5;0;1;6
12848;Zylutė;"Vesole misiaki";9162232979;Taip;6;0;0;6
12849;Zylutė;"Vesole misiaki";4715704693;Taip;0;7;0;7
12850;Zylutė;"Vesole misiaki";9457457032;Taip;8;2;0;10
12851;Zylutė;"Vesole misiaki";4543822765;Taip;7;0;1;8
12852;Zylutė;"Vesole misiaki";4566817285;Taip;6;0;0;6
12853;Zylutė;"Vesole misiaki";9737308076;Taip;0;8;0;8
12854;Zylutė;"Vesole misiaki";2999425729;Taip;13;0;0;13
12855;Zylutė;"Vesole misiaki";1290248125;Ne;3;0;0;3
12856;Zylutė;"Vesole misiaki";5027134228;Taip;0;8;0;8
12857;Zylutė;"Vesole misiaki";5589330186;Taip;3;19;0;22
12858;Zylutė;"Vesole misiaki";3848401615;Taip;6;0;1;7
12859;Zylutė;"Vesole misiaki";2913504349;Taip;0;7;0;7
12860;Zylutė;NYKŠTUKAI;3371202491;Taip;6;0;3;9
12861;Zylutė;NYKŠTUKAI;1797701777;Taip;0;1;0;1
12862;Zylutė;NYKŠTUKAI;1220439948;Taip;4;9;1;14
12863;Zylutė;NYKŠTUKAI;4646273830;Ne;3;6;0;9
12864;Zylutė;NYKŠTUKAI;6165548450;Taip;3;6;0;9
12865;Zylutė;NYKŠTUKAI;6784471792;Taip;4;9;0;13
12866;Zylutė;NYKŠTUKAI;8346794629;Taip;6;3;0;9
12867;Zylutė;NYKŠTUKAI;2966482773;Taip;8;4;0;12
12868;Zylutė;NYKŠTUKAI;9769201088;Ne;19;6;0;25
12869;Zylutė;NYKŠTUKAI;8820121776;Taip;4;6;0;10
12870;Zylutė;NYKŠTUKAI;4611555689;Taip;0;7;1;8
12871;Zylutė;NYKŠTUKAI;2110860958;Taip;4;6;0;10
12872;Zylutė;NYKŠTUKAI;9330583784;Taip;9;6;0;15
12873;Zylutė;NYKŠTUKAI;9580188426;Ne;5;5;0;10
12874;Zylutė;Ručijok;4916625058;Taip;14;2;0;16
12875;Zylutė;Ručijok;6848387941;Taip;18;1;0;19
12876;Zylutė;Ručijok;6962852787;Taip;0;11;0;11
12877;Zylutė;Ručijok;4548205666;Taip;0;11;0;11
12878;Zylutė;Ručijok;9220918504;Taip;20;0;0;20
12879;Zylutė;Ručijok;3447644735;Taip;7;8;0;15
12880;Zylutė;Ručijok;5096881585;Ne;22;0;0;22
12881;Zylutė;Ručijok;2444440430;Taip;4;5;0;9
12882;Zylutė;Ručijok;8130859512;Taip;3;0;4;7
12883;Zylutė;Ručijok;3372639449;Taip;0;0;3;3
12884;Zylutė;Ručijok;1404949829;Taip;0;6;0;6
12885;Zylutė;Ručijok;3174042441;Taip;3;6;0;9
12886;Zylutė;Ručijok;6281989117;Taip;13;1;0;14
12887;Zylutė;Ručijok;9193349264;Taip;3;0;0;3
12888;Zylutė;Ručijok;6601967273;Taip;3;7;3;13
12889;Zylutė;Ručijok;8204885376;Taip;0;0;5;5
12890;Zylutė;Raduga;9325387975;Taip;0;14;0;14
12891;Zylutė;Raduga;3363212754;Taip;0;9;0;9
12892;Zylutė;Raduga;6569135467;Taip;0;15;0;15
12893;Zylutė;Raduga;3117948118;Taip;8;0;3;11
12894;Zylutė;Raduga;3826815202;Taip;0;0;4;4
12895;Zylutė;Raduga;3943002728;Taip;5;6;0;11
12896;Zylutė;Raduga;4043810535;Taip;3;0;0;3
12897;Zylutė;Raduga;2107123106;Ne;10;0;1;11
12898;Zylutė;Raduga;7482740111;Taip;0;0;3;3
12899;Zylutė;Raduga;7824348276;Taip;6;0;0;6
12900;Zylutė;Raduga;4811667497;Ne;5;4;2;11
12901;Zylutė;Raduga;6391999153;Taip;0;0;1;1
12902;Zylutė;Raduga;6833030749;Taip;3;10;0;13
12903;Zylutė;Raduga;4493469560;Taip;8;0;1;9
12904;Zylutė;Raduga;3608920051;Taip;0;2;0;2
12905;Zylutė;Raduga;5233163416;Taip;0;3;1;4
12906;Zylutė;Raduga;3059970035;Taip;0;3;1;4
12907;Zylutė;Raduga;6340289012;Taip;1;0;2;3
12908;Zylutė;"Miki Maus";6833822248;Taip;21;0;0;21
12909;Zylutė;"Miki Maus";2501761963;Taip;1;7;0;8
12910;Zylutė;"Miki Maus";9159342804;Taip;22;0;0;22
12911;Zylutė;"Miki Maus";8023418946;Taip;13;0;0;13
12912;Zylutė;"Miki Maus";5369354390;Taip;0;12;7;19
12913;Zylutė;"Miki Maus";8121814945;Taip;1;0;0;1
12914;Zylutė;"Miki Maus";2313423907;Taip;0;7;0;7
12915;Zylutė;"Miki Maus";2489898107;Taip;16;0;0;16
12916;Zylutė;"Miki Maus";1070853175;Taip;0;5;0;5
12917;Zylutė;"Miki Maus";8101232865;Taip;0;0;2;2
12918;Zylutė;"Miki Maus";9018673580;Taip;5;0;0;5
12919;Zylutė;"Miki Maus";7762245887;Taip;22;0;0;22
12920;Zylutė;Solnyško;8379932761;Taip;12;7;0;19
12921;Zylutė;Solnyško;5556769710;Taip;0;4;5;9
12922;Zylutė;Solnyško;2088316489;Taip;0;12;0;12
12923;Zylutė;Solnyško;1076803315;Taip;10;0;0;10
12924;Zylutė;Solnyško;7616444695;Taip;19;6;0;25
12925;Zylutė;Solnyško;5234846079;Taip;7;1;0;8
12926;Zylutė;Solnyško;5939522435;Taip;0;13;0;13
12927;Zylutė;Solnyško;2117820453;Taip;10;0;0;10
12928;Zylutė;Solnyško;3111739911;Ne;0;0;1;1
12929;Zylutė;Solnyško;5826813410;Taip;0;19;0;19
12930;Zylutė;Solnyško;8033573972;Ne;8;0;0;8
12931;Zylutė;Solnyško;7447067072;Taip;8;1;0;9
12932;Zylutė;Solnyško;1386683435;Taip;11;1;0;12
12933;Zylutė;Solnyško;4669449744;Taip;6;4;0;10
12934;Zylutė;Solnyško;4478652694;Ne;0;7;0;7
12935;Zylutė;Solnyško;1969578486;Taip;4;3;0;7
12936;Zylutė;Solnyško;6573541087;Taip;11;6;0;17
12937;Zylutė;Motyliok;7241045507;Taip;7;0;0;7
12938;Zylutė;Motyliok;9913001904;Ne;0;4;0;4
12939;Zylutė;Motyliok;5891900062;Taip;3;6;0;9
12940;Zylutė;Motyliok;6112586092;Taip;5;5;0;10
12941;Zylutė;Motyliok;8178488164;Taip;11;0;0;11
12942;Zylutė;Motyliok;5045652581;Taip;17;4;0;21
12943;Zylutė;Motyliok;9586800176;Taip;6;0;0;6
12944;Zylutė;Motyliok;4497904128;Taip;7;7;0;14
12945;Zylutė;Motyliok;3355159275;Taip;10;4;0;14
12946;Zylutė;Motyliok;9995791665;Taip;13;5;0;18
12947;Zylutė;Motyliok;1455822427;Taip;8;0;0;8
12948;Zylutė;Motyliok;2654373943;Taip;18;1;0;19
12949;Zylutė;Motyliok;3455374127;Taip;8;3;0;11
12950;Zylutė;Motyliok;1632490481;Taip;18;0;0;18
12951;Zylutė;Motyliok;1726060015;Ne;10;0;0;10
12952;Zylutė;Motyliok;1975032693;Taip;10;9;0;19
12953;Zylutė;Motyliok;6051657134;Taip;9;0;0;9
12954;Zylutė;Motyliok;3271366684;Taip;13;4;0;17
12955;Zylutė;Motyliok;1390431397;Taip;5;0;0;5
12956;Zylutė;Motyliok;3633983359;Taip;21;0;0;21
12957;Zylutė;ŽVIRBLIUKAI;9902286013;Ne;0;1;1;2
12958;Zylutė;ŽVIRBLIUKAI;4154010905;Taip;1;0;0;1
12959;Zylutė;ŽVIRBLIUKAI;3919565034;Taip;0;5;0;5
12960;Zylutė;ŽVIRBLIUKAI;1319040747;Taip;8;10;5;23
12961;Zylutė;ŽVIRBLIUKAI;6548786007;Ne;0;11;0;11
12962;Zylutė;ŽVIRBLIUKAI;3074954453;Taip;0;7;1;8
12963;Zylutė;ŽVIRBLIUKAI;1048279422;Taip;0;7;6;13
12964;Zylutė;ŽVIRBLIUKAI;2153133102;Taip;0;10;11;21
12965;Zylutė;ŽVIRBLIUKAI;4394023057;Taip;0;9;0;9
12966;Zylutė;ŽVIRBLIUKAI;8326987895;Taip;0;5;2;7
12967;Zylutė;ŽVIRBLIUKAI;7977376435;Ne;7;0;0;7
12968;Zylutė;"DRUŽNYJE REBIATA";1674095701;Taip;3;12;0;15
12969;Zylutė;VIEVERSĖLIAI;4505081448;Taip;0;6;0;6
12970;Zylutė;VIEVERSĖLIAI;6275164528;Taip;0;2;0;2
12971;Zylutė;VIEVERSĖLIAI;5172154642;Taip;0;6;0;6
12972;Zylutė;VIEVERSĖLIAI;2943888466;Taip;6;6;0;12
12973;Zylutė;VIEVERSĖLIAI;6907378757;Taip;3;0;0;3
12974;Zylutė;VIEVERSĖLIAI;6154352500;Taip;0;2;0;2
12975;Zylutė;VIEVERSĖLIAI;4016518230;Taip;0;3;0;3
12976;Zylutė;VIEVERSĖLIAI;9660898505;Taip;0;5;0;5
12977;Zylutė;VIEVERSĖLIAI;5544338521;Taip;0;4;0;4
12978;Zylutė;VIEVERSĖLIAI;3246229837;Taip;5;0;0;5
12979;Zylutė;VIEVERSĖLIAI;7042731356;Taip;0;7;0;7
12980;Zylutė;VIEVERSĖLIAI;1452384017;Taip;0;5;0;5
12981;Zylutė;VIEVERSĖLIAI;5162635301;Taip;0;13;0;13
12982;Zylutė;VIEVERSĖLIAI;1939618217;Taip;0;1;0;1
12983;Zylutė;VIEVERSĖLIAI;20569748356;Taip;0;5;0;5
12984;Želmenėliai;Bitučių;3268310531;Taip;11;2;0;13
12985;Želmenėliai;Bitučių;2122665619;Taip;0;2;7;9
12986;Želmenėliai;Bitučių;2563117992;Taip;8;0;0;8
12987;Želmenėliai;Bitučių;6799702725;Taip;0;4;0;4
12988;Želmenėliai;Bitučių;9006406225;Taip;0;4;0;4
12989;Želmenėliai;Bitučių;4931835807;Taip;0;4;0;4
12990;Želmenėliai;Bitučių;5147895081;Taip;3;0;0;3
12991;Želmenėliai;Bitučių;6481952132;Taip;0;2;0;2
12992;Želmenėliai;Bitučių;9611741258;Taip;5;0;1;6
12993;Želmenėliai;Bitučių;1619143702;Taip;10;0;0;10
12994;Želmenėliai;Bitučių;9825545754;Taip;10;1;0;11
12995;Želmenėliai;Bitučių;5314438217;Taip;0;1;0;1
12996;Želmenėliai;Bitučių;4927030144;Taip;8;1;0;9
12997;Želmenėliai;Bitučių;3739751121;Taip;6;1;0;7
12998;Želmenėliai;Bitučių;2853659708;Taip;12;0;0;12
12999;Želmenėliai;Kačiukų;1292462938;Taip;5;3;0;8
13000;Želmenėliai;Kačiukų;2350936740;Taip;5;16;0;21
13001;Želmenėliai;Kačiukų;3063417708;Taip;0;22;0;22
13002;Želmenėliai;Kačiukų;2570248893;Taip;0;10;0;10
13003;Želmenėliai;Kačiukų;2577850672;Taip;0;2;0;2
13004;Želmenėliai;Kačiukų;7197717698;Taip;2;6;0;8
13005;Želmenėliai;Kačiukų;7849682820;Taip;0;16;0;16
13006;Želmenėliai;Kačiukų;2111008869;Taip;0;5;8;13
13007;Želmenėliai;Kačiukų;4589396143;Taip;5;2;3;10
13008;Želmenėliai;Kačiukų;4198085732;Taip;0;0;7;7
13009;Želmenėliai;Kačiukų;6509783586;Taip;8;5;2;15
13010;Želmenėliai;Kačiukų;4126499046;Taip;0;4;0;4
13011;Želmenėliai;Kačiukų;4758240577;Taip;0;3;0;3
13012;Želmenėliai;Kačiukų;7094853897;Taip;13;9;0;22
13013;Želmenėliai;Kačiukų;9493581034;Taip;4;16;0;20
13014;Želmenėliai;Kačiukų;4931664953;Taip;0;9;0;9
13015;Želmenėliai;Kačiukų;4376978921;Taip;4;23;0;27
13016;Želmenėliai;Kačiukų;9313666706;Taip;6;4;0;10
13017;Želmenėliai;Kačiukų;8590129703;Taip;4;0;0;4
13018;Želmenėliai;Kačiukų;3959066963;Taip;0;1;6;7
13019;Želmenėliai;Voveriukų;3258904017;Taip;0;11;0;11
13020;Želmenėliai;Voveriukų;1952686295;Taip;0;11;0;11
13021;Želmenėliai;Voveriukų;2231634495;Taip;0;15;0;15
13022;Želmenėliai;Voveriukų;1582618217;Taip;0;8;0;8
13023;Želmenėliai;Voveriukų;7054808979;Ne;0;11;0;11
13024;Želmenėliai;Voveriukų;9488762308;Taip;0;0;7;7
13025;Želmenėliai;Voveriukų;6343814445;Taip;0;9;0;9
13026;Želmenėliai;Voveriukų;7833143421;Taip;0;10;1;11
13027;Želmenėliai;Voveriukų;8418427863;Taip;15;1;0;16
13028;Želmenėliai;Voveriukų;5360157217;Taip;3;21;0;24
13029;Želmenėliai;Voveriukų;2545133678;Taip;0;2;0;2
13030;Želmenėliai;Voveriukų;8667865301;Taip;6;12;2;20
13031;Želmenėliai;Voveriukų;7099039424;Taip;0;1;0;1
13032;Želmenėliai;Ežiukų;1652131150;Taip;0;7;0;7
13033;Želmenėliai;Ežiukų;5795735579;Taip;2;1;0;3
13034;Želmenėliai;Ežiukų;3353793939;Taip;0;4;0;4
13035;Želmenėliai;Ežiukų;7495157523;Taip;1;0;0;1
13036;Želmenėliai;Ežiukų;3972980949;Taip;0;11;0;11
13037;Želmenėliai;Ežiukų;6779746783;Taip;13;10;0;23
13038;Želmenėliai;Ežiukų;6876147546;Taip;0;20;0;20
13039;Želmenėliai;Ežiukų;9126715074;Taip;0;1;0;1
13040;Želmenėliai;Ežiukų;1260607572;Taip;0;4;0;4
13041;Želmenėliai;Ežiukų;5638248652;Taip;0;19;0;19
13042;Želmenėliai;Ežiukų;8154713582;Taip;18;0;0;18
13043;Želmenėliai;Ežiukų;2296870749;Taip;10;6;0;16
13044;Želmenėliai;Ežiukų;6180553648;Taip;0;10;0;10
13045;Želmenėliai;Ežiukų;5171736943;Taip;0;5;0;5
13046;Želmenėliai;Ežiukų;7294722095;Taip;16;12;0;28
13047;Želmenėliai;Ežiukų;4120125150;Taip;16;7;0;23
13048;Želmenėliai;Ežiukų;5281861477;Taip;0;10;0;10
13049;Želmenėliai;Ežiukų;8987377791;Taip;0;4;0;4
13050;Želmenėliai;Ežiukų;7373892344;Taip;8;7;0;15
13051;Želmenėliai;Peledžiukų;4206128805;Taip;0;1;0;1
13052;Želmenėliai;Peledžiukų;6816346946;Taip;0;1;0;1
13053;Želmenėliai;Peledžiukų;9359070885;Taip;3;2;0;5
13054;Želmenėliai;Peledžiukų;5787772212;Taip;8;1;0;9
13055;Želmenėliai;Peledžiukų;1239398642;Taip;0;6;0;6
13056;Želmenėliai;Peledžiukų;29112205705;Taip;0;8;0;8
13057;Želmenėliai;Peledžiukų;1248541555;Taip;5;3;0;8
13058;Želmenėliai;Peledžiukų;8995804360;Taip;0;2;0;2
13059;Želmenėliai;Peledžiukų;5616709457;Taip;6;8;0;14
13060;Želmenėliai;Peledžiukų;8300887366;Taip;2;5;0;7
13061;Želmenėliai;Peledžiukų;5842563754;Taip;0;6;0;6
13062;Želmenėliai;Peledžiukų;1941723687;Taip;6;0;0;6
13063;Želmenėliai;Peledžiukų;8590746750;Taip;2;1;0;3
13064;Želmenėliai;Peledžiukų;8491797555;Taip;19;3;0;22
13065;Želmenėliai;Peledžiukų;37152467004;Taip;4;2;0;6
13066;Želmenėliai;Drugelių;7664430346;Taip;0;0;2;2
13067;Želmenėliai;Drugelių;3417538909;Taip;0;2;2;4
13068;Želmenėliai;Drugelių;3295852546;Taip;0;11;0;11
13069;Želmenėliai;Drugelių;3379266015;Taip;3;6;0;9
13070;Želmenėliai;Drugelių;5633127620;Taip;0;9;0;9
13071;Želmenėliai;Drugelių;1984105453;Taip;14;0;0;14
13072;Želmenėliai;Drugelių;4652412483;Taip;0;8;0;8
13073;Želmenėliai;Drugelių;1652949383;Taip;0;9;0;9
13074;Želmenėliai;Drugelių;5046836398;Taip;0;2;0;2
13075;Želmenėliai;Drugelių;9237611484;Taip;7;0;0;7
13076;Želmenėliai;Drugelių;13558387807;Taip;8;1;0;9
13077;Želmenėliai;Drugelių;5143554665;Taip;0;6;0;6
13078;Želmenėliai;Drugelių;7585159351;Taip;0;3;0;3
13079;Želmenėliai;Drugelių;9207984505;Taip;0;1;0;1
13080;Želmenėliai;Drugelių;4634346755;Taip;0;8;0;8
13081;Želmenėliai;Drugelių;4916436238;Taip;0;4;0;4
13082;Želmenėliai;Drugelių;5558795651;Taip;0;11;0;11
13083;Želmenėliai;Voriukų;4264751761;Taip;0;4;0;4
13084;Želmenėliai;Voriukų;1203343580;Taip;0;13;0;13
13085;Želmenėliai;Voriukų;9351650342;Ne;7;0;0;7
13086;Želmenėliai;Voriukų;3014568232;Taip;0;4;0;4
13087;Želmenėliai;Voriukų;6916426436;Taip;0;1;0;1
13088;Želmenėliai;Voriukų;7563461821;Taip;0;5;0;5
13089;Želmenėliai;Voriukų;4075533071;Taip;0;2;0;2
13090;Želmenėliai;Voriukų;4545012342;Taip;0;7;0;7
13091;Želmenėliai;Voriukų;7505996978;Taip;14;5;0;19
13092;Želmenėliai;Voriukų;2722619508;Taip;0;7;0;7
13093;Želmenėliai;Voriukų;5025345647;Taip;0;7;0;7
13094;Želmenėliai;Voriukų;8892137326;Taip;0;4;0;4
13095;Želmenėliai;Voriukų;7700521261;Taip;0;4;0;4
13096;Želmenėliai;Voriukų;1649724696;Ne;0;5;0;5
13097;Želmenėliai;Voriukų;5794346039;Taip;0;6;0;6
13098;Želmenėliai;Voriukų;8206979332;Taip;0;0;1;1
13099;Želmenėliai;Boružėlių;22539846993;Taip;0;1;0;1
13100;Želmenėliai;Boružėlių;5223588064;Taip;0;1;0;1
13101;Želmenėliai;Boružėlių;91372955120;Taip;0;6;0;6
13102;Želmenėliai;Boružėlių;2898358705;Taip;0;7;0;7
13103;Želmenėliai;Boružėlių;10462964817;Taip;3;4;0;7
13104;Želmenėliai;Boružėlių;2103938312;Taip;4;0;0;4
13105;Želmenėliai;Boružėlių;35901929384;Ne;9;9;0;18
13106;Želmenėliai;Boružėlių;39675390598;Taip;0;2;0;2
13107;Želmenėliai;Boružėlių;1290780920;Taip;2;2;0;4
13108;Želmenėliai;Boružėlių;98852944217;Taip;0;7;0;7
13109;Želmenėliai;Boružėlių;7502363323;Ne;0;11;0;11
13110;Želmenėliai;Boružėlių;1009164107;Ne;0;0;22;22
13111;Želmenėliai;Boružėlių;92486344928;Taip;0;1;0;1
13112;Želmenėliai;Boružėlių;1802714172;Taip;0;2;0;2
13113;Želmenėliai;Boružėlių;1933769076;Taip;0;5;6;11
13114;Želmenėliai;Boružėlių;9414488405;Taip;0;17;0;17
13115;Želmenėliai;Boružėlių;2005437403;Taip;0;7;0;7
13116;Želmenėliai;Boružėlių;2044063398;Taip;0;7;0;7
13117;Želmenėliai;Boružėlių;1744939559;Taip;0;1;0;1
13118;Želmenėliai;Boružėlių;27187464726;Taip;0;2;0;2
13119;Želmenėliai;Pūkuotukų;1803684569;Taip;0;1;0;1
13120;Želmenėliai;Ančiukų;5929410363;Taip;1;12;0;13
13121;Želmenėliai;Ančiukų;7751609462;Taip;0;10;0;10
13122;Želmenėliai;Ančiukų;4374898642;Taip;0;3;0;3
13123;Želmenėliai;Ančiukų;4485249321;Taip;0;7;0;7
13124;Želmenėliai;Ančiukų;2951719129;Taip;0;11;0;11
13125;Želmenėliai;Ančiukų;3869372021;Taip;0;4;0;4
13126;Želmenėliai;Ančiukų;5362390260;Taip;0;10;0;10
13127;Želmenėliai;Ančiukų;1580370689;Taip;0;10;0;10
13128;Želmenėliai;Ančiukų;6260153299;Taip;0;2;0;2
13129;Želmenėliai;Ančiukų;5205425589;Taip;0;1;0;1
13130;Želmenėliai;Ančiukų;1983575576;Taip;0;1;0;1
13131;Želmenėliai;Ančiukų;7672980212;Taip;5;7;0;12
13132;Želmenėliai;Ančiukų;3723155757;Taip;20;11;0;31
13133;Želmenėliai;Ančiukų;4810571143;Taip;3;14;0;17
13134;Želmenėliai;Ančiukų;6402784913;Ne;22;10;0;32
13135;Želmenėliai;Nykštukų;6187661667;Taip;4;4;0;8
13136;Želmenėliai;Nykštukų;4746898209;Taip;0;4;0;4
13137;Želmenėliai;Nykštukų;6109546917;Taip;22;0;0;22
13138;Želmenėliai;Nykštukų;8474210476;Taip;8;0;0;8
13139;Želmenėliai;Nykštukų;2179165096;Taip;17;0;0;17
13140;Želmenėliai;Nykštukų;2111705047;Taip;3;0;0;3
13141;Želmenėliai;Nykštukų;6662439747;Taip;8;1;0;9
13142;Želmenėliai;Nykštukų;8118696261;Taip;3;9;0;12
13143;Želmenėliai;Nykštukų;6230010537;Taip;8;0;0;8
13144;Želmenėliai;Nykštukų;5514167627;Taip;0;9;0;9
13145;Želmenėliai;Nykštukų;9929149682;Taip;16;0;0;16
13146;Želmenėliai;Nykštukų;5207899503;Taip;22;0;0;22
13147;Želmenėliai;Nykštukų;5052052744;Taip;0;6;0;6
13148;Želmenėliai;Nykštukų;2066439950;Taip;0;1;0;1
13149;Želmenėliai;Nykštukų;6764567873;Taip;0;18;0;18
13150;Želmenėliai;Lašelių;2262009049;Taip;8;0;0;8
13151;Želmenėliai;Lašelių;5161934903;Taip;0;5;0;5
13152;Želmenėliai;Lašelių;8654298177;Taip;14;0;0;14
13153;Želmenėliai;Lašelių;6761848439;Taip;8;1;0;9
13154;Želmenėliai;Lašelių;4451798870;Taip;8;0;0;8
13155;Želmenėliai;Lašelių;4485851428;Taip;8;5;0;13
13156;Želmenėliai;Lašelių;8147408275;Taip;6;1;0;7
13157;Želmenėliai;Lašelių;3558547171;Taip;7;0;0;7
13158;Želmenėliai;Lašelių;3516695805;Taip;10;6;0;16
13159;Želmenėliai;Lašelių;7077832687;Taip;0;17;0;17
13160;Želmenėliai;Lašelių;6569807889;Taip;0;8;0;8
13161;Želmenėliai;Lašelių;1764468979;Taip;9;2;0;11
13162;Želmenėliai;Lašelių;8722573513;Taip;0;4;0;4
13163;Želmenėliai;Lašelių;5949535657;Taip;14;0;0;14
13164;Želmenėliai;Lašelių;3896171121;Taip;15;3;0;18
13165;Želmenėliai;Lašelių;4930868989;Taip;8;1;0;9
13166;Želmenėliai;Lašelių;2501163903;Taip;7;0;0;7
13167;Želmenėliai;"ANČIUKAI 1";8060048377;Taip;0;2;0;2
13168;Žemyna;Čiauškučiai;9985529041;Taip;0;16;0;16
13169;Žemyna;Čiauškučiai;9570187081;Taip;0;1;0;1
13170;Žemyna;Čiauškučiai;2547436771;Taip;0;20;0;20
13171;Žemyna;Čiauškučiai;6051208732;Taip;2;0;0;2
13172;Žemyna;Čiauškučiai;6346173832;Taip;4;0;1;5
13173;Žemyna;Čiauškučiai;8694608716;Taip;0;0;2;2
13174;Žemyna;Čiauškučiai;3074391266;Taip;0;10;0;10
13175;Žemyna;Čiauškučiai;7620179886;Taip;0;0;8;8
13176;Žemyna;Čiauškučiai;2792702536;Taip;0;0;1;1
13177;Žemyna;Čiauškučiai;7277970673;Taip;0;3;1;4
13178;Žemyna;Čiauškučiai;7427119736;Taip;5;1;0;6
13179;Žemyna;Čiauškučiai;4642600915;Taip;7;0;0;7
13180;Žemyna;Čiauškučiai;2354265632;Taip;4;5;0;9
13181;Žemyna;Čiauškučiai;2887459684;Taip;0;0;2;2
13182;Žemyna;Čiauškučiai;1654157342;Taip;0;1;0;1
13183;Žemyna;Čiauškučiai;4652384557;Taip;10;0;1;11
13184;Žemyna;Čiauškučiai;7352868453;Taip;9;0;0;9
13185;Žemyna;Čiauškučiai;4501408683;Taip;0;6;0;6
13186;Žemyna;Čiauškučiai;4613946229;Taip;0;3;1;4
13187;Žemyna;Nykštukai;5114094924;Taip;0;2;0;2
13188;Žemyna;Nykštukai;3874855308;Taip;0;0;6;6
13189;Žemyna;Nykštukai;2461700030;Taip;0;6;0;6
13190;Žemyna;Nykštukai;1725771976;Taip;0;0;8;8
13191;Žemyna;Nykštukai;8622780639;Taip;0;0;1;1
13192;Žemyna;Nykštukai;3643594001;Taip;5;4;1;10
13193;Žemyna;Nykštukai;7121742098;Taip;0;7;1;8
13194;Žemyna;Nykštukai;1468040559;Ne;0;8;0;8
13195;Žemyna;Nykštukai;4322192775;Taip;0;4;0;4
13196;Žemyna;Nykštukai;4444870782;Taip;0;2;6;8
13197;Žemyna;Nykštukai;4257096808;Taip;3;1;1;5
13198;Žemyna;Nykštukai;1575505075;Taip;0;5;0;5
13199;Žemyna;Nykštukai;2860210906;Taip;0;0;4;4
13200;Žemyna;Nykštukai;7832066079;Taip;0;7;0;7
13201;Žemyna;Nykštukai;4759403487;Taip;0;0;7;7
13202;Žemyna;Nykštukai;9653530823;Taip;0;7;0;7
13203;Žemyna;Nykštukai;7508491119;Taip;0;0;2;2
13204;Žemyna;Nykštukai;2928125522;Taip;0;6;0;6
13205;Žemyna;Voveriukai;8500642069;Taip;0;0;3;3
13206;Žemyna;Voveriukai;7925774308;Taip;3;0;0;3
13207;Žemyna;Voveriukai;2412956023;Taip;0;13;0;13
13208;Žemyna;Voveriukai;3938938667;Taip;0;9;0;9
13209;Žemyna;Voveriukai;9958040413;Taip;19;0;0;19
13210;Žemyna;Voveriukai;1531980297;Taip;0;8;0;8
13211;Žemyna;Voveriukai;1114714466;Taip;0;0;5;5
13212;Žemyna;Voveriukai;1543415914;Taip;5;0;4;9
13213;Žemyna;Voveriukai;9148594407;Taip;0;5;0;5
13214;Žemyna;Voveriukai;9866110744;Taip;0;1;4;5
13215;Žemyna;Voveriukai;7693278353;Taip;0;9;1;10
13216;Žemyna;Voveriukai;1118997229;Taip;0;6;0;6
13217;Žemyna;Voveriukai;3357339710;Taip;0;0;1;1
13218;Žemyna;Kiškučiai;3398294520;Ne;0;10;0;10
13219;Žemyna;Kiškučiai;6264082741;Taip;8;0;0;8
13220;Žemyna;Kiškučiai;2593454678;Taip;2;0;0;2
13221;Žemyna;Kiškučiai;2100326039;Taip;0;0;2;2
13222;Žemyna;Kiškučiai;51870099224;Taip;12;0;3;15
13223;Žemyna;Kiškučiai;1705971732;Taip;0;0;1;1
13224;Žemyna;Kiškučiai;1623854426;Taip;0;0;1;1
13225;Žemyna;Kiškučiai;45222048620;Taip;0;6;1;7
13226;Žemyna;Kiškučiai;17784132877;Taip;0;0;1;1
13227;Žemyna;Kiškučiai;1471204471;Taip;0;0;3;3
13228;Žemyna;Kiškučiai;50369667193;Taip;0;3;0;3
13229;Žemyna;Kiškučiai;1941650167;Taip;0;0;3;3
13230;Žemyna;Kiškučiai;84680481889;Taip;0;0;1;1
13231;Žemyna;Kiškučiai;1607110213;Taip;2;0;0;2
13232;Žemyna;Kiškučiai;1299164876;Taip;0;9;0;9
13233;Žemyna;Kiškučiai;69532565511;Taip;0;0;4;4
13234;Žemyna;Vyturiukai;38769607968;Taip;0;0;3;3
13235;Žemyna;Vyturiukai;1687206394;Taip;4;9;0;13
13236;Žemyna;Vyturiukai;85135645557;Taip;0;3;1;4
13237;Žemyna;Vyturiukai;59506345859;Taip;0;1;0;1
13238;Žemyna;Vyturiukai;89787441782;Taip;0;2;0;2
13239;Žemyna;Vyturiukai;5506889213;Taip;0;1;0;1
13240;Žemyna;Vyturiukai;5306392307;Taip;9;1;0;10
13241;Žemyna;Vyturiukai;9018138289;Taip;0;9;0;9
13242;Žemyna;Vyturiukai;37570629861;Taip;0;6;0;6
13243;Žemyna;Vyturiukai;13242930752;Taip;0;1;0;1
13244;Žemyna;Vyturiukai;93423088394;Taip;0;11;0;11
13245;Žemyna;Vyturiukai;8040359407;Ne;0;0;4;4
13246;Žemyna;Vyturiukai;4524929331;Taip;3;1;0;4
13247;Žemyna;Vyturiukai;3622634119;Taip;0;0;3;3
13248;Žemyna;Vyturiukai;5815116293;Taip;0;1;0;1
13249;Žemyna;Vyturiukai;8096035110;Taip;3;0;1;4
13250;Žemyna;Vyturiukai;5933910526;Taip;0;0;3;3
13251;Žemyna;Pelėdžiukai;72801825176;Taip;0;0;5;5
13252;Žemyna;Pelėdžiukai;38604851102;Taip;0;0;7;7
13253;Žemyna;Pelėdžiukai;39175264243;Taip;0;1;0;1
13254;Žemyna;Pelėdžiukai;54253890981;Taip;1;0;3;4
13255;Žemyna;Pelėdžiukai;32755929074;Taip;0;8;0;8
13256;Žemyna;Pelėdžiukai;1694969407;Taip;3;0;0;3
13257;Žemyna;Pelėdžiukai;35462796459;Taip;0;0;7;7
13258;Žemyna;Pelėdžiukai;7343337032;Taip;0;0;1;1
13259;Žemyna;Pelėdžiukai;6089122225;Taip;0;3;0;3
13260;Žemyna;Pelėdžiukai;54823974018;Taip;0;2;2;4
13261;Žemyna;Pelėdžiukai;88775150201;Taip;0;0;4;4
13262;Žemyna;Pelėdžiukai;58578414067;Taip;0;0;1;1
13263;Žemyna;Pelėdžiukai;1305667359;Taip;0;0;2;2
13264;Žemyna;Pelėdžiukai;1421842247;Taip;0;0;2;2
13265;Žemyna;Pelėdžiukai;1049546597;Taip;0;0;1;1
13266;Žemyna;Pelėdžiukai;1649910477;Taip;0;0;6;6
13267;Žemyna;Vijurkai;17098859260;Taip;5;0;4;9
13268;Žemyna;Vijurkai;1882507954;Taip;0;0;3;3
13269;Žemyna;Vijurkai;80737839511;Taip;0;4;0;4
13270;Žemyna;Vijurkai;50687988382;Taip;0;4;0;4
13271;Žemyna;Vijurkai;6775880309;Taip;0;0;1;1
13272;Žemyna;Vijurkai;4796265997;Taip;0;0;3;3
13273;Žemyna;Vijurkai;1278096396;Taip;0;0;15;15
13274;Žemyna;Vijurkai;86746604640;Taip;0;1;0;1
13275;Žemyna;Vijurkai;82507236376;Taip;0;0;1;1
13276;Žemyna;Vijurkai;1847882950;Taip;0;0;2;2
13277;Žemyna;Vijurkai;8496195396;Taip;0;0;2;2
13278;Žemyna;Vijurkai;8726346349;Taip;3;0;2;5
13279;Žemyna;Vijurkai;2841526614;Taip;0;0;2;2
13280;Žemyna;Vijurkai;3596822649;Taip;1;0;0;1
13281;Žemyna;Vijurkai;84955588471;Taip;0;13;0;13
13282;Žemyna;Vijurkai;7008807590;Taip;12;0;2;14
13283;Žemyna;Vijurkai;30337030701;Taip;0;4;0;4
13284;Žemyna;Vijurkai;7120661911;Taip;0;0;1;1
13285;Žemyna;Vijurkai;5093418481;Taip;0;0;2;2
13286;Žemyna;Vijurkai;1187261223;Taip;0;0;8;8
13287;Žemyna;Vijurkai;57678677626;Taip;0;1;0;1
13288;Žemyna;Šnekučiai;6735720135;Taip;0;9;0;9
13289;Žemyna;Šnekučiai;2006173745;Taip;0;1;0;1
13290;Žemyna;Šnekučiai;6116581655;Taip;0;0;2;2
13291;Žemyna;Šnekučiai;7280740926;Taip;8;0;0;8
13292;Žemyna;Šnekučiai;6419974691;Taip;0;0;3;3
13293;Žemyna;Šnekučiai;9818711030;Taip;0;2;1;3
13294;Žemyna;Šnekučiai;9219519029;Taip;7;9;0;16
13295;Žemyna;Šnekučiai;7764615445;Taip;0;0;1;1
13296;Žemyna;Šnekučiai;5868208651;Taip;0;1;0;1
13297;Žemyna;Šnekučiai;3992383447;Taip;13;4;0;17
13298;Žemyna;Šnekučiai;9668975591;Taip;3;0;0;3
13299;Žemyna;Šnekučiai;6856737270;Taip;0;0;2;2
13300;Žemyna;Šnekučiai;4872348199;Taip;0;0;2;2
13301;Žemyna;Šnekučiai;6878669773;Taip;0;0;1;1
13302;Žemyna;Šnekučiai;4502958166;Taip;9;3;0;12
13303;Žemyna;Šnekučiai;6728229865;Taip;0;6;0;6
13304;Žemyna;Šnekučiai;2710551760;Taip;0;15;0;15
13305;Žemyna;Šnekučiai;4612112289;Taip;0;2;0;2
13306;Žemyna;Šnekučiai;3875204515;Taip;1;0;0;1
13307;Žemyna;Pabiručiai;9827401825;Taip;8;7;0;15
13308;Žemyna;Pabiručiai;5743535463;Taip;0;16;0;16
13309;Žemyna;Pabiručiai;6958537154;Taip;0;1;0;1
13310;Žemyna;Pabiručiai;1745197274;Taip;0;6;0;6
13311;Žemyna;Pabiručiai;6041223291;Taip;10;0;6;16
13312;Žemyna;Pabiručiai;9094718595;Taip;10;0;0;10
13313;Žemyna;Pabiručiai;6208953341;Taip;4;3;0;7
13314;Žemyna;Pabiručiai;1656335765;Taip;5;1;0;6
13315;Žemyna;Pabiručiai;5127174926;Taip;3;4;0;7
13316;Žemyna;Pabiručiai;8559870965;Taip;0;0;1;1
13317;Žemyna;Pabiručiai;1850100203;Taip;6;0;7;13
13318;Žemyna;Pabiručiai;6450681255;Taip;3;0;0;3
13319;Žemyna;Pabiručiai;2860232791;Taip;0;0;10;10
13320;Žemyna;Pabiručiai;4237778022;Taip;10;0;0;10
13321;Žemyna;Pabiručiai;2414400761;Taip;0;16;0;16
13322;Žemyna;Pabiručiai;9511935264;Taip;0;3;0;3
13323;Žemyna;Pabiručiai;8681308720;Taip;3;4;0;7
13324;Žemyna;Pabiručiai;4176386795;Taip;4;9;0;13
13325;Žemyna;Pabiručiai;3393414493;Taip;12;0;0;12
13326;Žemyna;Drugeliai;1867198805;Taip;0;4;0;4
13327;Žemyna;Drugeliai;8018865138;Taip;0;1;0;1
13328;Žemyna;Drugeliai;5233574060;Taip;0;5;0;5
13329;Žemyna;Drugeliai;8185243991;Taip;0;0;4;4
13330;Žemyna;Drugeliai;8525229514;Taip;22;0;0;22
13331;Žemyna;Drugeliai;1846287760;Taip;8;0;4;12
13332;Žemyna;Drugeliai;8775518984;Taip;22;0;0;22
13333;Žemyna;Drugeliai;5337086029;Taip;12;0;0;12
13334;Žemyna;Drugeliai;8926045231;Taip;0;11;0;11
13335;Žemyna;Drugeliai;3860791215;Taip;0;5;0;5
13336;Žemyna;Drugeliai;7676796264;Taip;0;3;0;3
13337;Žemyna;Drugeliai;3895238312;Taip;5;0;0;5
13338;Žemyna;Drugeliai;15110117571;Taip;12;9;0;21
13339;Žemyna;Drugeliai;1058705875;Taip;0;5;0;5
13340;Žemyna;Drugeliai;1717797530;Taip;0;0;2;2
13341;Žemyna;Drugeliai;8139714064;Taip;0;0;1;1
13342;Žemyna;Drugeliai;2090395417;Taip;0;7;0;7
13343;Žemyna;Drugeliai;6536698798;Taip;0;5;0;5
13344;Žemyna;Drugeliai;5056205809;Taip;8;0;0;8
13345;Žemyna;"ŽIRNIUKAI ";5416338054;Taip;9;0;0;9
13346;Žemyna;"ŽIRNIUKAI ";5133115712;Taip;9;0;0;9
13347;Žemyna;"ŽIRNIUKAI ";1417007895;Taip;5;0;3;8
13348;Žemyna;"ŽIRNIUKAI ";7300819771;Taip;0;0;3;3
13349;Žemyna;"ŽIRNIUKAI ";5355845891;Taip;0;0;3;3
13350;Žemyna;"ŽIRNIUKAI ";1481273689;Taip;7;0;0;7
13351;Žemyna;"ŽIRNIUKAI ";8577299116;Taip;0;0;16;16
13352;Žemyna;"ŽIRNIUKAI ";7781332622;Taip;8;0;0;8
13353;Žemyna;"ŽIRNIUKAI ";1031171460;Taip;8;0;3;11
13354;Žemyna;"ŽIRNIUKAI ";1345704379;Taip;7;0;0;7
13355;Žemyna;"ŽIRNIUKAI ";7920398415;Taip;0;7;0;7
13356;Žemyna;"ŽIRNIUKAI ";6097681172;Taip;7;0;4;11
13357;Žemyna;"ŽIRNIUKAI ";3446774478;Taip;8;0;0;8
13358;Žemyna;"ŽIRNIUKAI ";2304633263;Taip;11;0;0;11
13359;Žemyna;"ŽIRNIUKAI ";3501732353;Taip;8;0;2;10
13360;Žemyna;"ŽIRNIUKAI ";2526949655;Taip;14;0;0;14
13361;Žemyna;"ŽIRNIUKAI ";9366133892;Taip;5;0;0;5
13362;Žemyna;"ŽIRNIUKAI ";5204349188;Taip;8;0;0;8
13363;Žemyna;"ŽIOGELIAI ";2102920661;Taip;0;2;1;3
13364;Žemyna;"ŽIOGELIAI ";3390442637;Taip;15;1;0;16
13365;Žemyna;"ŽIOGELIAI ";2371069183;Taip;0;0;1;1
13366;Žemyna;"ŽIOGELIAI ";6575272457;Taip;2;0;3;5
13367;Žemyna;"ŽIOGELIAI ";2139103576;Taip;0;0;1;1
13368;Žemyna;"ŽIOGELIAI ";1279981170;Taip;6;0;1;7
13369;Žemyna;"ŽIOGELIAI ";5518125715;Taip;20;0;0;20
13370;Žemyna;"ŽIOGELIAI ";6164541167;Taip;13;0;1;14
13371;Žemyna;"ŽIOGELIAI ";7564693757;Taip;0;0;4;4
13372;Žemyna;"ŽIOGELIAI ";3872427931;Taip;0;4;0;4
13373;Žemyna;"ŽIOGELIAI ";2231967652;Taip;22;0;0;22
13374;Žemyna;"ŽIOGELIAI ";3505551915;Taip;0;14;0;14
13375;Žemyna;"ŽIOGELIAI ";9171823612;Taip;16;0;0;16
13376;Žemyna;"ŽIOGELIAI ";9589582451;Taip;6;0;0;6
13377;Žemyna;"ŽIOGELIAI ";9692952139;Taip;0;4;1;5
13378;Žemuogėlė;Boružiukai;1251497003;Taip;0;8;0;8
13379;Žemuogėlė;Boružiukai;3706531223;Taip;4;1;0;5
13380;Žemuogėlė;Boružiukai;4565097904;Taip;4;1;0;5
13381;Žemuogėlė;Boružiukai;8644564820;Taip;0;6;0;6
13382;Žemuogėlė;Boružiukai;3546429231;Taip;0;6;0;6
13383;Žemuogėlė;Boružiukai;9579921777;Taip;0;1;0;1
13384;Žemuogėlė;Boružiukai;3073956225;Taip;0;2;0;2
13385;Žemuogėlė;Boružiukai;4933948491;Taip;7;2;1;10
13386;Žemuogėlė;Boružiukai;6747566307;Taip;5;0;0;5
13387;Žemuogėlė;Boružiukai;2115883173;Taip;7;0;0;7
13388;Žemuogėlė;Boružiukai;7592566602;Taip;0;4;1;5
13389;Žemuogėlė;Boružiukai;1555899448;Taip;0;1;0;1
13390;Žemuogėlė;Boružiukai;9693814425;Taip;0;9;0;9
13391;Žemuogėlė;Boružiukai;3825509486;Taip;0;10;0;10
13392;Žemuogėlė;Boružiukai;3288369628;Taip;0;1;0;1
13393;Žemuogėlė;Boružiukai;8029484123;Taip;0;9;0;9
13394;Žemuogėlė;Boružiukai;1953538445;Taip;15;1;0;16
13395;Žemuogėlė;Šviesuliukai;3837424301;Taip;9;2;0;11
13396;Žemuogėlė;Šviesuliukai;1049009199;Taip;0;4;0;4
13397;Žemuogėlė;Šviesuliukai;8409711622;Taip;0;8;0;8
13398;Žemuogėlė;Šviesuliukai;5127370193;Taip;0;0;2;2
13399;Žemuogėlė;Šviesuliukai;5126348190;Taip;4;0;7;11
13400;Žemuogėlė;Šviesuliukai;9534937419;Taip;0;0;3;3
13401;Žemuogėlė;Šviesuliukai;3612833383;Taip;1;0;0;1
13402;Žemuogėlė;Šviesuliukai;9689082202;Taip;6;4;0;10
13403;Žemuogėlė;Šviesuliukai;4660479216;Taip;8;0;3;11
13404;Žemuogėlė;Šviesuliukai;5499401648;Taip;0;3;0;3
13405;Žemuogėlė;Šviesuliukai;6707522989;Taip;0;7;0;7
13406;Žemuogėlė;Šviesuliukai;6059069293;Ne;0;17;0;17
13407;Žemuogėlė;Šviesuliukai;5770044886;Taip;0;0;10;10
13408;Žemuogėlė;Šviesuliukai;5971652934;Taip;0;10;0;10
13409;Žemuogėlė;Šviesuliukai;4578291476;Taip;0;0;9;9
13410;Žemuogėlė;Šviesuliukai;7669457695;Taip;2;1;0;3
13411;Žemuogėlė;Šviesuliukai;8675089149;Taip;0;3;0;3
13412;Žemuogėlė;Šviesuliukai;3041461125;Taip;0;2;1;3
13413;Žemuogėlė;Lašiukai;2086546195;Taip;4;2;0;6
13414;Žemuogėlė;Lašiukai;4231767115;Taip;3;0;0;3
13415;Žemuogėlė;Lašiukai;5147617128;Taip;1;8;0;9
13416;Žemuogėlė;Lašiukai;5625943720;Taip;0;8;3;11
13417;Žemuogėlė;Lašiukai;1058207935;Taip;0;5;1;6
13418;Žemuogėlė;Lašiukai;1628749648;Taip;5;0;1;6
13419;Žemuogėlė;Lašiukai;711908013;Taip;0;11;0;11
13420;Žemuogėlė;Lašiukai;6962103028;Taip;0;1;0;1
13421;Žemuogėlė;Lašiukai;7714826773;Taip;9;3;0;12
13422;Žemuogėlė;Lašiukai;3134493860;Taip;0;7;0;7
13423;Žemuogėlė;Lašiukai;38870047353;Taip;6;4;0;10
13424;Žemuogėlė;Lašiukai;7403172794;Taip;3;0;0;3
13425;Žemuogėlė;Lašiukai;9315711142;Taip;7;2;0;9
13426;Žemuogėlė;Lašiukai;2102057496;Taip;0;2;1;3
13427;Žemuogėlė;Lašiukai;94792383091;Taip;0;18;0;18
13428;Žemuogėlė;Lašiukai;4421397490;Taip;4;0;3;7
13429;Žemuogėlė;Skambaliukai;64182347253;Taip;0;5;0;5
13430;Žemuogėlė;Skambaliukai;89682626079;Taip;6;1;0;7
13431;Žemuogėlė;Skambaliukai;21886029194;Taip;0;2;1;3
13432;Žemuogėlė;Skambaliukai;7503799036;Taip;0;0;2;2
13433;Žemuogėlė;Skambaliukai;95392130582;Taip;0;6;0;6
13434;Žemuogėlė;Skambaliukai;1099252682;Taip;0;2;0;2
13435;Žemuogėlė;Skambaliukai;1543283524;Taip;0;1;0;1
13436;Žemuogėlė;Skambaliukai;1085793430;Taip;0;1;0;1
13437;Žemuogėlė;Skambaliukai;1970687025;Taip;0;2;0;2
13438;Žemuogėlė;Skambaliukai;52842591023;Taip;0;9;2;11
13439;Žemuogėlė;Skambaliukai;5911529759;Taip;0;1;0;1
13440;Žemuogėlė;Skambaliukai;1093128368;Taip;0;10;0;10
13441;Žemuogėlė;Skambaliukai;70054283264;Taip;5;1;0;6
13442;Žemuogėlė;Skambaliukai;40590616715;Taip;0;2;7;9
13443;Žemuogėlė;Spinduliukai;75012082294;Taip;0;8;0;8
13444;Žemuogėlė;Spinduliukai;9042246873;Taip;3;5;0;8
13445;Žemuogėlė;Spinduliukai;96167322031;Taip;2;2;0;4
13446;Žemuogėlė;Spinduliukai;8187939143;Taip;0;1;0;1
13447;Žemuogėlė;Spinduliukai;3062268362;Taip;3;1;0;4
13448;Žemuogėlė;Spinduliukai;5395954931;Taip;0;1;0;1
13449;Žemuogėlė;Spinduliukai;29436958034;Taip;0;3;0;3
13450;Žemuogėlė;Spinduliukai;5095782784;Taip;0;0;5;5
13451;Žemuogėlė;Spinduliukai;5972567526;Taip;0;7;0;7
13452;Žemuogėlė;Spinduliukai;3000676765;Taip;0;3;0;3
13453;Žemuogėlė;Spinduliukai;3411390558;Taip;0;2;0;2
13454;Žemuogėlė;Perliukai;9592456683;Taip;0;1;0;1
13455;Žemuogėlė;Perliukai;7804015060;Taip;0;5;0;5
13456;Žemuogėlė;Perliukai;3765022476;Taip;8;2;0;10
13457;Žemuogėlė;Perliukai;2001471529;Taip;0;0;1;1
13458;Žemuogėlė;Perliukai;9519563708;Taip;0;1;0;1
13459;Žemuogėlė;Perliukai;5266493632;Taip;0;2;0;2
13460;Žemuogėlė;Perliukai;3237083654;Taip;0;2;0;2
13461;Žemuogėlė;Perliukai;2259779058;Taip;0;1;0;1
13462;Žemuogėlė;Perliukai;9693894254;Ne;4;2;2;8
13463;Žemuogėlė;Perliukai;9378432383;Taip;0;1;0;1
13464;Žemuogėlė;Perliukai;6913038845;Taip;0;7;0;7
13465;Žemuogėlė;Perliukai;5418395023;Ne;0;2;1;3
13466;Žemuogėlė;Perliukai;6581889641;Taip;0;2;2;4
13467;Žemuogėlė;Perliukai;2555902309;Taip;18;1;0;19
13468;Žemuogėlė;Perliukai;4536398519;Taip;0;4;4;8
13469;Žemuogėlė;Perliukai;8757701456;Taip;6;2;1;9
13470;Žemuogėlė;Perliukai;2132549536;Taip;0;8;0;8
13471;Žemuogėlė;Perliukai;5532053268;Taip;4;3;0;7
13472;Žemuogėlė;Perliukai;8496353410;Taip;0;9;0;9
13473;Žemuogėlė;Perliukai;1733808230;Taip;0;6;2;8
13474;Žemuogėlė;Perliukai;2841634296;Taip;0;2;1;3
13475;Žemuogėlė;Perliukai;9476688736;Taip;14;0;0;14
13476;Žemuogėlė;Perliukai;3458374439;Taip;0;0;1;1
13477;Žemuogėlė;Drugeliai;1350671777;Taip;5;0;0;5
13478;Žemuogėlė;Drugeliai;9344628661;Taip;3;0;0;3
13479;Žemuogėlė;Drugeliai;1639634300;Taip;8;0;0;8
13480;Žemuogėlė;Drugeliai;8661864424;Taip;0;1;0;1
13481;Žemuogėlė;Drugeliai;5427045039;Taip;15;0;0;15
13482;Žemuogėlė;Drugeliai;5911215640;Taip;0;1;2;3
13483;Žemuogėlė;Drugeliai;1150466286;Taip;0;1;0;1
13484;Žemuogėlė;Drugeliai;5521993938;Taip;16;2;0;18
13485;Žemuogėlė;Drugeliai;9562512849;Taip;15;2;0;17
13486;Žemuogėlė;Drugeliai;2158359435;Ne;18;0;0;18
13487;Žemuogėlė;Drugeliai;8426601160;Taip;9;0;0;9
13488;Žemuogėlė;Drugeliai;4663181188;Taip;1;0;2;3
13489;Žemuogėlė;Drugeliai;6086270618;Taip;0;3;0;3
13490;Žemuogėlė;Drugeliai;2745609317;Taip;3;12;0;15
13491;Žemuogėlė;"VIEVERSIUKAI ";9537297860;Taip;3;2;1;6
13492;Žemuogėlė;"VIEVERSIUKAI ";7050896262;Taip;0;2;3;5
13493;Žemuogėlė;"VIEVERSIUKAI ";8557325116;Taip;0;16;0;16
13494;Žemuogėlė;"VIEVERSIUKAI ";7328566035;Taip;4;0;0;4
13495;Žemuogėlė;"VIEVERSIUKAI ";2190458676;Taip;17;0;0;17
13496;Žemuogėlė;"VIEVERSIUKAI ";3413805578;Taip;0;0;1;1
13497;Žemuogėlė;"VIEVERSIUKAI ";1350383125;Taip;0;13;0;13
13498;Žemuogėlė;"VIEVERSIUKAI ";1901423257;Taip;1;0;0;1
13499;Žemuogėlė;"VIEVERSIUKAI ";8040255583;Taip;11;0;0;11
13500;Žemuogėlė;"VIEVERSIUKAI ";7668200447;Taip;0;6;0;6
13501;Žemuogėlė;"VIEVERSIUKAI ";6073591450;Taip;0;0;2;2
13502;Žemuogėlė;"VIEVERSIUKAI ";4862145385;Taip;2;2;0;4
13503;Žemuogėlė;"VIEVERSIUKAI ";3677459716;Taip;1;2;1;4
13504;Žemuogėlė;"VIEVERSIUKAI ";9902953729;Taip;18;4;0;22
13505;Žemuogėlė;"VIEVERSIUKAI ";4368183799;Taip;2;0;1;3
13506;Žemuogėlė;"VIEVERSIUKAI ";7148244029;Taip;4;0;0;4
13507;Žemuogėlė;"NYKŠTUKAI ";5687585794;Taip;1;0;0;1
13508;Žemuogėlė;"NYKŠTUKAI ";3710681463;Taip;10;0;0;10
13509;Žemuogėlė;"NYKŠTUKAI ";4629107942;Ne;19;0;0;19
13510;Žemuogėlė;"NYKŠTUKAI ";1306065826;Taip;0;1;0;1
13511;Žemuogėlė;"NYKŠTUKAI ";2664267604;Taip;0;1;0;1
13512;Žemuogėlė;"NYKŠTUKAI ";1658954821;Taip;5;0;0;5
13513;Žemuogėlė;"NYKŠTUKAI ";2922827304;Taip;0;1;0;1
13514;Žemuogėlė;"NYKŠTUKAI ";7415364637;Taip;14;0;0;14
13515;Žemuogėlė;"NYKŠTUKAI ";1796489729;Taip;5;0;0;5
13516;Žemuogėlė;"NYKŠTUKAI ";8215763877;Taip;1;0;0;1
13517;Žemuogėlė;"NYKŠTUKAI ";2934225120;Taip;3;0;0;3
13518;Žemuogėlė;"NYKŠTUKAI ";3426685084;Taip;0;5;0;5
13519;Žemuogėlė;KIŠKUČIAI;8890454460;Taip;0;1;0;1
13520;Žemuogėlė;KIŠKUČIAI;1341637008;Taip;8;1;0;9
13521;Žemuogėlė;KIŠKUČIAI;4309482351;Taip;0;11;0;11
13522;Žemuogėlė;KIŠKUČIAI;7288060676;Taip;22;0;0;22
13523;Žemuogėlė;KIŠKUČIAI;7189855370;Taip;0;6;0;6
13524;Žemuogėlė;KIŠKUČIAI;7551522580;Taip;0;0;6;6
13525;Žemuogėlė;KIŠKUČIAI;8492878852;Taip;0;2;0;2
13526;Žemuogėlė;KIŠKUČIAI;6755278376;Ne;0;14;0;14
13527;Žemuogėlė;KIŠKUČIAI;3801534195;Taip;14;8;0;22
13528;Žemuogėlė;KIŠKUČIAI;7603740057;Taip;19;0;0;19
13529;Žemuogėlė;KIŠKUČIAI;8848085495;Taip;22;0;0;22
13530;Žemuogėlė;KIŠKUČIAI;4506847669;Taip;0;1;0;1
13531;Žemuogėlė;Žiniukai;1296464444;Taip;0;7;0;7
13532;Žemuogėlė;Žiniukai;3208009994;Taip;1;1;0;2
13533;Žemuogėlė;Žiniukai;2320908623;Taip;0;5;0;5
13534;Žemuogėlė;Žiniukai;1248683052;Taip;0;1;0;1
13535;Žemuogėlė;Žiniukai;2146044539;Taip;0;2;0;2
13536;Žemuogėlė;Žiniukai;57783467185;Taip;0;2;0;2
13537;Žemuogėlė;Žiniukai;4900328025;Taip;5;4;0;9
13538;Žemuogėlė;Žiniukai;8295541141;Taip;0;2;2;4
13539;Žemuogėlė;Žiniukai;31450036105;Taip;5;2;0;7
13540;Žemuogėlė;Žiniukai;1608506638;Taip;0;1;0;1
13541;Žemuogėlė;Žiniukai;1448477562;Taip;0;1;0;1
13542;Žibutė;PELĖDŽIUKAI;54535455969;Taip;0;1;11;12
13543;Žibutė;PELĖDŽIUKAI;62146271609;Taip;0;4;0;4
13544;Žibutė;PELĖDŽIUKAI;85042822872;Taip;1;0;0;1
13545;Žibutė;PELĖDŽIUKAI;59824395612;Taip;0;0;1;1
13546;Žibutė;PELĖDŽIUKAI;1826763192;Taip;0;1;5;6
13547;Žibutė;PELĖDŽIUKAI;3826875107;Ne;0;2;0;2
13548;Žibutė;PELĖDŽIUKAI;3186792146;Taip;0;0;2;2
13549;Žibutė;PELĖDŽIUKAI;7344095020;Taip;9;3;2;14
13550;Žibutė;PELĖDŽIUKAI;1078105287;Taip;0;10;0;10
13551;Žibutė;PELĖDŽIUKAI;2152452830;Taip;0;9;0;9
13552;Žibutė;PELĖDŽIUKAI;1394895695;Taip;0;2;1;3
13553;Žibutė;PELĖDŽIUKAI;2236930916;Taip;4;0;1;5
13554;Žibutė;PELĖDŽIUKAI;7095870173;Taip;0;1;0;1
13555;Žibutė;PELĖDŽIUKAI;2840754631;Taip;4;3;0;7
13556;Žibutė;PELĖDŽIUKAI;6089325755;Taip;0;0;4;4
13557;Žibutė;PELĖDŽIUKAI;1274409680;Taip;0;9;10;19
13558;Žibutė;KREGŽDUTĖS;7036454359;Taip;18;0;0;18
13559;Žibutė;KREGŽDUTĖS;5677389434;Taip;5;5;1;11
13560;Žibutė;KREGŽDUTĖS;5416015554;Taip;5;0;5;10
13561;Žibutė;KREGŽDUTĖS;3555071718;Taip;9;0;0;9
13562;Žibutė;KREGŽDUTĖS;7531027545;Taip;0;5;1;6
13563;Žibutė;KREGŽDUTĖS;3645481894;Taip;0;9;0;9
13564;Žibutė;KREGŽDUTĖS;8880329060;Taip;0;0;4;4
13565;Žibutė;KREGŽDUTĖS;2957525481;Taip;0;2;0;2
13566;Žibutė;KREGŽDUTĖS;5009495840;Taip;5;0;0;5
13567;Žibutė;KREGŽDUTĖS;7136145033;Taip;0;0;7;7
13568;Žibutė;KREGŽDUTĖS;5187777741;Taip;0;1;0;1
13569;Žibutė;KREGŽDUTĖS;5190377896;Taip;3;0;2;5
13570;Žibutė;KREGŽDUTĖS;3191351976;Taip;0;7;3;10
13571;Žibutė;KREGŽDUTĖS;6013340521;Taip;8;6;2;16
13572;Žibutė;KREGŽDUTĖS;1362419302;Taip;0;4;1;5
13573;Žibutė;KREGŽDUTĖS;3574946816;Taip;0;0;1;1
13574;Žibutė;KREGŽDUTĖS;6194464236;Taip;0;0;4;4
13575;Žibutė;BORUŽĖLĖS;4278832423;Taip;4;0;1;5
13576;Žibutė;BORUŽĖLĖS;3066580779;Taip;8;0;0;8
13577;Žibutė;BORUŽĖLĖS;1786332689;Taip;2;9;0;11
13578;Žibutė;BORUŽĖLĖS;8879347884;Taip;6;0;4;10
13579;Žibutė;BORUŽĖLĖS;7023683517;Taip;5;0;0;5
13580;Žibutė;BORUŽĖLĖS;7764376193;Taip;13;0;1;14
13581;Žibutė;BORUŽĖLĖS;3618347199;Taip;0;10;0;10
13582;Žibutė;BORUŽĖLĖS;5186839413;Taip;2;2;1;5
13583;Žibutė;BORUŽĖLĖS;2374119662;Taip;0;3;15;18
13584;Žibutė;BORUŽĖLĖS;2923650566;Taip;0;0;9;9
13585;Žibutė;BORUŽĖLĖS;1381488132;Taip;3;0;2;5
13586;Žibutė;BORUŽĖLĖS;5591970907;Taip;0;7;2;9
13587;Žibutė;BORUŽĖLĖS;6672033757;Taip;0;1;1;2
13588;Žibutė;BORUŽĖLĖS;7481695788;Taip;8;0;0;8
13589;Žibutė;BORUŽĖLĖS;1112295932;Taip;2;1;0;3
13590;Žibutė;BORUŽĖLĖS;8155327668;Taip;0;1;0;1
13591;Žibutė;BORUŽĖLĖS;5632520305;Taip;7;0;6;13
13592;Žibutė;BITUTĖS;14091973543;Taip;7;1;0;8
13593;Žibutė;BITUTĖS;27182644850;Taip;0;3;2;5
13594;Žibutė;BITUTĖS;9591439732;Taip;0;3;4;7
13595;Žibutė;BITUTĖS;39367516353;Taip;0;2;1;3
13596;Žibutė;BITUTĖS;1192143609;Taip;0;2;0;2
13597;Žibutė;BITUTĖS;72357016152;Taip;0;6;0;6
13598;Žibutė;BITUTĖS;1054908586;Taip;0;5;0;5
13599;Žibutė;BITUTĖS;1215072172;Taip;0;1;0;1
13600;Žibutė;BITUTĖS;1010766308;Taip;0;2;0;2
13601;Žibutė;BITUTĖS;1749323904;Taip;0;2;0;2
13602;Žibutė;BITUTĖS;9109825948;Taip;5;1;0;6
13603;Žibutė;BITUTĖS;62187632470;Taip;0;7;0;7
13604;Žibutė;BITUTĖS;90082848356;Taip;5;7;0;12
13605;Žibutė;BITUTĖS;4480906648;Taip;6;1;0;7
13606;Žibutė;BITUTĖS;8587562864;Taip;0;8;4;12
13607;Žibutė;BITUTĖS;87741312158;Taip;0;1;0;1
13608;Žibutė;KAČIUKAI;6978977383;Taip;0;6;0;6
13609;Žibutė;KAČIUKAI;9634311146;Taip;0;1;0;1
13610;Žibutė;KAČIUKAI;8944042589;Taip;0;11;0;11
13611;Žibutė;KAČIUKAI;9868621666;Taip;0;2;3;5
13612;Žibutė;KAČIUKAI;9700866512;Taip;0;2;0;2
13613;Žibutė;KAČIUKAI;7774532200;Taip;0;10;0;10
13614;Žibutė;KAČIUKAI;1366469428;Taip;5;6;0;11
13615;Žibutė;KAČIUKAI;2607509585;Taip;6;9;0;15
13616;Žibutė;KAČIUKAI;4825064521;Taip;0;10;22;32
13617;Žibutė;KAČIUKAI;5826523148;Taip;0;11;0;11
13618;Žibutė;KAČIUKAI;2438980348;Taip;7;6;0;13
13619;Žibutė;KAČIUKAI;3957898269;Taip;0;5;0;5
13620;Žibutė;KAČIUKAI;9918283923;Taip;16;1;0;17
13621;Žibutė;KAČIUKAI;4382812297;Taip;8;0;0;8
13622;Žibutė;KAČIUKAI;5126232169;Taip;0;9;1;10
13623;Žibutė;KAČIUKAI;8792292819;Taip;8;2;2;12
13624;Žibutė;KAČIUKAI;7668484415;Taip;3;8;0;11
13625;Žibutė;KAČIUKAI;1004098038;Taip;4;19;3;26
13626;Žibutė;KAČIUKAI;7479437931;Taip;0;8;0;8
13627;Žibutė;ZUIKIAI;2312717334;Taip;0;6;0;6
13628;Žibutė;ZUIKIAI;1515636796;Taip;2;6;0;8
13629;Žibutė;ZUIKIAI;7853531467;Taip;0;0;4;4
13630;Žibutė;ZUIKIAI;9168673977;Taip;0;1;0;1
13631;Žibutė;ZUIKIAI;7872636200;Taip;0;6;2;8
13632;Žibutė;ZUIKIAI;4455757640;Taip;3;0;9;12
13633;Žibutė;ZUIKIAI;6361543454;Taip;13;4;0;17
13634;Žibutė;ZUIKIAI;1297347740;Taip;2;0;1;3
13635;Žibutė;ZUIKIAI;7611641692;Taip;0;7;2;9
13636;Žibutė;ZUIKIAI;9221523836;Taip;0;7;8;15
13637;Žibutė;ZUIKIAI;6833179680;Taip;0;0;1;1
13638;Žibutė;ZUIKIAI;4685356158;Taip;0;0;1;1
13639;Žibutė;ZUIKIAI;7792267540;Taip;0;4;0;4
13640;Žibutė;ZUIKIAI;6934760468;Taip;6;1;0;7
13641;Žibutė;ZUIKIAI;1614551884;Taip;10;2;2;14
13642;Žibutė;ZUIKIAI;3632745935;Taip;0;1;0;1
13643;Žibutė;ZUIKIAI;3687123871;Taip;11;0;0;11
13644;Žibutė;ZUIKIAI;8797870379;Taip;4;0;2;6
13645;Žibutė;ZUIKIAI;8276724226;Taip;0;0;2;2
13646;Žibutė;ZUIKIAI;5112512917;Taip;11;3;0;14
13647;Žiedas;Bitutės;9573180529;Taip;22;0;0;22
13648;Žiedas;Bitutės;1219022794;Taip;0;13;0;13
13649;Žiedas;Bitutės;3930283171;Taip;14;1;0;15
13650;Žiedas;Bitutės;1600420971;Taip;4;7;0;11
13651;Žiedas;Bitutės;42049755986;Taip;0;5;0;5
13652;Žiedas;Bitutės;1785446716;Taip;0;10;0;10
13653;Žiedas;Bitutės;1835889494;Taip;0;2;0;2
13654;Žiedas;Bitutės;52721173922;Taip;0;3;0;3
13655;Žiedas;Bitutės;3346603228;Ne;0;6;0;6
13656;Žiedas;Bitutės;2094277643;Taip;0;1;0;1
13657;Žiedas;Bitutės;5812737969;Taip;0;3;0;3
13658;Žiedas;Bitutės;1063755068;Taip;0;2;0;2
13659;Žiedas;Bitutės;1127645903;Taip;0;5;0;5
13660;Žiedas;Bitutės;27339844730;Taip;0;12;0;12
13661;Žiedas;Bitutės;1779122644;Taip;2;1;0;3
13662;Žiedas;Bitutės;9940683245;Taip;0;1;0;1
13663;Žiedas;Bitutės;1013773415;Taip;1;0;0;1
13664;Žiedas;Bitutės;7647496475;Taip;0;5;0;5
13665;Žiedas;Bitutės;1458152054;Taip;0;3;0;3
13666;Žiedas;Bitutės;8359296058;Taip;0;2;7;9
13667;Žiedas;Varpeliai;7097790025;Taip;0;2;0;2
13668;Žiedas;Varpeliai;3230107921;Taip;5;1;0;6
13669;Žiedas;Varpeliai;3178778438;Taip;22;0;0;22
13670;Žiedas;Varpeliai;9602083568;Taip;7;1;0;8
13671;Žiedas;Varpeliai;5628720422;Taip;0;2;0;2
13672;Žiedas;Varpeliai;1582961378;Taip;0;2;0;2
13673;Žiedas;Varpeliai;9020540780;Taip;5;0;0;5
13674;Žiedas;Varpeliai;6444377924;Taip;0;2;0;2
13675;Žiedas;Varpeliai;1878050384;Ne;0;1;0;1
13676;Žiedas;Varpeliai;3704491209;Taip;20;0;0;20
13677;Žiedas;Varpeliai;6882614465;Taip;0;5;0;5
13678;Žiedas;Varpeliai;5578227349;Taip;0;4;0;4
13679;Žiedas;Varpeliai;6914059680;Taip;0;4;0;4
13680;Žiedas;Varpeliai;6515510381;Taip;10;1;0;11
13681;Žiedas;Varpeliai;3842589827;Taip;5;0;0;5
13682;Žiedas;Varpeliai;5835309107;Taip;0;1;2;3
13683;Žiedas;Varpeliai;3387263016;Taip;0;2;0;2
13684;Žiedas;Varpeliai;3178580610;Taip;0;12;0;12
13685;Žiedas;Varpeliai;1043230748;Taip;0;1;0;1
13686;Žiedas;Varpeliai;5061575884;Taip;13;0;0;13
13687;Žiedas;Varpeliai;1333233100;Taip;13;4;0;17
13688;Žiedas;Ramunėlės;1333555044;Taip;0;4;0;4
13689;Žiedas;Ramunėlės;2092319455;Ne;0;5;0;5
13690;Žiedas;Ramunėlės;5789261620;Taip;0;1;0;1
13691;Žiedas;Ramunėlės;8753972322;Taip;0;3;0;3
13692;Žiedas;Ramunėlės;3900091129;Ne;5;1;0;6
13693;Žiedas;Ramunėlės;3067962647;Taip;0;1;0;1
13694;Žiedas;Ramunėlės;2843328732;Taip;0;6;0;6
13695;Žiedas;Ramunėlės;2515028280;Taip;0;5;0;5
13696;Žiedas;Ramunėlės;1583038469;Taip;0;6;0;6
13697;Žiedas;Ramunėlės;8208331527;Taip;14;1;0;15
13698;Žiedas;Ramunėlės;6815408748;Taip;0;6;0;6
13699;Žiedas;Ramunėlės;5577339739;Taip;5;1;0;6
13700;Žiedas;Ramunėlės;6884933845;Taip;0;3;0;3
13701;Žiedas;Ramunėlės;7548653053;Taip;9;0;0;9
13702;Žiedas;Ramunėlės;1659873036;Taip;0;1;0;1
13703;Žiedas;Pakalnutės;7016509405;Taip;1;2;0;3
13704;Žiedas;Pakalnutės;4922560649;Taip;0;5;0;5
13705;Žiedas;Pakalnutės;6703889237;Taip;0;1;0;1
13706;Žiedas;Pakalnutės;2095655987;Taip;0;1;0;1
13707;Žiedas;Pakalnutės;9648580306;Taip;3;3;0;6
13708;Žiedas;Pakalnutės;9699668892;Taip;0;3;0;3
13709;Žiedas;Pakalnutės;5653785844;Taip;0;1;0;1
13710;Žiedas;Pakalnutės;9247088735;Taip;0;4;0;4
13711;Žiedas;Pakalnutės;5588136738;Taip;0;7;0;7
13712;Žiedas;Pakalnutės;6786526552;Taip;5;0;0;5
13713;Žiedas;Pakalnutės;2511423525;Taip;0;2;0;2
13714;Žiedas;Pakalnutės;6432090199;Taip;0;5;0;5
13715;Žiedas;Pakalnutės;5626494892;Taip;17;0;0;17
13716;Žiedas;Pakalnutės;7708360056;Taip;0;10;0;10
13717;Žiedas;Pakalnutės;7954517383;Taip;0;5;0;5
13718;Žiedas;Pakalnutės;1794393042;Taip;0;3;0;3
13719;Žiedas;Pakalnutės;2849254119;Taip;12;4;0;16
13720;Žiedas;Pakalnutės;9736967156;Taip;4;3;0;7
13721;Žiedas;Pakalnutės;3586376571;Taip;0;7;0;7
13722;Žiedas;Rožytės;9702211410;Taip;8;2;0;10
13723;Žiedas;Rožytės;2763996098;Taip;3;5;0;8
13724;Žiedas;Rožytės;9129315784;Taip;4;4;0;8
13725;Žiedas;Rožytės;3370495317;Taip;9;7;0;16
13726;Žiedas;Rožytės;7952899220;Taip;22;0;0;22
13727;Žiedas;Rožytės;7672879525;Taip;0;3;0;3
13728;Žiedas;Rožytės;4222689492;Taip;0;1;0;1
13729;Žiedas;Rožytės;4983852075;Taip;5;2;0;7
13730;Žiedas;Pumpurėliai;2320543511;Taip;5;2;0;7
13731;Žiedas;Pumpurėliai;1243169901;Taip;6;3;0;9
13732;Žiedas;Pumpurėliai;4044156905;Taip;0;4;0;4
13733;Žiedas;Pumpurėliai;8056265378;Taip;0;22;0;22
13734;Žiedas;Pumpurėliai;9337317396;Taip;0;1;0;1
13735;Žiedas;Pumpurėliai;4844442247;Taip;4;1;0;5
13736;Žiedas;Pumpurėliai;8088806507;Taip;10;3;0;13
13737;Žiedas;Pumpurėliai;4348246825;Taip;5;0;0;5
13738;Žiedas;Pumpurėliai;7294671324;Taip;0;5;0;5
13739;Žiedas;Pumpurėliai;3821849812;Taip;7;0;0;7
13740;Žiedas;Pumpurėliai;1580781723;Taip;0;3;0;3
13741;Žiedas;Pumpurėliai;4933650089;Taip;0;4;0;4
13742;Žiedas;Pumpurėliai;5635958124;Taip;0;1;0;1
13743;Žiedas;Pumpurėliai;2633676360;Taip;0;7;0;7
13744;Žiedas;"Dobiliukai ";2932857132;Taip;4;3;0;7
13745;Žiedas;"Dobiliukai ";7604200899;Taip;0;1;0;1
13746;Žiedas;"Dobiliukai ";3303581707;Taip;0;10;0;10
13747;Žiedas;"Dobiliukai ";8887021328;Taip;0;9;0;9
13748;Žiedas;"Dobiliukai ";5552786845;Taip;16;1;0;17
13749;Žiedas;"Dobiliukai ";8833895006;Taip;10;2;0;12
13750;Žiedas;"Dobiliukai ";5658235821;Taip;14;0;0;14
13751;Žiedas;"Dobiliukai ";1645402434;Taip;8;0;0;8
13752;Žiedas;"Dobiliukai ";4712780337;Taip;8;0;0;8
13753;Žiedas;"Dobiliukai ";4564268323;Taip;9;1;0;10
13754;Žiedas;"Dobiliukai ";1609487830;Taip;13;6;0;19
13755;Žiedas;"Dobiliukai ";3437651010;Taip;3;5;0;8
13756;Žiedas;"Dobiliukai ";5274845525;Taip;0;22;0;22
13757;Žiedas;"Dobiliukai ";7057747531;Taip;0;1;0;1
13758;Žiedas;"Dobiliukai ";3422053505;Taip;0;10;0;10
13759;Žiedas;"Dobiliukai ";9057761408;Taip;0;2;0;2
13760;Žiedas;"Dobiliukai ";1011602827;Taip;0;2;0;2
13761;Žiedas;RŪTELĖS;5885209631;Taip;0;2;2;4
13762;Žiedas;RŪTELĖS;2134466899;Taip;11;3;0;14
13763;Žiedas;RŪTELĖS;5108263139;Taip;21;0;0;21
13764;Žiedas;RŪTELĖS;6822887260;Taip;0;3;0;3
13765;Žiedas;RŪTELĖS;5914428064;Taip;4;1;0;5
13766;Žiedas;RŪTELĖS;3857121753;Taip;14;3;0;17
13767;Žiedas;RŪTELĖS;6443633568;Taip;18;0;1;19
13768;Žiedas;RŪTELĖS;5959899914;Taip;0;7;0;7
13769;Žiedas;RŪTELĖS;7333813704;Taip;0;3;0;3
13770;Žiedas;RŪTELĖS;6658762922;Taip;0;1;0;1
13771;Žiedas;RŪTELĖS;5703750436;Taip;0;10;0;10
13772;Žiedas;RŪTELĖS;7578964555;Taip;0;4;0;4
13773;Žiedas;RŪTELĖS;5126173608;Taip;0;2;0;2
13774;Žiedas;RŪTELĖS;5647232875;Taip;12;0;0;12
13775;Žiedas;RŪTELĖS;1738121071;Taip;0;1;0;1
13776;Žiedas;RŪTELĖS;5420327672;Taip;0;2;2;4
13777;Žiedas;RŪTELĖS;1737296046;Taip;2;0;0;2
13778;Žiedas;RŪTELĖS;1253833615;Taip;0;5;0;5
13779;Žiedas;RŪTELĖS;7172793351;Taip;0;13;0;13
13780;Žiedas;RŪTELĖS;9218388800;Taip;13;9;0;22
13781;Žiedas;RŪTELĖS;7072578987;Taip;0;18;0;18
13782;Žiedas;RŪTELĖS;3715928992;Taip;2;4;0;6
13783;Žiedas;SAULĖGRĄŽOS;1484464986;Taip;8;0;0;8
13784;Žiedas;SAULĖGRĄŽOS;4807479784;Taip;0;2;0;2
13785;Žiedas;SAULĖGRĄŽOS;1030089009;Taip;0;6;0;6
13786;Žiedas;SAULĖGRĄŽOS;1529988412;Taip;0;2;0;2
13787;Žiedas;SAULĖGRĄŽOS;1007894628;Taip;10;5;0;15
13788;Žiedas;SAULĖGRĄŽOS;1550350520;Taip;0;2;0;2
13789;Žiedas;SAULĖGRĄŽOS;9058688663;Taip;0;5;0;5
13790;Žiedas;SAULĖGRĄŽOS;7150433256;Taip;0;3;0;3
13791;Žiedas;SAULĖGRĄŽOS;3414702993;Taip;0;5;0;5
13792;Žiedas;SAULĖGRĄŽOS;1824692620;Taip;4;10;2;16
13793;Žiedas;SAULĖGRĄŽOS;6145720452;Taip;0;14;0;14
13794;Žiedas;SAULĖGRĄŽOS;2507543124;Taip;8;7;0;15
13795;Žiedas;SAULĖGRĄŽOS;34193530;Taip;0;7;0;7
13796;Žiedas;SAULĖGRĄŽOS;86877563124;Taip;5;4;0;9
13797;Žiedas;SAULĖGRĄŽOS;78720591915;Taip;0;1;0;1
13798;Žiedas;SAULĖGRĄŽOS;2026728639;Taip;0;1;0;1
13799;Žiedas;SAULĖGRĄŽOS;5513311280;Taip;0;0;7;7
13800;Žiedas;RUGIAGĖLĖS;8148831014;Taip;0;18;0;18
13801;Žiedas;RUGIAGĖLĖS;8645771800;Taip;3;7;0;10
13802;Žiedas;RUGIAGĖLĖS;8163645535;Taip;0;13;0;13
13803;Žiedas;RUGIAGĖLĖS;6261847845;Taip;0;3;0;3
13804;Žiedas;RUGIAGĖLĖS;6459679214;Taip;0;2;0;2
13805;Žiedas;RUGIAGĖLĖS;7584712202;Taip;6;0;0;6
13806;Žiedas;RUGIAGĖLĖS;3984607857;Taip;6;2;0;8
13807;Žiedas;RUGIAGĖLĖS;7942276632;Taip;0;3;0;3
13808;Žiedas;RUGIAGĖLĖS;6041919197;Taip;0;2;0;2
13809;Žiedas;RUGIAGĖLĖS;7799489700;Taip;18;0;0;18
13810;Žiedas;RUGIAGĖLĖS;8927034492;Taip;0;22;0;22
13811;Žiedas;RUGIAGĖLĖS;2182381160;Taip;3;1;0;4
13812;Žiedas;RUGIAGĖLĖS;8822472312;Taip;3;1;0;4
13813;Žiedas;RUGIAGĖLĖS;9021286246;Taip;0;6;0;6
13814;Žiedas;RUGIAGĖLĖS;1777501190;Taip;0;1;0;1
13815;Žiedas;RUGIAGĖLĖS;1844621525;Ne;0;4;0;4
13816;Žiedas;RUGIAGĖLĖS;1219634640;Taip;0;1;0;1
13817;Žiedas;RUGIAGĖLĖS;9750690920;Ne;15;2;0;17
13818;Žiedas;RUGIAGĖLĖS;1035854293;Taip;11;0;0;11
13819;Žiedas;RUGIAGĖLĖS;1917085385;Taip;0;5;0;5
13820;Žiedas;RUGIAGĖLĖS;5020148822;Taip;0;4;0;4
13821;Žiedas;RUGIAGĖLĖS;4284627073;Taip;0;4;3;7
13822;Žiedas;RUGIAGĖLĖS;5987689515;Taip;22;0;0;22
13823;Žiedas;RUGIAGĖLĖS;1826599535;Taip;7;1;0;8
13824;Žiedas;Boružėlės;85152640431;Taip;0;1;0;1
13825;Žiedas;Boružėlės;2075892389;Taip;0;0;1;1
13826;Žiedas;Boružėlės;1733596148;Taip;3;2;0;5
13827;Žiedas;Boružėlės;1748932818;Taip;0;1;0;1
13828;Žiedas;Boružėlės;39022317368;Taip;0;7;0;7
13829;Žiedas;Boružėlės;2081656643;Taip;0;1;3;4
13830;Žiedas;Boružėlės;1120478375;Taip;8;1;0;9
13831;Žiedas;Boružėlės;1366570116;Taip;0;7;0;7
13832;Žiedas;Boružėlės;12622490543;Ne;3;8;0;11
13833;Žiedas;Boružėlės;32671505578;Taip;0;2;0;2
13834;Žiedas;Boružėlės;1443451076;Taip;3;4;0;7
13835;Žiedas;Boružėlės;99985645406;Ne;6;1;0;7
13836;Žiedas;Boružėlės;1618815502;Taip;2;1;0;3
13837;Žiedas;Boružėlės;2147350804;Taip;2;1;0;3
13838;Žiedas;Boružėlės;17275054601;Taip;0;6;0;6
13839;Žiedas;Boružėlės;1897597456;Taip;0;1;0;1
13840;Žiedas;Boružėlės;55459877940;Taip;0;1;0;1
13841;Žiedas;Boružėlės;1708363648;Taip;0;4;0;4
13842;Žiedas;AGUONĖLĖS;4917324037;Taip;0;4;0;4
13843;Žiedas;AGUONĖLĖS;3742949697;Taip;13;0;0;13
13844;Žiedas;AGUONĖLĖS;8857150598;Taip;19;0;0;19
13845;Žiedas;AGUONĖLĖS;8436592169;Taip;0;2;0;2
13846;Žiedas;AGUONĖLĖS;9054709268;Taip;0;3;0;3
13847;Žiedas;AGUONĖLĖS;9964883646;Taip;0;5;0;5
13848;Žiedas;AGUONĖLĖS;4021189767;Taip;0;2;0;2
13849;Žiedas;AGUONĖLĖS;1346658299;Taip;5;3;0;8
13850;Žiedas;AGUONĖLĖS;4697477761;Taip;10;0;0;10
13851;Žiedas;AGUONĖLĖS;7678333395;Taip;0;0;3;3
13852;Žiedas;AGUONĖLĖS;9207945616;Taip;0;0;3;3
13853;Žiedas;AGUONĖLĖS;7221702677;Taip;0;2;0;2
13854;Žiedas;AGUONĖLĖS;2393112381;Taip;5;5;0;10
13855;Žiedas;AGUONĖLĖS;2416234016;Taip;5;0;0;5
13856;Žiedas;AGUONĖLĖS;5353507617;Taip;19;0;0;19
13857;Žiedas;ŽIBUTĖS;2642760082;Taip;0;1;0;1
13858;Žiedas;ŽIBUTĖS;1975718197;Taip;0;2;0;2
13859;Žiedas;ŽIBUTĖS;7381658912;Taip;0;2;2;4
13860;Žiedas;ŽIBUTĖS;8794003030;Taip;4;1;0;5
13861;Žiedas;ŽIBUTĖS;2312361963;Taip;4;2;3;9
13862;Žiedas;ŽIBUTĖS;9586578606;Taip;0;8;0;8
13863;Žiedas;ŽIBUTĖS;1758868055;Taip;0;0;2;2
13864;Žiedas;ŽIBUTĖS;2182340305;Taip;3;2;0;5
13865;Žiedas;ŽIBUTĖS;3940002957;Taip;0;1;0;1
13866;Žiedas;ŽIBUTĖS;2347857813;Taip;0;22;0;22
13867;Žiedas;ŽIBUTĖS;2148027253;Taip;18;0;0;18
13868;Žiedas;ŽIBUTĖS;1093479755;Taip;13;0;0;13
13869;Žiedas;ŽIBUTĖS;2964286644;Taip;8;0;0;8
13870;Žiedas;ŽIBUTĖS;6859410675;Taip;11;0;0;11
13871;Žiogelis;SKRUZDELYTĖS;5054228916;Taip;0;0;1;1
13872;Žiogelis;SKRUZDELYTĖS;8712788346;Taip;3;1;0;4
13873;Žiogelis;SKRUZDELYTĖS;7535167450;Taip;4;0;2;6
13874;Žiogelis;SKRUZDELYTĖS;3361421852;Taip;0;2;0;2
13875;Žiogelis;SKRUZDELYTĖS;1268908081;Taip;7;0;0;7
13876;Žiogelis;SKRUZDELYTĖS;3856321373;Taip;4;4;0;8
13877;Žiogelis;SKRUZDELYTĖS;6378295945;Taip;13;2;1;16
13878;Žiogelis;SKRUZDELYTĖS;7340918175;Taip;8;1;0;9
13879;Žiogelis;SKRUZDELYTĖS;4513613915;Taip;11;7;0;18
13880;Žiogelis;SKRUZDELYTĖS;6866685213;Taip;3;1;0;4
13881;Žiogelis;SKRUZDELYTĖS;7310459638;Taip;0;1;0;1
13882;Žiogelis;SKRUZDELYTĖS;9813150014;Taip;0;1;0;1
13883;Žiogelis;SKRUZDELYTĖS;8591680136;Taip;6;0;0;6
13884;Žiogelis;SKRUZDELYTĖS;6515890056;Taip;13;0;0;13
13885;Žiogelis;SKRUZDELYTĖS;8959934210;Taip;6;0;0;6
13886;Žiogelis;SKRUZDELYTĖS;6593794147;Taip;10;0;0;10
13887;Žiogelis;SKRUZDELYTĖS;8058231095;Taip;22;0;0;22
13888;Žiogelis;SKRUZDELYTĖS;1650284820;Taip;14;0;0;14
13889;Žiogelis;SKRUZDELYTĖS;5487213418;Taip;0;6;0;6
13890;Žiogelis;SKRUZDELYTĖS;6980853713;Taip;7;0;0;7
13891;Žiogelis;SKRUZDELYTĖS;1763603533;Taip;9;0;0;9
13892;Žiogelis;ŽIRNIUKAI;4080391074;Taip;7;2;0;9
13893;Žiogelis;ŽIRNIUKAI;2797078863;Taip;8;0;0;8
13894;Žiogelis;ŽIRNIUKAI;2348525913;Taip;1;0;3;4
13895;Žiogelis;ŽIRNIUKAI;3813592739;Taip;0;1;0;1
13896;Žiogelis;ŽIRNIUKAI;3820406417;Taip;0;2;5;7
13897;Žiogelis;ŽIRNIUKAI;9533670829;Taip;0;2;1;3
13898;Žiogelis;ŽIRNIUKAI;1673279182;Taip;0;12;0;12
13899;Žiogelis;ŽIRNIUKAI;1103056775;Taip;0;0;2;2
13900;Žiogelis;ŽIRNIUKAI;5104952346;Taip;5;1;0;6
13901;Žiogelis;ŽIRNIUKAI;3516143432;Taip;22;0;0;22
13902;Žiogelis;ŽIRNIUKAI;9918493914;Taip;6;0;16;22
13903;Žiogelis;ŽIRNIUKAI;9431525960;Taip;11;0;0;11
13904;Žiogelis;ŽIRNIUKAI;2622354022;Taip;0;6;0;6
13905;Žiogelis;ŽIRNIUKAI;7462316396;Taip;0;11;0;11
13906;Žiogelis;ŽIRNIUKAI;7395496310;Taip;3;0;1;4
13907;Žiogelis;ŽIRNIUKAI;9717527407;Taip;7;0;0;7
13908;Žiogelis;ŽIRNIUKAI;9330018409;Taip;0;8;0;8
13909;Žiogelis;ŽIRNIUKAI;9964121573;Taip;18;0;1;19
13910;Žiogelis;DOBILĖLIAI;8683148826;Taip;0;0;16;16
13911;Žiogelis;DOBILĖLIAI;3502278745;Taip;1;0;1;2
13912;Žiogelis;DOBILĖLIAI;3308563362;Taip;0;1;0;1
13913;Žiogelis;DOBILĖLIAI;2117192553;Taip;0;0;1;1
13914;Žiogelis;DOBILĖLIAI;1190395481;Taip;0;1;0;1
13915;Žiogelis;DOBILĖLIAI;1465027680;Taip;0;0;4;4
13916;Žiogelis;DOBILĖLIAI;6340620973;Ne;0;10;0;10
13917;Žiogelis;DOBILĖLIAI;5961630249;Taip;22;0;0;22
13918;Žiogelis;DOBILĖLIAI;6532218580;Taip;0;0;1;1
13919;Žiogelis;DOBILĖLIAI;1763070523;Taip;0;1;0;1
13920;Žiogelis;DOBILĖLIAI;5911231906;Taip;6;1;0;7
13921;Žiogelis;DOBILĖLIAI;1609336147;Taip;0;0;3;3
13922;Žiogelis;DOBILĖLIAI;9610249055;Taip;0;3;0;3
13923;Žiogelis;DOBILĖLIAI;6115834138;Taip;0;0;5;5
13924;Žiogelis;DOBILĖLIAI;3887222613;Taip;6;0;0;6
13925;Žiogelis;DOBILĖLIAI;7065052244;Taip;4;0;3;7
13926;Žiogelis;DOBILĖLIAI;4103035195;Taip;3;2;0;5
13927;Žiogelis;DOBILĖLIAI;4609621832;Taip;0;0;20;20
13928;Žiogelis;BORUŽĖLĖS;54446173105;Taip;0;4;0;4
13929;Žiogelis;BORUŽĖLĖS;4776403513;Taip;0;0;2;2
13930;Žiogelis;BORUŽĖLĖS;81608736626;Taip;0;1;0;1
13931;Žiogelis;BORUŽĖLĖS;4465151986;Taip;0;0;16;16
13932;Žiogelis;BORUŽĖLĖS;6963163354;Taip;0;6;0;6
13933;Žiogelis;BORUŽĖLĖS;98660118094;Taip;22;0;0;22
13934;Žiogelis;BORUŽĖLĖS;8169022043;Taip;11;1;0;12
13935;Žiogelis;BORUŽĖLĖS;65387706999;Taip;0;0;9;9
13936;Žiogelis;BORUŽĖLĖS;39293593638;Taip;1;0;3;4
13937;Žiogelis;BORUŽĖLĖS;49836275638;Taip;0;4;2;6
13938;Žiogelis;BORUŽĖLĖS;30488905109;Taip;0;1;0;1
13939;Žiogelis;BORUŽĖLĖS;84919810287;Taip;6;1;0;7
13940;Žiogelis;BORUŽĖLĖS;87755643169;Taip;0;0;1;1
13941;Žiogelis;BORUŽĖLĖS;89934673064;Taip;0;0;6;6
13942;Žiogelis;BORUŽĖLĖS;8315172690;Taip;1;0;0;1
13943;Žiogelis;BORUŽĖLĖS;1137529145;Taip;0;7;0;7
13944;Žiogelis;BORUŽĖLĖS;18957711548;Taip;0;4;0;4
13945;Žiogelis;DRUGELIAI;4156736676;Taip;0;2;0;2
13946;Žiogelis;DRUGELIAI;7128248940;Taip;0;6;0;6
13947;Žiogelis;DRUGELIAI;3963308094;Taip;0;7;0;7
13948;Žiogelis;DRUGELIAI;9250789113;Taip;0;8;0;8
13949;Žiogelis;DRUGELIAI;7502572217;Taip;0;0;2;2
13950;Žiogelis;DRUGELIAI;1134384178;Taip;0;0;1;1
13951;Žiogelis;DRUGELIAI;5876904663;Taip;4;0;0;4
13952;Žiogelis;DRUGELIAI;7120126547;Taip;0;2;4;6
13953;Žiogelis;DRUGELIAI;9387048672;Taip;0;5;0;5
13954;Žiogelis;DRUGELIAI;4378941619;Taip;0;2;1;3
13955;Žiogelis;DRUGELIAI;3937261260;Taip;0;11;1;12
13956;Žiogelis;DRUGELIAI;8894068297;Taip;3;0;0;3
13957;Žiogelis;DRUGELIAI;4609861306;Taip;0;0;1;1
13958;Žiogelis;DRUGELIAI;2759766559;Taip;0;15;0;15
13959;Žiogelis;DRUGELIAI;1939672072;Taip;3;5;1;9
13960;Žiogelis;DRUGELIAI;8689074067;Taip;0;2;0;2
13961;Žiogelis;DRUGELIAI;7702173581;Taip;0;5;0;5
13962;Žiogelis;DRUGELIAI;7725494899;Taip;0;4;0;4
13963;Žiogelis;DRUGELIAI;2160862681;Taip;4;0;0;4
13964;Žiogelis;DRUGELIAI;5139645108;Taip;0;9;0;9
13965;Žiogelis;DRUGELIAI;8873231715;Taip;0;0;4;4
13966;Žiogelis;DRUGELIAI;5223426277;Taip;0;2;1;3
13967;Žiogelis;PELĖDŽIUKAI;9295720241;Taip;0;3;0;3
13968;Žiogelis;PELĖDŽIUKAI;24941867247;Taip;0;2;0;2
13969;Žiogelis;PELĖDŽIUKAI;8819549855;Ne;0;3;0;3
13970;Žiogelis;PELĖDŽIUKAI;3189872952;Taip;4;3;0;7
13971;Žiogelis;PELĖDŽIUKAI;2883732914;Taip;4;3;0;7
13972;Žiogelis;PELĖDŽIUKAI;3503872654;Taip;0;1;0;1
13973;Žiogelis;PELĖDŽIUKAI;4445888917;Taip;0;2;0;2
13974;Žiogelis;PELĖDŽIUKAI;7881358741;Taip;0;3;0;3
13975;Žiogelis;PELĖDŽIUKAI;64865699245;Taip;0;1;0;1
13976;Žiogelis;PELĖDŽIUKAI;8702710674;Taip;0;2;0;2
13977;Žiogelis;PELĖDŽIUKAI;4671356872;Taip;5;3;0;8
13978;Žiogelis;PELĖDŽIUKAI;18018505301;Taip;0;5;0;5
13979;Žiogelis;PELĖDŽIUKAI;3750023611;Taip;8;0;0;8
13980;Žiogelis;PELĖDŽIUKAI;4343510173;Taip;0;5;0;5
13981;Žiogelis;PELĖDŽIUKAI;6659086172;Taip;0;12;0;12
13982;Žiogelis;PELĖDŽIUKAI;4508141956;Taip;0;20;0;20
13983;Žiogelis;PELĖDŽIUKAI;95713316600;Taip;0;3;0;3
13984;Žiogelis;PELĖDŽIUKAI;3203359908;Taip;0;5;0;5
13985;Žiogelis;PELĖDŽIUKAI;3320077143;Taip;0;1;0;1
13986;Žiogelis;PELĖDŽIUKAI;60959051938;Taip;0;6;0;6
13987;Žiogelis;PELĖDŽIUKAI;1160064257;Taip;0;2;0;2
13988;Žiogelis;VARPELIAI;1198917418;Taip;0;9;0;9
13989;Žiogelis;VARPELIAI;7708273984;Taip;8;3;0;11
13990;Žiogelis;VARPELIAI;1060830668;Taip;20;0;0;20
13991;Žiogelis;VARPELIAI;6225523016;Taip;4;5;0;9
13992;Žiogelis;VARPELIAI;2575280329;Taip;0;1;0;1
13993;Žiogelis;VARPELIAI;4402777236;Taip;6;4;0;10
13994;Žiogelis;VARPELIAI;1370071592;Taip;5;1;0;6
13995;Žiogelis;VARPELIAI;7888873296;Taip;13;2;0;15
13996;Žiogelis;VARPELIAI;1837140329;Ne;0;1;0;1
13997;Žiogelis;VARPELIAI;3520393042;Taip;11;0;0;11
13998;Žiogelis;VARPELIAI;8983731310;Taip;0;2;0;2
13999;Žiogelis;VARPELIAI;1954544417;Ne;0;2;0;2
14000;Žiogelis;VARPELIAI;9501262918;Taip;0;1;0;1
14001;Žiogelis;VARPELIAI;6716558946;Taip;0;1;0;1
14002;Žiogelis;VARPELIAI;1035890284;Ne;5;7;0;12
14003;Žiogelis;VARPELIAI;9874412804;Taip;0;5;0;5
14004;Žiogelis;VARPELIAI;8217782981;Taip;5;2;0;7
14005;Žiogelis;KREGŽDUTĖS;52932005977;Taip;0;7;0;7
14006;Žiogelis;KREGŽDUTĖS;28585504631;Taip;6;0;0;6
14007;Žiogelis;KREGŽDUTĖS;71387182665;Taip;0;2;0;2
14008;Žiogelis;KREGŽDUTĖS;88933947850;Taip;0;1;0;1
14009;Žiogelis;KREGŽDUTĖS;22969768169;Taip;0;5;0;5
14010;Žiogelis;KREGŽDUTĖS;18304908981;Taip;3;0;0;3
14011;Žiogelis;KREGŽDUTĖS;1042591705;Taip;0;2;0;2
14012;Žiogelis;KREGŽDUTĖS;1162630845;Ne;0;2;1;3
14013;Žiogelis;KREGŽDUTĖS;2072071751;Taip;0;2;1;3
14014;Žiogelis;KREGŽDUTĖS;1200247527;Taip;0;2;0;2
14015;Žiogelis;KREGŽDUTĖS;44023584723;Taip;0;2;0;2
14016;Žiogelis;KREGŽDUTĖS;24010106626;Taip;0;6;0;6
14017;Žiogelis;KREGŽDUTĖS;10001742134;Taip;0;2;0;2
14018;Žiogelis;KREGŽDUTĖS;4675275745;Taip;10;0;0;10
14019;Žiogelis;KREGŽDUTĖS;80050087040;Taip;11;6;0;17
14020;Žiogelis;KREGŽDUTĖS;3072299230;Taip;0;0;7;7
14021;Žiogelis;KREGŽDUTĖS;1309122110;Taip;0;8;0;8
14022;Žiogelis;KREGŽDUTĖS;6067622823;Taip;0;1;0;1
14023;Žiogelis;ŽVIRBLIUKAI;4450344120;Taip;0;0;7;7
14024;Žiogelis;ŽVIRBLIUKAI;7000401606;Taip;0;1;3;4
14025;Žiogelis;ŽVIRBLIUKAI;8998694866;Taip;0;2;0;2
14026;Žiogelis;ŽVIRBLIUKAI;8475539983;Taip;5;1;0;6
14027;Žiogelis;ŽVIRBLIUKAI;9672307977;Taip;0;0;2;2
14028;Žiogelis;ŽVIRBLIUKAI;1067136657;Taip;7;0;0;7
14029;Žiogelis;ŽVIRBLIUKAI;7936785905;Taip;0;1;0;1
14030;Žiogelis;ŽVIRBLIUKAI;9142952548;Taip;0;0;6;6
14031;Žiogelis;ŽVIRBLIUKAI;2463360858;Taip;0;2;0;2
14032;Žiogelis;ŽVIRBLIUKAI;6617995346;Taip;3;6;2;11
14033;Žiogelis;ŽVIRBLIUKAI;8018943297;Taip;3;1;0;4
14034;Žiogelis;ŽVIRBLIUKAI;8038242532;Taip;9;0;0;9
14035;Žiogelis;ŽVIRBLIUKAI;5454676924;Taip;10;0;0;10
14036;Žiogelis;ŽVIRBLIUKAI;2771911603;Taip;8;1;0;9
14037;Žiogelis;ŽVIRBLIUKAI;9421670525;Taip;0;0;2;2
14038;Žiogelis;BITUTĖS;3752355139;Taip;8;0;0;8
14039;Žiogelis;BITUTĖS;4605250897;Taip;8;0;0;8
14040;Žiogelis;BITUTĖS;2173494736;Taip;3;0;2;5
14041;Žiogelis;BITUTĖS;5042341085;Taip;5;0;0;5
14042;Žiogelis;BITUTĖS;6347738933;Taip;5;0;0;5
14043;Žiogelis;BITUTĖS;9627583831;Taip;0;4;0;4
14044;Žiogelis;BITUTĖS;3296450902;Taip;0;1;0;1
14045;Žiogelis;BITUTĖS;3792114246;Taip;7;0;0;7
14046;Žiogelis;BITUTĖS;9981130790;Taip;19;1;0;20
14047;Žiogelis;BITUTĖS;3820534331;Taip;0;0;1;1
14048;Žiogelis;BITUTĖS;1996517542;Taip;0;4;0;4
14049;Žiogelis;BITUTĖS;9790463889;Ne;4;12;0;16
14050;Žiogelis;BITUTĖS;6024752960;Taip;0;5;0;5
14051;Žiogelis;BITUTĖS;8853905367;Taip;0;5;0;5
14052;Žiogelis;BITUTĖS;1397686161;Taip;0;15;0;15
14053;Žiogelis;BITUTĖS;2171351454;Taip;0;0;3;3
14054;Žiogelis;BITUTĖS;6760074113;Taip;13;0;0;13
14055;Žiogelis;BITUTĖS;8835394030;Taip;0;3;0;3
14056;Žiogelis;BITUTĖS;4645245689;Taip;0;0;3;3
14057;Žiogelis;RIEŠUTĖLIAI;8303283893;Taip;22;0;0;22
14058;Žiogelis;RIEŠUTĖLIAI;1937740173;Taip;0;9;0;9
14059;Žiogelis;RIEŠUTĖLIAI;9243862028;Taip;0;1;0;1
14060;Žiogelis;RIEŠUTĖLIAI;9819352425;Taip;10;0;0;10
14061;Žiogelis;RIEŠUTĖLIAI;2701091043;Taip;13;0;1;14
14062;Žiogelis;RIEŠUTĖLIAI;5281321968;Taip;0;0;1;1
14063;Žiogelis;RIEŠUTĖLIAI;7395901559;Taip;3;0;0;3
14064;Žiogelis;RIEŠUTĖLIAI;7881734492;Taip;16;0;0;16
14065;Žiogelis;RIEŠUTĖLIAI;5737326104;Taip;5;7;0;12
14066;Žiogelis;RIEŠUTĖLIAI;2959983278;Taip;4;1;0;5
14067;Žiogelis;RIEŠUTĖLIAI;4677024422;Taip;0;7;0;7
14068;Žiogelis;RIEŠUTĖLIAI;8780773039;Taip;0;1;0;1
14069;Žiogelis;RIEŠUTĖLIAI;7107814348;Taip;0;5;0;5
14070;Žiogelis;PAKALNUTĖS;7704256764;Taip;0;1;0;1
14071;Žiogelis;PAKALNUTĖS;1235203700;Taip;0;0;2;2
14072;Žiogelis;PAKALNUTĖS;6697117406;Taip;0;4;0;4
14073;Žiogelis;PAKALNUTĖS;2028383677;Taip;0;2;0;2
14074;Žiogelis;PAKALNUTĖS;3910954904;Taip;1;0;0;1
14075;Žiogelis;PAKALNUTĖS;2233244282;Taip;9;0;0;9
14076;Žiogelis;PAKALNUTĖS;9862582346;Taip;3;2;2;7
14077;Žiogelis;PAKALNUTĖS;9406830518;Taip;12;3;0;15
14078;Žiogelis;PAKALNUTĖS;1320651707;Taip;0;6;0;6
14079;Žiogelis;PAKALNUTĖS;3392582853;Taip;0;2;1;3
14080;Žiogelis;PAKALNUTĖS;5557800297;Taip;0;2;1;3
14081;Žiogelis;PAKALNUTĖS;3310492752;Taip;2;4;0;6
14082;Žiogelis;PAKALNUTĖS;2366095661;Taip;2;0;1;3
14083;Žiogelis;PAKALNUTĖS;8675451323;Taip;0;1;0;1
14084;Žiogelis;PAKALNUTĖS;7087781379;Taip;0;4;1;5
14085;Žiogelis;PAKALNUTĖS;4015109974;Taip;0;4;1;5
14086;Žiogelis;PAKALNUTĖS;14932261911;Taip;3;2;3;8
14087;Žiogelis;PAKALNUTĖS;4713696984;Taip;4;5;0;9
14088;Žiogelis;PAKALNUTĖS;1442866468;Taip;3;0;1;4
14089;Žiogelis;PAKALNUTĖS;1660784232;Taip;5;0;3;8
14090;Žolynėlis;Spanguolėlė;8810441600;Taip;5;5;0;10
14091;Žolynėlis;Spanguolėlė;3261542931;Taip;7;12;0;19
14092;Žolynėlis;Spanguolėlė;6440991320;Taip;0;22;0;22
14093;Žolynėlis;Spanguolėlė;3631138915;Taip;3;0;0;3
14094;Žolynėlis;Spanguolėlė;5218448120;Taip;0;1;0;1
14095;Žolynėlis;Spanguolėlė;4076450179;Taip;5;3;0;8
14096;Žolynėlis;Spanguolėlė;4494255525;Taip;0;5;0;5
14097;Žolynėlis;Spanguolėlė;2493633505;Ne;0;0;5;5
14098;Žolynėlis;Spanguolėlė;6425445537;Taip;0;2;14;16
14099;Žolynėlis;Spanguolėlė;5438607463;Taip;14;1;0;15
14100;Žolynėlis;Spanguolėlė;5208585298;Taip;0;2;0;2
14101;Žolynėlis;Spanguolėlė;7451189254;Taip;3;5;0;8
14102;Žolynėlis;Spanguolėlė;3498596516;Taip;0;3;0;3
14103;Žolynėlis;Spanguolėlė;7485033527;Taip;9;5;0;14
14104;Žolynėlis;"RŪTELĖ (spec)";48837362422;Ne;14;4;0;18
14105;Žolynėlis;"RŪTELĖ (spec)";1540454207;Taip;3;1;0;4
14106;Žolynėlis;"RŪTELĖ (spec)";4000928238;Taip;7;3;0;10
14107;Žolynėlis;"RŪTELĖ (spec)";5610113641;Taip;0;4;0;4
14108;Žolynėlis;"SAULUTĖ (spec)";9675783636;Taip;0;4;1;5
14109;Žolynėlis;"SAULUTĖ (spec)";7962304738;Taip;3;1;0;4
14110;Žolynėlis;"SAULUTĖ (spec)";6678697536;Taip;11;0;0;11
14111;Žolynėlis;"SAULUTĖ (spec)";3337602618;Ne;13;2;2;17
14112;Žolynėlis;"SAULUTĖ (spec)";3043560150;Taip;0;1;0;1
14113;Žolynėlis;"LINELIS (spec)";93519259505;Taip;0;1;0;1
14114;Žolynėlis;"LINELIS (spec)";4438939800;Taip;3;2;0;5
14115;Žolynėlis;"LINELIS (spec)";5346078886;Taip;4;0;0;4
14116;Žolynėlis;"RASAKILA (spec)";4971887781;Taip;2;0;0;2
14117;Žolynėlis;"RASAKILA (spec)";6510930436;Taip;22;0;0;22
14118;Žolynėlis;"RASAKILA (spec)";6619551947;Taip;16;0;0;16
14119;Žolynėlis;"RAMUNĖLĖS (spec)";8552635547;Taip;0;4;1;5
14120;Žolynėlis;"RAMUNĖLĖS (spec)";2078549599;Taip;9;2;11;22
14121;Žolynėlis;"RAMUNĖLĖS (spec)";4559404699;Taip;1;0;1;2
14122;Žolynėlis;"RAMUNĖLĖS (spec)";1703785525;Taip;6;0;0;6
14123;Žolynėlis;Dobiliukai;5787331165;Taip;4;0;0;4
14124;Žolynėlis;Dobiliukai;3091749692;Taip;0;9;0;9
14125;Žolynėlis;Dobiliukai;5332349177;Taip;0;6;0;6
14126;Žolynėlis;Dobiliukai;2263679711;Taip;10;0;1;11
14127;Žolynėlis;Dobiliukai;5149512625;Taip;6;2;0;8
14128;Žolynėlis;Dobiliukai;7234022613;Ne;3;2;1;6
14129;Žolynėlis;Dobiliukai;8713225753;Taip;9;0;0;9
14130;Žolynėlis;Dobiliukai;5973298389;Taip;7;1;0;8
14131;Žolynėlis;Dobiliukai;5474876914;Ne;11;1;0;12
14132;Žolynėlis;Dobiliukai;8403268732;Taip;15;3;0;18
14133;Žolynėlis;Dobiliukai;2005661306;Taip;0;5;0;5
14134;Žolynėlis;Aguonėlė;8027151284;Taip;0;2;0;2
14135;Žolynėlis;Aguonėlė;7256502393;Taip;0;5;0;5
14136;Žolynėlis;Aguonėlė;2881461471;Taip;0;7;0;7
14137;Žolynėlis;Aguonėlė;2565770471;Taip;8;8;0;16
14138;Žolynėlis;Aguonėlė;8700231970;Taip;5;5;0;10
14139;Žolynėlis;Aguonėlė;7339496409;Taip;0;2;0;2
14140;Žolynėlis;Aguonėlė;1901979061;Taip;0;1;0;1
14141;Žolynėlis;Aguonėlė;5717038791;Taip;0;1;0;1
14142;Žolynėlis;Aguonėlė;1933377698;Taip;0;9;0;9
14143;Žolynėlis;Aguonėlė;8215427354;Taip;14;0;0;14
14144;Žolynėlis;Aguonėlė;2108221942;Taip;0;10;0;10
14145;Žolynėlis;Pienė;3520272555;Taip;0;11;0;11
14146;Žolynėlis;Pienė;3088932720;Taip;0;4;2;6
14147;Žolynėlis;Pienė;2934361190;Taip;0;17;0;17
14148;Žolynėlis;Pienė;7980206574;Taip;4;0;0;4
14149;Žolynėlis;Pienė;2460982987;Taip;0;7;0;7
14150;Žolynėlis;Pienė;7339110559;Taip;0;7;0;7
14151;Žolynėlis;Pienė;6763515483;Taip;0;1;0;1
14152;Žolynėlis;Pienė;1485195267;Taip;0;2;1;3
14153;Žolynėlis;Pienė;1163753820;Taip;5;1;0;6
14154;Žolynėlis;Pienė;9106152447;Taip;0;4;0;4
14155;Žolynėlis;Pienė;1879046798;Taip;0;4;0;4
14156;Žolynėlis;Pienė;4758738231;Taip;0;22;0;22
14157;Žolynėlis;Pienė;9238832484;Taip;4;2;2;8
14158;Žolynėlis;Pienė;3877168024;Taip;7;4;0;11
14159;Žolynėlis;Pienė;6416217971;Taip;5;7;0;12
14160;Žolynėlis;Pienė;4618251201;Taip;0;1;0;1
14161;Žolynėlis;Pienė;5432464074;Taip;0;5;0;5
14162;Žolynėlis;Pienė;8510764089;Ne;0;2;4;6
14163;Žolynėlis;Pienė;6024288147;Taip;3;3;0;6
14164;Žolynėlis;Pienė;1264022895;Ne;3;2;2;7
14165;Žolynėlis;Pienė;8697184617;Taip;0;6;2;8
14166;Žolynėlis;Čiobreliai;3263848791;Taip;4;3;0;7
14167;Žolynėlis;Čiobreliai;8547773739;Taip;0;1;0;1
14168;Žolynėlis;Čiobreliai;1620578562;Taip;0;12;0;12
14169;Žolynėlis;Čiobreliai;1473516753;Taip;5;9;0;14
14170;Žolynėlis;Čiobreliai;79704789499;Taip;0;5;0;5
14171;Žolynėlis;Čiobreliai;84849092452;Taip;5;5;0;10
14172;Žolynėlis;Čiobreliai;95007685205;Taip;0;4;0;4
14173;Žolynėlis;Čiobreliai;77707724932;Taip;0;14;0;14
14174;Žolynėlis;Čiobreliai;28730145668;Taip;0;8;0;8
14175;Žolynėlis;Čiobreliai;71887799705;Taip;4;0;0;4
14176;Žolynėlis;Čiobreliai;1655571687;Taip;8;5;0;13
14177;Žolynėlis;Čiobreliai;76688557717;Taip;3;5;0;8
14178;Žolynėlis;Čiobreliai;15306882704;Taip;6;1;0;7
14179;Žolynėlis;Čiobreliai;47442048515;Taip;4;5;0;9
14180;Žolynėlis;Čiobreliai;75335374706;Taip;0;2;0;2
14181;Žolynėlis;Čiobreliai;92615552899;Taip;3;1;0;4
14182;Žolynėlis;Čiobreliai;1873372016;Taip;0;5;0;5
14183;Žolynėlis;Čiobreliai;1931800904;Taip;4;7;0;11
14184;Žolynėlis;Avietėlė;9904373687;Taip;0;3;0;3
14185;Žolynėlis;Avietėlė;3071570864;Taip;14;0;0;14
14186;Žolynėlis;Avietėlė;2628636018;Taip;9;0;0;9
14187;Žolynėlis;Avietėlė;6740105842;Taip;10;5;0;15
14188;Žolynėlis;Avietėlė;1365534272;Taip;5;0;0;5
14189;Žolynėlis;Avietėlė;1440666914;Taip;0;12;0;12
14190;Žolynėlis;Avietėlė;6554864184;Taip;0;11;0;11
14191;Žolynėlis;Avietėlė;2652417191;Taip;3;0;0;3
14192;Žolynėlis;Avietėlė;9285539649;Taip;4;4;0;8
14193;Žolynėlis;Avietėlė;5243624422;Taip;19;0;0;19
14194;Žolynėlis;Avietėlė;6385491699;Ne;0;18;0;18
14195;Žolynėlis;Avietėlė;3952731134;Taip;5;1;0;6
14196;Žuvėdra;"JŪROS ŽVAIGŽDUTĖS";3148638780;Taip;0;13;0;13
14197;Žuvėdra;"JŪROS ŽVAIGŽDUTĖS";7673681906;Taip;0;9;0;9
14198;Žuvėdra;"JŪROS ŽVAIGŽDUTĖS";6148764075;Taip;0;0;4;4
14199;Žuvėdra;"JŪROS ŽVAIGŽDUTĖS";8104921853;Taip;0;0;1;1
14200;Žuvėdra;"JŪROS ŽVAIGŽDUTĖS";8843700949;Ne;0;6;0;6
14201;Žuvėdra;"JŪROS ŽVAIGŽDUTĖS";8589283055;Taip;6;4;4;14
14202;Žuvėdra;"JŪROS ŽVAIGŽDUTĖS";1030020199;Taip;0;12;0;12
14203;Žuvėdra;"JŪROS ŽVAIGŽDUTĖS";8008000299;Taip;0;0;7;7
14204;Žuvėdra;"JŪROS ŽVAIGŽDUTĖS";9230342970;Taip;9;0;1;10
14205;Žuvėdra;"JŪROS ŽVAIGŽDUTĖS";1938808693;Taip;7;0;1;8
14206;Žuvėdra;"JŪROS ŽVAIGŽDUTĖS";2092890028;Taip;0;7;0;7
14207;Žuvėdra;"JŪROS ŽVAIGŽDUTĖS";2334342995;Taip;10;0;0;10
14208;Žuvėdra;"JŪROS ŽVAIGŽDUTĖS";5049101816;Taip;10;3;0;13
14209;Žuvėdra;"JŪROS ŽVAIGŽDUTĖS";1164464390;Taip;0;3;0;3
14210;Žuvėdra;"JŪROS ŽVAIGŽDUTĖS";1223362311;Taip;1;0;6;7
14211;Žuvėdra;"JŪROS ŽVAIGŽDUTĖS";4864834075;Taip;7;0;4;11
14212;Žuvėdra;"JŪROS ŽVAIGŽDUTĖS";1200084485;Taip;0;6;0;6
14213;Žuvėdra;"JŪROS ŽVAIGŽDUTĖS";4177319374;Taip;0;10;0;10
14214;Žuvėdra;DELFINUKAI;3620753237;Taip;2;2;0;4
14215;Žuvėdra;DELFINUKAI;2694424532;Taip;0;8;0;8
14216;Žuvėdra;DELFINUKAI;9733979816;Ne;16;0;2;18
14217;Žuvėdra;DELFINUKAI;2858729034;Taip;0;7;0;7
14218;Žuvėdra;DELFINUKAI;7121154799;Taip;8;6;0;14
14219;Žuvėdra;DELFINUKAI;5436158437;Taip;7;0;0;7
14220;Žuvėdra;DELFINUKAI;7958768355;Ne;4;0;0;4
14221;Žuvėdra;DELFINUKAI;6952843736;Taip;9;3;0;12
14222;Žuvėdra;DELFINUKAI;5571732399;Taip;15;0;0;15
14223;Žuvėdra;DELFINUKAI;7710853637;Taip;0;8;0;8
14224;Žuvėdra;DELFINUKAI;2582404760;Taip;4;6;0;10
14225;Žuvėdra;DELFINUKAI;6672289932;Taip;14;0;0;14
14226;Žuvėdra;DELFINUKAI;5273726957;Taip;13;0;2;15
14227;Žuvėdra;DELFINUKAI;5818639448;Taip;0;0;1;1
14228;Žuvėdra;DELFINUKAI;1171751803;Taip;0;0;2;2
14229;Žuvėdra;OSMINOŽKI;24915726868;Taip;0;2;0;2
14230;Žuvėdra;OSMINOŽKI;1116645502;Taip;0;10;0;10
14231;Žuvėdra;OSMINOŽKI;1195732987;Taip;0;9;0;9
14232;Žuvėdra;OSMINOŽKI;1312918359;Taip;0;1;0;1
14233;Žuvėdra;OSMINOŽKI;6468506668;Ne;5;1;0;6
14234;Žuvėdra;OSMINOŽKI;1127602652;Taip;0;2;0;2
14235;Žuvėdra;OSMINOŽKI;5021263583;Taip;0;1;0;1
14236;Žuvėdra;OSMINOŽKI;63053155507;Taip;8;1;0;9
14237;Žuvėdra;OSMINOŽKI;2731016281;Taip;0;12;0;12
14238;Žuvėdra;OSMINOŽKI;6612880861;Taip;0;1;0;1
14239;Žuvėdra;OSMINOŽKI;14760907606;Taip;3;0;0;3
14240;Žuvėdra;OSMINOŽKI;5684848140;Taip;4;9;0;13
14241;Žuvėdra;OSMINOŽKI;5489757084;Taip;0;3;0;3
14242;Žuvėdra;OSMINOŽKI;8408371550;Taip;1;0;0;1
14243;Žuvėdra;OSMINOŽKI;5496071972;Taip;3;5;0;8
14244;Žuvėdra;OSMINOŽKI;4828788876;Taip;0;3;0;3
14245;Žuvėdra;OSMINOŽKI;6068515077;Taip;0;14;0;14
14246;Žuvėdra;RUSALAČKA;3853045274;Taip;2;7;0;9
14247;Žuvėdra;RUSALAČKA;6537464526;Taip;0;5;0;5
14248;Žuvėdra;RUSALAČKA;5674529681;Taip;0;15;1;16
14249;Žuvėdra;RUSALAČKA;7368183516;Taip;0;4;0;4
14250;Žuvėdra;RUSALAČKA;5198825127;Taip;18;0;0;18
14251;Žuvėdra;RUSALAČKA;8700802853;Taip;0;5;0;5
14252;Žuvėdra;RUSALAČKA;1509519996;Taip;0;7;0;7
14253;Žuvėdra;RUSALAČKA;3613045982;Taip;3;13;0;16
14254;Žuvėdra;RUSALAČKA;7467154866;Ne;3;0;0;3
14255;Žuvėdra;RUSALAČKA;5151984122;Taip;0;1;0;1
14256;Žuvėdra;RUSALAČKA;2987217910;Taip;0;22;0;22
14257;Žuvėdra;RUSALAČKA;4715123063;Taip;4;2;0;6
14258;Žuvėdra;RUSALAČKA;6715416675;Taip;0;0;4;4
14259;Žuvėdra;RUSALAČKA;8308610070;Taip;0;2;0;2
14260;Žuvėdra;RUSALAČKA;3349158713;Taip;0;6;0;6
14261;Žuvėdra;RUSALAČKA;8942228415;Taip;0;13;0;13
14262;Žuvėdra;RUSALAČKA;8822952385;Ne;5;1;0;6
14263;Žuvėdra;JANTARIKI;1960306957;Ne;11;0;5;16
14264;Žuvėdra;JANTARIKI;4702627979;Taip;0;9;0;9
14265;Žuvėdra;JANTARIKI;2577280901;Taip;3;1;0;4
14266;Žuvėdra;JANTARIKI;9011276878;Taip;5;0;0;5
14267;Žuvėdra;JANTARIKI;7387863175;Taip;0;1;1;2
14268;Žuvėdra;JANTARIKI;2640238143;Taip;8;5;0;13
14269;Žuvėdra;JANTARIKI;1810114962;Taip;3;0;0;3
14270;Žuvėdra;JANTARIKI;6862766787;Taip;0;1;0;1
14271;Žuvėdra;JANTARIKI;8111760611;Taip;0;0;2;2
14272;Žuvėdra;JANTARIKI;4893062971;Taip;4;0;0;4
14273;Žuvėdra;JANTARIKI;5876618912;Taip;19;0;0;19
14274;Žuvėdra;JANTARIKI;1219808187;Taip;3;5;0;8
14275;Žuvėdra;JANTARIKI;9200342856;Taip;0;5;0;5
14276;Žuvėdra;JANTARIKI;2197976174;Taip;10;0;1;11
14277;Žuvėdra;JANTARIKI;4881712317;Taip;22;0;0;22
14278;Žuvėdra;"AUKSINĖ ŽUVELĖ";1715385224;Taip;0;16;0;16
14279;Žuvėdra;"AUKSINĖ ŽUVELĖ";7705946236;Taip;11;2;0;13
14280;Žuvėdra;"AUKSINĖ ŽUVELĖ";6327915228;Taip;14;0;0;14
14281;Žuvėdra;"AUKSINĖ ŽUVELĖ";5002760763;Taip;4;5;0;9
14282;Žuvėdra;"AUKSINĖ ŽUVELĖ";3041002600;Taip;0;5;0;5
14283;Žuvėdra;"AUKSINĖ ŽUVELĖ";7543073516;Taip;0;6;0;6
14284;Žvangutis;PELIUKŲ;50889154641;Taip;0;0;2;2
14285;Žvangutis;PELIUKŲ;1339151674;Taip;4;0;0;4
14286;Žvangutis;PELIUKŲ;1310113034;Taip;2;1;0;3
14287;Žvangutis;PELIUKŲ;7202747419;Taip;3;1;2;6
14288;Žvangutis;PELIUKŲ;7320625500;Taip;0;7;0;7
14289;Žvangutis;PELIUKŲ;3513746926;Taip;0;3;0;3
14290;Žvangutis;PELIUKŲ;4053450010;Taip;10;0;0;10
14291;Žvangutis;PELIUKŲ;6110958520;Ne;0;1;4;5
14292;Žvangutis;PELIUKŲ;3817258555;Taip;0;5;0;5
14293;Žvangutis;PELIUKŲ;6844824726;Taip;5;1;0;6
14294;Žvangutis;PELIUKŲ;3315858185;Taip;8;14;0;22
14295;Žvangutis;PELIUKŲ;6815104137;Taip;4;0;0;4
14296;Žvangutis;PELIUKŲ;5683601025;Taip;0;17;0;17
14297;Žvangutis;PELIUKŲ;8617941954;Taip;0;16;0;16
14298;Žvangutis;PELIUKŲ;3775960571;Taip;4;12;0;16
14299;Žvangutis;PELIUKŲ;8511103595;Taip;6;1;2;9
14300;Žvangutis;PELIUKŲ;6989839997;Taip;0;1;2;3
14301;Žvangutis;PELIUKŲ;1224292338;Taip;6;0;1;7
14302;Žvangutis;PELIUKŲ;2740875969;Taip;7;0;2;9
14303;Žvangutis;ANČIUKŲ;2705396929;Taip;0;1;0;1
14304;Žvangutis;ANČIUKŲ;1420510354;Taip;0;1;0;1
14305;Žvangutis;ANČIUKŲ;23369081648;Taip;0;1;1;2
14306;Žvangutis;ANČIUKŲ;1541156624;Taip;0;3;0;3
14307;Žvangutis;ANČIUKŲ;2145325174;Taip;0;2;0;2
14308;Žvangutis;ANČIUKŲ;1847928083;Taip;0;8;0;8
14309;Žvangutis;ANČIUKŲ;4699447138;Taip;1;6;0;7
14310;Žvangutis;ANČIUKŲ;619059820;Taip;7;1;0;8
14311;Žvangutis;ANČIUKŲ;1251015310;Taip;0;3;0;3
14312;Žvangutis;ANČIUKŲ;1096499939;Taip;0;1;0;1
14313;Žvangutis;ANČIUKŲ;1369424754;Taip;0;12;0;12
14314;Žvangutis;ANČIUKŲ;65598561926;Taip;0;15;0;15
14315;Žvangutis;ANČIUKŲ;9134683276;Taip;10;0;0;10
14316;Žvangutis;ANČIUKŲ;9145365865;Taip;5;9;0;14
14317;Žvangutis;ANČIUKŲ;5539992579;Taip;0;1;0;1
14318;Žvangutis;ANČIUKŲ;8269992031;Ne;0;0;3;3
14319;Žvangutis;PELĖDŽIUKŲ;1322688456;Taip;0;9;0;9
14320;Žvangutis;PELĖDŽIUKŲ;9036869235;Taip;0;3;0;3
14321;Žvangutis;PELĖDŽIUKŲ;2570379643;Taip;0;2;0;2
14322;Žvangutis;PELĖDŽIUKŲ;2600596320;Ne;3;0;0;3
14323;Žvangutis;PELĖDŽIUKŲ;2623107843;Taip;0;6;0;6
14324;Žvangutis;PELĖDŽIUKŲ;1185135525;Taip;0;4;0;4
14325;Žvangutis;PELĖDŽIUKŲ;2411307963;Taip;1;2;0;3
14326;Žvangutis;PELĖDŽIUKŲ;9468660351;Taip;0;2;0;2
14327;Žvangutis;PELĖDŽIUKŲ;1324948757;Taip;0;4;0;4
14328;Žvangutis;PELĖDŽIUKŲ;2922083476;Taip;0;10;0;10
14329;Žvangutis;PELĖDŽIUKŲ;1282567366;Taip;0;1;0;1
14330;Žvangutis;PELĖDŽIUKŲ;6068428687;Taip;2;1;0;3
14331;Žvangutis;PELĖDŽIUKŲ;9149037184;Taip;13;2;0;15
14332;Žvangutis;PELĖDŽIUKŲ;3665275100;Taip;0;1;0;1
14333;Žvangutis;PELĖDŽIUKŲ;5012996199;Taip;0;5;0;5
14334;Žvangutis;PELĖDŽIUKŲ;3276065009;Taip;9;8;0;17
14335;Žvangutis;PELĖDŽIUKŲ;6040986672;Taip;0;14;0;14
14336;Žvangutis;PELĖDŽIUKŲ;2716216474;Taip;0;3;0;3
14337;Žvangutis;PELĖDŽIUKŲ;5723728310;Taip;7;0;0;7
14338;Žvangutis;PELĖDŽIUKŲ;1404378308;Taip;0;5;0;5
14339;Žvangutis;PELĖDŽIUKŲ;6207989105;Taip;0;2;0;2
14340;Žvangutis;KAČIUKŲ;7213349517;Taip;2;1;0;3
14341;Žvangutis;KAČIUKŲ;7581320158;Ne;0;2;1;3
14342;Žvangutis;KAČIUKŲ;2296360416;Taip;0;3;0;3
14343;Žvangutis;KAČIUKŲ;7721746116;Taip;10;4;0;14
14344;Žvangutis;KAČIUKŲ;2598842770;Taip;11;0;0;11
14345;Žvangutis;KAČIUKŲ;1142315595;Taip;0;3;0;3
14346;Žvangutis;KAČIUKŲ;9239279639;Taip;8;0;0;8
14347;Žvangutis;KAČIUKŲ;4696437804;Taip;10;1;0;11
14348;Žvangutis;KAČIUKŲ;8492637734;Taip;8;3;0;11
14349;Žvangutis;KAČIUKŲ;2503355659;Taip;8;0;0;8
14350;Žvangutis;KAČIUKŲ;9235884407;Taip;0;6;0;6
14351;Žvangutis;KAČIUKŲ;1761596625;Taip;0;14;0;14
14352;Žvangutis;KAČIUKŲ;8360356476;Taip;0;0;1;1
14353;Žvangutis;KAČIUKŲ;8863909185;Taip;8;3;0;11
14354;Žvangutis;KAČIUKŲ;3498584864;Taip;0;3;0;3
14355;Žvangutis;KAČIUKŲ;4408086513;Taip;8;7;0;15
14356;Žvangutis;KAČIUKŲ;5180240547;Ne;0;2;0;2
14357;Žvangutis;KAČIUKŲ;1256264382;Taip;0;18;0;18
14358;Žvangutis;KAČIUKŲ;8030520477;Taip;0;10;4;14
14359;Žvangutis;KAČIUKŲ;5166614226;Taip;0;0;1;1
14360;Žvangutis;MEŠKUČIŲ;3957064486;Taip;0;5;0;5
14361;Žvangutis;MEŠKUČIŲ;9958554027;Taip;0;7;0;7
14362;Žvangutis;MEŠKUČIŲ;1328464199;Taip;0;12;0;12
14363;Žvangutis;MEŠKUČIŲ;8062689240;Taip;0;2;0;2
14364;Žvangutis;MEŠKUČIŲ;3875906173;Taip;0;2;0;2
14365;Žvangutis;MEŠKUČIŲ;7722153982;Taip;0;3;0;3
14366;Žvangutis;MEŠKUČIŲ;4295016449;Taip;8;14;0;22
14367;Žvangutis;MEŠKUČIŲ;8592522675;Taip;4;0;0;4
14368;Žvangutis;MEŠKUČIŲ;4337928288;Taip;5;1;0;6
14369;Žvangutis;MEŠKUČIŲ;3546672690;Taip;0;4;0;4
14370;Žvangutis;MEŠKUČIŲ;5112520119;Taip;10;2;0;12
14371;Žvangutis;MEŠKUČIŲ;5638068914;Taip;10;5;0;15
14372;Žvangutis;MEŠKUČIŲ;6788355315;Taip;2;0;0;2
14373;Žvangutis;MEŠKUČIŲ;4992231141;Taip;5;1;0;6
14374;Žvangutis;MEŠKUČIŲ;4407484687;Taip;0;11;0;11
14375;Žvangutis;MEŠKUČIŲ;5817402847;Taip;0;22;0;22
14376;Žvangutis;MEŠKUČIŲ;3906808900;Taip;0;0;2;2
14377;Žvangutis;KIŠKUČIŲ;8906823569;Taip;8;1;0;9
14378;Žvangutis;KIŠKUČIŲ;8481666202;Taip;0;0;1;1
14379;Žvangutis;KIŠKUČIŲ;6094686500;Taip;0;0;2;2
14380;Žvangutis;KIŠKUČIŲ;7844987649;Taip;11;0;0;11
14381;Žvangutis;KIŠKUČIŲ;2049990751;Taip;6;0;1;7
14382;Žvangutis;KIŠKUČIŲ;3408933802;Taip;4;0;0;4
14383;Žvangutis;KIŠKUČIŲ;9711017196;Taip;0;1;0;1
14384;Žvangutis;KIŠKUČIŲ;1845924089;Taip;0;9;0;9
14385;Žvangutis;KIŠKUČIŲ;4705131089;Taip;4;0;2;6
14386;Žvangutis;KIŠKUČIŲ;7843280418;Taip;0;6;0;6
14387;Žirniukas;Boružiukų;5311746004;Taip;0;0;8;8
14388;Žirniukas;Boružiukų;6466220057;Taip;0;2;0;2
14389;Žirniukas;Boružiukų;2476906136;Taip;0;11;0;11
14390;Žirniukas;Boružiukų;6624263476;Taip;0;1;0;1
14391;Žirniukas;Boružiukų;8213507698;Taip;0;2;2;4
14392;Žirniukas;Boružiukų;2528905738;Taip;6;2;4;12
14393;Žirniukas;Boružiukų;6268788036;Taip;0;4;0;4
14394;Žirniukas;Boružiukų;2636634198;Taip;1;5;0;6
14395;Žirniukas;Boružiukų;8148254025;Taip;0;2;0;2
14396;Žirniukas;Boružiukų;1867254291;Taip;2;7;1;10
14397;Žirniukas;Boružiukų;5058103759;Taip;5;4;0;9
14398;Žirniukas;Boružiukų;6531175340;Taip;0;2;0;2
14399;Žirniukas;Boružiukų;6641200341;Taip;3;2;1;6
14400;Žirniukas;Boružiukų;3022672028;Taip;4;11;0;15
14401;Žirniukas;Boružiukų;3909152902;Taip;7;0;0;7
14402;Žirniukas;Boružiukų;8180092480;Ne;3;5;0;8
14403;Žirniukas;Boružiukų;5420360864;Taip;0;2;2;4
14404;Žirniukas;Smalsučiai;1961708150;Taip;0;9;0;9
14405;Žirniukas;Smalsučiai;2282495237;Taip;0;11;0;11
14406;Žirniukas;Smalsučiai;98962928727;Taip;0;7;2;9
14407;Žirniukas;Smalsučiai;2141162140;Taip;0;2;0;2
14408;Žirniukas;Smalsučiai;1294183547;Taip;0;2;1;3
14409;Žirniukas;Smalsučiai;1991599271;Taip;3;1;0;4
14410;Žirniukas;Smalsučiai;1393738771;Taip;5;0;1;6
14411;Žirniukas;Smalsučiai;29420916883;Ne;0;5;0;5
14412;Žirniukas;Smalsučiai;32419042337;Taip;0;2;3;5
14413;Žirniukas;Smalsučiai;5189034384;Taip;5;2;0;7
14414;Žirniukas;Smalsučiai;28992463324;Taip;0;0;2;2
14415;Žirniukas;Smalsučiai;2022475049;Taip;0;1;0;1
14416;Žirniukas;Smalsučiai;2294854901;Taip;4;0;0;4
14417;Žirniukas;Smalsučiai;46265018782;Taip;3;1;0;4
14418;Žirniukas;Smalsučiai;1095501791;Taip;0;0;4;4
14419;Žirniukas;Smalsučiai;69810421328;Taip;0;1;0;1
14420;Žirniukas;Smalsučiai;37852143615;Taip;0;7;0;7
14421;Žirniukas;Smalsučiai;5188013194;Taip;0;4;0;4
14422;Žirniukas;Smalsučiai;1409567693;Taip;0;5;0;5
14423;Žirniukas;Smalsučiai;60060805955;Taip;0;4;2;6
14424;Žirniukas;Smalsučiai;51172128673;Taip;0;3;0;3
14425;Žirniukas;Smalsučiai;66153778144;Taip;0;0;2;2
14426;Žirniukas;Smalsučiai;52181077421;Taip;0;5;1;6
14427;Žirniukas;Gėlyčių;74425301830;Taip;0;0;12;12
14428;Žirniukas;Gėlyčių;6649555415;Taip;0;11;0;11
14429;Žirniukas;Gėlyčių;1878369945;Taip;8;0;1;9
14430;Žirniukas;Gėlyčių;7397202752;Taip;0;7;0;7
14431;Žirniukas;Gėlyčių;3306670221;Ne;3;0;1;4
14432;Žirniukas;Gėlyčių;9896415564;Taip;3;0;0;3
14433;Žirniukas;Gėlyčių;6409900451;Taip;20;0;1;21
14434;Žirniukas;Gėlyčių;9374080010;Taip;10;0;0;10
14435;Žirniukas;Gėlyčių;8294569569;Taip;9;1;0;10
14436;Žirniukas;Gėlyčių;2132625724;Taip;0;6;0;6
14437;Žirniukas;Gėlyčių;2557138057;Taip;0;2;0;2
14438;Žirniukas;Gėlyčių;1678041002;Taip;0;2;0;2
14439;Žirniukas;Gėlyčių;7190628011;Taip;3;6;3;12
14440;Žirniukas;Gėlyčių;3068684150;Taip;22;0;0;22
14441;Žirniukas;Gėlyčių;5761169841;Taip;7;0;0;7
14442;Žirniukas;Gėlyčių;2982628594;Taip;0;1;0;1
14443;Žirniukas;Gėlyčių;1823215441;Taip;0;0;5;5
14444;Žirniukas;Gėlyčių;6254250706;Taip;0;1;0;1
14445;Žirniukas;Gėlyčių;1262404954;Taip;0;1;0;1
14446;Žirniukas;Gėlyčių;6121388208;Taip;3;0;2;5
14447;Žirniukas;Nykštukų;2309995947;Taip;4;0;4;8
14448;Žirniukas;Nykštukų;1944169398;Taip;0;0;4;4
14449;Žirniukas;Nykštukų;1514504241;Taip;0;0;3;3
14450;Žirniukas;Nykštukų;1064894307;Taip;0;2;2;4
14451;Žirniukas;Nykštukų;1162904969;Taip;0;0;2;2
14452;Žirniukas;Nykštukų;2049123663;Taip;0;0;1;1
14453;Žirniukas;Nykštukų;2151329751;Taip;0;0;3;3
14454;Žirniukas;Nykštukų;5939918015;Taip;0;4;4;8
14455;Žirniukas;Nykštukų;3010062747;Taip;0;3;0;3
14456;Žirniukas;Nykštukų;2162238771;Taip;0;1;3;4
14457;Žirniukas;Nykštukų;2029018108;Taip;0;0;5;5
14458;Žirniukas;Nykštukų;5987510202;Taip;0;0;4;4
14459;Žirniukas;Nykštukų;5104110821;Taip;0;0;5;5
14460;Žirniukas;Nykštukų;6180439078;Taip;0;0;1;1
14461;Žirniukas;Nykštukų;3808838764;Taip;0;8;0;8
14462;Žirniukas;Saulytės;9649896460;Taip;0;0;6;6
14463;Žirniukas;Saulytės;2733313392;Taip;0;1;5;6
14464;Žirniukas;Saulytės;9707776533;Taip;0;1;0;1
14465;Žirniukas;Saulytės;7278153529;Taip;0;1;0;1
14466;Žirniukas;Saulytės;7927815250;Taip;0;2;0;2
14467;Žirniukas;Saulytės;2325139043;Taip;5;0;0;5
14468;Žirniukas;Saulytės;4527367786;Taip;0;2;0;2
14469;Žirniukas;Saulytės;3610402086;Taip;1;0;0;1
14470;Žirniukas;Saulytės;6362626389;Taip;0;1;0;1
14471;Žirniukas;Saulytės;9961947583;Taip;0;6;0;6
14472;Žirniukas;Saulytės;4045432303;Taip;4;4;0;8
14473;Žirniukas;Saulytės;1074945082;Taip;0;0;19;19
14474;Žirniukas;Saulytės;1594735501;Taip;0;6;0;6
14475;Žirniukas;Saulytės;7535098093;Taip;4;0;0;4
14476;Žirniukas;Saulytės;1648249689;Taip;11;0;0;11
14477;Žirniukas;Saulytės;4433579937;Taip;0;0;1;1
14478;Žirniukas;Saulytės;4229687519;Taip;0;2;3;5
14479;Žirniukas;Drugelių;6271194358;Taip;4;9;0;13
14480;Žirniukas;Drugelių;9232828844;Taip;5;2;0;7
14481;Žirniukas;Drugelių;5269074776;Taip;0;0;5;5
14482;Žirniukas;Drugelių;3509857181;Taip;13;0;0;13
14483;Žirniukas;Drugelių;1590778538;Taip;0;5;0;5
14484;Žirniukas;Drugelių;2517524802;Taip;11;1;0;12
14485;Žirniukas;Drugelių;9901196251;Taip;0;2;0;2
14486;Žirniukas;Drugelių;2555959199;Taip;4;0;0;4
14487;Žirniukas;Drugelių;4762596462;Taip;0;0;1;1
14488;Žirniukas;Drugelių;5046469974;Taip;3;0;0;3
14489;Žirniukas;Drugelių;1826203483;Taip;5;4;0;9
14490;Žirniukas;Drugelių;4536071547;Taip;2;1;5;8
14491;Žirniukas;Drugelių;3996393849;Taip;5;0;0;5
14492;Žirniukas;Drugelių;7240364379;Taip;9;0;0;9
14493;Žirniukas;Drugelių;6300372863;Taip;7;5;0;12
14494;Žirniukas;Drugelių;5670489807;Taip;0;7;0;7
14495;Žirniukas;Drugelių;9794535841;Taip;18;0;0;18
14496;Žirniukas;Drugelių;1031316325;Taip;5;0;0;5
14497;Žirniukas;Drugelių;1018506580;Taip;12;2;0;14
14498;Žirniukas;Drugelių;6993784924;Taip;0;0;6;6
14499;Žirniukas;Drugelių;9384464752;Taip;9;2;3;14
14500;Žirniukas;Pelėdžiukai;2895924102;Taip;0;0;5;5
14501;Žirniukas;Pelėdžiukai;4347695841;Taip;10;0;0;10
14502;Žirniukas;Pelėdžiukai;9381704756;Taip;4;0;3;7
14503;Žirniukas;Pelėdžiukai;4847093256;Taip;0;2;0;2
14504;Žirniukas;Pelėdžiukai;7356213150;Taip;3;9;0;12
14505;Žirniukas;Pelėdžiukai;7545458622;Taip;0;3;4;7
14506;Žirniukas;Pelėdžiukai;8354728917;Taip;0;1;0;1
14507;Žirniukas;Pelėdžiukai;5376080603;Taip;0;0;2;2
14508;Žirniukas;Pelėdžiukai;7755938379;Taip;4;0;2;6
14509;Žirniukas;Pelėdžiukai;5470692657;Taip;8;0;2;10
14510;Žirniukas;Pelėdžiukai;8690042163;Taip;0;2;11;13
14511;Žirniukas;Pelėdžiukai;8808445761;Taip;0;1;0;1
14512;Žirniukas;Pelėdžiukai;4464151713;Taip;0;8;0;8
14513;Žirniukas;ZUIKUČIAI;4704879073;Taip;7;6;0;13
14514;Žirniukas;ZUIKUČIAI;5422282267;Taip;0;0;1;1
14515;Žirniukas;ZUIKUČIAI;9425682286;Taip;5;0;0;5
14516;Žirniukas;ZUIKUČIAI;4732089209;Taip;4;7;0;11
14517;Žirniukas;ZUIKUČIAI;1532129054;Taip;0;3;0;3
14518;Žirniukas;ZUIKUČIAI;2526769571;Taip;4;1;0;5
14519;Žirniukas;ZUIKUČIAI;6201949014;Taip;0;0;4;4
14520;Žirniukas;ZUIKUČIAI;1635353228;Taip;9;0;0;9
14521;Žirniukas;ZUIKUČIAI;9478756666;Taip;0;1;0;1
14522;Žirniukas;ZUIKUČIAI;2027344763;Taip;0;0;6;6
14523;Žirniukas;ZUIKUČIAI;3874713264;Taip;12;2;0;14
14524;Žirniukas;ZUIKUČIAI;4282344625;Taip;0;1;0;1
14525;Žirniukas;ZUIKUČIAI;2746074694;Taip;7;2;1;10
14526;Žirniukas;ZUIKUČIAI;7368124402;Taip;4;1;0;5
14527;Žirniukas;ZUIKUČIAI;5467016584;Taip;0;13;0;13
14528;Žirniukas;ZUIKUČIAI;9730269905;Taip;5;0;0;5
14529;Žirniukas;ZUIKUČIAI;3214136760;Taip;8;2;0;10
14530;Aušra;Kodėlčiukai;2611563172;Taip;5;6;0;11
14531;Aušra;Kodėlčiukai;4720749995;Taip;0;1;5;6
14532;Aušra;Kodėlčiukai;5929538617;Taip;0;1;0;1
14533;Aušra;Kodėlčiukai;6139706771;Taip;13;9;0;22
14534;Aušra;Kodėlčiukai;7314273812;Taip;5;2;3;10
14535;Aušra;Kodėlčiukai;5046439805;Taip;0;1;0;1
14536;Aušra;Kodėlčiukai;4540040693;Taip;19;0;0;19
14537;Aušra;Kodėlčiukai;1423840991;Ne;17;0;0;17
14538;Aušra;Kodėlčiukai;5013135853;Taip;7;2;6;15
14539;Aušra;Kodėlčiukai;9728140172;Taip;0;0;5;5
14540;Aušra;Kodėlčiukai;4824773027;Taip;10;0;0;10
14541;Aušra;Kodėlčiukai;1897365632;Taip;0;2;0;2
14542;Aušra;Kodėlčiukai;7469266085;Taip;0;9;0;9
14543;Aušra;Kodėlčiukai;1010721404;Taip;0;4;0;4
14544;Aušra;Kodėlčiukai;1883185016;Taip;4;0;0;4
14545;Aušra;Kodėlčiukai;9437530221;Taip;0;2;10;12
14546;Aušra;Kodėlčiukai;7367602247;Taip;0;2;0;2
14547;Aušra;Kodėlčiukai;3627487971;Taip;0;2;0;2
14548;Aušra;"4B klasė";2610054474;Ne;0;22;0;22
14549;Aušra;"4B klasė";95798840861;Taip;3;0;0;3
14550;Aušra;"4B klasė";7553225340;Ne;1;0;0;1
14551;Aušra;"4B klasė";70054065156;Taip;0;22;0;22
14552;Aušra;"4B klasė";9695887585;Ne;1;0;0;1
14553;Aušra;"4B klasė";3225989797;Ne;3;0;0;3
14554;Aušra;"4B klasė";7405776766;Ne;0;22;0;22
14555;Aušra;"4B klasė";5005513948;Ne;1;0;0;1
14556;Aušra;"4B klasė";7697924792;Ne;0;22;0;22
14557;Aušra;"4B klasė";2075587354;Ne;1;0;0;1
14558;Aušra;"4B klasė";65535488153;Taip;4;0;0;4
14559;Aušra;"4B klasė";9600565378;Ne;0;22;0;22
14560;Aušra;"4B klasė";3114317363;Ne;1;0;0;1
14561;Aušra;"4B klasė";7075053685;Ne;0;22;0;22
14562;Aušra;"4B klasė";98154599269;Taip;0;22;0;22
14563;Aušra;"4B klasė";7321317333;Ne;0;22;0;22
14564;Aušra;"4B klasė";2893668707;Ne;8;0;0;8
14565;Aušra;"4B klasė";7886658451;Ne;3;0;0;3
14566;Aušra;"4B klasė";23029741320;Ne;3;0;0;3
14567;Aušra;Smalsučiai;2819491961;Taip;0;0;3;3
14568;Aušra;Smalsučiai;84116863778;Taip;0;0;1;1
14569;Aušra;Smalsučiai;21544489661;Taip;0;2;0;2
14570;Aušra;Smalsučiai;1893586984;Taip;10;0;0;10
14571;Aušra;Smalsučiai;3823619675;Taip;0;0;1;1
14572;Aušra;Smalsučiai;2227238810;Taip;0;2;0;2
14573;Aušra;Smalsučiai;57469542504;Taip;0;2;0;2
14574;Aušra;Smalsučiai;23609052737;Taip;0;2;0;2
14575;Aušra;Smalsučiai;41017803426;Taip;0;0;1;1
14576;Aušra;Smalsučiai;13825730049;Taip;14;0;1;15
14577;Aušra;Smalsučiai;8686777160;Taip;0;3;0;3
14578;Aušra;Smalsučiai;15657824495;Taip;0;8;0;8
14579;Aušra;Smalsučiai;5988529284;Taip;8;2;3;13
14580;Aušra;Smalsučiai;79051821501;Taip;10;0;1;11
14581;Aušra;Smalsučiai;18943927144;Taip;7;3;0;10
14582;Aušra;Smalsučiai;58254707316;Taip;0;2;2;4
14583;Aušra;Smalsučiai;1385844067;Taip;0;2;0;2
14584;Aušra;Smalsučiai;2121418946;Taip;0;22;0;22
14585;Aušra;Smalsučiai;4325224130;Taip;0;10;1;11
14586;Aušra;Smalsučiai;1623803107;Taip;0;2;3;5
14587;Aušra;Smalsučiai;2000206874;Taip;0;0;6;6
14588;Aušra;"1A klasė";1167565535;Ne;1;0;0;1
14589;Aušra;"1A klasė";1473962346;Taip;4;0;0;4
14590;Aušra;"1A klasė";1049364899;Taip;4;0;0;4
14591;Aušra;"1A klasė";1427235223;Taip;19;0;0;19
14592;Aušra;"1A klasė";42344686036;Taip;1;0;0;1
14593;Aušra;"1A klasė";95586246863;Taip;3;0;0;3
14594;Aušra;"1A klasė";5468993286;Taip;0;22;0;22
14595;Aušra;"1A klasė";75047415039;Taip;2;0;0;2
14596;Aušra;"1A klasė";85826303673;Taip;7;0;0;7
14597;Aušra;"1A klasė";1145863002;Taip;0;22;0;22
14598;Aušra;"1A klasė";77966124767;Taip;1;0;0;1
14599;Aušra;"1A klasė";97312326369;Taip;5;0;0;5
14600;Aušra;"1A klasė";48817619537;Taip;1;0;0;1
14601;Aušra;"1A klasė";55937499558;Taip;3;0;0;3
14602;Aušra;"1A klasė";35779814505;Taip;1;0;0;1
14603;Aušra;"1A klasė";76280361479;Taip;2;0;0;2
14604;Aušra;"1A klasė";2131349938;Taip;3;0;0;3
14605;Aušra;"1A klasė";474412140;Taip;6;0;0;6
14606;Aušra;"1A klasė";1455625997;Taip;2;0;0;2
14607;Aušra;"1A klasė";36447115547;Taip;2;0;0;2
14608;Aušra;"1A klasė";1393006122;Taip;4;0;0;4
14609;Aušra;"1A klasė";7998332115;Taip;9;0;0;9
14610;Aušra;"1A klasė";2647629246;Taip;4;0;0;4
14611;Aušra;"1A klasė";14611425618;Taip;4;0;0;4
14612;Aušra;"1A klasė";31458685084;Taip;1;0;0;1
14613;Aušra;"1A klasė";1315930711;Taip;2;0;0;2
14614;Aušra;"1A klasė";4110537888;Taip;9;0;0;9
14615;Aušra;"1A klasė";9603569117;Taip;2;0;0;2
14616;Aušra;"1A klasė";2019480768;Taip;1;0;0;1
14617;Aušra;"2A klasė";8510995681;Taip;2;0;0;2
14618;Aušra;"2A klasė";9605206310;Taip;2;0;0;2
14619;Aušra;"2A klasė";1396233353;Taip;7;0;0;7
14620;Aušra;"2A klasė";3284383302;Taip;1;0;0;1
14621;Aušra;"2A klasė";13157844661;Taip;1;0;0;1
14622;Aušra;"2A klasė";14157070764;Taip;1;0;0;1
14623;Aušra;"2A klasė";92468615840;Taip;2;0;0;2
14624;Aušra;"2A klasė";68160889669;Taip;3;0;0;3
14625;Aušra;"2A klasė";1437126272;Taip;3;0;0;3
14626;Aušra;"2A klasė";15330844181;Taip;1;0;0;1
14627;Aušra;"2A klasė";39537089288;Taip;1;0;0;1
14628;Aušra;"2A klasė";2062775070;Taip;7;0;0;7
14629;Aušra;"2A klasė";3965445196;Taip;3;0;0;3
14630;Aušra;"2A klasė";85578471272;Taip;1;0;0;1
14631;Aušra;"2A klasė";88655846176;Taip;1;0;0;1
14632;Aušra;"2A klasė";73509864636;Ne;1;0;0;1
14633;Aušra;"2A klasė";27958163601;Taip;3;0;0;3
14634;Aušra;"2A klasė";40499781883;Taip;5;0;0;5
14635;Aušra;"2A klasė";68031503463;Taip;4;0;0;4
14636;Aušra;"2A klasė";80929303402;Taip;11;0;0;11
14637;Aušra;"2A klasė";81633973264;Taip;0;22;0;22
14638;Aušra;"2A klasė";70233681803;Taip;7;0;0;7
14639;Aušra;"2A klasė";1437385365;Taip;0;22;0;22
14640;Aušra;"2A klasė";51185323645;Taip;0;22;0;22
14641;Aušra;"2A klasė";52985512945;Taip;0;22;0;22
14642;Aušra;"2A klasė";97781409787;Taip;7;0;0;7
14643;Aušra;"2A klasė";99073448709;Taip;5;0;0;5
14644;Aušra;"3A klasė";68481706412;Taip;0;22;0;22
14645;Aušra;"3A klasė";99886964420;Taip;0;22;0;22
14646;Aušra;"3A klasė";19920237804;Taip;1;0;0;1
14647;Aušra;"3A klasė";13361663464;Taip;3;0;0;3
14648;Aušra;"3A klasė";95948867937;Taip;0;22;0;22
14649;Aušra;"3A klasė";78030425432;Taip;1;0;0;1
14650;Aušra;"3A klasė";34795588283;Taip;0;22;0;22
14651;Aušra;"3A klasė";29636399665;Taip;1;0;0;1
14652;Aušra;"3A klasė";81428848455;Taip;2;0;0;2
14653;Aušra;"3A klasė";47725613978;Taip;0;22;0;22
14654;Aušra;"3A klasė";93365393803;Taip;11;0;0;11
14655;Aušra;"3A klasė";52864653926;Taip;5;0;0;5
14656;Aušra;"3A klasė";10272136932;Ne;1;0;0;1
14657;Aušra;"3A klasė";77425098448;Taip;7;0;0;7
14658;Aušra;"3A klasė";20550256232;Taip;1;0;0;1
14659;Aušra;"3A klasė";42015974556;Taip;3;0;0;3
14660;Aušra;"3A klasė";2113586354;Taip;5;0;0;5
14661;Aušra;"3A klasė";19718806057;Taip;0;22;0;22
14662;Aušra;"3A klasė";21856009403;Taip;5;0;0;5
14663;Aušra;"3A klasė";5166358753;Taip;1;0;0;1
14664;Aušra;"3A klasė";97596344387;Taip;5;0;0;5
14665;Aušra;"3A klasė";97596344387;Taip;5;0;0;5
14666;Aušra;"4A klasė";2908360090;Ne;0;22;0;22
14667;Aušra;"4A klasė";1585279799;Ne;0;22;0;22
14668;Aušra;"4A klasė";8497743711;Ne;10;0;0;10
14669;Aušra;"4A klasė";7439801986;Ne;2;0;0;2
14670;Aušra;"4A klasė";4952796453;Ne;0;22;0;22
14671;Aušra;"4A klasė";1404310604;Ne;3;0;0;3
14672;Aušra;"4A klasė";5770340819;Ne;0;22;0;22
14673;Aušra;"4A klasė";9510786725;Ne;1;0;0;1
14674;Aušra;"4A klasė";2280410145;Ne;0;22;0;22
14675;Aušra;"4A klasė";29945175192;Taip;0;22;0;22
14676;Aušra;"4A klasė";8367064629;Taip;0;22;0;22
14677;Aušra;"4A klasė";7931858964;Ne;8;0;0;8
14678;Aušra;"4A klasė";5792862565;Ne;1;0;0;1
14679;Aušra;"4A klasė";6942076490;Ne;1;0;0;1
14680;Aušra;"4A klasė";4399210916;Ne;1;0;0;1
14681;Aušra;"4A klasė";8892613555;Ne;1;0;0;1
14682;Aušra;"4A klasė";6534693192;Ne;0;22;0;22
14683;Aušra;"4A klasė";2797588970;Ne;0;22;0;22
14684;Aušra;"4A klasė";5657162092;Ne;0;22;0;22
14685;Aušra;"4A klasė";3435983733;Ne;2;0;0;2
14686;Aušra;"4A klasė";5825720308;Ne;0;22;0;22
14687;Aušra;"4A klasė";7313001921;Ne;1;0;0;1
14688;Aušra;"4A klasė";2796012982;Ne;1;0;0;1
14689;Aušra;"4A klasė";8632721907;Ne;1;0;0;1
14690;Aušra;"4A klasė";7113793626;Ne;0;22;0;22
14691;Aušra;"4A klasė";75839555732;Taip;2;0;0;2
14692;Aušra;"4A klasė";96979357769;Taip;0;22;0;22
14693;Aušra;"4A klasė";9584232864;Ne;3;0;0;3
14694;Aušra;"3B klasė";92119607174;Taip;2;0;0;2
14695;Aušra;"3B klasė";22923377435;Taip;2;0;0;2
14696;Aušra;"3B klasė";41852924528;Taip;2;0;0;2
14697;Aušra;"3B klasė";58526614808;Taip;2;0;0;2
14698;Aušra;"3B klasė";41039525379;Taip;9;0;0;9
14699;Aušra;"3B klasė";37339481276;Taip;2;0;0;2
14700;Aušra;"3B klasė";45165946624;Taip;3;0;0;3
14701;Aušra;"3B klasė";59107169775;Taip;2;0;0;2
14702;Aušra;"3B klasė";48349819906;Taip;2;0;0;2
14703;Aušra;"3B klasė";71596384638;Taip;2;0;0;2
14704;Aušra;"3B klasė";52332096506;Taip;2;0;0;2
14705;Aušra;"3B klasė";35703433862;Taip;5;0;0;5
14706;Aušra;"3B klasė";6201728036;Taip;3;0;0;3
14707;Aušra;"3B klasė";36889923728;Taip;3;0;0;3
14708;Aušra;"3B klasė";39957179831;Taip;0;22;0;22
14709;Aušra;"3B klasė";52909474598;Taip;2;0;0;2
14710;Aušra;"3B klasė";8901585006;Taip;0;22;0;22
14711;Aušra;"3B klasė";64562667133;Taip;0;22;0;22
14712;Aušra;"3B klasė";95076478544;Ne;2;0;0;2
14713;Aušra;"3B klasė";36899257479;Ne;3;0;0;3
14714;Aušra;"3B klasė";57520886724;Taip;0;22;0;22
14715;Aušra;"3B klasė";1815771421;Taip;2;0;0;2
14716;Aušra;"3B klasė";75433637766;Taip;18;0;0;18
14717;Aušra;"3B klasė";83119050626;Taip;0;22;0;22
14718;Aušra;Pabiručiai;7542690501;Taip;0;22;0;22
14719;Aušra;Pabiručiai;9466807067;Taip;3;0;0;3
14720;Aušra;Pabiručiai;6508435821;Taip;3;2;3;8
14721;Aušra;Pabiručiai;7926621700;Taip;0;6;0;6
14722;Aušra;Pabiručiai;8665364744;Taip;22;0;0;22
14723;Aušra;Pabiručiai;6555345047;Taip;3;0;0;3
14724;Aušra;Pabiručiai;7888891808;Taip;3;0;0;3
14725;Aušra;Pabiručiai;1306616759;Taip;0;3;7;10
14726;Aušra;Pabiručiai;3275288747;Taip;0;5;0;5
14727;Aušra;Pabiručiai;5797692122;Taip;0;3;8;11
14728;Aušra;Pabiručiai;4071233786;Taip;0;0;2;2
14729;Aušra;Pabiručiai;4646215025;Taip;15;0;1;16
14730;Aušra;Pabiručiai;7199483890;Taip;0;2;2;4
14731;Aušra;Pabiručiai;7944904281;Taip;11;2;1;14
14732;Aušra;Pabiručiai;3336605264;Taip;7;4;0;11
14733;Aušra;Pabiručiai;3553620602;Taip;1;0;0;1
14734;Aušra;Pabiručiai;3759593393;Taip;0;2;3;5
14735;Aušra;Pabiručiai;2904303784;Taip;6;2;2;10
14736;Aušra;Pabiručiai;6056923592;Taip;4;1;0;5
14737;Aušra;Pabiručiai;3953653896;Taip;0;7;0;7
14738;Aušra;Pabiručiai;8462418277;Taip;5;0;0;5
14739;Aušra;Gudručiai;6351008213;Taip;16;0;0;16
14740;Aušra;Gudručiai;2271582954;Taip;5;0;0;5
14741;Aušra;Gudručiai;5854637278;Taip;8;0;0;8
14742;Aušra;Gudručiai;8715912139;Taip;3;1;0;4
14743;Aušra;Gudručiai;7783006852;Taip;0;1;0;1
14744;Aušra;Gudručiai;9614562473;Taip;0;5;0;5
14745;Aušra;Gudručiai;6658178519;Taip;4;2;2;8
14746;Aušra;Gudručiai;7921251819;Taip;0;8;0;8
14747;Aušra;Gudručiai;9628651723;Taip;22;0;0;22
14748;Aušra;Gudručiai;3343235857;Taip;3;0;1;4
14749;Aušra;Gudručiai;1450251779;Taip;0;9;0;9
14750;Aušra;Gudručiai;3530905126;Taip;0;22;0;22
14751;Aušra;Gudručiai;1429548355;Taip;0;12;0;12
14752;Aušra;Gudručiai;1933801749;Taip;0;3;0;3
14753;Aušra;Gudručiai;5955385407;Taip;0;22;0;22
14754;Aušra;Gudručiai;2243689816;Taip;0;5;0;5
14755;Aušra;Gudručiai;6935310711;Taip;2;1;0;3
14756;Aušra;Gudručiai;3698868934;Taip;6;0;0;6
14757;Aušra;Gudručiai;9079804366;Taip;0;1;0;1
14758;Aušra;Gudručiai;3498143162;Taip;0;1;0;1
14759;Aušra;Naminukai;5409157554;Taip;5;2;0;7
14760;Aušra;Naminukai;3680329197;Taip;0;0;2;2
14761;Aušra;Naminukai;8740755922;Taip;0;0;5;5
14762;Aušra;Naminukai;3898178166;Taip;10;4;0;14
14763;Aušra;Naminukai;29499576216;Taip;0;2;0;2
14764;Aušra;Naminukai;4404047456;Taip;0;0;7;7
14765;Aušra;Naminukai;97102749430;Taip;0;2;1;3
14766;Aušra;Naminukai;9702136789;Taip;0;2;4;6
14767;Aušra;Naminukai;5673568541;Taip;0;0;2;2
14768;Aušra;Naminukai;5524681006;Taip;0;4;8;12
14769;Aušra;Naminukai;6384243597;Taip;0;3;0;3
14770;Aušra;Naminukai;1343532870;Taip;0;1;0;1
14771;Aušra;Naminukai;7043021721;Taip;0;13;0;13
14772;Aušra;Naminukai;1612662076;Taip;0;11;0;11
14773;Aušra;Naminukai;2288159223;Taip;0;10;0;10
14774;Aušra;Naminukai;1575761029;Taip;0;0;13;13
14775;Aušra;Naminukai;5777939563;Taip;5;0;0;5
14776;Aušra;Naminukai;7814902928;Taip;0;1;8;9
14777;Aušra;Naminukai;8176840834;Taip;19;0;0;19
14778;Aušra;Naminukai;1387254053;Taip;0;2;2;4
14779;Aušra;Naminukai;19402768340;Taip;0;5;0;5
14780;Berželis;PČIOLKI;1470907829;Taip;0;0;1;1
14781;Berželis;PČIOLKI;301318033;Taip;0;1;0;1
14782;Berželis;PČIOLKI;3215259838;Taip;11;0;1;12
14783;Berželis;PČIOLKI;2002649360;Taip;0;5;0;5
14784;Berželis;PČIOLKI;25985469678;Ne;5;0;3;8
14785;Berželis;PČIOLKI;83253240251;Taip;0;0;9;9
14786;Berželis;PČIOLKI;1061894314;Taip;0;0;2;2
14787;Berželis;PČIOLKI;11671380984;Taip;0;0;1;1
14788;Berželis;PČIOLKI;1183377037;Taip;0;0;2;2
14789;Berželis;PČIOLKI;1492203156;Taip;0;0;11;11
14790;Berželis;PČIOLKI;8939353460;Taip;0;4;5;9
14791;Berželis;PČIOLKI;2028316867;Ne;0;6;0;6
14792;Berželis;PČIOLKI;1511044883;Taip;0;1;0;1
14793;Berželis;PČIOLKI;1573177287;Taip;0;12;0;12
14794;Berželis;PČIOLKI;48932211843;Taip;0;5;0;5
14795;Berželis;PČIOLKI;1865658456;Taip;0;0;4;4
14796;Berželis;PČIOLKI;1953624864;Taip;14;0;2;16
14797;Berželis;"BOŽJI KOROVKI";3162044236;Taip;0;0;4;4
14798;Berželis;"BOŽJI KOROVKI";9132058594;Taip;8;0;0;8
14799;Berželis;"BOŽJI KOROVKI";7421059780;Taip;8;0;0;8
14800;Berželis;"BOŽJI KOROVKI";5739847580;Taip;13;0;0;13
14801;Berželis;"BOŽJI KOROVKI";4100740863;Taip;8;9;0;17
14802;Berželis;"BOŽJI KOROVKI";1750209600;Taip;4;1;0;5
14803;Berželis;"BOŽJI KOROVKI";5953387226;Taip;0;22;0;22
14804;Berželis;"BOŽJI KOROVKI";3070917065;Taip;8;1;5;14
14805;Berželis;"BOŽJI KOROVKI";2005082089;Taip;0;2;0;2
14806;Berželis;"BOŽJI KOROVKI";5692603837;Taip;0;4;0;4
14807;Berželis;"BOŽJI KOROVKI";5194480946;Taip;6;0;0;6
14808;Berželis;"BOŽJI KOROVKI";9848723402;Taip;7;1;2;10
14809;Berželis;"BOŽJI KOROVKI";5551459997;Taip;1;0;0;1
14810;Berželis;"BOŽJI KOROVKI";6651007152;Taip;14;0;3;17
14811;Berželis;"BOŽJI KOROVKI";8451877584;Taip;13;0;0;13
14812;Berželis;"BOŽJI KOROVKI";7080168105;Taip;9;1;1;11
14813;Berželis;"BOŽJI KOROVKI";9438498834;Ne;0;1;0;1
14814;Berželis;"BOŽJI KOROVKI";1132252592;Taip;0;4;1;5
14815;Berželis;"BOŽJI KOROVKI";5550598069;Taip;0;6;2;8
14816;Berželis;"BOŽJI KOROVKI";1852964349;Taip;2;6;0;8
14817;Berželis;"BOŽJI KOROVKI";8871199713;Taip;8;9;0;17
14818;Berželis;"BOŽJI KOROVKI";1722262813;Taip;0;1;0;1
14819;Berželis;SOLNYŠKO;2182268389;Taip;0;0;1;1
14820;Berželis;SOLNYŠKO;1498165322;Taip;0;1;0;1
14821;Berželis;SOLNYŠKO;6189116357;Taip;0;0;2;2
14822;Berželis;SOLNYŠKO;8737788279;Taip;3;0;0;3
14823;Berželis;SOLNYŠKO;8771171576;Taip;0;0;4;4
14824;Berželis;SOLNYŠKO;2901168499;Taip;0;0;2;2
14825;Berželis;SOLNYŠKO;2693961315;Taip;16;0;0;16
14826;Berželis;SOLNYŠKO;7411282628;Taip;13;0;5;18
14827;Berželis;SOLNYŠKO;8957312159;Taip;9;0;0;9
14828;Berželis;SOLNYŠKO;4910899296;Taip;14;0;0;14
14829;Berželis;SOLNYŠKO;4249048581;Taip;14;0;0;14
14830;Berželis;SOLNYŠKO;1167103292;Taip;4;0;1;5
14831;Berželis;SOLNYŠKO;5408368340;Taip;22;0;0;22
14832;Berželis;SOLNYŠKO;1070751052;Taip;5;0;3;8
14833;Berželis;SOLNYŠKO;5464385395;Taip;0;1;0;1
14834;Berželis;SOLNYŠKO;6422037185;Taip;0;0;3;3
14835;Berželis;BABOČKI;4923631429;Taip;11;2;0;13
14836;Berželis;BABOČKI;2016194182;Taip;0;0;1;1
14837;Berželis;BABOČKI;2030770943;Taip;0;0;4;4
14838;Berželis;BABOČKI;2667957070;Taip;0;0;1;1
14839;Berželis;BABOČKI;7781031211;Taip;0;8;0;8
14840;Berželis;BABOČKI;2493612905;Taip;1;0;2;3
14841;Berželis;BABOČKI;5688897783;Taip;0;12;0;12
14842;Berželis;BABOČKI;6942559693;Taip;16;0;0;16
14843;Berželis;BABOČKI;6352635742;Taip;0;2;0;2
14844;Berželis;BABOČKI;8448872491;Taip;10;0;0;10
14845;Berželis;BABOČKI;5069322062;Taip;0;0;8;8
14846;Berželis;BABOČKI;2954451168;Taip;0;0;1;1
14847;Berželis;BABOČKI;9585609150;Taip;7;5;0;12
14848;Berželis;BABOČKI;7940591009;Taip;0;0;1;1
14849;Berželis;BABOČKI;4546285993;Taip;10;0;10;20
14850;Berželis;BABOČKI;5876182759;Taip;0;7;0;7
14851;Berželis;BABOČKI;9568910880;Taip;0;0;14;14
14852;Berželis;SOVUŠKI;5350402890;Taip;0;0;2;2
14853;Berželis;SOVUŠKI;8185887403;Taip;0;22;0;22
14854;Berželis;SOVUŠKI;8989621715;Taip;14;4;0;18
14855;Berželis;SOVUŠKI;1289333809;Taip;9;1;0;10
14856;Berželis;SOVUŠKI;8086074279;Taip;0;12;0;12
14857;Berželis;SOVUŠKI;9273819928;Taip;0;0;4;4
14858;Berželis;SOVUŠKI;9750863775;Taip;11;0;0;11
14859;Berželis;SOVUŠKI;3885474466;Taip;8;0;0;8
14860;Berželis;SOVUŠKI;1825910306;Taip;11;0;0;11
14861;Berželis;SOVUŠKI;6706273205;Taip;3;0;0;3
14862;Berželis;SOVUŠKI;2895332184;Ne;9;0;2;11
14863;Berželis;SOVUŠKI;1464998584;Taip;22;0;0;22
14864;Berželis;SOVUŠKI;2844736188;Taip;12;0;0;12
14865;Berželis;SOVUŠKI;3835273594;Taip;6;0;0;6
14866;Berželis;SOVUŠKI;2632535013;Taip;22;0;0;22
14867;Berželis;SOVUŠKI;6698849108;Taip;6;0;2;8
14868;Berželis;PODSOLNUŠKI;4521372127;Taip;0;2;0;2
14869;Berželis;PODSOLNUŠKI;2214171136;Taip;11;0;2;13
14870;Berželis;PODSOLNUŠKI;97218091736;Taip;0;0;11;11
14871;Berželis;PODSOLNUŠKI;1521982237;Taip;0;0;4;4
14872;Berželis;PODSOLNUŠKI;4013215941;Taip;0;3;0;3
14873;Berželis;PODSOLNUŠKI;7526006253;Taip;0;3;0;3
14874;Berželis;PODSOLNUŠKI;64214150955;Taip;7;0;0;7
14875;Berželis;PODSOLNUŠKI;6473498471;Taip;0;4;0;4
14876;Berželis;PODSOLNUŠKI;1067618571;Taip;0;6;0;6
14877;Berželis;PODSOLNUŠKI;3772780161;Taip;6;3;0;9
14878;Berželis;PODSOLNUŠKI;4563582416;Taip;5;4;0;9
14879;Berželis;PODSOLNUŠKI;6113571093;Taip;0;0;3;3
14880;Berželis;PODSOLNUŠKI;1036370516;Taip;0;0;1;1
14881;Berželis;PODSOLNUŠKI;2615440913;Taip;0;0;7;7
14882;Berželis;PODSOLNUŠKI;9894751274;Taip;0;0;1;1
14883;Berželis;PODSOLNUŠKI;3298044639;Taip;1;0;0;1
14884;Berželis;LAPIUKAI;8650915495;Taip;8;0;3;11
14885;Berželis;LAPIUKAI;8318089070;Taip;0;0;9;9
14886;Berželis;LAPIUKAI;2971765753;Taip;0;7;0;7
14887;Berželis;LAPIUKAI;3952731134;Taip;4;0;0;4
14888;Berželis;LAPIUKAI;9658062645;Taip;8;0;2;10
14889;Berželis;LAPIUKAI;7947225506;Taip;8;0;0;8
14890;Berželis;LAPIUKAI;2144796691;Taip;18;0;0;18
14891;Berželis;LAPIUKAI;1834920753;Taip;4;0;0;4
14892;Berželis;LAPIUKAI;6384939601;Taip;8;0;2;10
14893;Berželis;LAPIUKAI;2410514408;Taip;5;0;0;5
14894;Berželis;LAPIUKAI;2794074071;Taip;13;0;0;13
14895;Berželis;LAPIUKAI;9681310544;Taip;19;0;0;19
14896;Berželis;LAPIUKAI;4254592648;Taip;8;0;6;14
14897;Berželis;LAPIUKAI;9543499205;Taip;0;7;0;7
14898;Berželis;MEŠKIUKAI;3679990879;Taip;11;0;1;12
14899;Berželis;MEŠKIUKAI;8994102218;Taip;14;0;0;14
14900;Berželis;MEŠKIUKAI;4427274462;Taip;8;0;0;8
14901;Berželis;MEŠKIUKAI;4854931959;Taip;12;0;0;12
14902;Berželis;MEŠKIUKAI;5839964720;Taip;5;0;0;5
14903;Berželis;MEŠKIUKAI;9646494715;Taip;10;0;0;10
14904;Berželis;MEŠKIUKAI;5686182866;Ne;4;0;0;4
14905;Berželis;MEŠKIUKAI;8679005113;Ne;16;0;0;16
14906;Berželis;MEŠKIUKAI;7902774064;Taip;22;0;0;22
14907;Berželis;MEŠKIUKAI;4243086262;Taip;15;0;0;15
14908;Berželis;MEŠKIUKAI;1044720859;Taip;8;0;3;11
14909;Berželis;ŽIEDELIAI;3786609012;Taip;3;5;0;8
14910;Berželis;ŽIEDELIAI;9805181733;Taip;4;0;0;4
14911;Berželis;ŽIEDELIAI;1165300871;Taip;7;1;0;8
14912;Berželis;ŽIEDELIAI;3379227410;Taip;0;22;0;22
14913;Berželis;ŽIEDELIAI;2016827207;Ne;13;0;0;13
14914;Berželis;ŽIEDELIAI;9979442772;Ne;0;2;0;2
14915;Berželis;ŽIEDELIAI;9881246268;Taip;3;0;0;3
14916;Berželis;ŽIEDELIAI;7042967329;Taip;10;0;5;15
14917;Berželis;ŽIEDELIAI;9925865228;Taip;9;0;9;18
14918;Berželis;ŽIEDELIAI;1402975280;Taip;0;5;0;5
14919;Berželis;ŽIEDELIAI;1535940949;Taip;0;8;0;8
14920;Berželis;ŽIEDELIAI;2030492491;Taip;4;0;4;8
14921;Berželis;ŽIEDELIAI;3351114197;Taip;3;0;6;9
14922;Berželis;ŽIEDELIAI;4032178538;Taip;2;0;5;7
14923;Berželis;ŽIEDELIAI;5248880873;Taip;13;0;0;13
14924;Berželis;NYKŠTUKAI;6188186413;Taip;0;0;22;22
14925;Berželis;NYKŠTUKAI;8148104183;Ne;0;0;1;1
14926;Berželis;NYKŠTUKAI;7935684899;Ne;8;0;10;18
14927;Berželis;NYKŠTUKAI;5012540410;Taip;10;0;1;11
14928;Berželis;NYKŠTUKAI;1403664386;Taip;0;9;3;12
14929;Berželis;NYKŠTUKAI;5637168259;Taip;11;0;0;11
14930;Berželis;NYKŠTUKAI;9666648116;Taip;8;0;2;10
14931;Berželis;NYKŠTUKAI;3559065542;Ne;0;0;17;17
14932;Berželis;NYKŠTUKAI;3556594755;Taip;0;0;2;2
14933;Berželis;NYKŠTUKAI;2933069798;Taip;8;0;0;8
14934;Berželis;NYKŠTUKAI;9773066955;Ne;15;0;0;15
14935;Berželis;NYKŠTUKAI;8430372047;Taip;0;0;3;3
14936;Berželis;NYKŠTUKAI;5099275362;Taip;0;4;0;4
14937;Berželis;NYKŠTUKAI;5101382213;Taip;2;0;1;3
14938;Berželis;NYKŠTUKAI;2425621326;Ne;6;0;7;13
14939;Berželis;NYKŠTUKAI;3563882751;Taip;15;0;3;18
14940;Berželis;NYKŠTUKAI;7676141462;Ne;8;3;0;11
14941;Berželis;NYKŠTUKAI;3852021563;Taip;0;0;3;3
14942;Berželis;UOGELĖS;6110797822;Taip;0;0;5;5
14943;Berželis;UOGELĖS;8164697203;Taip;1;0;0;1
14944;Berželis;UOGELĖS;2762946143;Taip;0;5;0;5
14945;Berželis;UOGELĖS;8735934456;Taip;0;0;3;3
14946;Berželis;UOGELĖS;5304917030;Taip;19;0;0;19
14947;Berželis;UOGELĖS;1146976812;Ne;0;0;1;1
14948;Berželis;UOGELĖS;1414150066;Ne;4;0;0;4
14949;Berželis;UOGELĖS;8907020701;Taip;8;0;0;8
14950;Berželis;UOGELĖS;6136155301;Taip;13;0;0;13
14951;Berželis;UOGELĖS;9950641759;Taip;2;0;5;7
14952;Berželis;UOGELĖS;9034464618;Taip;13;0;0;13
14953;Berželis;UOGELĖS;5851732944;Taip;0;6;7;13
14954;Berželis;UOGELĖS;2321608974;Ne;0;0;2;2
14955;Berželis;KODĖLČIUKAI;3241194385;Taip;8;0;2;10
14956;Berželis;KODĖLČIUKAI;5134372871;Taip;3;0;0;3
14957;Berželis;KODĖLČIUKAI;7852089381;Taip;0;0;8;8
14958;Berželis;KODĖLČIUKAI;5751995154;Ne;15;0;0;15
14959;Berželis;KODĖLČIUKAI;7986744784;Ne;5;1;0;6
14960;Berželis;KODĖLČIUKAI;1127524998;Taip;0;4;0;4
14961;Berželis;KODĖLČIUKAI;3951962738;Taip;0;0;7;7
14962;Berželis;KODĖLČIUKAI;2193392844;Taip;9;0;1;10
14963;Berželis;KODĖLČIUKAI;8286301258;Taip;0;0;11;11
14964;Berželis;KODĖLČIUKAI;8297975308;Taip;3;8;0;11
14965;Berželis;KODĖLČIUKAI;8875116641;Taip;0;6;6;12
14966;Berželis;KODĖLČIUKAI;9282593781;Taip;0;6;0;6
14967;Berželis;KODĖLČIUKAI;6500588668;Taip;1;0;1;2
14968;Berželis;KODĖLČIUKAI;3327751482;Ne;19;0;0;19
14969;Berželis;KODĖLČIUKAI;6060490387;Taip;3;0;0;3
14970;Berželis;KODĖLČIUKAI;7504002028;Ne;0;0;1;1
14971;Saulutė;Drugeliai;66108847230;Taip;5;0;7;12
14972;Saulutė;Drugeliai;1556270046;Taip;0;1;0;1
14973;Saulutė;Drugeliai;3064199909;Taip;0;0;4;4
14974;Saulutė;Drugeliai;1717909005;Taip;7;0;4;11
14975;Saulutė;Drugeliai;1283800571;Taip;0;9;0;9
14976;Saulutė;Drugeliai;8599199376;Taip;4;0;0;4
14977;Saulutė;Drugeliai;87814849917;Taip;0;0;2;2
14978;Saulutė;Drugeliai;1291318940;Taip;0;2;0;2
14979;Saulutė;Drugeliai;1391904744;Taip;0;1;2;3
14980;Saulutė;Drugeliai;8944601874;Taip;0;6;0;6
14981;Saulutė;Drugeliai;4272320685;Taip;0;1;1;2
14982;Saulutė;Drugeliai;7539721995;Taip;5;0;1;6
14983;Saulutė;Drugeliai;1320018338;Taip;4;1;0;5
14984;Saulutė;Drugeliai;1750571258;Taip;7;0;2;9
14985;Saulutė;Drugeliai;1609952589;Taip;2;0;0;2
14986;Saulutė;Drugeliai;8379304869;Ne;0;5;1;6
14987;Saulutė;Drugeliai;6096297366;Ne;5;0;2;7
14988;Saulutė;"Saulės zuikučiai";8946107286;Taip;5;0;0;5
14989;Saulutė;"Saulės zuikučiai";2397257894;Taip;0;0;1;1
14990;Saulutė;"Saulės zuikučiai";2010774109;Taip;0;21;0;21
14991;Saulutė;"Saulės zuikučiai";5148542811;Taip;0;14;0;14
14992;Saulutė;"Saulės zuikučiai";2259917151;Taip;0;1;2;3
14993;Saulutė;"Saulės zuikučiai";3691381351;Taip;0;1;0;1
14994;Saulutė;"Saulės zuikučiai";3749374270;Taip;0;5;0;5
14995;Saulutė;"Saulės zuikučiai";9146298505;Taip;0;1;0;1
14996;Saulutė;"Saulės zuikučiai";8242602551;Ne;0;6;0;6
14997;Saulutė;"Saulės zuikučiai";1324799653;Taip;0;5;0;5
14998;Saulutė;"Saulės zuikučiai";5247769309;Taip;3;11;0;14
14999;Saulutė;"Saulės zuikučiai";2816806902;Taip;0;3;0;3
15000;Saulutė;"Saulės zuikučiai";2781003892;Taip;0;6;0;6
15001;Saulutė;"Saulės zuikučiai";5839981073;Ne;0;12;0;12
15002;Saulutė;"Saulės zuikučiai";7888435573;Taip;3;0;3;6
15003;Saulutė;"Saulės zuikučiai";9521155670;Taip;0;6;0;6
15004;Saulutė;"Saulės zuikučiai";7844396402;Taip;8;0;2;10
15005;Saulutė;"Saulės zuikučiai";7351477901;Taip;0;1;0;1
15006;Saulutė;"Saulės zuikučiai";3089541630;Taip;0;2;0;2
15007;Saulutė;"Saulės zuikučiai";9892855816;Taip;0;9;1;10
15008;Saulutė;"Saulės zuikučiai";5326279083;Taip;0;8;0;8
15009;Saulutė;"Saulės zuikučiai";1562393383;Taip;0;5;3;8
15010;Saulutė;"Saulės zuikučiai";1275552038;Taip;5;0;0;5
15011;Saulutė;Boružėlės;1587328722;Taip;0;0;4;4
15012;Saulutė;Boružėlės;8390767549;Taip;0;0;2;2
15013;Saulutė;Boružėlės;7576532632;Taip;0;0;9;9
15014;Saulutė;Boružėlės;2725491887;Taip;8;0;4;12
15015;Saulutė;Boružėlės;9314889468;Taip;11;0;0;11
15016;Saulutė;Boružėlės;7764493159;Taip;3;0;1;4
15017;Saulutė;Boružėlės;5565832676;Taip;4;0;0;4
15018;Saulutė;Boružėlės;5811810714;Taip;0;0;6;6
15019;Saulutė;Boružėlės;8643975544;Taip;0;0;7;7
15020;Saulutė;Boružėlės;7474989619;Taip;0;0;6;6
15021;Saulutė;Boružėlės;8619163154;Ne;0;0;9;9
15022;Saulutė;Boružėlės;7574225926;Taip;0;0;11;11
15023;Saulutė;Boružėlės;3272296969;Taip;0;3;0;3
15024;Saulutė;Boružėlės;1803710557;Taip;8;0;5;13
15025;Saulutė;Boružėlės;9098663596;Taip;7;0;5;12
15026;Saulutė;Boružėlės;7425789805;Taip;0;11;2;13
15027;Saulutė;Boružėlės;1265174091;Taip;0;11;0;11
15028;Saulutė;Boružėlės;2527027536;Taip;0;0;3;3
15029;Saulutė;Boružėlės;2988010963;Taip;11;0;1;12
15030;Saulutė;Nykštukai;4663795223;Taip;0;0;7;7
15031;Saulutė;Nykštukai;2601822200;Taip;5;0;0;5
15032;Saulutė;Nykštukai;3244850673;Taip;0;3;0;3
15033;Saulutė;Nykštukai;9497439410;Taip;0;6;0;6
15034;Saulutė;Nykštukai;3408369823;Taip;0;0;1;1
15035;Saulutė;Nykštukai;5607937410;Taip;0;1;0;1
15036;Saulutė;Nykštukai;3571751974;Taip;7;0;1;8
15037;Saulutė;Nykštukai;3221612665;Taip;8;9;0;17
15038;Saulutė;Nykštukai;2140277182;Taip;6;3;0;9
15039;Saulutė;Nykštukai;4510990261;Taip;0;0;4;4
15040;Saulutė;Nykštukai;4800144085;Taip;7;0;0;7
15041;Saulutė;Nykštukai;8257363228;Taip;11;0;0;11
15042;Saulutė;Nykštukai;9947607411;Ne;0;0;4;4
15043;Saulutė;Nykštukai;9664809396;Taip;4;0;0;4
15044;Saulutė;Nykštukai;8984040932;Taip;3;1;0;4
15045;Saulutė;Nykštukai;3463428772;Taip;3;0;2;5
15046;Saulutė;Nykštukai;3126468651;Taip;8;0;1;9
15047;Saulutė;Meškiukai;2337702344;Taip;0;3;0;3
15048;Saulutė;Meškiukai;1370201372;Taip;6;3;0;9
15049;Saulutė;Meškiukai;3133714991;Taip;16;4;0;20
15050;Saulutė;Meškiukai;2484025931;Taip;0;6;0;6
15051;Saulutė;Meškiukai;9317649996;Taip;10;5;0;15
15052;Saulutė;Meškiukai;6678283260;Taip;7;0;0;7
15053;Saulutė;Meškiukai;3662919521;Taip;6;9;0;15
15054;Saulutė;Meškiukai;6304028361;Taip;22;0;0;22
15055;Saulutė;Meškiukai;7967532537;Taip;4;0;1;5
15056;Saulutė;Meškiukai;5335820652;Taip;5;0;1;6
15057;Saulutė;Meškiukai;1088813143;Taip;0;0;2;2
15058;Saulutė;Meškiukai;4039065925;Taip;4;7;6;17
15059;Saulutė;Meškiukai;2728669975;Taip;8;1;0;9
15060;Saulutė;Meškiukai;8952893819;Taip;1;11;0;12
15061;Saulutė;Meškiukai;6455593653;Taip;8;0;3;11
15062;Saulutė;Meškiukai;6924891265;Taip;0;0;5;5
15063;Saulutė;Meškiukai;8919457259;Taip;6;0;2;8
15064;Saulutė;Meškiukai;9410517602;Taip;8;5;0;13
15065;Saulutė;Ežiukai;1546200973;Taip;8;0;2;10
15066;Saulutė;Ežiukai;2813274509;Taip;0;0;11;11
15067;Saulutė;Ežiukai;3410606033;Taip;0;5;0;5
15068;Saulutė;Ežiukai;6982979199;Taip;0;0;1;1
15069;Saulutė;Ežiukai;2315812734;Taip;0;0;21;21
15070;Saulutė;Ežiukai;2059342403;Ne;12;0;0;12
15071;Saulutė;Ežiukai;8736917541;Taip;0;0;3;3
15072;Saulutė;Ežiukai;4363210987;Taip;0;0;5;5
15073;Saulutė;Ežiukai;5972503001;Taip;8;0;2;10
15074;Saulutė;Ežiukai;4765483387;Taip;2;1;0;3
15075;Saulutė;Ežiukai;4575314373;Ne;18;4;0;22
15076;Saulutė;Ežiukai;6219942114;Taip;8;0;2;10
15077;Saulutė;Ežiukai;4194586403;Taip;3;0;9;12
15078;Saulutė;Ežiukai;1853984777;Taip;0;0;5;5
15079;Saulutė;Bitutės;1268204445;Taip;6;0;0;6
15080;Saulutė;Bitutės;4288298305;Taip;8;0;2;10
15081;Saulutė;Bitutės;9106119465;Ne;1;19;0;20
15082;Saulutė;Bitutės;3265401334;Taip;0;0;7;7
15083;Saulutė;Bitutės;9133269796;Taip;13;0;0;13
15084;Saulutė;Bitutės;5987478379;Taip;2;3;4;9
15085;Saulutė;Bitutės;5943795519;Taip;6;0;1;7
15086;Saulutė;Bitutės;8003855875;Taip;6;0;0;6
15087;Saulutė;Bitutės;2669711574;Taip;2;0;0;2
15088;Saulutė;Bitutės;7689842018;Taip;4;0;0;4
15089;Saulutė;Bitutės;5931269521;Taip;17;0;0;17
15090;Saulutė;Bitutės;4915192103;Taip;0;7;0;7
15091;Saulutė;Bitutės;4453610732;Taip;0;0;1;1
15092;Saulutė;Bitutės;4067009709;Taip;14;0;2;16
15093;Saulutė;Bitutės;2301903550;Taip;7;15;0;22
15094;Saulutė;Bitutės;6057938367;Taip;22;0;0;22
15095;Saulutė;Bitutės;4781756849;Taip;7;15;0;22
15096;Saulutė;Bitutės;4222649372;Ne;0;22;0;22
15097;Saulutė;Pelėdžiukai;8512137633;Taip;0;0;1;1
15098;Saulutė;Pelėdžiukai;4211866191;Taip;0;0;2;2
15099;Saulutė;Pelėdžiukai;2373409300;Taip;0;0;4;4
15100;Saulutė;Pelėdžiukai;1745754752;Taip;3;1;0;4
15101;Saulutė;Pelėdžiukai;4123500930;Ne;0;1;6;7
15102;Saulutė;Pelėdžiukai;1056158093;Taip;5;0;2;7
15103;Saulutė;Pelėdžiukai;8371366346;Taip;0;0;6;6
15104;Saulutė;Pelėdžiukai;6842585310;Taip;0;22;0;22
15105;Saulutė;Pelėdžiukai;1776164273;Taip;8;0;5;13
15106;Saulutė;Pelėdžiukai;5850783789;Taip;5;1;0;6
15107;Saulutė;Pelėdžiukai;6608003946;Taip;0;1;12;13
15108;Saulutė;Pelėdžiukai;7243072252;Taip;15;0;0;15
15109;Saulutė;Pelėdžiukai;9903380188;Taip;0;0;4;4
15110;Saulutė;Pelėdžiukai;2450554594;Taip;5;0;0;5
15111;Saulutė;Pelėdžiukai;7620841597;Taip;10;0;0;10
15112;Saulutė;Pelėdžiukai;7640441297;Taip;0;0;11;11
15113;Saulutė;Pelėdžiukai;6046611248;Taip;0;6;0;6
15114;Saulutė;Pelėdžiukai;4301516165;Taip;0;0;12;12
15115;Saulutė;Pelėdžiukai;7258180835;Ne;0;22;0;22
15116;Saulutė;Pelėdžiukai;2566263680;Ne;0;22;0;22
15117;Saulutė;Zylutės;1786491396;Taip;0;4;0;4
15118;Saulutė;Zylutės;16622528829;Taip;22;0;0;22
15119;Saulutė;Zylutės;1911318708;Taip;6;0;0;6
15120;Saulutė;Zylutės;1332002470;Taip;0;2;0;2
15121;Saulutė;Zylutės;9081236999;Taip;0;1;0;1
15122;Saulutė;Zylutės;67332285574;Taip;0;1;11;12
15123;Saulutė;Zylutės;1513449225;Taip;0;1;2;3
15124;Saulutė;Zylutės;28772515317;Taip;0;1;3;4
15125;Saulutė;Zylutės;3228226715;Taip;22;0;0;22
15126;Saulutė;Zylutės;8040751073;Taip;0;0;5;5
15127;Saulutė;Zylutės;2074473832;Taip;0;7;0;7
15128;Saulutė;Zylutės;8041118115;Taip;8;11;0;19
15129;Saulutė;Zylutės;5198558993;Taip;22;0;0;22
15130;Saulutė;Zylutės;6109527712;Ne;0;1;1;2
15131;Saulutė;Zylutės;4686825392;Taip;2;0;0;2
15132;Saulutė;Zylutės;7281873166;Taip;5;7;0;12
15133;Saulutė;Zylutės;7446423510;Taip;0;0;6;6
15134;Saulutė;Zylutės;7839168221;Taip;9;0;1;10
15135;Saulutė;Zylutės;8717210130;Taip;7;0;2;9
15136;Saulutė;Zylutės;7318452189;Taip;0;7;0;7
15137;Saulutė;Zylutės;1579654900;Taip;1;0;1;2
15138;Saulutė;"1 klasė";45306237230;Taip;4;10;0;14
15139;Saulutė;"1 klasė";79919438191;Ne;1;10;0;11
15140;Saulutė;"1 klasė";31705050946;Taip;9;10;0;19
15141;Saulutė;"1 klasė";2622662153;Taip;9;10;0;19
15142;Saulutė;"1 klasė";37315117916;Taip;1;10;0;11
15143;Saulutė;"1 klasė";46280382280;Taip;1;10;0;11
15144;Saulutė;"1 klasė";9612975694;Taip;10;10;0;20
15145;Saulutė;"1 klasė";3445723020;Ne;4;10;0;14
15146;Saulutė;"1 klasė";14195215027;Taip;4;10;0;14
15147;Saulutė;"1 klasė";2098990667;Taip;2;10;0;12
15148;Saulutė;"1 klasė";27386434894;Taip;3;10;0;13
15149;Saulutė;"1 klasė";77923802656;Taip;4;10;0;14
15150;Saulutė;"1 klasė";1935503629;Taip;1;10;0;11
15151;Saulutė;"1 klasė";75405796772;Taip;4;10;0;14
15152;Saulutė;"1 klasė";1277263391;Taip;1;10;0;11
15153;Saulutė;"1 klasė";97145959022;Taip;22;10;0;32
15154;Saulutė;"1 klasė";77170708225;Taip;1;10;0;11
15155;Saulutė;"1 klasė";65492344097;Taip;3;10;0;13
15156;Saulutė;"1 klasė";1534183935;Taip;6;10;0;16
15157;Saulutė;"1 klasė";5574049005;Taip;6;10;0;16
15158;Saulutė;"1 klasė";1510434265;Taip;4;10;0;14
15159;Saulutė;"1 klasė";79438946697;Taip;3;10;0;13
15160;Saulutė;"1 klasė";29074930927;Taip;6;10;0;16
15161;Saulutė;"1 klasė";21605684303;Taip;9;10;0;19
15162;Saulutė;"1 klasė";64418469679;Taip;1;10;0;11
15163;Saulutė;"1 klasė";1704733670;Ne;0;10;0;10
15164;Saulutė;"1 klasė";8369703027;Taip;2;10;0;12
15165;Saulutė;"1 klasė";4640909915;Ne;4;10;0;14
15166;Saulutė;"2 klasė";1005459768;Taip;3;10;0;13
15167;Saulutė;"2 klasė";1804521229;Taip;4;10;0;14
15168;Saulutė;"2 klasė";76108591835;Taip;4;10;0;14
15169;Saulutė;"2 klasė";1475031090;Taip;1;10;0;11
15170;Saulutė;"2 klasė";3156830821;Taip;1;10;0;11
15171;Saulutė;"2 klasė";5741276602;Taip;1;10;0;11
15172;Saulutė;"2 klasė";3246485288;Taip;1;10;0;11
15173;Saulutė;"2 klasė";44452051978;Ne;1;10;0;11
15174;Saulutė;"2 klasė";78967475616;Ne;8;10;0;18
15175;Saulutė;"2 klasė";89710141573;Taip;1;10;0;11
15176;Saulutė;"2 klasė";25124975646;Taip;2;10;0;12
15177;Saulutė;"2 klasė";3450668814;Taip;2;10;0;12
15178;Saulutė;"2 klasė";8168961080;Ne;4;10;0;14
15179;Saulutė;"2 klasė";57283533169;Taip;1;10;0;11
15180;Saulutė;"2 klasė";76744652185;Taip;3;10;0;13
15181;Saulutė;"2 klasė";97296161595;Taip;6;10;0;16
15182;Saulutė;"2 klasė";87409240076;Taip;6;10;0;16
15183;Saulutė;"2 klasė";1205642335;Taip;2;10;0;12
15184;Saulutė;"2 klasė";2426509692;Taip;2;10;0;12
15185;Saulutė;"2 klasė";36414547943;Taip;11;10;0;21
15186;Saulutė;"2 klasė";99841176399;Taip;8;10;0;18
15187;Saulutė;"2 klasė";21703177024;Taip;5;10;0;15
15188;Saulutė;"2 klasė";1337654926;Taip;13;10;0;23
15189;Saulutė;"2 klasė";54950572289;Taip;1;10;0;11
15190;Saulutė;"2 klasė";13147367113;Taip;1;10;0;11
15191;Saulutė;"2 klasė";2216383015;Taip;1;10;0;11
15192;Saulutė;"2 klasė";1644704074;Taip;4;10;0;14
15193;Saulutė;"2 klasė";96497471950;Taip;4;10;0;14
15194;Saulutė;"2 klasė";6557918941;Taip;4;10;0;14
15195;Saulutė;"3 klasė";58163470119;Taip;2;10;0;12
15196;Saulutė;"3 klasė";5822529731;Taip;1;10;0;11
15197;Saulutė;"3 klasė";67739063665;Ne;5;10;0;15
15198;Saulutė;"3 klasė";13916981850;Taip;3;10;0;13
15199;Saulutė;"3 klasė";39606108938;Ne;2;10;0;12
15200;Saulutė;"3 klasė";81191097069;Taip;2;10;0;12
15201;Saulutė;"3 klasė";92198716772;Taip;3;10;0;13
15202;Saulutė;"3 klasė";16523279366;Taip;7;10;0;17
15203;Saulutė;"3 klasė";2095347468;Taip;3;10;0;13
15204;Saulutė;"3 klasė";37839378248;Taip;1;10;0;11
15205;Saulutė;"3 klasė";8308288099;Ne;1;10;0;11
15206;Saulutė;"3 klasė";30863736694;Taip;4;10;0;14
15207;Saulutė;"3 klasė";12964000357;Taip;2;10;0;12
15208;Saulutė;"3 klasė";54726632101;Taip;5;10;0;15
15209;Saulutė;"3 klasė";25720655179;Taip;2;10;0;12
15210;Saulutė;"3 klasė";45877127245;Taip;3;10;0;13
15211;Saulutė;"3 klasė";82106514982;Taip;4;10;0;14
15212;Saulutė;"3 klasė";61113930769;Taip;1;10;0;11
15213;Saulutė;"3 klasė";7785909571;Ne;8;10;0;18
15214;Saulutė;"3 klasė";90078805222;Taip;2;10;0;12
15215;Saulutė;"3 klasė";50110262859;Taip;2;10;0;12
15216;Saulutė;"3 klasė";42204884890;Ne;2;10;0;12
15217;Saulutė;"3 klasė";5213320470;Ne;4;10;0;14
15218;Saulutė;"3 klasė";2262536579;Taip;2;10;0;12
15219;Saulutė;"3 klasė";2819521168;Taip;1;10;0;11
15220;Saulutė;"4 klasė";4252242862;Taip;0;10;0;10
15221;Saulutė;"4 klasė";2517511237;Ne;3;0;0;3
15222;Saulutė;"4 klasė";8953313952;Ne;22;0;0;22
15223;Saulutė;"4 klasė";1436690766;Taip;0;10;0;10
15224;Saulutė;"4 klasė";4342595483;Taip;8;10;0;18
15225;Saulutė;"4 klasė";5786453424;Taip;0;10;0;10
15226;Saulutė;"4 klasė";1153099638;Taip;7;10;0;17
15227;Saulutė;"4 klasė";8531372660;Taip;0;10;0;10
15228;Saulutė;"4 klasė";3614749034;Taip;22;10;0;32
15229;Saulutė;"4 klasė";8192525690;Taip;1;10;0;11
15230;Saulutė;"4 klasė";7696948081;Taip;1;10;0;11
15231;Saulutė;"4 klasė";2957436888;Taip;3;10;0;13
15232;Saulutė;"4 klasė";3937034221;Taip;2;10;0;12
15233;Saulutė;"4 klasė";1312993030;Taip;1;10;0;11
15234;Saulutė;"4 klasė";3450860412;Taip;2;10;0;12
15235;Saulutė;"4 klasė";7543978588;Taip;4;10;0;14
15236;Saulutė;"4 klasė";6924270821;Taip;0;10;0;10
15237;Saulutė;"4 klasė";1701868565;Taip;3;10;0;13
15238;Saulutė;"4 klasė";3755300838;Taip;0;10;0;10
15239;Saulutė;"4 klasė";1117229507;Taip;0;10;0;10
15240;Saulutė;"4 klasė";6025668467;Taip;0;10;0;10
15241;Saulutė;"4 klasė";5898983204;Ne;1;10;0;11
15242;Svaja;SAULĖGRĄŽA;4189290919;Taip;0;22;0;22
15243;Svaja;SAULĖGRĄŽA;4333001830;Taip;0;0;8;8
15244;Svaja;SAULĖGRĄŽA;1579441289;Taip;0;9;0;9
15245;Svaja;SAULĖGRĄŽA;9811110367;Taip;0;9;0;9
15246;Svaja;SAULĖGRĄŽA;9311520300;Taip;0;0;2;2
15247;Svaja;SAULĖGRĄŽA;3912426942;Taip;0;0;2;2
15248;Svaja;SAULĖGRĄŽA;9680766688;Taip;7;0;4;11
15249;Svaja;SAULĖGRĄŽA;3809817617;Taip;0;0;2;2
15250;Svaja;SAULĖGRĄŽA;3792660330;Taip;9;0;0;9
15251;Svaja;SAULĖGRĄŽA;2209697834;Taip;19;0;0;19
15252;Svaja;SAULĖGRĄŽA;3563842321;Taip;0;0;1;1
15253;Svaja;SAULĖGRĄŽA;4253831334;Taip;0;7;8;15
15254;Svaja;SAULĖGRĄŽA;3461282516;Taip;0;0;4;4
15255;Svaja;SAULĖGRĄŽA;9240037050;Taip;4;0;2;6
15256;Svaja;SAULĖGRĄŽA;7089640807;Taip;14;0;0;14
15257;Svaja;SAULĖGRĄŽA;4510147045;Taip;4;7;0;11
15258;Svaja;SAULĖGRĄŽA;7023534254;Taip;0;0;4;4
15259;Svaja;SAULĖGRĄŽA;6928763381;Taip;0;0;11;11
15260;Svaja;SAULĖGRĄŽA;3501620040;Taip;0;0;3;3
15261;Svaja;SAULĖGRĄŽA;7575922215;Taip;0;0;3;3
15262;Svaja;SAULĖGRĄŽA;7408966637;Taip;7;0;0;7
15263;Svaja;"STEBUKLINGAS ŽIBINTAS";9814969596;Taip;0;4;0;4
15264;Svaja;"STEBUKLINGAS ŽIBINTAS";2200408537;Taip;1;0;1;2
15265;Svaja;"STEBUKLINGAS ŽIBINTAS";9086270220;Taip;0;0;1;1
15266;Svaja;"STEBUKLINGAS ŽIBINTAS";3940123543;Taip;7;0;0;7
15267;Svaja;"STEBUKLINGAS ŽIBINTAS";8353427144;Taip;5;0;2;7
15268;Svaja;"STEBUKLINGAS ŽIBINTAS";9843726794;Taip;0;0;1;1
15269;Svaja;"STEBUKLINGAS ŽIBINTAS";4237592104;Ne;4;4;2;10
15270;Svaja;"STEBUKLINGAS ŽIBINTAS";2658828200;Taip;0;4;0;4
15271;Svaja;"STEBUKLINGAS ŽIBINTAS";4290716676;Taip;9;0;0;9
15272;Svaja;"STEBUKLINGAS ŽIBINTAS";9102872020;Taip;0;0;1;1
15273;Svaja;"STEBUKLINGAS ŽIBINTAS";4394417103;Taip;0;1;0;1
15274;Svaja;"STEBUKLINGAS ŽIBINTAS";8827421660;Taip;17;0;0;17
15275;Svaja;"STEBUKLINGAS ŽIBINTAS";7277217069;Taip;14;0;0;14
15276;Svaja;"STEBUKLINGAS ŽIBINTAS";9259478140;Taip;0;0;2;2
15277;Svaja;"STEBUKLINGAS ŽIBINTAS";1050291871;Taip;20;0;0;20
15278;Svaja;"STEBUKLINGAS ŽIBINTAS";2188430052;Taip;15;0;2;17
15279;Svaja;"STEBUKLINGAS ŽIBINTAS";1860076171;Taip;7;0;4;11
15280;Svaja;"STEBUKLINGAS ŽIBINTAS";8363418532;Taip;0;0;15;15
15281;Svaja;"STEBUKLINGAS ŽIBINTAS";8172396846;Taip;7;5;0;12
15282;Svaja;"STEBUKLINGAS ŽIBINTAS";9545690301;Taip;6;0;1;7
15283;Svaja;"STEBUKLINGAS ŽIBINTAS";4004383843;Taip;0;4;0;4
15284;Svaja;"STEBUKLINGAS ŽIBINTAS";1150040935;Taip;12;0;0;12
15285;Svaja;SAULUTĖ;50207734108;Ne;5;0;0;5
15286;Svaja;SAULUTĖ;20473739993;Taip;22;0;0;22
15287;Svaja;SAULUTĖ;30719991872;Taip;19;0;0;19
15288;Svaja;SAULUTĖ;6665752307;Taip;1;0;3;4
15289;Svaja;SAULUTĖ;4968201186;Taip;0;5;0;5
15290;Svaja;SAULUTĖ;8689706130;Taip;0;1;0;1
15291;Svaja;SAULUTĖ;3633996231;Taip;0;0;2;2
15292;Svaja;SAULUTĖ;2750615517;Taip;19;0;0;19
15293;Svaja;SAULUTĖ;3049808328;Taip;0;0;2;2
15294;Svaja;SAULUTĖ;1045300185;Taip;0;0;2;2
15295;Svaja;SAULUTĖ;3802996573;Taip;7;0;1;8
15296;Svaja;SAULUTĖ;7936765752;Taip;5;0;0;5
15297;Svaja;SAULUTĖ;4293339784;Taip;4;0;1;5
15298;Svaja;SAULUTĖ;9475971731;Taip;3;0;2;5
15299;Svaja;SAULUTĖ;5479482244;Ne;7;0;1;8
15300;Svaja;SAULUTĖ;7473493846;Taip;10;0;3;13
15301;Svaja;SAULUTĖ;5443682744;Taip;0;6;0;6
15302;Svaja;SAULUTĖ;9112198914;Taip;0;0;1;1
15303;Svaja;SAULUTĖ;2166382346;Taip;0;0;2;2
15304;Svaja;"AUKSINĖ ŽUVELĖ";43307670660;Taip;0;5;0;5
15305;Svaja;"AUKSINĖ ŽUVELĖ";25194696146;Taip;2;0;0;2
15306;Svaja;"AUKSINĖ ŽUVELĖ";55925058866;Taip;0;2;0;2
15307;Svaja;"AUKSINĖ ŽUVELĖ";1704075006;Taip;0;4;0;4
15308;Svaja;"AUKSINĖ ŽUVELĖ";70641067006;Taip;0;3;0;3
15309;Svaja;"AUKSINĖ ŽUVELĖ";8875237023;Taip;0;4;0;4
15310;Svaja;"AUKSINĖ ŽUVELĖ";8279605005;Taip;0;0;2;2
15311;Svaja;"AUKSINĖ ŽUVELĖ";1437557657;Taip;22;0;0;22
15312;Svaja;"AUKSINĖ ŽUVELĖ";36505115395;Taip;0;0;1;1
15313;Svaja;"AUKSINĖ ŽUVELĖ";6593047776;Taip;6;0;0;6
15314;Svaja;"AUKSINĖ ŽUVELĖ";7911488445;Taip;3;0;0;3
15315;Svaja;"AUKSINĖ ŽUVELĖ";64196174690;Taip;17;0;0;17
15316;Svaja;"AUKSINĖ ŽUVELĖ";22702341083;Taip;0;10;0;10
15317;Svaja;"AUKSINĖ ŽUVELĖ";2076060840;Taip;4;0;0;4
15318;Svaja;"AUKSINĖ ŽUVELĖ";27445299450;Taip;0;0;1;1
15319;Svaja;"AUKSINĖ ŽUVELĖ";21871530266;Taip;16;0;0;16
15320;Svaja;"AUKSINĖ ŽUVELĖ";8491275729;Ne;0;0;1;1
15321;Svaja;"AUKSINĖ ŽUVELĖ";7753488216;Taip;0;5;0;5
15322;Svaja;"AUKSINĖ ŽUVELĖ";7669562010;Taip;5;8;0;13
15323;Svaja;"PRIE ĮLANKOS";2985196852;Taip;0;0;3;3
15324;Svaja;"PRIE ĮLANKOS";1046879533;Taip;2;0;6;8
15325;Svaja;"PRIE ĮLANKOS";1714711904;Taip;7;0;0;7
15326;Svaja;"PRIE ĮLANKOS";49787034798;Taip;0;0;2;2
15327;Svaja;"PRIE ĮLANKOS";9110985103;Taip;0;0;1;1
15328;Svaja;"PRIE ĮLANKOS";65917456866;Taip;0;1;0;1
15329;Svaja;"PRIE ĮLANKOS";47457128214;Taip;10;1;0;11
15330;Svaja;"PRIE ĮLANKOS";3562817807;Taip;3;0;5;8
15331;Svaja;"PRIE ĮLANKOS";2069150261;Taip;6;0;0;6
15332;Svaja;"PRIE ĮLANKOS";5337604370;Taip;10;0;1;11
15333;Svaja;"PRIE ĮLANKOS";1191494598;Taip;0;0;4;4
15334;Svaja;"PRIE ĮLANKOS";15159708127;Taip;0;0;3;3
15335;Svaja;"PRIE ĮLANKOS";5595087767;Taip;0;0;1;1
15336;Svaja;"PRIE ĮLANKOS";8503177793;Taip;5;0;1;6
15337;Svaja;"PRIE ĮLANKOS";1633236289;Taip;0;16;0;16
15338;Svaja;"PRIE ĮLANKOS";9414846817;Taip;16;0;1;17
15339;Svaja;"PRIE ĮLANKOS";56117509354;Taip;0;0;7;7
15340;Svaja;"PRIE ĮLANKOS";30360097999;Taip;0;4;0;4
15341;Svaja;"1 B klasė";1509272327;Taip;0;6;0;6
15342;Svaja;"1 B klasė";1601648171;Taip;0;1;0;1
15343;Svaja;"1 B klasė";40814723278;Taip;0;3;0;3
15344;Svaja;"1 B klasė";4881476441;Taip;0;1;0;1
15345;Svaja;"1 B klasė";4804779327;Taip;0;22;0;22
15346;Svaja;"1 B klasė";69413101571;Taip;0;1;0;1
15347;Svaja;"1 B klasė";1655551042;Taip;0;4;0;4
15348;Svaja;"1 B klasė";21608020858;Taip;0;1;0;1
15349;Svaja;"1 B klasė";7719185632;Taip;0;3;0;3
15350;Svaja;"1 B klasė";69028070656;Taip;0;1;0;1
15351;Svaja;"1 B klasė";1967394949;Taip;0;5;0;5
15352;Svaja;"1 B klasė";19887874988;Ne;0;3;0;3
15353;Svaja;"1 B klasė";57216954289;Taip;0;1;0;1
15354;Svaja;"1 B klasė";3499148291;Taip;0;2;0;2
15355;Svaja;"1 B klasė";3077814152;Taip;0;1;0;1
15356;Svaja;"1 B klasė";44989143252;Taip;0;3;0;3
15357;Svaja;"1 B klasė";6056157113;Taip;0;3;0;3
15358;Svaja;"1 B klasė";87432529423;Taip;0;4;0;4
15359;Svaja;"1 B klasė";54745410330;Taip;0;1;0;1
15360;Svaja;"1 B klasė";30036722764;Taip;0;1;0;1
15361;Svaja;"1 B klasė";89316574266;Taip;0;2;0;2
15362;Svaja;"1 B klasė";78293798850;Taip;0;1;0;1
15363;Svaja;"1 B klasė";809734624;Taip;0;1;0;1
15364;Svaja;"1 B klasė";76618850202;Taip;0;1;0;1
15365;Svaja;"1 A klasė";26500981786;Taip;0;1;0;1
15366;Svaja;"1 A klasė";5522433229;Taip;0;1;0;1
15367;Svaja;"1 A klasė";1400892707;Taip;0;22;0;22
15368;Svaja;"1 A klasė";23112873505;Taip;0;7;0;7
15369;Svaja;"1 A klasė";15246943974;Taip;0;2;0;2
15370;Svaja;"1 A klasė";67462299886;Taip;0;2;0;2
15371;Svaja;"1 A klasė";40856210635;Taip;0;1;0;1
15372;Svaja;"1 A klasė";18733824395;Taip;0;2;0;2
15373;Svaja;"1 A klasė";3022690832;Taip;0;3;0;3
15374;Svaja;"1 A klasė";9628146488;Ne;0;1;0;1
15375;Svaja;"1 A klasė";1562041360;Taip;0;22;0;22
15376;Svaja;"1 A klasė";43223177664;Taip;0;1;0;1
15377;Svaja;"1 A klasė";1017471747;Taip;0;1;0;1
15378;Svaja;"1 A klasė";1943166503;Taip;0;5;0;5
15379;Svaja;"1 A klasė";30027404222;Taip;0;2;0;2
15380;Svaja;"1 A klasė";1297727288;Taip;0;1;0;1
15381;Svaja;"1 A klasė";1304775332;Taip;0;11;0;11
15382;Svaja;"1 A klasė";9847061480;Taip;0;7;0;7
15383;Svaja;"1 A klasė";1352488176;Taip;0;1;0;1
15384;Svaja;"1 A klasė";1660742385;Taip;0;2;0;2
15385;Svaja;"1 A klasė";26902749194;Taip;0;2;0;2
15386;Svaja;"1 A klasė";8198614500;Taip;0;2;0;2
15387;Svaja;"1 A klasė";2058827699;Taip;0;4;0;4
15388;Svaja;"1 A klasė";84508228457;Taip;0;2;0;2
15389;Svaja;"1 A klasė";89042677798;Taip;0;2;0;2
15390;Svaja;"1 A klasė";1048576329;Taip;0;6;0;6
15391;Svaja;"2 A klasė";60448774566;Taip;0;1;0;1
15392;Svaja;"2 A klasė";72752022712;Taip;0;5;0;5
15393;Svaja;"2 A klasė";8828911320;Taip;0;6;0;6
15394;Svaja;"2 A klasė";36386223863;Taip;0;5;0;5
15395;Svaja;"2 A klasė";75104768118;Taip;0;2;0;2
15396;Svaja;"2 A klasė";1649920341;Taip;0;2;0;2
15397;Svaja;"2 A klasė";30754812113;Taip;0;2;0;2
15398;Svaja;"2 A klasė";64487515384;Taip;0;4;0;4
15399;Svaja;"2 A klasė";34216516886;Taip;0;1;0;1
15400;Svaja;"2 A klasė";3474439050;Taip;0;6;0;6
15401;Svaja;"2 A klasė";63346231562;Taip;0;22;0;22
15402;Svaja;"2 A klasė";75296600945;Taip;0;4;0;4
15403;Svaja;"2 A klasė";6057524892;Taip;0;2;0;2
15404;Svaja;"2 A klasė";2321739150;Ne;0;5;0;5
15405;Svaja;"2 A klasė";4617061890;Taip;0;4;0;4
15406;Svaja;"2 A klasė";1181877436;Taip;0;2;0;2
15407;Svaja;"2 A klasė";89695643588;Taip;0;7;0;7
15408;Svaja;"2 A klasė";3604946305;Taip;0;4;0;4
15409;Svaja;"2 A klasė";25578518444;Taip;0;8;0;8
15410;Svaja;"2 A klasė";1168637823;Taip;0;6;0;6
15411;Svaja;"2 A klasė";4906784415;Taip;0;5;0;5
15412;Svaja;"2 A klasė";15252353189;Taip;0;2;0;2
15413;Svaja;"2 A klasė";7348182434;Taip;0;4;0;4
15414;Svaja;"2 B klasė";6905550313;Ne;0;3;0;3
15415;Svaja;"2 B klasė";62971657427;Taip;0;4;0;4
15416;Svaja;"2 B klasė";1367687415;Taip;0;3;0;3
15417;Svaja;"2 B klasė";4416877973;Taip;0;7;0;7
15418;Svaja;"2 B klasė";1847775266;Taip;0;4;0;4
15419;Svaja;"2 B klasė";17947580061;Taip;0;3;0;3
15420;Svaja;"2 B klasė";6969692916;Taip;0;3;0;3
15421;Svaja;"2 B klasė";44418402260;Taip;0;3;0;3
15422;Svaja;"2 B klasė";50649509868;Taip;0;3;0;3
15423;Svaja;"2 B klasė";73391331150;Taip;0;3;0;3
15424;Svaja;"2 B klasė";70507326327;Taip;0;22;0;22
15425;Svaja;"2 B klasė";80772711351;Taip;0;4;0;4
15426;Svaja;"2 B klasė";54328462992;Taip;0;6;0;6
15427;Svaja;"2 B klasė";1470843400;Taip;0;3;0;3
15428;Svaja;"2 B klasė";92044111261;Taip;0;4;0;4
15429;Svaja;"2 B klasė";11937575740;Taip;0;4;0;4
15430;Svaja;"2 B klasė";6020060540;Taip;0;8;0;8
15431;Svaja;"2 B klasė";8011137572;Taip;0;4;0;4
15432;Svaja;"2 B klasė";71708072632;Taip;0;5;0;5
15433;Svaja;"2 B klasė";56506642672;Taip;0;5;0;5
15434;Svaja;"2 B klasė";3526873547;Taip;0;4;0;4
15435;Svaja;"2 B klasė";70506691027;Taip;0;4;0;4
15436;Svaja;"3 A klasė";96680395594;Taip;0;22;0;22
15437;Svaja;"3 A klasė";31604152893;Taip;0;2;0;2
15438;Svaja;"3 A klasė";70513111186;Ne;0;2;0;2
15439;Svaja;"3 A klasė";72655912805;Taip;0;2;0;2
15440;Svaja;"3 A klasė";20363553383;Taip;0;22;0;22
15441;Svaja;"3 A klasė";8876971658;Taip;0;22;0;22
15442;Svaja;"3 A klasė";69928474471;Taip;0;22;0;22
15443;Svaja;"3 A klasė";49184638535;Taip;0;22;0;22
15444;Svaja;"3 A klasė";58497063533;Taip;0;22;0;22
15445;Svaja;"3 A klasė";89075087937;Taip;0;22;0;22
15446;Svaja;"3 A klasė";99157757025;Ne;0;9;0;9
15447;Svaja;"3 A klasė";16955510836;Taip;0;5;0;5
15448;Svaja;"3 A klasė";24812635291;Taip;0;4;0;4
15449;Svaja;"3 A klasė";21534170175;Taip;0;6;0;6
15450;Svaja;"3 A klasė";28311552445;Taip;0;22;0;22
15451;Svaja;"3 A klasė";38781141060;Taip;0;4;0;4
15452;Svaja;"3 A klasė";88447528808;Taip;0;4;0;4
15453;Svaja;"3 A klasė";66507774550;Taip;0;9;0;9
15454;Svaja;"3 A klasė";76101749947;Taip;0;22;0;22
15455;Svaja;"3 A klasė";3775578708;Taip;0;22;0;22
15456;Svaja;"3 B klasė";61996055386;Taip;0;1;0;1
15457;Svaja;"3 B klasė";57983452414;Taip;0;22;0;22
15458;Svaja;"3 B klasė";30200636424;Ne;0;5;0;5
15459;Svaja;"3 B klasė";8802243719;Taip;0;5;0;5
15460;Svaja;"3 B klasė";7747921362;Taip;0;3;0;3
15461;Svaja;"3 B klasė";38464012322;Taip;0;2;0;2
15462;Svaja;"3 B klasė";5712106350;Taip;0;3;0;3
15463;Svaja;"3 B klasė";9401605132;Taip;0;5;0;5
15464;Svaja;"3 B klasė";27313057222;Ne;0;22;0;22
15465;Svaja;"3 B klasė";68894832324;Taip;0;4;0;4
15466;Svaja;"3 B klasė";29972474690;Taip;0;22;0;22
15467;Svaja;"3 B klasė";47441661801;Ne;0;3;0;3
15468;Svaja;"3 B klasė";62579722313;Taip;0;5;0;5
15469;Svaja;"3 B klasė";21035820496;Taip;0;3;0;3
15470;Svaja;"3 B klasė";71840791098;Taip;0;8;0;8
15471;Svaja;"3 B klasė";59707838958;Taip;0;6;0;6
15472;Svaja;"3 B klasė";71086654007;Taip;0;8;0;8
15473;Svaja;"3 B klasė";15871540340;Taip;0;22;0;22
15474;Svaja;"3 B klasė";97651620085;Taip;0;3;0;3
15475;Svaja;"3 B klasė";77796846388;Taip;0;22;0;22
15476;Svaja;"4 A klasė";6331528628;Taip;0;1;0;1
15477;Svaja;"4 A klasė";3812365439;Taip;0;22;0;22
15478;Svaja;"4 A klasė";4732976577;Ne;0;2;0;2
15479;Svaja;"4 A klasė";4819506647;Taip;0;22;0;22
15480;Svaja;"4 A klasė";7374204735;Taip;0;22;0;22
15481;Svaja;"4 A klasė";4147975771;Taip;0;1;0;1
15482;Svaja;"4 A klasė";8907191675;Taip;0;22;0;22
15483;Svaja;"4 A klasė";6301200166;Taip;0;1;0;1
15484;Svaja;"4 A klasė";7406969545;Taip;0;1;0;1
15485;Svaja;"4 A klasė";6182584108;Taip;0;4;0;4
15486;Svaja;"4 A klasė";6561055995;Taip;0;1;0;1
15487;Svaja;"4 A klasė";7745440861;Taip;0;1;0;1
15488;Svaja;"4 A klasė";3100769948;Taip;0;1;0;1
15489;Svaja;"4 A klasė";1932041952;Taip;0;1;0;1
15490;Svaja;"4 A klasė";2963665708;Taip;0;2;0;2
15491;Svaja;"4 A klasė";6166818062;Taip;0;22;0;22
15492;Svaja;"4 A klasė";4677183471;Taip;0;1;0;1
15493;Svaja;"4 A klasė";3876795349;Taip;0;1;0;1
15494;Svaja;"4 A klasė";4570702330;Taip;0;1;0;1
15495;Svaja;"4 A klasė";4559408388;Taip;0;1;0;1
15496;Svaja;"4 A klasė";1851430613;Taip;0;4;0;4
15497;Svaja;"4 A klasė";18914413731;Taip;0;22;0;22
15498;Svaja;"4 B klasė";6685023540;Taip;0;1;0;1
15499;Svaja;"4 B klasė";3917545035;Taip;0;22;0;22
15500;Svaja;"4 B klasė";3154268090;Taip;0;1;0;1
15501;Svaja;"4 B klasė";7137011094;Taip;0;1;0;1
15502;Svaja;"4 B klasė";8497722175;Taip;0;1;0;1
15503;Svaja;"4 B klasė";1949789571;Taip;0;1;0;1
15504;Svaja;"4 B klasė";986820082;Taip;0;5;0;5
15505;Svaja;"4 B klasė";5316972581;Taip;0;22;0;22
15506;Svaja;"4 B klasė";5304302886;Taip;0;22;0;22
15507;Svaja;"4 B klasė";9390649669;Ne;0;22;0;22
15508;Svaja;"4 B klasė";2543801351;Taip;0;1;0;1
15509;Svaja;"4 B klasė";2768998567;Taip;0;2;0;2
15510;Svaja;"4 B klasė";5417233257;Taip;0;5;0;5
15511;Svaja;"4 B klasė";8934053695;Ne;0;22;0;22
15512;Svaja;"4 B klasė";6888324693;Taip;0;1;0;1
15513;Svaja;"4 B klasė";9741563523;Taip;0;22;0;22
15514;Svaja;"4 B klasė";9474581791;Taip;0;22;0;22
15515;Svaja;"4 B klasė";7185891478;Ne;0;22;0;22
15516;Svaja;"4 B klasė";6949932613;Taip;0;22;0;22
15517;Svaja;"4 B klasė";9227257148;Taip;0;1;0;1
15518;Svaja;"4 B klasė";7403841330;Taip;0;22;0;22
15519;Svaja;"4 B klasė";6387070757;Taip;0;22;0;22
15520;Svaja;"4 B klasė";4859522896;Taip;0;2;0;2
15521;Svaja;"4 B klasė";7165840275;Taip;0;1;0;1
15522;Svaja;"4 B klasė";4858401763;Taip;0;3;0;3
15523;Svaja;"4 C klasė";4022762780;Taip;0;22;0;22
15524;Svaja;"4 C klasė";5749575112;Taip;0;2;0;2
15525;Svaja;"4 C klasė";8150945946;Taip;0;22;0;22
15526;Svaja;"4 C klasė";1915009909;Taip;0;22;0;22
15527;Svaja;"4 C klasė";4310597965;Taip;0;2;0;2
15528;Svaja;"4 C klasė";8274918664;Taip;0;2;0;2
15529;Svaja;"4 C klasė";4333896021;Taip;0;2;0;2
15530;Svaja;"4 C klasė";5467666579;Ne;0;2;0;2
15531;Svaja;"4 C klasė";5453168902;Taip;0;2;0;2
15532;Svaja;"4 C klasė";1750972673;Taip;0;2;0;2
15533;Svaja;"4 C klasė";5633989310;Taip;0;2;0;2
15534;Svaja;"4 C klasė";4807854408;Taip;0;22;0;22
15535;Svaja;"4 C klasė";9653780566;Taip;0;2;0;2
15536;Svaja;"4 C klasė";8556383911;Taip;0;2;0;2
15537;Svaja;"4 C klasė";5736016717;Taip;0;22;0;22
15538;Svaja;"4 C klasė";6956015602;Taip;0;22;0;22
15539;Svaja;"4 C klasė";6958729265;Taip;0;22;0;22
15540;Svaja;"4 C klasė";4196053724;Taip;0;2;0;2
15541;Svaja;"4 C klasė";3466700144;Taip;0;2;0;2
15542;Svaja;"4 C klasė";9961965117;Taip;0;22;0;22
15543;Svaja;"4 C klasė";4809644609;Taip;0;22;0;22
15544;Svaja;"4 C klasė";1910435736;Taip;0;2;0;2
15545;Svaja;"4 C klasė";5205253544;Taip;0;4;0;4
15546;Svaja;"2 C klasė";1848422504;Taip;0;4;0;4
15547;Svaja;"2 C klasė";3743948734;Taip;0;5;0;5
15548;Svaja;"2 C klasė";25934507261;Taip;0;3;0;3
15549;Svaja;"2 C klasė";89047123808;Taip;0;22;0;22
15550;Svaja;"2 C klasė";74904581010;Taip;0;22;0;22
15551;Svaja;"2 C klasė";50510924690;Taip;0;3;0;3
15552;Svaja;"2 C klasė";41183537732;Taip;0;5;0;5
15553;Svaja;"2 C klasė";70714898590;Taip;0;3;0;3
15554;Svaja;"2 C klasė";54852358913;Taip;0;22;0;22
15555;Svaja;"2 C klasė";57253216255;Taip;0;8;0;8
15556;Svaja;"2 C klasė";34995551069;Taip;0;3;0;3
15557;Svaja;"2 C klasė";1795682827;Taip;0;3;0;3
15558;Svaja;"2 C klasė";93651139102;Taip;0;3;0;3
15559;Svaja;"2 C klasė";1742951527;Taip;0;3;0;3
15560;Svaja;"2 C klasė";91855230473;Taip;0;5;0;5
15561;Svaja;"2 C klasė";1855559693;Taip;0;22;0;22
15562;Svaja;"2 C klasė";2165716699;Taip;0;22;0;22
15563;Svaja;"2 C klasė";31216445971;Ne;0;5;0;5
15564;Svaja;"2 C klasė";20342193231;Taip;0;3;0;3
15565;Svaja;"2 C klasė";54462393937;Taip;0;22;0;22
15566;Svaja;"2 C klasė";36001411632;Taip;0;3;0;3
15567;Svaja;"2 C klasė";94449039022;Taip;0;13;0;13
15568;Svaja;"2 C klasė";85150525696;Taip;0;3;0;3
15569;Svaja;"2 C klasė";91088224294;Taip;0;22;0;22
15570;Svaja;"3 C klasė";79260508923;Taip;0;2;0;2
15571;Svaja;"3 C klasė";94437606762;Taip;0;22;0;22
15572;Svaja;"3 C klasė";73440582394;Taip;0;2;0;2
15573;Svaja;"3 C klasė";60982723867;Taip;0;22;0;22
15574;Svaja;"3 C klasė";70157518595;Taip;0;22;0;22
15575;Svaja;"3 C klasė";5975083034;Taip;0;22;0;22
15576;Svaja;"3 C klasė";76871144487;Taip;0;22;0;22
15577;Svaja;"3 C klasė";6613028133;Taip;0;4;0;4
15578;Svaja;"3 C klasė";48888360976;Taip;0;5;0;5
15579;Svaja;"3 C klasė";12226488343;Taip;0;5;0;5
15580;Svaja;"3 C klasė";3909240894;Taip;0;2;0;2
15581;Svaja;"3 C klasė";53352329988;Taip;0;5;0;5
15582;Svaja;"3 C klasė";59917024948;Taip;0;3;0;3
15583;Svaja;"3 C klasė";73691352138;Ne;0;3;0;3
15584;Svaja;"3 C klasė";66967032561;Taip;0;8;0;8
15585;Svaja;"3 C klasė";77712240909;Taip;0;2;0;2
15586;Svaja;"3 C klasė";82358174131;Taip;0;3;0;3
15587;Svaja;"3 C klasė";2018073862;Taip;0;22;0;22
15588;Svaja;"3 C klasė";25585032766;Taip;0;22;0;22
15589;Svaja;"3 C klasė";79572045341;Taip;0;22;0;22
15590;Šilelis;PAUKŠTELIAI;6128379060;Taip;13;9;0;22
15591;Šilelis;PAUKŠTELIAI;9653439873;Taip;6;2;0;8
15592;Šilelis;PAUKŠTELIAI;2823486581;Taip;0;2;0;2
15593;Šilelis;PAUKŠTELIAI;6369443270;Taip;6;0;1;7
15594;Šilelis;PAUKŠTELIAI;7595774842;Taip;0;7;1;8
15595;Šilelis;PAUKŠTELIAI;6614686867;Taip;22;0;0;22
15596;Šilelis;PAUKŠTELIAI;3053443777;Taip;8;0;0;8
15597;Šilelis;PAUKŠTELIAI;4960501068;Taip;4;12;0;16
15598;Šilelis;PAUKŠTELIAI;7072057348;Taip;8;1;0;9
15599;Šilelis;PAUKŠTELIAI;8598321310;Taip;0;0;10;10
15600;Šilelis;PAUKŠTELIAI;5974537364;Taip;7;10;0;17
15601;Šilelis;PAUKŠTELIAI;8166061969;Taip;6;0;1;7
15602;Šilelis;PAUKŠTELIAI;5509365461;Taip;9;0;1;10
15603;Šilelis;PAUKŠTELIAI;5025956218;Taip;3;0;1;4
15604;Šilelis;PAUKŠTELIAI;2913622440;Taip;3;0;5;8
15605;Šilelis;PAUKŠTELIAI;1124854378;Taip;6;4;0;10
15606;Šilelis;SKRUZDELIUKAI;6099940488;Taip;22;0;0;22
15607;Šilelis;SKRUZDELIUKAI;6139976105;Taip;1;2;0;3
15608;Šilelis;SKRUZDELIUKAI;3823958567;Taip;3;6;0;9
15609;Šilelis;SKRUZDELIUKAI;1887013803;Taip;0;2;0;2
15610;Šilelis;SKRUZDELIUKAI;6359318134;Taip;8;0;3;11
15611;Šilelis;SKRUZDELIUKAI;5598152793;Taip;8;1;0;9
15612;Šilelis;SKRUZDELIUKAI;8090773379;Taip;3;11;0;14
15613;Šilelis;SKRUZDELIUKAI;3373275644;Taip;6;2;0;8
15614;Šilelis;SKRUZDELIUKAI;9589138527;Taip;8;6;0;14
15615;Šilelis;SKRUZDELIUKAI;6852463814;Ne;0;3;0;3
15616;Šilelis;SKRUZDELIUKAI;3967932407;Taip;0;3;0;3
15617;Šilelis;SKRUZDELIUKAI;4629917226;Taip;4;0;0;4
15618;Šilelis;SKRUZDELIUKAI;9461117894;Taip;7;2;0;9
15619;Šilelis;SKRUZDELIUKAI;5817818596;Taip;0;14;6;20
15620;Šilelis;SKRUZDELIUKAI;6827855685;Taip;8;0;0;8
15621;Šilelis;SMERFY;7936978436;Taip;3;0;0;3
15622;Šilelis;SMERFY;6572969153;Taip;0;4;0;4
15623;Šilelis;SMERFY;3247333567;Taip;0;2;0;2
15624;Šilelis;SMERFY;6999088222;Taip;3;0;1;4
15625;Šilelis;SMERFY;3089270468;Taip;0;12;0;12
15626;Šilelis;SMERFY;7824279279;Ne;0;2;0;2
15627;Šilelis;SMERFY;4504627601;Taip;3;1;0;4
15628;Šilelis;SMERFY;7534468539;Taip;0;0;1;1
15629;Šilelis;SMERFY;6390855924;Taip;8;3;0;11
15630;Šilelis;SMERFY;1821827154;Taip;5;0;0;5
15631;Šilelis;SMERFY;4196893379;Taip;0;4;0;4
15632;Šilelis;EŽIUKAI;4494932923;Taip;0;1;0;1
15633;Šilelis;EŽIUKAI;7074963804;Taip;0;3;0;3
15634;Šilelis;EŽIUKAI;1165219272;Taip;0;1;0;1
15635;Šilelis;EŽIUKAI;3234612149;Taip;5;7;5;17
15636;Šilelis;EŽIUKAI;4702068672;Taip;0;1;0;1
15637;Šilelis;EŽIUKAI;1724976098;Taip;4;4;0;8
15638;Šilelis;EŽIUKAI;1586414960;Taip;2;0;0;2
15639;Šilelis;EŽIUKAI;5020209473;Taip;0;10;4;14
15640;Šilelis;EŽIUKAI;2295849333;Taip;0;6;0;6
15641;Šilelis;EŽIUKAI;1883483049;Taip;0;10;0;10
15642;Šilelis;EŽIUKAI;6386996498;Taip;4;0;3;7
15643;Šilelis;EŽIUKAI;9354491312;Taip;14;3;2;19
15644;Šilelis;EŽIUKAI;4822495270;Taip;7;0;1;8
15645;Šilelis;EŽIUKAI;3211649292;Taip;5;0;0;5
15646;Šilelis;EŽIUKAI;6091878190;Taip;4;0;8;12
15647;Šilelis;NYKŠTUKAI;3046954717;Taip;0;0;1;1
15648;Šilelis;NYKŠTUKAI;2862894359;Taip;0;0;1;1
15649;Šilelis;NYKŠTUKAI;3158708835;Taip;0;2;0;2
15650;Šilelis;NYKŠTUKAI;8807755852;Taip;0;3;0;3
15651;Šilelis;NYKŠTUKAI;6195580698;Taip;0;0;7;7
15652;Šilelis;NYKŠTUKAI;4323998445;Taip;0;0;1;1
15653;Šilelis;NYKŠTUKAI;2095572561;Taip;0;0;2;2
15654;Šilelis;NYKŠTUKAI;2161973782;Taip;5;5;0;10
15655;Šilelis;NYKŠTUKAI;3728633100;Taip;6;2;0;8
15656;Šilelis;NYKŠTUKAI;3999426414;Taip;0;5;0;5
15657;Šilelis;NYKŠTUKAI;5745874033;Taip;4;8;0;12
15658;Šilelis;NYKŠTUKAI;9769483899;Taip;3;1;0;4
15659;Šilelis;ANČIUKAI;1621768113;Taip;0;1;0;1
15660;Šilelis;ANČIUKAI;3892886609;Taip;0;1;0;1
15661;Šilelis;ANČIUKAI;2018007566;Taip;0;5;0;5
15662;Šilelis;ANČIUKAI;1594700604;Taip;0;8;0;8
15663;Šilelis;ANČIUKAI;5375413045;Taip;0;15;0;15
15664;Šilelis;ANČIUKAI;1246899777;Taip;0;0;1;1
15665;Šilelis;ANČIUKAI;93686653078;Taip;0;3;0;3
15666;Šilelis;ANČIUKAI;6297546907;Taip;0;3;0;3
15667;Šilelis;ANČIUKAI;2570831181;Taip;0;0;1;1
15668;Šilelis;ANČIUKAI;5766702969;Taip;10;7;0;17
15669;Šilelis;ANČIUKAI;6104538160;Taip;13;0;0;13
15670;Šilelis;ANČIUKAI;4682742121;Taip;0;10;1;11
15671;Šilelis;KAČIUKAI;3216168797;Taip;0;22;0;22
15672;Šilelis;KAČIUKAI;8387022157;Taip;0;5;0;5
15673;Šilelis;KAČIUKAI;3393466953;Taip;2;4;0;6
15674;Šilelis;KAČIUKAI;2111979474;Taip;0;10;0;10
15675;Šilelis;KAČIUKAI;8064905796;Taip;0;4;0;4
15676;Šilelis;KAČIUKAI;5176259940;Ne;0;0;7;7
15677;Šilelis;KAČIUKAI;5589764935;Taip;15;0;2;17
15678;Šilelis;KAČIUKAI;7123048946;Taip;10;4;0;14
15679;Šilelis;KAČIUKAI;6479728064;Taip;0;12;0;12
15680;Šilelis;KAČIUKAI;2906501601;Taip;0;15;0;15
15681;Šilelis;KAČIUKAI;6510813364;Taip;0;1;0;1
15682;Šilelis;KAČIUKAI;8319185507;Taip;8;0;0;8
15683;Šilelis;KAČIUKAI;8504187981;Taip;0;0;4;4
15684;Šilelis;KAČIUKAI;3419284228;Taip;9;1;0;10
15685;Šilelis;KAČIUKAI;3712001932;Taip;0;6;0;6
15686;Šilelis;KAČIUKAI;9106999969;Taip;9;0;0;9
15687;Šilelis;KIŠKUČIAI;193181908;Ne;0;0;1;1
15688;Šilelis;KIŠKUČIAI;1747920772;Taip;0;0;3;3
15689;Šilelis;KIŠKUČIAI;6061033736;Taip;0;1;0;1
15690;Šilelis;KIŠKUČIAI;88436890881;Taip;0;0;3;3
15691;Šilelis;KIŠKUČIAI;2681063256;Taip;0;0;6;6
15692;Šilelis;KIŠKUČIAI;7208757038;Taip;0;5;4;9
15693;Šilelis;KIŠKUČIAI;1898004894;Taip;8;0;1;9
15694;Šilelis;KREGŽDUTĖS;1344825612;Taip;0;2;0;2
15695;Šilelis;KREGŽDUTĖS;3655800765;Taip;0;2;0;2
15696;Šilelis;KREGŽDUTĖS;1719681061;Taip;0;6;0;6
15697;Šilelis;KREGŽDUTĖS;36811772392;Taip;0;4;0;4
15698;Šilelis;KREGŽDUTĖS;1958785859;Taip;0;1;0;1
15699;Šilelis;KREGŽDUTĖS;89194687299;Taip;0;4;0;4
15700;Šilelis;KREGŽDUTĖS;82928837930;Taip;0;2;0;2
15701;Šilelis;KREGŽDUTĖS;1984731000;Taip;0;10;0;10
15702;Šilelis;KREGŽDUTĖS;75274553746;Taip;0;3;4;7
15703;Šilelis;KREGŽDUTĖS;7542121945;Taip;0;3;0;3
15704;Šilelis;KREGŽDUTĖS;8915228012;Taip;0;3;0;3
15705;Šilelis;KREGŽDUTĖS;1448291886;Taip;0;2;0;2
15706;Šilelis;PAGRANDUKAI;4814863979;Taip;10;6;0;16
15707;Šilelis;PAGRANDUKAI;9670243727;Taip;2;0;0;2
15708;Šilelis;PAGRANDUKAI;8357287467;Taip;6;1;0;7
15709;Šilelis;PAGRANDUKAI;20525573092;Taip;0;2;0;2
15710;Šilelis;PAGRANDUKAI;2897196188;Taip;0;0;4;4
15711;Šilelis;PAGRANDUKAI;3583955729;Taip;3;0;0;3
15712;Šilelis;PAGRANDUKAI;9113098594;Taip;6;0;5;11
15713;Šilelis;PAGRANDUKAI;7623203279;Taip;2;0;2;4
15714;Šilelis;PAGRANDUKAI;4340856490;Taip;5;0;0;5
15715;Šilelis;PAGRANDUKAI;3807787648;Taip;0;2;0;2
15716;Šilelis;PAGRANDUKAI;6276408187;Taip;0;0;3;3
15717;Šilelis;PAGRANDUKAI;8416126751;Taip;6;0;2;8
15718;Šilelis;BITUTĖS;2948291866;Taip;0;16;0;16
15719;Šilelis;BITUTĖS;7512731255;Taip;0;2;0;2
15720;Šilelis;BITUTĖS;1268335563;Taip;0;4;0;4
15721;Šilelis;BITUTĖS;4781652156;Ne;7;0;0;7
15722;Šilelis;BITUTĖS;9035595952;Taip;0;0;1;1
15723;Šilelis;BITUTĖS;9071963194;Taip;7;11;0;18
15724;Šilelis;BITUTĖS;5843337891;Taip;10;1;0;11
15725;Šilelis;BITUTĖS;1960952604;Taip;4;1;0;5
15726;Šilelis;BITUTĖS;3954379433;Taip;0;19;0;19
15727;Šilelis;BITUTĖS;7350013139;Taip;0;18;0;18
15728;Šilelis;BITUTĖS;1390916076;Taip;0;6;0;6
15729;Šilelis;BITUTĖS;6143099736;Taip;4;8;0;12
15730;Šilelis;BITUTĖS;2667785768;Taip;0;0;2;2
15731;Šilelis;BITUTĖS;5210301367;Taip;7;1;1;9
15732;Šilelis;DRUGELIAI;3598370884;Taip;10;0;0;10
15733;Šilelis;DRUGELIAI;1347150938;Taip;0;1;1;2
15734;Šilelis;DRUGELIAI;7636725161;Taip;5;5;1;11
15735;Šilelis;DRUGELIAI;1891388542;Taip;0;1;0;1
15736;Šilelis;DRUGELIAI;5759824196;Taip;0;1;0;1
15737;Šilelis;DRUGELIAI;31906089315;Taip;0;3;0;3
15738;Šilelis;DRUGELIAI;4115738520;Taip;0;11;0;11
15739;Šilelis;DRUGELIAI;3824174896;Taip;0;11;0;11
15740;Šilelis;DRUGELIAI;8090765017;Taip;0;4;0;4
15741;Šilelis;DRUGELIAI;54633547799;Taip;0;1;0;1
15742;Šilelis;DRUGELIAI;9100047520;Taip;0;2;0;2
15743;Šilelis;DRUGELIAI;5863425750;Taip;0;0;9;9
15744;Šilelis;DRUGELIAI;1638362625;Taip;9;0;0;9
15745;Šilelis;DRUGELIAI;9482667810;Taip;0;10;0;10
15746;Šilelis;DRUGELIAI;5379171382;Taip;7;1;1;9
15747;Šilelis;DRUGELIAI;6230566495;Taip;0;3;0;3
15748;Šilelis;DRUGELIAI;6523676718;Taip;0;6;0;6
15749;Vaduvos;PAGRANDUKAI;1431863758;Taip;0;1;0;1
15750;Vaduvos;PAGRANDUKAI;8408017356;Taip;0;6;0;6
15751;Vaduvos;PAGRANDUKAI;72724196791;Taip;0;10;10;20
15752;Vaduvos;PAGRANDUKAI;9371067563;Taip;0;1;0;1
15753;Vaduvos;PAGRANDUKAI;6425640531;Taip;5;1;0;6
15754;Vaduvos;PAGRANDUKAI;4029586203;Taip;0;1;0;1
15755;Vaduvos;PAGRANDUKAI;73800920781;Taip;0;1;0;1
15756;Vaduvos;PAGRANDUKAI;18035723255;Taip;0;0;1;1
15757;Vaduvos;PAGRANDUKAI;5954492368;Taip;0;9;0;9
15758;Vaduvos;PAGRANDUKAI;7397068779;Ne;0;6;0;6
15759;Vaduvos;PAGRANDUKAI;8875709110;Taip;0;3;0;3
15760;Vaduvos;PAGRANDUKAI;4789480822;Taip;6;4;0;10
15761;Vaduvos;PAGRANDUKAI;7305111076;Taip;0;0;2;2
15762;Vaduvos;PAGRANDUKAI;68848152670;Taip;0;10;0;10
15763;Vaduvos;PAGRANDUKAI;4105978403;Taip;0;3;0;3
15764;Vaduvos;PAGRANDUKAI;5428067167;Taip;0;7;0;7
15765;Vaduvos;PAGRANDUKAI;3699578284;Taip;9;2;0;11
15766;Vaduvos;PAGRANDUKAI;8299189235;Taip;15;0;3;18
15767;Vaduvos;KODĖLČIUKAI;3010510262;Taip;0;9;0;9
15768;Vaduvos;KODĖLČIUKAI;9429028460;Taip;0;1;0;1
15769;Vaduvos;KODĖLČIUKAI;6210729584;Taip;17;0;0;17
15770;Vaduvos;KODĖLČIUKAI;9606193112;Taip;4;1;0;5
15771;Vaduvos;KODĖLČIUKAI;9540008495;Taip;0;0;6;6
15772;Vaduvos;KODĖLČIUKAI;4177935331;Taip;8;6;0;14
15773;Vaduvos;KODĖLČIUKAI;9072097216;Taip;0;0;2;2
15774;Vaduvos;KODĖLČIUKAI;6810198013;Taip;0;2;1;3
15775;Vaduvos;KODĖLČIUKAI;3641822841;Taip;9;5;0;14
15776;Vaduvos;KODĖLČIUKAI;4270137614;Taip;0;1;0;1
15777;Vaduvos;KODĖLČIUKAI;3682708061;Taip;5;0;0;5
15778;Vaduvos;KODĖLČIUKAI;5262165284;Taip;6;0;2;8
15779;Vaduvos;KODĖLČIUKAI;8603418399;Taip;3;1;0;4
15780;Vaduvos;KODĖLČIUKAI;3096104197;Taip;19;0;0;19
15781;Vaduvos;KODĖLČIUKAI;5761137540;Taip;0;1;0;1
15782;Vaduvos;KODĖLČIUKAI;1054097622;Taip;7;10;0;17
15783;Vaduvos;KODĖLČIUKAI;7508333714;Ne;7;0;4;11
15784;Vaduvos;KODĖLČIUKAI;6013737546;Taip;0;22;0;22
15785;Vaduvos;KODĖLČIUKAI;3962369527;Ne;8;0;4;12
15786;Vaduvos;KODĖLČIUKAI;6991960029;Taip;9;0;0;9
15787;Vaduvos;SMALSUČIAI;5307128703;Taip;0;6;0;6
15788;Vaduvos;SMALSUČIAI;62183976729;Taip;0;0;1;1
15789;Vaduvos;SMALSUČIAI;1622695085;Taip;0;0;4;4
15790;Vaduvos;SMALSUČIAI;3555513755;Taip;0;3;0;3
15791;Vaduvos;SMALSUČIAI;2184711783;Taip;0;3;0;3
15792;Vaduvos;SMALSUČIAI;7337663549;Taip;0;0;5;5
15793;Vaduvos;SMALSUČIAI;5055972872;Taip;4;2;0;6
15794;Vaduvos;SMALSUČIAI;6192828320;Ne;10;2;0;12
15795;Vaduvos;SMALSUČIAI;13888236429;Taip;0;0;7;7
15796;Vaduvos;SMALSUČIAI;3722349868;Taip;0;2;0;2
15797;Vaduvos;SMALSUČIAI;3174998523;Taip;0;2;1;3
15798;Vaduvos;SMALSUČIAI;3091707832;Ne;19;0;2;21
15799;Vaduvos;SMALSUČIAI;6128582180;Taip;4;0;1;5
15800;Vaduvos;SMALSUČIAI;87008942241;Taip;0;0;2;2
15801;Vaduvos;SMALSUČIAI;7181151562;Taip;0;13;4;17
15802;Vaduvos;SMALSUČIAI;7431411663;Taip;0;1;0;1
15803;Vaduvos;GILIUKAI;11202010413;Taip;0;9;0;9
15804;Vaduvos;GILIUKAI;1046867513;Taip;0;1;0;1
15805;Vaduvos;GILIUKAI;4342471835;Taip;0;0;1;1
15806;Vaduvos;GILIUKAI;41870343319;Taip;0;1;0;1
15807;Vaduvos;GILIUKAI;93702732546;Taip;0;0;1;1
15808;Vaduvos;GILIUKAI;2006018986;Ne;7;2;0;9
15809;Vaduvos;GILIUKAI;46608435244;Taip;8;0;0;8
15810;Vaduvos;GILIUKAI;59616893535;Taip;8;0;2;10
15811;Vaduvos;GILIUKAI;22641388717;Taip;0;3;0;3
15812;Vaduvos;GILIUKAI;61046090149;Taip;3;1;0;4
15813;Vaduvos;GILIUKAI;56280470781;Taip;10;0;0;10
15814;Vaduvos;GILIUKAI;68937983441;Taip;0;8;0;8
15815;Vaduvos;GILIUKAI;65843855427;Taip;5;1;0;6
15816;Vaduvos;GILIUKAI;2065411907;Ne;0;0;14;14
15817;Vaduvos;GILIUKAI;4513707989;Ne;0;0;11;11
15818;Vaduvos;GILIUKAI;1370696345;Taip;0;0;6;6
15819;Vaduvos;GILIUKAI;13178417729;Taip;0;12;0;12
15820;Vaduvos;BORUŽĖLĖS;2277525837;Taip;0;5;1;6
15821;Vaduvos;BORUŽĖLĖS;6439773886;Taip;0;5;0;5
15822;Vaduvos;BORUŽĖLĖS;5634252033;Taip;0;0;8;8
15823;Vaduvos;BORUŽĖLĖS;6593754016;Taip;13;5;0;18
15824;Vaduvos;BORUŽĖLĖS;5356902834;Taip;13;0;1;14
15825;Vaduvos;BORUŽĖLĖS;7521846747;Taip;4;3;0;7
15826;Vaduvos;BORUŽĖLĖS;1422507884;Taip;0;6;0;6
15827;Vaduvos;BORUŽĖLĖS;8324927031;Taip;0;0;1;1
15828;Vaduvos;BORUŽĖLĖS;4465504676;Taip;4;2;0;6
15829;Vaduvos;BORUŽĖLĖS;7904713344;Taip;0;0;1;1
15830;Vaduvos;BORUŽĖLĖS;2417613291;Taip;0;0;2;2
15831;Vaduvos;BORUŽĖLĖS;6462126837;Taip;0;5;0;5
15832;Vaduvos;BORUŽĖLĖS;5717064754;Ne;0;0;6;6
15833;Vaduvos;BORUŽĖLĖS;8064111922;Taip;18;0;1;19
15834;Vaduvos;BORUŽĖLĖS;6552763746;Taip;3;0;0;3
15835;Vaduvos;BORUŽĖLĖS;3255011809;Taip;15;0;1;16
15836;Vaduvos;BORUŽĖLĖS;8946940285;Taip;0;5;0;5
15837;Vaduvos;BORUŽĖLĖS;9188471756;Taip;4;6;0;10
15838;Vaduvos;BORUŽĖLĖS;7169054113;Taip;0;1;0;1
15839;Vaduvos;BORUŽĖLĖS;2366843609;Taip;6;0;0;6
15840;Vaduvos;DRUGELIAI;4936598927;Taip;10;0;1;11
15841;Vaduvos;DRUGELIAI;2341467486;Taip;0;0;1;1
15842;Vaduvos;DRUGELIAI;5510687497;Ne;10;6;0;16
15843;Vaduvos;DRUGELIAI;9824469881;Taip;0;0;9;9
15844;Vaduvos;DRUGELIAI;5915272436;Taip;0;0;6;6
15845;Vaduvos;DRUGELIAI;4238942070;Taip;5;0;0;5
15846;Vaduvos;DRUGELIAI;6770559352;Taip;4;5;0;9
15847;Vaduvos;DRUGELIAI;4856601924;Taip;4;6;0;10
15848;Vaduvos;DRUGELIAI;3477273224;Taip;4;0;0;4
15849;Vaduvos;DRUGELIAI;2452309232;Taip;0;9;0;9
15850;Vaduvos;DRUGELIAI;6776150749;Taip;9;0;1;10
15851;Vaduvos;DRUGELIAI;4587836073;Taip;3;2;0;5
15852;Vaduvos;DRUGELIAI;9333495119;Taip;10;1;0;11
15853;Vaduvos;DRUGELIAI;7597268115;Taip;0;1;0;1
15854;Vaduvos;DRUGELIAI;8400344609;Taip;0;0;1;1
15855;Vaduvos;DRUGELIAI;2789503381;Taip;0;0;3;3
15856;Vaduvos;DRUGELIAI;1987969267;Taip;15;0;0;15
15857;Vaduvos;RIEŠUTĖLIAI;9167796462;Taip;4;0;1;5
15858;Vaduvos;RIEŠUTĖLIAI;5297217576;Taip;6;1;0;7
15859;Vaduvos;RIEŠUTĖLIAI;3540548094;Taip;0;0;3;3
15860;Vaduvos;RIEŠUTĖLIAI;5376707663;Taip;0;2;1;3
15861;Vaduvos;RIEŠUTĖLIAI;2957685586;Taip;22;0;0;22
15862;Vaduvos;RIEŠUTĖLIAI;6514406042;Taip;8;0;2;10
15863;Vaduvos;RIEŠUTĖLIAI;8188374113;Taip;0;0;5;5
15864;Vaduvos;RIEŠUTĖLIAI;6676167440;Taip;16;0;0;16
15865;Vaduvos;RIEŠUTĖLIAI;2939561403;Taip;9;0;3;12
15866;Vaduvos;RIEŠUTĖLIAI;7573756485;Taip;0;9;5;14
15867;Vaduvos;RIEŠUTĖLIAI;2835635250;Taip;7;8;0;15
15868;Vaduvos;RIEŠUTĖLIAI;6409466338;Taip;6;3;0;9
15869;Vaduvos;RIEŠUTĖLIAI;8580834401;Taip;6;0;1;7
15870;Vaduvos;RIEŠUTĖLIAI;6276149710;Taip;7;0;1;8
15871;Vaduvos;RIEŠUTĖLIAI;3057729267;Taip;15;0;0;15
15872;Vaduvos;RIEŠUTĖLIAI;6346625714;Taip;10;5;0;15
15873;Vaduvos;RIEŠUTĖLIAI;8964194121;Taip;0;7;0;7
15874;Vaduvos;RIEŠUTĖLIAI;6572776966;Taip;12;0;1;13
15875;Vaduvos;"1 klasė";49738318631;Taip;0;11;0;11
15876;Vaduvos;"1 klasė";1139509471;Taip;0;32;0;32
15877;Vaduvos;"1 klasė";1107557891;Taip;0;32;0;32
15878;Vaduvos;"1 klasė";8802765960;Taip;0;11;0;11
15879;Vaduvos;"1 klasė";61243200177;Taip;0;11;0;11
15880;Vaduvos;"1 klasė";65647119496;Taip;0;14;0;14
15881;Vaduvos;"1 klasė";6155494370;Ne;0;17;0;17
15882;Vaduvos;"1 klasė";70693742936;Taip;0;14;0;14
15883;Vaduvos;"1 klasė";2348627375;Taip;0;13;0;13
15884;Vaduvos;"1 klasė";1010061503;Taip;0;14;0;14
15885;Vaduvos;"1 klasė";6279678482;Ne;0;11;0;11
15886;Vaduvos;"1 klasė";96892752634;Taip;0;16;0;16
15887;Vaduvos;"1 klasė";62703428759;Taip;0;11;0;11
15888;Vaduvos;"1 klasė";68420568339;Taip;0;12;0;12
15889;Vaduvos;"1 klasė";19390879176;Taip;0;14;0;14
15890;Vaduvos;"1 klasė";4670249904;Ne;0;20;0;20
15891;Vaduvos;"1 klasė";3172047211;Taip;0;12;0;12
15892;Vaduvos;"1 klasė";3516213965;Ne;0;21;0;21
15893;Vaduvos;"1 klasė";3516213965;Ne;0;21;0;21
15894;Vaduvos;"2 klasė";97423576166;Taip;0;13;0;13
15895;Vaduvos;"2 klasė";42498568346;Taip;0;12;0;12
15896;Vaduvos;"2 klasė";38504924027;Taip;0;11;0;11
15897;Vaduvos;"2 klasė";96148085691;Taip;0;16;0;16
15898;Vaduvos;"2 klasė";12330772986;Taip;0;11;0;11
15899;Vaduvos;"2 klasė";33277362439;Ne;0;13;0;13
15900;Vaduvos;"2 klasė";32138087379;Taip;0;32;0;32
15901;Vaduvos;"2 klasė";67324784528;Taip;0;11;0;11
15902;Vaduvos;"2 klasė";4807104855;Taip;0;11;0;11
15903;Vaduvos;"2 klasė";2181614424;Taip;0;11;0;11
15904;Vaduvos;"2 klasė";2019573643;Taip;0;26;0;26
15905;Vaduvos;"2 klasė";27419094487;Taip;0;11;0;11
15906;Vaduvos;"2 klasė";41272273463;Ne;0;11;0;11
15907;Vaduvos;"2 klasė";89793734700;Taip;0;11;0;11
15908;Vaduvos;"2 klasė";17473821556;Taip;0;14;0;14
15909;Vaduvos;"2 klasė";53866301875;Ne;0;32;0;32
15910;Vaduvos;"2 klasė";7786986697;Taip;0;17;0;17
15911;Vaduvos;"2 klasė";9147332638;Taip;0;12;0;12
15912;Vaduvos;"2 klasė";1532675814;Taip;0;12;0;12
15913;Vaduvos;"2 klasė";98259624669;Taip;0;11;0;11
15914;Vaduvos;"2 klasė";36931517006;Taip;0;13;0;13
15915;Vaduvos;"2 klasė";61243424057;Taip;0;12;0;12
15916;Vaduvos;"2 klasė";30979103892;Taip;0;11;0;11
15917;Vaduvos;"2 klasė";78245732319;Taip;0;11;0;11
15918;Vaduvos;"2 klasė";97878811046;Taip;0;11;0;11
15919;Vaduvos;"2 klasė";48433447683;Taip;0;14;0;14
15920;Vaduvos;"2 klasė";85090873161;Taip;0;32;0;32
15921;Vaduvos;"3 klasė";96473212525;Taip;0;12;0;12
15922;Vaduvos;"3 klasė";75428164558;Taip;0;11;0;11
15923;Vaduvos;"3 klasė";63286903462;Taip;0;11;0;11
15924;Vaduvos;"3 klasė";13721939854;Taip;0;11;0;11
15925;Vaduvos;"3 klasė";1171210935;Taip;0;17;0;17
15926;Vaduvos;"3 klasė";7172286009;Taip;0;12;0;12
15927;Vaduvos;"3 klasė";6049882391;Ne;0;32;0;32
15928;Vaduvos;"3 klasė";38013859931;Taip;0;13;0;13
15929;Vaduvos;"3 klasė";4591744662;Taip;0;13;0;13
15930;Vaduvos;"3 klasė";9149523910;Taip;0;13;0;13
15931;Vaduvos;"3 klasė";76662161382;Taip;0;12;0;12
15932;Vaduvos;"3 klasė";26934740147;Taip;0;15;0;15
15933;Vaduvos;"3 klasė";18300713872;Taip;0;32;0;32
15934;Vaduvos;"3 klasė";768455288;Taip;0;32;0;32
15935;Vaduvos;"3 klasė";1768173501;Taip;0;11;0;11
15936;Vaduvos;"3 klasė";60531886576;Taip;0;12;0;12
15937;Vaduvos;"3 klasė";38462664426;Ne;0;11;0;11
15938;Vaduvos;"3 klasė";1821644443;Ne;0;12;0;12
15939;Vaduvos;"3 klasė";20841176336;Taip;0;19;0;19
15940;Vaduvos;"4 klasė";8009941823;Taip;0;1;0;1
15941;Vaduvos;"4 klasė";2423925079;Taip;0;5;0;5
15942;Vaduvos;"4 klasė";7410760461;Taip;0;1;0;1
15943;Vaduvos;"4 klasė";6487033699;Ne;0;16;0;16
15944;Vaduvos;"4 klasė";1671409152;Taip;0;1;0;1
15945;Vaduvos;"4 klasė";5072769647;Taip;0;1;0;1
15946;Vaduvos;"4 klasė";4637670260;Taip;0;1;0;1
15947;Vaduvos;"4 klasė";7236550835;Taip;0;1;0;1
15948;Vaduvos;"4 klasė";9372936408;Taip;0;1;0;1
15949;Vaduvos;"4 klasė";7243175751;Taip;0;22;0;22
15950;Vaduvos;"4 klasė";2482212122;Taip;0;1;0;1
15951;Vaduvos;"4 klasė";1982860223;Taip;0;1;0;1
15952;Vaduvos;"4 klasė";4447152355;Taip;0;22;0;22
15953;Vaduvos;"4 klasė";3325229112;Taip;0;1;0;1
15954;Vaduvos;"4 klasė";5531150399;Taip;0;22;0;22
15955;Vaduvos;"4 klasė";6980440631;Taip;0;1;0;1
15956;Vaduvos;"4 klasė";1091221509;Taip;0;8;0;8
15957;Vaduvos;"4 klasė";7614692200;Taip;0;1;0;1
15958;Vaduvos;"4 klasė";8216757208;Taip;0;1;0;1
15959;Vaduvos;"4 klasė";5459268700;Taip;0;22;0;22
15960;Vaduvos;"4 klasė";5593756016;Taip;0;4;0;4
15961;Vaduvos;"4 klasė";1642242442;Taip;0;4;0;4
15962;Vaduvos;"4 klasė";8928517238;Taip;0;1;0;1
15963;Vaduvos;"4 klasė";5099560123;Taip;0;3;0;3
15964;Vaduvos;"4 klasė";7899239147;Taip;0;1;0;1
15965;Vaduvos;"1 B klasė";40872193458;Taip;0;11;0;11
15966;Vaduvos;"1 B klasė";78931952732;Ne;0;20;0;20
15967;Vaduvos;"1 B klasė";1241148402;Taip;0;11;0;11
15968;Vaduvos;"1 B klasė";66359913774;Taip;0;10;0;10
15969;Vaduvos;"1 B klasė";64074141491;Taip;0;10;0;10
15970;Vaduvos;"1 B klasė";87671358423;Taip;0;32;0;32
15971;Vaduvos;"1 B klasė";95104294893;Taip;0;11;0;11
15972;Vaduvos;"1 B klasė";47465933557;Taip;0;10;0;10
15973;Vaduvos;"1 B klasė";16882774330;Taip;0;10;0;10
15974;Vaduvos;"1 B klasė";55138588393;Taip;0;12;0;12
15975;Vaduvos;"1 B klasė";6500567162;Taip;0;18;0;18
15976;Vaduvos;"1 B klasė";24887196729;Taip;0;16;0;16
15977;Vaduvos;"1 B klasė";39687066893;Taip;0;10;0;10
15978;Vaduvos;"1 B klasė";93924290247;Taip;0;15;0;15
15979;Vaduvos;"1 B klasė";62521006557;Taip;0;10;0;10
15980;Vaduvos;"1 B klasė";8782782031;Taip;0;10;0;10
15981;Vaduvos;"1 B klasė";3259114583;Taip;0;13;0;13
15982;Vaduvos;"1 B klasė";50489733849;Taip;0;11;0;11
15983;Vaduvos;"1 B klasė";6246550950;Ne;0;23;0;23
15984;Vilkpėdės;BORUŽĖLĖS;8969001990;Taip;8;0;1;9
15985;Vilkpėdės;BORUŽĖLĖS;6744834487;Taip;7;0;1;8
15986;Vilkpėdės;BORUŽĖLĖS;7401886306;Taip;0;9;0;9
15987;Vilkpėdės;BORUŽĖLĖS;6820236577;Taip;0;11;0;11
15988;Vilkpėdės;BORUŽĖLĖS;4255757333;Ne;0;8;0;8
15989;Vilkpėdės;BORUŽĖLĖS;4166416292;Taip;0;9;0;9
15990;Vilkpėdės;BORUŽĖLĖS;3785308006;Taip;2;0;3;5
15991;Vilkpėdės;BORUŽĖLĖS;6283767445;Taip;0;2;0;2
15992;Vilkpėdės;BORUŽĖLĖS;9605430333;Taip;11;9;2;22
15993;Vilkpėdės;BORUŽĖLĖS;9601934563;Taip;5;1;0;6
15994;Vilkpėdės;BORUŽĖLĖS;2359315281;Taip;0;1;0;1
15995;Vilkpėdės;BORUŽĖLĖS;7745776486;Taip;0;3;0;3
15996;Vilkpėdės;BORUŽĖLĖS;7158737372;Ne;7;1;1;9
15997;Vilkpėdės;BORUŽĖLĖS;1063561954;Ne;1;0;0;1
15998;Vilkpėdės;SKRUZDĖLIUKAI;4018140154;Taip;8;5;0;13
15999;Vilkpėdės;SKRUZDĖLIUKAI;2419661008;Taip;0;0;4;4
16000;Vilkpėdės;SKRUZDĖLIUKAI;7114183123;Taip;0;0;9;9
16001;Vilkpėdės;SKRUZDĖLIUKAI;8804335248;Taip;0;1;5;6
16002;Vilkpėdės;SKRUZDĖLIUKAI;2525399410;Taip;10;0;6;16
16003;Vilkpėdės;SKRUZDĖLIUKAI;4656475161;Taip;0;0;14;14
16004;Vilkpėdės;SKRUZDĖLIUKAI;4031175523;Taip;4;0;3;7
16005;Vilkpėdės;SKRUZDĖLIUKAI;6198736925;Taip;7;9;0;16
16006;Vilkpėdės;SKRUZDĖLIUKAI;1478022307;Taip;0;7;1;8
16007;Vilkpėdės;SKRUZDĖLIUKAI;2205143759;Taip;0;1;3;4
16008;Vilkpėdės;SKRUZDĖLIUKAI;6598572049;Taip;0;5;0;5
16009;Vilkpėdės;SKRUZDĖLIUKAI;1342167313;Taip;8;0;0;8
16010;Vilkpėdės;SKRUZDĖLIUKAI;1838974989;Taip;0;0;1;1
16011;Vilkpėdės;SKRUZDĖLIUKAI;5334238235;Taip;0;0;3;3
16012;Vilkpėdės;DRUGELIAI;2420271759;Taip;12;0;0;12
16013;Vilkpėdės;DRUGELIAI;7698759895;Taip;0;4;0;4
16014;Vilkpėdės;DRUGELIAI;1019057127;Taip;0;12;0;12
16015;Vilkpėdės;DRUGELIAI;1807884737;Taip;4;0;0;4
16016;Vilkpėdės;DRUGELIAI;6816745585;Taip;14;0;0;14
16017;Vilkpėdės;DRUGELIAI;2320350937;Taip;5;2;0;7
16018;Vilkpėdės;DRUGELIAI;9795696242;Taip;0;4;0;4
16019;Vilkpėdės;DRUGELIAI;8581661608;Taip;0;3;0;3
16020;Vilkpėdės;DRUGELIAI;6261547304;Taip;3;0;0;3
16021;Vilkpėdės;DRUGELIAI;4095366279;Taip;0;5;0;5
16022;Vilkpėdės;DRUGELIAI;2251274741;Taip;0;9;0;9
16023;Vilkpėdės;DRUGELIAI;6522707709;Taip;0;0;22;22
16024;Vilkpėdės;DRUGELIAI;1217929358;Taip;1;1;0;2
16025;Vilkpėdės;DRUGELIAI;5048931309;Taip;7;0;0;7
16026;Vilkpėdės;DRUGELIAI;7010024061;Taip;7;1;0;8
16027;Vilkpėdės;DRUGELIAI;7894766629;Taip;0;3;0;3
16028;Vilkpėdės;DRUGELIAI;3987021185;Taip;0;18;0;18
16029;Vilkpėdės;ŽIOGELIAI;5551822633;Taip;19;0;0;19
16030;Vilkpėdės;ŽIOGELIAI;1063740772;Taip;3;0;0;3
16031;Vilkpėdės;ŽIOGELIAI;3666145718;Taip;0;2;0;2
16032;Vilkpėdės;ŽIOGELIAI;5422061533;Taip;7;1;0;8
16033;Vilkpėdės;ŽIOGELIAI;5346798201;Taip;0;13;0;13
16034;Vilkpėdės;ŽIOGELIAI;3720639726;Taip;0;0;2;2
16035;Vilkpėdės;ŽIOGELIAI;1609823694;Taip;0;0;2;2
16036;Vilkpėdės;ŽIOGELIAI;6690742997;Taip;0;9;0;9
16037;Vilkpėdės;ŽIOGELIAI;1655985778;Taip;0;0;7;7
16038;Vilkpėdės;ŽIOGELIAI;3664125930;Ne;17;0;0;17
16039;Vilkpėdės;ŽIOGELIAI;3737265597;Taip;22;0;0;22
16040;Vilkpėdės;ŽIOGELIAI;2241104719;Taip;1;6;0;7
16041;Vilkpėdės;BITUTĖS;6418829930;Taip;0;4;0;4
16042;Vilkpėdės;BITUTĖS;1633942236;Taip;0;1;0;1
16043;Vilkpėdės;BITUTĖS;8484873068;Taip;2;0;0;2
16044;Vilkpėdės;BITUTĖS;2503128176;Taip;4;8;0;12
16045;Vilkpėdės;BITUTĖS;9570469277;Taip;9;4;0;13
16046;Vilkpėdės;BITUTĖS;5420512675;Taip;8;0;0;8
16047;Vilkpėdės;BITUTĖS;8613778606;Taip;0;10;0;10
16048;Vilkpėdės;BITUTĖS;2736318576;Taip;3;0;3;6
16049;Vilkpėdės;BITUTĖS;5577199802;Taip;15;0;0;15
16050;Vilkpėdės;BITUTĖS;3303872633;Taip;14;1;0;15
16051;Vilkpėdės;BITUTĖS;5972405023;Taip;5;3;0;8
16052;Vilkpėdės;BITUTĖS;4485811377;Taip;3;0;0;3
16053;Vilkpėdės;BITUTĖS;5274855225;Taip;2;1;0;3
16054;Vilkpėdės;BITUTĖS;8860791478;Taip;0;2;0;2
16055;Vilkpėdės;"3 klasė";14499651046;Ne;0;4;0;4
16056;Vilkpėdės;"3 klasė";51286525404;Taip;1;0;0;1
16057;Vilkpėdės;"3 klasė";49513181091;Taip;0;4;0;4
16058;Vilkpėdės;"3 klasė";1032216128;Taip;0;1;0;1
16059;Vilkpėdės;"3 klasė";37450374921;Taip;0;5;0;5
16060;Vilkpėdės;"3 klasė";36704555745;Taip;0;3;0;3
16061;Vilkpėdės;"3 klasė";66356984763;Taip;0;6;0;6
16062;Vilkpėdės;"3 klasė";88279045901;Taip;0;5;0;5
16063;Vilkpėdės;"3 klasė";66451097025;Taip;0;2;0;2
16064;Vilkpėdės;"3 klasė";2806307083;Taip;0;3;0;3
16065;Vilkpėdės;"3 klasė";79269485254;Taip;0;4;0;4
16066;Vilkpėdės;"3 klasė";61833757576;Taip;0;2;0;2
16067;Vilkpėdės;"3 klasė";1024429836;Taip;0;1;0;1
16068;Vilkpėdės;"4 klasė";3330174377;Ne;4;0;0;4
16069;Vilkpėdės;"4 klasė";1894949069;Ne;2;0;0;2
16070;Vilkpėdės;"4 klasė";3096541013;Ne;5;0;0;5
16071;Vilkpėdės;"4 klasė";2621713818;Ne;1;0;0;1
16072;Vilkpėdės;"4 klasė";4467711387;Ne;2;0;0;2
16073;Vilkpėdės;GUDRUČIAI;1527272055;Taip;5;0;0;5
16074;Vilkpėdės;GUDRUČIAI;1451102218;Taip;0;1;0;1
16075;Vilkpėdės;GUDRUČIAI;2065010940;Taip;0;7;0;7
16076;Vilkpėdės;GUDRUČIAI;2181146968;Taip;0;9;1;10
16077;Vilkpėdės;GUDRUČIAI;4515945951;Taip;4;0;0;4
16078;Vilkpėdės;GUDRUČIAI;2736368118;Taip;0;1;0;1
16079;Vilkpėdės;GUDRUČIAI;7527929277;Taip;6;3;0;9
16080;Vilkpėdės;GUDRUČIAI;46561435465;Taip;0;7;0;7
16081;Vilkpėdės;GUDRUČIAI;48059844727;Taip;0;3;0;3
16082;Vilkpėdės;GUDRUČIAI;4735164204;Taip;0;6;0;6
16083;Vilkpėdės;GUDRUČIAI;7889480219;Ne;1;1;0;2
16084;Vilkpėdės;GUDRUČIAI;9867411687;Taip;10;1;0;11
16085;Vilkpėdės;GUDRUČIAI;2900581406;Taip;0;1;0;1
16086;Vilkpėdės;GUDRUČIAI;7875898177;Taip;5;0;0;5
16087;Vilkpėdės;GUDRUČIAI;1195392132;Taip;3;0;0;3
16088;Vilkpėdės;GUDRUČIAI;7634355147;Taip;0;3;0;3
16089;Vilkpėdės;GUDRUČIAI;4276158771;Taip;4;1;0;5
16090;Vilkpėdės;GUDRUČIAI;2604179994;Taip;2;2;0;4
16091;Vilkpėdės;GUDRUČIAI;3696611509;Taip;14;2;0;16
16092;Vilkpėdės;SMALSUČIAI;1052719398;Taip;0;1;0;1
16093;Vilkpėdės;SMALSUČIAI;1145968615;Taip;6;4;0;10
16094;Vilkpėdės;SMALSUČIAI;55747681017;Taip;0;4;0;4
16095;Vilkpėdės;SMALSUČIAI;1136036746;Taip;0;6;0;6
16096;Vilkpėdės;SMALSUČIAI;51976067616;Taip;0;1;0;1
16097;Vilkpėdės;SMALSUČIAI;73470824566;Taip;0;5;0;5
16098;Vilkpėdės;SMALSUČIAI;5912919726;Taip;0;2;0;2
16099;Vilkpėdės;SMALSUČIAI;40385792431;Taip;0;3;0;3
16100;Vilkpėdės;SMALSUČIAI;1795879331;Taip;0;6;0;6
16101;Vilkpėdės;SMALSUČIAI;2000428715;Taip;0;5;0;5
16102;Vilkpėdės;SMALSUČIAI;1042000830;Taip;0;1;0;1
16103;Vilkpėdės;SMALSUČIAI;72899151328;Taip;3;1;0;4
16104;Vilkpėdės;SMALSUČIAI;1384224802;Taip;0;1;0;1
16105;Vilkpėdės;SMALSUČIAI;25008201566;Taip;5;0;0;5
16106;Vilkpėdės;SMALSUČIAI;9393571483;Taip;0;2;0;2
16107;Vilkpėdės;SMALSUČIAI;1328830555;Taip;0;7;0;7
16108;Vilkpėdės;SMALSUČIAI;9613791189;Taip;0;2;0;2
16109;Vilkpėdės;SMALSUČIAI;1961069495;Taip;0;1;0;1
16110;Vilkpėdės;SMALSUČIAI;2718251356;Taip;0;2;0;2
16111;Vilkpėdės;SMALSUČIAI;1598018406;Taip;0;1;0;1
16112;Žiburėlis;Nykštukai;7163594513;Taip;3;2;1;6
16113;Žiburėlis;Nykštukai;5174211773;Taip;6;1;0;7
16114;Žiburėlis;Nykštukai;5408766721;Taip;21;0;0;21
16115;Žiburėlis;Nykštukai;7211961512;Taip;0;1;0;1
16116;Žiburėlis;Nykštukai;7862546963;Taip;3;0;0;3
16117;Žiburėlis;Nykštukai;8902837168;Taip;4;0;0;4
16118;Žiburėlis;Nykštukai;7465939429;Taip;5;0;5;10
16119;Žiburėlis;Nykštukai;7307386173;Taip;14;0;0;14
16120;Žiburėlis;Nykštukai;4710995351;Taip;6;0;0;6
16121;Žiburėlis;Nykštukai;7633450988;Taip;12;0;0;12
16122;Žiburėlis;Nykštukai;2292895729;Taip;0;1;0;1
16123;Žiburėlis;Nykštukai;7273838695;Taip;0;1;0;1
16124;Žiburėlis;Nykštukai;9806454408;Ne;3;7;3;13
16125;Žiburėlis;Nykštukai;1764592065;Taip;3;0;0;3
16126;Žiburėlis;Nykštukai;2741301903;Taip;0;1;0;1
16127;Žiburėlis;Nykštukai;3938379566;Taip;10;0;0;10
16128;Žiburėlis;Nykštukai;9932264675;Taip;3;0;0;3
16129;Žiburėlis;Nykštukai;2253167147;Taip;7;2;2;11
16130;Žiburėlis;Nykštukai;8480167191;Taip;0;7;0;7
16131;Žiburėlis;"Žiniukai ";5816890413;Taip;22;0;0;22
16132;Žiburėlis;"Žiniukai ";2928528630;Taip;4;1;0;5
16133;Žiburėlis;"Žiniukai ";2624326930;Taip;8;3;0;11
16134;Žiburėlis;"Žiniukai ";6300247811;Taip;3;2;0;5
16135;Žiburėlis;"Žiniukai ";3033049328;Taip;0;2;0;2
16136;Žiburėlis;"Žiniukai ";3262856058;Taip;8;1;0;9
16137;Žiburėlis;"Žiniukai ";1720078356;Taip;7;0;0;7
16138;Žiburėlis;"Žiniukai ";7424129974;Taip;5;2;0;7
16139;Žiburėlis;"Žiniukai ";4187381976;Taip;5;0;0;5
16140;Žiburėlis;"Žiniukai ";5006361324;Taip;6;0;0;6
16141;Žiburėlis;"Žiniukai ";2956339420;Taip;18;0;0;18
16142;Žiburėlis;"Žiniukai ";7070952018;Taip;0;3;0;3
16143;Žiburėlis;"Žiniukai ";8438876806;Taip;11;5;0;16
16144;Žiburėlis;"Žiniukai ";3687703187;Taip;0;3;0;3
16145;Žiburėlis;"Smalsiukai ";6190642132;Taip;0;3;2;5
16146;Žiburėlis;"Smalsiukai ";97007740148;Taip;4;0;0;4
16147;Žiburėlis;"Smalsiukai ";2009050470;Ne;0;15;0;15
16148;Žiburėlis;"Smalsiukai ";57749440744;Taip;0;1;0;1
16149;Žiburėlis;"Smalsiukai ";808556747;Taip;0;9;0;9
16150;Žiburėlis;"Smalsiukai ";1614403409;Taip;0;1;0;1
16151;Žiburėlis;"Smalsiukai ";1612968712;Ne;0;12;0;12
16152;Žiburėlis;"Smalsiukai ";38096163093;Taip;0;1;0;1
16153;Žiburėlis;"Smalsiukai ";46449810717;Taip;0;9;0;9
16154;Žiburėlis;"Smalsiukai ";9069606713;Taip;5;2;1;8
16155;Žiburėlis;"Smalsiukai ";1106875762;Taip;0;0;4;4
16156;Žiburėlis;"Smalsiukai ";5438697081;Taip;4;4;0;8
16157;Žiburėlis;"Smalsiukai ";1126972447;Ne;6;3;0;9
16158;Žiburėlis;"Smalsiukai ";9783567484;Taip;0;1;0;1
16159;Žiburėlis;"Smalsiukai ";5114554577;Taip;4;7;0;11
16160;Žiburėlis;"Smalsiukai ";3936418539;Taip;5;0;0;5
16161;Žiburėlis;"Smalsiukai ";2072972990;Taip;3;0;0;3
16162;Žiburėlis;"Smalsiukai ";3835820013;Taip;0;1;0;1
16163;Žiburėlis;"Giliukai ";4355778076;Taip;0;1;0;1
16164;Žiburėlis;"Giliukai ";92490398630;Taip;0;1;0;1
16165;Žiburėlis;"Giliukai ";67168630669;Taip;0;2;0;2
16166;Žiburėlis;"Giliukai ";3867540155;Taip;0;5;0;5
16167;Žiburėlis;"Giliukai ";7578655857;Taip;0;10;0;10
16168;Žiburėlis;"Giliukai ";75538036055;Taip;0;2;0;2
16169;Žiburėlis;"Giliukai ";9253393819;Taip;0;1;0;1
16170;Žiburėlis;"Giliukai ";2796489509;Taip;0;21;0;21
16171;Žiburėlis;"Giliukai ";18739941845;Taip;0;2;0;2
16172;Žiburėlis;"Giliukai ";24639355056;Taip;7;3;0;10
16173;Žiburėlis;"Giliukai ";6519139977;Taip;21;0;0;21
16174;Žiburėlis;"Giliukai ";7861704875;Taip;0;4;0;4
16175;Žiburėlis;"Giliukai ";34873231652;Taip;11;0;0;11
16176;Žiburėlis;"Giliukai ";1125662904;Taip;17;0;0;17
16177;Žiburėlis;"Giliukai ";2175751377;Taip;5;0;0;5
16178;Žiburėlis;"Giliukai ";28985997205;Taip;0;13;0;13
16179;Žiburėlis;"Giliukai ";1599112927;Taip;0;9;0;9
16180;Žiburėlis;Meškiukai;3723613593;Taip;6;2;0;8
16181;Žiburėlis;Meškiukai;8936912406;Taip;8;1;0;9
16182;Žiburėlis;Meškiukai;5205959106;Taip;3;0;2;5
16183;Žiburėlis;Meškiukai;9964255985;Taip;6;2;0;8
16184;Žiburėlis;Meškiukai;2995697464;Taip;12;1;0;13
16185;Žiburėlis;Meškiukai;7856708616;Taip;5;0;0;5
16186;Žiburėlis;Meškiukai;4003368130;Taip;17;0;0;17
16187;Žiburėlis;Meškiukai;7895148630;Taip;22;0;0;22
16188;Žiburėlis;Meškiukai;3593851196;Taip;0;7;0;7
16189;Žiburėlis;Meškiukai;1868558773;Taip;14;4;0;18
16190;Žiburėlis;Meškiukai;9470154520;Taip;9;1;2;12
16191;Žiburėlis;Meškiukai;4667559315;Taip;6;1;0;7
16192;Žiburėlis;Meškiukai;2117995780;Taip;10;0;0;10
16193;Žiburėlis;Meškiukai;2285666668;Taip;11;0;0;11
16194;Žiburėlis;Meškiukai;2836519241;Taip;22;0;0;22
16195;Žiburėlis;Viščiukai;3821663597;Taip;22;0;0;22
16196;Žiburėlis;Viščiukai;5148264064;Taip;0;9;0;9
16197;Žiburėlis;Viščiukai;8752098051;Taip;9;1;0;10
16198;Žiburėlis;Viščiukai;6274583813;Taip;6;0;0;6
16199;Žiburėlis;Viščiukai;1090883494;Taip;5;6;0;11
16200;Žiburėlis;Viščiukai;9215654134;Taip;3;1;0;4
16201;Žiburėlis;Viščiukai;9771442035;Taip;6;1;0;7
16202;Žiburėlis;Viščiukai;6946621147;Taip;13;2;0;15
16203;Žiburėlis;Viščiukai;7310274376;Taip;3;0;0;3
16204;Žiburėlis;Viščiukai;2866098551;Taip;16;0;0;16
16205;Žiburėlis;Viščiukai;4656467260;Taip;4;0;0;4
16206;Žiburėlis;Viščiukai;2500898625;Taip;3;11;0;14
16207;Žiburėlis;Viščiukai;3715070791;Taip;10;0;0;10
16208;Žiburėlis;Viščiukai;5194593598;Taip;19;1;0;20
16209;Žiburėlis;Viščiukai;2683662906;Taip;15;0;0;15
16210;Žiburėlis;"Drambliukai ";1943162133;Taip;0;1;0;1
16211;Žiburėlis;"Drambliukai ";4091901597;Taip;0;1;0;1
16212;Žiburėlis;"Drambliukai ";8440073413;Taip;21;0;0;21
16213;Žiburėlis;"Drambliukai ";6121237159;Taip;21;0;0;21
16214;Žiburėlis;"Drambliukai ";6733333096;Taip;10;0;0;10
16215;Žiburėlis;"Drambliukai ";3807588865;Taip;18;0;0;18
16216;Žiburėlis;"Drambliukai ";4432542988;Taip;22;0;0;22
16217;Žiburėlis;"Drambliukai ";4016969144;Taip;3;3;0;6
16218;Žiburėlis;"Drambliukai ";3776569251;Taip;22;0;0;22
16219;Žiburėlis;"Drambliukai ";6289338466;Taip;6;1;0;7
16220;Žiburėlis;"Drambliukai ";4783894465;Taip;0;6;0;6
16221;Žiburėlis;"Drambliukai ";9494271740;Taip;0;8;0;8
16222;Žiburėlis;"Drambliukai ";5724506894;Taip;5;8;0;13
16223;Žiburėlis;"Drambliukai ";2102574423;Taip;7;0;0;7
16224;Žiburėlis;"Drambliukai ";3992503848;Taip;0;2;0;2
16225;Žiburėlis;"Drambliukai ";4937518207;Taip;0;2;0;2
16226;Žiburėlis;"NAUJA (LOPŠELIS)";4631232618;Taip;0;4;0;4
16227;Žiburėlis;"NAUJA (LOPŠELIS)";9256751455;Taip;4;1;0;5
16228;Žiburėlis;"NAUJA (LOPŠELIS)";6128571259;Taip;0;0;2;2
16229;Žiburėlis;"NAUJA (LOPŠELIS)";8373944614;Taip;22;0;0;22
16230;Žiburėlis;"NAUJA (LOPŠELIS)";7017574924;Taip;0;3;0;3
16231;Žiburėlis;"NAUJA (LOPŠELIS)";4578828135;Taip;0;2;2;4
16232;Žiburėlis;"NAUJA (LOPŠELIS)";7343491213;Taip;0;3;1;4
16233;Žiburėlis;"NAUJA (LOPŠELIS)";9357376188;Taip;9;2;2;13
16234;Žiburėlis;"NAUJA (LOPŠELIS)";3760039280;Taip;2;0;0;2
16235;Žiburėlis;"NAUJA (LOPŠELIS)";5793531526;Taip;0;1;0;1
16236;Žiburėlis;"NAUJA (LOPŠELIS)";2077823704;Taip;7;0;0;7
16237;Žiburėlis;"NAUJA (LOPŠELIS)";4229040996;Taip;0;4;0;4
16238;Žiburėlis;"NAUJA (LOPŠELIS)";7769235807;Taip;2;0;0;2
16239;Žiburėlis;"NAUJA (LOPŠELIS)";1661456806;Taip;8;1;0;9
16240;Žiburėlis;"NAUJA DARŽELIS";4617871795;Taip;0;11;3;14
16241;Žiburėlis;"NAUJA DARŽELIS";1334695206;Taip;0;9;9;18
16242;Žiburėlis;"NAUJA DARŽELIS";6648895512;Taip;19;0;0;19
16243;Žiburėlis;"NAUJA DARŽELIS";6492467281;Taip;0;9;2;11
16244;Žiburėlis;"NAUJA DARŽELIS";3296994981;Taip;9;0;3;12
16245;Žiburėlis;"NAUJA DARŽELIS";4079793067;Taip;0;0;1;1
16246;Žiburėlis;"NAUJA DARŽELIS";5418413225;Taip;0;1;0;1
16247;Žiburėlis;"NAUJA DARŽELIS";2712358146;Taip;9;6;1;16
16248;Žiburėlis;"NAUJA DARŽELIS";6019278045;Taip;5;0;0;5
16249;Žiburėlis;"NAUJA DARŽELIS";6044837042;Taip;0;11;0;11
16250;Žiburėlis;"NAUJA DARŽELIS";1887550130;Taip;13;4;0;17
16251;Žiburėlis;"NAUJA DARŽELIS";6562748977;Ne;8;0;5;13
16252;Žiburėlis;"NAUJA DARŽELIS";3352845095;Taip;0;0;1;1
16253;Žiburėlis;"NAUJA DARŽELIS";7597762608;Taip;0;8;0;8
16254;Žiburėlis;"NAUJA DARŽELIS";4477396434;Ne;10;1;0;11
16255;Žiburėlis;"NAUJA DARŽELIS";5145195661;Taip;9;2;0;11
16256;Žiburėlis;"NAUJA DARŽELIS 7";7402647048;Taip;0;2;0;2
16257;Žiburėlis;"NAUJA DARŽELIS 7";9352485231;Taip;0;3;0;3
16258;Žiburėlis;"NAUJA DARŽELIS 7";6830200578;Ne;5;2;0;7
16259;Žiburėlis;"NAUJA DARŽELIS 7";8346571253;Taip;0;3;0;3
16260;Žiburėlis;"NAUJA DARŽELIS 7";5098955523;Taip;0;4;0;4
16261;Žiburėlis;"NAUJA DARŽELIS 7";5629404179;Taip;0;8;0;8
16262;Žiburėlis;"NAUJA DARŽELIS 7";8686565770;Taip;8;5;0;13
16263;Žiburėlis;"NAUJA DARŽELIS 7";5556807335;Taip;0;1;0;1
16264;Žiburėlis;"NAUJA DARŽELIS 7";8973307069;Taip;7;2;0;9
16265;Žiburėlis;"NAUJA DARŽELIS 7";6647598068;Taip;7;0;0;7
16266;Žiburėlis;"NAUJA DARŽELIS 7";7825665451;Taip;7;3;0;10
16267;Žiburėlis;"NAUJA DARŽELIS 7";1667968829;Taip;4;2;0;6
16268;Žiburėlis;"NAUJA DARŽELIS 7";5951659866;Taip;0;8;0;8
16269;Žiburėlis;"NAUJA DARŽELIS 7";1775465307;Taip;0;11;0;11
16270;Žiburėlis;"NAUJA DARŽELIS 7";1559091567;Taip;0;3;0;3
16271;Žiburėlis;"NAUJA DARŽELIS 7";3750024153;Taip;0;3;0;3
16272;Žiburėlis;"NAUJA DARŽELIS 6";4109288891;Taip;19;0;0;19
16273;Žiburėlis;"NAUJA DARŽELIS 6";4387021429;Taip;0;9;0;9
16274;Žiburėlis;"NAUJA DARŽELIS 6";4916545915;Taip;0;3;1;4
16275;Žiburėlis;"NAUJA DARŽELIS 6";8133371774;Taip;0;22;0;22
16276;Žiburėlis;"NAUJA DARŽELIS 6";8970153523;Taip;0;0;3;3
16277;Žiburėlis;"NAUJA DARŽELIS 6";1015624216;Taip;0;8;0;8
16278;Žiburėlis;"NAUJA DARŽELIS 6";4910787530;Taip;0;19;0;19
16279;Žiburėlis;"NAUJA DARŽELIS 6";5324852807;Ne;5;12;0;17
16280;Žiburėlis;"NAUJA DARŽELIS 6";7278242428;Taip;9;0;0;9
16281;Žiburėlis;"NAUJA DARŽELIS 6";8928649700;Taip;5;2;2;9
16282;Žiburėlis;"NAUJA DARŽELIS 6";1190058462;Taip;0;4;0;4
16283;Žiburėlis;"NAUJA DARŽELIS 6";5732540560;Ne;0;4;0;4
16284;Žiburėlis;"NAUJA DARŽELIS 6";1833704617;Taip;0;2;2;4
16285;Žiburėlis;"NAUJA DARŽELIS 6";1228806324;Taip;1;2;0;3
16286;Žiburėlis;"NAUJA DARŽELIS 6";2163018032;Taip;10;4;0;14
16287;Žiburėlis;"NAUJA DARŽELIS 6";4581800760;Taip;0;0;2;2
16288;Žiburėlis;"NAUJA DARŽELIS 6";2491972986;Taip;0;10;0;10
16289;Žiburėlis;"NAUJA DARŽELIS 6";8018718405;Taip;0;6;0;6
16290;Žiburėlis;"NAUJA DARŽELIS 6";4170747166;Taip;0;8;0;8
16291;Žiburėlis;"NAUJA DARŽELIS 6";9526477121;Taip;5;2;2;9
16292;Aidas;Boružėlių;2027860670;Taip;0;2;0;2
16293;Aidas;Boružėlių;5311183877;Taip;4;1;0;5
16294;Aidas;Boružėlių;1538635985;Taip;18;0;0;18
16295;Aidas;Boružėlių;1196172221;Ne;6;0;0;6
16296;Aidas;Boružėlių;7122041826;Taip;20;2;0;22
16297;Aidas;Drugelių;7094228848;Ne;0;5;0;5
16298;Aidas;Drugelių;5560434420;Ne;0;5;0;5
16299;Aidas;Drugelių;2070454339;Ne;8;0;0;8
16300;Aidas;Drugelių;1675384533;Taip;0;3;0;3
16301;Aidas;Drugelių;4544126354;Taip;19;0;0;19
16302;Aidas;"V-VIII A jungtinė lavinamoji klasė";62142659591;Taip;0;1;0;1
16303;Aidas;"V-VIII A jungtinė lavinamoji klasė";4990112920;Taip;3;0;0;3
16304;Aidas;"II-IV A jungtinė lavinamoji klasė";1535004699;Ne;0;15;0;15
16305;Aidas;"II-IV A jungtinė lavinamoji klasė";99943424821;Taip;0;1;0;1
16306;Aidas;"II-IV B jungtinė lavinamoji klasė";1079077463;Taip;0;9;0;9
16307;Aidas;"II-IV B jungtinė lavinamoji klasė";17920063762;Taip;0;2;0;2
16308;Aidas;"II-IV B jungtinė lavinamoji klasė";7329254454;Taip;0;22;0;22
16309;Aidas;"II-IV B jungtinė lavinamoji klasė";72751441075;Taip;0;7;0;7
16310;Aidas;"II-IV B jungtinė lavinamoji klasė";9816043688;Ne;0;7;0;7
16311;Aidas;"V-IX oji jungtinė lavinamoji klasė";2501187241;Taip;0;14;0;14
16312;Aidas;"V-IX oji jungtinė lavinamoji klasė";6213577188;Taip;11;0;0;11
16313;Aidas;"V-IX oji jungtinė lavinamoji klasė";81654551230;Ne;0;11;0;11
16314;Aidas;"V-IX oji jungtinė lavinamoji klasė";5388697695;Taip;0;3;0;3
16315;Aidas;"V-IX oji jungtinė lavinamoji klasė";92425322676;Ne;0;2;0;2
16316;Aidas;"I-II oji jungtinė lavinamoji klasė";3127870635;Taip;1;0;0;1
16317;Aidas;"I-II oji jungtinė lavinamoji klasė";3366848846;Taip;0;2;0;2
16318;Aidas;"I-II oji jungtinė lavinamoji klasė";1999375828;Taip;0;22;0;22
16319;Aidas;"I-II oji jungtinė lavinamoji klasė";2154030073;Taip;0;22;0;22
16320;Aidas;"V-VIII B jungtinė lavinamoji klasė";7740504510;Taip;0;1;0;1
16321;Aidas;"V-VIII B jungtinė lavinamoji klasė";1742331213;Taip;0;3;0;3
16322;Aidas;"V-VIII B jungtinė lavinamoji klasė";6868265902;Taip;0;22;0;22
16323;Aidas;"V-VIII B jungtinė lavinamoji klasė";2234931428;Taip;0;22;0;22
16324;Aidas;"V-VIII B jungtinė lavinamoji klasė";7354905114;Taip;3;0;0;3
16325;Aidas;"I metų socialinių įgūdžių ugdymo klasė";8642665550;Taip;0;10;0;10
16326;Aidas;"I metų socialinių įgūdžių ugdymo klasė";5309862220;Taip;0;22;0;22
16327;Aidas;"VI-X oji jungtinė lavinamoji klasė";3352587395;Taip;0;1;0;1
16328;Aidas;"VI-X oji jungtinė lavinamoji klasė";4372628947;Taip;0;7;0;7
16329;Aidas;"VI-X oji jungtinė lavinamoji klasė";9944901942;Taip;0;12;0;12
16330;Aidas;"VI-X oji jungtinė lavinamoji klasė";5570772793;Taip;0;1;0;1
16331;Aidas;"VI-X oji jungtinė lavinamoji klasė";2681438925;Taip;0;2;0;2
16332;Aidas;"VI-X oji jungtinė lavinamoji klasė";3442250711;Ne;0;3;0;3
16333;Aidas;"II-III metų socialinių įgūdžių ugdymo klasė";2945444897;Taip;0;10;0;10
16334;Aidas;"II-III metų socialinių įgūdžių ugdymo klasė";2970002617;Taip;0;22;0;22
16335;Bangelė;Aštuonkojai;7861208185;Taip;0;0;2;2
16336;Bangelė;Aštuonkojai;1377734102;Taip;0;0;3;3
16337;Bangelė;Aštuonkojai;5950451237;Ne;0;1;0;1
16338;Bangelė;Aštuonkojai;6173470021;Taip;4;0;1;5
16339;Bangelė;Aštuonkojai;6026399355;Taip;0;0;3;3
16340;Bangelė;Aštuonkojai;6927540308;Taip;0;0;5;5
16341;Bangelė;Aštuonkojai;9464115339;Taip;0;1;0;1
16342;Bangelė;Aštuonkojai;4122927034;Ne;5;2;0;7
16343;Bangelė;Aštuonkojai;3338203753;Taip;0;0;5;5
16344;Bangelė;Aštuonkojai;2503946448;Taip;0;1;0;1
16345;Bangelė;Aštuonkojai;3206495858;Taip;0;0;2;2
16346;Bangelė;Aštuonkojai;9488932192;Taip;0;0;7;7
16347;Bangelė;Delfinukai,;9143945953;Taip;0;2;0;2
16348;Bangelė;Delfinukai,;1351714626;Taip;6;2;0;8
16349;Bangelė;Delfinukai,;1754002501;Taip;0;0;2;2
16350;Bangelė;Delfinukai,;9842873660;Taip;0;7;2;9
16351;Bangelė;Delfinukai,;8875703109;Taip;0;3;0;3
16352;Bangelė;Delfinukai,;3063439996;Taip;0;13;0;13
16353;Bangelė;Delfinukai,;3022508446;Taip;0;1;0;1
16354;Bangelė;Delfinukai,;5546256869;Taip;0;4;1;5
16355;Bangelė;Delfinukai,;6980232224;Ne;0;1;1;2
16356;Bangelė;Delfinukai,;1390623903;Taip;0;7;0;7
16357;Bangelė;Delfinukai,;9788923823;Taip;0;0;22;22
16358;Bangelė;Delfinukai,;7136625230;Taip;0;11;0;11
16359;Bangelė;Delfinukai,;8748218387;Taip;0;1;0;1
16360;Bangelė;Delfinukai,;3471355267;Taip;0;0;1;1
16361;Bangelė;"Saulės spindulėliai";2059508310;Taip;0;11;0;11
16362;Bangelė;"Saulės spindulėliai";1953702121;Taip;0;4;0;4
16363;Bangelė;"Saulės spindulėliai";1594486275;Taip;0;5;0;5
16364;Bangelė;"Saulės spindulėliai";4865289474;Taip;8;0;2;10
16365;Bangelė;"Saulės spindulėliai";5135762163;Taip;0;13;0;13
16366;Bangelė;"Saulės spindulėliai";22773040549;Taip;0;2;0;2
16367;Bangelė;"Saulės spindulėliai";6508452044;Taip;5;6;0;11
16368;Bangelė;"Saulės spindulėliai";1377575533;Taip;0;2;0;2
16369;Bangelė;"Saulės spindulėliai";2032075296;Taip;5;1;0;6
16370;Bangelė;"Saulės spindulėliai";6739499483;Taip;0;5;0;5
16371;Bangelė;"Saulės spindulėliai";7059603451;Taip;6;3;0;9
16372;Bangelė;"Saulės spindulėliai";1053744221;Taip;0;0;4;4
16373;Bangelė;"Saulės spindulėliai";4187165474;Taip;0;11;0;11
16374;Bangelė;"Saulės spindulėliai";42739113312;Taip;0;0;8;8
16375;Bangelė;"Saulės spindulėliai";2195543161;Ne;0;3;0;3
16376;Bangelė;"Saulės spindulėliai";1065164865;Taip;0;0;10;10
16377;Bangelė;"Saulės spindulėliai";5142785037;Taip;8;1;0;9
16378;Bangelė;"Saulės spindulėliai";55668308050;Taip;9;8;0;17
16379;Bangelė;"Saulės spindulėliai";9150185864;Taip;0;0;1;1
16380;Bangelė;"Saulės spindulėliai";9155192250;Taip;0;0;9;9
16381;Bangelė;"Pingvinukai ";2858929915;Taip;0;2;0;2
16382;Bangelė;"Pingvinukai ";2575806242;Taip;0;13;0;13
16383;Bangelė;"Pingvinukai ";7068305612;Taip;0;19;1;20
16384;Bangelė;"Pingvinukai ";2518820268;Ne;4;0;0;4
16385;Bangelė;"Pingvinukai ";7434358474;Taip;0;16;0;16
16386;Bangelė;"Pingvinukai ";6480681705;Taip;2;3;0;5
16387;Bangelė;"Pingvinukai ";5747403413;Ne;0;17;0;17
16388;Bangelė;"Pingvinukai ";2491928697;Taip;0;0;1;1
16389;Bangelė;"Pingvinukai ";9801978617;Taip;0;2;0;2
16390;Bangelė;"Pingvinukai ";7434879947;Taip;0;5;0;5
16391;Bangelė;"Pingvinukai ";5994720767;Taip;0;2;0;2
16392;Bangelė;"Pingvinukai ";4036461205;Taip;6;1;0;7
16393;Bangelė;"Pingvinukai ";3344441441;Taip;10;0;3;13
16394;Bangelė;"Pingvinukai ";4532810332;Taip;0;4;0;4
16395;Bangelė;"Pingvinukai ";4317054990;Taip;0;2;0;2
16396;Bangelė;"Jūros žvaigždutės ";3991021350;Taip;0;0;8;8
16397;Bangelė;"Jūros žvaigždutės ";8316505307;Taip;5;6;0;11
16398;Bangelė;"Jūros žvaigždutės ";5190563034;Taip;7;0;0;7
16399;Bangelė;"Jūros žvaigždutės ";9765268154;Taip;21;0;0;21
16400;Bangelė;"Jūros žvaigždutės ";2134225414;Taip;4;0;1;5
16401;Bangelė;"Jūros žvaigždutės ";7419016784;Ne;8;4;0;12
16402;Bangelė;"Jūros žvaigždutės ";8495423628;Taip;5;0;0;5
16403;Bangelė;"Jūros žvaigždutės ";6165322599;Taip;0;10;0;10
16404;Bangelė;"Jūros žvaigždutės ";7142694888;Ne;0;0;2;2
16405;Bangelė;"Jūros žvaigždutės ";9493465898;Ne;8;0;3;11
16406;Bangelė;"Jūros žvaigždutės ";8734511431;Taip;4;1;0;5
16407;Bangelė;"Jūros žvaigždutės ";1895213200;Taip;0;0;4;4
16408;Bangelė;"Jūros žvaigždutės ";2946714377;Taip;0;0;8;8
16409;Bangelė;"Jūros žvaigždutės ";9954762483;Taip;10;4;0;14
16410;Bangelė;"Jūros žvaigždutės ";5597329949;Taip;0;0;4;4
16411;Bangelė;"Jūros žvaigždutės ";4494049529;Taip;6;0;2;8
16412;Bangelė;"Jūros žvaigždutės ";3334029244;Taip;6;3;0;9
16413;Bangelė;"Jūros žvaigždutės ";5673493708;Taip;0;22;0;22
16414;Bangelė;"Jūros žvaigždutės ";1898671487;Taip;0;6;0;6
16415;Bangelė;"Jūros žvaigždutės ";7174742281;Taip;15;3;0;18
16416;Bangelė;"Jūros žvaigždutės ";6806911810;Taip;0;0;11;11
16417;Bangelė;Žuvytės;4412780063;Ne;3;3;0;6
16418;Bangelė;Žuvytės;9009809585;Ne;0;1;0;1
16419;Bangelė;Žuvytės;6044653707;Ne;13;2;0;15
16420;Bangelė;Žuvytės;1915827035;Taip;13;2;0;15
16421;Bangelė;Žuvytės;9041585534;Taip;0;4;0;4
16422;Bangelė;Žuvytės;9706351115;Taip;0;4;0;4
16423;Bangelė;Žuvytės;6693019825;Taip;0;1;0;1
16424;Bangelė;Žuvytės;3990966706;Taip;0;13;0;13
16425;Bangelė;Žuvytės;2764009011;Taip;0;3;0;3
16426;Bangelė;Žuvytės;4338067260;Taip;0;10;0;10
16427;Bangelė;Žuvytės;8758933649;Taip;5;0;5;10
16428;Bangelė;Žuvytės;3900236858;Taip;0;1;0;1
16429;Bangelė;Žuvytės;7230987338;Taip;0;2;0;2
16430;Bangelė;Žuvytės;7337449523;Taip;0;0;2;2
16431;Bangelė;Žuvytės;1528387105;Taip;3;3;0;6
16432;Bangelė;Žuvytės;3500097405;Taip;17;0;0;17
16433;Bangelė;Ruoniai;3115177810;Taip;0;0;4;4
16434;Bangelė;Ruoniai;1790881495;Taip;0;2;0;2
16435;Bangelė;Ruoniai;1683377649;Taip;0;3;0;3
16436;Bangelė;Ruoniai;10694830733;Ne;0;4;0;4
16437;Bangelė;Ruoniai;8149880453;Taip;0;3;0;3
16438;Bangelė;Ruoniai;8836861853;Taip;9;0;0;9
16439;Bangelė;Ruoniai;2872188915;Taip;0;0;15;15
16440;Bangelė;Ruoniai;9983202427;Ne;0;2;0;2
16441;Bangelė;Ruoniai;4571869439;Taip;0;5;0;5
16442;Bangelė;Ruoniai;9672505885;Taip;0;0;9;9
16443;Bangelė;Ruoniai;7701956270;Taip;0;17;0;17
16444;Bangelė;Ruoniai;2017886238;Taip;0;2;0;2
16445;Bangelė;Ruoniai;1348995498;Ne;3;12;0;15
16446;Bangelė;"Pagrandukai ";1940743710;Taip;4;11;0;15
16447;Bangelė;"Pagrandukai ";9561221619;Taip;0;6;0;6
16448;Bangelė;"Pagrandukai ";9311379746;Taip;4;2;0;6
16449;Bangelė;"Pagrandukai ";4940247006;Taip;7;0;0;7
16450;Bangelė;"Pagrandukai ";7016039389;Taip;3;0;0;3
16451;Bangelė;"Pagrandukai ";8335931279;Taip;0;13;0;13
16452;Bangelė;"Pagrandukai ";4712616315;Taip;8;10;0;18
16453;Bangelė;"Pagrandukai ";9955097720;Taip;8;4;0;12
16454;Bangelė;"Pagrandukai ";2107766301;Taip;16;0;0;16
16455;Bangelė;"Pagrandukai ";4851593235;Taip;0;2;0;2
16456;Bangelė;"Pagrandukai ";6566277472;Taip;0;15;0;15
16457;Bangelė;"Pagrandukai ";9128326823;Taip;0;0;3;3
16458;Bangelė;"Pagrandukai ";7362196984;Taip;0;0;10;10
16459;Bangelė;"Zuikučiai ";3069288815;Taip;0;21;0;21
16460;Bangelė;"Zuikučiai ";5229147553;Taip;0;0;2;2
16461;Bangelė;"Zuikučiai ";4086446380;Taip;1;0;1;2
16462;Bangelė;"Zuikučiai ";8563674709;Taip;14;3;0;17
16463;Bangelė;"Zuikučiai ";9267349375;Taip;0;22;0;22
16464;Bangelė;"Zuikučiai ";7364368699;Taip;11;0;0;11
16465;Bangelė;"Zuikučiai ";6400785821;Taip;0;0;4;4
16466;Bangelė;"Zuikučiai ";1954786116;Taip;0;22;0;22
16467;Bangelė;"Zuikučiai ";4831656996;Taip;7;3;0;10
16468;Bangelė;"Zuikučiai ";1544311819;Ne;5;1;0;6
16469;Bangelė;"Zuikučiai ";6705583340;Taip;0;0;3;3
16470;Bangelė;"Zuikučiai ";2558088727;Taip;0;22;0;22
16471;Bangelė;"Zuikučiai ";8745595583;Taip;11;0;1;12
16472;Bangelė;Nauja;4651237403;Taip;3;0;0;3
16473;Bangelė;Nauja;8661284187;Taip;7;0;0;7
16474;Bangelė;Nauja;9608900293;Taip;6;0;0;6
16475;Bangelė;Nauja;4080993439;Taip;0;7;3;10
16476;Bangelė;Nauja;2662758502;Ne;4;3;0;7
16477;Bangelė;Nauja;6174617493;Taip;0;0;2;2
16478;Bangelė;Nauja;9633372201;Ne;4;2;3;9
16479;Gėlynas;PAKALNUTĖ;5145396320;Taip;0;0;5;5
16480;Gėlynas;PAKALNUTĖ;4445250490;Taip;0;1;0;1
16481;Gėlynas;PAKALNUTĖ;1897547388;Taip;0;11;0;11
16482;Gėlynas;PAKALNUTĖ;9911225363;Taip;0;8;2;10
16483;Gėlynas;PAKALNUTĖ;1257113113;Taip;0;6;0;6
16484;Gėlynas;PAKALNUTĖ;6898127005;Taip;0;4;0;4
16485;Gėlynas;PAKALNUTĖ;2906909558;Taip;4;0;6;10
16486;Gėlynas;PAKALNUTĖ;3365442661;Taip;4;0;10;14
16487;Gėlynas;PAKALNUTĖ;77283628988;Taip;0;2;0;2
16488;Gėlynas;PAKALNUTĖ;6528464599;Taip;0;9;0;9
16489;Gėlynas;PAKALNUTĖ;8464074679;Taip;0;0;1;1
16490;Gėlynas;PAKALNUTĖ;5395474698;Ne;0;3;0;3
16491;Gėlynas;PAKALNUTĖ;90046802421;Taip;0;4;0;4
16492;Gėlynas;PAKALNUTĖ;8615943743;Taip;0;6;0;6
16493;Gėlynas;PAKALNUTĖ;7814357385;Taip;0;3;0;3
16494;Gėlynas;PAKALNUTĖ;1674569569;Taip;3;0;0;3
16495;Gėlynas;PAKALNUTĖ;5695333666;Taip;0;1;0;1
16496;Gėlynas;PAKALNUTĖ;7730322729;Taip;0;3;0;3
16497;Gėlynas;PAKALNUTĖ;7877521812;Taip;0;1;0;1
16498;Gėlynas;PAKALNUTĖ;2132298690;Taip;10;0;0;10
16499;Gėlynas;VARPELIS;1406567756;Taip;0;3;0;3
16500;Gėlynas;VARPELIS;2100188574;Taip;0;1;0;1
16501;Gėlynas;VARPELIS;1608626732;Taip;0;2;0;2
16502;Gėlynas;VARPELIS;86881175896;Taip;0;16;0;16
16503;Gėlynas;VARPELIS;17587435701;Taip;0;0;1;1
16504;Gėlynas;VARPELIS;1363040744;Taip;0;0;1;1
16505;Gėlynas;VARPELIS;1053422007;Taip;3;0;0;3
16506;Gėlynas;VARPELIS;2099722437;Taip;0;1;0;1
16507;Gėlynas;VARPELIS;2018911523;Taip;10;0;10;20
16508;Gėlynas;VARPELIS;47220216751;Taip;0;5;0;5
16509;Gėlynas;VARPELIS;85310323038;Taip;3;0;0;3
16510;Gėlynas;VARPELIS;7796794153;Taip;0;5;0;5
16511;Gėlynas;VARPELIS;1117528954;Taip;0;8;0;8
16512;Gėlynas;VARPELIS;57429063547;Taip;0;3;0;3
16513;Gėlynas;RAKTAŽOLĖ;6264361257;Taip;0;3;0;3
16514;Gėlynas;RAKTAŽOLĖ;1754734306;Taip;0;1;0;1
16515;Gėlynas;RAKTAŽOLĖ;84546885977;Taip;0;8;0;8
16516;Gėlynas;RAKTAŽOLĖ;7808971151;Taip;0;7;0;7
16517;Gėlynas;RAKTAŽOLĖ;1036951275;Taip;6;8;0;14
16518;Gėlynas;RAKTAŽOLĖ;7337987259;Taip;0;1;0;1
16519;Gėlynas;RAKTAŽOLĖ;4382465307;Taip;7;5;0;12
16520;Gėlynas;RAKTAŽOLĖ;7562201835;Taip;0;8;0;8
16521;Gėlynas;RAKTAŽOLĖ;1557503831;Taip;0;16;0;16
16522;Gėlynas;RAKTAŽOLĖ;2417880374;Taip;5;0;2;7
16523;Gėlynas;RAKTAŽOLĖ;3491517766;Taip;5;0;0;5
16524;Gėlynas;RAKTAŽOLĖ;4505012978;Taip;0;2;0;2
16525;Gėlynas;RAKTAŽOLĖ;5124029118;Taip;15;5;0;20
16526;Gėlynas;RAKTAŽOLĖ;8999346908;Taip;0;6;0;6
16527;Gėlynas;RAKTAŽOLĖ;1004866224;Taip;0;0;2;2
16528;Gėlynas;RAKTAŽOLĖ;9382160515;Ne;0;1;0;1
16529;Gėlynas;SAULĖGRĄŽA;7150367866;Taip;2;0;0;2
16530;Gėlynas;SAULĖGRĄŽA;1505666690;Taip;0;0;3;3
16531;Gėlynas;SAULĖGRĄŽA;3492361041;Taip;3;5;0;8
16532;Gėlynas;SAULĖGRĄŽA;6451922757;Taip;3;0;0;3
16533;Gėlynas;SAULĖGRĄŽA;2742456983;Taip;0;9;0;9
16534;Gėlynas;SAULĖGRĄŽA;9305282699;Taip;0;2;0;2
16535;Gėlynas;SAULĖGRĄŽA;6815740588;Taip;8;9;0;17
16536;Gėlynas;SAULĖGRĄŽA;3606076029;Taip;0;4;0;4
16537;Gėlynas;SAULĖGRĄŽA;5964419627;Taip;0;2;0;2
16538;Gėlynas;SAULĖGRĄŽA;9330385153;Taip;0;1;0;1
16539;Gėlynas;SAULĖGRĄŽA;9724668402;Taip;0;1;0;1
16540;Gėlynas;SAULĖGRĄŽA;2784709117;Taip;0;1;4;5
16541;Gėlynas;SAULĖGRĄŽA;6114995335;Taip;3;1;1;5
16542;Gėlynas;SAULĖGRĄŽA;5320531856;Taip;0;11;0;11
16543;Gėlynas;SAULĖGRĄŽA;7998013477;Taip;0;0;3;3
16544;Gėlynas;SAULĖGRĄŽA;6042268146;Taip;0;0;2;2
16545;Gėlynas;RAMUNĖLĖ;1665668966;Taip;3;0;8;11
16546;Gėlynas;RAMUNĖLĖ;5751256561;Taip;13;0;2;15
16547;Gėlynas;RAMUNĖLĖ;7504469409;Taip;3;0;1;4
16548;Gėlynas;RAMUNĖLĖ;6053841081;Taip;7;1;0;8
16549;Gėlynas;RAMUNĖLĖ;1590299264;Taip;0;4;0;4
16550;Gėlynas;RAMUNĖLĖ;3470963396;Taip;9;6;0;15
16551;Gėlynas;RAMUNĖLĖ;1548317086;Taip;0;0;1;1
16552;Gėlynas;RAMUNĖLĖ;7389502638;Taip;8;12;0;20
16553;Gėlynas;RAMUNĖLĖ;4557380282;Taip;4;0;0;4
16554;Gėlynas;RAMUNĖLĖ;9707677931;Taip;0;6;0;6
16555;Gėlynas;RAMUNĖLĖ;2171064300;Taip;0;6;0;6
16556;Gėlynas;RAMUNĖLĖ;2404562144;Taip;0;1;0;1
16557;Gėlynas;RAMUNĖLĖ;8693415786;Taip;0;1;0;1
16558;Gėlynas;RAMUNĖLĖ;7064068912;Taip;5;0;6;11
16559;Gėlynas;RAMUNĖLĖ;6884111634;Taip;0;0;1;1
16560;Gėlynas;RAMUNĖLĖ;1463783538;Taip;10;0;1;11
16561;Gėlynas;RAMUNĖLĖ;4366442459;Taip;13;0;1;14
16562;Gėlynas;ŽIBUTĖ;1015554617;Taip;0;1;0;1
16563;Gėlynas;ŽIBUTĖ;1822933936;Taip;8;0;0;8
16564;Gėlynas;ŽIBUTĖ;8444505017;Taip;16;4;0;20
16565;Gėlynas;ŽIBUTĖ;2273705177;Taip;0;10;8;18
16566;Gėlynas;ŽIBUTĖ;5350834071;Taip;0;0;5;5
16567;Gėlynas;ŽIBUTĖ;5826067446;Taip;0;9;0;9
16568;Gėlynas;ŽIBUTĖ;6296728638;Taip;0;2;0;2
16569;Gėlynas;ŽIBUTĖ;5382148888;Taip;9;0;0;9
16570;Gėlynas;ŽIBUTĖ;4668195919;Taip;6;4;0;10
16571;Gėlynas;ŽIBUTĖ;6875794958;Taip;2;4;0;6
16572;Gėlynas;ŽIBUTĖ;8555408466;Taip;10;2;0;12
16573;Gėlynas;ŽIBUTĖ;4192292896;Taip;0;19;0;19
16574;Gėlynas;ŽIBUTĖ;8080660097;Taip;5;1;0;6
16575;Gėlynas;ŽIBUTĖ;6826311903;Taip;0;5;0;5
16576;Gėlynas;ŽIBUTĖ;8447789767;Taip;0;10;0;10
16577;Obelėlė;Gudručiai;2014314139;Ne;0;1;0;1
16578;Obelėlė;Gudručiai;9900484892;Taip;10;0;0;10
16579;Obelėlė;Gudručiai;6145113624;Taip;0;5;0;5
16580;Obelėlė;Gudručiai;9586720282;Taip;4;0;3;7
16581;Obelėlė;Gudručiai;4015702815;Taip;22;0;0;22
16582;Obelėlė;Gudručiai;5141585309;Taip;0;3;0;3
16583;Obelėlė;Gudručiai;6720058972;Taip;4;0;0;4
16584;Obelėlė;Gudručiai;4451814487;Taip;11;0;0;11
16585;Obelėlė;Gudručiai;2053807216;Taip;16;0;0;16
16586;Obelėlė;Gudručiai;2204293216;Ne;0;5;0;5
16587;Obelėlė;Gudručiai;1184082097;Taip;21;0;0;21
16588;Obelėlė;Gudručiai;1312484983;Taip;0;0;3;3
16589;Obelėlė;Gudručiai;1565630870;Taip;0;6;0;6
16590;Obelėlė;Gudručiai;1598785483;Taip;0;4;0;4
16591;Obelėlė;Drugeliai;9059791812;Taip;0;7;0;7
16592;Obelėlė;Drugeliai;65578250853;Taip;0;0;1;1
16593;Obelėlė;Drugeliai;1061262980;Taip;3;0;4;7
16594;Obelėlė;Pasakaitė;1695933896;Ne;0;1;1;2
16595;Obelėlė;Pasakaitė;1543298097;Taip;0;4;0;4
16596;Obelėlė;Pasakaitė;79601449969;Taip;0;9;0;9
16597;Obelėlė;Pasakaitė;4257479486;Taip;0;0;2;2
16598;Obelėlė;Pasakaitė;8394566707;Taip;0;0;1;1
16599;Obelėlė;Pasakaitė;9527363918;Taip;0;8;0;8
16600;Obelėlė;Pasakaitė;10939948244;Taip;0;4;0;4
16601;Obelėlė;Pasakaitė;1707652145;Taip;2;0;0;2
16602;Obelėlė;Pasakaitė;1893470952;Taip;0;3;2;5
16603;Obelėlė;Pasakaitė;7754276632;Taip;0;22;0;22
16604;Obelėlė;Pasakaitė;69055416041;Taip;0;0;5;5
16605;Obelėlė;Svajokliai;9981446556;Taip;3;0;2;5
16606;Obelėlė;Svajokliai;4849499826;Taip;0;1;0;1
16607;Obelėlė;Svajokliai;1469593267;Taip;10;0;2;12
16608;Obelėlė;Svajokliai;9819048265;Taip;17;5;0;22
16609;Obelėlė;Svajokliai;1010954005;Taip;8;0;0;8
16610;Obelėlė;Svajokliai;4489212434;Taip;3;0;2;5
16611;Obelėlė;Svajokliai;6325027163;Taip;0;0;3;3
16612;Obelėlė;Svajokliai;5588467580;Taip;0;22;0;22
16613;Obelėlė;Svajokliai;7094715237;Taip;2;0;1;3
16614;Obelėlė;Svajokliai;8231489868;Taip;6;4;0;10
16615;Obelėlė;Svajokliai;3986892111;Taip;0;8;1;9
16616;Obelėlė;Svajokliai;7003947655;Taip;0;1;0;1
16617;Obelėlė;Svajokliai;9641297002;Taip;0;0;1;1
16618;Obelėlė;Svajokliai;8918176312;Taip;6;0;2;8
16619;Obelėlė;Svajokliai;8604451971;Taip;0;0;2;2
16620;Obelėlė;Svajokliai;6785654280;Taip;3;0;1;4
16621;Obelėlė;Svajokliai;6311322617;Taip;8;3;0;11
16622;Obelėlė;Svajokliai;2813927086;Taip;6;0;4;10
16623;Obelėlė;Smalsučiai;6497584911;Taip;7;0;1;8
16624;Obelėlė;Smalsučiai;7687093936;Taip;0;4;2;6
16625;Obelėlė;Smalsučiai;9323228591;Taip;3;0;0;3
16626;Obelėlė;Smalsučiai;7108517080;Taip;10;0;0;10
16627;Obelėlė;Smalsučiai;6008839269;Taip;2;1;0;3
16628;Obelėlė;Smalsučiai;4987747783;Taip;0;0;2;2
16629;Obelėlė;Smalsučiai;5085970254;Taip;5;0;1;6
16630;Obelėlė;Smalsučiai;8709758561;Taip;3;0;4;7
16631;Obelėlė;Smalsučiai;4318546408;Taip;4;9;0;13
16632;Obelėlė;Smalsučiai;5739522736;Taip;3;0;2;5
16633;Obelėlė;Smalsučiai;2631405243;Ne;0;0;2;2
16634;Obelėlė;Smalsučiai;8173307704;Taip;4;0;4;8
16635;Obelėlė;Smalsučiai;9796759067;Taip;0;8;0;8
16636;Obelėlė;Smalsučiai;6720808705;Taip;0;0;5;5
16637;Obelėlė;Smalsučiai;7850656031;Taip;0;0;1;1
16638;Obelėlė;Smalsučiai;9084969712;Taip;0;0;7;7
16639;Obelėlė;Smalsučiai;6364101139;Taip;0;0;6;6
16640;Obelėlė;Smalsučiai;8183287212;Taip;2;3;2;7
16641;Obelėlė;Pabiručiai;1547195948;Taip;0;2;1;3
16642;Obelėlė;Pabiručiai;1586544097;Taip;0;2;1;3
16643;Obelėlė;Pabiručiai;94350358246;Taip;0;0;2;2
16644;Obelėlė;Pabiručiai;74915473313;Taip;6;0;0;6
16645;Obelėlė;Pabiručiai;79388410820;Taip;0;0;1;1
16646;Obelėlė;Pabiručiai;40103909643;Taip;0;9;0;9
16647;Obelėlė;Pabiručiai;2662966388;Taip;1;0;0;1
16648;Obelėlė;Pabiručiai;2678719111;Taip;2;0;0;2
16649;Obelėlė;Pabiručiai;1420633482;Taip;7;0;2;9
16650;Obelėlė;Pabiručiai;31018018065;Taip;3;4;0;7
16651;Obelėlė;Pabiručiai;2015165566;Taip;10;0;0;10
16652;Obelėlė;Pabiručiai;16430825029;Taip;0;5;0;5
16653;Obelėlė;Pabiručiai;8882103124;Taip;0;0;1;1
16654;Obelėlė;Pabiručiai;5471194804;Taip;0;8;1;9
16655;Obelėlė;Pabiručiai;74455701543;Taip;12;0;5;17
16656;Obelėlė;Pabiručiai;74564453474;Taip;0;10;0;10
16657;Obelėlė;Pabiručiai;8173154620;Taip;0;0;2;2
16658;Obelėlė;Strakaliukai;2770477678;Taip;0;8;0;8
16659;Obelėlė;Strakaliukai;8754552660;Taip;10;0;4;14
16660;Obelėlė;Strakaliukai;9716500560;Taip;4;0;0;4
16661;Obelėlė;Strakaliukai;4251418414;Taip;2;0;1;3
16662;Obelėlė;Strakaliukai;7128421330;Taip;0;0;3;3
16663;Obelėlė;Strakaliukai;5943314566;Taip;0;22;0;22
16664;Obelėlė;Strakaliukai;3116100694;Taip;0;2;0;2
16665;Obelėlė;Strakaliukai;5741823041;Taip;0;8;0;8
16666;Obelėlė;Strakaliukai;8050551266;Taip;5;0;1;6
16667;Obelėlė;Strakaliukai;7468335279;Taip;4;1;0;5
16668;Obelėlė;Strakaliukai;1180508643;Taip;0;0;2;2
16669;Obelėlė;Strakaliukai;7124393375;Taip;0;0;8;8
16670;Obelėlė;Strakaliukai;1040304018;Taip;1;7;1;9
16671;Obelėlė;Strakaliukai;5001844064;Taip;3;1;0;4
16672;Obelėlė;Strakaliukai;9976694313;Taip;0;0;1;1
16673;Obelėlė;Saulutė;98290583667;Taip;2;0;2;4
16674;Obelėlė;Saulutė;77954383604;Taip;0;0;4;4
16675;Obelėlė;Saulutė;1826138505;Taip;0;1;0;1
16676;Obelėlė;Saulutė;38968623613;Taip;5;0;0;5
16677;Obelėlė;Saulutė;1240673124;Taip;0;0;3;3
16678;Obelėlė;Saulutė;24010838180;Taip;0;1;0;1
16679;Obelėlė;Saulutė;1935023634;Taip;0;0;2;2
16680;Obelėlė;Saulutė;2099500866;Taip;0;0;3;3
16681;Obelėlė;Saulutė;1352415596;Ne;0;4;2;6
16682;Obelėlė;Saulutė;3076493150;Taip;0;1;0;1
16683;Obelėlė;Saulutė;1521926754;Taip;0;0;7;7
16684;Obelėlė;Saulutė;6720229368;Ne;0;4;3;7
16685;Obelėlė;Saulutė;4107928390;Taip;0;0;1;1
16686;Obelėlė;Saulutė;4396725994;Taip;0;0;4;4
16687;Obelėlė;Saulutė;14574836082;Taip;5;0;0;5
16688;Obelėlė;Saulutė;5973972464;Taip;3;0;0;3
16689;Obelėlė;Rieduliukai;6470533765;Taip;16;0;0;16
16690;Obelėlė;Rieduliukai;8223715886;Taip;16;0;0;16
16691;Obelėlė;Rieduliukai;2730569223;Taip;0;0;3;3
16692;Obelėlė;Rieduliukai;7491934262;Taip;1;2;0;3
16693;Obelėlė;Rieduliukai;1858251094;Taip;0;0;1;1
16694;Obelėlė;Rieduliukai;9043542844;Taip;0;0;2;2
16695;Obelėlė;Rieduliukai;2893378990;Taip;8;0;3;11
16696;Obelėlė;Rieduliukai;6874039388;Taip;0;0;7;7
16697;Obelėlė;Rieduliukai;4218895290;Taip;8;8;0;16
16698;Obelėlė;Rieduliukai;4209489251;Taip;3;16;0;19
16699;Obelėlė;Rieduliukai;8461505586;Taip;0;5;1;6
16700;Obelėlė;Rieduliukai;4309622934;Taip;6;2;1;9
16701;Obelėlė;Rieduliukai;4321210604;Taip;8;0;0;8
16702;Obelėlė;Rieduliukai;1472630240;Taip;5;0;0;5
16703;Obelėlė;Žirniukai;6161821339;Taip;10;0;7;17
16704;Obelėlė;Žirniukai;5599466885;Taip;0;22;0;22
16705;Obelėlė;Žirniukai;2035035265;Taip;0;0;3;3
16706;Obelėlė;Žirniukai;4851824672;Taip;4;7;0;11
16707;Obelėlė;Žirniukai;2262107831;Taip;0;0;3;3
16708;Obelėlė;Žirniukai;3951816174;Taip;5;0;0;5
16709;Obelėlė;Žirniukai;8948297718;Taip;0;0;1;1
16710;Obelėlė;Žirniukai;8579887226;Taip;0;6;0;6
16711;Obelėlė;Žirniukai;5763713052;Taip;12;0;0;12
16712;Obelėlė;Bičiuliai;3425736276;Taip;9;0;0;9
16713;Obelėlė;Bičiuliai;1507072248;Taip;2;0;2;4
16714;Obelėlė;Bičiuliai;5776116844;Taip;2;3;0;5
16715;Obelėlė;Bičiuliai;8487088625;Taip;0;1;0;1
16716;Obelėlė;Bičiuliai;1630067014;Taip;0;22;0;22
16717;Obelėlė;Bičiuliai;1537769810;Taip;0;0;3;3
16718;Obelėlė;Bičiuliai;8371648703;Taip;0;0;1;1
16719;Obelėlė;Bičiuliai;3517342646;Taip;7;0;0;7
16720;Obelėlė;Bičiuliai;2329734472;Taip;0;0;1;1
16721;Obelėlė;Bičiuliai;8155712451;Taip;0;0;1;1
16722;Obelėlė;Bičiuliai;7934760271;Taip;4;0;3;7
16723;Obelėlė;Bičiuliai;4849175527;Ne;0;0;2;2
16724;Obelėlė;Bičiuliai;3769993089;Taip;0;0;1;1
16725;Obelėlė;Kodėlčiukai;9960526051;Taip;1;0;0;1
16726;Obelėlė;Kodėlčiukai;1050919659;Taip;0;0;4;4
16727;Obelėlė;Kodėlčiukai;7014872044;Taip;5;0;0;5
16728;Obelėlė;Kodėlčiukai;4717038536;Taip;0;0;2;2
16729;Obelėlė;Kodėlčiukai;4840134079;Taip;8;8;0;16
16730;Obelėlė;Kodėlčiukai;8762518354;Taip;0;0;1;1
16731;Obelėlė;Kodėlčiukai;3320493372;Taip;13;9;0;22
16732;Obelėlė;Kodėlčiukai;8366162313;Taip;5;0;0;5
16733;Obelėlė;Kodėlčiukai;7901070568;Taip;3;0;0;3
16734;Obelėlė;Kodėlčiukai;6481365666;Taip;0;22;0;22
16735;Obelėlė;Kodėlčiukai;2227383487;Taip;0;0;5;5
16736;Obelėlė;Kodėlčiukai;8818153952;Taip;14;0;1;15
16737;Obelėlė;Kodėlčiukai;4887103549;Taip;5;0;0;5
16738;Obelėlė;Kodėlčiukai;5221918341;Taip;8;0;4;12
16739;Obelėlė;Kodėlčiukai;7696478568;Taip;0;0;4;4
16740;Obelėlė;Kodėlčiukai;7422668691;Taip;13;0;0;13
16741;Spygliukas;Bitutės;5827455834;Taip;0;2;0;2
16742;Spygliukas;Bitutės;9975117461;Taip;0;0;5;5
16743;Spygliukas;Bitutės;16828631895;Taip;0;1;7;8
16744;Spygliukas;Bitutės;4653108810;Taip;0;3;0;3
16745;Spygliukas;Bitutės;7421000718;Taip;3;7;1;11
16746;Spygliukas;Bitutės;8103481313;Taip;5;7;1;13
16747;Spygliukas;Bitutės;5022615426;Taip;2;6;0;8
16748;Spygliukas;Bitutės;7250958367;Taip;0;2;0;2
16749;Spygliukas;Bitutės;1679263120;Taip;9;0;0;9
16750;Spygliukas;Bitutės;9001243644;Taip;8;9;5;22
16751;Spygliukas;Bitutės;8646122773;Taip;0;4;0;4
16752;Spygliukas;Bitutės;4933577424;Taip;0;5;0;5
16753;Spygliukas;Bitutės;8992822256;Taip;0;1;0;1
16754;Spygliukas;Bitutės;1940209166;Taip;1;0;0;1
16755;Spygliukas;Bitutės;1855897974;Taip;10;1;0;11
16756;Spygliukas;Bitutės;1238940921;Taip;0;0;1;1
16757;Spygliukas;Bitutės;9797138740;Taip;0;0;12;12
16758;Spygliukas;Kiškučiai;1927028026;Taip;11;4;0;15
16759;Spygliukas;Kiškučiai;3094528907;Taip;4;0;0;4
16760;Spygliukas;Kiškučiai;9813995933;Taip;10;9;0;19
16761;Spygliukas;Kiškučiai;4013601534;Taip;19;0;0;19
16762;Spygliukas;Kiškučiai;3959136555;Taip;0;22;0;22
16763;Spygliukas;Kiškučiai;6383264068;Taip;8;0;0;8
16764;Spygliukas;Kiškučiai;5369930705;Taip;14;0;0;14
16765;Spygliukas;Kiškučiai;6344932171;Taip;0;0;2;2
16766;Spygliukas;Kiškučiai;4340767624;Taip;0;0;4;4
16767;Spygliukas;Kiškučiai;6246925536;Taip;5;0;0;5
16768;Spygliukas;Kiškučiai;1037321774;Taip;5;1;0;6
16769;Spygliukas;Boružėlės;3569857813;Taip;0;5;0;5
16770;Spygliukas;Boružėlės;6931145017;Taip;3;0;3;6
16771;Spygliukas;Boružėlės;8802722601;Taip;0;0;3;3
16772;Spygliukas;Boružėlės;9285259322;Taip;0;3;0;3
16773;Spygliukas;Boružėlės;1341333016;Taip;22;0;0;22
16774;Spygliukas;Boružėlės;8806126755;Taip;8;0;1;9
16775;Spygliukas;Boružėlės;4477402331;Taip;15;0;0;15
16776;Spygliukas;Boružėlės;2772801133;Taip;4;0;1;5
16777;Spygliukas;Boružėlės;4245624629;Taip;7;0;0;7
16778;Spygliukas;Boružėlės;6332646009;Taip;4;0;0;4
16779;Spygliukas;Boružėlės;5765106914;Taip;0;1;0;1
16780;Spygliukas;Boružėlės;3416275094;Taip;10;0;6;16
16781;Spygliukas;Boružėlės;6248409896;Taip;9;0;0;9
16782;Spygliukas;Boružėlės;8708083787;Taip;0;6;0;6
16783;Spygliukas;Boružėlės;8825264090;Taip;0;0;4;4
16784;Spygliukas;Ežiukai;6242194100;Taip;3;0;2;5
16785;Spygliukas;Ežiukai;5778081118;Taip;8;0;4;12
16786;Spygliukas;Ežiukai;4577592862;Taip;3;1;3;7
16787;Spygliukas;Ežiukai;6835488489;Taip;4;0;0;4
16788;Spygliukas;Ežiukai;50047868918;Taip;4;1;0;5
16789;Spygliukas;Ežiukai;6457632191;Taip;0;0;1;1
16790;Spygliukas;Ežiukai;1691209405;Taip;0;0;1;1
16791;Spygliukas;Ežiukai;9178184431;Taip;8;5;0;13
16792;Spygliukas;Ežiukai;2739564216;Taip;0;0;4;4
16793;Spygliukas;Ežiukai;4610504338;Taip;4;0;0;4
16794;Spygliukas;Ežiukai;7900652746;Taip;0;9;0;9
16795;Spygliukas;Ežiukai;8048474808;Taip;0;0;7;7
16796;Spygliukas;Ežiukai;8331205164;Taip;3;4;0;7
16797;Spygliukas;Ežiukai;1662885055;Taip;3;0;3;6
16798;Spygliukas;Geniukai;8404929784;Taip;0;2;0;2
16799;Spygliukas;Geniukai;4835818382;Taip;5;1;0;6
16800;Spygliukas;Geniukai;3041184642;Taip;11;0;0;11
16801;Spygliukas;Geniukai;9070219319;Taip;0;5;0;5
16802;Spygliukas;Geniukai;9413950200;Taip;0;2;0;2
16803;Spygliukas;Geniukai;8869320003;Taip;0;5;6;11
16804;Spygliukas;Geniukai;8476882854;Taip;4;5;0;9
16805;Spygliukas;Geniukai;8270525839;Taip;9;4;0;13
16806;Spygliukas;Geniukai;3697691132;Taip;3;2;0;5
16807;Spygliukas;Geniukai;4053158210;Taip;0;1;0;1
16808;Spygliukas;Geniukai;2395961015;Taip;0;6;0;6
16809;Spygliukas;Geniukai;4454348462;Taip;7;8;4;19
16810;Spygliukas;Geniukai;5134327772;Taip;0;1;4;5
16811;Spygliukas;Geniukai;3761715811;Taip;10;0;0;10
16812;Spygliukas;Geniukai;1550737449;Taip;5;0;0;5
16813;Spygliukas;Riešutėliai;26697357569;Taip;0;1;0;1
16814;Spygliukas;Riešutėliai;7649832094;Taip;0;4;3;7
16815;Spygliukas;Riešutėliai;3037648954;Taip;0;1;0;1
16816;Spygliukas;Riešutėliai;42285404110;Taip;0;0;2;2
16817;Spygliukas;Riešutėliai;29015391754;Taip;0;1;0;1
16818;Spygliukas;Riešutėliai;1832756255;Taip;0;0;1;1
16819;Spygliukas;Riešutėliai;1881745347;Taip;0;3;0;3
16820;Spygliukas;Riešutėliai;53324066837;Ne;0;0;1;1
16821;Spygliukas;Riešutėliai;2040903312;Taip;3;6;0;9
16822;Spygliukas;Riešutėliai;1211969263;Taip;0;5;0;5
16823;Spygliukas;Riešutėliai;9957292202;Taip;0;0;2;2
16824;Spygliukas;Riešutėliai;7219659640;Taip;0;2;0;2
16825;Spygliukas;Riešutėliai;84556142803;Taip;0;5;0;5
16826;Spygliukas;Riešutėliai;1298381738;Taip;0;0;6;6
16827;Spygliukas;Riešutėliai;2901031642;Taip;0;9;0;9
16828;Spygliukas;Riešutėliai;1260920726;Taip;0;8;0;8
16829;Spygliukas;Riešutėliai;4355472423;Taip;0;0;1;1
16830;Spygliukas;Riešutėliai;8686118262;Taip;4;3;1;8
16831;Spygliukas;Pelėdžiukai;1323720621;Taip;0;4;1;5
16832;Spygliukas;Pelėdžiukai;1002603766;Taip;0;12;0;12
16833;Spygliukas;Pelėdžiukai;1842315404;Taip;0;6;0;6
16834;Spygliukas;Pelėdžiukai;1151844475;Taip;0;0;4;4
16835;Spygliukas;Pelėdžiukai;30201229961;Taip;0;9;0;9
16836;Spygliukas;Pelėdžiukai;9288806012;Taip;0;1;0;1
16837;Spygliukas;Pelėdžiukai;79584454527;Taip;0;4;0;4
16838;Spygliukas;Pelėdžiukai;92279064240;Taip;0;6;0;6
16839;Spygliukas;Pelėdžiukai;10858715103;Taip;0;0;1;1
16840;Spygliukas;Pelėdžiukai;4104158994;Taip;0;1;0;1
16841;Spygliukas;Pelėdžiukai;1321926079;Taip;0;0;1;1
16842;Spygliukas;Pelėdžiukai;73047963456;Taip;0;0;2;2
16843;Spygliukas;Pelėdžiukai;34209607173;Taip;0;6;0;6
16844;Spygliukas;Pelėdžiukai;9513387087;Ne;0;0;8;8
16845;Spygliukas;Pelėdžiukai;1030973848;Taip;9;0;0;9
16846;Spygliukas;Pelėdžiukai;45881077771;Taip;0;4;0;4
16847;Spygliukas;Pelėdžiukai;52719709314;Taip;0;2;0;2
16848;Spygliukas;Pelėdžiukai;1415694208;Taip;0;0;2;2
16849;Spygliukas;Pelėdžiukai;29449834997;Taip;9;0;3;12
16850;Spygliukas;Zylutės;9465470810;Taip;11;0;0;11
16851;Spygliukas;Zylutės;8366571422;Taip;3;0;0;3
16852;Spygliukas;Zylutės;9783154498;Taip;0;0;4;4
16853;Spygliukas;Zylutės;4417471958;Taip;14;8;0;22
16854;Spygliukas;Zylutės;3811864870;Taip;3;0;1;4
16855;Spygliukas;Zylutės;4177369871;Taip;10;2;0;12
16856;Spygliukas;Zylutės;8105507156;Taip;4;0;0;4
16857;Spygliukas;Zylutės;6858338620;Taip;0;0;7;7
16858;Spygliukas;Zylutės;8581453160;Taip;3;0;0;3
16859;Spygliukas;Zylutės;9601530981;Taip;6;0;0;6
16860;Spygliukas;Zylutės;3066293772;Ne;18;0;0;18
16861;Spygliukas;Zylutės;3988253265;Taip;2;0;5;7
16862;Spygliukas;Zylutės;5625257865;Taip;2;0;6;8
16863;Spygliukas;Zylutės;3268222954;Taip;11;0;0;11
16864;Spygliukas;Zylutės;1775612723;Taip;4;0;0;4
16865;Spygliukas;Zylutės;5006372835;Taip;7;0;0;7
16866;Spygliukas;Skruzdėliukai;1983112873;Taip;5;0;2;7
16867;Spygliukas;Skruzdėliukai;4615217628;Taip;0;1;4;5
16868;Spygliukas;Skruzdėliukai;2184487073;Taip;1;0;0;1
16869;Spygliukas;Skruzdėliukai;5612894706;Taip;0;9;0;9
16870;Spygliukas;Skruzdėliukai;6552944183;Taip;1;0;1;2
16871;Spygliukas;Skruzdėliukai;1353217998;Taip;5;0;0;5
16872;Spygliukas;Skruzdėliukai;7749937772;Taip;8;1;0;9
16873;Spygliukas;Skruzdėliukai;2719100414;Taip;5;1;1;7
16874;Spygliukas;Skruzdėliukai;1429613380;Taip;8;1;0;9
16875;Spygliukas;Skruzdėliukai;4026252608;Taip;10;2;1;13
16876;Spygliukas;Skruzdėliukai;9321493897;Taip;1;0;1;2
16877;Spygliukas;Skruzdėliukai;7908419787;Taip;6;0;4;10
16878;Spygliukas;Skruzdėliukai;5366783639;Taip;0;1;0;1
16879;Spygliukas;Skruzdėliukai;3088387895;Taip;8;0;0;8
16880;Spygliukas;Skruzdėliukai;7287543571;Taip;7;6;1;14
16881;Spygliukas;Voveraitės;9112172144;Taip;4;0;5;9
16882;Spygliukas;Voveraitės;7897603878;Taip;0;3;0;3
16883;Spygliukas;Voveraitės;7741841634;Taip;0;4;0;4
16884;Spygliukas;Voveraitės;3077468722;Taip;12;0;0;12
16885;Spygliukas;Voveraitės;1177439438;Taip;0;8;0;8
16886;Spygliukas;Voveraitės;4948147941;Taip;4;0;0;4
16887;Spygliukas;Voveraitės;6587957213;Taip;4;3;1;8
16888;Spygliukas;Voveraitės;6758336405;Taip;0;0;11;11
16889;Spygliukas;Voveraitės;3668191959;Taip;3;9;0;12
16890;Spygliukas;Voveraitės;1426267001;Taip;0;1;0;1
16891;Spygliukas;Voveraitės;7611880543;Taip;10;0;0;10
16892;Spygliukas;Voveraitės;8189748611;Taip;0;9;0;9
16893;Spygliukas;Voveraitės;8877911083;Taip;5;3;0;8
16894;Spygliukas;Voveraitės;6405496193;Taip;0;8;3;11
16895;Spygliukas;Voveraitės;9231097598;Taip;3;0;3;6
16896;Spygliukas;Voveraitės;4681061579;Taip;0;0;1;1
16897;Spygliukas;Voveraitės;7313828707;Taip;6;0;0;6
16898;Spygliukas;Voveraitės;1234195733;Taip;3;1;0;4
16899;Spygliukas;Giliukų;9945315122;Taip;6;6;1;13
16900;Spygliukas;Giliukų;1291429206;Taip;9;0;0;9
16901;Spygliukas;Giliukų;8308394841;Taip;0;0;1;1
16902;Spygliukas;Giliukų;6343141973;Taip;4;0;0;4
16903;Spygliukas;Giliukų;1127941700;Taip;9;0;0;9
16904;Spygliukas;Giliukų;3317395260;Taip;11;0;2;13
16905;Spygliukas;Giliukų;9141146733;Taip;4;0;0;4
16906;Spygliukas;Giliukų;6363991196;Taip;5;0;1;6
16907;Spygliukas;Giliukų;6700076900;Taip;0;4;0;4
16908;Spygliukas;Giliukų;8093949301;Taip;0;1;2;3
16909;Spygliukas;Giliukų;7561072315;Taip;4;0;0;4
16910;Spygliukas;Giliukų;2950722789;Taip;0;3;0;3
16911;Spygliukas;Giliukų;1863442354;Taip;5;0;1;6
16912;Spygliukas;Giliukų;7477731865;Taip;3;4;0;7
16913;Spygliukas;Drugeliai;7271659513;Taip;0;12;4;16
16914;Spygliukas;Drugeliai;8604767396;Taip;0;0;11;11
16915;Spygliukas;Drugeliai;4634660174;Taip;0;6;1;7
16916;Spygliukas;Drugeliai;7924880159;Taip;3;5;1;9
16917;Spygliukas;Drugeliai;4368224847;Taip;7;0;1;8
16918;Spygliukas;Drugeliai;9316731983;Taip;0;0;1;1
16919;Spygliukas;Drugeliai;6630979640;Taip;3;1;0;4
16920;Spygliukas;Drugeliai;5012876830;Taip;4;6;0;10
16921;Spygliukas;Drugeliai;2315421636;Taip;4;0;5;9
16922;Spygliukas;Drugeliai;7125425492;Taip;0;0;1;1
16923;Spygliukas;Drugeliai;7928675053;Taip;0;7;0;7
16924;Spygliukas;Drugeliai;9052337501;Taip;0;0;6;6
16925;Spygliukas;Drugeliai;1974541155;Taip;0;3;2;5
16926;Spygliukas;Drugeliai;4505044604;Taip;0;5;0;5
16927;Spygliukas;Drugeliai;2989701249;Taip;8;0;1;9
16928;Spygliukas;Drugeliai;9086986643;Taip;4;0;1;5
16929;Vieversys;Žirniukai;8129139979;Taip;0;1;0;1
16930;Vieversys;Žirniukai;1149316471;Taip;0;7;0;7
16931;Vieversys;Žirniukai;6787960120;Ne;0;8;0;8
16932;Vieversys;Žirniukai;9612415733;Taip;0;8;0;8
16933;Vieversys;Žirniukai;5917328379;Taip;0;1;1;2
16934;Vieversys;Žirniukai;53977164888;Taip;0;1;0;1
16935;Vieversys;Žirniukai;82594887399;Taip;0;7;0;7
16936;Vieversys;Žirniukai;7500147648;Taip;0;12;0;12
16937;Vieversys;Žirniukai;9835682858;Taip;0;17;0;17
16938;Vieversys;Žirniukai;6596979763;Taip;0;6;0;6
16939;Vieversys;Žirniukai;5286521728;Taip;0;3;0;3
16940;Vieversys;Žirniukai;8038341998;Taip;0;5;0;5
16941;Vieversys;Žirniukai;1247565595;Taip;7;1;0;8
16942;Vieversys;Žirniukai;6720355390;Taip;9;1;5;15
16943;Vieversys;Žirniukai;4313822180;Taip;0;1;0;1
16944;Vieversys;Žirniukai;7812227428;Taip;0;1;0;1
16945;Vieversys;Žirniukai;5810605263;Taip;4;4;0;8
16946;Vieversys;Žirniukai;3205204176;Taip;0;0;3;3
16947;Vieversys;Žirniukai;95891054066;Ne;0;2;0;2
16948;Vieversys;Varpelių;41215224179;Ne;0;2;1;3
16949;Vieversys;Varpelių;78901148667;Taip;0;1;0;1
16950;Vieversys;Varpelių;2130449373;Taip;0;1;0;1
16951;Vieversys;Varpelių;2141967793;Taip;0;3;0;3
16952;Vieversys;Varpelių;2128428329;Taip;0;3;0;3
16953;Vieversys;Varpelių;1462608187;Taip;0;3;0;3
16954;Vieversys;Varpelių;1190396975;Taip;0;4;0;4
16955;Vieversys;Varpelių;3839507103;Taip;0;1;0;1
16956;Vieversys;Varpelių;12524976076;Taip;0;2;0;2
16957;Vieversys;Varpelių;44086673096;Taip;0;1;0;1
16958;Vieversys;Varpelių;55553505459;Taip;0;7;2;9
16959;Vieversys;Varpelių;16002848795;Taip;0;7;1;8
16960;Vieversys;Varpelių;938801303;Taip;0;4;0;4
16961;Vieversys;Varpelių;46624143347;Taip;0;1;4;5
16962;Vieversys;Varpelių;1933907389;Taip;0;2;0;2
16963;Vieversys;Varpelių;61101237391;Taip;0;4;0;4
16964;Vieversys;Varpelių;1300013110;Taip;0;1;0;1
16965;Vieversys;Varpelių;5123994167;Taip;0;3;0;3
16966;Vieversys;Varpelių;89223502405;Taip;7;0;0;7
16967;Vieversys;Varpelių;62465517391;Taip;0;7;0;7
16968;Vieversys;Varpelių;2879546284;Taip;0;2;0;2
16969;Vieversys;Varpelių;8213134622;Taip;5;1;0;6
16970;Vieversys;Kiškučių;15473504836;Taip;0;6;0;6
16971;Vieversys;Kiškučių;72395946516;Taip;0;1;3;4
16972;Vieversys;Kiškučių;95472887427;Taip;0;0;4;4
16973;Vieversys;Kiškučių;86119860485;Taip;3;1;0;4
16974;Vieversys;Kiškučių;32630544785;Taip;0;0;3;3
16975;Vieversys;Kiškučių;57223617591;Taip;0;0;3;3
16976;Vieversys;Kiškučių;8744701209;Taip;0;6;0;6
16977;Vieversys;Kiškučių;95886969053;Taip;0;5;0;5
16978;Vieversys;Kiškučių;86213464121;Taip;0;12;0;12
16979;Vieversys;Kiškučių;1588939300;Taip;0;6;0;6
16980;Vieversys;Kiškučių;1815073796;Taip;0;1;0;1
16981;Vieversys;Kiškučių;1715902540;Taip;0;1;3;4
16982;Vieversys;Kiškučių;20960056744;Taip;5;1;0;6
16983;Vieversys;Kiškučių;58287759954;Taip;7;0;0;7
16984;Vieversys;Kiškučių;5197639355;Taip;0;1;0;1
16985;Vieversys;Kiškučių;6116471730;Taip;0;7;0;7
16986;Vieversys;Kiškučių;8966153890;Taip;0;1;0;1
16987;Vieversys;Kiškučių;9980447111;Taip;0;1;0;1
16988;Vieversys;Kiškučių;84134333980;Ne;0;1;0;1
16989;Vieversys;Kiškučių;6236703869;Taip;0;4;0;4
16990;Vieversys;Kiškučių;1601102808;Taip;0;2;0;2
16991;Vieversys;Kiškučių;2733479642;Taip;0;1;0;1
16992;Vieversys;Kiškučių;25507613416;Ne;0;0;4;4
16993;Vieversys;Pelėdžiukų;8421719030;Taip;0;1;2;3
16994;Vieversys;Pelėdžiukų;94463134058;Taip;0;7;0;7
16995;Vieversys;Pelėdžiukų;7578552471;Taip;0;0;1;1
16996;Vieversys;Pelėdžiukų;2193074123;Taip;0;0;4;4
16997;Vieversys;Pelėdžiukų;7007620994;Taip;0;1;5;6
16998;Vieversys;Pelėdžiukų;9499315463;Taip;5;0;0;5
16999;Vieversys;Pelėdžiukų;9774365819;Taip;7;0;0;7
17000;Vieversys;Pelėdžiukų;2521488728;Taip;0;8;4;12
17001;Vieversys;Pelėdžiukų;6473759470;Taip;5;4;0;9
17002;Vieversys;Pelėdžiukų;1273951001;Taip;0;9;0;9
17003;Vieversys;Pelėdžiukų;48430863473;Taip;0;4;0;4
17004;Vieversys;Pelėdžiukų;1027693153;Taip;0;1;0;1
17005;Vieversys;Pelėdžiukų;5871715452;Taip;0;0;1;1
17006;Vieversys;Pelėdžiukų;3458399180;Ne;0;10;0;10
17007;Vieversys;Pelėdžiukų;1361156816;Taip;0;5;0;5
17008;Vieversys;Pelėdžiukų;3755410640;Taip;0;3;0;3
17009;Vieversys;Pelėdžiukų;1322495361;Taip;0;0;1;1
17010;Vieversys;Saulučių;3164280186;Ne;0;0;3;3
17011;Vieversys;Saulučių;3405502715;Taip;0;6;0;6
17012;Vieversys;Saulučių;6127272124;Taip;0;0;1;1
17013;Vieversys;Saulučių;4892622551;Taip;0;0;1;1
17014;Vieversys;Saulučių;5654533451;Taip;0;1;0;1
17015;Vieversys;Saulučių;9972526744;Taip;0;3;0;3
17016;Vieversys;Saulučių;2140887757;Taip;0;0;2;2
17017;Vieversys;Saulučių;1748006118;Taip;0;0;1;1
17018;Vieversys;Saulučių;4690095102;Taip;0;0;3;3
17019;Vieversys;Saulučių;7048475906;Taip;9;0;2;11
17020;Vieversys;Saulučių;6031200259;Ne;5;3;0;8
17021;Vieversys;Saulučių;4072323869;Taip;0;1;0;1
17022;Vieversys;Saulučių;2663322242;Ne;0;2;0;2
17023;Vieversys;Saulučių;7596355010;Taip;0;4;0;4
17024;Vieversys;Kregždučių;3156245273;Taip;0;5;0;5
17025;Vieversys;Kregždučių;5645852451;Taip;0;1;5;6
17026;Vieversys;Kregždučių;9088171869;Taip;0;0;8;8
17027;Vieversys;Kregždučių;7998100115;Taip;0;10;0;10
17028;Vieversys;Kregždučių;9093088054;Taip;0;11;0;11
17029;Vieversys;Kregždučių;4870401841;Taip;0;5;1;6
17030;Vieversys;Kregždučių;2849852593;Taip;1;0;0;1
17031;Vieversys;Kregždučių;6808541662;Taip;0;1;0;1
17032;Vieversys;Kregždučių;2529690060;Taip;0;1;0;1
17033;Vieversys;Kregždučių;2230503026;Taip;5;2;0;7
17034;Vieversys;Kregždučių;6157594693;Taip;0;2;0;2
17035;Vieversys;Kregždučių;1322953831;Taip;0;1;0;1
17036;Vieversys;Kregždučių;9090281352;Taip;0;0;1;1
17037;Vieversys;Kregždučių;4308330177;Taip;3;1;4;8
17038;Vieversys;Kregždučių;3122763958;Taip;14;1;0;15
17039;Vieversys;Kregždučių;2938302462;Taip;4;6;0;10
17040;Vieversys;Kregždučių;9577869269;Taip;0;0;1;1
17041;Vieversys;Boružėlių;1478357320;Taip;0;11;0;11
17042;Vieversys;Boružėlių;6838828193;Taip;6;7;0;13
17043;Vieversys;Boružėlių;8587368497;Taip;0;5;0;5
17044;Vieversys;Boružėlių;5683183310;Taip;5;2;2;9
17045;Vieversys;Boružėlių;9884517851;Taip;0;1;0;1
17046;Vieversys;Boružėlių;4565799599;Taip;0;2;0;2
17047;Vieversys;Boružėlių;7399326463;Taip;10;0;0;10
17048;Vieversys;Boružėlių;4088189914;Taip;0;2;0;2
17049;Vieversys;Boružėlių;7364582681;Taip;0;2;2;4
17050;Vieversys;Boružėlių;9826657384;Taip;0;6;0;6
17051;Vieversys;Boružėlių;3731412573;Taip;0;3;0;3
17052;Vieversys;Boružėlių;9255292099;Taip;4;1;0;5
17053;Vieversys;Boružėlių;7429565381;Taip;0;14;0;14
17054;Vieversys;Boružėlių;4297477514;Taip;0;2;4;6
17055;Vieversys;Boružėlių;8816714193;Taip;0;10;0;10
17056;Vieversys;Boružėlių;6148482625;Taip;13;0;0;13
17057;Vieversys;Boružėlių;2701284187;Taip;0;5;0;5
17058;Vieversys;Boružėlių;9911792407;Taip;9;0;3;12
17059;Vieversys;Boružėlių;6234199996;Taip;13;0;1;14
17060;Vieversys;Bitučių;9268459013;Taip;0;2;0;2
17061;Vieversys;Bitučių;8706336322;Taip;18;0;0;18
17062;Vieversys;Bitučių;5966170543;Taip;0;1;1;2
17063;Vieversys;Bitučių;5210732072;Taip;4;0;0;4
17064;Vieversys;Bitučių;2072413459;Taip;0;0;6;6
17065;Vieversys;Bitučių;9454017990;Taip;0;22;0;22
17066;Vieversys;Bitučių;9476611261;Taip;0;0;1;1
17067;Vieversys;Bitučių;6083402842;Taip;4;0;0;4
17068;Vieversys;Bitučių;4428101863;Taip;0;0;1;1
17069;Vieversys;Bitučių;6839896363;Taip;0;0;1;1
17070;Vieversys;Bitučių;9978867863;Taip;0;0;2;2
17071;Vieversys;Bitučių;9092693925;Taip;0;0;1;1
17072;Vieversys;Bitučių;2661027772;Taip;10;0;0;10
17073;Vieversys;Smalsučių;3681120339;Taip;0;9;0;9
17074;Vieversys;Smalsučių;5922485482;Taip;0;0;2;2
17075;Vieversys;Smalsučių;9164615794;Taip;5;3;0;8
17076;Vieversys;Smalsučių;3684937630;Taip;5;0;0;5
17077;Vieversys;Smalsučių;6563139211;Taip;0;5;0;5
17078;Vieversys;Smalsučių;4294676988;Taip;0;8;0;8
17079;Vieversys;Smalsučių;3917758713;Taip;5;3;3;11
17080;Vieversys;Smalsučių;4835022593;Taip;5;1;0;6
17081;Vieversys;Smalsučių;3249717073;Taip;0;15;0;15
17082;Vieversys;Smalsučių;7120329258;Taip;0;2;0;2
17083;Vieversys;Smalsučių;9387421639;Taip;5;8;0;13
17084;Vieversys;Smalsučių;8174124875;Taip;9;3;0;12
17085;Vieversys;Smalsučių;5769453869;Taip;0;2;0;2
17086;Vieversys;Smalsučių;3946609345;Taip;0;1;1;2
17087;Vieversys;Smalsučių;2383765752;Taip;6;0;0;6
17088;Vieversys;Smalsučių;9686787125;Taip;0;0;2;2
17089;Vieversys;Kodėlčiukų;69275621813;Ne;0;5;0;5
17090;Vieversys;Kodėlčiukų;1455615413;Taip;0;5;0;5
17091;Vieversys;Kodėlčiukų;1970088958;Taip;0;10;0;10
17092;Vieversys;Kodėlčiukų;9012978017;Taip;0;12;0;12
17093;Vieversys;Kodėlčiukų;1491424075;Taip;9;0;2;11
17094;Vieversys;Kodėlčiukų;1361494430;Taip;0;5;0;5
17095;Vieversys;Kodėlčiukų;9829388743;Taip;2;1;0;3
17096;Vieversys;Kodėlčiukų;1878278158;Taip;2;1;0;3
17097;Vieversys;Kodėlčiukų;7315438787;Taip;0;5;0;5
17098;Vieversys;Kodėlčiukų;16617102917;Taip;3;2;0;5
17099;Vieversys;Kodėlčiukų;2236904814;Taip;5;0;9;14
17100;Vieversys;Kodėlčiukų;3792076932;Taip;0;6;0;6
17101;Vieversys;Kodėlčiukų;7385860819;Taip;0;1;0;1
17102;Vieversys;Kodėlčiukų;9680719247;Taip;0;1;0;1
17103;Vieversys;Kodėlčiukų;2294276744;Taip;0;5;0;5
17104;Vieversys;Kodėlčiukų;3640960566;Taip;3;8;0;11
17105;Vieversys;Kodėlčiukų;2006325359;Taip;0;1;0;1
17106;Vieversys;Kodėlčiukų;1122002166;Taip;0;8;0;8
17107;Vieversys;Kodėlčiukų;1546655542;Ne;0;0;4;4
17108;Vieversys;NYKŠTUKAI;9580031042;Taip;11;0;1;12
17109;Vieversys;NYKŠTUKAI;3262738994;Taip;0;5;0;5
17110;Vieversys;NYKŠTUKAI;5160814541;Taip;0;0;1;1
17111;Vieversys;NYKŠTUKAI;3332069842;Taip;0;1;2;3
17112;Vieversys;NYKŠTUKAI;2635722489;Taip;10;0;2;12
17113;Vieversys;NYKŠTUKAI;9102341863;Taip;0;1;1;2
17114;Vieversys;NYKŠTUKAI;3595005599;Taip;11;1;0;12
17115;Vieversys;NYKŠTUKAI;5150986489;Taip;6;0;0;6
17116;Vieversys;NYKŠTUKAI;2956566201;Taip;13;0;1;14
17117;Vieversys;NYKŠTUKAI;9155896981;Taip;0;1;0;1
17118;Vieversys;NYKŠTUKAI;1924774817;Taip;3;11;0;14
17119;Vieversys;NYKŠTUKAI;9463693741;Taip;0;0;2;2
17120;Vieversys;NYKŠTUKAI;8350070741;Taip;5;0;0;5
17121;Vieversys;NYKŠTUKAI;7611047781;Taip;0;1;1;2
17122;Vieversys;NYKŠTUKAI;2107000312;Taip;5;3;11;19
17123;Vieversys;DRUGELIAI;5912306325;Taip;3;14;0;17
17124;Vieversys;DRUGELIAI;5898422871;Taip;3;0;12;15
17125;Vieversys;DRUGELIAI;5037806018;Taip;0;0;2;2
17126;Vieversys;DRUGELIAI;6926960486;Taip;0;1;0;1
17127;Vieversys;DRUGELIAI;1384388802;Taip;5;5;0;10
17128;Vieversys;DRUGELIAI;7453156612;Taip;0;0;1;1
17129;Vieversys;DRUGELIAI;6709556873;Taip;5;0;3;8
17130;Vieversys;DRUGELIAI;2562413607;Taip;3;0;2;5
17131;Vieversys;DRUGELIAI;4193031329;Taip;0;0;1;1
17132;Vieversys;DRUGELIAI;4631238425;Taip;5;1;2;8
17133;Vieversys;DRUGELIAI;3180687885;Taip;0;0;12;12
17134;Vieversys;DRUGELIAI;4702339508;Taip;0;8;0;8
17135;Vieversys;DRUGELIAI;1752359969;Taip;0;6;0;6
17136;Vieversys;DRUGELIAI;9217208794;Taip;0;0;22;22
17137;Vieversys;DRUGELIAI;9965162863;Taip;0;2;0;2
17138;Vieversys;DRUGELIAI;6791121542;Taip;4;0;0;4
17139;Vieversys;DRUGELIAI;1881076551;Taip;7;0;0;7
17140;Žirmūnėliai;SAULUTĖS;8030469722;Taip;5;0;0;5
17141;Žirmūnėliai;SAULUTĖS;1073135587;Taip;0;12;0;12
17142;Žirmūnėliai;SAULUTĖS;4598761492;Taip;0;1;0;1
17143;Žirmūnėliai;SAULUTĖS;1478039469;Taip;0;1;0;1
17144;Žirmūnėliai;SAULUTĖS;1255857051;Taip;0;2;0;2
17145;Žirmūnėliai;SAULUTĖS;72738770293;Taip;11;2;0;13
17146;Žirmūnėliai;SAULUTĖS;1582563837;Taip;3;0;0;3
17147;Žirmūnėliai;SAULUTĖS;5037669167;Taip;8;1;1;10
17148;Žirmūnėliai;SAULUTĖS;1761284228;Taip;0;4;0;4
17149;Žirmūnėliai;SAULUTĖS;41018224936;Taip;0;2;3;5
17150;Žirmūnėliai;SAULUTĖS;1894070647;Ne;0;8;0;8
17151;Žirmūnėliai;SAULUTĖS;1347664230;Taip;0;0;5;5
17152;Žirmūnėliai;SAULUTĖS;1435743911;Taip;5;0;0;5
17153;Žirmūnėliai;SAULUTĖS;8308074932;Taip;0;1;0;1
17154;Žirmūnėliai;SAULUTĖS;2007790746;Taip;0;7;0;7
17155;Žirmūnėliai;GILIUKAI;6430944858;Taip;3;7;0;10
17156;Žirmūnėliai;GILIUKAI;3562689670;Taip;0;8;0;8
17157;Žirmūnėliai;GILIUKAI;5929166560;Taip;0;2;0;2
17158;Žirmūnėliai;GILIUKAI;3767421827;Taip;0;4;0;4
17159;Žirmūnėliai;GILIUKAI;5104310002;Taip;6;9;5;20
17160;Žirmūnėliai;GILIUKAI;1025809131;Taip;0;1;0;1
17161;Žirmūnėliai;GILIUKAI;6899109664;Taip;5;0;1;6
17162;Žirmūnėliai;GILIUKAI;7410921362;Taip;0;2;0;2
17163;Žirmūnėliai;GILIUKAI;8627403283;Taip;0;3;1;4
17164;Žirmūnėliai;GILIUKAI;5089884149;Taip;0;6;0;6
17165;Žirmūnėliai;GILIUKAI;1791977446;Taip;4;3;0;7
17166;Žirmūnėliai;GILIUKAI;6875484657;Taip;0;0;6;6
17167;Žirmūnėliai;GILIUKAI;9871163622;Taip;1;0;0;1
17168;Žirmūnėliai;GILIUKAI;3532895278;Taip;0;5;0;5
17169;Žirmūnėliai;GILIUKAI;8459217612;Taip;12;0;0;12
17170;Žirmūnėliai;GILIUKAI;2959090234;Taip;0;6;5;11
17171;Žirmūnėliai;GILIUKAI;8444883234;Ne;22;0;0;22
17172;Žirmūnėliai;DAINORĖLIAI;6493142538;Taip;0;0;2;2
17173;Žirmūnėliai;DAINORĖLIAI;1655437833;Taip;0;0;3;3
17174;Žirmūnėliai;DAINORĖLIAI;2693415717;Taip;0;1;0;1
17175;Žirmūnėliai;DAINORĖLIAI;8930536051;Taip;0;0;3;3
17176;Žirmūnėliai;DAINORĖLIAI;7953019230;Taip;0;9;0;9
17177;Žirmūnėliai;DAINORĖLIAI;3994865244;Taip;0;0;19;19
17178;Žirmūnėliai;DAINORĖLIAI;6878528100;Taip;0;3;1;4
17179;Žirmūnėliai;DAINORĖLIAI;8440187348;Taip;4;2;1;7
17180;Žirmūnėliai;DAINORĖLIAI;1832367936;Taip;0;4;0;4
17181;Žirmūnėliai;DAINORĖLIAI;9759491055;Taip;0;0;3;3
17182;Žirmūnėliai;DAINORĖLIAI;1127214387;Taip;6;0;1;7
17183;Žirmūnėliai;DAINORĖLIAI;4101748829;Taip;8;2;0;10
17184;Žirmūnėliai;DAINORĖLIAI;2379638934;Taip;0;1;0;1
17185;Žirmūnėliai;DAINORĖLIAI;6448582622;Taip;0;2;0;2
17186;Žirmūnėliai;DAINORĖLIAI;2661052835;Taip;0;6;0;6
17187;Žirmūnėliai;DAINORĖLIAI;7011701994;Taip;4;0;0;4
17188;Žirmūnėliai;DAINORĖLIAI;3180116136;Taip;0;2;0;2
17189;Žirmūnėliai;DAINORĖLIAI;4968278870;Taip;0;0;1;1
17190;Žirmūnėliai;DRUGELIAI;4218266688;Taip;0;0;1;1
17191;Žirmūnėliai;DRUGELIAI;3449815783;Taip;0;2;0;2
17192;Žirmūnėliai;DRUGELIAI;5736502380;Taip;0;2;0;2
17193;Žirmūnėliai;DRUGELIAI;9154874729;Taip;0;1;0;1
17194;Žirmūnėliai;DRUGELIAI;9378860669;Taip;0;6;0;6
17195;Žirmūnėliai;DRUGELIAI;8607934394;Taip;0;10;12;22
17196;Žirmūnėliai;DRUGELIAI;7892626521;Taip;0;8;0;8
17197;Žirmūnėliai;DRUGELIAI;8999160836;Taip;0;4;1;5
17198;Žirmūnėliai;DRUGELIAI;8209309240;Taip;0;8;0;8
17199;Žirmūnėliai;DRUGELIAI;2837129621;Taip;0;1;0;1
17200;Žirmūnėliai;DRUGELIAI;1273684243;Taip;0;1;1;2
17201;Žirmūnėliai;DRUGELIAI;2971175236;Taip;0;2;0;2
17202;Žirmūnėliai;DRUGELIAI;6594728970;Taip;0;2;1;3
17203;Žirmūnėliai;DRUGELIAI;7422544482;Taip;5;2;2;9
17204;Žirmūnėliai;DRUGELIAI;4336415033;Taip;0;1;3;4
17205;Žirmūnėliai;DRUGELIAI;9241738140;Taip;3;4;0;7
17206;Žirmūnėliai;DRUGELIAI;3274576752;Taip;22;0;0;22
17207;Žirmūnėliai;BORUŽIUKAI;52420072025;Taip;3;0;0;3
17208;Žirmūnėliai;BORUŽIUKAI;4796654075;Taip;9;0;0;9
17209;Žirmūnėliai;BORUŽIUKAI;64969220116;Taip;0;13;0;13
17210;Žirmūnėliai;BORUŽIUKAI;2127930970;Taip;0;6;0;6
17211;Žirmūnėliai;BORUŽIUKAI;7918747416;Taip;0;0;3;3
17212;Žirmūnėliai;BORUŽIUKAI;86501162211;Taip;0;1;0;1
17213;Žirmūnėliai;BORUŽIUKAI;1017903291;Taip;0;2;0;2
17214;Žirmūnėliai;BORUŽIUKAI;3691651489;Taip;2;0;0;2
17215;Žirmūnėliai;BORUŽIUKAI;51723882387;Taip;3;1;5;9
17216;Žirmūnėliai;BORUŽIUKAI;73664204182;Taip;0;0;5;5
17217;Žirmūnėliai;BORUŽIUKAI;1816123753;Taip;0;1;0;1
17218;Žirmūnėliai;BORUŽIUKAI;99546532431;Taip;0;6;0;6
17219;Žirmūnėliai;BORUŽIUKAI;6578685370;Taip;0;3;0;3
17220;Žirmūnėliai;BORUŽIUKAI;1302040861;Taip;0;6;0;6
17221;Žirmūnėliai;BORUŽIUKAI;50829749038;Taip;5;0;1;6
17222;Žirmūnėliai;BORUŽIUKAI;37231106844;Taip;0;3;5;8
17223;Žirmūnėliai;BORUŽIUKAI;68678277635;Taip;4;0;0;4
17224;Žirmūnėliai;BORUŽIUKAI;5996547081;Taip;0;2;0;2
17225;Žirmūnėliai;BORUŽIUKAI;1493536049;Taip;0;7;0;7
17226;Žirmūnėliai;BORUŽIUKAI;1234956674;Taip;3;12;0;15
17227;Žirmūnėliai;EŽIUKAI;9829630143;Taip;0;11;0;11
17228;Žirmūnėliai;EŽIUKAI;5527904792;Taip;0;12;0;12
17229;Žirmūnėliai;EŽIUKAI;3006508357;Taip;0;2;6;8
17230;Žirmūnėliai;EŽIUKAI;1120531178;Taip;4;0;0;4
17231;Žirmūnėliai;EŽIUKAI;52524235797;Taip;0;1;0;1
17232;Žirmūnėliai;EŽIUKAI;4986702792;Taip;0;2;0;2
17233;Žirmūnėliai;EŽIUKAI;1273301982;Taip;3;1;5;9
17234;Žirmūnėliai;EŽIUKAI;1308593517;Taip;0;9;0;9
17235;Žirmūnėliai;EŽIUKAI;1626619024;Taip;0;1;0;1
17236;Žirmūnėliai;EŽIUKAI;1183883183;Taip;0;19;0;19
17237;Žirmūnėliai;EŽIUKAI;1734624632;Taip;2;0;0;2
17238;Žirmūnėliai;EŽIUKAI;5673929155;Taip;0;0;8;8
17239;Žirmūnėliai;EŽIUKAI;53028161711;Taip;0;1;4;5
17240;Žirmūnėliai;EŽIUKAI;1556389237;Taip;0;2;15;17
17241;Žirmūnėliai;EŽIUKAI;8339819296;Taip;0;0;1;1
17242;Žirmūnėliai;ŽVIRBLIUKAI;2336720944;Taip;8;2;1;11
17243;Žirmūnėliai;ŽVIRBLIUKAI;93072181228;Taip;0;1;0;1
17244;Žirmūnėliai;ŽVIRBLIUKAI;9666769523;Taip;0;2;0;2
17245;Žirmūnėliai;ŽVIRBLIUKAI;2094542223;Taip;0;1;0;1
17246;Žirmūnėliai;ŽVIRBLIUKAI;24877884441;Taip;0;2;0;2
17247;Žirmūnėliai;ŽVIRBLIUKAI;85408994677;Taip;0;2;0;2
17248;Žirmūnėliai;ŽVIRBLIUKAI;155054610;Taip;0;2;1;3
17249;Žirmūnėliai;ŽVIRBLIUKAI;9232201424;Taip;0;5;0;5
17250;Žirmūnėliai;ŽVIRBLIUKAI;1259227112;Taip;0;0;1;1
17251;Žirmūnėliai;ŽVIRBLIUKAI;19389343819;Taip;0;1;0;1
17252;Žirmūnėliai;ŽVIRBLIUKAI;47645482781;Taip;3;0;0;3
17253;Žirmūnėliai;ŽVIRBLIUKAI;2216383670;Taip;20;0;0;20
17254;Žirmūnėliai;ŽVIRBLIUKAI;89429083939;Taip;0;1;0;1
17255;Žirmūnėliai;ŽVIRBLIUKAI;8824743884;Taip;0;10;0;10
17256;Žirmūnėliai;ŽVIRBLIUKAI;1961293870;Taip;0;12;0;12
17257;Žirmūnėliai;SPALVELĖS;9482910388;Taip;0;12;0;12
17258;Žirmūnėliai;SPALVELĖS;4815427530;Taip;0;0;4;4
17259;Žirmūnėliai;SPALVELĖS;6641667315;Taip;0;2;0;2
17260;Žirmūnėliai;SPALVELĖS;9936156579;Taip;0;22;0;22
17261;Žirmūnėliai;SPALVELĖS;2985092368;Taip;2;2;3;7
17262;Žirmūnėliai;SPALVELĖS;1158768017;Taip;0;1;0;1
17263;Žirmūnėliai;SPALVELĖS;5154076629;Taip;0;22;0;22
17264;Žirmūnėliai;SPALVELĖS;6259368139;Taip;0;2;1;3
17265;Žirmūnėliai;SPALVELĖS;1356219744;Taip;0;2;0;2
17266;Žirmūnėliai;SPALVELĖS;3458810185;Taip;9;2;0;11
17267;Žirmūnėliai;SPALVELĖS;9306935083;Taip;4;0;0;4
17268;Žirmūnėliai;SPALVELĖS;7067837709;Taip;5;0;0;5
17269;Žirmūnėliai;DEBESĖLIAI;6161223611;Taip;0;2;3;5
17270;Žirmūnėliai;DEBESĖLIAI;31403739893;Taip;5;1;0;6
17271;Žirmūnėliai;DEBESĖLIAI;9926432375;Taip;0;9;0;9
17272;Žirmūnėliai;DEBESĖLIAI;5367009184;Taip;0;10;5;15
17273;Žirmūnėliai;DEBESĖLIAI;1618573494;Taip;0;9;0;9
17274;Žirmūnėliai;DEBESĖLIAI;5611315994;Taip;0;1;0;1
17275;Žirmūnėliai;DEBESĖLIAI;6337036947;Taip;0;0;2;2
17276;Žirmūnėliai;DEBESĖLIAI;2739395691;Taip;0;5;0;5
17277;Žirmūnėliai;DEBESĖLIAI;7528704460;Taip;0;1;0;1
17278;Žirmūnėliai;DEBESĖLIAI;8623037038;Taip;0;0;1;1
17279;Žirmūnėliai;DEBESĖLIAI;5125341440;Taip;0;2;0;2
17280;Žirmūnėliai;DEBESĖLIAI;6647641423;Taip;3;6;1;10
17281;Žirmūnėliai;DEBESĖLIAI;4778339658;Taip;0;9;0;9
17282;Žirmūnėliai;DEBESĖLIAI;2866010286;Taip;4;0;0;4
17283;Žirmūnėliai;DEBESĖLIAI;2904787614;Taip;0;2;0;2
17284;Žirmūnėliai;DEBESĖLIAI;7580002502;Taip;3;0;0;3
17285;Žirmūnėliai;DEBESĖLIAI;7087770068;Taip;0;5;0;5
17286;Žirmūnėliai;VIŠČIUKAI;8592714547;Taip;0;5;0;5
17287;Žirmūnėliai;VIŠČIUKAI;9042509512;Taip;5;0;0;5
17288;Žirmūnėliai;VIŠČIUKAI;1940552890;Taip;0;6;0;6
17289;Žirmūnėliai;VIŠČIUKAI;4343419766;Taip;0;1;0;1
17290;Žirmūnėliai;VIŠČIUKAI;9145626116;Taip;0;0;21;21
17291;Žirmūnėliai;VIŠČIUKAI;7675488865;Taip;0;0;2;2
17292;Žirmūnėliai;VIŠČIUKAI;5440814849;Taip;0;2;1;3
17293;Žirmūnėliai;VIŠČIUKAI;5076712824;Taip;0;4;0;4
17294;Žirmūnėliai;VIŠČIUKAI;4653124134;Taip;8;0;0;8
17295;Žirmūnėliai;VIŠČIUKAI;8242112212;Taip;0;0;22;22
17296;Žirmūnėliai;VIŠČIUKAI;2392106040;Taip;0;1;0;1
17297;Žirmūnėliai;ZUIKUČIŲ;6817236579;Taip;0;19;0;19
17298;Žirmūnėliai;ZUIKUČIŲ;5560694124;Taip;9;1;1;11
17299;Žirmūnėliai;ZUIKUČIŲ;6116321928;Taip;9;0;0;9
17300;Žirmūnėliai;ZUIKUČIŲ;2310523676;Taip;9;2;0;11
17301;Žirmūnėliai;ZUIKUČIŲ;5683829836;Taip;4;3;0;7
17302;Žirmūnėliai;ZUIKUČIŲ;4291114238;Taip;0;1;8;9
17303;Žirmūnėliai;ZUIKUČIŲ;4922028935;Taip;8;0;0;8
17304;Žirmūnėliai;ZUIKUČIŲ;1948299433;Taip;6;0;0;6
17305;Žirmūnėliai;ZUIKUČIŲ;4763350308;Taip;9;0;0;9
17306;Žirmūnėliai;ZUIKUČIŲ;5626711530;Taip;11;2;0;13
17307;Žirmūnėliai;ZUIKUČIŲ;3902161368;Taip;5;0;0;5
17308;Žirmūnėliai;ZUIKUČIŲ;4338673048;Taip;10;0;0;10
17309;Žirmūnėliai;ZUIKUČIŲ;4793967980;Taip;6;0;0;6
17310;Žirmūnėliai;ZUIKUČIŲ;6072407337;Taip;0;0;1;1
17311;Žirmūnėliai;OBUOLIUKAI;4575123456;Taip;4;2;0;6
17312;Žirmūnėliai;OBUOLIUKAI;3795476732;Ne;12;0;1;13
17313;Žirmūnėliai;OBUOLIUKAI;1917500190;Taip;0;2;3;5
17314;Žirmūnėliai;OBUOLIUKAI;9002868728;Taip;0;5;0;5
17315;Žirmūnėliai;OBUOLIUKAI;2073922023;Taip;0;0;1;1
17316;Žirmūnėliai;OBUOLIUKAI;7059249540;Taip;5;0;1;6
17317;Žirmūnėliai;OBUOLIUKAI;4999561481;Taip;2;0;0;2
17318;Žirmūnėliai;OBUOLIUKAI;4802771311;Taip;0;5;1;6
17319;Žirmūnėliai;OBUOLIUKAI;6358006462;Taip;5;0;1;6
17320;Žirmūnėliai;OBUOLIUKAI;9213372991;Taip;0;0;6;6
17321;Žirmūnėliai;OBUOLIUKAI;2497258407;Taip;0;2;0;2
17322;Žirmūnėliai;OBUOLIUKAI;3949374730;Taip;4;0;1;5
17323;Žirmūnėliai;OBUOLIUKAI;6869102228;Taip;0;0;5;5
17324;Žirmūnėliai;OBUOLIUKAI;9367849317;Taip;0;5;0;5
17325;Žirmūnėliai;OBUOLIUKAI;9892620134;Taip;2;0;0;2
17326;Žirmūnėliai;OBUOLIUKAI;6450412481;Taip;0;1;0;1
17327;Žirmūnėliai;OBUOLIUKAI;1523231731;Taip;0;4;0;4
17328;Žirmūnėliai;OBUOLIUKAI;9225654910;Taip;0;7;0;7
17329;Žirmūnėliai;OBUOLIUKAI;8823426998;Taip;0;0;2;2
17330;Dainorėliai;VARPELIAI;87242570532;Taip;19;0;0;19
17331;Dainorėliai;VARPELIAI;31902102771;Taip;0;0;22;22
17332;Dainorėliai;VARPELIAI;18233813290;Taip;0;2;4;6
17333;Dainorėliai;VARPELIAI;6176171443;Taip;0;2;0;2
17334;Dainorėliai;VARPELIAI;88781762328;Taip;10;4;0;14
17335;Dainorėliai;VARPELIAI;9319771186;Taip;9;2;1;12
17336;Dainorėliai;VARPELIAI;5693385617;Taip;0;4;0;4
17337;Dainorėliai;VARPELIAI;8267213392;Taip;0;2;0;2
17338;Dainorėliai;VARPELIAI;5959380807;Taip;0;1;0;1
17339;Dainorėliai;VARPELIAI;2938732886;Taip;0;2;0;2
17340;Dainorėliai;VARPELIAI;3183793211;Taip;0;2;4;6
17341;Dainorėliai;VARPELIAI;65467351140;Taip;0;2;0;2
17342;Dainorėliai;VARPELIAI;6909583023;Taip;0;2;0;2
17343;Dainorėliai;VARPELIAI;6430425182;Taip;0;2;1;3
17344;Dainorėliai;VARPELIAI;4269946363;Taip;5;0;0;5
17345;Dainorėliai;VARPELIAI;1088248393;Taip;0;2;6;8
17346;Dainorėliai;VARPELIAI;2074070030;Taip;6;2;0;8
17347;Dainorėliai;VARPELIAI;68134437706;Taip;0;1;0;1
17348;Dainorėliai;VARPELIAI;6898685834;Taip;0;0;1;1
17349;Dainorėliai;ŽIOGELIAI;5591598390;Taip;6;4;0;10
17350;Dainorėliai;ŽIOGELIAI;6481621329;Ne;4;1;0;5
17351;Dainorėliai;ŽIOGELIAI;5715129088;Taip;3;0;0;3
17352;Dainorėliai;ŽIOGELIAI;9132532505;Taip;10;0;0;10
17353;Dainorėliai;ŽIOGELIAI;2450726148;Taip;0;6;0;6
17354;Dainorėliai;ŽIOGELIAI;4307634491;Taip;0;1;0;1
17355;Dainorėliai;ŽIOGELIAI;9107727583;Taip;4;0;0;4
17356;Dainorėliai;ŽIOGELIAI;3598951899;Taip;1;0;0;1
17357;Dainorėliai;ŽIOGELIAI;7591953671;Taip;0;6;11;17
17358;Dainorėliai;ŽIOGELIAI;4973241539;Taip;1;0;3;4
17359;Dainorėliai;ŽIOGELIAI;9154573489;Taip;4;1;1;6
17360;Dainorėliai;ŽIOGELIAI;3592770633;Taip;8;0;0;8
17361;Dainorėliai;ŽIOGELIAI;6169434322;Taip;7;1;4;12
17362;Dainorėliai;ŽIOGELIAI;2094849111;Taip;0;1;0;1
17363;Dainorėliai;ŽIOGELIAI;6659114730;Taip;6;0;1;7
17364;Dainorėliai;ŽIOGELIAI;3887433142;Taip;5;1;1;7
17365;Dainorėliai;ŽIOGELIAI;2541781620;Taip;0;6;1;7
17366;Dainorėliai;ŽIOGELIAI;8239000041;Taip;8;2;0;10
17367;Dainorėliai;ŽIOGELIAI;7984447187;Taip;12;6;0;18
17368;Dainorėliai;ŽIOGELIAI;3897725337;Taip;7;0;0;7
17369;Dainorėliai;DRUGELIAI;65253606353;Ne;0;2;0;2
17370;Dainorėliai;DRUGELIAI;6411939690;Ne;0;4;5;9
17371;Dainorėliai;DRUGELIAI;2483267929;Ne;0;2;1;3
17372;Dainorėliai;DRUGELIAI;6404337541;Ne;0;2;1;3
17373;Dainorėliai;DRUGELIAI;94480397292;Ne;12;0;0;12
17374;Dainorėliai;DRUGELIAI;53935690864;Ne;4;3;0;7
17375;Dainorėliai;DRUGELIAI;27521381629;Ne;0;7;4;11
17376;Dainorėliai;DRUGELIAI;86187568203;Ne;0;7;0;7
17377;Dainorėliai;DRUGELIAI;5238082419;Ne;0;22;0;22
17378;Dainorėliai;DRUGELIAI;49483881135;Ne;7;0;1;8
17379;Dainorėliai;DRUGELIAI;1626877066;Ne;0;0;1;1
17380;Dainorėliai;DRUGELIAI;1158895670;Ne;0;2;0;2
17381;Dainorėliai;DRUGELIAI;3128897752;Ne;8;0;0;8
17382;Dainorėliai;DRUGELIAI;1357413314;Ne;0;0;2;2
17383;Dainorėliai;DRUGELIAI;1515552402;Taip;0;22;0;22
17384;Dainorėliai;DRUGELIAI;73386013083;Ne;10;3;3;16
17385;Dainorėliai;DRUGELIAI;2287353933;Ne;0;3;7;10
17386;Dainorėliai;"1 klasė";67124516230;Ne;4;0;0;4
17387;Dainorėliai;"1 klasė";58071607976;Taip;5;0;0;5
17388;Dainorėliai;"1 klasė";35134511946;Taip;2;0;0;2
17389;Dainorėliai;"1 klasė";7506194777;Taip;8;0;0;8
17390;Dainorėliai;"1 klasė";1829858221;Taip;5;0;0;5
17391;Dainorėliai;"1 klasė";7569146994;Taip;3;0;0;3
17392;Dainorėliai;"1 klasė";6948863728;Taip;3;0;0;3
17393;Dainorėliai;"1 klasė";5236797727;Ne;2;0;0;2
17394;Dainorėliai;"2 klasė";1889037823;Taip;0;1;0;1
17395;Dainorėliai;"2 klasė";49342277188;Taip;0;1;0;1
17396;Dainorėliai;"2 klasė";42402953271;Taip;3;1;0;4
17397;Dainorėliai;"2 klasė";34219208558;Taip;1;1;0;2
17398;Dainorėliai;"2 klasė";2045625141;Taip;2;0;0;2
17399;Dainorėliai;"2 klasė";2441164154;Taip;0;1;0;1
17400;Dainorėliai;"2 klasė";69556449215;Taip;1;1;0;2
17401;Dainorėliai;"2 klasė";8244355193;Taip;0;1;0;1
17402;Dainorėliai;"2 klasė";98796240124;Taip;0;1;0;1
17403;Dainorėliai;"2 klasė";2142553899;Taip;0;1;0;1
17404;Dainorėliai;"2 klasė";37660372564;Taip;0;1;0;1
17405;Dainorėliai;"2 klasė";13138644060;Taip;1;0;0;1
17406;Dainorėliai;"2 klasė";84084897419;Taip;0;1;0;1
17407;Dainorėliai;"2 klasė";98830139164;Taip;0;1;0;1
17408;Dainorėliai;"2 klasė";37708779599;Taip;0;1;0;1
17409;Dainorėliai;"2 klasė";18741625569;Taip;0;1;0;1
17410;Dainorėliai;"2 klasė";84424772471;Taip;1;1;0;2
17411;Dainorėliai;"2 klasė";34686211072;Taip;3;1;0;4
17412;Dainorėliai;"2 klasė";79461209783;Taip;0;1;0;1
17413;Dainorėliai;"2 klasė";47323045857;Taip;2;0;0;2
17414;Dainorėliai;"2 klasė";10679627657;Taip;0;1;0;1
17415;Dainorėliai;"2 klasė";25073134850;Taip;4;1;0;5
17416;Dainorėliai;"2 klasė";65118883315;Taip;0;1;0;1
17417;Dainorėliai;"2 klasė";84999972369;Taip;0;1;0;1
17418;Dainorėliai;"2 klasė";69732047046;Taip;7;1;0;8
17419;Dainorėliai;"2 klasė";1209781483;Taip;0;1;0;1
17420;Dainorėliai;"3 klasė";6203511535;Taip;2;4;0;6
17421;Dainorėliai;"3 klasė";23144978287;Taip;2;2;0;4
17422;Dainorėliai;"3 klasė";29726515194;Taip;2;0;0;2
17423;Dainorėliai;"3 klasė";24048489264;Taip;2;4;0;6
17424;Dainorėliai;"3 klasė";93738984644;Taip;2;0;0;2
17425;Dainorėliai;"3 klasė";8562371599;Taip;1;0;0;1
17426;Dainorėliai;"3 klasė";19292860218;Taip;3;0;0;3
17427;Dainorėliai;"3 klasė";81956978417;Taip;2;0;0;2
17428;Dainorėliai;"3 klasė";91457137356;Taip;1;0;0;1
17429;Dainorėliai;"3 klasė";97182565649;Taip;4;0;0;4
17430;Dainorėliai;"3 klasė";3018657993;Taip;1;0;0;1
17431;Dainorėliai;"3 klasė";57179351170;Taip;3;0;0;3
17432;Dainorėliai;"3 klasė";48245075123;Taip;1;0;0;1
17433;Dainorėliai;"3 klasė";57618865048;Taip;6;0;0;6
17434;Dainorėliai;"3 klasė";13846131820;Taip;1;0;0;1
17435;Dainorėliai;"4 klasė";9028699114;Taip;1;0;0;1
17436;Dainorėliai;"4 klasė";4642369086;Taip;4;0;0;4
17437;Dainorėliai;"4 klasė";2135997501;Taip;5;0;0;5
17438;Dainorėliai;"4 klasė";4631981231;Taip;2;0;0;2
17439;Dainorėliai;"4 klasė";47031645815;Taip;6;0;0;6
17440;Dainorėliai;"4 klasė";1734712911;Taip;1;0;0;1
17441;Dainorėliai;"4 klasė";4309610318;Taip;1;0;0;1
17442;Dainorėliai;SAULUTĖS;5102030168;Taip;0;1;1;2
17443;Dainorėliai;SAULUTĖS;6385439136;Taip;0;1;0;1
17444;Dainorėliai;SAULUTĖS;6704354150;Taip;0;6;0;6
17445;Dainorėliai;SAULUTĖS;4612995336;Ne;0;1;0;1
17446;Dainorėliai;SAULUTĖS;6697149560;Taip;3;7;0;10
17447;Dainorėliai;SAULUTĖS;8857018998;Taip;0;2;1;3
17448;Dainorėliai;SAULUTĖS;7118473669;Taip;8;8;0;16
17449;Dainorėliai;SAULUTĖS;4307591123;Taip;10;4;0;14
17450;Dainorėliai;SAULUTĖS;2070086316;Taip;0;1;0;1
17451;Dainorėliai;SAULUTĖS;5632663846;Taip;0;1;5;6
17452;Dainorėliai;SAULUTĖS;7804441689;Taip;3;0;4;7
17453;Dainorėliai;SAULUTĖS;6090746954;Taip;0;1;0;1
17454;Dainorėliai;SAULUTĖS;5410183494;Taip;6;0;0;6
17455;Dainorėliai;SAULUTĖS;9130473411;Taip;6;0;2;8
17456;Dainorėliai;SAULUTĖS;5587907483;Taip;17;0;0;17
17457;Dainorėliai;SAULUTĖS;1547686786;Taip;0;2;1;3
17458;Dainorėliai;SAULUTĖS;3762178533;Taip;0;15;0;15
17459;Dainorėliai;SAULUTĖS;2064843848;Taip;3;0;5;8
17460;Dainorėliai;SAULUTĖS;4431804759;Taip;0;5;0;5
17461;Dainorėliai;PUMPURĖLIŲ;6513417505;Taip;13;10;0;23
17462;Dainorėliai;PUMPURĖLIŲ;8015545426;Taip;0;3;0;3
17463;Dainorėliai;PUMPURĖLIŲ;5691833295;Taip;0;17;0;17
17464;Dainorėliai;PUMPURĖLIŲ;4033317616;Taip;0;8;1;9
17465;Dainorėliai;PUMPURĖLIŲ;6449332338;Taip;0;10;0;10
17466;Dainorėliai;PUMPURĖLIŲ;1873415679;Taip;1;0;0;1
17467;Dainorėliai;PUMPURĖLIŲ;4560328911;Taip;0;31;0;31
17468;Dainorėliai;PUMPURĖLIŲ;2215481883;Taip;0;3;0;3
17469;Dainorėliai;PUMPURĖLIŲ;3705286231;Taip;0;7;1;8
17470;Dainorėliai;PUMPURĖLIŲ;3561729784;Taip;0;8;0;8
17471;Dainorėliai;PUMPURĖLIŲ;6362265057;Taip;0;2;0;2
17472;Dainorėliai;PUMPURĖLIŲ;2534758615;Taip;0;21;0;21
17473;Dainorėliai;PUMPURĖLIŲ;4286864865;Taip;0;4;4;8
17474;Dainorėliai;PUMPURĖLIŲ;1554081754;Taip;0;12;1;13
17475;Dainorėliai;PUMPURĖLIŲ;1233029451;Taip;0;22;0;22
17476;Dainorėliai;PUMPURĖLIŲ;7197089520;Taip;0;11;0;11
17477;Dainorėliai;DEBESĖLIŲ;1300411811;Taip;0;9;0;9
17478;Dainorėliai;DEBESĖLIŲ;2003536788;Taip;0;10;0;10
17479;Dainorėliai;DEBESĖLIŲ;40762091796;Taip;0;5;0;5
17480;Dainorėliai;DEBESĖLIŲ;5189351158;Taip;0;1;0;1
17481;Dainorėliai;DEBESĖLIŲ;42514000113;Taip;0;7;0;7
17482;Dainorėliai;DEBESĖLIŲ;4058545269;Taip;0;9;0;9
17483;Dainorėliai;DEBESĖLIŲ;1046385778;Taip;0;11;0;11
17484;Dainorėliai;DEBESĖLIŲ;25015347703;Taip;0;19;0;19
17485;Dainorėliai;DEBESĖLIŲ;2095914442;Taip;0;2;0;2
17486;Dainorėliai;DEBESĖLIŲ;4255893222;Taip;0;3;0;3
17487;Dainorėliai;DEBESĖLIŲ;3271090533;Taip;0;21;0;21
17488;Dainorėliai;DEBESĖLIŲ;36311288300;Taip;0;3;0;3
17489;Dainorėliai;DEBESĖLIŲ;6284140548;Taip;6;10;0;16
17490;Dainorėliai;DEBESĖLIŲ;5605084046;Taip;7;1;0;8
17491;Dainorėliai;DEBESĖLIŲ;2823401633;Taip;4;0;0;4
17492;Dainorėliai;DEBESĖLIŲ;5283566263;Taip;18;9;0;27
17493;Dainorėliai;DEBESĖLIŲ;9285865812;Taip;0;1;0;1
17494;Lokiukas;BITUTĖS;6758550653;Taip;22;0;0;22
17495;Lokiukas;BITUTĖS;1040288021;Taip;9;2;0;11
17496;Lokiukas;BITUTĖS;1733486244;Taip;0;0;1;1
17497;Lokiukas;BITUTĖS;6336140882;Taip;0;10;0;10
17498;Lokiukas;BITUTĖS;8775608581;Taip;0;5;0;5
17499;Lokiukas;BITUTĖS;1752784666;Taip;3;1;1;5
17500;Lokiukas;BITUTĖS;6069516217;Taip;0;12;0;12
17501;Lokiukas;BITUTĖS;7943213321;Taip;0;1;2;3
17502;Lokiukas;BITUTĖS;8915504279;Taip;0;1;0;1
17503;Lokiukas;BITUTĖS;8796640190;Taip;0;0;3;3
17504;Lokiukas;BITUTĖS;5943412920;Taip;0;1;2;3
17505;Lokiukas;BITUTĖS;3694653020;Taip;0;2;0;2
17506;Lokiukas;BITUTĖS;4379238557;Taip;0;1;0;1
17507;Lokiukas;BITUTĖS;8902619265;Taip;0;11;0;11
17508;Lokiukas;BITUTĖS;3485639108;Taip;0;4;0;4
17509;Lokiukas;BITUTĖS;4060641736;Ne;0;4;4;8
17510;Lokiukas;BITUTĖS;9501202273;Taip;0;1;0;1
17511;Lokiukas;"1 B klasė";7235277422;Taip;3;0;0;3
17512;Lokiukas;"1 B klasė";1133294157;Taip;2;0;0;2
17513;Lokiukas;"1 B klasė";1072148409;Taip;6;0;0;6
17514;Lokiukas;"1 B klasė";57505829630;Taip;4;0;0;4
17515;Lokiukas;"1 B klasė";7334971595;Taip;4;0;0;4
17516;Lokiukas;"1 B klasė";51059574159;Taip;1;0;0;1
17517;Lokiukas;"1 B klasė";2959877846;Taip;22;0;0;22
17518;Lokiukas;"1 B klasė";7130407913;Taip;22;0;0;22
17519;Lokiukas;"1 B klasė";61807094999;Taip;1;0;0;1
17520;Lokiukas;"1 B klasė";32714964224;Taip;2;0;0;2
17521;Lokiukas;"1 B klasė";8920359311;Taip;2;0;0;2
17522;Lokiukas;"1 B klasė";92373834478;Ne;3;0;0;3
17523;Lokiukas;"1 B klasė";2054450461;Taip;1;0;0;1
17524;Lokiukas;"1 B klasė";14234831040;Taip;3;0;0;3
17525;Lokiukas;"1 B klasė";4662981914;Taip;4;0;0;4
17526;Lokiukas;"1 B klasė";6414861823;Taip;22;0;0;22
17527;Lokiukas;"1 B klasė";98045145204;Taip;3;0;0;3
17528;Lokiukas;"1 B klasė";68390568000;Taip;4;0;0;4
17529;Lokiukas;"1 B klasė";14937983736;Taip;2;0;0;2
17530;Lokiukas;"1 B klasė";8996622650;Taip;3;0;0;3
17531;Lokiukas;"1 B klasė";2078673522;Taip;3;0;0;3
17532;Lokiukas;"1 B klasė";40006848965;Taip;4;0;0;4
17533;Lokiukas;"1 B klasė";3255141230;Taip;22;0;0;22
17534;Lokiukas;"1 B klasė";3255141230;Taip;22;0;0;22
17535;Lokiukas;"1 B klasė";8980902068;Taip;5;0;0;5
17536;Lokiukas;"1 B klasė";4164426360;Taip;4;0;0;4
17537;Lokiukas;"1 A klasė";83279104490;Taip;22;0;0;22
17538;Lokiukas;"1 A klasė";38884246104;Taip;7;0;0;7
17539;Lokiukas;"1 A klasė";1201125655;Taip;6;0;0;6
17540;Lokiukas;"1 A klasė";67133709394;Taip;22;0;0;22
17541;Lokiukas;"1 A klasė";73696992182;Taip;3;0;0;3
17542;Lokiukas;"1 A klasė";1056075876;Taip;10;0;0;10
17543;Lokiukas;"1 A klasė";82025637099;Taip;4;0;0;4
17544;Lokiukas;"1 A klasė";8846527481;Taip;2;0;0;2
17545;Lokiukas;"1 A klasė";4353695640;Ne;6;0;0;6
17546;Lokiukas;"1 A klasė";73515179103;Taip;5;0;0;5
17547;Lokiukas;"1 A klasė";36677665098;Taip;3;0;0;3
17548;Lokiukas;"1 A klasė";131300206;Taip;4;0;0;4
17549;Lokiukas;"1 A klasė";66528256040;Taip;3;0;0;3
17550;Lokiukas;"1 A klasė";83528495608;Ne;6;0;0;6
17551;Lokiukas;"1 A klasė";1333650630;Ne;4;0;0;4
17552;Lokiukas;"1 A klasė";52940830874;Taip;6;0;0;6
17553;Lokiukas;"1 A klasė";8240261104;Taip;3;0;0;3
17554;Lokiukas;"1 A klasė";41809745552;Taip;22;0;0;22
17555;Lokiukas;"1 A klasė";83086633109;Taip;22;0;0;22
17556;Lokiukas;"1 A klasė";2502465398;Taip;3;0;0;3
17557;Lokiukas;"1 A klasė";9890308887;Taip;8;0;0;8
17558;Lokiukas;"1 A klasė";77512682081;Taip;5;0;0;5
17559;Lokiukas;"1 A klasė";86120193313;Taip;3;0;0;3
17560;Lokiukas;"1 A klasė";45028887854;Taip;2;0;0;2
17561;Lokiukas;"1 A klasė";51237034253;Taip;2;0;0;2
17562;Lokiukas;"1 A klasė";27403835292;Taip;2;0;0;2
17563;Lokiukas;GUDRUČIAI;1570438208;Taip;6;0;0;6
17564;Lokiukas;GUDRUČIAI;5943583254;Taip;0;2;0;2
17565;Lokiukas;GUDRUČIAI;47399326083;Taip;0;0;1;1
17566;Lokiukas;GUDRUČIAI;5437008837;Taip;10;1;0;11
17567;Lokiukas;GUDRUČIAI;4569798381;Taip;0;2;0;2
17568;Lokiukas;GUDRUČIAI;97284171512;Taip;0;1;0;1
17569;Lokiukas;GUDRUČIAI;2548712970;Taip;6;1;0;7
17570;Lokiukas;GUDRUČIAI;2673522432;Taip;0;4;0;4
17571;Lokiukas;GUDRUČIAI;8399364170;Taip;1;0;2;3
17572;Lokiukas;GUDRUČIAI;4427448272;Taip;3;1;0;4
17573;Lokiukas;GUDRUČIAI;5453470660;Taip;0;4;0;4
17574;Lokiukas;GUDRUČIAI;8568285232;Taip;0;5;0;5
17575;Lokiukas;GUDRUČIAI;7591418969;Taip;0;1;0;1
17576;Lokiukas;GUDRUČIAI;20659573470;Taip;4;1;0;5
17577;Lokiukas;BORUŽĖLĖS;4849031542;Taip;0;4;0;4
17578;Lokiukas;BORUŽĖLĖS;3744484616;Taip;0;1;1;2
17579;Lokiukas;BORUŽĖLĖS;8286358519;Taip;5;0;1;6
17580;Lokiukas;BORUŽĖLĖS;2625981190;Taip;0;8;0;8
17581;Lokiukas;BORUŽĖLĖS;4585621105;Taip;0;1;0;1
17582;Lokiukas;BORUŽĖLĖS;8576418875;Taip;0;14;0;14
17583;Lokiukas;BORUŽĖLĖS;4617372387;Taip;0;1;3;4
17584;Lokiukas;BORUŽĖLĖS;6869785650;Taip;0;4;0;4
17585;Lokiukas;BORUŽĖLĖS;5467387832;Taip;9;1;1;11
17586;Lokiukas;BORUŽĖLĖS;3930463578;Taip;0;0;2;2
17587;Lokiukas;BORUŽĖLĖS;2660616022;Taip;0;1;2;3
17588;Lokiukas;BORUŽĖLĖS;9798351980;Taip;11;0;2;13
17589;Lokiukas;BORUŽĖLĖS;5401463671;Ne;0;1;2;3
17590;Lokiukas;BORUŽĖLĖS;9996442005;Ne;16;0;0;16
17591;Lokiukas;BORUŽĖLĖS;1226376844;Ne;0;1;2;3
17592;Lokiukas;BORUŽĖLĖS;4840187188;Taip;19;0;0;19
17593;Lokiukas;BORUŽĖLĖS;1886540733;Taip;10;1;1;12
17594;Lokiukas;BORUŽĖLĖS;6516980498;Ne;6;0;0;6
17595;Lokiukas;ANČIUKAI;9834746275;Taip;0;0;2;2
17596;Lokiukas;ANČIUKAI;3397999534;Taip;0;3;0;3
17597;Lokiukas;ANČIUKAI;2126391728;Taip;9;0;0;9
17598;Lokiukas;ANČIUKAI;4551069961;Taip;7;0;0;7
17599;Lokiukas;ANČIUKAI;8059759103;Taip;3;0;0;3
17600;Lokiukas;ANČIUKAI;5217458476;Taip;3;0;1;4
17601;Lokiukas;ANČIUKAI;6260486656;Taip;13;4;0;17
17602;Lokiukas;ANČIUKAI;9480025132;Taip;9;0;0;9
17603;Lokiukas;ANČIUKAI;8334800302;Taip;6;4;2;12
17604;Lokiukas;ANČIUKAI;6883994020;Taip;8;0;2;10
17605;Lokiukas;ANČIUKAI;1987485885;Ne;8;0;2;10
17606;Lokiukas;ANČIUKAI;5794303981;Taip;6;9;0;15
17607;Lokiukas;ANČIUKAI;2671053309;Taip;0;0;4;4
17608;Lokiukas;ANČIUKAI;8209165996;Taip;11;2;0;13
17609;Lokiukas;ANČIUKAI;1647778939;Taip;5;0;3;8
17610;Lokiukas;ANČIUKAI;5473316050;Taip;8;0;0;8
17611;Lokiukas;ANČIUKAI;8378138411;Taip;10;0;0;10
17612;Lokiukas;KODĖLČIUKAI;9625041533;Ne;3;1;0;4
17613;Lokiukas;KODĖLČIUKAI;2170176922;Ne;0;0;3;3
17614;Lokiukas;KODĖLČIUKAI;1606617694;Taip;0;7;0;7
17615;Lokiukas;KODĖLČIUKAI;8243342948;Taip;0;3;0;3
17616;Lokiukas;KODĖLČIUKAI;3991821717;Taip;4;2;0;6
17617;Lokiukas;KODĖLČIUKAI;8455869600;Taip;6;0;1;7
17618;Lokiukas;KODĖLČIUKAI;69364831994;Ne;0;1;0;1
17619;Lokiukas;KODĖLČIUKAI;14605095801;Taip;0;1;0;1
17620;Lokiukas;KODĖLČIUKAI;1230490562;Ne;0;0;11;11
17621;Lokiukas;KODĖLČIUKAI;5528406839;Ne;3;2;0;5
17622;Lokiukas;KODĖLČIUKAI;8452600632;Taip;5;5;0;10
17623;Lokiukas;KODĖLČIUKAI;5879386524;Taip;17;0;0;17
17624;Lokiukas;KODĖLČIUKAI;39222094073;Taip;13;0;1;14
17625;Lokiukas;KODĖLČIUKAI;2476231041;Ne;0;1;0;1
17626;Lokiukas;KODĖLČIUKAI;1626698185;Taip;3;1;0;4
17627;Lokiukas;KODĖLČIUKAI;1625137322;Taip;0;4;0;4
17628;Lokiukas;KODĖLČIUKAI;2642065594;Taip;0;9;0;9
17629;Lokiukas;KODĖLČIUKAI;1210407640;Taip;0;2;0;2
17630;Lokiukas;KODĖLČIUKAI;8270572748;Ne;0;0;3;3
17631;Lokiukas;DRUGELIAI;1170293017;Taip;0;9;4;13
17632;Lokiukas;DRUGELIAI;4442073527;Taip;0;5;0;5
17633;Lokiukas;DRUGELIAI;2021477393;Taip;0;1;0;1
17634;Lokiukas;DRUGELIAI;7006828256;Taip;0;6;0;6
17635;Lokiukas;DRUGELIAI;7532603655;Taip;0;13;0;13
17636;Lokiukas;DRUGELIAI;4858829710;Taip;0;2;0;2
17637;Lokiukas;DRUGELIAI;2782818158;Taip;0;2;0;2
17638;Lokiukas;DRUGELIAI;4197547631;Taip;12;1;0;13
17639;Lokiukas;DRUGELIAI;8596706753;Taip;6;0;0;6
17640;Lokiukas;DRUGELIAI;4272205822;Taip;2;9;0;11
17641;Lokiukas;DRUGELIAI;2374601283;Taip;0;0;3;3
17642;Lokiukas;DRUGELIAI;7195184433;Taip;0;1;0;1
17643;Lokiukas;DRUGELIAI;4919744559;Taip;10;0;0;10
17644;Lokiukas;DRUGELIAI;1390586527;Taip;13;0;1;14
17645;Lokiukas;DRUGELIAI;9899561161;Taip;22;0;0;22
17646;Lokiukas;DRUGELIAI;2093224908;Taip;0;9;0;9
17647;Lokiukas;DRUGELIAI;1341265560;Taip;5;3;0;8
17648;Lokiukas;DRUGELIAI;8994257898;Taip;0;22;0;22
17649;Lokiukas;"2 A klasė";25170045140;Taip;22;0;0;22
17650;Lokiukas;"2 A klasė";15406362908;Taip;8;0;0;8
17651;Lokiukas;"2 A klasė";45122233067;Taip;1;0;0;1
17652;Lokiukas;"2 A klasė";15685936471;Taip;2;0;0;2
17653;Lokiukas;"2 A klasė";10948160841;Taip;22;0;0;22
17654;Lokiukas;"2 A klasė";21802863853;Taip;6;0;0;6
17655;Lokiukas;"2 A klasė";84682977618;Taip;2;0;0;2
17656;Lokiukas;"2 A klasė";22979689191;Taip;3;0;0;3
17657;Lokiukas;"2 A klasė";80754592972;Taip;7;0;0;7
17658;Lokiukas;"2 A klasė";14903100496;Taip;1;0;0;1
17659;Lokiukas;"2 A klasė";97609897018;Taip;2;0;0;2
17660;Lokiukas;"2 A klasė";4608275224;Taip;6;0;0;6
17661;Lokiukas;"2 A klasė";99706061553;Taip;3;0;0;3
17662;Lokiukas;"2 A klasė";7785940412;Taip;22;0;0;22
17663;Lokiukas;"2 A klasė";24099693663;Taip;3;0;0;3
17664;Lokiukas;"2 A klasė";72092394330;Taip;2;0;0;2
17665;Lokiukas;"2 A klasė";35769782473;Taip;5;0;0;5
17666;Lokiukas;"2 A klasė";23688235312;Taip;1;0;0;1
17667;Lokiukas;"2 A klasė";43070670534;Taip;2;0;0;2
17668;Lokiukas;"2 A klasė";38531751377;Taip;2;0;0;2
17669;Lokiukas;"2 A klasė";15574258138;Taip;5;0;0;5
17670;Lokiukas;"2 A klasė";59840033826;Taip;2;0;0;2
17671;Lokiukas;"2 A klasė";84273668685;Taip;2;0;0;2
17672;Lokiukas;"2 A klasė";9077016953;Taip;4;0;0;4
17673;Lokiukas;"2 A klasė";9747265775;Taip;3;0;0;3
17674;Lokiukas;"2 A klasė";5198408183;Taip;6;0;0;6
17675;Lokiukas;"2 A klasė";80793623068;Ne;4;0;0;4
17676;Lokiukas;"2 A klasė";93374754851;Taip;2;0;0;2
17677;Lokiukas;"2 A klasė";24523198513;Taip;22;0;0;22
17678;Lokiukas;"2 A klasė";29577495646;Taip;6;0;0;6
17679;Lokiukas;"2 B klasė";61890775725;Taip;9;0;0;9
17680;Lokiukas;"2 B klasė";32506466236;Taip;1;0;0;1
17681;Lokiukas;"2 B klasė";24221829774;Taip;6;0;0;6
17682;Lokiukas;"2 B klasė";96046361641;Taip;5;0;0;5
17683;Lokiukas;"2 B klasė";7324496782;Taip;22;0;0;22
17684;Lokiukas;"2 B klasė";95910336503;Taip;4;0;0;4
17685;Lokiukas;"2 B klasė";58513885211;Taip;2;0;0;2
17686;Lokiukas;"2 B klasė";57958699478;Taip;8;0;0;8
17687;Lokiukas;"2 B klasė";10811780420;Taip;1;0;0;1
17688;Lokiukas;"2 B klasė";18646642032;Taip;2;0;0;2
17689;Lokiukas;"2 B klasė";79109699217;Taip;2;0;0;2
17690;Lokiukas;"2 B klasė";50713289266;Taip;22;0;0;22
17691;Lokiukas;"2 B klasė";20231469825;Taip;10;0;0;10
17692;Lokiukas;"2 B klasė";18336619115;Taip;1;0;0;1
17693;Lokiukas;"2 B klasė";2105377652;Taip;3;0;0;3
17694;Lokiukas;"2 B klasė";39867459515;Taip;8;0;0;8
17695;Lokiukas;"2 B klasė";1146878499;Taip;13;0;0;13
17696;Lokiukas;"2 B klasė";46587243900;Taip;3;0;0;3
17697;Lokiukas;"2 B klasė";62268017779;Taip;1;0;0;1
17698;Lokiukas;"2 B klasė";28796727185;Taip;2;0;0;2
17699;Lokiukas;"2 B klasė";88415635113;Taip;14;0;0;14
17700;Lokiukas;"2 B klasė";9141446821;Taip;7;0;0;7
17701;Lokiukas;"2 B klasė";7497324442;Taip;22;0;0;22
17702;Lokiukas;"2 B klasė";7903535850;Taip;8;0;0;8
17703;Lokiukas;"2 B klasė";75507005694;Taip;2;0;0;2
17704;Lokiukas;"2 B klasė";73426072972;Taip;6;0;0;6
17705;Lokiukas;"2 B klasė";59913848400;Taip;6;0;0;6
17706;Lokiukas;"3 A klasė";67818191566;Taip;8;0;0;8
17707;Lokiukas;"3 A klasė";45280536946;Taip;22;0;0;22
17708;Lokiukas;"3 A klasė";53087036306;Taip;2;0;0;2
17709;Lokiukas;"3 A klasė";79223457439;Taip;4;0;0;4
17710;Lokiukas;"3 A klasė";75613665040;Taip;1;0;0;1
17711;Lokiukas;"3 A klasė";10240586503;Taip;22;0;0;22
17712;Lokiukas;"3 A klasė";86623153797;Taip;2;0;0;2
17713;Lokiukas;"3 A klasė";27050402360;Ne;22;0;0;22
17714;Lokiukas;"3 A klasė";43389930516;Taip;4;0;0;4
17715;Lokiukas;"3 A klasė";23222644824;Taip;3;0;0;3
17716;Lokiukas;"3 A klasė";52296454506;Taip;22;0;0;22
17717;Lokiukas;"3 A klasė";66999644935;Taip;22;0;0;22
17718;Lokiukas;"3 A klasė";72167964645;Taip;1;0;0;1
17719;Lokiukas;"3 A klasė";2143040924;Ne;3;0;0;3
17720;Lokiukas;"3 A klasė";3206276637;Ne;22;0;0;22
17721;Lokiukas;"3 A klasė";5775631777;Taip;4;0;0;4
17722;Lokiukas;"3 A klasė";3703002168;Taip;4;0;0;4
17723;Lokiukas;"3 A klasė";38636200254;Taip;1;0;0;1
17724;Lokiukas;"3 A klasė";47410036889;Taip;4;0;0;4
17725;Lokiukas;"3 A klasė";53544600623;Taip;1;0;0;1
17726;Lokiukas;"3 A klasė";14341255985;Taip;10;0;0;10
17727;Lokiukas;"3 A klasė";6702448475;Taip;6;0;0;6
17728;Lokiukas;"3 A klasė";82966541165;Taip;3;0;0;3
17729;Lokiukas;"3 A klasė";42292408557;Taip;4;0;0;4
17730;Lokiukas;"3 B klasė";35018370441;Taip;22;0;0;22
17731;Lokiukas;"3 B klasė";60370754283;Taip;4;0;0;4
17732;Lokiukas;"3 B klasė";98289469398;Taip;3;0;0;3
17733;Lokiukas;"3 B klasė";15445053855;Taip;1;0;0;1
17734;Lokiukas;"3 B klasė";3262579895;Taip;1;0;0;1
17735;Lokiukas;"3 B klasė";51554951703;Taip;6;0;0;6
17736;Lokiukas;"3 B klasė";88947878548;Taip;5;0;0;5
17737;Lokiukas;"3 B klasė";29198900240;Taip;1;0;0;1
17738;Lokiukas;"3 B klasė";77441549037;Taip;10;0;0;10
17739;Lokiukas;"3 B klasė";79301547085;Taip;1;0;0;1
17740;Lokiukas;"3 B klasė";10897713744;Taip;4;0;0;4
17741;Lokiukas;"3 B klasė";16889795010;Taip;22;0;0;22
17742;Lokiukas;"3 B klasė";5067673212;Taip;1;0;0;1
17743;Lokiukas;"3 B klasė";1104333637;Taip;1;0;0;1
17744;Lokiukas;"3 B klasė";69089214980;Taip;1;0;0;1
17745;Lokiukas;"3 B klasė";45735190114;Taip;22;0;0;22
17746;Lokiukas;"3 B klasė";2353550739;Taip;22;0;0;22
17747;Lokiukas;"3 B klasė";15004419516;Taip;4;0;0;4
17748;Lokiukas;"3 B klasė";1424195731;Taip;22;0;0;22
17749;Lokiukas;"4 A klasė";2374089307;Taip;9;0;0;9
17750;Lokiukas;"4 A klasė";2607988265;Taip;19;0;0;19
17751;Lokiukas;"4 A klasė";4992275038;Taip;15;0;0;15
17752;Lokiukas;"4 A klasė";1492303633;Taip;22;0;0;22
17753;Lokiukas;"4 A klasė";6856770462;Ne;8;0;0;8
17754;Lokiukas;"4 A klasė";8766212402;Ne;22;0;0;22
17755;Lokiukas;"4 A klasė";5559967651;Taip;14;0;0;14
17756;Lokiukas;"4 A klasė";3528533437;Taip;22;0;0;22
17757;Lokiukas;"4 A klasė";5465758477;Taip;5;0;0;5
17758;Lokiukas;"4 A klasė";5700685872;Ne;3;0;0;3
17759;Lokiukas;"4 A klasė";6496662759;Taip;22;0;0;22
17760;Lokiukas;"4 A klasė";5737714024;Ne;22;0;0;22
17761;Lokiukas;"4 A klasė";7069020705;Taip;8;0;0;8
17762;Lokiukas;"4 A klasė";6129602024;Ne;6;0;0;6
17763;Lokiukas;"4 A klasė";9199283952;Taip;22;0;0;22
17764;Lokiukas;"4 A klasė";8378630091;Taip;6;0;0;6
17765;Lokiukas;"4 A klasė";3138145333;Ne;9;0;0;9
17766;Lokiukas;"4 A klasė";3506723678;Taip;21;0;0;21
17767;Lokiukas;"4 A klasė";1555365851;Ne;19;0;0;19
17768;Lokiukas;"4 A klasė";4615481025;Ne;22;0;0;22
17769;Lokiukas;"4 A klasė";5889819809;Ne;9;0;0;9
17770;Lokiukas;"4 A klasė";8499895935;Taip;22;0;0;22
17771;Lokiukas;"4 A klasė";7553457572;Ne;13;0;0;13
17772;Lokiukas;"4 A klasė";1571404671;Taip;5;0;0;5
17773;Lokiukas;"4 A klasė";1729941577;Taip;5;0;0;5
17774;Lokiukas;"4 A klasė";3152845756;Taip;22;0;0;22
17775;Lokiukas;"4 B klasė";5745254234;Taip;14;0;0;14
17776;Lokiukas;"4 B klasė";8189433550;Taip;22;0;0;22
17777;Lokiukas;"4 B klasė";9114504810;Taip;4;0;0;4
17778;Lokiukas;"4 B klasė";1048772300;Taip;14;0;0;14
17779;Lokiukas;"4 B klasė";5918592397;Taip;3;0;0;3
17780;Lokiukas;"4 B klasė";6538311120;Taip;3;0;0;3
17781;Lokiukas;"4 B klasė";7595514531;Taip;4;0;0;4
17782;Lokiukas;"4 B klasė";7144013238;Taip;6;0;0;6
17783;Lokiukas;"4 B klasė";8235437961;Taip;4;0;0;4
17784;Lokiukas;"4 B klasė";2905935730;Taip;22;0;0;22
17785;Lokiukas;"4 B klasė";8395026474;Taip;2;0;0;2
17786;Lokiukas;"4 B klasė";7439047502;Taip;4;0;0;4
17787;Lokiukas;"4 B klasė";8954484534;Taip;3;0;0;3
17788;Lokiukas;"4 B klasė";7722830021;Taip;4;0;0;4
17789;Lokiukas;"4 B klasė";9681048306;Taip;14;0;0;14
17790;Lokiukas;"4 B klasė";1388342336;Taip;3;0;0;3
17791;Lokiukas;"4 B klasė";1746819279;Taip;16;0;0;16
17792;Lokiukas;"4 B klasė";4418425219;Taip;14;0;0;14
17793;Lokiukas;"4 B klasė";3364994110;Taip;22;0;0;22
17794;Lokiukas;"4 B klasė";6063796643;Taip;4;0;0;4
17795;Lokiukas;"4 B klasė";6663700618;Taip;2;0;0;2
17796;Lokiukas;"4 B klasė";1676862169;Taip;14;0;0;14
17797;Lokiukas;"4 B klasė";6151885589;Taip;3;0;0;3
17798;Lokiukas;"4 B klasė";1440437389;Taip;4;0;0;4
17799;Lokiukas;"4 B klasė";2059112380;Taip;4;0;0;4
17800;Šaltinėlis;Ančiukų;9769491789;Taip;0;7;0;7
17801;Šaltinėlis;Ančiukų;56396772538;Taip;0;8;0;8
17802;Šaltinėlis;Ančiukų;6462738640;Taip;4;1;0;5
17803;Šaltinėlis;Ančiukų;9218883174;Taip;13;0;0;13
17804;Šaltinėlis;Ančiukų;7133143923;Taip;12;4;0;16
17805;Šaltinėlis;Ančiukų;9820788524;Taip;0;12;0;12
17806;Šaltinėlis;Ančiukų;3691635011;Taip;5;0;0;5
17807;Šaltinėlis;Ančiukų;2630875135;Taip;0;3;0;3
17808;Šaltinėlis;Ančiukų;2973820849;Taip;10;3;0;13
17809;Šaltinėlis;Ančiukų;9274165569;Taip;0;6;0;6
17810;Šaltinėlis;Ančiukų;4332884673;Taip;5;2;0;7
17811;Šaltinėlis;Ančiukų;9362495172;Taip;0;6;0;6
17812;Šaltinėlis;Ančiukų;7737797979;Taip;11;1;0;12
17813;Šaltinėlis;Ančiukų;6887838949;Taip;4;4;0;8
17814;Šaltinėlis;Ančiukų;2084451705;Taip;20;0;0;20
17815;Šaltinėlis;Ančiukų;1517367843;Taip;0;4;0;4
17816;Šaltinėlis;Ančiukų;5251390843;Taip;4;2;0;6
17817;Šaltinėlis;Bitučių;8902634958;Taip;12;0;2;14
17818;Šaltinėlis;Bitučių;3582666579;Taip;5;0;0;5
17819;Šaltinėlis;Bitučių;1910670134;Taip;0;3;0;3
17820;Šaltinėlis;Bitučių;7247237786;Taip;0;3;0;3
17821;Šaltinėlis;Bitučių;1130153806;Taip;0;7;0;7
17822;Šaltinėlis;Bitučių;9188065549;Ne;5;1;0;6
17823;Šaltinėlis;Bitučių;2801321116;Taip;0;1;0;1
17824;Šaltinėlis;Bitučių;1543331408;Taip;0;0;1;1
17825;Šaltinėlis;Bitučių;6880337593;Ne;3;4;0;7
17826;Šaltinėlis;Bitučių;3516760367;Taip;21;0;0;21
17827;Šaltinėlis;Bitučių;7483928256;Taip;0;1;0;1
17828;Šaltinėlis;Bitučių;9757246434;Taip;22;0;0;22
17829;Šaltinėlis;Bitučių;3609939325;Ne;0;6;0;6
17830;Šaltinėlis;Bitučių;8555517284;Taip;3;0;0;3
17831;Šaltinėlis;Bitučių;9305706589;Ne;4;0;0;4
17832;Šaltinėlis;Saulutės;7311831014;Taip;8;1;0;9
17833;Šaltinėlis;Saulutės;5854723120;Taip;0;10;0;10
17834;Šaltinėlis;Saulutės;5833136956;Taip;0;1;0;1
17835;Šaltinėlis;Saulutės;3483756240;Taip;8;0;0;8
17836;Šaltinėlis;Saulutės;5799032398;Taip;17;0;0;17
17837;Šaltinėlis;Saulutės;5525740049;Taip;5;5;0;10
17838;Šaltinėlis;Saulutės;5382567842;Taip;0;7;0;7
17839;Šaltinėlis;Saulutės;9762392403;Taip;5;3;0;8
17840;Šaltinėlis;Saulutės;4743907195;Taip;6;1;0;7
17841;Šaltinėlis;Saulutės;5343279219;Taip;17;0;0;17
17842;Šaltinėlis;Saulutės;7118672118;Taip;15;0;0;15
17843;Šaltinėlis;Saulutės;2465009553;Taip;0;3;0;3
17844;Šaltinėlis;Saulutės;9108653045;Taip;0;3;0;3
17845;Šaltinėlis;Saulutės;5345738219;Taip;17;0;0;17
17846;Šaltinėlis;Saulutės;6721510313;Taip;0;1;0;1
17847;Šaltinėlis;Saulutės;7650840990;Taip;3;0;0;3
17848;Šaltinėlis;Saulutės;3507180650;Taip;14;0;0;14
17849;Šaltinėlis;Saulutės;1678450741;Taip;0;6;0;6
17850;Šaltinėlis;Saulutės;5774391181;Ne;5;0;0;5
17851;Šaltinėlis;Saulutės;4681460322;Taip;0;2;0;2
17852;Šaltinėlis;Saulutės;3968514430;Taip;0;3;0;3
17853;Šaltinėlis;Meškiukų;5256665649;Ne;5;0;1;6
17854;Šaltinėlis;Meškiukų;6915625306;Taip;13;2;0;15
17855;Šaltinėlis;Meškiukų;6645807642;Taip;16;3;0;19
17856;Šaltinėlis;Meškiukų;9759912102;Ne;4;0;0;4
17857;Šaltinėlis;Meškiukų;4664741207;Taip;0;0;3;3
17858;Šaltinėlis;Meškiukų;1400918201;Taip;22;0;0;22
17859;Šaltinėlis;Meškiukų;5420067622;Taip;0;0;1;1
17860;Šaltinėlis;Meškiukų;1656674673;Taip;8;0;0;8
17861;Šaltinėlis;Meškiukų;4248763165;Taip;0;0;1;1
17862;Šaltinėlis;Meškiukų;5982018366;Taip;22;0;0;22
17863;Šaltinėlis;Meškiukų;9922223978;Taip;8;9;0;17
17864;Šaltinėlis;Meškiukų;8995077908;Taip;3;4;0;7
17865;Šaltinėlis;Meškiukų;5982188743;Ne;10;0;0;10
17866;Šaltinėlis;Meškiukų;6586783795;Taip;10;0;4;14
17867;Šaltinėlis;Meškiukų;1094473189;Ne;0;0;9;9
17868;Šaltinėlis;Meškiukų;7468640592;Taip;10;0;0;10
17869;Šaltinėlis;Nykštukai;9522524163;Taip;22;0;0;22
17870;Šaltinėlis;Nykštukai;4430546695;Taip;10;0;0;10
17871;Šaltinėlis;Nykštukai;1686009371;Taip;12;5;0;17
17872;Šaltinėlis;Nykštukai;9075507649;Taip;1;0;0;1
17873;Šaltinėlis;Nykštukai;7068058767;Taip;0;7;0;7
17874;Šaltinėlis;Nykštukai;8914777163;Taip;0;9;0;9
17875;Šaltinėlis;Nykštukai;7387221265;Taip;0;2;0;2
17876;Šaltinėlis;Nykštukai;3073692882;Taip;14;0;0;14
17877;Šaltinėlis;Nykštukai;2126751248;Taip;21;0;0;21
17878;Šaltinėlis;Nykštukai;7133044918;Taip;22;0;0;22
17879;Šaltinėlis;Nykštukai;2806453623;Taip;5;0;0;5
17880;Šaltinėlis;Nykštukai;8695191968;Taip;8;0;0;8
17881;Šaltinėlis;Nykštukai;2825412170;Taip;1;0;0;1
17882;Šaltinėlis;Nykštukai;2189112609;Taip;10;4;0;14
17883;Šaltinėlis;Nykštukai;5325974488;Taip;0;8;0;8
17884;Šaltinėlis;Nykštukai;1445108285;Taip;12;0;0;12
17885;Šaltinėlis;Nykštukai;9674923143;Taip;0;7;0;7
17886;Šaltinėlis;Nykštukai;9691993251;Taip;5;0;0;5
17887;Šaltinėlis;Nykštukai;3271931810;Taip;9;2;0;11
17888;Šaltinėlis;Perliukų;17147527171;Taip;0;2;0;2
17889;Šaltinėlis;Perliukų;11083638216;Taip;0;6;0;6
17890;Šaltinėlis;Perliukų;52507085619;Taip;0;0;1;1
17891;Šaltinėlis;Perliukų;23301579810;Taip;0;6;0;6
17892;Šaltinėlis;Perliukų;1958647188;Taip;0;8;0;8
17893;Šaltinėlis;Perliukų;1935762293;Taip;6;5;0;11
17894;Šaltinėlis;Perliukų;1583520894;Taip;10;5;0;15
17895;Šaltinėlis;Perliukų;1023238509;Taip;7;0;0;7
17896;Šaltinėlis;Perliukų;84494627465;Taip;0;4;0;4
17897;Šaltinėlis;Perliukų;1004445904;Taip;0;5;0;5
17898;Šaltinėlis;Perliukų;9425353041;Taip;0;5;0;5
17899;Šaltinėlis;Perliukų;526307704;Taip;8;10;0;18
17900;Šaltinėlis;Perliukų;7262120071;Ne;0;3;0;3
17901;Šaltinėlis;Perliukų;6068980312;Taip;6;2;0;8
17902;Šaltinėlis;Perliukų;5869977541;Ne;13;2;0;15
17903;Šaltinėlis;Perliukų;2333071711;Taip;0;3;0;3
17904;Šaltinėlis;Perliukų;1580090516;Taip;0;2;0;2
17905;Šaltinėlis;Perliukų;3660687688;Taip;0;5;0;5
17906;Šaltinėlis;BORUŽĖLĖS;4226929875;Taip;15;0;0;15
17907;Šaltinėlis;BORUŽĖLĖS;5498764523;Taip;14;0;0;14
17908;Šaltinėlis;BORUŽĖLĖS;3901200729;Taip;8;0;0;8
17909;Šaltinėlis;BORUŽĖLĖS;6383844995;Taip;22;0;0;22
17910;Šaltinėlis;BORUŽĖLĖS;2027779524;Taip;13;2;0;15
17911;Šaltinėlis;BORUŽĖLĖS;1312785137;Taip;4;0;0;4
17912;Šaltinėlis;BORUŽĖLĖS;9209105445;Taip;17;0;0;17
17913;Šaltinėlis;BORUŽĖLĖS;1928794692;Taip;18;0;0;18
17914;Šaltinėlis;BORUŽĖLĖS;7120592596;Taip;3;0;0;3
17915;Šaltinėlis;BORUŽĖLĖS;9112527921;Taip;5;4;0;9
17916;Šaltinėlis;BORUŽĖLĖS;1489377928;Taip;4;0;6;10
17917;Šaltinėlis;BORUŽĖLĖS;5005394548;Taip;0;8;0;8
17918;Šaltinėlis;BORUŽĖLĖS;6244924079;Taip;12;0;0;12
17919;Šaltinėlis;BORUŽĖLĖS;3806267811;Taip;9;0;1;10
17920;Šaltinėlis;BORUŽĖLĖS;3497881408;Ne;0;11;0;11
17921;Šaltinėlis;BORUŽĖLĖS;7325258256;Ne;17;0;1;18
17922;Šaltinėlis;BORUŽĖLĖS;1102861619;Taip;7;0;0;7
17923;Šaltinėlis;"4B klasė";7142082502;Ne;0;22;0;22
17924;Šaltinėlis;"4B klasė";1756003648;Taip;0;22;0;22
17925;Šaltinėlis;"4B klasė";4141263000;Ne;0;3;0;3
17926;Šaltinėlis;"4B klasė";3863654037;Ne;0;2;0;2
17927;Šaltinėlis;"4B klasė";5776007602;Ne;0;2;0;2
17928;Šaltinėlis;"4B klasė";3037854361;Ne;0;2;0;2
17929;Šaltinėlis;"4B klasė";2089316824;Ne;0;19;0;19
17930;Šaltinėlis;"4B klasė";7420737103;Ne;0;3;0;3
17931;Šaltinėlis;"4B klasė";8380122669;Ne;0;3;0;3
17932;Šaltinėlis;"4B klasė";82404351290;Taip;0;2;0;2
17933;Šaltinėlis;"4B klasė";5999279571;Ne;0;2;0;2
17934;Šaltinėlis;"4B klasė";3329317171;Ne;0;2;0;2
17935;Šaltinėlis;"4B klasė";8219291385;Ne;0;2;0;2
17936;Šaltinėlis;"4B klasė";49275031765;Taip;0;3;0;3
17937;Šaltinėlis;"4B klasė";3454918343;Taip;0;4;0;4
17938;Šaltinėlis;1A;32264290873;Taip;0;1;0;1
17939;Šaltinėlis;1A;1767635282;Taip;0;6;0;6
17940;Šaltinėlis;1A;1390316465;Taip;0;1;0;1
17941;Šaltinėlis;1A;5442943843;Taip;0;3;0;3
17942;Šaltinėlis;1A;10918276041;Taip;0;6;0;6
17943;Šaltinėlis;1A;3455754351;Taip;0;22;0;22
17944;Šaltinėlis;1A;86592374576;Taip;0;22;0;22
17945;Šaltinėlis;1A;13808708760;Taip;0;4;0;4
17946;Šaltinėlis;1A;79406746980;Taip;0;4;0;4
17947;Šaltinėlis;1A;48525545812;Taip;0;3;0;3
17948;Šaltinėlis;1A;7073644279;Taip;0;5;0;5
17949;Šaltinėlis;1A;3022926855;Taip;0;3;0;3
17950;Šaltinėlis;1A;1190394855;Taip;0;4;0;4
17951;Šaltinėlis;1A;1456486363;Taip;0;10;0;10
17952;Šaltinėlis;1A;32949623652;Taip;0;3;0;3
17953;Šaltinėlis;1A;40186714037;Taip;0;5;0;5
17954;Šaltinėlis;"2A klasė";80649337160;Taip;0;4;0;4
17955;Šaltinėlis;"2A klasė";92958012146;Taip;0;2;0;2
17956;Šaltinėlis;"2A klasė";84656960510;Taip;0;2;0;2
17957;Šaltinėlis;"2A klasė";83621946293;Taip;0;22;0;22
17958;Šaltinėlis;"2A klasė";67808618878;Ne;0;22;0;22
17959;Šaltinėlis;"2A klasė";1278910777;Taip;0;1;0;1
17960;Šaltinėlis;"2A klasė";9647785988;Taip;0;22;0;22
17961;Šaltinėlis;"2A klasė";82671662416;Taip;0;1;0;1
17962;Šaltinėlis;"2A klasė";54025577281;Taip;0;1;0;1
17963;Šaltinėlis;"2A klasė";488285764;Taip;0;1;0;1
17964;Šaltinėlis;"2A klasė";29482180151;Taip;0;2;0;2
17965;Šaltinėlis;"2A klasė";64821172553;Taip;0;8;0;8
17966;Šaltinėlis;"2A klasė";25459069972;Ne;0;4;0;4
17967;Šaltinėlis;"2A klasė";6669392157;Taip;0;3;0;3
17968;Šaltinėlis;"2A klasė";89358384113;Taip;0;4;0;4
17969;Šaltinėlis;"2A klasė";28956971978;Taip;0;2;0;2
17970;Šaltinėlis;"2A klasė";4050444191;Taip;0;1;0;1
17971;Šaltinėlis;"2A klasė";89093437170;Taip;0;1;0;1
17972;Šaltinėlis;"2A klasė";51872331010;Taip;0;8;0;8
17973;Šaltinėlis;"2A klasė";5744976843;Taip;0;1;0;1
17974;Šaltinėlis;"2B klasė";93256161233;Taip;0;6;0;6
17975;Šaltinėlis;"2B klasė";83173349544;Taip;0;2;0;2
17976;Šaltinėlis;"2B klasė";39088869084;Taip;0;8;0;8
17977;Šaltinėlis;"2B klasė";1422035829;Taip;0;22;0;22
17978;Šaltinėlis;"2B klasė";7711903999;Ne;0;3;0;3
17979;Šaltinėlis;"2B klasė";95542489944;Taip;0;1;0;1
17980;Šaltinėlis;"2B klasė";3072314714;Taip;0;1;0;1
17981;Šaltinėlis;"2B klasė";74337710550;Taip;0;2;0;2
17982;Šaltinėlis;"2B klasė";35401075864;Taip;0;22;0;22
17983;Šaltinėlis;"2B klasė";19630605543;Taip;0;6;0;6
17984;Šaltinėlis;"2B klasė";84522552145;Taip;0;4;0;4
17985;Šaltinėlis;"2B klasė";3626545396;Ne;0;2;0;2
17986;Šaltinėlis;"2B klasė";6317111400;Taip;0;4;0;4
17987;Šaltinėlis;"2B klasė";72372808270;Taip;0;3;0;3
17988;Šaltinėlis;"2B klasė";1924418657;Taip;0;4;0;4
17989;Šaltinėlis;"2B klasė";77194317310;Taip;0;3;0;3
17990;Šaltinėlis;"2B klasė";57847832778;Taip;0;2;0;2
17991;Šaltinėlis;"2B klasė";70315400705;Taip;0;3;0;3
17992;Šaltinėlis;"2B klasė";81082410620;Taip;0;5;0;5
17993;Šaltinėlis;"2B klasė";2099800744;Taip;0;2;0;2
17994;Šaltinėlis;"3A klasė";83657465071;Taip;0;2;0;2
17995;Šaltinėlis;"3A klasė";9705941341;Taip;0;3;0;3
17996;Šaltinėlis;"3A klasė";38496350161;Taip;0;22;0;22
17997;Šaltinėlis;"3A klasė";62612067151;Taip;0;1;0;1
17998;Šaltinėlis;"3A klasė";96133834896;Ne;0;22;0;22
17999;Šaltinėlis;"3A klasė";2323456393;Taip;0;22;0;22
18000;Šaltinėlis;"3A klasė";56279691365;Taip;0;2;0;2
18001;Šaltinėlis;"3A klasė";4587186145;Taip;0;2;0;2
18002;Šaltinėlis;"3A klasė";70948186548;Taip;0;2;0;2
18003;Šaltinėlis;"3A klasė";47045578599;Taip;0;2;0;2
18004;Šaltinėlis;"3A klasė";36718328105;Taip;0;3;0;3
18005;Šaltinėlis;"3A klasė";86995081866;Taip;0;22;0;22
18006;Šaltinėlis;"3A klasė";7929809205;Ne;0;2;0;2
18007;Šaltinėlis;"3A klasė";29683761586;Ne;0;10;0;10
18008;Šaltinėlis;"3A klasė";40769315138;Taip;0;4;0;4
18009;Šaltinėlis;"3A klasė";7563879445;Taip;0;2;0;2
18010;Šaltinėlis;"3A klasė";66754907606;Ne;0;22;0;22
18011;Šaltinėlis;"3A klasė";35387543586;Taip;0;5;0;5
18012;Šaltinėlis;"3A klasė";9927833966;Ne;0;2;0;2
18013;Šaltinėlis;"3A klasė";6056572441;Ne;0;4;0;4
18014;Šaltinėlis;"3A klasė";9842958341;Ne;0;6;0;6
18015;Šaltinėlis;"4A klasė";7214517805;Ne;0;22;0;22
18016;Šaltinėlis;"4A klasė";9978493148;Ne;0;2;0;2
18017;Šaltinėlis;"4A klasė";1839665658;Ne;0;2;0;2
18018;Šaltinėlis;"4A klasė";8445115141;Ne;0;2;0;2
18019;Šaltinėlis;"4A klasė";1450894955;Ne;0;22;0;22
18020;Šaltinėlis;"4A klasė";8898225999;Ne;0;22;0;22
18021;Šaltinėlis;"4A klasė";6044895102;Ne;0;2;0;2
18022;Šaltinėlis;"4A klasė";7967108692;Ne;0;2;0;2
18023;Šaltinėlis;"4A klasė";4843823058;Ne;0;3;0;3
18024;Šaltinėlis;"4A klasė";92001008485;Taip;0;5;0;5
18025;Šaltinėlis;"4A klasė";7264810605;Ne;0;4;0;4
18026;Šaltinėlis;"4A klasė";7058348243;Ne;0;6;0;6
18027;Šaltinėlis;"4A klasė";5012608633;Ne;0;1;0;1
18028;Šaltinėlis;"4A klasė";2076892804;Ne;0;3;0;3
18029;Šaltinėlis;"4A klasė";8680271000;Ne;0;22;0;22
18030;Šaltinėlis;"4A klasė";6876036723;Ne;0;5;0;5
18031;Šaltinėlis;"4A klasė";6171441011;Ne;0;22;0;22
18032;Gabijėlė;GANDRIUKŲ;4498088417;Taip;0;2;0;2
18033;Gabijėlė;GANDRIUKŲ;9706026832;Taip;0;1;0;1
18034;Gabijėlė;GANDRIUKŲ;2277489032;Taip;0;0;6;6
18035;Gabijėlė;GANDRIUKŲ;8994076883;Taip;0;0;6;6
18036;Gabijėlė;GANDRIUKŲ;7087892822;Taip;0;0;5;5
18037;Gabijėlė;GANDRIUKŲ;9030890792;Taip;4;0;0;4
18038;Gabijėlė;GANDRIUKŲ;3031333199;Taip;12;0;0;12
18039;Gabijėlė;GANDRIUKŲ;5057272847;Taip;9;6;2;17
18040;Gabijėlė;GANDRIUKŲ;3548399391;Taip;0;4;2;6
18041;Gabijėlė;GANDRIUKŲ;2215880644;Taip;1;0;5;6
18042;Gabijėlė;GANDRIUKŲ;8904768332;Taip;0;5;0;5
18043;Gabijėlė;GANDRIUKŲ;3799003783;Taip;0;2;0;2
18044;Gabijėlė;GANDRIUKŲ;8572833698;Taip;0;0;1;1
18045;Gabijėlė;GANDRIUKŲ;7433142478;Taip;0;0;1;1
18046;Gabijėlė;GANDRIUKŲ;2491503656;Taip;0;5;0;5
18047;Gabijėlė;GANDRIUKŲ;9116153981;Taip;5;2;2;9
18048;Gabijėlė;GANDRIUKŲ;9581539166;Taip;14;3;0;17
18049;Gabijėlė;GANDRIUKŲ;6004026516;Taip;0;6;1;7
18050;Gabijėlė;GANDRIUKŲ;4634029418;Taip;0;4;0;4
18051;Gabijėlė;GANDRIUKŲ;5715645968;Taip;9;0;1;10
18052;Gabijėlė;GANDRIUKŲ;4328252445;Taip;0;5;0;5
18053;Gabijėlė;LAKŠTINGALIUKŲ;5862882027;Taip;8;0;4;12
18054;Gabijėlė;LAKŠTINGALIUKŲ;9491327802;Taip;0;0;1;1
18055;Gabijėlė;LAKŠTINGALIUKŲ;6730947751;Taip;0;4;6;10
18056;Gabijėlė;LAKŠTINGALIUKŲ;8798786098;Taip;0;0;4;4
18057;Gabijėlė;LAKŠTINGALIUKŲ;8035360208;Taip;0;5;0;5
18058;Gabijėlė;LAKŠTINGALIUKŲ;2384469423;Taip;0;0;3;3
18059;Gabijėlė;LAKŠTINGALIUKŲ;8167646385;Taip;0;0;7;7
18060;Gabijėlė;LAKŠTINGALIUKŲ;8926268619;Taip;18;0;0;18
18061;Gabijėlė;LAKŠTINGALIUKŲ;9480021589;Taip;0;6;0;6
18062;Gabijėlė;LAKŠTINGALIUKŲ;3215569531;Taip;0;5;0;5
18063;Gabijėlė;LAKŠTINGALIUKŲ;9324498850;Taip;0;2;0;2
18064;Gabijėlė;LAKŠTINGALIUKŲ;5992403900;Taip;4;0;5;9
18065;Gabijėlė;LAKŠTINGALIUKŲ;2206038658;Taip;0;0;8;8
18066;Gabijėlė;LAKŠTINGALIUKŲ;9116943443;Taip;0;12;0;12
18067;Gabijėlė;LAKŠTINGALIUKŲ;8314088016;Taip;1;2;0;3
18068;Gabijėlė;LAKŠTINGALIUKŲ;6295299651;Taip;1;2;0;3
18069;Gabijėlė;LAKŠTINGALIUKŲ;8383489040;Taip;0;7;0;7
18070;Gabijėlė;LAKŠTINGALIUKŲ;9694544564;Taip;10;0;0;10
18071;Gabijėlė;LAKŠTINGALIUKŲ;6927730664;Taip;4;0;0;4
18072;Gabijėlė;LAKŠTINGALIUKŲ;2550300871;Taip;0;4;0;4
18073;Gabijėlė;LAKŠTINGALIUKŲ;9398722388;Taip;3;1;3;7
18074;Gabijėlė;ŽVIRBLIUKŲ;7043775905;Taip;5;0;0;5
18075;Gabijėlė;ŽVIRBLIUKŲ;4475530177;Taip;0;0;1;1
18076;Gabijėlė;ŽVIRBLIUKŲ;5743861607;Taip;0;0;3;3
18077;Gabijėlė;ŽVIRBLIUKŲ;7410541320;Taip;0;14;0;14
18078;Gabijėlė;ŽVIRBLIUKŲ;4493192224;Taip;8;6;0;14
18079;Gabijėlė;ŽVIRBLIUKŲ;3268231136;Taip;0;19;0;19
18080;Gabijėlė;ŽVIRBLIUKŲ;8879972953;Taip;0;8;0;8
18081;Gabijėlė;ŽVIRBLIUKŲ;5332825339;Taip;0;0;9;9
18082;Gabijėlė;ŽVIRBLIUKŲ;9627906252;Taip;0;0;17;17
18083;Gabijėlė;ŽVIRBLIUKŲ;1725665169;Taip;5;0;0;5
18084;Gabijėlė;ŽVIRBLIUKŲ;2264669298;Taip;9;3;0;12
18085;Gabijėlė;ŽVIRBLIUKŲ;5942625633;Taip;0;0;2;2
18086;Gabijėlė;ŽVIRBLIUKŲ;8292463617;Taip;0;0;4;4
18087;Gabijėlė;ŽVIRBLIUKŲ;3155403180;Taip;0;0;19;19
18088;Gabijėlė;ŽVIRBLIUKŲ;1158461185;Taip;0;0;14;14
18089;Gabijėlė;ŽVIRBLIUKŲ;6604681536;Taip;6;0;0;6
18090;Gabijėlė;ŽVIRBLIUKŲ;4146051969;Taip;6;0;0;6
18091;Gabijėlė;ŽVIRBLIUKŲ;6674038058;Taip;8;0;1;9
18092;Gabijėlė;ŽVIRBLIUKŲ;8823299212;Taip;0;0;5;5
18093;Gabijėlė;GENIUKŲ;3445433386;Taip;0;6;0;6
18094;Gabijėlė;GENIUKŲ;2980295345;Taip;2;2;0;4
18095;Gabijėlė;GENIUKŲ;1862655595;Taip;0;1;0;1
18096;Gabijėlė;GENIUKŲ;7312628876;Taip;0;2;0;2
18097;Gabijėlė;GENIUKŲ;3176075887;Taip;0;11;0;11
18098;Gabijėlė;GENIUKŲ;9972967198;Taip;0;7;3;10
18099;Gabijėlė;GENIUKŲ;8305098808;Taip;0;1;0;1
18100;Gabijėlė;GENIUKŲ;1589534853;Taip;0;2;0;2
18101;Gabijėlė;GENIUKŲ;3020599503;Taip;0;16;0;16
18102;Gabijėlė;GENIUKŲ;1922979974;Taip;0;0;8;8
18103;Gabijėlė;GENIUKŲ;6482824000;Taip;0;1;2;3
18104;Gabijėlė;GENIUKŲ;5962852108;Taip;0;0;10;10
18105;Gabijėlė;GENIUKŲ;1974388885;Taip;0;3;2;5
18106;Gabijėlė;GENIUKŲ;5418276275;Taip;10;0;0;10
18107;Gabijėlė;GENIUKŲ;2407507314;Taip;0;0;8;8
18108;Gabijėlė;DAGILIUKŲ;9120107749;Taip;5;0;1;6
18109;Gabijėlė;DAGILIUKŲ;7426579018;Taip;6;2;0;8
18110;Gabijėlė;DAGILIUKŲ;9783343968;Taip;0;11;0;11
18111;Gabijėlė;DAGILIUKŲ;3700639354;Taip;0;0;2;2
18112;Gabijėlė;DAGILIUKŲ;6438144206;Taip;8;0;5;13
18113;Gabijėlė;DAGILIUKŲ;8078326688;Taip;0;0;1;1
18114;Gabijėlė;DAGILIUKŲ;3017939983;Taip;0;1;0;1
18115;Gabijėlė;DAGILIUKŲ;4462129182;Taip;13;1;1;15
18116;Gabijėlė;DAGILIUKŲ;8662914262;Taip;0;5;0;5
18117;Gabijėlė;DAGILIUKŲ;9280283478;Taip;5;4;0;9
18118;Gabijėlė;DAGILIUKŲ;9503639471;Taip;3;0;2;5
18119;Gabijėlė;DAGILIUKŲ;1988597157;Taip;0;22;0;22
18120;Gabijėlė;DAGILIUKŲ;8036572198;Taip;8;14;0;22
18121;Gabijėlė;DAGILIUKŲ;9895518740;Taip;15;0;0;15
18122;Gabijėlė;DAGILIUKŲ;1455856766;Ne;0;1;2;3
18123;Gabijėlė;DAGILIUKŲ;9449023766;Taip;0;2;0;2
18124;Gabijėlė;DAGILIUKŲ;2254104149;Taip;0;3;0;3
18125;Gabijėlė;DAGILIUKŲ;1286688629;Taip;1;0;1;2
18126;Gabijėlė;DAGILIUKŲ;8864190314;Taip;0;5;0;5
18127;Gabijėlė;DAGILIUKŲ;4797994026;Taip;0;14;0;14
18128;Gabijėlė;PELEDŽIUKŲ;94478599707;Taip;0;0;1;1
18129;Gabijėlė;PELEDŽIUKŲ;2067646395;Taip;0;0;2;2
18130;Gabijėlė;PELEDŽIUKŲ;1068556799;Taip;0;2;0;2
18131;Gabijėlė;PELEDŽIUKŲ;1171257945;Taip;0;2;0;2
18132;Gabijėlė;PELEDŽIUKŲ;8044682830;Taip;0;2;0;2
18133;Gabijėlė;PELEDŽIUKŲ;43109352262;Ne;0;4;0;4
18134;Gabijėlė;PELEDŽIUKŲ;1747282196;Taip;0;0;1;1
18135;Gabijėlė;PELEDŽIUKŲ;39679870094;Taip;7;0;0;7
18136;Gabijėlė;PELEDŽIUKŲ;36642141718;Taip;7;0;0;7
18137;Gabijėlė;PELEDŽIUKŲ;1491653325;Taip;0;2;0;2
18138;Gabijėlė;PELEDŽIUKŲ;1608940997;Taip;0;2;0;2
18139;Gabijėlė;PELEDŽIUKŲ;3610392405;Taip;0;5;0;5
18140;Gabijėlė;PELEDŽIUKŲ;4916964663;Taip;0;2;0;2
18141;Gabijėlė;PELEDŽIUKŲ;17443601729;Taip;5;1;0;6
18142;Gabijėlė;PELEDŽIUKŲ;1286307671;Taip;0;0;1;1
18143;Gabijėlė;PELEDŽIUKŲ;8428069167;Taip;0;0;1;1
18144;Gabijėlė;PELEDŽIUKŲ;4726771205;Taip;0;4;3;7
18145;Gabijėlė;PELEDŽIUKŲ;24035160251;Taip;0;0;3;3
18146;Gabijėlė;PELEDŽIUKŲ;38497069329;Taip;0;0;1;1
18147;Gabijėlė;PELEDŽIUKŲ;54948441867;Taip;0;0;1;1
18148;Gabijėlė;PELEDŽIUKŲ;57559227292;Taip;0;1;0;1
18149;Gabijėlė;PELEDŽIUKŲ;6866641272;Taip;5;0;5;10
18150;Gabijėlė;PELEDŽIUKŲ;9376398157;Taip;0;0;1;1
18151;Gabijėlė;PELEDŽIUKŲ;33124420723;Taip;0;0;1;1
18152;Gabijėlė;KREGZDŽIUKŲ;1759118326;Taip;0;4;0;4
18153;Gabijėlė;KREGZDŽIUKŲ;9533325351;Taip;0;4;0;4
18154;Gabijėlė;KREGZDŽIUKŲ;5407565441;Taip;19;0;0;19
18155;Gabijėlė;KREGZDŽIUKŲ;8327903800;Taip;0;0;1;1
18156;Gabijėlė;KREGZDŽIUKŲ;6845038692;Taip;6;0;0;6
18157;Gabijėlė;KREGZDŽIUKŲ;9683202312;Taip;0;0;4;4
18158;Gabijėlė;KREGZDŽIUKŲ;2357515455;Taip;4;0;0;4
18159;Gabijėlė;KREGZDŽIUKŲ;1574272380;Taip;0;6;0;6
18160;Gabijėlė;KREGZDŽIUKŲ;9675186834;Taip;8;3;0;11
18161;Gabijėlė;KREGZDŽIUKŲ;2634722171;Taip;0;1;0;1
18162;Gabijėlė;KREGZDŽIUKŲ;3584692524;Taip;0;2;0;2
18163;Gabijėlė;KREGZDŽIUKŲ;8613821848;Taip;3;0;0;3
18164;Gabijėlė;KREGZDŽIUKŲ;4317708029;Taip;0;12;0;12
18165;Gabijėlė;KREGZDŽIUKŲ;7038167942;Taip;0;1;0;1
18166;Gabijėlė;KREGZDŽIUKŲ;8555272917;Taip;3;0;1;4
18167;Gabijėlė;KREGZDŽIUKŲ;1142939183;Taip;6;0;0;6
18168;Gabijėlė;KREGZDŽIUKŲ;2251276876;Taip;0;1;0;1
18169;Gabijėlė;KREGZDŽIUKŲ;6570702235;Taip;6;0;0;6
18170;Gabijėlė;ZYLIUKŲ;6154378055;Taip;9;0;1;10
18171;Gabijėlė;ZYLIUKŲ;2727329238;Taip;0;6;0;6
18172;Gabijėlė;ZYLIUKŲ;7700700293;Taip;13;0;0;13
18173;Gabijėlė;ZYLIUKŲ;6759447513;Taip;0;9;0;9
18174;Gabijėlė;ZYLIUKŲ;1090635644;Taip;0;0;2;2
18175;Gabijėlė;ZYLIUKŲ;4267803371;Taip;0;0;1;1
18176;Gabijėlė;ZYLIUKŲ;9259673720;Taip;1;5;1;7
18177;Gabijėlė;ZYLIUKŲ;2764185879;Taip;0;0;4;4
18178;Gabijėlė;ZYLIUKŲ;8362509831;Taip;0;1;0;1
18179;Gabijėlė;ZYLIUKŲ;4907669556;Taip;0;1;0;1
18180;Gabijėlė;ZYLIUKŲ;1947898190;Taip;0;2;0;2
18181;Gabijėlė;ZYLIUKŲ;2384174631;Taip;0;0;2;2
18182;Gabijėlė;ZYLIUKŲ;6562965816;Taip;5;0;4;9
18183;Gabijėlė;ZYLIUKŲ;4376486874;Taip;6;0;0;6
18184;Gabijėlė;ZYLIUKŲ;7047606048;Taip;4;0;4;8
18185;Gabijėlė;ZYLIUKŲ;6983092888;Taip;0;0;2;2
18186;Gabijėlė;VOLUNGĖLIŲ;4166739739;Taip;0;5;0;5
18187;Gabijėlė;VOLUNGĖLIŲ;1492231030;Taip;0;5;0;5
18188;Gabijėlė;VOLUNGĖLIŲ;21740150080;Taip;0;8;0;8
18189;Gabijėlė;VOLUNGĖLIŲ;5558919097;Taip;0;0;2;2
18190;Gabijėlė;VOLUNGĖLIŲ;92191048844;Taip;0;0;1;1
18191;Gabijėlė;VOLUNGĖLIŲ;9683524530;Taip;6;0;0;6
18192;Gabijėlė;VOLUNGĖLIŲ;59837942520;Taip;4;0;0;4
18193;Gabijėlė;VOLUNGĖLIŲ;46021970332;Taip;0;14;0;14
18194;Gabijėlė;VOLUNGĖLIŲ;8480479946;Taip;0;8;0;8
18195;Gabijėlė;VOLUNGĖLIŲ;13265905500;Taip;0;1;0;1
18196;Gabijėlė;VOLUNGĖLIŲ;43737170074;Taip;0;3;0;3
18197;Gabijėlė;VOLUNGĖLIŲ;1480704497;Taip;0;1;0;1
18198;Gabijėlė;VOLUNGĖLIŲ;5704281727;Taip;0;0;2;2
18199;Gabijėlė;VOLUNGĖLIŲ;95685721388;Taip;0;9;0;9
18200;Gabijėlė;VOLUNGĖLIŲ;29328876924;Taip;0;0;1;1
18201;Gabijėlė;VOLUNGĖLIŲ;76416239647;Taip;2;0;0;2
18202;Gabijėlė;VOLUNGĖLIŲ;2102821834;Taip;0;0;2;2
18203;Gabijėlė;VOLUNGĖLIŲ;6271780003;Ne;0;0;1;1
18204;Gabijėlė;VOLUNGĖLIŲ;2051109865;Taip;0;10;0;10
18205;Gabijėlė;VOLUNGĖLIŲ;64252867351;Taip;0;3;0;3
18206;Gabijėlė;ANČIUKŲ;43123279348;Taip;0;9;0;9
18207;Gabijėlė;ANČIUKŲ;2036978425;Taip;0;9;0;9
18208;Gabijėlė;ANČIUKŲ;10796114623;Taip;0;1;0;1
18209;Gabijėlė;ANČIUKŲ;3454412432;Taip;0;7;0;7
18210;Gabijėlė;ANČIUKŲ;4752631976;Taip;0;0;2;2
18211;Gabijėlė;ANČIUKŲ;1415184607;Taip;3;0;3;6
18212;Gabijėlė;ANČIUKŲ;85836097485;Taip;5;0;2;7
18213;Gabijėlė;ANČIUKŲ;28017865889;Taip;0;6;0;6
18214;Gabijėlė;ANČIUKŲ;1917587420;Taip;0;6;0;6
18215;Gabijėlė;ANČIUKŲ;1465584524;Taip;4;0;1;5
18216;Gabijėlė;ANČIUKŲ;6198439092;Taip;3;4;0;7
18217;Gabijėlė;ANČIUKŲ;5783373671;Taip;0;3;0;3
18218;Gabijėlė;ANČIUKŲ;7948343328;Taip;0;11;0;11
18219;Gabijėlė;ANČIUKŲ;2052892422;Taip;4;0;4;8
18220;Gabijėlė;ANČIUKŲ;8111239476;Taip;0;9;0;9
18221;Gabijėlė;ANČIUKŲ;8778396292;Taip;9;0;4;13
18222;Gabijėlė;ANČIUKŲ;4085049535;Taip;0;5;0;5
18223;Gabijėlė;ANČIUKŲ;8893637755;Taip;0;11;0;11
18224;Gabijėlė;ANČIUKŲ;8874692591;Taip;0;0;6;6
18225;Gabijėlė;BALANDŽIUKŲ;6196322537;Taip;0;0;1;1
18226;Gabijėlė;BALANDŽIUKŲ;4110081664;Taip;5;0;0;5
18227;Gabijėlė;BALANDŽIUKŲ;9157819780;Taip;0;4;0;4
18228;Gabijėlė;BALANDŽIUKŲ;2921208571;Taip;5;0;0;5
18229;Gabijėlė;BALANDŽIUKŲ;1045338865;Taip;0;12;0;12
18230;Gabijėlė;BALANDŽIUKŲ;2097260657;Taip;0;1;2;3
18231;Gabijėlė;BALANDŽIUKŲ;8131229306;Taip;2;0;10;12
18232;Gabijėlė;BALANDŽIUKŲ;8525869648;Taip;3;3;0;6
18233;Gabijėlė;BALANDŽIUKŲ;2070050969;Taip;0;4;0;4
18234;Gabijėlė;BALANDŽIUKŲ;15049855022;Taip;0;8;0;8
18235;Gabijėlė;BALANDŽIUKŲ;2776579713;Taip;6;0;3;9
18236;Gabijėlė;BALANDŽIUKŲ;9197020006;Taip;0;2;0;2
18237;Gabijėlė;BALANDŽIUKŲ;1615940996;Taip;0;0;5;5
18238;Gabijėlė;BALANDŽIUKŲ;1273722177;Taip;20;0;0;20
18239;Gabijėlė;BALANDŽIUKŲ;8746641978;Taip;0;5;4;9
18240;Gabijėlė;BALANDŽIUKŲ;65735862964;Taip;0;1;1;2
18241;Gabijėlė;VYTURIUKŲ;2059859352;Taip;4;0;0;4
18242;Gabijėlė;VYTURIUKŲ;3484413830;Taip;0;0;2;2
18243;Gabijėlė;VYTURIUKŲ;87868591956;Taip;13;0;0;13
18244;Gabijėlė;VYTURIUKŲ;1859288888;Taip;0;1;2;3
18245;Gabijėlė;VYTURIUKŲ;44322663690;Taip;0;0;4;4
18246;Gabijėlė;VYTURIUKŲ;4765125810;Taip;3;0;1;4
18247;Gabijėlė;VYTURIUKŲ;1219257874;Taip;2;4;0;6
18248;Gabijėlė;VYTURIUKŲ;1829866148;Taip;6;0;0;6
18249;Gabijėlė;VYTURIUKŲ;1949644078;Taip;0;8;0;8
18250;Gabijėlė;VYTURIUKŲ;47989272121;Taip;0;2;0;2
18251;Gabijėlė;VYTURIUKŲ;5736000160;Taip;13;0;3;16
18252;Gabijėlė;VYTURIUKŲ;4632508075;Taip;0;0;1;1
18253;Gabijėlė;VYTURIUKŲ;1426802917;Taip;0;5;1;6
18254;Gabijėlė;VYTURIUKŲ;41212490042;Taip;0;0;3;3
18255;Gabijėlė;VYTURIUKŲ;1852597048;Taip;0;0;1;1
18256;Gabijėlė;VYTURIUKŲ;1287165224;Taip;0;0;1;1
18257;Gabijėlė;VYTURIUKŲ;34609028374;Taip;0;2;0;2
18258;Gabijėlė;VYTURIUKŲ;48342584892;Taip;0;0;1;1
18259;Gabijėlė;VYTURIUKŲ;1185452849;Taip;3;0;0;3
18260;Gabijėlė;VYTURIUKŲ;6492199649;Taip;3;2;1;6
18261;Saulėgrąža;Gudručiai;1765068230;Taip;0;0;1;1
18262;Saulėgrąža;Gudručiai;89296280794;Taip;0;0;3;3
18263;Saulėgrąža;Gudručiai;61216523654;Taip;4;0;0;4
18264;Saulėgrąža;Gudručiai;83822678544;Taip;15;0;0;15
18265;Saulėgrąža;Gudručiai;30031307014;Taip;0;0;4;4
18266;Saulėgrąža;Gudručiai;48794489414;Taip;0;0;4;4
18267;Saulėgrąža;Gudručiai;324203958;Taip;0;0;3;3
18268;Saulėgrąža;Gudručiai;8589104624;Taip;0;2;1;3
18269;Saulėgrąža;Gudručiai;1529330828;Ne;0;0;5;5
18270;Saulėgrąža;Gudručiai;3360745408;Taip;10;0;0;10
18271;Saulėgrąža;Gudručiai;7662786913;Taip;5;0;0;5
18272;Saulėgrąža;Gudručiai;2098470842;Taip;3;0;0;3
18273;Saulėgrąža;Gudručiai;1600632550;Taip;0;1;0;1
18274;Saulėgrąža;Gudručiai;4567469696;Taip;4;0;0;4
18275;Saulėgrąža;Gudručiai;9633623577;Taip;0;0;2;2
18276;Saulėgrąža;Gudručiai;7506522045;Taip;10;0;0;10
18277;Saulėgrąža;Gudručiai;1750741211;Taip;6;0;2;8
18278;Saulėgrąža;"Boruželės ";3334830210;Taip;10;10;0;20
18279;Saulėgrąža;"Boruželės ";1220044197;Taip;0;1;0;1
18280;Saulėgrąža;"Boruželės ";2325641957;Taip;5;9;2;16
18281;Saulėgrąža;"Boruželės ";2142393859;Taip;13;8;0;21
18282;Saulėgrąža;"Boruželės ";9377753981;Taip;0;2;5;7
18283;Saulėgrąža;"Boruželės ";2811204521;Taip;5;4;0;9
18284;Saulėgrąža;"Boruželės ";9703861091;Taip;1;4;0;5
18285;Saulėgrąža;"Boruželės ";6925730672;Taip;10;8;0;18
18286;Saulėgrąža;"Boruželės ";2787116787;Taip;0;5;0;5
18287;Saulėgrąža;"Boruželės ";6188169984;Taip;12;10;6;28
18288;Saulėgrąža;"Boruželės ";3455052574;Taip;2;7;0;9
18289;Saulėgrąža;"Boruželės ";6803731510;Taip;0;10;4;14
18290;Saulėgrąža;"Boruželės ";5493928884;Taip;3;9;0;12
18291;Saulėgrąža;"Boruželės ";9537997340;Taip;0;2;0;2
18292;Saulėgrąža;"Boruželės ";4593109666;Taip;0;7;0;7
18293;Saulėgrąža;"Boruželės ";3460944414;Taip;5;0;1;6
18294;Saulėgrąža;"Boruželės ";8066720746;Taip;12;0;0;12
18295;Saulėgrąža;"Boruželės ";4656827505;Taip;10;2;0;12
18296;Saulėgrąža;"Boruželės ";1557512232;Taip;3;5;0;8
18297;Saulėgrąža;"Boruželės ";4347883309;Taip;8;0;0;8
18298;Saulėgrąža;"Boruželės ";6087243776;Taip;0;6;10;16
18299;Saulėgrąža;Žiogeliai;7400016718;Taip;0;13;1;14
18300;Saulėgrąža;Žiogeliai;8518372931;Taip;0;0;5;5
18301;Saulėgrąža;Žiogeliai;3540590993;Taip;0;5;3;8
18302;Saulėgrąža;Žiogeliai;6909434851;Taip;4;9;0;13
18303;Saulėgrąža;Žiogeliai;6297303519;Taip;4;9;0;13
18304;Saulėgrąža;Žiogeliai;7399313501;Taip;11;3;0;14
18305;Saulėgrąža;Žiogeliai;8649254574;Taip;13;3;2;18
18306;Saulėgrąža;Žiogeliai;5991261247;Taip;8;0;1;9
18307;Saulėgrąža;Žiogeliai;9609919355;Taip;0;5;0;5
18308;Saulėgrąža;Žiogeliai;2551242973;Taip;3;1;8;12
18309;Saulėgrąža;Žiogeliai;6332380237;Taip;0;2;1;3
18310;Saulėgrąža;Žiogeliai;7881751334;Ne;6;2;0;8
18311;Saulėgrąža;Žiogeliai;4332729441;Ne;3;13;1;17
18312;Saulėgrąža;Žiogeliai;6818436741;Taip;8;6;3;17
18313;Saulėgrąža;Žiogeliai;3290592235;Taip;3;0;0;3
18314;Saulėgrąža;Žiogeliai;3690611746;Taip;9;0;2;11
18315;Saulėgrąža;Žiogeliai;7807068772;Taip;0;6;5;11
18316;Saulėgrąža;Žiogeliai;1961682373;Taip;0;5;4;9
18317;Saulėgrąža;Žiogeliai;5360973768;Ne;0;1;1;2
18318;Saulėgrąža;Žiogeliai;8769720021;Taip;3;0;1;4
18319;Saulėgrąža;Žiogeliai;7329004031;Taip;0;7;0;7
18320;Saulėgrąža;Žiogeliai;5328915059;Taip;8;2;2;12
18321;Saulėgrąža;Drugeliai;8155080474;Taip;0;8;0;8
18322;Saulėgrąža;Drugeliai;1955944355;Taip;0;1;0;1
18323;Saulėgrąža;Drugeliai;2680631642;Taip;0;1;0;1
18324;Saulėgrąža;Drugeliai;8337203952;Taip;0;1;0;1
18325;Saulėgrąža;Drugeliai;6127496900;Taip;3;13;0;16
18326;Saulėgrąža;Drugeliai;8841882983;Taip;14;3;0;17
18327;Saulėgrąža;Drugeliai;6608001857;Taip;8;5;1;14
18328;Saulėgrąža;Drugeliai;4663169787;Taip;0;2;2;4
18329;Saulėgrąža;Drugeliai;6981928727;Taip;0;7;0;7
18330;Saulėgrąža;Drugeliai;8873608939;Taip;0;4;0;4
18331;Saulėgrąža;Drugeliai;8138991066;Taip;6;3;0;9
18332;Saulėgrąža;Drugeliai;1379283244;Taip;0;8;0;8
18333;Saulėgrąža;Drugeliai;4767744537;Taip;22;6;0;28
18334;Saulėgrąža;Drugeliai;4361365993;Taip;0;2;0;2
18335;Saulėgrąža;Drugeliai;8882080945;Taip;8;0;4;12
18336;Saulėgrąža;Drugeliai;1080500584;Taip;0;8;0;8
18337;Saulėgrąža;Drugeliai;1386348080;Taip;0;2;1;3
18338;Saulėgrąža;Drugeliai;3318222372;Taip;0;11;0;11
18339;Saulėgrąža;Drugeliai;8148900529;Taip;0;2;2;4
18340;Saulėgrąža;Drugeliai;3988854847;Taip;0;2;4;6
18341;Saulėgrąža;Pabiručiai;3124081874;Taip;0;0;16;16
18342;Saulėgrąža;Pabiručiai;3898229402;Taip;13;0;1;14
18343;Saulėgrąža;Pabiručiai;7795898798;Taip;0;8;0;8
18344;Saulėgrąža;Pabiručiai;8100161189;Taip;10;0;0;10
18345;Saulėgrąža;Pabiručiai;2320995262;Taip;2;0;1;3
18346;Saulėgrąža;Pabiručiai;1193968905;Taip;9;0;1;10
18347;Saulėgrąža;Pabiručiai;6924492377;Taip;6;0;0;6
18348;Saulėgrąža;Pabiručiai;9812784697;Taip;17;0;0;17
18349;Saulėgrąža;Pabiručiai;1732823416;Taip;15;0;0;15
18350;Saulėgrąža;Pabiručiai;2063366170;Taip;7;0;2;9
18351;Saulėgrąža;Pabiručiai;5417303387;Taip;10;0;1;11
18352;Saulėgrąža;Pabiručiai;4687158499;Taip;0;1;0;1
18353;Saulėgrąža;Pabiručiai;6937382186;Taip;0;0;21;21
18354;Saulėgrąža;Pabiručiai;4113866451;Taip;10;0;0;10
18355;Saulėgrąža;Pabiručiai;5168679344;Taip;12;0;1;13
18356;Saulėgrąža;Pabiručiai;3467805481;Taip;0;0;2;2
18357;Saulėgrąža;Pabiručiai;1217899072;Taip;10;4;0;14
18358;Saulėgrąža;Pabiručiai;5759064166;Taip;6;0;0;6
18359;Saulėgrąža;Žvirbliukai;4204112706;Taip;0;5;0;5
18360;Saulėgrąža;Žvirbliukai;4252425680;Taip;0;2;1;3
18361;Saulėgrąža;Žvirbliukai;7374802873;Taip;0;2;0;2
18362;Saulėgrąža;Žvirbliukai;7804106261;Taip;4;0;0;4
18363;Saulėgrąža;Žvirbliukai;3551146001;Taip;4;5;0;9
18364;Saulėgrąža;Žvirbliukai;9859511749;Taip;5;0;0;5
18365;Saulėgrąža;Žvirbliukai;1563002207;Taip;0;10;0;10
18366;Saulėgrąža;Žvirbliukai;1314754650;Taip;0;11;0;11
18367;Saulėgrąža;Žvirbliukai;7236623241;Taip;0;1;0;1
18368;Saulėgrąža;Žvirbliukai;9641357813;Taip;0;5;0;5
18369;Saulėgrąža;Žvirbliukai;3214026239;Taip;5;0;0;5
18370;Saulėgrąža;Žvirbliukai;5201590576;Taip;0;4;0;4
18371;Saulėgrąža;Žvirbliukai;6627868194;Taip;8;0;0;8
18372;Saulėgrąža;Žvirbliukai;7964046826;Taip;0;1;0;1
18373;Saulėgrąža;Žvirbliukai;2378071205;Ne;13;0;0;13
18374;Saulėgrąža;Žvirbliukai;12350048317;Taip;5;5;0;10
18375;Saulėgrąža;Pagrandukai;8766433391;Taip;3;8;2;13
18376;Saulėgrąža;Pagrandukai;8531862400;Taip;0;0;10;10
18377;Saulėgrąža;Pagrandukai;9437387272;Ne;8;0;15;23
18378;Saulėgrąža;Pagrandukai;6641588877;Taip;4;0;5;9
18379;Saulėgrąža;Pagrandukai;1381240000;Taip;0;0;10;10
18380;Saulėgrąža;Pagrandukai;4265356484;Taip;0;0;4;4
18381;Saulėgrąža;Pagrandukai;2042826101;Taip;0;0;4;4
18382;Saulėgrąža;Pagrandukai;5940167166;Taip;0;0;9;9
18383;Saulėgrąža;Pagrandukai;4733063461;Taip;0;0;9;9
18384;Saulėgrąža;Pagrandukai;3319538368;Taip;13;0;14;27
18385;Saulėgrąža;Pagrandukai;7387477589;Taip;5;1;2;8
18386;Saulėgrąža;Pagrandukai;7283302671;Taip;0;0;14;14
18387;Saulėgrąža;Pagrandukai;8597567633;Taip;5;0;3;8
18388;Saulėgrąža;Pagrandukai;2809788049;Taip;5;0;2;7
18389;Saulėgrąža;Pagrandukai;5221286194;Taip;1;0;8;9
18390;Saulėgrąža;Pagrandukai;9481319116;Taip;0;0;3;3
18391;Saulėgrąža;Pagrandukai;8384708422;Taip;0;2;6;8
18392;Saulėgrąža;Pagrandukai;1345079291;Taip;0;14;2;16
18393;Pilaitukas;BITUTĖS;4305634374;Taip;18;0;0;18
18394;Pilaitukas;BITUTĖS;8169484415;Taip;0;8;0;8
18395;Pilaitukas;BITUTĖS;1253300093;Taip;4;1;0;5
18396;Pilaitukas;BITUTĖS;2242454299;Taip;0;2;0;2
18397;Pilaitukas;BITUTĖS;9793278788;Taip;0;2;0;2
18398;Pilaitukas;BITUTĖS;4082490488;Taip;2;10;0;12
18399;Pilaitukas;BITUTĖS;3345387791;Taip;0;14;1;15
18400;Pilaitukas;BITUTĖS;3913169122;Taip;0;1;0;1
18401;Pilaitukas;BITUTĖS;3541354283;Taip;0;1;0;1
18402;Pilaitukas;BITUTĖS;5740951665;Taip;0;1;5;6
18403;Pilaitukas;BITUTĖS;4591799893;Taip;16;0;0;16
18404;Pilaitukas;BITUTĖS;6308557885;Taip;14;0;0;14
18405;Pilaitukas;BITUTĖS;6514731102;Taip;10;0;0;10
18406;Pilaitukas;BITUTĖS;5988165204;Taip;0;0;1;1
18407;Pilaitukas;BITUTĖS;3037850837;Taip;0;1;0;1
18408;Pilaitukas;BITUTĖS;9126553732;Taip;8;5;0;13
18409;Pilaitukas;BITUTĖS;7438112270;Taip;3;0;2;5
18410;Pilaitukas;BITUTĖS;1295215465;Taip;0;1;0;1
18411;Pilaitukas;BITUTĖS;5331915157;Taip;0;0;1;1
18412;Pilaitukas;BITUTĖS;3159733673;Taip;5;2;1;8
18413;Pilaitukas;BITUTĖS;2122392982;Taip;0;1;0;1
18414;Pilaitukas;ZUIKUČIAI;8993885764;Taip;4;0;0;4
18415;Pilaitukas;ZUIKUČIAI;5206637809;Taip;0;3;2;5
18416;Pilaitukas;ZUIKUČIAI;5288784331;Taip;0;5;1;6
18417;Pilaitukas;ZUIKUČIAI;8255398803;Taip;14;1;0;15
18418;Pilaitukas;ZUIKUČIAI;2862447956;Taip;4;1;0;5
18419;Pilaitukas;ZUIKUČIAI;8727175656;Taip;4;1;0;5
18420;Pilaitukas;ZUIKUČIAI;8207194955;Taip;8;0;2;10
18421;Pilaitukas;ZUIKUČIAI;5640802570;Taip;0;1;0;1
18422;Pilaitukas;ZUIKUČIAI;4623818227;Taip;4;0;0;4
18423;Pilaitukas;ZUIKUČIAI;9260893320;Ne;0;3;0;3
18424;Pilaitukas;ZUIKUČIAI;1607454890;Taip;0;0;1;1
18425;Pilaitukas;ZUIKUČIAI;5710747769;Taip;0;10;1;11
18426;Pilaitukas;ZUIKUČIAI;7568744500;Taip;0;0;3;3
18427;Pilaitukas;ZUIKUČIAI;5407354218;Taip;0;0;1;1
18428;Pilaitukas;ZUIKUČIAI;1704055907;Taip;0;0;8;8
18429;Pilaitukas;ZUIKUČIAI;7853910193;Taip;4;0;0;4
18430;Pilaitukas;ZUIKUČIAI;9735358433;Taip;0;1;0;1
18431;Pilaitukas;ZUIKUČIAI;2705235576;Taip;5;7;3;15
18432;Pilaitukas;ZUIKUČIAI;9688421636;Taip;0;4;0;4
18433;Pilaitukas;ANČIUKAI;92108889661;Taip;0;0;4;4
18434;Pilaitukas;ANČIUKAI;9724892897;Taip;8;0;0;8
18435;Pilaitukas;ANČIUKAI;1114477688;Taip;0;6;0;6
18436;Pilaitukas;ANČIUKAI;1512181401;Taip;3;0;1;4
18437;Pilaitukas;ANČIUKAI;3821748678;Taip;5;0;0;5
18438;Pilaitukas;ANČIUKAI;8319676743;Taip;0;0;1;1
18439;Pilaitukas;ANČIUKAI;4505384039;Taip;0;0;2;2
18440;Pilaitukas;ANČIUKAI;5206439753;Taip;2;6;0;8
18441;Pilaitukas;ANČIUKAI;79485847381;Taip;0;0;3;3
18442;Pilaitukas;ANČIUKAI;87760608710;Taip;0;0;5;5
18443;Pilaitukas;ANČIUKAI;7909465673;Taip;0;0;3;3
18444;Pilaitukas;ANČIUKAI;2298935154;Taip;5;0;0;5
18445;Pilaitukas;ANČIUKAI;4694691187;Taip;0;5;0;5
18446;Pilaitukas;ANČIUKAI;9224653856;Taip;0;5;3;8
18447;Pilaitukas;ANČIUKAI;58250008277;Taip;0;0;2;2
18448;Pilaitukas;ANČIUKAI;5252233127;Taip;0;4;0;4
18449;Pilaitukas;MEŠKIUKAI;57931719105;Taip;5;0;0;5
18450;Pilaitukas;MEŠKIUKAI;14554050141;Taip;0;2;0;2
18451;Pilaitukas;MEŠKIUKAI;2929868229;Taip;4;0;0;4
18452;Pilaitukas;MEŠKIUKAI;1135880899;Taip;4;3;0;7
18453;Pilaitukas;MEŠKIUKAI;4505147961;Taip;0;0;1;1
18454;Pilaitukas;MEŠKIUKAI;9618329726;Taip;5;0;2;7
18455;Pilaitukas;MEŠKIUKAI;9732741366;Taip;6;0;1;7
18456;Pilaitukas;MEŠKIUKAI;4038320896;Taip;0;12;0;12
18457;Pilaitukas;MEŠKIUKAI;3794882532;Taip;4;0;0;4
18458;Pilaitukas;MEŠKIUKAI;18466900688;Taip;0;8;0;8
18459;Pilaitukas;MEŠKIUKAI;2736736697;Taip;0;7;0;7
18460;Pilaitukas;MEŠKIUKAI;3214740183;Taip;0;1;0;1
18461;Pilaitukas;MEŠKIUKAI;39600380611;Taip;6;0;0;6
18462;Pilaitukas;MEŠKIUKAI;5604992163;Taip;0;3;0;3
18463;Pilaitukas;MEŠKIUKAI;9450834035;Taip;0;3;0;3
18464;Pilaitukas;MEŠKIUKAI;1003278169;Taip;10;0;0;10
18465;Pilaitukas;MEŠKIUKAI;6117985788;Taip;15;3;0;18
18466;Pilaitukas;MEŠKIUKAI;9924612250;Taip;0;0;1;1
18467;Pilaitukas;ŽUVYTĖS;1611616941;Taip;0;6;0;6
18468;Pilaitukas;ŽUVYTĖS;29229117661;Taip;0;5;0;5
18469;Pilaitukas;ŽUVYTĖS;4306078592;Taip;5;0;0;5
18470;Pilaitukas;ŽUVYTĖS;54387359229;Taip;0;8;0;8
18471;Pilaitukas;ŽUVYTĖS;12327235652;Ne;4;0;0;4
18472;Pilaitukas;ŽUVYTĖS;42514613325;Taip;11;0;0;11
18473;Pilaitukas;ŽUVYTĖS;89719236172;Taip;0;4;0;4
18474;Pilaitukas;ŽUVYTĖS;89730708991;Taip;0;0;2;2
18475;Pilaitukas;ŽUVYTĖS;68571454940;Taip;0;3;0;3
18476;Pilaitukas;ŽUVYTĖS;3685682772;Taip;0;22;0;22
18477;Pilaitukas;ŽUVYTĖS;90148331957;Taip;17;0;0;17
18478;Pilaitukas;ŽUVYTĖS;71302602535;Taip;0;0;2;2
18479;Pilaitukas;ŽUVYTĖS;54706920576;Taip;0;0;5;5
18480;Pilaitukas;ŽUVYTĖS;26063381713;Taip;0;8;0;8
18481;Pilaitukas;ŽUVYTĖS;8152280709;Taip;2;0;1;3
18482;Pilaitukas;ŽUVYTĖS;1613536796;Taip;0;0;2;2
18483;Pilaitukas;ŽUVYTĖS;15303269615;Taip;0;2;0;2
18484;Pilaitukas;ŽUVYTĖS;1779631590;Taip;0;0;2;2
18485;Pilaitukas;ŽUVYTĖS;2466250509;Ne;0;0;1;1
18486;Pilaitukas;ŽUVYTĖS;48011638560;Taip;7;1;2;10
18487;Pilaitukas;ŽUVYTĖS;1426526569;Ne;0;0;4;4
18488;Pilaitukas;PAUKŠTELIAI;7082054458;Taip;0;6;0;6
18489;Pilaitukas;PAUKŠTELIAI;7961518607;Taip;0;6;0;6
18490;Pilaitukas;PAUKŠTELIAI;8640149293;Taip;0;0;1;1
18491;Pilaitukas;PAUKŠTELIAI;1056269188;Taip;0;1;0;1
18492;Pilaitukas;PAUKŠTELIAI;92823052045;Taip;0;1;0;1
18493;Pilaitukas;PAUKŠTELIAI;1726805610;Taip;14;0;0;14
18494;Pilaitukas;PAUKŠTELIAI;34346418650;Taip;5;1;0;6
18495;Pilaitukas;PAUKŠTELIAI;17571219106;Taip;0;0;2;2
18496;Pilaitukas;PAUKŠTELIAI;4283157555;Taip;0;0;3;3
18497;Pilaitukas;PAUKŠTELIAI;9496336005;Taip;0;4;0;4
18498;Pilaitukas;PAUKŠTELIAI;6069797837;Taip;0;0;2;2
18499;Pilaitukas;PAUKŠTELIAI;3147809450;Taip;0;0;2;2
18500;Pilaitukas;PAUKŠTELIAI;3325511140;Taip;0;2;3;5
18501;Pilaitukas;BORUŽĖLĖS;56069293343;Taip;0;0;2;2
18502;Pilaitukas;BORUŽĖLĖS;7156205658;Taip;0;0;9;9
18503;Pilaitukas;BORUŽĖLĖS;8364902911;Taip;0;9;0;9
18504;Pilaitukas;BORUŽĖLĖS;5063602139;Taip;0;4;2;6
18505;Pilaitukas;BORUŽĖLĖS;5464065587;Taip;8;0;0;8
18506;Pilaitukas;BORUŽĖLĖS;5984878126;Taip;0;2;0;2
18507;Pilaitukas;BORUŽĖLĖS;6024861998;Taip;0;4;0;4
18508;Pilaitukas;BORUŽĖLĖS;58416972423;Taip;3;0;1;4
18509;Pilaitukas;BORUŽĖLĖS;9898379569;Taip;0;0;4;4
18510;Pilaitukas;BORUŽĖLĖS;5324806808;Taip;0;0;3;3
18511;Pilaitukas;BORUŽĖLĖS;5185051301;Taip;3;0;2;5
18512;Pilaitukas;BORUŽĖLĖS;5326258755;Taip;0;9;6;15
18513;Pilaitukas;BORUŽĖLĖS;8470482026;Taip;11;0;8;19
18514;Pilaitukas;BORUŽĖLĖS;6838035491;Taip;0;0;1;1
18515;Pilaitukas;BORUŽĖLĖS;1731106179;Taip;0;0;4;4
18516;Pilaitukas;BORUŽĖLĖS;3784944532;Taip;1;0;3;4
18517;Pilaitukas;BORUŽĖLĖS;5186675623;Taip;12;0;6;18
18518;Pilaitukas;BORUŽĖLĖS;4317406707;Taip;0;7;0;7
18519;Pilaitukas;DRUGELIAI;1677962644;Ne;9;1;0;10
18520;Pilaitukas;DRUGELIAI;4745358362;Ne;9;1;0;10
18521;Pilaitukas;DRUGELIAI;3483758882;Taip;0;1;0;1
18522;Pilaitukas;DRUGELIAI;7082099968;Taip;0;5;0;5
18523;Pilaitukas;DRUGELIAI;2917197418;Ne;19;0;1;20
18524;Pilaitukas;DRUGELIAI;6712878938;Taip;15;0;0;15
18525;Pilaitukas;DRUGELIAI;1747834520;Taip;17;1;0;18
18526;Pilaitukas;DRUGELIAI;3298272815;Taip;13;0;4;17
18527;Pilaitukas;DRUGELIAI;3772830210;Ne;0;0;2;2
18528;Pilaitukas;DRUGELIAI;4719223490;Taip;17;0;0;17
18529;Pilaitukas;DRUGELIAI;6280870972;Taip;5;8;0;13
18530;Pilaitukas;DRUGELIAI;9741985709;Ne;8;0;1;9
18531;Pilaitukas;PELIUKAI;9246925227;Taip;2;0;2;4
18532;Pilaitukas;PELIUKAI;7808204054;Taip;4;0;0;4
18533;Pilaitukas;PELIUKAI;4810825253;Taip;14;1;0;15
18534;Pilaitukas;PELIUKAI;8769116377;Taip;0;0;2;2
18535;Pilaitukas;PELIUKAI;8501376663;Taip;0;0;2;2
18536;Pilaitukas;PELIUKAI;5421602723;Ne;12;2;0;14
18537;Pilaitukas;PELIUKAI;6754825353;Taip;0;7;0;7
18538;Pilaitukas;PELIUKAI;8168228529;Taip;0;5;0;5
18539;Pilaitukas;PELIUKAI;4014329370;Taip;0;0;4;4
18540;Pilaitukas;PELIUKAI;6833933586;Taip;3;3;0;6
18541;Pilaitukas;PELIUKAI;8877142428;Taip;0;0;1;1
18542;Pilaitukas;PELIUKAI;2416277190;Taip;13;0;0;13
18543;Pilaitukas;PELIUKAI;9774222130;Taip;8;13;1;22
18544;Pilaitukas;PELIUKAI;1270365948;Taip;0;1;2;3
18545;Pilaitukas;PELIUKAI;9556421129;Taip;13;0;0;13
18546;Pilaitukas;PELIUKAI;3954210452;Ne;4;0;0;4
18547;Pilaitukas;PELIUKAI;9870994949;Taip;14;0;1;15
18548;Pilaitukas;PELIUKAI;5223336496;Taip;8;0;2;10
18549;Pilaitukas;PELIUKAI;3651140874;Taip;10;0;0;10
18550;Pilaitukas;PELIUKAI;2823859128;Taip;8;0;1;9
18551;Pilaitukas;PELIUKAI;7750936973;Taip;17;0;1;18
18552;Pilaitukas;KAČIUKAI;6234641884;Taip;9;9;1;19
18553;Pilaitukas;KAČIUKAI;2406183145;Taip;0;8;0;8
18554;Pilaitukas;KAČIUKAI;2379660463;Taip;0;8;0;8
18555;Pilaitukas;KAČIUKAI;7594484959;Taip;17;0;0;17
18556;Pilaitukas;KAČIUKAI;2463482642;Taip;0;1;0;1
18557;Pilaitukas;KAČIUKAI;3080014745;Taip;17;0;0;17
18558;Pilaitukas;KAČIUKAI;5353687011;Taip;8;3;0;11
18559;Pilaitukas;KAČIUKAI;8009040109;Taip;0;1;0;1
18560;Pilaitukas;KAČIUKAI;2105380328;Taip;6;1;0;7
18561;Pilaitukas;KAČIUKAI;5326689274;Taip;10;0;0;10
18562;Pilaitukas;KAČIUKAI;9653647227;Taip;10;0;0;10
18563;Pilaitukas;KAČIUKAI;4022543517;Taip;0;7;0;7
18564;Pilaitukas;KAČIUKAI;1999942175;Taip;4;1;0;5
18565;Pilaitukas;KAČIUKAI;3825942473;Taip;0;6;0;6
18566;Pilaitukas;KAČIUKAI;1611371690;Taip;22;0;0;22
18567;Pilaitukas;KAČIUKAI;6436694057;Taip;0;1;0;1
18568;Pilaitukas;KAČIUKAI;9974310580;Taip;0;3;0;3
18569;Pilaitukas;KAČIUKAI;6235375235;Taip;11;0;0;11
18570;Pilaitukas;KAČIUKAI;9914575692;Taip;7;1;0;8
18571;Pilaitukas;SAULUTĖS;7222856683;Taip;8;1;0;9
18572;Pilaitukas;SAULUTĖS;8787181006;Taip;0;1;0;1
18573;Pilaitukas;SAULUTĖS;3035456834;Taip;0;5;0;5
18574;Pilaitukas;SAULUTĖS;3005101776;Taip;4;0;1;5
18575;Pilaitukas;SAULUTĖS;2830212921;Taip;4;1;0;5
18576;Pilaitukas;SAULUTĖS;2476942319;Taip;2;5;0;7
18577;Pilaitukas;SAULUTĖS;8047683859;Taip;5;0;1;6
18578;Pilaitukas;SAULUTĖS;8694369154;Taip;5;0;1;6
18579;Pilaitukas;SAULUTĖS;1781762820;Taip;8;0;0;8
18580;Pilaitukas;SAULUTĖS;7479542200;Taip;7;3;0;10
18581;Pilaitukas;SAULUTĖS;8033540052;Taip;12;0;0;12
18582;Pilaitukas;SAULUTĖS;8710069256;Taip;0;22;0;22
18583;Pilaitukas;SAULUTĖS;7830059468;Taip;15;4;0;19
18584;Pilaitukas;SAULUTĖS;8380819975;Taip;2;0;1;3
18585;Pilaitukas;SAULUTĖS;6807166920;Taip;0;2;0;2
18586;Pilaitukas;SAULUTĖS;9405479859;Taip;0;0;3;3
18587;Pilaitukas;MENULIUKAI;6337917448;Taip;5;1;3;9
18588;Pilaitukas;MENULIUKAI;3636976107;Taip;5;1;3;9
18589;Pilaitukas;MENULIUKAI;2923272767;Taip;8;1;0;9
18590;Pilaitukas;MENULIUKAI;4097742120;Taip;5;2;2;9
18591;Pilaitukas;MENULIUKAI;8620858011;Ne;14;0;0;14
18592;Pilaitukas;MENULIUKAI;6888607864;Taip;22;0;0;22
18593;Pilaitukas;MENULIUKAI;5026344198;Taip;0;0;4;4
18594;Pilaitukas;MENULIUKAI;5564784922;Taip;0;22;0;22
18595;Pilaitukas;MENULIUKAI;5490465905;Taip;0;7;0;7
18596;Pilaitukas;MENULIUKAI;3761827714;Taip;4;0;0;4
18597;Pilaitukas;MENULIUKAI;3357097410;Taip;4;0;0;4
18598;Pilaitukas;MENULIUKAI;1120549352;Taip;0;0;2;2
18599;Pilaitukas;MENULIUKAI;4286388920;Taip;3;0;0;3
18600;Pilaitukas;MENULIUKAI;1290017967;Taip;0;22;0;22
18601;Pilaitukas;MENULIUKAI;7773318230;Taip;0;10;0;10
18602;Pilaitukas;MENULIUKAI;8279288250;Taip;6;1;0;7
18603;Pilaitukas;MENULIUKAI;7876850509;Taip;3;2;1;6
18604;Pilaitukas;MENULIUKAI;9930306085;Taip;21;0;0;21
18605;Pilaitukas;ĖŽIUKAI;9187961584;Taip;0;3;0;3
18606;Pilaitukas;ĖŽIUKAI;8268790017;Taip;4;2;2;8
18607;Pilaitukas;ĖŽIUKAI;4171896175;Taip;5;0;2;7
18608;Pilaitukas;ĖŽIUKAI;1362132769;Taip;4;2;2;8
18609;Pilaitukas;ĖŽIUKAI;7781507786;Taip;0;0;12;12
18610;Pilaitukas;ĖŽIUKAI;2054626415;Taip;9;1;0;10
18611;Pilaitukas;ĖŽIUKAI;2365387089;Taip;0;0;9;9
18612;Pilaitukas;ĖŽIUKAI;9670329628;Taip;5;3;0;8
18613;Pilaitukas;ĖŽIUKAI;7750575554;Taip;0;10;0;10
18614;Pilaitukas;ĖŽIUKAI;8577357264;Taip;0;1;0;1
18615;Pilaitukas;ĖŽIUKAI;1660462256;Taip;0;11;0;11
18616;Pilaitukas;ĖŽIUKAI;1610122884;Taip;0;0;1;1
18617;Pilaitukas;ĖŽIUKAI;8322980583;Taip;0;1;0;1
18618;Pilaitukas;ĖŽIUKAI;5297214263;Taip;0;6;0;6
18619;Pilaitukas;ĖŽIUKAI;9742268665;Taip;0;22;0;22
18620;Pilaitukas;ĖŽIUKAI;1568651642;Taip;9;0;9;18
18621;Švelnukas;Pelėdžiukai;8016531082;Taip;3;10;9;22
18622;Švelnukas;Pelėdžiukai;8219071968;Taip;4;0;17;21
18623;Švelnukas;Pelėdžiukai;3235768013;Taip;3;0;2;5
18624;Švelnukas;Pelėdžiukai;9008722163;Taip;0;5;0;5
18625;Švelnukas;Pelėdžiukai;5699300764;Taip;5;0;1;6
18626;Švelnukas;Pelėdžiukai;5554625346;Taip;10;1;0;11
18627;Švelnukas;Pelėdžiukai;3282020958;Taip;10;1;0;11
18628;Švelnukas;Pelėdžiukai;1116279011;Ne;0;0;1;1
18629;Švelnukas;Pelėdžiukai;3892058023;Ne;0;0;1;1
18630;Švelnukas;Pelėdžiukai;5681611554;Taip;0;0;2;2
18631;Švelnukas;Pelėdžiukai;8589226595;Taip;0;1;0;1
18632;Švelnukas;Pelėdžiukai;9802064955;Taip;4;0;0;4
18633;Švelnukas;Pelėdžiukai;3804532959;Taip;0;2;0;2
18634;Švelnukas;Pelėdžiukai;1462620951;Taip;0;0;1;1
18635;Švelnukas;Pelėdžiukai;1415899173;Taip;8;1;0;9
18636;Švelnukas;Ežiukai;64192510147;Taip;0;0;1;1
18637;Švelnukas;Ežiukai;25374873288;Taip;5;0;1;6
18638;Švelnukas;Ežiukai;15308444101;Taip;0;0;2;2
18639;Švelnukas;Ežiukai;6282389058;Taip;0;0;2;2
18640;Švelnukas;Ežiukai;38902466526;Taip;0;1;0;1
18641;Švelnukas;Ežiukai;4711482287;Taip;0;7;0;7
18642;Švelnukas;Ežiukai;8681264696;Taip;0;1;0;1
18643;Švelnukas;Ežiukai;73628749439;Taip;0;8;0;8
18644;Švelnukas;Ežiukai;2521009631;Taip;3;0;0;3
18645;Švelnukas;Ežiukai;2031043488;Taip;0;5;0;5
18646;Švelnukas;Ežiukai;1165172787;Taip;0;1;0;1
18647;Švelnukas;Ežiukai;2892176166;Taip;0;5;0;5
18648;Švelnukas;Ežiukai;7308701231;Taip;0;0;4;4
18649;Švelnukas;Ežiukai;2400781175;Taip;10;3;1;14
18650;Švelnukas;Ežiukai;6209334207;Taip;4;0;0;4
18651;Švelnukas;Ežiukai;1201550386;Taip;0;0;1;1
18652;Švelnukas;Ežiukai;7266255326;Taip;0;0;10;10
18653;Švelnukas;Ežiukai;2348752207;Taip;0;22;0;22
18654;Švelnukas;Švelnukai;4681584014;Taip;0;0;1;1
18655;Švelnukas;Švelnukai;6607578153;Taip;5;6;0;11
18656;Švelnukas;Švelnukai;9766734938;Taip;5;0;2;7
18657;Švelnukas;Švelnukai;3020524039;Taip;0;0;1;1
18658;Švelnukas;Švelnukai;2464467471;Taip;8;0;0;8
18659;Švelnukas;Švelnukai;5032829856;Taip;0;8;0;8
18660;Švelnukas;Švelnukai;5213589179;Taip;0;11;2;13
18661;Švelnukas;Švelnukai;4194249709;Taip;4;0;0;4
18662;Švelnukas;Švelnukai;5936821902;Taip;4;0;6;10
18663;Švelnukas;Švelnukai;7607215137;Taip;5;0;0;5
18664;Švelnukas;Švelnukai;4629757899;Taip;0;1;0;1
18665;Švelnukas;Švelnukai;8951810066;Taip;0;0;3;3
18666;Švelnukas;Švelnukai;2663990082;Taip;3;0;0;3
18667;Švelnukas;Švelnukai;6204286255;Taip;0;0;4;4
18668;Švelnukas;Švelnukai;5960966542;Taip;0;1;1;2
18669;Švelnukas;Boružiukai;1951447127;Taip;0;0;16;16
18670;Švelnukas;Boružiukai;3849957906;Taip;0;0;1;1
18671;Švelnukas;Boružiukai;5550841477;Taip;19;0;0;19
18672;Švelnukas;Boružiukai;9722532034;Taip;8;1;2;11
18673;Švelnukas;Boružiukai;1264256177;Taip;0;0;3;3
18674;Švelnukas;Boružiukai;1332533332;Taip;22;0;0;22
18675;Švelnukas;Boružiukai;4134678301;Taip;0;0;1;1
18676;Švelnukas;Boružiukai;8458233793;Taip;0;6;0;6
18677;Švelnukas;Boružiukai;7967996032;Taip;0;11;6;17
18678;Švelnukas;Boružiukai;8951980999;Taip;0;2;0;2
18679;Švelnukas;Boružiukai;4990399144;Taip;4;4;0;8
18680;Švelnukas;Boružiukai;9575767514;Taip;0;0;15;15
18681;Švelnukas;Boružiukai;6282137936;Taip;0;4;0;4
18682;Švelnukas;Boružiukai;5409130195;Taip;10;0;0;10
18683;Švelnukas;Boružiukai;2088128734;Taip;0;4;0;4
18684;Švelnukas;Boružiukai;2077614498;Taip;8;0;4;12
18685;Švelnukas;Boružiukai;3145935641;Taip;0;6;0;6
18686;Švelnukas;Boružiukai;4404904322;Taip;0;5;0;5
18687;Švelnukas;Boružiukai;3561920685;Taip;7;0;0;7
18688;Švelnukas;Boružiukai;8895028305;Taip;1;0;0;1
18689;Švelnukas;Boružiukai;4961854528;Taip;1;0;2;3
18690;Švelnukas;Boružiukai;4823928859;Taip;14;0;1;15
18691;Švelnukas;Smalsučiai;82202942341;Taip;0;1;0;1
18692;Švelnukas;Smalsučiai;63394075248;Taip;0;1;0;1
18693;Švelnukas;Smalsučiai;1183982303;Taip;5;3;1;9
18694;Švelnukas;Smalsučiai;47645479348;Taip;0;2;0;2
18695;Švelnukas;Smalsučiai;19117783391;Taip;4;0;2;6
18696;Švelnukas;Smalsučiai;26077395334;Taip;0;8;2;10
18697;Švelnukas;Smalsučiai;15711256627;Taip;0;2;0;2
18698;Švelnukas;Smalsučiai;95780894209;Taip;0;0;3;3
18699;Švelnukas;Smalsučiai;76563731138;Taip;0;4;0;4
18700;Švelnukas;Smalsučiai;3388721433;Taip;0;1;0;1
18701;Švelnukas;Smalsučiai;1742714140;Taip;0;0;2;2
18702;Švelnukas;Smalsučiai;54425041280;Taip;0;3;0;3
18703;Švelnukas;Smalsučiai;91569132037;Taip;0;0;3;3
18704;Švelnukas;Smalsučiai;78611632021;Taip;2;1;0;3
18705;Švelnukas;Smalsučiai;1139744541;Taip;0;9;3;12
18706;Švelnukas;Smalsučiai;15774114007;Taip;12;0;0;12
18707;Švelnukas;Smalsučiai;35501839416;Taip;3;0;0;3
18708;Švelnukas;Smalsučiai;5910842956;Taip;0;0;1;1
18709;Švelnukas;Nykštukai;1293700097;Taip;0;7;0;7
18710;Švelnukas;Nykštukai;2141519946;Taip;0;1;0;1
18711;Švelnukas;Nykštukai;8771953161;Taip;0;3;4;7
18712;Švelnukas;Nykštukai;2282356211;Taip;0;1;0;1
18713;Švelnukas;Nykštukai;4697253853;Taip;0;0;2;2
18714;Švelnukas;Nykštukai;7387060610;Taip;0;2;0;2
18715;Švelnukas;Nykštukai;1762528313;Taip;0;0;1;1
18716;Švelnukas;Nykštukai;3370028567;Taip;0;6;0;6
18717;Švelnukas;Nykštukai;62969317035;Taip;0;0;1;1
18718;Švelnukas;Nykštukai;6633233824;Taip;2;0;0;2
18719;Švelnukas;Nykštukai;2106591525;Taip;8;0;4;12
18720;Švelnukas;Nykštukai;93497358197;Taip;0;10;0;10
18721;Švelnukas;Nykštukai;2971380970;Taip;0;3;0;3
18722;Švelnukas;Nykštukai;3389897065;Taip;0;3;0;3
18723;Švelnukas;Nykštukai;4302735157;Taip;5;2;1;8
18724;Švelnukas;Nykštukai;2785396019;Taip;0;0;2;2
18725;Boružėlė;"Nykštukai gudručiai";7736917485;Taip;0;2;0;2
18726;Boružėlė;"Nykštukai gudručiai";9520696660;Taip;0;6;0;6
18727;Boružėlė;"Nykštukai gudručiai";5691884576;Taip;0;2;0;2
18728;Boružėlė;"Nykštukai gudručiai";9193273478;Taip;4;0;0;4
18729;Boružėlė;"Nykštukai gudručiai";3237771499;Taip;5;2;0;7
18730;Boružėlė;"Nykštukai gudručiai";8359957290;Ne;0;2;7;9
18731;Boružėlė;"Nykštukai gudručiai";2349571778;Taip;0;7;0;7
18732;Boružėlė;"Nykštukai gudručiai";1894170218;Taip;9;0;0;9
18733;Boružėlė;"Nykštukai gudručiai";3509512899;Taip;10;0;0;10
18734;Boružėlė;"Nykštukai gudručiai";8888151470;Taip;10;0;0;10
18735;Boružėlė;"Nykštukai gudručiai";3430953692;Taip;0;1;0;1
18736;Boružėlė;"Nykštukai gudručiai";6166247730;Taip;0;2;0;2
18737;Boružėlė;"Nykštukai gudručiai";8365962523;Taip;0;3;0;3
18738;Boružėlė;"Nykštukai gudručiai";3592853535;Taip;0;1;0;1
18739;Boružėlė;"Nykštukai gudručiai";6876323023;Taip;0;1;0;1
18740;Boružėlė;"Nykštukai gudručiai";2744894565;Taip;0;11;0;11
18741;Boružėlė;"Nykštukai gudručiai";6590829182;Ne;0;2;1;3
18742;Boružėlė;"Nykštukai gudručiai";3129825206;Ne;0;4;0;4
18743;Boružėlė;"Nykštukai gudručiai";9771767352;Taip;9;1;0;10
18744;Boružėlė;"Nykštukai gudručiai";9078805020;Taip;0;4;0;4
18745;Boružėlė;"Saulės zuikučiai";4554260776;Taip;5;1;0;6
18746;Boružėlė;"Saulės zuikučiai";5298170118;Taip;0;5;0;5
18747;Boružėlė;"Saulės zuikučiai";9271331800;Taip;0;16;0;16
18748;Boružėlė;"Saulės zuikučiai";1116012068;Taip;10;2;0;12
18749;Boružėlė;"Saulės zuikučiai";1292298259;Taip;0;16;0;16
18750;Boružėlė;"Saulės zuikučiai";7256396576;Taip;0;0;4;4
18751;Boružėlė;"Saulės zuikučiai";4323998138;Taip;13;0;1;14
18752;Boružėlė;"Saulės zuikučiai";2087238951;Taip;0;6;0;6
18753;Boružėlė;"Saulės zuikučiai";4999277693;Taip;0;11;5;16
18754;Boružėlė;"Saulės zuikučiai";6990311896;Taip;0;11;5;16
18755;Boružėlė;"Saulės zuikučiai";3952645542;Taip;0;2;0;2
18756;Boružėlė;"Saulės zuikučiai";5516103398;Taip;0;0;5;5
18757;Boružėlė;"Saulės zuikučiai";8259586236;Taip;0;8;0;8
18758;Boružėlė;"Saulės zuikučiai";3955841578;Taip;4;7;0;11
18759;Boružėlė;"Saulės zuikučiai";1583223569;Taip;0;8;0;8
18760;Boružėlė;"Saulės zuikučiai";4433248526;Taip;0;0;3;3
18761;Boružėlė;"Saulės zuikučiai";1547802140;Taip;0;0;2;2
18762;Boružėlė;"Saulės zuikučiai";4020348640;Taip;16;0;0;16
18763;Boružėlė;"Saulės zuikučiai";2842256033;Taip;0;1;0;1
18764;Boružėlė;"Saulės zuikučiai";2561969142;Taip;0;7;3;10
18765;Boružėlė;"Saulės zuikučiai";7262515868;Taip;0;2;0;2
18766;Boružėlė;Gėlytės;3288141024;Taip;0;2;0;2
18767;Boružėlė;Gėlytės;7956982615;Taip;0;2;1;3
18768;Boružėlė;Gėlytės;4637656311;Taip;0;0;1;1
18769;Boružėlė;Gėlytės;6070356395;Taip;9;4;0;13
18770;Boružėlė;Gėlytės;4180537253;Taip;6;0;0;6
18771;Boružėlė;Gėlytės;6722353853;Taip;0;0;1;1
18772;Boružėlė;Gėlytės;5252261660;Taip;22;0;0;22
18773;Boružėlė;Gėlytės;8376436755;Taip;0;2;1;3
18774;Boružėlė;Gėlytės;7763958937;Taip;13;0;0;13
18775;Boružėlė;Gėlytės;9855354210;Taip;8;0;0;8
18776;Boružėlė;Gėlytės;2515608520;Taip;8;0;0;8
18777;Boružėlė;Gėlytės;8520403894;Taip;0;8;5;13
18778;Boružėlė;Smalsutis;2086485441;Taip;0;0;8;8
18779;Boružėlė;Smalsutis;5129244830;Taip;0;5;4;9
18780;Boružėlė;Smalsutis;6927100979;Taip;5;5;0;10
18781;Boružėlė;Smalsutis;4947670606;Taip;0;4;2;6
18782;Boružėlė;Smalsutis;5267216044;Taip;1;16;0;17
18783;Boružėlė;Smalsutis;2917508421;Taip;0;0;2;2
18784;Boružėlė;Smalsutis;5708558321;Taip;0;1;0;1
18785;Boružėlė;Smalsutis;2132904457;Taip;0;2;0;2
18786;Boružėlė;Smalsutis;77513300382;Taip;0;7;5;12
18787;Boružėlė;Smalsutis;39553430808;Taip;0;0;11;11
18788;Boružėlė;Smalsutis;4958704459;Taip;0;5;0;5
18789;Boružėlė;Smalsutis;8493908653;Taip;0;1;0;1
18790;Boružėlė;Smalsutis;4283064680;Taip;0;0;17;17
18791;Boružėlė;Smalsutis;2447148171;Taip;0;2;0;2
18792;Boružėlė;Smalsutis;1391562352;Taip;0;0;3;3
18793;Boružėlė;Smalsutis;7386694567;Taip;0;0;1;1
18794;Boružėlė;Smalsutis;9634967237;Taip;0;1;0;1
18795;Boružėlė;Smalsutis;3592594142;Taip;0;1;0;1
18796;Boružėlė;Drugeliai;8357946299;Taip;0;2;0;2
18797;Boružėlė;Drugeliai;1130980139;Taip;0;2;0;2
18798;Boružėlė;Drugeliai;6463583187;Taip;0;2;0;2
18799;Boružėlė;Drugeliai;8683282162;Taip;0;2;0;2
18800;Boružėlė;Drugeliai;3136028536;Taip;5;0;0;5
18801;Boružėlė;Drugeliai;2211576663;Taip;0;7;0;7
18802;Boružėlė;Drugeliai;1559001916;Taip;6;0;0;6
18803;Boružėlė;Drugeliai;4233602822;Taip;0;2;0;2
18804;Boružėlė;Drugeliai;8482813204;Taip;2;1;0;3
18805;Boružėlė;Drugeliai;6902130914;Taip;3;1;0;4
18806;Boružėlė;Drugeliai;3459207879;Taip;4;1;0;5
18807;Boružėlė;Drugeliai;6980022864;Taip;0;3;0;3
18808;Boružėlė;Drugeliai;7756929745;Taip;7;0;0;7
18809;Boružėlė;Drugeliai;6049501362;Taip;0;2;0;2
18810;Boružėlė;Drugeliai;2783338563;Taip;0;2;1;3
18811;Boružėlė;Vyturėliai;1913540317;Taip;0;2;0;2
18812;Boružėlė;Vyturėliai;1950269258;Taip;2;1;0;3
18813;Boružėlė;Vyturėliai;1591582954;Taip;0;8;0;8
18814;Boružėlė;Vyturėliai;3322567969;Taip;0;1;0;1
18815;Boružėlė;Vyturėliai;1718509953;Ne;0;2;0;2
18816;Boružėlė;Vyturėliai;8311383437;Taip;0;2;3;5
18817;Boružėlė;Vyturėliai;7534482245;Taip;3;2;8;13
18818;Boružėlė;Vyturėliai;3310676316;Taip;0;2;0;2
18819;Boružėlė;Vyturėliai;87834777247;Taip;0;1;0;1
18820;Boružėlė;Vyturėliai;50071056728;Taip;4;8;0;12
18821;Boružėlė;Vyturėliai;43300167107;Taip;0;5;0;5
18822;Boružėlė;Vyturėliai;2098408445;Taip;0;2;0;2
18823;Boružėlė;Vyturėliai;5337704114;Taip;0;2;0;2
18824;Boružėlė;Vyturėliai;9150703371;Taip;0;10;0;10
18825;Boružėlė;Vyturėliai;5811751925;Taip;0;7;0;7
18826;Boružėlė;Vyturėliai;7136428795;Taip;2;5;0;7
18827;Boružėlė;Žvaigždutės;4990831292;Taip;0;0;8;8
18828;Boružėlė;Žvaigždutės;7825636053;Taip;0;2;0;2
18829;Boružėlė;Žvaigždutės;6293878183;Taip;0;2;0;2
18830;Boružėlė;Žvaigždutės;7901880926;Taip;0;3;0;3
18831;Boružėlė;Žvaigždutės;6242220139;Taip;0;1;0;1
18832;Boružėlė;Žvaigždutės;3489498503;Taip;16;2;0;18
18833;Boružėlė;Žvaigždutės;9720535449;Taip;0;1;0;1
18834;Boružėlė;Žvaigždutės;6435556131;Taip;0;1;0;1
18835;Boružėlė;Žvaigždutės;5804189049;Taip;0;0;15;15
18836;Boružėlė;Žvaigždutės;5307997577;Taip;8;0;3;11
18837;Boružėlė;Žvaigždutės;8916241914;Taip;0;8;6;14
18838;Boružėlė;Žvaigždutės;6724101421;Taip;0;2;0;2
18839;Boružėlė;Žvaigždutės;6972646373;Taip;0;1;0;1
18840;Boružėlė;Žvaigždutės;8820827882;Taip;0;3;0;3
18841;Boružėlė;Žvaigždutės;2857645329;Taip;0;1;0;1
18842;Boružėlė;Žvaigždutės;5242187638;Taip;3;1;0;4
18843;Boružėlė;Žvaigždutės;1799882790;Taip;0;3;0;3
18844;Boružėlė;Ąžuoliukai;5774358876;Taip;0;3;0;3
18845;Boružėlė;Ąžuoliukai;4519645340;Taip;0;4;0;4
18846;Boružėlė;Ąžuoliukai;24315678618;Taip;0;0;1;1
18847;Boružėlė;Ąžuoliukai;4994696176;Taip;0;1;0;1
18848;Boružėlė;Ąžuoliukai;5138737297;Taip;0;2;0;2
18849;Boružėlė;Ąžuoliukai;3040376382;Ne;0;2;1;3
18850;Boružėlė;Ąžuoliukai;3840860155;Taip;0;5;0;5
18851;Boružėlė;Ąžuoliukai;6954794465;Taip;4;2;0;6
18852;Boružėlė;Ąžuoliukai;5832223872;Taip;0;2;1;3
18853;Boružėlė;Ąžuoliukai;3695411422;Taip;5;8;0;13
18854;Boružėlė;Ąžuoliukai;5148410392;Taip;2;4;4;10
18855;Boružėlė;Ąžuoliukai;76222777017;Taip;0;5;0;5
18856;Boružėlė;Ąžuoliukai;45181369655;Taip;0;3;0;3
18857;Boružėlė;Ąžuoliukai;6022191251;Taip;0;2;0;2
18858;Boružėlė;Ąžuoliukai;3869817904;Taip;0;2;0;2
18859;Boružėlė;Ąžuoliukai;9269501176;Taip;0;13;0;13
18860;Boružėlė;Ąžuoliukai;8029389952;Taip;0;2;0;2
18861;Boružėlė;Saulutės;64389558278;Taip;0;2;0;2
18862;Boružėlė;Saulutės;46425201501;Taip;0;1;0;1
18863;Boružėlė;Saulutės;72321159041;Taip;0;1;0;1
18864;Boružėlė;Saulutės;8814486475;Taip;0;3;0;3
18865;Boružėlė;Saulutės;4567360023;Taip;0;1;0;1
18866;Boružėlė;Saulutės;96500755145;Taip;8;0;0;8
18867;Boružėlė;Saulutės;1506999888;Taip;0;2;0;2
18868;Boružėlė;Saulutės;2402968573;Taip;0;2;0;2
18869;Boružėlė;Saulutės;2690216341;Taip;0;2;0;2
18870;Boružėlė;Saulutės;1580917200;Taip;0;1;0;1
18871;Boružėlė;Saulutės;2618814096;Taip;0;1;0;1
18872;Boružėlė;Saulutės;60134201468;Taip;0;4;0;4
18873;Boružėlė;Saulutės;1861612651;Taip;0;1;0;1
18874;Boružėlė;Saulutės;2473644942;Taip;0;9;0;9
18875;Boružėlė;Saulutės;76569470768;Taip;0;2;0;2
18876;Boružėlė;Ežiukai;80490841186;Taip;0;0;4;4
18877;Boružėlė;Ežiukai;9645420240;Taip;0;0;2;2
18878;Boružėlė;Ežiukai;97765175729;Taip;0;2;0;2
18879;Boružėlė;Ežiukai;9436674675;Taip;14;1;0;15
18880;Boružėlė;Ežiukai;58923894463;Taip;2;2;0;4
18881;Boružėlė;Ežiukai;27456755162;Taip;0;1;0;1
18882;Boružėlė;Ežiukai;80239337645;Taip;0;2;0;2
18883;Boružėlė;Ežiukai;1007058344;Taip;0;3;0;3
18884;Boružėlė;Ežiukai;2138048547;Taip;9;0;0;9
18885;Boružėlė;Ežiukai;1431869021;Taip;5;1;0;6
18886;Boružėlė;Ežiukai;1474967056;Taip;0;12;0;12
18887;Boružėlė;Ežiukai;62548032852;Taip;2;1;0;3
18888;Boružėlė;Ežiukai;17258743024;Taip;0;9;0;9
18889;Boružėlė;Ežiukai;31109596405;Taip;0;16;0;16
18890;Boružėlė;Ežiukai;46486992436;Taip;0;2;0;2
18891;Boružėlė;Ežiukai;61932744418;Taip;5;8;0;13
18892;Boružėlė;Ežiukai;1459630343;Taip;0;9;0;9
18893;Boružėlė;Boružiukai;5768415821;Taip;9;1;0;10
18894;Boružėlė;Boružiukai;6609156790;Taip;0;4;0;4
18895;Boružėlė;Boružiukai;2879726579;Taip;0;5;0;5
18896;Boružėlė;Boružiukai;7068409148;Taip;2;1;0;3
18897;Boružėlė;Boružiukai;8804878419;Taip;0;2;0;2
18898;Boružėlė;Boružiukai;8434178580;Taip;6;0;0;6
18899;Boružėlė;Boružiukai;3953507461;Taip;22;0;0;22
18900;Boružėlė;Boružiukai;8291389794;Taip;7;4;0;11
18901;Boružėlė;Boružiukai;1492091211;Taip;8;2;0;10
18902;Boružėlė;Boružiukai;1830043506;Taip;8;2;0;10
18903;Boružėlė;Boružiukai;5680510186;Taip;0;2;0;2
18904;Boružėlė;Boružiukai;1152697871;Taip;1;4;0;5
18905;Boružėlė;Boružiukai;1779839709;Taip;22;0;0;22
18906;Boružėlė;Boružiukai;5508064424;Taip;13;0;0;13
18907;Boružėlė;Boružiukai;5064892417;Taip;6;0;0;6
18908;Boružėlė;Boružiukai;7652740249;Taip;3;13;0;16
18909;Boružėlė;Nykštukai;2926620929;Taip;4;4;0;8
18910;Boružėlė;Nykštukai;5825164520;Taip;0;0;5;5
18911;Boružėlė;Nykštukai;1784594085;Taip;3;1;0;4
18912;Boružėlė;Nykštukai;9391811395;Taip;0;13;0;13
18913;Boružėlė;Nykštukai;6448688592;Taip;5;8;0;13
18914;Boružėlė;Nykštukai;3331139963;Taip;0;2;1;3
18915;Boružėlė;Nykštukai;9893643199;Taip;4;10;0;14
18916;Boružėlė;Nykštukai;3112016309;Taip;0;1;1;2
18917;Boružėlė;Nykštukai;5394149649;Taip;0;1;1;2
18918;Boružėlė;Nykštukai;9822629428;Taip;11;2;0;13
18919;Boružėlė;Nykštukai;9663535338;Taip;14;2;0;16
18920;Boružėlė;Nykštukai;7260471712;Taip;22;0;0;22
18921;Boružėlė;Nykštukai;9423458813;Taip;9;2;0;11
18922;Boružėlė;Nykštukai;7190980006;Taip;0;5;0;5
18923;Boružėlė;Nykštukai;1047419932;Taip;0;2;3;5
18924;Boružėlė;Nykštukai;7459531236;Taip;0;13;0;13
18925;Boružėlė;Nykštukai;8818358360;Taip;0;13;0;13
18926;Boružėlė;Nykštukai;8167376712;Taip;6;0;0;6
18927;Boružėlė;Nykštukai;2429696310;Taip;7;0;0;7
18928;Žaliakalnio;Drugeliai;1012597457;Taip;12;3;0;15
18929;Žaliakalnio;Drugeliai;5428225559;Taip;0;0;5;5
18930;Žaliakalnio;Drugeliai;20794781914;Taip;4;4;4;12
18931;Žaliakalnio;Drugeliai;4511376806;Taip;3;3;3;9
18932;Žaliakalnio;Drugeliai;6919074533;Taip;0;7;0;7
18933;Žaliakalnio;Drugeliai;6379145626;Ne;12;8;2;22
18934;Žaliakalnio;Drugeliai;9771191966;Taip;22;8;0;30
18935;Žaliakalnio;Drugeliai;7094914749;Taip;0;22;0;22
18936;Žaliakalnio;Drugeliai;7449949339;Ne;5;5;2;12
18937;Žaliakalnio;Drugeliai;2607433844;Taip;0;5;2;7
18938;Žaliakalnio;Drugeliai;1413563085;Ne;0;17;0;17
18939;Žaliakalnio;Drugeliai;2432935088;Ne;0;2;0;2
18940;Žaliakalnio;Drugeliai;7700118291;Ne;0;9;0;9
18941;Žaliakalnio;Drugeliai;92533370070;Taip;10;5;0;15
18942;Žaliakalnio;Drugeliai;40283689721;Taip;0;20;0;20
18943;Žaliakalnio;Drugeliai;54907763331;Ne;0;0;5;5
18944;Žaliakalnio;Drugeliai;6986149495;Ne;0;6;0;6
18945;Žaliakalnio;Boružėlių;5843020412;Taip;0;8;0;8
18946;Žaliakalnio;Boružėlių;9625531462;Taip;0;25;0;25
18947;Žaliakalnio;Boružėlių;6699373334;Taip;0;25;0;25
18948;Žaliakalnio;Boružėlių;7087535800;Taip;0;6;0;6
18949;Žaliakalnio;Boružėlių;1528111839;Taip;0;7;0;7
18950;Žaliakalnio;Boružėlių;7023886811;Taip;0;14;0;14
18951;Žaliakalnio;Boružėlių;1673321992;Taip;0;18;0;18
18952;Žaliakalnio;Boružėlių;2284465378;Taip;0;13;0;13
18953;Žaliakalnio;Boružėlių;2808776865;Taip;17;7;0;24
18954;Žaliakalnio;Boružėlių;2278681435;Taip;8;7;3;18
18955;Žaliakalnio;Boružėlių;5157814568;Taip;0;1;2;3
18956;Žaliakalnio;Boružėlių;9421259943;Taip;1;2;3;6
18957;Žaliakalnio;Boružėlių;3445649442;Taip;0;6;0;6
18958;Žaliakalnio;Boružėlių;3105500733;Taip;10;5;0;15
18959;Žaliakalnio;Boružėlių;5764128482;Taip;0;7;0;7
18960;Žaliakalnio;Boružėlių;1200844791;Taip;0;15;0;15
18961;Žaliakalnio;Boružėlių;8052539476;Taip;19;7;0;26
18962;Žaliakalnio;Boružėlių;6590016097;Ne;13;8;0;21
18963;Žaliakalnio;Boružėlių;8304431519;Taip;8;1;2;11
18964;Žaliakalnio;Boružėlių;9984857605;Ne;6;2;2;10
18965;Žaliakalnio;Zuikučiai;1592051491;Taip;0;8;0;8
18966;Žaliakalnio;Zuikučiai;6088333997;Taip;4;11;0;15
18967;Žaliakalnio;Zuikučiai;2621828772;Taip;4;1;0;5
18968;Žaliakalnio;Zuikučiai;2673619031;Taip;8;9;0;17
18969;Žaliakalnio;Zuikučiai;5843314345;Taip;0;10;0;10
18970;Žaliakalnio;Zuikučiai;2180165053;Taip;0;8;0;8
18971;Žaliakalnio;Zuikučiai;6823528666;Taip;6;7;0;13
18972;Žaliakalnio;Zuikučiai;3509064089;Taip;0;10;0;10
18973;Žaliakalnio;Zuikučiai;7000429934;Taip;0;5;0;5
18974;Žaliakalnio;Zuikučiai;5730610895;Taip;6;10;0;16
18975;Žaliakalnio;Zuikučiai;6881070397;Taip;0;15;0;15
18976;Žaliakalnio;Zuikučiai;8209559343;Taip;8;10;1;19
18977;Žaliakalnio;Zuikučiai;3835667120;Taip;4;24;0;28
18978;Žaliakalnio;Zuikučiai;9799056285;Taip;0;12;0;12
18979;Žaliakalnio;Zuikučiai;1321592040;Ne;0;14;0;14
18980;Žaliakalnio;Zuikučiai;8298313285;Taip;0;5;0;5
18981;Žaliakalnio;Zuikučiai;9331287916;Taip;0;14;0;14
18982;Žaliakalnio;Zuikučiai;6726832258;Ne;0;6;0;6
18983;Žaliakalnio;Zuikučiai;4607456527;Taip;11;9;0;20
18984;Žaliakalnio;Zuikučiai;9363615751;Taip;9;9;4;22
18985;Žaliakalnio;Zuikučiai;6341640909;Taip;1;9;0;10
18986;Žaliakalnio;Bitutė;5744370516;Taip;3;11;0;14
18987;Žaliakalnio;Bitutė;3619817569;Taip;6;5;1;12
18988;Žaliakalnio;Bitutė;3905448562;Taip;9;9;0;18
18989;Žaliakalnio;Bitutė;8481665290;Taip;0;11;0;11
18990;Žaliakalnio;Bitutė;8950583202;Taip;0;14;0;14
18991;Žaliakalnio;Bitutė;6324315523;Taip;6;7;0;13
18992;Žaliakalnio;Bitutė;6877235095;Taip;3;8;0;11
18993;Žaliakalnio;Bitutė;2280683252;Ne;3;7;0;10
18994;Žaliakalnio;Bitutė;7711347723;Taip;2;6;0;8
18995;Žaliakalnio;Bitutė;4561672875;Taip;0;8;0;8
18996;Žaliakalnio;Bitutė;8185190219;Taip;2;1;0;3
18997;Žaliakalnio;Bitutė;7830692152;Taip;9;9;0;18
18998;Žaliakalnio;Bitutė;1423481154;Taip;0;13;0;13
18999;Žaliakalnio;Bitutė;4928400872;Taip;0;10;0;10
19000;Žaliakalnio;Bitutė;2613771302;Taip;17;8;0;25
19001;Žaliakalnio;Bitutė;3976548663;Taip;8;8;0;16
19002;Žaliakalnio;Bitutė;8599646291;Taip;12;2;0;14
19003;Žaliakalnio;Bitutė;1343293430;Taip;4;7;0;11
19004;Žaliakalnio;Bitutė;3721878250;Ne;2;7;5;14
19005;Žaliakalnio;Bitutė;6291287113;Ne;5;2;3;10
19006;Žaliakalnio;Bitutė;4412760433;Taip;8;6;0;14
19007;Žaliakalnio;Bitutė;7989372873;Ne;5;12;0;17
19008;Žaliakalnio;Nykštukų;9057678671;Ne;5;2;1;8
19009;Žaliakalnio;Nykštukų;8640423692;Taip;0;3;0;3
19010;Žaliakalnio;Nykštukų;19192494119;Taip;0;1;0;1
19011;Žaliakalnio;Nykštukų;91524700281;Taip;0;1;0;1
19012;Žaliakalnio;Nykštukų;1753760382;Taip;0;6;0;6
19013;Žaliakalnio;Nykštukų;61215164827;Ne;0;2;0;2
19014;Žaliakalnio;Nykštukų;4936664829;Taip;0;4;0;4
19015;Žaliakalnio;Nykštukų;1657390839;Ne;0;6;0;6
19016;Žaliakalnio;Nykštukų;2655227703;Taip;0;12;0;12
19017;Žaliakalnio;Nykštukų;8085215871;Taip;0;11;0;11
19018;Žaliakalnio;Nykštukų;41844570217;Ne;5;2;0;7
19019;Žaliakalnio;Nykštukų;6638075273;Ne;0;15;0;15
19020;Žaliakalnio;Nykštukų;21744638321;Taip;0;1;0;1
19021;Žaliakalnio;Nykštukų;1514982516;Taip;2;8;0;10
19022;Žaliakalnio;Nykštukų;1497932659;Ne;1;4;0;5
19023;Žaliakalnio;Nykštukų;5946168564;Ne;0;10;0;10
19024;Žaliakalnio;Nykštukų;44058368949;Ne;0;8;0;8
19025;Žaliakalnio;Nykštukų;1511544568;Taip;2;9;0;11
19026;Žaliakalnio;ŽIOGELIAI;2426844621;Ne;8;0;0;8
19027;Žaliakalnio;ŽIOGELIAI;5752912101;Ne;7;7;0;14
19028;Žaliakalnio;ŽIOGELIAI;9967098834;Ne;0;11;0;11
19029;Žaliakalnio;ŽIOGELIAI;1133557422;Taip;17;4;0;21
19030;Žaliakalnio;ŽIOGELIAI;3464935314;Taip;0;18;0;18
19031;Žaliakalnio;ŽIOGELIAI;4497938258;Taip;8;2;0;10
19032;Žaliakalnio;ŽIOGELIAI;7648422668;Ne;9;12;0;21
19033;Žaliakalnio;ŽIOGELIAI;4702470511;Taip;0;10;0;10
19034;Žaliakalnio;ŽIOGELIAI;2272043654;Taip;0;13;0;13
19035;Žaliakalnio;ŽIOGELIAI;8518422934;Taip;1;10;0;11
19036;Žaliakalnio;ŽIOGELIAI;2305496316;Ne;0;8;0;8
19037;Žaliakalnio;ŽIOGELIAI;6674631040;Taip;7;8;0;15
19038;Žaliakalnio;ŽIOGELIAI;8245784590;Taip;22;9;0;31
19039;Žaliakalnio;ŽIOGELIAI;9485995178;Taip;0;12;0;12
19040;Žaliakalnio;ŽIOGELIAI;8179329874;Ne;9;1;0;10
19041;Žaliakalnio;ŽIOGELIAI;8383425712;Ne;7;7;0;14
19042;Žaliakalnio;ŽIOGELIAI;1309236035;Ne;8;7;0;15
19043;Žaliakalnio;ŽIOGELIAI;7025195076;Taip;6;3;0;9
19044;Žaliakalnio;ŽIOGELIAI;2514763739;Ne;3;5;0;8
19045;Žaliakalnio;ŽIOGELIAI;8891815592;Ne;2;6;0;8
19046;Žaliakalnio;ŽIOGELIAI;6294045755;Taip;0;14;0;14
19047;Volungė;Bitutės;6273977588;Taip;3;0;8;11
19048;Volungė;Bitutės;1689261748;Taip;0;0;2;2
19049;Volungė;Bitutės;2139675610;Taip;6;1;0;7
19050;Volungė;Bitutės;1333045175;Taip;0;0;5;5
19051;Volungė;Bitutės;1742777458;Taip;0;0;14;14
19052;Volungė;Bitutės;3803129970;Taip;0;0;3;3
19053;Volungė;Bitutės;1752357091;Taip;0;0;1;1
19054;Volungė;Bitutės;1974360497;Taip;0;0;3;3
19055;Volungė;Bitutės;7075466773;Taip;5;0;1;6
19056;Volungė;Bitutės;2763686861;Taip;0;0;1;1
19057;Volungė;Bitutės;1726933019;Taip;0;0;4;4
19058;Volungė;Bitutės;1539188909;Taip;0;0;3;3
19059;Volungė;Bitutės;3155184296;Taip;0;0;4;4
19060;Volungė;Bitutės;1333755594;Taip;0;0;8;8
19061;Volungė;Bitutės;19340864795;Taip;0;0;5;5
19062;Volungė;Bitutės;86784613109;Taip;0;0;2;2
19063;Volungė;Bitutės;1731981819;Taip;0;0;1;1
19064;Volungė;Boružiukai;6431477042;Taip;0;0;7;7
19065;Volungė;Boružiukai;1137713075;Taip;0;7;0;7
19066;Volungė;Boružiukai;2322594823;Taip;0;20;0;20
19067;Volungė;Boružiukai;7965601199;Taip;0;4;0;4
19068;Volungė;Boružiukai;5710662590;Taip;0;0;1;1
19069;Volungė;Boružiukai;3746978206;Taip;1;0;4;5
19070;Volungė;Boružiukai;4839484528;Taip;0;0;2;2
19071;Volungė;Boružiukai;9188994935;Taip;0;13;0;13
19072;Volungė;Boružiukai;8285309230;Taip;0;0;3;3
19073;Volungė;Boružiukai;7149986415;Taip;0;0;4;4
19074;Volungė;Boružiukai;4598763851;Taip;0;9;1;10
19075;Volungė;Boružiukai;5174427959;Taip;0;0;4;4
19076;Volungė;Boružiukai;7867741556;Taip;0;0;10;10
19077;Volungė;Boružiukai;3430719834;Taip;0;6;0;6
19078;Volungė;Boružiukai;8459167833;Taip;0;4;1;5
19079;Volungė;Boružiukai;8784150784;Taip;16;2;0;18
19080;Volungė;Boružiukai;6028582927;Taip;10;0;0;10
19081;Volungė;Boružiukai;3832613221;Taip;2;0;2;4
19082;Volungė;Boružiukai;7971287899;Ne;0;7;0;7
19083;Volungė;Žvirbliukai;2599441104;Taip;3;0;1;4
19084;Volungė;Žvirbliukai;8333832673;Taip;5;0;4;9
19085;Volungė;Žvirbliukai;3222329369;Taip;0;0;10;10
19086;Volungė;Žvirbliukai;7151952679;Taip;0;0;2;2
19087;Volungė;Žvirbliukai;6755366051;Taip;0;0;16;16
19088;Volungė;Žvirbliukai;8470433743;Taip;8;0;7;15
19089;Volungė;Žvirbliukai;4013639324;Taip;0;0;5;5
19090;Volungė;Žvirbliukai;3666364101;Taip;8;0;6;14
19091;Volungė;Žvirbliukai;3515725398;Taip;0;0;2;2
19092;Volungė;Žvirbliukai;5892600735;Taip;0;0;10;10
19093;Volungė;Žvirbliukai;1752817125;Taip;0;0;20;20
19094;Volungė;Žvirbliukai;5300334761;Taip;1;0;0;1
19095;Volungė;Žvirbliukai;1902122510;Taip;0;0;7;7
19096;Volungė;Žvirbliukai;3307326410;Taip;5;0;4;9
19097;Volungė;Žvirbliukai;5960027749;Taip;0;0;2;2
19098;Volungė;Žiogeliai;6360834021;Taip;0;3;0;3
19099;Volungė;Žiogeliai;4856240879;Taip;0;0;3;3
19100;Volungė;Žiogeliai;9100947038;Taip;0;0;4;4
19101;Volungė;Žiogeliai;4694016281;Taip;0;6;0;6
19102;Volungė;Žiogeliai;9816038480;Taip;0;0;7;7
19103;Volungė;Žiogeliai;8640511964;Taip;0;0;4;4
19104;Volungė;Žiogeliai;8421730419;Taip;0;0;10;10
19105;Volungė;Žiogeliai;6532202782;Taip;0;10;0;10
19106;Volungė;Žiogeliai;2712034356;Taip;0;0;5;5
19107;Volungė;Žiogeliai;6074678642;Taip;11;0;2;13
19108;Volungė;Žiogeliai;2246291631;Taip;0;0;2;2
19109;Volungė;Žiogeliai;2456643081;Taip;0;0;2;2
19110;Volungė;Žiogeliai;8299305464;Taip;0;4;16;20
19111;Volungė;Žiogeliai;1781838937;Taip;0;11;0;11
19112;Volungė;Žiogeliai;7859381467;Taip;0;22;0;22
19113;Volungė;Žiogeliai;2603335248;Ne;0;0;3;3
19114;Volungė;Pelėdžiukai;1032406917;Taip;0;1;0;1
19115;Volungė;Pelėdžiukai;1105647976;Taip;3;0;0;3
19116;Volungė;Pelėdžiukai;1705153224;Taip;0;0;1;1
19117;Volungė;Pelėdžiukai;2048619311;Taip;3;0;0;3
19118;Volungė;Pelėdžiukai;1205393441;Taip;1;0;2;3
19119;Volungė;Pelėdžiukai;3675279848;Taip;0;4;0;4
19120;Volungė;Pelėdžiukai;9097775073;Taip;1;0;0;1
19121;Volungė;Pelėdžiukai;1938717633;Taip;9;0;1;10
19122;Volungė;Pelėdžiukai;56766828567;Taip;0;3;0;3
19123;Volungė;Pelėdžiukai;1072302178;Ne;0;0;4;4
19124;Volungė;Pelėdžiukai;6977873198;Taip;5;0;2;7
19125;Volungė;Pelėdžiukai;1917593287;Taip;5;0;0;5
19126;Volungė;Pelėdžiukai;85731265908;Taip;0;0;2;2
19127;Volungė;Pelėdžiukai;5483140534;Taip;0;0;2;2
19128;Volungė;Pelėdžiukai;8236836742;Taip;0;9;1;10
19129;Volungė;Pelėdžiukai;1158253769;Taip;0;0;1;1
19130;Volungė;Pelėdžiukai;1021284696;Taip;0;0;6;6
19131;Volungė;Pelėdžiukai;79934072325;Taip;0;1;7;8
19132;Volungė;Pelėdžiukai;88077831193;Taip;0;0;6;6
19133;Volungė;Drugeliai;6280208510;Taip;4;6;0;10
19134;Volungė;Drugeliai;4032261812;Taip;7;0;6;13
19135;Volungė;Drugeliai;6488473384;Taip;12;0;0;12
19136;Volungė;Drugeliai;8045459660;Taip;5;0;0;5
19137;Volungė;Drugeliai;1402200673;Taip;5;0;0;5
19138;Volungė;Drugeliai;7574856429;Taip;11;0;0;11
19139;Volungė;Drugeliai;5284011092;Taip;0;0;2;2
19140;Volungė;Drugeliai;9729285419;Taip;0;0;15;15
19141;Volungė;Drugeliai;9973604148;Taip;0;10;0;10
19142;Volungė;Drugeliai;8905401944;Taip;4;0;3;7
19143;Volungė;Drugeliai;2923810441;Taip;0;0;3;3
19144;Volungė;Drugeliai;6782622442;Taip;0;0;1;1
19145;Volungė;Drugeliai;5354511593;Taip;0;9;0;9
19146;Volungė;Drugeliai;3150532451;Taip;0;0;3;3
19147;Volungė;Drugeliai;9343118795;Taip;2;12;0;14
19148;Volungė;Drugeliai;4745609424;Taip;3;0;0;3
19149;Volungė;"SKRUZDĖLIUKAI ";8174587725;Taip;0;0;12;12
19150;Volungė;"SKRUZDĖLIUKAI ";7521910384;Taip;5;0;1;6
19151;Volungė;"SKRUZDĖLIUKAI ";8268202101;Taip;0;0;6;6
19152;Volungė;"SKRUZDĖLIUKAI ";2566901599;Taip;0;0;1;1
19153;Volungė;"SKRUZDĖLIUKAI ";3215314804;Taip;0;0;5;5
19154;Volungė;"SKRUZDĖLIUKAI ";7281448136;Taip;0;2;2;4
19155;Volungė;"SKRUZDĖLIUKAI ";2420242319;Taip;0;0;1;1
19156;Volungė;"SKRUZDĖLIUKAI ";1120682487;Taip;0;0;3;3
19157;Volungė;"SKRUZDĖLIUKAI ";1366066359;Taip;0;4;1;5
19158;Volungė;"SKRUZDĖLIUKAI ";9068889427;Taip;0;0;4;4
19159;Volungė;"SKRUZDĖLIUKAI ";6565522808;Taip;5;0;2;7
19160;Volungė;"SKRUZDĖLIUKAI ";1225378067;Taip;0;0;1;1
19161;Volungė;"SKRUZDĖLIUKAI ";3356901662;Taip;3;0;2;5
19162;Volungė;"SKRUZDĖLIUKAI ";9082860913;Taip;0;0;5;5
19163;Volungė;"SKRUZDĖLIUKAI ";7973680488;Taip;0;0;2;2
19164;Volungė;"SKRUZDĖLIUKAI ";9629567682;Taip;0;0;4;4
19165;Volungė;"SKRUZDĖLIUKAI ";4123080241;Taip;0;0;10;10
19166;Volungė;"SKRUZDĖLIUKAI ";7364431725;Taip;5;0;10;15
19167;Volungė;"SKRUZDĖLIUKAI ";8578521969;Taip;0;0;7;7
19168;Volungė;Zylutės;5942497397;Taip;18;0;0;18
19169;Volungė;Zylutės;4437625791;Taip;0;0;1;1
19170;Volungė;Zylutės;2212423676;Taip;0;0;4;4
19171;Volungė;Zylutės;5833091791;Taip;0;6;0;6
19172;Volungė;Zylutės;9319825151;Taip;0;1;0;1
19173;Volungė;Zylutės;8613580206;Taip;5;0;0;5
19174;Volungė;Zylutės;4991465781;Taip;4;0;2;6
19175;Volungė;Zylutės;1653024489;Taip;11;0;2;13
19176;Volungė;Zylutės;5332306628;Taip;0;0;11;11
19177;Volungė;Zylutės;1101228927;Taip;8;0;0;8
19178;Volungė;Zylutės;6370584522;Taip;8;12;0;20
19179;Volungė;Zylutės;3818924175;Taip;7;0;1;8
19180;Volungė;Zylutės;6110117105;Taip;6;0;0;6
19181;Volungė;Zylutės;5994884455;Taip;0;0;1;1
19182;Volungė;Zylutės;8992514683;Taip;0;0;3;3
19183;Volungė;Zylutės;4944556574;Taip;0;0;4;4
19184;Volungė;Zylutės;8168630107;Taip;0;4;0;4
19185;Giliukas;SMALSUČIAI;3252419072;Taip;5;0;0;5
19186;Giliukas;SMALSUČIAI;9608331265;Taip;0;6;0;6
19187;Giliukas;SMALSUČIAI;1870173947;Taip;6;0;5;11
19188;Giliukas;SMALSUČIAI;9644050818;Taip;0;11;0;11
19189;Giliukas;SMALSUČIAI;3150981084;Taip;5;2;4;11
19190;Giliukas;SMALSUČIAI;6134554678;Taip;0;9;0;9
19191;Giliukas;SMALSUČIAI;3137768675;Taip;0;2;1;3
19192;Giliukas;SMALSUČIAI;9408948207;Taip;4;2;2;8
19193;Giliukas;SMALSUČIAI;2003990493;Taip;0;2;1;3
19194;Giliukas;SMALSUČIAI;4960232685;Taip;0;0;1;1
19195;Giliukas;SMALSUČIAI;8267507304;Ne;17;1;0;18
19196;Giliukas;SMALSUČIAI;6338583515;Taip;3;1;1;5
19197;Giliukas;SMALSUČIAI;9458151965;Taip;0;0;1;1
19198;Giliukas;SMALSUČIAI;3691791222;Taip;6;0;0;6
19199;Giliukas;SMALSUČIAI;1890147760;Taip;0;0;1;1
19200;Giliukas;SMALSUČIAI;1469477982;Taip;0;4;0;4
19201;Giliukas;SMALSUČIAI;3983555939;Taip;0;1;0;1
19202;Giliukas;SMALSUČIAI;2951628295;Taip;0;2;1;3
19203;Giliukas;SMALSUČIAI;9401247559;Taip;3;2;0;5
19204;Giliukas;SMALSUČIAI;4916844983;Taip;7;0;0;7
19205;Giliukas;SMALSUČIAI;5787041097;Taip;7;1;0;8
19206;Giliukas;GUDRUČIAI;1289574961;Taip;0;1;0;1
19207;Giliukas;GUDRUČIAI;89954209937;Taip;0;1;0;1
19208;Giliukas;GUDRUČIAI;4053376466;Taip;5;2;2;9
19209;Giliukas;GUDRUČIAI;26109227683;Taip;0;0;2;2
19210;Giliukas;GUDRUČIAI;9225515816;Taip;0;1;0;1
19211;Giliukas;GUDRUČIAI;10326073797;Taip;0;1;1;2
19212;Giliukas;GUDRUČIAI;7732836522;Taip;7;0;0;7
19213;Giliukas;GUDRUČIAI;1406371374;Taip;3;0;0;3
19214;Giliukas;GUDRUČIAI;1664239181;Taip;0;1;0;1
19215;Giliukas;GUDRUČIAI;40373221046;Taip;0;1;0;1
19216;Giliukas;GUDRUČIAI;1595057434;Taip;1;5;0;6
19217;Giliukas;GUDRUČIAI;1417138570;Taip;0;1;0;1
19218;Giliukas;GUDRUČIAI;1463748654;Taip;0;4;0;4
19219;Giliukas;GUDRUČIAI;14318411597;Taip;0;7;0;7
19220;Giliukas;GUDRUČIAI;8575067944;Taip;3;0;0;3
19221;Giliukas;GUDRUČIAI;34155615138;Ne;0;8;0;8
19222;Giliukas;GUDRUČIAI;6453425490;Taip;2;0;1;3
19223;Giliukas;GUDRUČIAI;5914236976;Taip;8;0;0;8
19224;Giliukas;GUDRUČIAI;2006450088;Taip;3;1;0;4
19225;Giliukas;ŠVELNUKAI;3274313536;Taip;1;0;0;1
19226;Giliukas;ŠVELNUKAI;9287193955;Taip;0;22;0;22
19227;Giliukas;ŠVELNUKAI;5527212334;Taip;5;0;2;7
19228;Giliukas;ŠVELNUKAI;9499591494;Taip;4;0;0;4
19229;Giliukas;ŠVELNUKAI;2099575372;Taip;11;0;0;11
19230;Giliukas;ŠVELNUKAI;7195772641;Taip;9;0;0;9
19231;Giliukas;ŠVELNUKAI;6157459742;Taip;0;20;0;20
19232;Giliukas;ŠVELNUKAI;4258921446;Taip;2;0;2;4
19233;Giliukas;ŠVELNUKAI;2004782696;Taip;14;0;3;17
19234;Giliukas;ŠVELNUKAI;8977247073;Taip;6;0;0;6
19235;Giliukas;ŠVELNUKAI;5551537261;Taip;14;0;1;15
19236;Giliukas;ŠVELNUKAI;8147492951;Taip;3;0;0;3
19237;Giliukas;ŽINIUKAI;8499893356;Ne;6;4;0;10
19238;Giliukas;ŽINIUKAI;6422178450;Taip;0;1;0;1
19239;Giliukas;ŽINIUKAI;3847358328;Taip;14;1;1;16
19240;Giliukas;ŽINIUKAI;2502801547;Taip;14;1;1;16
19241;Giliukas;ŽINIUKAI;9617542456;Taip;0;14;0;14
19242;Giliukas;ŽINIUKAI;9205911152;Taip;5;0;0;5
19243;Giliukas;ŽINIUKAI;2562809633;Taip;7;1;1;9
19244;Giliukas;ŽINIUKAI;3720032249;Taip;3;0;2;5
19245;Giliukas;ŽINIUKAI;3659105022;Ne;11;2;0;13
19246;Giliukas;ŽINIUKAI;4940718205;Taip;13;0;0;13
19247;Giliukas;ŽINIUKAI;6165618131;Ne;4;6;0;10
19248;Giliukas;ŽINIUKAI;5326178821;Ne;4;6;0;10
19249;Giliukas;ŽINIUKAI;2692141913;Taip;7;1;0;8
19250;Giliukas;ŽINIUKAI;9152432124;Taip;7;9;0;16
19251;Giliukas;ŽINIUKAI;8491008130;Taip;12;1;0;13
19252;Giliukas;ŽINIUKAI;2537186002;Taip;10;0;1;11
19253;Giliukas;ŽINIUKAI;4854370266;Taip;0;1;0;1
19254;Giliukas;ŽINIUKAI;6703080106;Taip;2;4;0;6
19255;Giliukas;ŽINIUKAI;1332725572;Taip;2;4;0;6
19256;Giliukas;ŽINIUKAI;4163383707;Taip;0;3;0;3
19257;Giliukas;MYLIMUKAI;3055598917;Taip;0;1;3;4
19258;Giliukas;MYLIMUKAI;6953123617;Taip;0;12;5;17
19259;Giliukas;MYLIMUKAI;4207939009;Taip;5;3;0;8
19260;Giliukas;MYLIMUKAI;2742106493;Taip;5;0;9;14
19261;Giliukas;MYLIMUKAI;1916905497;Taip;5;0;0;5
19262;Giliukas;MYLIMUKAI;7053406257;Taip;0;3;0;3
19263;Giliukas;MYLIMUKAI;5222092567;Taip;10;0;0;10
19264;"Lazdynų mokykla";Drugeliai;7154882168;Taip;0;22;0;22
19265;"Lazdynų mokykla";Drugeliai;4520091712;Taip;0;0;1;1
19266;"Lazdynų mokykla";Drugeliai;8472834181;Taip;0;12;0;12
19267;"Lazdynų mokykla";Drugeliai;9196184984;Taip;11;10;0;21
19268;"Lazdynų mokykla";Drugeliai;2469486746;Taip;0;11;0;11
19269;"Lazdynų mokykla";Drugeliai;6394098306;Taip;6;4;6;16
19270;"Lazdynų mokykla";Drugeliai;2027751624;Taip;2;5;0;7
19271;"Lazdynų mokykla";Drugeliai;2767732459;Ne;0;13;0;13
19272;"Lazdynų mokykla";Drugeliai;5902104981;Taip;0;8;0;8
19273;"Lazdynų mokykla";Drugeliai;7590111138;Taip;4;12;0;16
19274;"Lazdynų mokykla";Drugeliai;7524849851;Taip;4;9;0;13
19275;"Lazdynų mokykla";Drugeliai;1951041742;Ne;1;6;0;7
19276;"Lazdynų mokykla";Drugeliai;9309081745;Taip;0;1;0;1
19277;"Lazdynų mokykla";Zuikučiai;9123178095;Taip;0;23;0;23
19278;"Lazdynų mokykla";Zuikučiai;1365362641;Taip;0;10;0;10
19279;"Lazdynų mokykla";Zuikučiai;3435025978;Taip;5;10;0;15
19280;"Lazdynų mokykla";Zuikučiai;8899186547;Taip;17;3;0;20
19281;"Lazdynų mokykla";Zuikučiai;5465094647;Taip;0;9;0;9
19282;"Lazdynų mokykla";Zuikučiai;1044630813;Taip;0;5;0;5
19283;"Lazdynų mokykla";Zuikučiai;3268305561;Taip;3;12;3;18
19284;"Lazdynų mokykla";Zuikučiai;3535244441;Taip;0;3;8;11
19285;"Lazdynų mokykla";Zuikučiai;3265099747;Taip;0;13;2;15
19286;"Lazdynų mokykla";Zuikučiai;8001610972;Ne;10;3;0;13
19287;"Lazdynų mokykla";Zuikučiai;1336503878;Taip;3;0;0;3
19288;"Lazdynų mokykla";Zuikučiai;8669630986;Taip;3;1;0;4
19289;"Lazdynų mokykla";RUPG;1017100748;Taip;3;6;0;9
19290;"Lazdynų mokykla";RUPG;9236417880;Taip;0;0;3;3
19291;"Lazdynų mokykla";RUPG;1894521927;Taip;0;0;3;3
19292;"Lazdynų mokykla";RUPG;1386277428;Taip;0;7;0;7
19293;"Lazdynų mokykla";RUPG;7743741353;Taip;0;22;0;22
19294;"Lazdynų mokykla";RUPG;4514642887;Taip;0;0;1;1
19295;"Lazdynų mokykla";RUPG;7456563336;Taip;0;0;1;1
19296;"Lazdynų mokykla";RUPG;8886654664;Taip;4;0;3;7
19297;"Lazdynų mokykla";RUPG;5076773045;Taip;0;0;7;7
19298;"Lazdynų mokykla";RUPG;6646352376;Ne;0;22;0;22
19299;"Lazdynų mokykla";RUPG;3510685610;Taip;0;22;0;22
19300;"Lazdynų mokykla";PG;64706392096;Taip;0;22;0;22
19301;"Lazdynų mokykla";PG;1169321455;Taip;11;5;0;16
19302;"Lazdynų mokykla";PG;64601938351;Taip;0;4;0;4
19303;"Lazdynų mokykla";PG;32489318287;Taip;0;0;1;1
19304;"Lazdynų mokykla";PG;1608544032;Taip;0;5;0;5
19305;"Lazdynų mokykla";PG;80459437057;Taip;7;0;1;8
19306;"Lazdynų mokykla";PG;41008813511;Ne;5;0;0;5
19307;"Lazdynų mokykla";PG;3035056391;Taip;0;3;0;3
19308;"Lazdynų mokykla";PG;8383285502;Taip;9;0;5;14
19309;"Lazdynų mokykla";PG;8324750958;Ne;0;0;15;15
19310;"Lazdynų mokykla";PG;1065999533;Taip;0;0;2;2
19311;"Lazdynų mokykla";PG;9591838054;Taip;5;0;0;5
19312;"Lazdynų mokykla";PG;3171487020;Taip;10;0;4;14
19313;"Lazdynų mokykla";PG;6117542654;Taip;3;0;0;3
19314;"Lazdynų mokykla";ZUIKUČIAI;4166599533;Taip;0;0;2;2
19315;"„Atžalyno” mokykla-darželis";Giliukai;8354263485;Taip;0;0;2;2
19316;"„Atžalyno” mokykla-darželis";Giliukai;3917667527;Taip;0;0;2;2
19317;"„Atžalyno” mokykla-darželis";Giliukai;41775536104;Taip;4;0;1;5
19318;"„Atžalyno” mokykla-darželis";Giliukai;38762730531;Ne;0;14;4;18
19319;"„Atžalyno” mokykla-darželis";Giliukai;3461773781;Taip;0;0;5;5
19320;"„Atžalyno” mokykla-darželis";Giliukai;71840666522;Taip;10;0;1;11
19321;"„Atžalyno” mokykla-darželis";Giliukai;37897965773;Taip;0;0;8;8
19322;"„Atžalyno” mokykla-darželis";Riešutėliai;4784990018;Taip;10;3;0;13
19323;"„Atžalyno” mokykla-darželis";Riešutėliai;4345420422;Taip;14;0;0;14
19324;"„Atžalyno” mokykla-darželis";Riešutėliai;9806203065;Taip;0;6;0;6
19325;"„Atžalyno” mokykla-darželis";Riešutėliai;9215658103;Taip;0;0;1;1
19326;"„Atžalyno” mokykla-darželis";Riešutėliai;3484401937;Taip;0;0;4;4
19327;"„Atžalyno” mokykla-darželis";Riešutėliai;9013323901;Taip;0;10;0;10
19328;"„Atžalyno” mokykla-darželis";Riešutėliai;3529875728;Taip;0;4;0;4
19329;"„Atžalyno” mokykla-darželis";Riešutėliai;8688627865;Taip;1;0;0;1
19330;"„Atžalyno” mokykla-darželis";Riešutėliai;5030879885;Taip;0;0;4;4
19331;"„Atžalyno” mokykla-darželis";Riešutėliai;1311162040;Taip;0;4;1;5
19332;"„Atžalyno” mokykla-darželis";Riešutėliai;2601122166;Taip;15;0;0;15
19333;"„Atžalyno” mokykla-darželis";Riešutėliai;4427232735;Taip;0;1;0;1
19334;"„Atžalyno” mokykla-darželis";Riešutėliai;5503766544;Taip;0;7;0;7
19335;"„Atžalyno” mokykla-darželis";Riešutėliai;1958519966;Taip;0;12;1;13
19336;"„Atžalyno” mokykla-darželis";Žirniukai;6903825217;Taip;0;14;0;14
19337;"„Atžalyno” mokykla-darželis";Žirniukai;9101301819;Taip;0;1;0;1
19338;"„Atžalyno” mokykla-darželis";Žirniukai;6602037942;Taip;0;2;0;2
19339;"„Atžalyno” mokykla-darželis";Žirniukai;1915676392;Ne;11;0;1;12
19340;"„Atžalyno” mokykla-darželis";Žirniukai;7669725276;Taip;0;10;0;10
19341;"„Atžalyno” mokykla-darželis";Žirniukai;5986664970;Taip;5;0;0;5
19342;"„Atžalyno” mokykla-darželis";Žirniukai;9913048992;Taip;0;5;0;5
19343;"„Atžalyno” mokykla-darželis";Žirniukai;4616870552;Taip;0;0;1;1
19344;"„Atžalyno” mokykla-darželis";Žirniukai;4107946143;Taip;0;11;0;11
19345;"„Atžalyno” mokykla-darželis";Žirniukai;7883570492;Ne;0;2;0;2
19346;"„Atžalyno” mokykla-darželis";Žirniukai;8320161812;Taip;1;3;0;4
19347;"„Atžalyno” mokykla-darželis";Žirniukai;5335059675;Taip;2;3;0;5
19348;"„Atžalyno” mokykla-darželis";Žirniukai;6922776405;Taip;0;1;0;1
19349;"„Atžalyno” mokykla-darželis";Žirniukai;9690554753;Taip;0;0;13;13
19350;"„Atžalyno” mokykla-darželis";Žirniukai;1961428224;Ne;4;1;0;5
19351;"„Atžalyno” mokykla-darželis";Žirniukai;8070499557;Taip;0;8;0;8
19352;"„Atžalyno” mokykla-darželis";Žirniukai;2446697763;Taip;0;0;5;5
19353;"„Atžalyno” mokykla-darželis";VYŠNIUKAI;5947938371;Ne;0;0;3;3
19354;"„Atžalyno” mokykla-darželis";VYŠNIUKAI;4246430352;Taip;15;0;0;15
19355;"„Atžalyno” mokykla-darželis";VYŠNIUKAI;8574494664;Ne;0;4;0;4
19356;"„Atžalyno” mokykla-darželis";VYŠNIUKAI;5815412814;Taip;13;0;0;13
19357;"„Atžalyno” mokykla-darželis";VYŠNIUKAI;4161658496;Ne;0;3;0;3
19358;"„Atžalyno” mokykla-darželis";VYŠNIUKAI;8942132574;Taip;12;2;0;14
19359;"„Atžalyno” mokykla-darželis";VYŠNIUKAI;7109850241;Taip;0;14;0;14
19360;"„Atžalyno” mokykla-darželis";VYŠNIUKAI;7368616441;Taip;0;0;5;5
19361;"„Atžalyno” mokykla-darželis";VYŠNIUKAI;5242752663;Taip;9;0;0;9
19362;"„Atžalyno” mokykla-darželis";VYŠNIUKAI;5709028342;Taip;0;0;1;1
19363;"„Atžalyno” mokykla-darželis";VYŠNIUKAI;5994983369;Ne;0;2;0;2
19364;"„Atžalyno” mokykla-darželis";VYŠNIUKAI;7676614240;Taip;18;0;0;18
19365;"„Atžalyno” mokykla-darželis";VYŠNIUKAI;3751729666;Taip;7;0;3;10
19366;"„Atžalyno” mokykla-darželis";VYŠNIUKAI;5384245347;Taip;4;3;0;7
19367;"„Atžalyno” mokykla-darželis";VYŠNIUKAI;4360099345;Taip;9;0;0;9
19368;"„Atžalyno” mokykla-darželis";VYŠNIUKAI;8803555426;Taip;0;0;1;1
19369;"„Atžalyno” mokykla-darželis";PIPIRIUKAI;8357021249;Taip;11;0;0;11
19370;"„Atžalyno” mokykla-darželis";PIPIRIUKAI;4582284727;Taip;0;0;1;1
19371;"„Atžalyno” mokykla-darželis";PIPIRIUKAI;4785607785;Taip;1;0;2;3
19372;"„Atžalyno” mokykla-darželis";PIPIRIUKAI;5615246040;Taip;0;0;2;2
19373;"„Atžalyno” mokykla-darželis";PIPIRIUKAI;1988657552;Taip;22;0;0;22
19374;"„Atžalyno” mokykla-darželis";PIPIRIUKAI;6721771665;Taip;1;0;0;1
19375;"„Atžalyno” mokykla-darželis";PIPIRIUKAI;7946139474;Taip;0;0;2;2
19376;"„Atžalyno” mokykla-darželis";PIPIRIUKAI;2921181385;Ne;0;0;3;3
19377;"„Atžalyno” mokykla-darželis";PIPIRIUKAI;2108706876;Taip;16;0;4;20
19378;"„Atžalyno” mokykla-darželis";PIPIRIUKAI;1228919159;Taip;0;10;0;10
19379;"„Atžalyno” mokykla-darželis";PIPIRIUKAI;3919301151;Taip;8;0;0;8
19380;"„Atžalyno” mokykla-darželis";PIPIRIUKAI;3624299098;Taip;0;0;11;11
19381;"„Atžalyno” mokykla-darželis";PIPIRIUKAI;2537063401;Taip;0;0;7;7
19382;"„Atžalyno” mokykla-darželis";PIPIRIUKAI;4166521512;Taip;0;0;2;2
19383;"„Atžalyno” mokykla-darželis";PIPIRIUKAI;8372179128;Taip;0;0;2;2
19384;"„Atžalyno” mokykla-darželis";PIPIRIUKAI;3204191459;Taip;0;5;0;5
19385;"„Atžalyno” mokykla-darželis";PIPIRIUKAI;9674145631;Taip;7;0;8;15
19386;"„Atžalyno” mokykla-darželis";PIPIRIUKAI;3015863723;Taip;7;1;0;8
19387;"„Atžalyno” mokykla-darželis";PIPIRIUKAI;3323233525;Taip;7;1;0;8
19388;"„Atžalyno” mokykla-darželis";PIPIRIUKAI;4596770586;Taip;2;0;2;4
19389;"„Atžalyno” mokykla-darželis";PIPIRIUKAI;3441950153;Taip;9;4;0;13
19390;"Vilniaus Naujininkų mokykla";SMALSUČIAI;16769013415;Taip;0;9;0;9
19391;"Vilniaus Naujininkų mokykla";SMALSUČIAI;2283471768;Ne;0;11;0;11
19392;"Vilniaus Naujininkų mokykla";SMALSUČIAI;3867799187;Taip;5;0;0;5
19393;"Vilniaus Naujininkų mokykla";SMALSUČIAI;8044895207;Taip;0;0;19;19
19394;"Vilniaus Naujininkų mokykla";SMALSUČIAI;51982253355;Taip;0;11;0;11
19395;"Vilniaus Naujininkų mokykla";SMALSUČIAI;2066711124;Taip;0;1;0;1
19396;"Vilniaus Naujininkų mokykla";SMALSUČIAI;9130093851;Taip;0;0;8;8
19397;"Vilniaus Naujininkų mokykla";SMALSUČIAI;175310584;Taip;0;4;0;4
19398;"Vilniaus Naujininkų mokykla";SMALSUČIAI;4291687553;Taip;0;11;0;11
19399;"Vilniaus Naujininkų mokykla";SMALSUČIAI;81714181307;Taip;9;0;1;10
19400;"Vilniaus Naujininkų mokykla";SMALSUČIAI;2115818836;Taip;0;0;5;5
19401;"Vilniaus Naujininkų mokykla";SMALSUČIAI;1124808709;Taip;0;0;5;5
19402;"Vilniaus Naujininkų mokykla";SMALSUČIAI;4405486406;Taip;0;0;1;1
19403;"Vilniaus Naujininkų mokykla";SMALSUČIAI;51689349222;Taip;0;0;3;3
19404;"Vilniaus Naujininkų mokykla";SMALSUČIAI;5661401548;Taip;0;2;0;2
19405;"Vilniaus Naujininkų mokykla";SMALSUČIAI;93378182766;Taip;0;0;1;1
19406;"Vilniaus Naujininkų mokykla";SMALSUČIAI;6999689312;Taip;0;0;5;5
19407;"Vilniaus Naujininkų mokykla";SMALSUČIAI;1350744949;Taip;0;0;1;1
19408;"Vilniaus Naujininkų mokykla";"SAULĖS ZUIKUČIAI";1096474672;Taip;8;2;1;11
19409;"Vilniaus Naujininkų mokykla";"SAULĖS ZUIKUČIAI";7144378150;Taip;11;7;0;18
19410;"Vilniaus Naujininkų mokykla";"SAULĖS ZUIKUČIAI";9856315057;Taip;5;0;0;5
19411;"Vilniaus Naujininkų mokykla";"SAULĖS ZUIKUČIAI";6894804166;Taip;0;15;0;15
19412;"Vilniaus Naujininkų mokykla";"SAULĖS ZUIKUČIAI";3192556582;Taip;0;15;0;15
19413;"Vilniaus Naujininkų mokykla";"SAULĖS ZUIKUČIAI";5302103644;Ne;10;2;0;12
19414;"Vilniaus Naujininkų mokykla";"SAULĖS ZUIKUČIAI";1901250406;Ne;0;6;0;6
19415;"Vilniaus Naujininkų mokykla";"SAULĖS ZUIKUČIAI";63557632023;Taip;0;5;0;5
19416;"Vilniaus Naujininkų mokykla";"SAULĖS ZUIKUČIAI";1041144226;Ne;13;0;0;13
19417;"Vilniaus Naujininkų mokykla";"SAULĖS ZUIKUČIAI";8280826634;Ne;0;4;0;4
19418;"Vilniaus Naujininkų mokykla";"SAULĖS ZUIKUČIAI";9427388681;Taip;0;3;0;3
19419;"Vilniaus Naujininkų mokykla";"SAULĖS ZUIKUČIAI";5512321795;Taip;0;6;0;6
19420;"Vilniaus Naujininkų mokykla";"SAULĖS ZUIKUČIAI";9411054207;Ne;0;7;0;7
19421;"Vilniaus Naujininkų mokykla";"SAULĖS ZUIKUČIAI";3810550099;Taip;0;12;0;12
19422;"Vilniaus Naujininkų mokykla";"SAULĖS ZUIKUČIAI";4086025657;Ne;8;0;2;10
19423;"Vilniaus Emilijos Pliaterytės progimnazija";PELĖDŽIUKAI;15500820772;Taip;4;0;0;4
19424;"Vilniaus Emilijos Pliaterytės progimnazija";PELĖDŽIUKAI;47393966396;Taip;0;0;1;1
19425;"Vilniaus Emilijos Pliaterytės progimnazija";PELĖDŽIUKAI;61091610394;Taip;0;0;4;4
19426;"Vilniaus Emilijos Pliaterytės progimnazija";PELĖDŽIUKAI;1683299408;Taip;0;2;0;2
19427;"Vilniaus Emilijos Pliaterytės progimnazija";PELĖDŽIUKAI;94650801877;Taip;0;1;0;1
19428;"Vilniaus Emilijos Pliaterytės progimnazija";PELĖDŽIUKAI;1847664280;Taip;0;9;0;9
19429;"Vilniaus Emilijos Pliaterytės progimnazija";PELĖDŽIUKAI;2818073374;Taip;0;3;1;4
19430;"Vilniaus Emilijos Pliaterytės progimnazija";PELĖDŽIUKAI;9192660067;Taip;0;2;0;2
19431;"Vilniaus Emilijos Pliaterytės progimnazija";PELĖDŽIUKAI;2544422668;Taip;0;1;0;1
19432;"Vilniaus Emilijos Pliaterytės progimnazija";PELĖDŽIUKAI;4675716163;Taip;0;0;1;1
19433;"Vilniaus Emilijos Pliaterytės progimnazija";PELĖDŽIUKAI;1293862946;Taip;0;0;2;2
19434;"Vilniaus Emilijos Pliaterytės progimnazija";BITUTĖS;4743331873;Taip;0;0;9;9
19435;"Vilniaus Emilijos Pliaterytės progimnazija";BITUTĖS;38755774035;Taip;5;1;0;6
19436;"Vilniaus Emilijos Pliaterytės progimnazija";BITUTĖS;91658912153;Taip;0;0;5;5
19437;"Vilniaus Emilijos Pliaterytės progimnazija";BITUTĖS;2026582294;Taip;0;8;0;8
19438;"Vilniaus Emilijos Pliaterytės progimnazija";BITUTĖS;2019000592;Taip;0;0;1;1
19439;"Vilniaus Emilijos Pliaterytės progimnazija";BITUTĖS;14978429821;Taip;0;2;1;3
19440;"Vilniaus Emilijos Pliaterytės progimnazija";BITUTĖS;3215514769;Taip;0;0;5;5
19441;"Vilniaus Emilijos Pliaterytės progimnazija";BITUTĖS;8741172408;Taip;8;0;7;15
19442;"Vilniaus Emilijos Pliaterytės progimnazija";BITUTĖS;2159037118;Taip;0;2;0;2
19443;"Vilniaus Emilijos Pliaterytės progimnazija";BITUTĖS;40696452801;Taip;0;2;1;3
19444;"Vilniaus Emilijos Pliaterytės progimnazija";BITUTĖS;73039119839;Taip;0;1;0;1
19445;"Vilniaus Emilijos Pliaterytės progimnazija";BITUTĖS;2332865106;Ne;8;2;4;14
19446;"Vilniaus Emilijos Pliaterytės progimnazija";BITUTĖS;6826626104;Taip;0;6;2;8
19447;"Vilniaus Emilijos Pliaterytės progimnazija";BITUTĖS;1583090840;Taip;0;2;0;2
19448;"Vilniaus Emilijos Pliaterytės progimnazija";BITUTĖS;2774371800;Taip;8;0;7;15
19449;"Vilniaus Karaliaus Mindaugo pagrindinė mokykla";"PUG 2";2080944830;Taip;0;0;1;1
19450;"Vilniaus Karaliaus Mindaugo pagrindinė mokykla";"PUG 2";94289379983;Taip;0;0;1;1
19451;"Vilniaus Karaliaus Mindaugo pagrindinė mokykla";"PUG 2";86134224919;Taip;9;0;1;10
19452;"Vilniaus Karaliaus Mindaugo pagrindinė mokykla";"PUG 2";41763338811;Ne;0;0;1;1
19453;"Vilniaus Karaliaus Mindaugo pagrindinė mokykla";"PUG 2";1331295966;Ne;0;0;2;2
19454;"Vilniaus Karaliaus Mindaugo pagrindinė mokykla";"PUG 2";9166145365;Taip;0;0;7;7
19455;"Vilniaus Karaliaus Mindaugo pagrindinė mokykla";"PUG 2";13209811505;Taip;0;5;0;5
19456;"Vilniaus Karaliaus Mindaugo pagrindinė mokykla";"PUG 2";1744313172;Taip;8;0;2;10
19457;"Vilniaus Karaliaus Mindaugo pagrindinė mokykla";"PUG 2";1620268693;Taip;5;0;1;6
19458;"Vilniaus Karaliaus Mindaugo pagrindinė mokykla";"PUG 2";1447824885;Taip;0;0;10;10
19459;"Vilniaus Karaliaus Mindaugo pagrindinė mokykla";"PUG 2";8724334916;Taip;0;0;3;3
19460;"Vilniaus Karaliaus Mindaugo pagrindinė mokykla";"PUG 2";3227066520;Taip;0;0;5;5
19461;"Vilniaus Karaliaus Mindaugo pagrindinė mokykla";"PUG 2";68484583641;Taip;8;0;4;12
19462;"Vilniaus Karaliaus Mindaugo pagrindinė mokykla";"PUG 2";1089500743;Taip;0;0;3;3
19463;"Vilniaus Karaliaus Mindaugo pagrindinė mokykla";"PUG 2";1738802158;Taip;0;0;5;5
19464;"Vilniaus Karaliaus Mindaugo pagrindinė mokykla";"PUG 2";1949773124;Taip;0;0;6;6
19465;"Vilniaus Karaliaus Mindaugo pagrindinė mokykla";"PUG 1";9669281441;Taip;3;0;0;3
19466;"Vilniaus Karaliaus Mindaugo pagrindinė mokykla";"PUG 1";40438226874;Taip;0;6;0;6
19467;"Vilniaus Karaliaus Mindaugo pagrindinė mokykla";"PUG 1";1000393691;Taip;18;0;4;22
19468;"Vilniaus Karaliaus Mindaugo pagrindinė mokykla";"PUG 1";5925573087;Taip;0;0;1;1
19469;"Vilniaus Karaliaus Mindaugo pagrindinė mokykla";"PUG 1";1236147310;Taip;0;0;2;2
19470;"Vilniaus Karaliaus Mindaugo pagrindinė mokykla";"PUG 1";63043069680;Taip;0;3;0;3
19471;"Vilniaus Karaliaus Mindaugo pagrindinė mokykla";"PUG 1";1430790285;Taip;7;0;3;10
19472;"Vilniaus Karaliaus Mindaugo pagrindinė mokykla";"PUG 1";16810083920;Taip;0;0;4;4
19473;"Vilniaus Karaliaus Mindaugo pagrindinė mokykla";"PUG 1";9654611393;Taip;13;0;0;13
19474;"Vilniaus Karaliaus Mindaugo pagrindinė mokykla";"PUG 1";1836892386;Taip;0;0;4;4
19475;"Vilniaus Karaliaus Mindaugo pagrindinė mokykla";"PUG 1";81648325534;Ne;0;5;0;5
19476;"Vilniaus Karaliaus Mindaugo pagrindinė mokykla";"PUG 1";7087183198;Taip;16;0;3;19
19477;"Vilniaus Karaliaus Mindaugo pagrindinė mokykla";"PUG 1";28382049716;Taip;0;0;2;2
19478;"Vilniaus Karaliaus Mindaugo pagrindinė mokykla";"PUG 1";2079943643;Taip;0;0;1;1
19479;"Vilniaus Karaliaus Mindaugo pagrindinė mokykla";"PUG 1";1719236931;Taip;0;0;6;6
19480;"Vilniaus Baltupių progimnazija";Kodėlčiukai;1662282971;Taip;0;0;3;3
19481;"Vilniaus Baltupių progimnazija";Kodėlčiukai;9584956349;Taip;0;0;1;1
19482;"Vilniaus Baltupių progimnazija";Kodėlčiukai;1001114367;Taip;0;0;2;2
19483;"Vilniaus Baltupių progimnazija";Kodėlčiukai;1105249315;Taip;0;0;1;1
19484;"Vilniaus Baltupių progimnazija";Kodėlčiukai;1912938544;Taip;0;0;4;4
19485;"Vilniaus Baltupių progimnazija";Kodėlčiukai;3467135952;Taip;0;0;5;5
19486;"Vilniaus Baltupių progimnazija";Kodėlčiukai;96211766919;Taip;0;1;0;1
19487;"Vilniaus Baltupių progimnazija";Kodėlčiukai;37612987791;Taip;5;1;0;6
19488;"Vilniaus Baltupių progimnazija";Kodėlčiukai;63221497564;Taip;0;6;0;6
19489;"Vilniaus Baltupių progimnazija";Kodėlčiukai;89051269756;Taip;0;0;1;1
19490;"Vilniaus Baltupių progimnazija";Kodėlčiukai;6426075546;Taip;0;0;2;2
19491;"Vilniaus Baltupių progimnazija";Kodėlčiukai;4785035794;Taip;0;0;12;12
19492;"Vilniaus Baltupių progimnazija";Kodėlčiukai;2004434873;Taip;0;0;2;2
19493;"Vilniaus Baltupių progimnazija";Smalsučiai;45632551657;Taip;2;0;0;2
19494;"Vilniaus Baltupių progimnazija";Smalsučiai;88801178853;Ne;19;0;0;19
19495;"Vilniaus Baltupių progimnazija";Smalsučiai;4767702053;Taip;3;11;1;15
19496;"Vilniaus Baltupių progimnazija";Smalsučiai;29480359781;Taip;8;1;0;9
19497;"Vilniaus Baltupių progimnazija";Smalsučiai;1882797491;Taip;0;0;9;9
19498;"Vilniaus Baltupių progimnazija";Smalsučiai;3292572563;Taip;5;0;2;7
19499;"Vilniaus Baltupių progimnazija";Smalsučiai;5346961743;Taip;0;0;7;7
19500;"Vilniaus Baltupių progimnazija";Smalsučiai;93809482039;Taip;5;0;0;5
19501;"Vilniaus Baltupių progimnazija";Smalsučiai;9989381310;Taip;0;22;0;22
19502;"Vilniaus Baltupių progimnazija";Smalsučiai;81135362098;Taip;5;0;0;5
19503;"Vilniaus Baltupių progimnazija";Smalsučiai;5249215625;Taip;3;0;2;5
19504;"Vilniaus Baltupių progimnazija";Smalsučiai;7744905325;Taip;0;0;8;8
19505;"Vilniaus Baltupių progimnazija";Smalsučiai;1848089606;Taip;8;0;14;22
19506;"Vilniaus Levo Karsavino vidurinė mokykla";"Priešmokyklinukai A";42101273435;Taip;3;1;0;4
19507;"Vilniaus Levo Karsavino vidurinė mokykla";"Priešmokyklinukai A";1145364380;Taip;8;0;0;8
19508;"Vilniaus Levo Karsavino vidurinė mokykla";"Priešmokyklinukai A";23826981323;Taip;0;0;3;3
19509;"Vilniaus Levo Karsavino vidurinė mokykla";"Priešmokyklinukai A";1598044320;Taip;0;1;0;1
19510;"Vilniaus Levo Karsavino vidurinė mokykla";"Priešmokyklinukai A";62991250307;Taip;0;6;0;6
19511;"Vilniaus Levo Karsavino vidurinė mokykla";"Priešmokyklinukai A";5739686368;Taip;4;0;0;4
19512;"Vilniaus Levo Karsavino vidurinė mokykla";"Priešmokyklinukai A";1418000665;Taip;4;0;0;4
19513;"Vilniaus Levo Karsavino vidurinė mokykla";"Priešmokyklinukai A";1445891751;Taip;0;0;1;1
19514;"Vilniaus Levo Karsavino vidurinė mokykla";"Priešmokyklinukai A";45779928616;Ne;0;0;1;1
19515;"Vilniaus Levo Karsavino vidurinė mokykla";"Priešmokyklinukai A";1756267879;Taip;2;0;0;2
19516;"Vilniaus Levo Karsavino vidurinė mokykla";"Priešmokyklinukai A";1001570452;Taip;0;9;0;9
19517;"Vilniaus Levo Karsavino vidurinė mokykla";"Priešmokyklinukai B";1290119150;Taip;0;22;0;22
19518;"Vilniaus Levo Karsavino vidurinė mokykla";"Priešmokyklinukai B";99799126572;Taip;0;7;0;7
19519;"Vilniaus Levo Karsavino vidurinė mokykla";"Priešmokyklinukai B";6341589553;Taip;0;22;0;22
19520;"Vilniaus Levo Karsavino vidurinė mokykla";"Priešmokyklinukai B";5879965735;Taip;0;0;3;3
19521;"Vilniaus Levo Karsavino vidurinė mokykla";"Priešmokyklinukai B";95548866362;Taip;9;6;0;15
19522;"Vilniaus Levo Karsavino vidurinė mokykla";"Priešmokyklinukai B";3028866163;Ne;0;22;0;22
19523;"Vilniaus Levo Karsavino vidurinė mokykla";"Priešmokyklinukai B";4438653210;Taip;0;22;0;22
19524;"Vilniaus Levo Karsavino vidurinė mokykla";"Priešmokyklinukai B";76463522285;Taip;0;0;1;1
19525;"Vilniaus Levo Karsavino vidurinė mokykla";"Priešmokyklinukai B";1515536619;Taip;11;3;0;14
19526;"Vilniaus Levo Karsavino vidurinė mokykla";"Priešmokyklinukai B";2764568625;Taip;8;0;0;8
19527;"Vilniaus Levo Karsavino vidurinė mokykla";"Priešmokyklinukai B";1686464393;Taip;0;4;0;4
19528;"Vilniaus Levo Karsavino vidurinė mokykla";"Priešmokyklinukai B";53994799769;Taip;5;0;0;5
19529;"Vilniaus Levo Karsavino vidurinė mokykla";"Priešmokyklinukai B";45252076215;Ne;22;0;0;22
19530;"Vilniaus Levo Karsavino vidurinė mokykla";"Priešmokyklinukai B";9094328900;Taip;3;7;0;10
19531;"Vilniaus Levo Karsavino vidurinė mokykla";"Priešmokyklinukai B";3801820891;Taip;0;4;0;4
19532;"Vilniaus Liepkalnio Pagrindinė Mokykla";Bitutės;9202293067;Taip;0;0;6;6
19533;"Vilniaus Liepkalnio Pagrindinė Mokykla";Bitutės;1863845099;Ne;0;0;5;5
19534;"Vilniaus Liepkalnio Pagrindinė Mokykla";Bitutės;5075314234;Taip;6;0;0;6
19535;"Vilniaus Liepkalnio Pagrindinė Mokykla";Bitutės;4620927378;Taip;0;0;4;4
19536;"Vilniaus Liepkalnio Pagrindinė Mokykla";Bitutės;9871477318;Taip;0;0;8;8
19537;"Vilniaus Liepkalnio Pagrindinė Mokykla";Bitutės;1851385706;Taip;0;0;2;2
19538;"Vilniaus Liepkalnio Pagrindinė Mokykla";Bitutės;53725247148;Taip;3;0;4;7
19539;"Vilniaus Liepkalnio Pagrindinė Mokykla";Bitutės;5424383005;Taip;0;0;5;5
19540;"Vilniaus Liepkalnio Pagrindinė Mokykla";Bitutės;6355534391;Ne;0;0;7;7
19541;"Vilniaus Liepkalnio Pagrindinė Mokykla";Bitutės;47141854213;Taip;0;0;4;4
19542;"Vilniaus Liepkalnio Pagrindinė Mokykla";Bitutės;9929297266;Taip;0;0;22;22
19543;"Vilniaus Liepkalnio Pagrindinė Mokykla";Bitutės;4320017329;Taip;0;0;7;7
19544;"Vilniaus Liepkalnio Pagrindinė Mokykla";Bitutės;1843306606;Taip;0;0;6;6
19545;"Vilniaus Liepkalnio Pagrindinė Mokykla";Bitutės;1106183808;Taip;8;0;4;12
19546;"Vilniaus Liepkalnio Pagrindinė Mokykla";Bitutės;9103319661;Taip;6;0;3;9
19547;"Vilniaus Liepkalnio Pagrindinė Mokykla";Bitutės;2947239203;Taip;0;0;2;2
19548;"Vilniaus Liepkalnio Pagrindinė Mokykla";Bitutės;9909794030;Taip;0;0;2;2
19549;"Vilniaus Liepkalnio Pagrindinė Mokykla";Bitutės;1688610825;Taip;0;0;5;5
19550;"Vilniaus Pranciškaus Skorinos gimnazija";Saulytė;3374669528;Taip;0;0;3;3
19551;"Vilniaus Pranciškaus Skorinos gimnazija";Saulytė;1590889839;Taip;0;22;0;22
19552;"Vilniaus Pranciškaus Skorinos gimnazija";Saulytė;4332682721;Ne;0;0;5;5
19553;"Vilniaus Pranciškaus Skorinos gimnazija";Saulytė;1997651024;Ne;0;3;3;6
19554;"Vilniaus Pranciškaus Skorinos gimnazija";Saulytė;1711690546;Taip;0;1;4;5
19555;"Vilniaus Pranciškaus Skorinos gimnazija";Saulytė;1757412586;Taip;0;1;3;4
19556;"Vilniaus Pranciškaus Skorinos gimnazija";Saulytė;6977000987;Taip;0;5;2;7
19557;"Vilniaus Pranciškaus Skorinos gimnazija";Saulytė;4789626884;Taip;5;0;3;8
19558;"Vilniaus Pranciškaus Skorinos gimnazija";Saulytė;6236051765;Taip;0;4;2;6
19559;"Vilniaus Pranciškaus Skorinos gimnazija";Saulytė;1388103298;Taip;0;22;0;22
19560;"Vilniaus Pranciškaus Skorinos gimnazija";Saulytė;20920553773;Taip;0;9;1;10
19561;"Vilniaus Pranciškaus Skorinos gimnazija";Saulytė;1109105359;Taip;0;6;0;6
19562;"Vilniaus Pranciškaus Skorinos gimnazija";Saulytė;2397630691;Taip;4;7;1;12
19563;"Vilniaus Pranciškaus Skorinos gimnazija";Saulytė;5194059497;Taip;0;9;4;13
19564;"Vilniaus Simono Konarskio mokykla";"1 gr.";3961043533;Taip;4;0;0;4
19565;"Vilniaus Simono Konarskio mokykla";"1 gr.";3341090773;Ne;4;0;0;4
19566;"Vilniaus Trakų Vokės gimnazija";Priešmokyklinė;88989814775;Taip;0;1;1;2
19567;"Vilniaus Trakų Vokės gimnazija";Priešmokyklinė;86504089176;Taip;0;10;0;10
19568;"Vilniaus Trakų Vokės gimnazija";Priešmokyklinė;64083541565;Taip;0;0;1;1
19569;"Vilniaus Trakų Vokės gimnazija";Priešmokyklinė;33984949164;Taip;0;0;1;1
19570;"Vilniaus Trakų Vokės gimnazija";Priešmokyklinė;69866048102;Taip;0;15;0;15
19571;"Vilniaus Trakų Vokės gimnazija";Priešmokyklinė;24064321676;Taip;5;0;0;5
19572;"Vilniaus Trakų Vokės gimnazija";Priešmokyklinė;69311478204;Taip;0;16;0;16
19573;"Vilniaus Trakų Vokės gimnazija";Priešmokyklinė;6675993703;Taip;3;9;0;12
19574;"Vilniaus Trakų Vokės gimnazija";Priešmokyklinė;6418198934;Taip;0;10;0;10
19575;"Vilniaus Trakų Vokės gimnazija";Priešmokyklinė;71417288063;Taip;0;13;2;15
19576;"Vilniaus Trakų Vokės gimnazija";Priešmokyklinė;64019248229;Taip;0;1;1;2
19577;"Vilniaus Trakų Vokės gimnazija";Priešmokyklinė;18796898215;Taip;0;6;1;7
19578;"Vilniaus Trakų Vokės gimnazija";Priešmokyklinė;85293469079;Taip;5;0;4;9
19579;"Vilniaus Trakų Vokės gimnazija";Priešmokyklinė;9449948668;Taip;0;3;0;3
19580;"Vilniaus Trakų Vokės gimnazija";Priešmokyklinė;9705561511;Taip;0;6;2;8
19581;"Vilniaus Trakų Vokės gimnazija";Priešmokyklinė;1766156349;Taip;0;4;2;6
19582;"Vilniaus Trakų Vokės gimnazija";Priešmokyklinė;9386629495;Taip;0;2;0;2
19583;"Vilniaus Trakų Vokės gimnazija";Priešmokyklinė;6209271043;Taip;0;3;1;4
19584;"Vilniaus Trakų Vokės gimnazija";Priešmokyklinė;1303873524;Taip;0;3;2;5
19585;"Vilniaus Trakų Vokės gimnazija";Priešmokyklinė;1177208864;Taip;3;0;5;8
19586;"Vilniaus Trakų Vokės gimnazija";"Priešmokyklinė 2";67434532111;Taip;0;2;0;2
19587;"Vilniaus Trakų Vokės gimnazija";"Priešmokyklinė 2";10453975773;Taip;0;7;0;7
19588;"Vilniaus Trakų Vokės gimnazija";"Priešmokyklinė 2";66085180057;Ne;0;6;0;6
19589;"Vilniaus Trakų Vokės gimnazija";"Priešmokyklinė 2";4362066941;Taip;0;0;3;3
19590;"Vilniaus Trakų Vokės gimnazija";"Priešmokyklinė 2";1074730366;Ne;0;10;1;11
19591;"Vilniaus Trakų Vokės gimnazija";"Priešmokyklinė 2";4046440160;Taip;0;0;11;11
19592;"Vilniaus Trakų Vokės gimnazija";"Priešmokyklinė 2";50697040061;Taip;0;28;0;28
19593;"Vilniaus Trakų Vokės gimnazija";"Priešmokyklinė 2";1117304239;Taip;4;3;1;8
19594;"Vilniaus Trakų Vokės gimnazija";"Priešmokyklinė 2";44023296535;Taip;0;2;0;2
19595;"Vilniaus Trakų Vokės gimnazija";"Priešmokyklinė 2";26598573711;Taip;0;6;0;6
19596;"Vilniaus Trakų Vokės gimnazija";"Priešmokyklinė 2";6740592681;Ne;0;9;0;9
19597;"Vilniaus Trakų Vokės gimnazija";"Priešmokyklinė 2";1179402963;Taip;0;6;0;6
19598;"Vilniaus Trakų Vokės gimnazija";"Priešmokyklinė 2";15897808544;Taip;0;1;0;1
19599;"Vilniaus Trakų Vokės gimnazija";"Priešmokyklinė 2";6593654477;Taip;0;0;1;1
19600;"Vilniaus Trakų Vokės gimnazija";"Priešmokyklinė 2";9582511053;Taip;0;20;0;20
19601;"Vilniaus Trakų Vokės gimnazija";"Priešmokyklinė 2";1693185124;Taip;0;10;0;10
19602;"Vilniaus Trakų Vokės gimnazija";"Priešmokyklinė 2";9039274775;Taip;5;5;1;11
19603;"Vilniaus Trakų Vokės gimnazija";"Priešmokyklinė 2";4615315809;Taip;0;19;0;19
19604;"Vilniaus Trakų Vokės gimnazija";"Priešmokyklinė 2";25106446270;Taip;0;10;0;10
19605;"Vilniaus Trakų Vokės gimnazija";"Priešmokyklinė 2";9960520926;Ne;0;10;0;10
19606;"Vilniaus Ryto progimnazija";Pelėdžiukai;1434737480;Taip;1;0;2;3
19607;"Vilniaus Ryto progimnazija";Pelėdžiukai;1379827887;Taip;9;0;2;11
19608;"Vilniaus Ryto progimnazija";Pelėdžiukai;1010025777;Taip;0;0;7;7
19609;"Vilniaus Ryto progimnazija";Pelėdžiukai;2350690409;Taip;0;0;5;5
19610;"Vilniaus Ryto progimnazija";Pelėdžiukai;1208227740;Taip;0;6;0;6
19611;"Vilniaus Ryto progimnazija";Pelėdžiukai;1968892466;Taip;0;0;4;4
19612;"Vilniaus Ryto progimnazija";Pelėdžiukai;55848491611;Taip;0;0;6;6
19613;"Vilniaus Ryto progimnazija";Pelėdžiukai;1011101007;Ne;0;0;1;1
19614;"Vilniaus Ryto progimnazija";Pelėdžiukai;86601289023;Taip;13;0;0;13
19615;"Vilniaus Ryto progimnazija";Pelėdžiukai;6479758789;Taip;0;0;5;5
19616;"Vilniaus Ryto progimnazija";Pelėdžiukai;31669188580;Taip;0;0;4;4
19617;"Vilniaus Ryto progimnazija";Pelėdžiukai;24021665703;Taip;1;0;0;1
19618;"Vilniaus Ryto progimnazija";Pelėdžiukai;1959331544;Taip;0;0;3;3
19619;"Vilniaus Ryto progimnazija";Vyturiukai;24065109279;Taip;0;0;1;1
19620;"Vilniaus Ryto progimnazija";Vyturiukai;545765924;Taip;0;0;3;3
19621;"Vilniaus Ryto progimnazija";Vyturiukai;1295593408;Taip;0;0;5;5
19622;"Vilniaus Ryto progimnazija";Vyturiukai;1694848410;Taip;0;0;6;6
19623;"Vilniaus Ryto progimnazija";Vyturiukai;1311654913;Taip;0;1;0;1
19624;"Vilniaus Ryto progimnazija";Vyturiukai;96861425670;Ne;0;0;1;1
19625;"Vilniaus Ryto progimnazija";Vyturiukai;1472082682;Taip;0;0;3;3
19626;"Vilniaus Ryto progimnazija";Vyturiukai;15047814683;Taip;0;0;3;3
19627;"Vilniaus Salininkų gimnazija";"Priešmokyklinė A";1202154135;Taip;0;7;0;7
19628;"Vilniaus Salininkų gimnazija";"Priešmokyklinė A";1153455356;Taip;0;1;0;1
19629;"Vilniaus Salininkų gimnazija";"Priešmokyklinė A";95919160139;Taip;0;2;0;2
19630;"Vilniaus Salininkų gimnazija";"Priešmokyklinė A";1948988168;Taip;3;3;0;6
19631;"Vilniaus Salininkų gimnazija";"Priešmokyklinė A";20609963605;Taip;6;0;0;6
19632;"Vilniaus Salininkų gimnazija";"Priešmokyklinė A";1521333219;Taip;0;1;0;1
19633;"Vilniaus Salininkų gimnazija";"Priešmokyklinė A";23990693770;Taip;0;2;0;2
19634;"Vilniaus Salininkų gimnazija";"Priešmokyklinė A";58234889370;Taip;0;22;0;22
19635;"Vilniaus Salininkų gimnazija";"Priešmokyklinė A";1910467994;Taip;0;5;0;5
19636;"Vilniaus Salininkų gimnazija";"Priešmokyklinė A";9074440999;Taip;1;2;0;3
19637;"Vilniaus Salininkų gimnazija";"Priešmokyklinė A";51756630728;Taip;0;2;0;2
19638;"Vilniaus Salininkų gimnazija";"Priešmokyklinė A";6830115988;Taip;5;4;0;9
19639;"Vilniaus Salininkų gimnazija";"Priešmokyklinė A";2415539904;Ne;0;0;1;1
19640;"Vilniaus Salininkų gimnazija";"Priešmokyklinė A";7537900082;Taip;0;22;0;22
19641;"Vilniaus Salininkų gimnazija";"Priešmokyklinė A";5434294777;Taip;0;1;0;1
19642;"Vilniaus Salininkų gimnazija";"Priešmokyklinė A";29341671329;Taip;0;2;0;2
19643;"Vilniaus Salininkų gimnazija";"Priešmokyklinė A";45194646218;Taip;0;5;0;5
19644;"Vilniaus Salininkų gimnazija";"Priešmokyklinė A";1918440067;Taip;0;3;0;3
19645;"Vilniaus Salininkų gimnazija";"Priešmokyklinė A";1963139815;Taip;0;1;0;1
19646;"Vilniaus Salininkų gimnazija";"Priešmokyklinė A";81888649482;Taip;0;1;0;1
19647;"Vilniaus Salininkų gimnazija";"Priešmokyklinė A";2062813004;Taip;0;4;0;4
19648;"Vilniaus Salininkų gimnazija";"PRIEŠMOKYKLINĖ B";2171462527;Taip;3;0;0;3
19649;"Vilniaus Salininkų gimnazija";"PRIEŠMOKYKLINĖ B";2031724954;Taip;1;1;0;2
19650;"Vilniaus Salininkų gimnazija";"PRIEŠMOKYKLINĖ B";52499970010;Taip;5;4;0;9
19651;"Vilniaus Salininkų gimnazija";"PRIEŠMOKYKLINĖ B";1439852031;Taip;4;6;0;10
19652;"Vilniaus Salininkų gimnazija";"PRIEŠMOKYKLINĖ B";1868857584;Taip;2;0;0;2
19653;"Vilniaus Salininkų gimnazija";"PRIEŠMOKYKLINĖ B";14626363996;Taip;0;22;0;22
19654;"Vilniaus Salininkų gimnazija";"PRIEŠMOKYKLINĖ B";1470744233;Taip;6;2;0;8
19655;"Vilniaus Salininkų gimnazija";"PRIEŠMOKYKLINĖ B";1815368137;Taip;5;0;0;5
19656;"Vilniaus Salininkų gimnazija";"PRIEŠMOKYKLINĖ B";1699958696;Ne;2;2;0;4
19657;"Vilniaus Salininkų gimnazija";"PRIEŠMOKYKLINĖ B";65190372194;Taip;9;0;0;9
19658;"Vilniaus Salininkų gimnazija";"PRIEŠMOKYKLINĖ B";15199054558;Ne;3;6;0;9
19659;"Vilniaus Salininkų gimnazija";"PRIEŠMOKYKLINĖ B";86019335524;Taip;2;0;0;2
19660;"Vilniaus Salininkų gimnazija";"PRIEŠMOKYKLINĖ B";52194170807;Taip;2;0;0;2
19661;"Vilniaus Salininkų gimnazija";"PRIEŠMOKYKLINĖ B";5301130718;Taip;7;0;0;7
19662;"Vilniaus Salininkų gimnazija";"PRIEŠMOKYKLINĖ B";67593920224;Taip;0;4;0;4
19663;"Vilniaus Salininkų gimnazija";"PRIEŠMOKYKLINĖ B";25941514634;Taip;4;0;0;4
19664;"Vilniaus Salininkų gimnazija";"PRIEŠMOKYKLINĖ B";7296677745;Taip;5;0;0;5
19665;"Vilniaus Salininkų gimnazija";"PRIEŠMOKYKLINĖ B";6125334614;Taip;2;0;0;2
19666;"Vilniaus „Spindulio“ progimnazija";PM3;4460061333;Ne;3;0;0;3
19667;"Vilniaus „Spindulio“ progimnazija";PM3;3769217717;Ne;3;0;0;3
19668;"Vilniaus „Spindulio“ progimnazija";PM3;9168812609;Taip;0;0;1;1
19669;"Vilniaus „Spindulio“ progimnazija";PM3;29225108934;Taip;0;0;2;2
19670;"Vilniaus „Spindulio“ progimnazija";PM3;33133728999;Ne;0;22;0;22
19671;"Vilniaus „Spindulio“ progimnazija";PM3;1336592238;Taip;0;3;3;6
19672;"Vilniaus „Spindulio“ progimnazija";PM3;4569691896;Taip;2;2;0;4
19673;"Vilniaus „Spindulio“ progimnazija";PM3;12287981032;Taip;3;1;0;4
19674;"Vilniaus „Spindulio“ progimnazija";PM3;18592085188;Taip;0;2;0;2
19675;"Vilniaus „Spindulio“ progimnazija";PM3;92286460424;Taip;0;5;0;5
19676;"Vilniaus „Spindulio“ progimnazija";PM3;17266052771;Taip;5;3;0;8
19677;"Vilniaus „Spindulio“ progimnazija";PM3;1036752305;Taip;0;22;0;22
19678;"Vilniaus „Spindulio“ progimnazija";PM3;61158254770;Taip;0;8;0;8
19679;"Vilniaus „Spindulio“ progimnazija";PM3;34706967888;Taip;0;22;0;22
19680;"Vilniaus „Spindulio“ progimnazija";PM3;97014601220;Taip;0;1;0;1
19681;"Vilniaus „Spindulio“ progimnazija";PM2;5495813195;Taip;8;0;0;8
19682;"Vilniaus „Spindulio“ progimnazija";PM2;1498120150;Taip;0;2;0;2
19683;"Vilniaus „Spindulio“ progimnazija";PM2;2993704795;Taip;0;2;1;3
19684;"Vilniaus „Spindulio“ progimnazija";PM2;16785309188;Taip;0;5;0;5
19685;"Vilniaus „Spindulio“ progimnazija";PM2;1613911039;Taip;0;1;0;1
19686;"Vilniaus „Spindulio“ progimnazija";PM2;1301231548;Taip;0;1;0;1
19687;"Vilniaus „Spindulio“ progimnazija";PM2;60150682872;Taip;0;8;0;8
19688;"Vilniaus „Spindulio“ progimnazija";PM2;2009324145;Taip;0;1;0;1
19689;"Vilniaus „Spindulio“ progimnazija";PM2;98742243823;Taip;0;0;2;2
19690;"Vilniaus „Spindulio“ progimnazija";PM2;94713648240;Taip;0;13;0;13
19691;"Vilniaus „Spindulio“ progimnazija";PM2;2096874518;Taip;0;2;2;4
19692;"Vilniaus „Spindulio“ progimnazija";PM2;1269734734;Taip;0;2;0;2
19693;"Vilniaus „Spindulio“ progimnazija";PM2;4142864015;Taip;0;4;0;4
19694;"Vilniaus „Spindulio“ progimnazija";PM2;65798709244;Taip;0;3;0;3
19695;"Vilniaus „Spindulio“ progimnazija";PM1;2402524470;Taip;0;6;0;6
19696;"Vilniaus „Spindulio“ progimnazija";PM1;3225662051;Taip;0;0;1;1
19697;"Vilniaus „Spindulio“ progimnazija";PM1;7452656662;Taip;0;0;1;1
19698;"Vilniaus „Spindulio“ progimnazija";PM1;1703266825;Taip;0;0;1;1
19699;"Vilniaus „Spindulio“ progimnazija";PM1;1767369189;Taip;5;1;0;6
19700;"Vilniaus „Spindulio“ progimnazija";PM1;1939499375;Taip;4;1;0;5
19701;"Vilniaus „Spindulio“ progimnazija";PM1;27140729689;Taip;2;0;1;3
19702;"Vilniaus „Spindulio“ progimnazija";PM1;1479759021;Taip;5;2;0;7
19703;"Vilniaus „Spindulio“ progimnazija";PM1;57676205527;Taip;0;0;1;1
19704;"Vilniaus „Spindulio“ progimnazija";PM1;1988406276;Taip;0;8;0;8
19705;"Vilniaus „Spindulio“ progimnazija";PM1;4365489653;Taip;4;0;1;5
19706;"Vilniaus „Spindulio“ progimnazija";PM1;2060067625;Ne;0;0;1;1
19707;"Vilniaus „Spindulio“ progimnazija";PM1;2049079012;Taip;2;9;0;11
19708;"Vilniaus „Spindulio“ progimnazija";PM1;4405301567;Taip;0;0;3;3
19709;"Vilniaus „Spindulio“ progimnazija";PM1;1839723500;Ne;0;0;6;6
19710;"Vilniaus Vladislavo Sirokomlės gimnazija";Nykštukai;19782508652;Taip;0;1;1;2
19711;"Vilniaus Vladislavo Sirokomlės gimnazija";Nykštukai;5282211767;Taip;0;2;0;2
19712;"Vilniaus Vladislavo Sirokomlės gimnazija";Nykštukai;9380332489;Taip;0;1;0;1
19713;"Vilniaus Vladislavo Sirokomlės gimnazija";Nykštukai;2112394008;Taip;5;0;0;5
19714;"Vilniaus Vladislavo Sirokomlės gimnazija";Nykštukai;30180586342;Taip;0;1;4;5
19715;"Vilniaus Vladislavo Sirokomlės gimnazija";Nykštukai;2686950289;Taip;4;1;0;5
19716;"Vilniaus Vladislavo Sirokomlės gimnazija";Nykštukai;2504312724;Taip;0;1;1;2
19717;"Vilniaus Vladislavo Sirokomlės gimnazija";Nykštukai;19486911273;Taip;0;1;0;1
19718;"Vilniaus Vladislavo Sirokomlės gimnazija";Nykštukai;1077526046;Taip;0;1;1;2
19719;"Vilniaus Vladislavo Sirokomlės gimnazija";Nykštukai;71806077882;Taip;0;3;0;3
19720;"Vilniaus Vladislavo Sirokomlės gimnazija";Nykštukai;5005090378;Ne;0;1;1;2
19721;"Vilniaus Vladislavo Sirokomlės gimnazija";Smurfai;7982806747;Ne;0;2;0;2
19722;"Vilniaus Vladislavo Sirokomlės gimnazija";Smurfai;74475070018;Taip;0;7;0;7
19723;"Vilniaus Vladislavo Sirokomlės gimnazija";Smurfai;1012658900;Taip;1;8;0;9
19724;"Vilniaus Vladislavo Sirokomlės gimnazija";Smurfai;1398564881;Ne;5;0;0;5
19725;"Vilniaus Vladislavo Sirokomlės gimnazija";Smurfai;8226921630;Taip;8;1;0;9
19726;"Vilniaus Vladislavo Sirokomlės gimnazija";Smurfai;1801724527;Taip;0;3;0;3
19727;"Vilniaus Vladislavo Sirokomlės gimnazija";Smurfai;5633883897;Taip;0;2;0;2
19728;"Vilniaus Vladislavo Sirokomlės gimnazija";Smurfai;7956620111;Taip;0;22;0;22
19729;"Vilniaus Vladislavo Sirokomlės gimnazija";Smurfai;198112701;Taip;0;5;0;5
19730;"Vilniaus Vladislavo Sirokomlės gimnazija";Smurfai;3859776410;Taip;0;2;0;2
19731;"Vilniaus Vladislavo Sirokomlės gimnazija";Smurfai;8995997848;Taip;0;22;0;22
19732;"Vilniaus Vladislavo Sirokomlės gimnazija";Smurfai;5544613599;Taip;7;3;0;10
19733;"Vilniaus Vladislavo Sirokomlės gimnazija";Smurfai;25415760747;Taip;3;2;0;5
19734;"Vilniaus Vladislavo Sirokomlės gimnazija";Smurfai;2219712757;Taip;0;2;0;2
19735;"Vilniaus „Pelėdos” pradinė mokykla";Bitutės;55089909579;Taip;0;1;4;5
19736;"Vilniaus „Pelėdos” pradinė mokykla";Bitutės;8742157840;Taip;0;1;4;5
19737;"Vilniaus „Pelėdos” pradinė mokykla";Bitutės;1181972027;Taip;14;0;2;16
19738;"Vilniaus „Pelėdos” pradinė mokykla";Bitutės;1555183700;Taip;0;1;2;3
19739;"Vilniaus „Pelėdos” pradinė mokykla";Bitutės;1785794727;Taip;0;0;3;3
19740;"Vilniaus „Pelėdos” pradinė mokykla";Bitutės;1585956968;Taip;0;0;6;6
19741;"Vilniaus „Pelėdos” pradinė mokykla";Bitutės;1405642653;Taip;0;0;5;5
19742;"Vilniaus „Pelėdos” pradinė mokykla";Bitutės;59176678396;Taip;0;1;0;1
19743;"Vilniaus „Pelėdos” pradinė mokykla";Bitutės;35192728896;Taip;0;1;0;1
19744;"Vilniaus „Pelėdos” pradinė mokykla";Bitutės;55151392377;Taip;0;0;2;2
19745;"Vilniaus „Pelėdos” pradinė mokykla";Bitutės;1844038414;Taip;0;1;5;6
19746;"Vilniaus „Pelėdos” pradinė mokykla";Bitutės;7207507008;Taip;0;1;0;1
19747;"Vilniaus „Pelėdos” pradinė mokykla";Boružėlės;68853730495;Taip;0;1;1;2
19748;"Vilniaus „Pelėdos” pradinė mokykla";Boružėlės;30823793919;Taip;8;0;0;8
19749;"Vilniaus „Pelėdos” pradinė mokykla";Boružėlės;13774489893;Taip;0;0;1;1
19750;"Vilniaus „Pelėdos” pradinė mokykla";Boružėlės;28543773229;Taip;0;1;0;1
19751;"Vilniaus „Pelėdos” pradinė mokykla";Boružėlės;57621616956;Taip;4;0;0;4
19752;"Vilniaus „Pelėdos” pradinė mokykla";Boružėlės;4569794380;Taip;17;5;0;22
19753;"Vilniaus „Pelėdos” pradinė mokykla";Boružėlės;80827159258;Taip;4;0;0;4
19754;"Vilniaus „Pelėdos” pradinė mokykla";Boružėlės;12741015006;Taip;0;0;1;1
19755;"Vilniaus „Pelėdos” pradinė mokykla";Boružėlės;61301662234;Taip;8;0;0;8
19756;"Vilniaus „Pelėdos” pradinė mokykla";Boružėlės;2027779101;Taip;5;0;4;9
19757;"Vilniaus „Pelėdos” pradinė mokykla";Boružėlės;1976450069;Taip;0;0;1;1
19758;"Vilniaus „Pelėdos” pradinė mokykla";Boružėlės;5199005933;Taip;0;1;1;2
19759;"Vilniaus „Pelėdos” pradinė mokykla";Boružėlės;6268022925;Taip;0;0;5;5
19760;"Vilniaus „Pelėdos” pradinė mokykla";Boružėlės;53603222817;Taip;5;0;0;5
19761;"Vilniaus „Pelėdos” pradinė mokykla";Boružėlės;1504818113;Taip;0;0;2;2
19762;"Vilniaus „Pelėdos” pradinė mokykla";Boružėlės;90692179185;Taip;0;0;4;4
19763;"Vilniaus „Pelėdos” pradinė mokykla";Boružėlės;3680292393;Ne;0;0;4;4
19764;"Vilniaus Joachimo Lelevelio inžinerijos mokykla";0A;27082059521;Taip;6;0;2;8
19765;"Vilniaus Joachimo Lelevelio inžinerijos mokykla";0A;9967553882;Taip;1;1;0;2
19766;"Vilniaus Joachimo Lelevelio inžinerijos mokykla";0A;70188972463;Taip;0;0;2;2
19767;"Vilniaus Joachimo Lelevelio inžinerijos mokykla";0A;4101387438;Taip;0;0;1;1
19768;"Vilniaus Joachimo Lelevelio inžinerijos mokykla";0A;47825918748;Taip;0;22;0;22
19769;"Vilniaus Joachimo Lelevelio inžinerijos mokykla";0A;18542160352;Taip;0;1;0;1
19770;"Vilniaus Joachimo Lelevelio inžinerijos mokykla";0A;98526928421;Taip;0;0;2;2
19771;"Vilniaus Joachimo Lelevelio inžinerijos mokykla";0A;2059267616;Taip;3;0;1;4
19772;"Vilniaus Joachimo Lelevelio inžinerijos mokykla";0A;3842907348;Taip;0;22;0;22
19773;"Vilniaus Joachimo Lelevelio inžinerijos mokykla";0A;1771141306;Taip;0;6;0;6
19774;"Vilniaus Joachimo Lelevelio inžinerijos mokykla";0B;2711819539;Taip;2;2;2;6
19775;"Vilniaus Joachimo Lelevelio inžinerijos mokykla";0B;2169729414;Taip;0;6;0;6
19776;"Vilniaus Joachimo Lelevelio inžinerijos mokykla";0B;1049699735;Taip;0;4;0;4
19777;"Vilniaus Joachimo Lelevelio inžinerijos mokykla";0B;32583177093;Taip;0;2;0;2
19778;"Vilniaus Joachimo Lelevelio inžinerijos mokykla";0B;6713783853;Taip;2;0;1;3
19779;"Vilniaus Joachimo Lelevelio inžinerijos mokykla";0B;2492364016;Taip;3;2;5;10
19780;"Vilniaus Joachimo Lelevelio inžinerijos mokykla";0B;1367704050;Taip;3;0;3;6
19781;"Vilniaus Joachimo Lelevelio inžinerijos mokykla";0B;2118500745;Taip;0;1;0;1
19782;"Vilniaus Joachimo Lelevelio inžinerijos mokykla";0B;2072018782;Taip;0;4;0;4
19783;"Vilniaus Joachimo Lelevelio inžinerijos mokykla";0B;1378845384;Taip;0;6;0;6
19784;"Vilniaus Joachimo Lelevelio inžinerijos mokykla";0B;2760501432;Ne;0;0;11;11
19785;"Vilniaus Joachimo Lelevelio inžinerijos mokykla";0B;69883785412;Ne;1;0;0;1
19786;"Vilniaus Joachimo Lelevelio inžinerijos mokykla";0B;1409708149;Taip;0;2;3;5
19787;"Vilniaus Joachimo Lelevelio inžinerijos mokykla";0B;8552721960;Taip;3;2;0;5
19788;"Vilniaus Joachimo Lelevelio inžinerijos mokykla";0B;1477555365;Taip;0;7;0;7
19789;"Vilniaus Juzefo Ignacijaus Kraševskio gimnazija";Priešmokyklinė;1963122314;Taip;4;4;0;8
19790;"Vilniaus Juzefo Ignacijaus Kraševskio gimnazija";Priešmokyklinė;9167719015;Ne;4;0;3;7
19791;"Vilniaus Juzefo Ignacijaus Kraševskio gimnazija";Priešmokyklinė;6560740320;Taip;0;1;0;1
19792;"Vilniaus Juzefo Ignacijaus Kraševskio gimnazija";Priešmokyklinė;6224053661;Taip;0;7;0;7
19793;"Vilniaus Juzefo Ignacijaus Kraševskio gimnazija";Priešmokyklinė;3738703854;Taip;0;4;0;4
19794;"Vilniaus Juzefo Ignacijaus Kraševskio gimnazija";Priešmokyklinė;1812071213;Taip;3;0;3;6
19795;"Vilniaus Juzefo Ignacijaus Kraševskio gimnazija";Priešmokyklinė;4747481676;Taip;0;3;0;3
19796;"Vilniaus Juzefo Ignacijaus Kraševskio gimnazija";Priešmokyklinė;83027842354;Taip;8;0;0;8
19797;"Vilniaus Juzefo Ignacijaus Kraševskio gimnazija";Priešmokyklinė;1459614385;Taip;0;0;1;1
19798;"Vilniaus Juzefo Ignacijaus Kraševskio gimnazija";Priešmokyklinė;6887858560;Ne;0;0;5;5
19799;"Vilniaus Juzefo Ignacijaus Kraševskio gimnazija";Priešmokyklinė;8323242104;Taip;0;3;0;3
19800;"Vilniaus Juzefo Ignacijaus Kraševskio gimnazija";Priešmokyklinė;2201538495;Taip;21;0;0;21
19801;"Vilniaus Juzefo Ignacijaus Kraševskio gimnazija";Priešmokyklinė;9114472645;Ne;8;1;0;9
19802;"Vilniaus Juzefo Ignacijaus Kraševskio gimnazija";Priešmokyklinė;5261769707;Taip;11;0;0;11
19803;"Vilniaus Juzefo Ignacijaus Kraševskio gimnazija";Priešmokyklinė;9685152753;Taip;0;0;3;3
19804;"Vilniaus Juzefo Ignacijaus Kraševskio gimnazija";Priešmokyklinė;1993899235;Ne;0;0;3;3
19805;"Vilniaus Juzefo Ignacijaus Kraševskio gimnazija";Priešmokyklinė;5255617339;Ne;0;0;5;5
19806;"Vilniaus Jono Pauliaus II progimnazija";Nykštukai;43342043904;Taip;0;22;0;22
19807;"Vilniaus Jono Pauliaus II progimnazija";Nykštukai;8802891670;Taip;0;22;0;22
19808;"Vilniaus Jono Pauliaus II progimnazija";Nykštukai;6953225656;Taip;7;1;0;8
19809;"Vilniaus Jono Pauliaus II progimnazija";Nykštukai;20492762368;Taip;0;22;0;22
19810;"Vilniaus Jono Pauliaus II progimnazija";Nykštukai;30508998297;Taip;0;7;0;7
19811;"Vilniaus Jono Pauliaus II progimnazija";Nykštukai;5392514118;Taip;5;1;1;7
19812;"Vilniaus Jono Pauliaus II progimnazija";Nykštukai;64628040227;Taip;0;2;0;2
19813;"Vilniaus Jono Pauliaus II progimnazija";Nykštukai;1223627682;Taip;0;3;0;3
19814;"Vilniaus Jono Pauliaus II progimnazija";Nykštukai;3797894882;Taip;0;7;0;7
19815;"Vilniaus Jono Pauliaus II progimnazija";Nykštukai;8226906949;Taip;0;3;0;3
19816;"Vilniaus Jono Pauliaus II progimnazija";Nykštukai;9383951600;Ne;0;22;0;22
19817;"Vilniaus Jono Pauliaus II progimnazija";Nykštukai;4813881161;Ne;0;1;0;1
19818;"Vilniaus Jono Pauliaus II progimnazija";Nykštukai;3126726854;Taip;0;4;0;4
19819;"Vilniaus Jono Pauliaus II progimnazija";Nykštukai;1661768112;Taip;2;2;0;4
19820;"Vilniaus Jono Pauliaus II progimnazija";Nykštukai;5207473829;Taip;2;1;0;3
19821;"Vilniaus Jono Pauliaus II progimnazija";Nykštukai;8172222365;Taip;0;9;0;9
19822;"Vilniaus Jono Pauliaus II progimnazija";Nykštukai;22865699640;Taip;0;1;0;1
19823;"Vilniaus Jono Pauliaus II progimnazija";Nykštukai;1931763128;Taip;7;0;0;7
19824;"Vilniaus Jono Pauliaus II progimnazija";Nykštukai;48118825872;Taip;0;3;0;3
19825;"Vilniaus Jono Pauliaus II progimnazija";Nykštukai;2037477873;Taip;0;1;0;1
19826;"Vilniaus Jono Pauliaus II progimnazija";Nykštukai;1008705526;Taip;0;1;0;1
19827;"Vilniaus Jono Pauliaus II progimnazija";Nykštukai;2597864783;Taip;1;1;0;2
19828;"Vilniaus Jono Pauliaus II progimnazija";Nykštukai;96010737590;Taip;0;5;0;5
19829;"Vilniaus Jono Pauliaus II progimnazija";Nykštukai;6299191475;Taip;0;3;0;3
19830;"Vilniaus Jono Pauliaus II progimnazija";Žiniukai;11343969028;Taip;0;1;0;1
19831;"Vilniaus Jono Pauliaus II progimnazija";Žiniukai;76758476679;Taip;0;22;0;22
19832;"Vilniaus Jono Pauliaus II progimnazija";Žiniukai;1239744245;Taip;0;1;0;1
19833;"Vilniaus Jono Pauliaus II progimnazija";Žiniukai;1408704528;Taip;0;1;0;1
19834;"Vilniaus Jono Pauliaus II progimnazija";Žiniukai;65208134706;Taip;4;1;0;5
19835;"Vilniaus Jono Pauliaus II progimnazija";Žiniukai;1251348150;Taip;0;5;0;5
19836;"Vilniaus Jono Pauliaus II progimnazija";Žiniukai;1256879956;Taip;0;10;0;10
19837;"Vilniaus Jono Pauliaus II progimnazija";Žiniukai;4416064304;Taip;0;1;0;1
19838;"Vilniaus Jono Pauliaus II progimnazija";Žiniukai;1659390234;Taip;0;1;0;1
19839;"Vilniaus Jono Pauliaus II progimnazija";Žiniukai;4786380413;Taip;0;22;0;22
19840;"Vilniaus Jono Pauliaus II progimnazija";Žiniukai;1206774772;Ne;0;22;0;22
19841;"Vilniaus Jono Pauliaus II progimnazija";Žiniukai;1287020629;Taip;1;1;1;3
19842;"Vilniaus Jono Pauliaus II progimnazija";Žiniukai;74190923349;Taip;0;5;0;5
19843;"Vilniaus Jono Pauliaus II progimnazija";Žiniukai;4541308000;Ne;7;1;5;13
19844;"Vilniaus Jono Pauliaus II progimnazija";Žiniukai;40386182073;Taip;11;1;0;12
19845;"Vilniaus Jono Pauliaus II progimnazija";Žiniukai;1750552925;Taip;0;1;0;1
19846;"Vilniaus Jono Pauliaus II progimnazija";Žiniukai;1393351147;Taip;0;4;0;4
19847;"Vilniaus Jono Pauliaus II progimnazija";Žiniukai;1029009937;Taip;0;1;1;2
19848;"Vilniaus Jono Pauliaus II progimnazija";Žiniukai;6958822972;Taip;0;1;0;1
19849;"Vilniaus Jono Pauliaus II progimnazija";Žiniukai;26468121179;Taip;0;0;3;3
19850;"Vilniaus Jono Pauliaus II progimnazija";Žiniukai;1588070786;Ne;3;1;0;4
19851;"Vilniaus Jono Pauliaus II progimnazija";Spindulėlis;1927141701;Taip;6;2;0;8
19852;"Vilniaus Jono Pauliaus II progimnazija";Spindulėlis;81796510706;Taip;0;1;1;2
19853;"Vilniaus Jono Pauliaus II progimnazija";Spindulėlis;27495253866;Taip;3;3;3;9
19854;"Vilniaus Jono Pauliaus II progimnazija";Spindulėlis;9428634658;Taip;0;1;2;3
19855;"Vilniaus Jono Pauliaus II progimnazija";Spindulėlis;8127562502;Taip;6;2;0;8
19856;"Vilniaus Jono Pauliaus II progimnazija";Spindulėlis;2022412040;Taip;1;1;0;2
19857;"Vilniaus Jono Pauliaus II progimnazija";Spindulėlis;6775770656;Taip;5;2;1;8
19858;"Vilniaus Jono Pauliaus II progimnazija";Spindulėlis;5729812682;Taip;0;1;0;1
19859;"Vilniaus Jono Pauliaus II progimnazija";Spindulėlis;5098282548;Taip;9;0;2;11
19860;"Vilniaus Jono Pauliaus II progimnazija";Spindulėlis;27084497916;Taip;0;1;0;1
19861;"Vilniaus Jono Pauliaus II progimnazija";Spindulėlis;8182873487;Taip;0;2;0;2
19862;"Vilniaus Jono Pauliaus II progimnazija";Spindulėlis;1343667707;Taip;6;1;1;8
19863;"Vilniaus Jono Pauliaus II progimnazija";Spindulėlis;1184543607;Taip;6;0;2;8
19864;"Vilniaus Jono Pauliaus II progimnazija";Spindulėlis;2043278242;Taip;0;1;0;1
19865;"Vilniaus Jono Pauliaus II progimnazija";Spindulėlis;89943712210;Taip;1;1;1;3
19866;"Vilniaus Jono Pauliaus II progimnazija";Spindulėlis;3356127625;Taip;1;1;1;3
19867;"Vilniaus Jono Pauliaus II progimnazija";Spindulėlis;2069277030;Taip;0;1;0;1
19868;"Vilniaus Jono Pauliaus II progimnazija";Spindulėlis;1996032555;Taip;0;4;0;4
19869;"Vilniaus Jono Pauliaus II progimnazija";Spindulėlis;2212814026;Taip;0;1;0;1
19870;"Vilniaus Jono Pauliaus II progimnazija";Spindulėlis;78516912418;Taip;5;3;0;8
19871;"Vilniaus Jono Pauliaus II progimnazija";Spindulėlis;30244366906;Taip;0;2;0;2
19872;"Vilniaus Jono Pauliaus II progimnazija";Spindulėlis;1206863546;Taip;0;1;0;1
19873;Gluosnis;KIŠKUČIAI;4591550636;Taip;0;10;2;12
19874;Gluosnis;KIŠKUČIAI;6955695422;Taip;0;8;0;8
19875;Gluosnis;KIŠKUČIAI;6140294839;Taip;9;0;1;10
19876;Gluosnis;KIŠKUČIAI;1305651237;Taip;15;0;0;15
19877;Gluosnis;KIŠKUČIAI;4285562600;Taip;0;2;1;3
19878;Gluosnis;KIŠKUČIAI;5432102004;Taip;3;0;4;7
19879;Gluosnis;KIŠKUČIAI;8009719622;Taip;0;0;1;1
19880;Gluosnis;KIŠKUČIAI;9833971809;Taip;5;0;2;7
19881;Gluosnis;KIŠKUČIAI;6883663577;Taip;9;0;2;11
19882;Gluosnis;KIŠKUČIAI;1512855055;Taip;16;3;0;19
19883;Gluosnis;KIŠKUČIAI;8337313448;Taip;0;5;0;5
19884;Gluosnis;KIŠKUČIAI;4632419177;Taip;3;0;1;4
19885;Gluosnis;KIŠKUČIAI;6113153127;Taip;5;0;1;6
19886;Gluosnis;KIŠKUČIAI;7769522093;Taip;9;0;1;10
19887;Gluosnis;KIŠKUČIAI;8928597187;Taip;0;0;5;5
19888;Gluosnis;KIŠKUČIAI;9993638596;Taip;0;0;2;2
19889;Gluosnis;KIŠKUČIAI;9221983318;Taip;8;5;0;13
19890;Gluosnis;KIŠKUČIAI;5664156894;Taip;0;17;0;17
19891;Gluosnis;EŽIUKAI;4153713911;Taip;3;0;4;7
19892;Gluosnis;EŽIUKAI;1301904113;Taip;7;0;2;9
19893;Gluosnis;EŽIUKAI;5350702449;Taip;15;0;1;16
19894;Gluosnis;EŽIUKAI;6622415563;Taip;11;0;1;12
19895;Gluosnis;EŽIUKAI;3988305400;Taip;0;2;0;2
19896;Gluosnis;EŽIUKAI;9788278155;Taip;10;1;0;11
19897;Gluosnis;EŽIUKAI;7974944779;Taip;0;8;0;8
19898;Gluosnis;EŽIUKAI;7526020668;Taip;8;1;0;9
19899;Gluosnis;EŽIUKAI;5522411084;Taip;9;0;0;9
19900;Gluosnis;EŽIUKAI;5392759654;Taip;9;6;0;15
19901;Gluosnis;EŽIUKAI;6681653921;Taip;12;2;0;14
19902;Gluosnis;EŽIUKAI;4902627153;Taip;19;0;1;20
19903;Gluosnis;EŽIUKAI;2525780494;Taip;6;8;0;14
19904;Gluosnis;EŽIUKAI;9389736360;Taip;12;0;2;14
19905;Gluosnis;MEŠKIUKAI;4022182529;Taip;0;15;3;18
19906;Gluosnis;MEŠKIUKAI;8981904827;Taip;9;0;0;9
19907;Gluosnis;MEŠKIUKAI;8998776286;Taip;9;5;1;15
19908;Gluosnis;MEŠKIUKAI;1846499141;Taip;6;0;3;9
19909;Gluosnis;MEŠKIUKAI;7935750427;Taip;0;0;1;1
19910;Gluosnis;MEŠKIUKAI;9102081648;Taip;6;0;3;9
19911;Gluosnis;MEŠKIUKAI;4498429439;Taip;7;0;0;7
19912;Gluosnis;MEŠKIUKAI;6067801976;Taip;5;0;1;6
19913;Gluosnis;MEŠKIUKAI;8259160584;Taip;6;1;0;7
19914;Gluosnis;MEŠKIUKAI;1235091885;Taip;0;7;0;7
19915;Gluosnis;MEŠKIUKAI;1165636758;Taip;0;4;0;4
19916;Gluosnis;MEŠKIUKAI;8499748544;Taip;0;5;0;5
19917;Gluosnis;MEŠKIUKAI;9699577397;Taip;0;0;15;15
19918;Gluosnis;MEŠKIUKAI;1712795835;Taip;0;4;0;4
19919;Gluosnis;MEŠKIUKAI;4107344313;Ne;0;1;0;1
19920;Gluosnis;MEŠKIUKAI;7995558671;Taip;0;7;0;7
19921;Gluosnis;MEŠKIUKAI;1602556462;Taip;0;3;3;6
19922;Gluosnis;MEŠKIUKAI;6428753580;Taip;9;0;0;9
19923;Gluosnis;MEŠKIUKAI;3323237449;Taip;14;0;0;14
19924;Gluosnis;BORUŽĖLĖS;8840658383;Taip;0;2;0;2
19925;Gluosnis;BORUŽĖLĖS;1102935178;Ne;6;0;0;6
19926;Gluosnis;BORUŽĖLĖS;8328948120;Taip;0;10;0;10
19927;Gluosnis;BORUŽĖLĖS;2167312808;Taip;0;0;6;6
19928;Gluosnis;BORUŽĖLĖS;4204797742;Taip;4;0;0;4
19929;Gluosnis;BORUŽĖLĖS;6302765948;Taip;6;0;1;7
19930;Gluosnis;BORUŽĖLĖS;9938235476;Taip;0;15;1;16
19931;Gluosnis;BORUŽĖLĖS;2945796648;Taip;0;8;0;8
19932;Gluosnis;BORUŽĖLĖS;2173191971;Taip;0;8;0;8
19933;Gluosnis;BORUŽĖLĖS;4237053702;Taip;0;5;1;6
19934;Gluosnis;BORUŽĖLĖS;6320411660;Taip;0;1;0;1
19935;Gluosnis;BORUŽĖLĖS;7731887361;Taip;0;0;3;3
19936;Gluosnis;BORUŽĖLĖS;8502947568;Taip;0;0;5;5
19937;Gluosnis;BORUŽĖLĖS;9664090375;Taip;0;0;1;1
19938;Gluosnis;BORUŽĖLĖS;1335152703;Taip;8;5;0;13
19939;Gluosnis;BORUŽĖLĖS;1314992969;Taip;0;1;1;2
19940;Gluosnis;BORUŽĖLĖS;7833136455;Taip;5;0;0;5
19941;Gluosnis;BORUŽĖLĖS;5556821953;Taip;6;4;0;10
19942;Gluosnis;BORUŽĖLĖS;2515646510;Taip;0;0;3;3
19943;Gluosnis;BORUŽĖLĖS;3212658311;Taip;0;7;7;14
19944;Gluosnis;BORUŽĖLĖS;2603201633;Taip;12;0;2;14
19945;Gluosnis;BORUŽĖLĖS;6086258054;Taip;9;2;0;11
19946;Gluosnis;BORUŽĖLĖS;1351519995;Taip;8;2;0;10
19947;Gluosnis;LAPIUKAI;94487630173;Taip;0;1;0;1
19948;Gluosnis;LAPIUKAI;7445566160;Taip;0;0;14;14
19949;Gluosnis;LAPIUKAI;1933496033;Taip;4;0;0;4
19950;Gluosnis;LAPIUKAI;8259035822;Taip;0;9;0;9
19951;Gluosnis;LAPIUKAI;4960167173;Ne;0;0;1;1
19952;Gluosnis;LAPIUKAI;2181550091;Taip;0;8;0;8
19953;Gluosnis;LAPIUKAI;2810808007;Taip;9;1;0;10
19954;Gluosnis;LAPIUKAI;6163009686;Taip;4;4;0;8
19955;Gluosnis;LAPIUKAI;1671693932;Taip;0;0;3;3
19956;Gluosnis;LAPIUKAI;4005023841;Ne;3;0;8;11
19957;Gluosnis;LAPIUKAI;9497547057;Taip;5;0;1;6
19958;Gluosnis;LAPIUKAI;1298724775;Taip;0;1;0;1
19959;Gluosnis;LAPIUKAI;1185903576;Taip;0;0;3;3
19960;Gluosnis;LAPIUKAI;7842723958;Taip;0;7;0;7
19961;Gluosnis;LAPIUKAI;6865973084;Taip;0;5;1;6
19962;Gluosnis;PELĖDŽIUKAI;1739047746;Taip;4;0;0;4
19963;Gluosnis;PELĖDŽIUKAI;3840001741;Ne;0;0;6;6
19964;Gluosnis;PELĖDŽIUKAI;4856769984;Taip;0;0;11;11
19965;Gluosnis;PELĖDŽIUKAI;1944291082;Ne;13;0;1;14
19966;Gluosnis;PELĖDŽIUKAI;75777330223;Taip;0;10;0;10
19967;Gluosnis;PELĖDŽIUKAI;1319664504;Taip;0;0;10;10
19968;Gluosnis;PELĖDŽIUKAI;62170308628;Taip;0;0;1;1
19969;Gluosnis;PELĖDŽIUKAI;3107005229;Taip;4;0;0;4
19970;Gluosnis;PELĖDŽIUKAI;98818207299;Taip;0;5;0;5
19971;Gluosnis;PELĖDŽIUKAI;48170110340;Taip;0;0;2;2
19972;Gluosnis;PELĖDŽIUKAI;31133574731;Taip;0;10;2;12
19973;Gluosnis;PELĖDŽIUKAI;1244309058;Taip;8;0;0;8
19974;Gluosnis;PELĖDŽIUKAI;1730588815;Taip;0;0;1;1
19975;Gluosnis;PELĖDŽIUKAI;49606187547;Taip;0;0;5;5
19976;Gluosnis;PELĖDŽIUKAI;2050880681;Taip;0;0;2;2
19977;Gluosnis;PELĖDŽIUKAI;1630582747;Taip;5;0;0;5
19978;Gluosnis;PELĖDŽIUKAI;1147279898;Taip;22;0;0;22
19979;Gluosnis;VOVERIUKAI;7761376910;Taip;0;0;1;1
19980;Gluosnis;VOVERIUKAI;3434902234;Taip;0;0;10;10
19981;Gluosnis;VOVERIUKAI;6944918504;Taip;0;0;10;10
19982;Gluosnis;VOVERIUKAI;9379825678;Ne;6;0;0;6
19983;Gluosnis;VOVERIUKAI;1076538028;Taip;8;0;0;8
19984;Gluosnis;VOVERIUKAI;1787206205;Taip;0;1;0;1
19985;Gluosnis;VOVERIUKAI;5204445760;Taip;6;6;0;12
19986;Gluosnis;VOVERIUKAI;6001358241;Taip;10;0;2;12
19987;Gluosnis;VOVERIUKAI;5380755693;Taip;0;0;12;12
19988;Gluosnis;VOVERIUKAI;4966816780;Taip;0;0;5;5
19989;Gluosnis;DRUGELIAI;5949954525;Taip;0;0;2;2
19990;Gluosnis;DRUGELIAI;7537587118;Taip;10;0;3;13
19991;Gluosnis;DRUGELIAI;6478139233;Taip;0;0;3;3
19992;Gluosnis;DRUGELIAI;1716235604;Taip;4;6;0;10
19993;Gluosnis;DRUGELIAI;8430102757;Taip;7;0;0;7
19994;Gluosnis;DRUGELIAI;4125830926;Taip;0;9;1;10
19995;Gluosnis;DRUGELIAI;6358187113;Taip;0;7;1;8
19996;Gluosnis;DRUGELIAI;2260938817;Taip;0;0;1;1
19997;Gluosnis;DRUGELIAI;9084785666;Taip;12;0;4;16
19998;Gluosnis;DRUGELIAI;4940563623;Taip;8;0;0;8
19999;Gluosnis;DRUGELIAI;1113731535;Taip;0;4;0;4
20000;Gluosnis;DRUGELIAI;4653963373;Taip;10;1;0;11
20001;Gluosnis;DRUGELIAI;2458662117;Taip;0;5;0;5
20002;Gluosnis;DRUGELIAI;4220504133;Taip;13;0;0;13
20003;Gluosnis;DRUGELIAI;9931766935;Taip;7;4;1;12
20004;Gluosnis;DRUGELIAI;3527418865;Taip;9;3;0;12
20005;Gluosnis;DRUGELIAI;6914171069;Taip;6;0;1;7
20006;Gluosnis;DRUGELIAI;1848647593;Taip;19;0;0;19
20007;Gluosnis;DRUGELIAI;5943955268;Taip;10;0;0;10
20008;Gluosnis;DRUGELIAI;8690911930;Taip;0;0;7;7
20009;Gluosnis;BITUTĖS;2554790908;Taip;6;0;0;6
20010;Gluosnis;BITUTĖS;8281499182;Taip;4;0;2;6
20011;Gluosnis;BITUTĖS;2403029153;Taip;4;1;0;5
20012;Gluosnis;BITUTĖS;6432475763;Taip;2;0;2;4
20013;Gluosnis;BITUTĖS;9542889575;Taip;0;2;0;2
20014;Gluosnis;BITUTĖS;1966484574;Taip;4;0;0;4
20015;Gluosnis;BITUTĖS;4353195155;Taip;6;7;0;13
20016;Gluosnis;BITUTĖS;5889360726;Taip;0;0;5;5
20017;Gluosnis;BITUTĖS;8035097045;Taip;0;0;9;9
20018;Gluosnis;BITUTĖS;3362089746;Taip;0;3;2;5
20019;Gluosnis;BITUTĖS;7390361159;Taip;4;0;5;9
20020;Gluosnis;BITUTĖS;8380310240;Taip;0;0;2;2
20021;Gluosnis;BITUTĖS;4481544177;Taip;0;0;7;7
20022;Gluosnis;BITUTĖS;2495616844;Taip;0;4;0;4
20023;Gluosnis;BITUTĖS;3673702157;Taip;3;5;1;9
20024;Gluosnis;BITUTĖS;9098141563;Taip;0;0;11;11
20025;Gluosnis;BITUTĖS;9201769624;Taip;0;0;1;1
20026;Gluosnis;BITUTĖS;1306381382;Taip;3;1;0;4
20027;Gluosnis;BITUTĖS;5329894543;Ne;5;0;1;6
20028;Gluosnis;BITUTĖS;6767500085;Taip;4;0;1;5
20029;"Vilniaus Saulėtekio mokykla-daugiafunkcinis centras";Priešmokyklinė;1350410221;Taip;0;0;1;1
20030;"Vilniaus Saulėtekio mokykla-daugiafunkcinis centras";Priešmokyklinė;1514160794;Taip;0;0;5;5
20031;"Vilniaus Saulėtekio mokykla-daugiafunkcinis centras";Priešmokyklinė;3200197276;Taip;0;0;8;8
20032;"Vilniaus Saulėtekio mokykla-daugiafunkcinis centras";Priešmokyklinė;9086988322;Taip;0;0;2;2
20033;"Vilniaus Saulėtekio mokykla-daugiafunkcinis centras";Priešmokyklinė;1071231078;Taip;0;0;11;11
20034;"Vilniaus Saulėtekio mokykla-daugiafunkcinis centras";Priešmokyklinė;1070487015;Taip;6;0;0;6
20035;"Vilniaus Saulėtekio mokykla-daugiafunkcinis centras";Priešmokyklinė;3644398178;Taip;6;0;0;6
20036;"Vilniaus Saulėtekio mokykla-daugiafunkcinis centras";Priešmokyklinė;21982990619;Taip;0;0;1;1
20037;"Vilniaus Saulėtekio mokykla-daugiafunkcinis centras";Priešmokyklinė;1558792099;Taip;6;0;0;6
20038;"Vilniaus Saulėtekio mokykla-daugiafunkcinis centras";Priešmokyklinė;9145974232;Taip;0;0;2;2
20039;"Vilniaus Saulėtekio mokykla-daugiafunkcinis centras";Priešmokyklinė;3406566321;Taip;0;0;5;5
20040;"Vilniaus Saulėtekio mokykla-daugiafunkcinis centras";Priešmokyklinė;1887788595;Ne;0;0;5;5
20041;"Vilniaus Saulėtekio mokykla-daugiafunkcinis centras";Priešmokyklinė;65268360807;Taip;0;0;5;5
20042;"Vilniaus Saulėtekio mokykla-daugiafunkcinis centras";Priešmokyklinė;1055737892;Taip;3;0;4;7
20043;"Vilniaus Saulėtekio mokykla-daugiafunkcinis centras";Priešmokyklinė;5980241303;Ne;0;0;6;6
20044;"Vilniaus Saulėtekio mokykla-daugiafunkcinis centras";Priešmokyklinė;1622097832;Ne;0;0;5;5
20045;"Vilniaus Saulėtekio mokykla-daugiafunkcinis centras";Priešmokyklinė;1038206495;Taip;10;0;7;17
20046;"Vilniaus Saulėtekio mokykla-daugiafunkcinis centras";Priešmokyklinė;87023919637;Taip;0;0;5;5
20047;"Vilniaus Saulėtekio mokykla-daugiafunkcinis centras";Priešmokyklinė;29012161897;Taip;0;0;19;19
20048;"Vilniaus Saulėtekio mokykla-daugiafunkcinis centras";"PRIEŠMOKYKLINĖ 2";2823248215;Taip;0;0;2;2
20049;"Vilniaus Saulėtekio mokykla-daugiafunkcinis centras";"PRIEŠMOKYKLINĖ 2";55197056543;Taip;0;0;2;2
20050;"Vilniaus Saulėtekio mokykla-daugiafunkcinis centras";"PRIEŠMOKYKLINĖ 2";38142737487;Taip;0;0;1;1
20051;"Vilniaus Saulėtekio mokykla-daugiafunkcinis centras";"PRIEŠMOKYKLINĖ 2";3779296366;Taip;0;3;0;3
20052;"Vilniaus Saulėtekio mokykla-daugiafunkcinis centras";"PRIEŠMOKYKLINĖ 2";1618813873;Taip;0;0;13;13
20053;"Vilniaus Saulėtekio mokykla-daugiafunkcinis centras";"PRIEŠMOKYKLINĖ 2";27625410128;Taip;0;5;0;5
20054;"Vilniaus Saulėtekio mokykla-daugiafunkcinis centras";"PRIEŠMOKYKLINĖ 2";9689230151;Taip;1;0;8;9
20055;"Vilniaus Saulėtekio mokykla-daugiafunkcinis centras";"PRIEŠMOKYKLINĖ 2";1537712920;Taip;0;0;4;4
20056;"Vilniaus Saulėtekio mokykla-daugiafunkcinis centras";"PRIEŠMOKYKLINĖ 2";3049862993;Taip;0;0;7;7
20057;"Vilniaus Saulėtekio mokykla-daugiafunkcinis centras";"PRIEŠMOKYKLINĖ 2";713862923;Taip;0;0;3;3
20058;"Vilniaus Saulėtekio mokykla-daugiafunkcinis centras";"PRIEŠMOKYKLINĖ 2";6161829923;Taip;0;9;0;9
20059;"Vilniaus Saulėtekio mokykla-daugiafunkcinis centras";"PRIEŠMOKYKLINĖ 2";78106313493;Taip;0;0;3;3
20060;"Vilniaus Saulėtekio mokykla-daugiafunkcinis centras";"PRIEŠMOKYKLINĖ 2";8873895533;Taip;0;0;4;4
20061;"Vilniaus Saulėtekio mokykla-daugiafunkcinis centras";"PRIEŠMOKYKLINĖ 2";9465331919;Taip;0;0;20;20
20062;"Vilniaus Saulėtekio mokykla-daugiafunkcinis centras";"PRIEŠMOKYKLINĖ 2";2267599637;Taip;4;0;2;6
20063;"Vilniaus Saulėtekio mokykla-daugiafunkcinis centras";"PRIEŠMOKYKLINĖ 2";1383759549;Taip;5;0;8;13
20064;"Vilniaus Saulėtekio mokykla-daugiafunkcinis centras";"PRIEŠMOKYKLINĖ 2";9391594216;Taip;3;12;0;15
20065;"Vilniaus Martyno Mažvydo progimnazija";PRIEŠMOKYKLINĖ;2970564576;Taip;0;3;3;6
20066;"Vilniaus Martyno Mažvydo progimnazija";PRIEŠMOKYKLINĖ;3220507716;Taip;0;3;0;3
20067;"Vilniaus Martyno Mažvydo progimnazija";PRIEŠMOKYKLINĖ;8122944228;Taip;9;0;2;11
20068;"Vilniaus Martyno Mažvydo progimnazija";PRIEŠMOKYKLINĖ;1755767517;Taip;1;4;0;5
20069;"Vilniaus Martyno Mažvydo progimnazija";PRIEŠMOKYKLINĖ;19429820228;Taip;4;0;3;7
20070;"Vilniaus Martyno Mažvydo progimnazija";PRIEŠMOKYKLINĖ;1487082744;Taip;0;1;0;1
20071;"Vilniaus Martyno Mažvydo progimnazija";PRIEŠMOKYKLINĖ;2044676215;Taip;0;0;5;5
20072;"Vilniaus Martyno Mažvydo progimnazija";PRIEŠMOKYKLINĖ;1915791061;Taip;0;5;0;5
20073;"Vilniaus Martyno Mažvydo progimnazija";PRIEŠMOKYKLINĖ;95743540902;Taip;4;0;1;5
20074;"Vilniaus Martyno Mažvydo progimnazija";PRIEŠMOKYKLINĖ;5347745655;Taip;0;9;0;9
20075;"Vilniaus Martyno Mažvydo progimnazija";PRIEŠMOKYKLINĖ;1814624149;Taip;8;1;6;15
20076;"Vilniaus Martyno Mažvydo progimnazija";PRIEŠMOKYKLINĖ;1674584707;Taip;0;0;4;4
20077;"Vilniaus Martyno Mažvydo progimnazija";PRIEŠMOKYKLINĖ;1392336985;Taip;0;0;2;2
20078;"Vilniaus Martyno Mažvydo progimnazija";PRIEŠMOKYKLINĖ;1409464952;Taip;0;1;1;2
20079;"Vilniaus Martyno Mažvydo progimnazija";PRIEŠMOKYKLINĖ;1835817116;Taip;5;8;1;14
20080;"Vilniaus Martyno Mažvydo progimnazija";PRIEŠMOKYKLINĖ;1536331721;Taip;3;0;3;6
20081;"Vilniaus Martyno Mažvydo progimnazija";PRIEŠMOKYKLINĖ;85274001355;Taip;9;0;0;9
20082;"Vilniaus Martyno Mažvydo progimnazija";PRIEŠMOKYKLINĖ;2831484614;Taip;0;0;1;1
20083;"Vilniaus Martyno Mažvydo progimnazija";PRIEŠMOKYKLINĖ;1573413882;Taip;0;0;4;4
20084;"Vilniaus Martyno Mažvydo progimnazija";PRIEŠMOKYKLINĖ;80818670065;Taip;0;2;4;6
20085;"Vilniaus Martyno Mažvydo progimnazija";PRIEŠMOKYKLINĖ;1986547624;Taip;0;0;7;7
20086;"Vilniaus „Genio“ progimnazija";Priešmokyklinė;97778827111;Taip;0;1;0;1
20087;"Vilniaus „Genio“ progimnazija";Priešmokyklinė;78048449266;Taip;0;5;0;5
20088;"Vilniaus „Genio“ progimnazija";Priešmokyklinė;1456577285;Taip;0;1;0;1
20089;"Vilniaus „Genio“ progimnazija";Priešmokyklinė;2102893949;Taip;0;18;0;18
20090;"Vilniaus „Genio“ progimnazija";Priešmokyklinė;1985052072;Taip;0;5;0;5
20091;"Vilniaus „Genio“ progimnazija";Priešmokyklinė;5272792732;Taip;0;0;4;4
20092;"Vilniaus „Genio“ progimnazija";Priešmokyklinė;1750123072;Taip;6;0;0;6
20093;"Vilniaus „Genio“ progimnazija";Priešmokyklinė;56474981516;Taip;7;0;0;7
20094;"Gintarėlis (Popieriaus g. 46A)";ŽIOGELIAI;7274616480;Taip;0;3;0;3
20095;"Gintarėlis (Popieriaus g. 46A)";ŽIOGELIAI;1362980885;Taip;0;3;0;3
20096;"Gintarėlis (Popieriaus g. 46A)";ŽIOGELIAI;2052962147;Taip;14;1;2;17
20097;"Gintarėlis (Popieriaus g. 46A)";ŽIOGELIAI;9762364250;Taip;5;2;0;7
20098;"Gintarėlis (Popieriaus g. 46A)";ŽIOGELIAI;1400817076;Taip;15;0;0;15
20099;"Gintarėlis (Popieriaus g. 46A)";ŽIOGELIAI;5190355636;Taip;4;0;0;4
20100;"Gintarėlis (Popieriaus g. 46A)";ŽIOGELIAI;6081634102;Taip;0;15;0;15
20101;"Gintarėlis (Popieriaus g. 46A)";ŽIOGELIAI;7400455090;Taip;0;4;0;4
20102;"Gintarėlis (Popieriaus g. 46A)";ŽIOGELIAI;7413074674;Taip;14;1;0;15
20103;"Gintarėlis (Popieriaus g. 46A)";ŽIOGELIAI;7031945895;Taip;13;0;0;13
20104;"Gintarėlis (Popieriaus g. 46A)";ŽIOGELIAI;7206593645;Ne;0;0;2;2
20105;"Gintarėlis (Popieriaus g. 46A)";ŽIOGELIAI;3702588434;Taip;10;6;0;16
20106;"Gintarėlis (Popieriaus g. 46A)";ŽIOGELIAI;6849227110;Taip;0;4;0;4
20107;"Gintarėlis (Popieriaus g. 46A)";ŽIOGELIAI;6821929306;Taip;0;12;0;12
20108;"Gintarėlis (Popieriaus g. 46A)";SKRUZDĖLIUKAI;6162836315;Taip;0;6;0;6
20109;"Gintarėlis (Popieriaus g. 46A)";SKRUZDĖLIUKAI;3825572125;Taip;5;4;0;9
20110;"Gintarėlis (Popieriaus g. 46A)";SKRUZDĖLIUKAI;5738933125;Taip;0;3;0;3
20111;"Gintarėlis (Popieriaus g. 46A)";SKRUZDĖLIUKAI;1994856959;Taip;0;1;0;1
20112;"Gintarėlis (Popieriaus g. 46A)";SKRUZDĖLIUKAI;8223747534;Taip;1;8;0;9
20113;"Gintarėlis (Popieriaus g. 46A)";SKRUZDĖLIUKAI;1045355492;Taip;7;2;0;9
20114;"Gintarėlis (Popieriaus g. 46A)";SKRUZDĖLIUKAI;6193540660;Taip;0;2;1;3
20115;"Gintarėlis (Popieriaus g. 46A)";SKRUZDĖLIUKAI;9153589128;Taip;19;0;0;19
20116;"Gintarėlis (Popieriaus g. 46A)";SKRUZDĖLIUKAI;3459439843;Taip;4;6;0;10
20117;"Gintarėlis (Popieriaus g. 46A)";SKRUZDĖLIUKAI;7916257692;Taip;8;1;0;9
20118;"Gintarėlis (Popieriaus g. 46A)";SKRUZDĖLIUKAI;7510541192;Taip;6;0;0;6
20119;"Gintarėlis (Popieriaus g. 46A)";SKRUZDĖLIUKAI;9045108717;Taip;0;10;0;10
20120;"Gintarėlis (Popieriaus g. 46A)";SKRUZDĖLIUKAI;9462019924;Taip;7;6;0;13
20121;"Gintarėlis (Popieriaus g. 46A)";SKRUZDĖLIUKAI;1955719034;Taip;0;2;0;2
20122;"Gintarėlis (Popieriaus g. 46A)";SKRUZDĖLIUKAI;1215549844;Taip;7;2;0;9
20123;"Gintarėlis (Popieriaus g. 46A)";SKRUZDĖLIUKAI;5379858630;Taip;0;0;11;11
20124;"Gintarėlis (Popieriaus g. 46A)";SKRUZDĖLIUKAI;8710469480;Taip;0;6;0;6
20125;"Gintarėlis (Popieriaus g. 46A)";SKRUZDĖLIUKAI;5961603860;Taip;5;2;0;7
20126;"Gintarėlis (Popieriaus g. 46A)";SKRUZDĖLIUKAI;8068499156;Taip;0;8;0;8
20127;"Gintarėlis (Popieriaus g. 46A)";PELĖDŽIUKAI;77906464117;Taip;4;2;0;6
20128;"Gintarėlis (Popieriaus g. 46A)";PELĖDŽIUKAI;6506180216;Taip;0;8;0;8
20129;"Gintarėlis (Popieriaus g. 46A)";PELĖDŽIUKAI;9200073539;Taip;6;2;0;8
20130;"Gintarėlis (Popieriaus g. 46A)";PELĖDŽIUKAI;3254739432;Taip;0;0;2;2
20131;"Gintarėlis (Popieriaus g. 46A)";PELĖDŽIUKAI;8019543081;Taip;0;4;0;4
20132;"Gintarėlis (Popieriaus g. 46A)";PELĖDŽIUKAI;1628276472;Taip;0;1;0;1
20133;"Gintarėlis (Popieriaus g. 46A)";PELĖDŽIUKAI;5223116373;Taip;5;2;0;7
20134;"Gintarėlis (Popieriaus g. 46A)";PELĖDŽIUKAI;8792175474;Taip;3;1;0;4
20135;"Gintarėlis (Popieriaus g. 46A)";PELĖDŽIUKAI;3304191482;Taip;0;2;2;4
20136;"Gintarėlis (Popieriaus g. 46A)";PELĖDŽIUKAI;8171192401;Taip;15;2;5;22
20137;"Gintarėlis (Popieriaus g. 46A)";PELĖDŽIUKAI;2731865977;Taip;7;2;0;9
20138;"Gintarėlis (Popieriaus g. 46A)";PELĖDŽIUKAI;4181430769;Taip;8;0;0;8
20139;"Gintarėlis (Popieriaus g. 46A)";PELĖDŽIUKAI;9257812097;Taip;0;6;0;6
20140;"Gintarėlis (Popieriaus g. 46A)";PELĖDŽIUKAI;3202819190;Taip;3;0;1;4
20141;"Gintarėlis (Popieriaus g. 46A)";PELĖDŽIUKAI;2737144359;Taip;5;2;0;7
20142;"Gintarėlis (Popieriaus g. 46A)";PELĖDŽIUKAI;9807784148;Taip;11;0;0;11
20143;"Gintarėlis (Popieriaus g. 46A)";PELĖDŽIUKAI;2546360134;Taip;4;2;0;6
20144;"Gintarėlis (Popieriaus g. 46A)";PELĖDŽIUKAI;2308673417;Taip;0;6;0;6
20145;"Gintarėlis (Popieriaus g. 46A)";PELĖDŽIUKAI;6883573289;Taip;3;2;1;6
20146;"Gintarėlis (Popieriaus g. 46A)";"LINKSMASIS AVILYS";19360482785;Taip;0;6;0;6
20147;"Gintarėlis (Popieriaus g. 46A)";"LINKSMASIS AVILYS";7872515649;Taip;0;6;0;6
20148;"Gintarėlis (Popieriaus g. 46A)";"LINKSMASIS AVILYS";7256557310;Taip;0;2;0;2
20149;"Gintarėlis (Popieriaus g. 46A)";"LINKSMASIS AVILYS";1321551506;Taip;7;0;0;7
20150;"Gintarėlis (Popieriaus g. 46A)";"LINKSMASIS AVILYS";4419831934;Taip;15;0;0;15
20151;"Gintarėlis (Popieriaus g. 46A)";"LINKSMASIS AVILYS";9840473841;Taip;0;3;0;3
20152;"Gintarėlis (Popieriaus g. 46A)";"LINKSMASIS AVILYS";63932903598;Taip;0;3;0;3
20153;"Gintarėlis (Popieriaus g. 46A)";"LINKSMASIS AVILYS";6425840559;Taip;0;2;3;5
20154;"Gintarėlis (Popieriaus g. 46A)";"LINKSMASIS AVILYS";1695680881;Taip;3;1;0;4
20155;"Gintarėlis (Popieriaus g. 46A)";"LINKSMASIS AVILYS";3572188688;Taip;0;0;4;4
20156;"Gintarėlis (Popieriaus g. 46A)";"LINKSMASIS AVILYS";7010430969;Taip;0;2;0;2
20157;"Gintarėlis (Popieriaus g. 46A)";"LINKSMASIS AVILYS";1070119148;Taip;0;9;0;9
20158;"Gintarėlis (Popieriaus g. 46A)";"LINKSMASIS AVILYS";9182625265;Taip;0;1;0;1
20159;"Gintarėlis (Popieriaus g. 46A)";"LINKSMASIS AVILYS";49937307547;Taip;0;5;0;5
20160;"Pušynėlis (A. Mickevičiaus g. 21)";DAIGIUKAI;4997004998;Taip;0;1;0;1
20161;"Pušynėlis (A. Mickevičiaus g. 21)";DAIGIUKAI;9450347140;Taip;0;0;2;2
20162;"Pušynėlis (A. Mickevičiaus g. 21)";DAIGIUKAI;2222790161;Taip;6;2;0;8
20163;"Pušynėlis (A. Mickevičiaus g. 21)";DAIGIUKAI;7596876368;Taip;15;1;0;16
20164;"Pušynėlis (A. Mickevičiaus g. 21)";DAIGIUKAI;9517319856;Taip;0;1;0;1
20165;"Pušynėlis (A. Mickevičiaus g. 21)";DAIGIUKAI;9028515427;Taip;10;0;0;10
20166;"Pušynėlis (A. Mickevičiaus g. 21)";DAIGIUKAI;2825756894;Taip;9;13;0;22
20167;"Pušynėlis (A. Mickevičiaus g. 21)";DAIGIUKAI;2892213973;Taip;0;2;6;8
20168;"Pušynėlis (A. Mickevičiaus g. 21)";DAIGIUKAI;7429853563;Taip;13;2;0;15
20169;"Pušynėlis (A. Mickevičiaus g. 21)";DAIGIUKAI;2518703833;Taip;0;0;3;3
20170;"Pušynėlis (A. Mickevičiaus g. 21)";DAIGIUKAI;8464672994;Taip;8;1;0;9
20171;"Pušynėlis (A. Mickevičiaus g. 21)";DAIGIUKAI;1904434730;Taip;8;0;0;8
20172;"Pušynėlis (A. Mickevičiaus g. 21)";DAIGIUKAI;1134325833;Taip;3;0;0;3
20173;"Pušynėlis (A. Mickevičiaus g. 21)";DAIGIUKAI;3574446664;Taip;0;2;0;2
20174;"Pušynėlis (A. Mickevičiaus g. 21)";DAIGIUKAI;3362971538;Taip;3;1;0;4
20175;"Pušynėlis (A. Mickevičiaus g. 21)";NYKŠTUKAI;3158789663;Taip;0;1;0;1
20176;"Pušynėlis (A. Mickevičiaus g. 21)";NYKŠTUKAI;5668765825;Taip;7;0;3;10
20177;"Pušynėlis (A. Mickevičiaus g. 21)";NYKŠTUKAI;7685809238;Taip;3;1;0;4
20178;"Pušynėlis (A. Mickevičiaus g. 21)";NYKŠTUKAI;7011836009;Taip;9;0;0;9
20179;"Pušynėlis (A. Mickevičiaus g. 21)";NYKŠTUKAI;3301741162;Taip;8;0;0;8
20180;"Pušynėlis (A. Mickevičiaus g. 21)";NYKŠTUKAI;6735037523;Taip;14;0;2;16
20181;"Pušynėlis (A. Mickevičiaus g. 21)";NYKŠTUKAI;4456549120;Taip;6;1;3;10
20182;"Pušynėlis (A. Mickevičiaus g. 21)";NYKŠTUKAI;9147558926;Taip;0;3;4;7
20183;"Pušynėlis (A. Mickevičiaus g. 21)";NYKŠTUKAI;7881263225;Taip;0;4;0;4
20184;"Pušynėlis (A. Mickevičiaus g. 21)";NYKŠTUKAI;1612049897;Taip;0;2;2;4
20185;"Pušynėlis (A. Mickevičiaus g. 21)";NYKŠTUKAI;9920959446;Taip;2;0;0;2
20186;"Pušynėlis (A. Mickevičiaus g. 21)";NYKŠTUKAI;4898147530;Taip;0;13;0;13
20187;"Pušynėlis (A. Mickevičiaus g. 21)";NYKŠTUKAI;2228682366;Ne;0;14;0;14
20188;"Pušynėlis (A. Mickevičiaus g. 21)";GILIUKAI;8339073780;Taip;0;2;4;6
20189;"Pušynėlis (A. Mickevičiaus g. 21)";GILIUKAI;1887737859;Taip;0;2;0;2
20190;"Pušynėlis (A. Mickevičiaus g. 21)";GILIUKAI;8837847094;Taip;0;2;5;7
20191;"Pušynėlis (A. Mickevičiaus g. 21)";GILIUKAI;1194624252;Taip;7;2;1;10
20192;"Pušynėlis (A. Mickevičiaus g. 21)";GILIUKAI;4738909947;Taip;0;1;0;1
20193;"Pušynėlis (A. Mickevičiaus g. 21)";GILIUKAI;1148540808;Ne;0;5;0;5
20194;"Pušynėlis (A. Mickevičiaus g. 21)";GILIUKAI;9401101407;Taip;0;3;0;3
20195;"Pušynėlis (A. Mickevičiaus g. 21)";GILIUKAI;2315614501;Taip;1;0;0;1
20196;"Pušynėlis (A. Mickevičiaus g. 21)";GILIUKAI;3189188757;Taip;0;1;0;1
20197;"Pušynėlis (A. Mickevičiaus g. 21)";GILIUKAI;6130634131;Taip;0;0;2;2
20198;"Pušynėlis (A. Mickevičiaus g. 21)";GILIUKAI;8654487151;Taip;0;8;0;8
20199;"Pušynėlis (A. Mickevičiaus g. 21)";GILIUKAI;2391319590;Taip;0;1;0;1
20200;"Pušynėlis (A. Mickevičiaus g. 21)";GILIUKAI;6160295507;Taip;0;0;1;1
20201;"Pušynėlis (A. Mickevičiaus g. 21)";GILIUKAI;6374352500;Taip;4;0;0;4
20202;"Pušynėlis (A. Mickevičiaus g. 21)";GILIUKAI;6979471009;Taip;8;0;1;9
20203;"Pušynėlis (A. Mickevičiaus g. 21)";GILIUKAI;71647031404;Taip;3;1;0;4
20204;"Pušynėlis (A. Mickevičiaus g. 21)";SAULUTĖ;4443285231;Taip;0;3;0;3
20205;"Pušynėlis (A. Mickevičiaus g. 21)";SAULUTĖ;58467930454;Taip;0;13;0;13
20206;"Pušynėlis (A. Mickevičiaus g. 21)";SAULUTĖ;37069004807;Taip;0;2;1;3
20207;"Pušynėlis (A. Mickevičiaus g. 21)";SAULUTĖ;5075219728;Taip;0;10;4;14
20208;"Pušynėlis (A. Mickevičiaus g. 21)";SAULUTĖ;1623356368;Taip;0;0;9;9
20209;"Pušynėlis (A. Mickevičiaus g. 21)";SAULUTĖ;5302605429;Taip;0;10;0;10
20210;"Pušynėlis (A. Mickevičiaus g. 21)";SAULUTĖ;1891722948;Taip;0;9;0;9
20211;"Pušynėlis (A. Mickevičiaus g. 21)";SAULUTĖ;4644771654;Taip;0;25;0;25
20212;"Pušynėlis (A. Mickevičiaus g. 21)";SAULUTĖ;94514045159;Taip;3;10;0;13
20213;"Pušynėlis (A. Mickevičiaus g. 21)";SAULUTĖ;46788785414;Taip;0;5;1;6
20214;"Pušynėlis (A. Mickevičiaus g. 21)";SAULUTĖ;18414199111;Taip;8;13;6;27
20215;"Pušynėlis (A. Mickevičiaus g. 21)";SAULUTĖ;32821891070;Taip;0;21;0;21
20216;"Pušynėlis (A. Mickevičiaus g. 21)";SAULUTĖ;1270931913;Taip;0;10;3;13
20217;"Pušynėlis (A. Mickevičiaus g. 21)";SAULUTĖ;1237521453;Taip;1;6;1;8
20218;"Pušynėlis (A. Mickevičiaus g. 21)";SAULUTĖ;61862257310;Taip;0;1;0;1
20219;"Pušynėlis (A. Mickevičiaus g. 21)";SAULUTĖ;1310088394;Taip;0;3;0;3
20220;"Pušynėlis (A. Mickevičiaus g. 21)";SAULUTĖ;1159267747;Taip;0;4;0;4
20221;"Pušynėlis (A. Mickevičiaus g. 21)";SAULUTĖ;79543604124;Taip;0;4;1;5
20222;"Pušynėlis (A. Mickevičiaus g. 21)";SAULUTĖ;3300710386;Taip;0;2;3;5
20223;"Pušynėlis (A. Mickevičiaus g. 21)";SAULUTĖ;1505058152;Taip;0;2;0;2
20224;"Pušynėlis (A. Mickevičiaus g. 21)";SAULUTĖ;3483401448;Taip;0;10;0;10
20225;"Pušynėlis (A. Mickevičiaus g. 21)";SAULUTĖ;1526473615;Taip;0;5;0;5
20226;"Naminukas (Klinikų g. 5)";VARPELIAI;7947598191;Taip;0;0;1;1
20227;"Naminukas (Klinikų g. 5)";VARPELIAI;3911352454;Taip;15;0;0;15
20228;"Naminukas (Klinikų g. 5)";VARPELIAI;7107337857;Taip;0;0;18;18
20229;"Naminukas (Klinikų g. 5)";VARPELIAI;7301768930;Taip;0;0;3;3
20230;"Naminukas (Klinikų g. 5)";VARPELIAI;2336627398;Taip;0;0;1;1
20231;"Naminukas (Klinikų g. 5)";VARPELIAI;1879925655;Taip;0;1;7;8
20232;"Naminukas (Klinikų g. 5)";VARPELIAI;4836599508;Taip;0;0;2;2
20233;"Naminukas (Klinikų g. 5)";VARPELIAI;1563213488;Taip;0;0;2;2
20234;"Naminukas (Klinikų g. 5)";VARPELIAI;4709625816;Taip;0;0;2;2
20235;"Naminukas (Klinikų g. 5)";VARPELIAI;6471277755;Taip;0;0;8;8
20236;"Naminukas (Klinikų g. 5)";VARPELIAI;1932169696;Taip;0;22;0;22
20237;"Naminukas (Klinikų g. 5)";SAULUTĖS;3276656641;Taip;6;0;0;6
20238;"Naminukas (Klinikų g. 5)";SAULUTĖS;6633031473;Taip;0;0;2;2
20239;"Naminukas (Klinikų g. 5)";SAULUTĖS;5569407817;Taip;19;0;1;20
20240;"Naminukas (Klinikų g. 5)";SAULUTĖS;4116151797;Taip;0;0;5;5
20241;"Naminukas (Klinikų g. 5)";SAULUTĖS;7033053271;Taip;0;3;0;3
20242;"Naminukas (Klinikų g. 5)";SAULUTĖS;1454039572;Taip;8;0;1;9
20243;"Naminukas (Klinikų g. 5)";SAULUTĖS;9740815635;Taip;0;3;0;3
20244;"Naminukas (Klinikų g. 5)";SAULUTĖS;9835701381;Ne;0;0;5;5
20245;"Naminukas (Klinikų g. 5)";SAULUTĖS;9212800864;Ne;0;4;0;4
20246;"Naminukas (Klinikų g. 5)";SAULUTĖS;7184471307;Taip;0;1;1;2
20247;"Naminukas (Klinikų g. 5)";SAULUTĖS;6949857110;Taip;1;1;4;6
20248;"Naminukas (Klinikų g. 5)";SAULUTĖS;8039086094;Taip;6;0;1;7
20249;"Naminukas (Klinikų g. 5)";SAULUTĖS;8432194383;Taip;5;0;2;7
20250;"Naminukas (Klinikų g. 5)";SAULUTĖS;7463647806;Taip;0;1;6;7
20251;"Naminukas (Klinikų g. 5)";SAULUTĖS;4171789569;Ne;0;13;0;13
20252;"Naminukas (Klinikų g. 5)";SAULUTĖS;9215327479;Taip;19;0;0;19
20253;"Naminukas (Klinikų g. 5)";SAULUTĖS;6880075874;Taip;2;0;0;2
20254;"Naminukas (Klinikų g. 5)";SAULUTĖS;8793327541;Taip;0;1;0;1
20255;"Naminukas (Klinikų g. 5)";DRUGELIAI;1424288192;Taip;0;0;1;1
20256;"Naminukas (Klinikų g. 5)";DRUGELIAI;2339599448;Taip;0;4;0;4
20257;"Naminukas (Klinikų g. 5)";DRUGELIAI;1180176295;Taip;0;0;2;2
20258;"Naminukas (Klinikų g. 5)";DRUGELIAI;4077985773;Taip;3;0;0;3
20259;"Naminukas (Klinikų g. 5)";DRUGELIAI;6592057292;Taip;0;0;10;10
20260;"Naminukas (Klinikų g. 5)";DRUGELIAI;2511267939;Ne;1;11;0;12
20261;"Naminukas (Klinikų g. 5)";DRUGELIAI;5288557629;Taip;0;4;0;4
20262;"Naminukas (Klinikų g. 5)";DRUGELIAI;5233044803;Taip;8;0;0;8
20263;"Naminukas (Klinikų g. 5)";DRUGELIAI;1346035733;Taip;0;6;0;6
20264;"Naminukas (Klinikų g. 5)";DRUGELIAI;3791118736;Taip;0;0;1;1
20265;"Naminukas (Klinikų g. 5)";DRUGELIAI;3088386659;Taip;0;0;6;6
20266;"Naminukas (Klinikų g. 5)";DRUGELIAI;5578151523;Taip;0;0;2;2
20267;"Naminukas (Klinikų g. 5)";DRUGELIAI;4353031174;Taip;0;0;1;1
20268;"Naminukas (Klinikų g. 5)";DRUGELIAI;9244494109;Taip;4;0;4;8
20269;"Naminukas (Klinikų g. 5)";DRUGELIAI;8923393066;Taip;0;0;11;11
20270;"Naminukas (Klinikų g. 5)";DRUGELIAI;1730248631;Taip;0;0;7;7
20271;"Naminukas (Klinikų g. 5)";DRUGELIAI;9178907705;Taip;0;1;6;7
20272;"Naminukas (Klinikų g. 5)";BITUTĖS;96365393879;Taip;3;1;1;5
20273;"Naminukas (Klinikų g. 5)";BITUTĖS;72997461686;Taip;0;0;5;5
20274;"Naminukas (Klinikų g. 5)";BITUTĖS;27408123487;Taip;0;13;0;13
20275;"Naminukas (Klinikų g. 5)";BITUTĖS;9145337789;Taip;3;0;1;4
20276;"Naminukas (Klinikų g. 5)";BITUTĖS;21152690883;Taip;0;4;0;4
20277;"Naminukas (Klinikų g. 5)";BITUTĖS;6435045068;Taip;0;0;2;2
20278;"Naminukas (Klinikų g. 5)";BITUTĖS;1391226466;Taip;0;0;2;2
20279;"Naminukas (Klinikų g. 5)";BITUTĖS;1821231102;Taip;3;0;0;3
20280;"Naminukas (Klinikų g. 5)";BITUTĖS;5050019035;Taip;0;0;3;3
20281;"Naminukas (Klinikų g. 5)";BITUTĖS;1679106754;Taip;0;6;0;6
20282;"Naminukas (Klinikų g. 5)";BITUTĖS;1528496272;Taip;0;1;0;1
20283;"Naminukas (Klinikų g. 5)";BITUTĖS;63344816879;Taip;14;0;0;14
20284;"Naminukas (Klinikų g. 5)";BITUTĖS;60956380679;Taip;0;1;3;4
20285;"Naminukas (Klinikų g. 5)";BITUTĖS;92417802345;Taip;0;0;7;7
20286;"Gervelė (Stadiono g. 5)";BORUŽĖLĖS;6427072260;Taip;0;0;1;1
20287;"Gervelė (Stadiono g. 5)";BORUŽĖLĖS;1204513844;Taip;4;0;0;4
20288;"Gervelė (Stadiono g. 5)";BORUŽĖLĖS;9777308731;Taip;1;0;0;1
20289;"Gervelė (Stadiono g. 5)";BORUŽĖLĖS;5285868851;Taip;0;1;0;1
20290;"Gervelė (Stadiono g. 5)";BORUŽĖLĖS;9154032804;Ne;0;12;0;12
20291;"Gervelė (Stadiono g. 5)";BORUŽĖLĖS;1395241501;Taip;0;2;0;2
20292;"Gervelė (Stadiono g. 5)";BORUŽĖLĖS;8126701466;Taip;3;0;0;3
20293;"Gervelė (Stadiono g. 5)";BORUŽĖLĖS;3676856569;Taip;3;0;0;3
20294;"Gervelė (Stadiono g. 5)";BORUŽĖLĖS;7419432731;Taip;3;0;0;3
20295;"Gervelė (Stadiono g. 5)";BORUŽĖLĖS;4588890423;Taip;0;16;0;16
20296;"Gervelė (Stadiono g. 5)";BORUŽĖLĖS;2712133300;Taip;17;0;0;17
20297;"Gervelė (Stadiono g. 5)";BORUŽĖLĖS;1611114179;Taip;8;0;0;8
20298;"Gervelė (Stadiono g. 5)";PAUKŠTELIAI;4347007911;Taip;0;3;0;3
20299;"Gervelė (Stadiono g. 5)";PAUKŠTELIAI;9291855374;Taip;0;3;0;3
20300;"Gervelė (Stadiono g. 5)";PAUKŠTELIAI;2031118410;Taip;0;7;0;7
20301;"Gervelė (Stadiono g. 5)";PAUKŠTELIAI;4832348492;Taip;0;0;9;9
20302;"Gervelė (Stadiono g. 5)";PAUKŠTELIAI;5966215998;Taip;3;0;2;5
20303;"Gervelė (Stadiono g. 5)";PAUKŠTELIAI;8472436632;Taip;22;0;0;22
20304;"Gervelė (Stadiono g. 5)";PAUKŠTELIAI;7855598075;Taip;0;9;0;9
20305;"Gervelė (Stadiono g. 5)";PAUKŠTELIAI;3490370918;Ne;13;3;0;16
20306;"Gervelė (Stadiono g. 5)";PAUKŠTELIAI;7463376031;Taip;0;10;0;10
20307;"Gervelė (Stadiono g. 5)";PAUKŠTELIAI;1751440418;Taip;6;0;1;7
20308;"Gervelė (Stadiono g. 5)";PAUKŠTELIAI;8777858708;Ne;0;10;0;10
20309;"Gervelė (Stadiono g. 5)";PAUKŠTELIAI;3567687304;Taip;0;4;0;4
20310;"Gervelė (Stadiono g. 5)";PAUKŠTELIAI;6488139414;Taip;13;0;0;13
20311;"Gervelė (Stadiono g. 5)";PAUKŠTELIAI;6372245141;Taip;5;0;0;5
20312;"Gervelė (Stadiono g. 5)";PAUKŠTELIAI;9183582003;Ne;13;3;0;16
20313;"Gervelė (Stadiono g. 5)";SPINDULĖLIAI;30473769754;Taip;0;0;1;1
20314;"Gervelė (Stadiono g. 5)";SPINDULĖLIAI;4508176017;Taip;0;0;11;11
20315;"Gervelė (Stadiono g. 5)";SPINDULĖLIAI;32063805512;Taip;0;4;0;4
20316;"Gervelė (Stadiono g. 5)";SPINDULĖLIAI;4051246539;Ne;8;0;0;8
20317;"Gervelė (Stadiono g. 5)";SPINDULĖLIAI;1520846063;Taip;0;13;0;13
20318;"Gervelė (Stadiono g. 5)";SPINDULĖLIAI;4558350854;Ne;0;14;0;14
20319;"Gervelė (Stadiono g. 5)";SPINDULĖLIAI;8154620920;Taip;0;9;0;9
20320;"Gervelė (Stadiono g. 5)";SPINDULĖLIAI;5705915729;Taip;0;5;0;5
20321;"Gervelė (Stadiono g. 5)";SPINDULĖLIAI;5786557195;Taip;0;6;0;6
20322;"Gervelė (Stadiono g. 5)";SPINDULĖLIAI;9125827523;Taip;0;10;0;10
20323;"Gervelė (Stadiono g. 5)";SPINDULĖLIAI;2041814549;Taip;2;0;0;2
20324;"Gervelė (Stadiono g. 5)";SPINDULĖLIAI;9865628172;Taip;0;0;1;1
20325;"Gervelė (Stadiono g. 5)";SPINDULĖLIAI;2207041148;Taip;0;6;0;6
20326;"Gervelė (Stadiono g. 5)";SPINDULĖLIAI;88565114332;Taip;4;0;0;4
20327;"Gervelė (Stadiono g. 5)";SPINDULĖLIAI;3397741232;Taip;0;1;0;1
20328;"Gervelė (Stadiono g. 5)";GĖLYTĖS;1953918266;Taip;0;9;0;9
20329;"Gervelė (Stadiono g. 5)";GĖLYTĖS;4733970252;Taip;0;1;0;1
20330;"Gervelė (Stadiono g. 5)";GĖLYTĖS;1942666372;Taip;0;8;0;8
20331;"Gervelė (Stadiono g. 5)";GĖLYTĖS;8584120396;Taip;2;1;8;11
20332;"Gervelė (Stadiono g. 5)";GĖLYTĖS;23520576240;Taip;0;3;0;3
20333;"Gervelė (Stadiono g. 5)";GĖLYTĖS;5024289280;Taip;1;4;0;5
20334;"Gervelė (Stadiono g. 5)";GĖLYTĖS;1685710938;Taip;2;2;0;4
20335;"Gervelė (Stadiono g. 5)";GĖLYTĖS;6172016747;Taip;14;0;0;14
20336;"Gervelė (Stadiono g. 5)";GĖLYTĖS;3873345138;Ne;0;14;0;14
20337;"Gervelė (Stadiono g. 5)";GĖLYTĖS;5518309115;Taip;3;3;0;6
20338;"Gervelė (Stadiono g. 5)";GĖLYTĖS;1161906832;Taip;1;0;0;1
20339;"Gervelė (Stadiono g. 5)";GĖLYTĖS;2744433344;Taip;13;0;1;14
20340;"Gervelė (Stadiono g. 5)";GĖLYTĖS;7426544243;Taip;3;4;0;7
20341;"Gervelė (Stadiono g. 5)";GĖLYTĖS;50441219517;Taip;0;5;0;5
20342;"Gervelė (Stadiono g. 5)";GĖLYTĖS;4930308435;Taip;0;3;0;3
20343;"Gervelė (Stadiono g. 5)";GĖLYTĖS;1606294984;Taip;5;0;0;5
20344;"Gervelė (Stadiono g. 5)";GĖLYTĖS;6621769160;Taip;13;1;0;14
20345;"Gervelė (Stadiono g. 5)";GĖLYTĖS;2043650571;Taip;5;0;0;5
20346;"Gervelė (Stadiono g. 5)";GĖLYTĖS;5354831337;Ne;0;13;0;13
20347;"Kūlverstukas (Mindaugo g. 7)";GNOMIKI;4894478262;Taip;0;9;5;14
20348;"Kūlverstukas (Mindaugo g. 7)";GNOMIKI;2501327054;Ne;0;3;0;3
20349;"Kūlverstukas (Mindaugo g. 7)";GNOMIKI;8348978878;Taip;8;3;0;11
20350;"Kūlverstukas (Mindaugo g. 7)";GNOMIKI;2539486337;Taip;2;0;4;6
20351;"Kūlverstukas (Mindaugo g. 7)";GNOMIKI;8927489885;Taip;0;0;1;1
20352;"Kūlverstukas (Mindaugo g. 7)";GNOMIKI;2709547427;Taip;6;0;0;6
20353;"Kūlverstukas (Mindaugo g. 7)";GNOMIKI;1312165385;Taip;0;1;0;1
20354;"Kūlverstukas (Mindaugo g. 7)";GNOMIKI;5532063862;Taip;5;2;0;7
20355;"Kūlverstukas (Mindaugo g. 7)";GNOMIKI;5747277587;Taip;0;2;4;6
20356;"Kūlverstukas (Mindaugo g. 7)";GNOMIKI;1848018684;Taip;0;1;0;1
20357;"Kūlverstukas (Mindaugo g. 7)";GNOMIKI;1166429762;Taip;0;2;0;2
20358;"Kūlverstukas (Mindaugo g. 7)";GNOMIKI;6514730230;Taip;22;0;0;22
20359;"Kūlverstukas (Mindaugo g. 7)";ZAIČIATA;1102996499;Taip;10;0;0;10
20360;"Kūlverstukas (Mindaugo g. 7)";ZAIČIATA;8994705290;Taip;12;4;0;16
20361;"Kūlverstukas (Mindaugo g. 7)";ZAIČIATA;8496678513;Taip;4;0;0;4
20362;"Kūlverstukas (Mindaugo g. 7)";ZAIČIATA;7933156766;Taip;15;0;1;16
20363;"Kūlverstukas (Mindaugo g. 7)";ZAIČIATA;2494202134;Ne;0;3;0;3
20364;"Kūlverstukas (Mindaugo g. 7)";ZAIČIATA;2714297182;Taip;0;0;3;3
20365;"Kūlverstukas (Mindaugo g. 7)";ZAIČIATA;4998847820;Ne;0;0;3;3
20366;"Kūlverstukas (Mindaugo g. 7)";ZAIČIATA;6497373567;Taip;0;8;0;8
20367;"Kūlverstukas (Mindaugo g. 7)";ZAIČIATA;5546604017;Taip;13;0;0;13
20368;"Kūlverstukas (Mindaugo g. 7)";ZAIČIATA;3660002342;Taip;0;0;1;1
20369;"Kūlverstukas (Mindaugo g. 7)";ZAIČIATA;6311116034;Taip;10;0;0;10
20370;"Kūlverstukas (Mindaugo g. 7)";SVETLIAČKI;9734653830;Ne;0;12;3;15
20371;"Kūlverstukas (Mindaugo g. 7)";SVETLIAČKI;13885215871;Taip;0;2;0;2
20372;"Kūlverstukas (Mindaugo g. 7)";SVETLIAČKI;6219872984;Taip;12;0;0;12
20373;"Kūlverstukas (Mindaugo g. 7)";SVETLIAČKI;9098427210;Taip;0;0;4;4
20374;"Kūlverstukas (Mindaugo g. 7)";SVETLIAČKI;2091204077;Ne;0;10;0;10
20375;"Kūlverstukas (Mindaugo g. 7)";SVETLIAČKI;70033583066;Taip;0;8;0;8
20376;"Kūlverstukas (Mindaugo g. 7)";SVETLIAČKI;2154916232;Taip;0;0;6;6
20377;"Kūlverstukas (Mindaugo g. 7)";SVETLIAČKI;75301544496;Taip;0;3;1;4
20378;"Kūlverstukas (Mindaugo g. 7)";SVETLIAČKI;6376189019;Taip;6;2;1;9
20379;"Kūlverstukas (Mindaugo g. 7)";SVETLIAČKI;1125206576;Taip;0;13;0;13
20380;"Kūlverstukas (Mindaugo g. 7)";SVETLIAČKI;1786822865;Taip;0;3;0;3
20381;"Kūlverstukas (Mindaugo g. 7)";SVETLIAČKI;1557237011;Taip;12;0;0;12
20382;"Kūlverstukas (Mindaugo g. 7)";SVETLIAČKI;6031087595;Taip;12;0;0;12
20383;"Kūlverstukas (Mindaugo g. 7)";SVETLIAČKI;8577197481;Ne;17;1;0;18
20384;"Kūlverstukas (Mindaugo g. 7)";SVETLIAČKI;3449300504;Taip;0;5;0;5
20385;"Kūlverstukas (Mindaugo g. 7)";ZVONOČKI;1486878343;Taip;0;0;1;1
20386;"Kūlverstukas (Mindaugo g. 7)";ZVONOČKI;4392299046;Taip;0;0;7;7
20387;"Kūlverstukas (Mindaugo g. 7)";ZVONOČKI;8835111916;Taip;0;0;3;3
20388;"Kūlverstukas (Mindaugo g. 7)";ZVONOČKI;5724787637;Taip;0;5;0;5
20389;"Kūlverstukas (Mindaugo g. 7)";ZVONOČKI;4377803110;Taip;0;5;0;5
20390;"Kūlverstukas (Mindaugo g. 7)";ZVONOČKI;7898746258;Taip;9;0;1;10
20391;"Kūlverstukas (Mindaugo g. 7)";ZVONOČKI;9835391223;Taip;9;4;0;13
20392;"Kūlverstukas (Mindaugo g. 7)";ZVONOČKI;4677564389;Ne;0;7;0;7
20393;"Kūlverstukas (Mindaugo g. 7)";ZVONOČKI;1916522637;Taip;5;0;1;6
20394;"Kūlverstukas (Mindaugo g. 7)";ZVONOČKI;2429527586;Taip;0;0;21;21
20395;"Kūlverstukas (Mindaugo g. 7)";ZVONOČKI;5217751936;Taip;0;12;0;12
20396;"Kūlverstukas (Mindaugo g. 7)";ZVONOČKI;1566191212;Taip;0;2;0;2
20397;"Kūlverstukas (Mindaugo g. 7)";ZVONOČKI;9569296370;Taip;0;2;14;16
20398;"Kūlverstukas (Mindaugo g. 7)";ZVONOČKI;3239566139;Taip;0;3;0;3
20399;"Kūlverstukas (Mindaugo g. 7)";ZVONOČKI;4404602365;Taip;0;8;2;10
20400;"Kūlverstukas (Mindaugo g. 7)";ZVONOČKI;9756326725;Taip;0;0;15;15
20401;"Kūlverstukas (Mindaugo g. 7)";ZVONOČKI;9156801640;Taip;6;2;1;9
20402;"Kūlverstukas (Mindaugo g. 7)";ZVONOČKI;1713133196;Taip;0;1;0;1
